date_hzcode,hzone_code,cases,deaths,shifted_cases,cum_cases,cases_neighbors_avg,weights,dow
2020-03-01-170101,170101,0,0,0,0,0.0,2.2074178e-07,6
2020-03-02-170101,170101,0,0,2,0,0.0,4.617517e-07,0
2020-03-03-170101,170101,0,0,1,0,0.0,0.0014496956,1
2020-03-04-170101,170101,0,1,3,0,0.0,9.260696e-07,2
2020-03-05-170101,170101,0,0,3,0,0.0,0.0011639531,3
2020-03-06-170101,170101,0,0,9,0,0.0,6.8092972e-06,4
2020-03-07-170101,170101,0,0,1,0,0.0,0.00024572204,5
2020-03-08-170101,170101,0,0,2,0,0.0,1.0289756e-08,6
2020-03-09-170101,170101,0,0,10,0,0.0,7.579266e-05,0
2020-03-10-170101,170101,0,0,4,0,0.0,2.0425668e-05,1
2020-03-11-170101,170101,0,0,5,0,0.0,0.0024678835,2
2020-03-12-170101,170101,0,0,4,0,0.5,0.021344615,3
2020-03-13-170101,170101,1,0,3,1,0.25,0.027772045,4
2020-03-14-170101,170101,0,0,2,1,0.25,7.2630195e-07,5
2020-03-15-170101,170101,0,0,5,1,0.25,0.006238415,6
2020-03-16-170101,170101,2,0,6,3,0.75,0.022681398,0
2020-03-17-170101,170101,1,0,5,4,0.0,0.009765668,1
2020-03-18-170101,170101,3,0,10,7,2.75,0.053510334,2
2020-03-19-170101,170101,3,1,15,10,1.75,0.079168096,3
2020-03-20-170101,170101,9,0,6,19,0.25,0.030024964,4
2020-03-21-170101,170101,1,0,2,20,0.75,0.0116214305,5
2020-03-22-170101,170101,2,0,2,22,0.75,0.013906216,6
2020-03-23-170101,170101,10,0,5,32,2.5,0.05522304,0
2020-03-24-170101,170101,4,0,3,36,0.75,0.022431467,1
2020-03-25-170101,170101,5,0,1,41,5.5,0.055441994,2
2020-03-26-170101,170101,4,0,3,45,3.5,0.039918475,3
2020-03-27-170101,170101,3,0,26,48,3.25,0.022344347,4
2020-03-28-170101,170101,2,0,5,50,0.75,0.0037591541,5
2020-03-29-170101,170101,5,0,0,55,1.0,0.020733396,6
2020-03-30-170101,170101,6,0,6,61,3.0,0.054491255,0
2020-03-31-170101,170101,5,0,6,66,3.25,0.04942588,1
2020-04-01-170101,170101,10,0,6,76,4.25,0.06528655,2
2020-04-02-170101,170101,15,0,6,91,2.25,0.06851976,3
2020-04-03-170101,170101,6,0,1,97,2.75,0.04677598,4
2020-04-04-170101,170101,2,0,2,99,0.5,0.0057553905,5
2020-04-05-170101,170101,2,0,0,101,0.75,0.011098814,6
2020-04-06-170101,170101,5,0,5,106,2.75,0.06902112,0
2020-04-07-170101,170101,3,0,1,109,1.75,0.049517196,1
2020-04-08-170101,170101,1,0,2,110,2.0,0.03723561,2
2020-04-09-170101,170101,3,0,0,113,1.75,0.03725372,3
2020-04-10-170101,170101,26,0,1,139,7.25,0.1364462,4
2020-04-11-170101,170101,5,1,0,144,0.75,0.017620264,5
2020-04-12-170101,170101,0,0,0,144,0.25,0.009827303,6
2020-04-13-170101,170101,6,0,1,150,1.0,0.022978032,0
2020-04-14-170101,170101,6,0,2,156,0.25,0.03504386,1
2020-04-15-170101,170101,6,0,1,162,1.25,0.030548703,2
2020-04-16-170101,170101,6,0,1,168,0.5,0.029532522,3
2020-04-17-170101,170101,1,0,1,169,0.25,0.031132068,4
2020-04-18-170101,170101,2,0,0,171,0.0,0.0065230764,5
2020-04-19-170101,170101,0,0,0,171,0.0,0.009389073,6
2020-04-20-170101,170101,5,0,0,176,0.5,0.032051854,0
2020-04-21-170101,170101,1,0,1,177,0.5,0.018490825,1
2020-04-22-170101,170101,2,0,4,179,0.25,0.02506196,2
2020-04-23-170101,170101,0,0,0,179,0.0,0.001031157,3
2020-04-24-170101,170101,1,0,4,180,0.75,0.026180575,4
2020-04-25-170101,170101,0,0,2,180,0.75,0.014467847,5
2020-04-26-170101,170101,0,0,0,180,0.25,0.0030959588,6
2020-04-27-170101,170101,1,0,2,181,0.25,0.017218057,0
2020-04-28-170101,170101,2,0,1,183,0.5,0.020527085,1
2020-04-29-170101,170101,1,2,0,184,1.25,0.0329802,2
2020-04-30-170101,170101,1,0,3,185,0.25,0.005168506,3
2020-05-01-170101,170101,1,0,2,186,0.25,0.0052396054,4
2020-05-02-170101,170101,0,0,0,186,0.5,0.013067235,5
2020-05-03-170101,170101,0,0,0,186,0.25,0.009069101,6
2020-05-04-170101,170101,0,0,1,186,0.25,0.01019822,0
2020-05-05-170101,170101,1,0,1,187,0.5,0.008697862,1
2020-05-06-170101,170101,4,0,1,191,1.25,0.023469843,2
2020-05-07-170101,170101,0,0,0,191,1.25,0.044079445,3
2020-05-08-170101,170101,4,0,1,195,1.25,0.048041396,4
2020-05-09-170101,170101,2,0,0,197,0.75,0.021390418,5
2020-05-10-170101,170101,0,0,0,197,0.25,0.009882172,6
2020-05-11-170101,170101,2,0,2,199,1.0,0.02953785,0
2020-05-12-170101,170101,1,0,1,200,0.0,0.028929425,1
2020-05-13-170101,170101,0,0,1,200,0.25,0.009879404,2
2020-05-14-170101,170101,3,0,0,203,0.5,0.02137413,3
2020-05-15-170101,170101,2,0,1,205,0.5,0.011171815,4
2020-05-16-170101,170101,0,0,0,205,0.0,0.0006473786,5
2020-05-17-170101,170101,0,0,1,205,0.0,0.0008648902,6
2020-05-18-170101,170101,1,0,0,206,0.0,0.019211715,0
2020-05-19-170101,170101,1,0,1,207,0.25,0.012425603,1
2020-05-20-170101,170101,1,0,2,208,0.75,0.022349553,2
2020-05-21-170101,170101,0,0,0,208,0.25,0.009840745,3
2020-05-22-170101,170101,1,1,0,209,0.25,0.017667772,4
2020-05-23-170101,170101,0,0,0,209,0.0,0.0013893092,5
2020-05-24-170101,170101,0,0,1,209,0.0,0.006018253,6
2020-05-25-170101,170101,2,1,0,211,0.5,0.021979365,0
2020-05-26-170101,170101,1,0,1,212,0.0,0.014942255,1
2020-05-27-170101,170101,1,0,0,213,0.5,0.0057430663,2
2020-05-28-170101,170101,0,3,2,213,0.0,0.025971388,3
2020-05-29-170101,170101,1,2,1,214,0.25,0.004811979,4
2020-05-30-170101,170101,0,0,0,214,0.0,0.0009484443,5
2020-05-31-170101,170101,1,1,0,215,0.0,0.014400199,6
2020-06-01-170101,170101,0,0,0,215,0.0,0.009269472,0
2020-06-02-170101,170101,1,0,0,216,0.25,0.027708499,1
2020-06-03-170101,170101,2,0,1,218,0.25,0.01639831,2
2020-06-04-170101,170101,0,0,0,218,0.5,0.0035123008,3
2020-06-05-170101,170101,0,0,0,218,0.25,0.0059257955,4
2020-06-06-170101,170101,0,0,0,218,0.0,0.0035106393,5
2020-06-07-170101,170101,1,0,0,219,0.0,0.0016741946,6
2020-06-08-170101,170101,0,0,2,219,0.75,0.018944528,0
2020-06-09-170101,170101,1,0,1,220,0.25,0.007835235,1
2020-06-10-170101,170101,0,0,0,220,0.0,0.0014134542,2
2020-06-11-170101,170101,2,0,1,222,0.25,0.0038146817,3
2020-06-12-170101,170101,1,0,0,223,0.0,0.005939233,4
2020-06-13-170101,170101,0,0,0,223,0.0,2.9279958e-05,5
2020-06-14-170101,170101,0,0,0,223,0.25,0.008055597,6
2020-06-15-170101,170101,0,0,0,223,0.25,0.008839376,0
2020-06-16-170101,170101,0,0,0,223,0.5,0.013345371,1
2020-06-17-170101,170101,1,0,0,224,0.5,0.021576852,2
2020-06-18-170101,170101,0,0,0,224,0.75,0.0209805,3
2020-06-19-170101,170101,0,0,0,224,0.0,0.00289172,4
2020-06-20-170101,170101,0,0,0,224,0.25,0.017908353,5
2020-06-21-170101,170101,0,0,0,224,0.0,0.0055595106,6
2020-06-22-170101,170101,2,0,0,226,0.0,0.006260195,0
2020-06-23-170101,170101,1,0,0,227,0.25,0.00727948,1
2020-06-24-170101,170101,0,0,0,227,0.0,0.0100497,2
2020-06-25-170101,170101,1,0,1,228,0.25,0.006901936,3
2020-06-26-170101,170101,0,2,0,228,0.0,0.01617768,4
2020-06-27-170101,170101,0,0,1,228,0.0,0.0013567641,5
2020-06-28-170101,170101,0,0,0,228,0.0,0.0031999992,6
2020-06-29-170101,170101,0,0,0,228,0.25,0.008002339,0
2020-06-30-170101,170101,0,0,0,228,0.0,0.006244163,1
2020-07-01-170101,170101,0,0,0,228,0.5,0.015132203,2
2020-07-02-170101,170101,0,0,0,228,0.0,0.012850159,3
2020-07-03-170101,170101,0,0,1,228,0.0,0.006344208,4
2020-07-04-170101,170101,0,0,0,228,0.0,0.0020471786,5
2020-07-05-170101,170101,0,0,0,228,0.0,0.00017624167,6
2020-07-06-170101,170101,0,0,0,228,0.0,0.010049321,0
2020-07-07-170101,170101,0,0,0,228,0.5,0.0128094815,1
2020-07-08-170101,170101,0,0,0,228,0.0,0.002241278,2
2020-07-09-170101,170101,1,0,0,229,0.0,0.0034237485,3
2020-07-10-170101,170101,0,0,0,229,0.0,0.021881681,4
2020-07-11-170101,170101,1,0,0,230,0.0,0.023810871,5
2020-07-12-170101,170101,0,0,0,230,0.0,0.0034325875,6
2020-07-13-170101,170101,0,0,1,230,0.0,0.011946043,0
2020-07-14-170101,170101,0,0,0,230,0.5,0.014010498,1
2020-07-15-170101,170101,0,0,0,230,0.5,0.0103527745,2
2020-07-16-170101,170101,0,0,0,230,0.0,0.006049716,3
2020-07-17-170101,170101,1,1,0,231,0.0,0.027832992,4
2020-07-18-170101,170101,0,0,0,231,0.0,0.01961244,5
2020-07-19-170101,170101,0,0,0,231,0.0,3.078614e-07,6
2020-07-20-170101,170101,0,0,0,231,0.0,0.014861069,0
2020-07-21-170101,170101,0,0,0,231,0.25,0.00829387,1
2020-07-22-170101,170101,0,0,0,231,0.0,0.012628992,2
2020-07-23-170101,170101,0,0,0,231,0.75,0.024246903,3
2020-07-24-170101,170101,0,0,0,231,0.0,0.0007048585,4
2020-07-25-170101,170101,0,0,1,231,0.0,6.749046e-05,5
2020-07-26-170101,170101,0,0,0,231,0.0,0.002296098,6
2020-07-27-170101,170101,1,0,0,232,0.25,0.013947199,0
2020-07-28-170101,170101,0,0,2,232,0.0,0.010151054,1
2020-07-29-170101,170101,0,0,1,232,0.0,0.006671412,2
2020-07-30-170101,170101,0,0,0,232,0.0,0.008438815,3
2020-07-31-170101,170101,0,0,0,232,0.25,0.016822355,4
2020-08-01-170101,170101,0,0,0,232,0.0,0.00079106574,5
2020-08-02-170101,170101,0,0,0,232,0.0,0.0024440582,6
2020-08-03-170101,170101,0,0,1,232,0.0,0.01741993,0
2020-08-04-170101,170101,0,0,0,232,0.0,0.028311025,1
2020-08-05-170101,170101,0,0,0,232,0.75,0.060006358,2
2020-08-06-170101,170101,0,1,0,232,0.25,0.07367034,3
2020-08-07-170101,170101,0,0,3,232,1.25,0.08040314,4
2020-08-08-170101,170101,1,0,0,233,0.0,0.085068636,5
2020-08-09-170101,170101,0,0,0,233,0.5,0.004069756,6
2020-08-10-170101,170101,0,0,2,233,0.75,0.055100065,0
2020-08-11-170101,170101,2,0,4,235,2.0,0.086716905,1
2020-08-12-170101,170101,1,0,7,236,1.25,0.11286585,2
2020-08-13-170101,170101,0,0,0,236,0.75,0.13311955,3
2020-08-14-170101,170101,0,0,0,236,3.5,0.1626193,4
2020-08-15-170101,170101,0,0,1,236,0.75,0.0606765,5
2020-08-16-170101,170101,0,0,2,236,0.0,0.014671076,6
2020-08-17-170101,170101,1,0,1,237,0.5,0.08546223,0
2020-08-18-170101,170101,0,0,0,237,0.25,0.03952648,1
2020-08-19-170101,170101,0,2,1,237,1.25,0.06381281,2
2020-08-20-170101,170101,0,0,10,237,12.5,0.094671115,3
2020-08-21-170101,170101,3,0,0,240,1.0,0.10672469,4
2020-08-22-170101,170101,0,0,0,240,7.75,0.036940347,5
2020-08-23-170101,170101,0,0,0,240,0.75,0.042323034,6
2020-08-24-170101,170101,2,0,2,242,0.75,0.035332486,0
2020-08-25-170101,170101,4,0,0,246,1.0,0.047004253,1
2020-08-26-170101,170101,7,0,2,253,1.25,0.053304456,2
2020-08-27-170101,170101,0,0,0,253,0.5,0.056305975,3
2020-08-28-170101,170101,0,0,3,253,0.5,0.037498612,4
2020-08-29-170101,170101,1,0,25,254,3.75,0.049869858,5
2020-08-30-170101,170101,2,0,0,256,1.0,0.034442436,6
2020-08-31-170101,170101,1,0,1,257,0.75,0.035584614,0
2020-09-01-170101,170101,0,0,8,257,0.5,0.038807683,1
2020-09-02-170101,170101,1,1,3,258,0.0,0.004084817,2
2020-09-03-170101,170101,10,0,4,268,2.0,0.11262662,3
2020-09-04-170101,170101,0,0,4,268,2.75,0.099325,4
2020-09-05-170101,170101,0,0,1,268,1.0,0.033252485,5
2020-09-06-170101,170101,0,0,0,268,0.25,0.02479104,6
2020-09-07-170101,170101,2,1,0,270,0.5,0.042597815,0
2020-09-08-170101,170101,0,0,2,270,0.75,0.06754411,1
2020-09-09-170101,170101,2,0,6,272,1.25,0.084222876,2
2020-09-10-170101,170101,0,0,1,272,1.5,0.06182305,3
2020-09-11-170101,170101,3,0,6,275,2.25,0.077120036,4
2020-09-12-170101,170101,25,0,2,300,0.25,0.05756293,5
2020-09-13-170101,170101,0,0,0,300,1.25,0.038646895,6
2020-09-14-170101,170101,1,0,2,301,0.25,0.034845944,0
2020-09-15-170101,170101,8,0,0,309,1.0,0.056178726,1
2020-09-16-170101,170101,3,0,7,312,2.5,0.06352796,2
2020-09-17-170101,170101,4,0,1,316,0.0,0.045444667,3
2020-09-18-170101,170101,4,0,2,320,4.5,0.12431463,4
2020-09-19-170101,170101,1,0,2,321,1.75,0.025314054,5
2020-09-20-170101,170101,0,1,0,321,0.5,0.00860153,6
2020-09-21-170101,170101,0,1,5,321,0.75,0.038562655,0
2020-09-22-170101,170101,2,1,1,323,1.75,0.07235948,1
2020-09-23-170101,170101,6,0,2,329,0.75,0.07336537,2
2020-09-24-170101,170101,1,1,2,330,0.25,0.031654667,3
2020-09-25-170101,170101,6,0,1,336,0.75,0.0722006,4
2020-09-26-170101,170101,2,0,1,338,0.0,0.024947489,5
2020-09-27-170101,170101,0,0,0,338,0.0,0.0027965757,6
2020-09-28-170101,170101,2,0,1,340,0.25,0.022825785,0
2020-09-29-170101,170101,0,1,0,340,0.5,0.040567286,1
2020-09-30-170101,170101,7,1,0,347,0.25,0.038917586,2
2020-10-01-170101,170101,1,0,0,348,0.75,0.04360697,3
2020-10-02-170101,170101,2,0,0,350,0.75,0.028370045,4
2020-10-03-170101,170101,2,0,0,352,0.25,0.02501656,5
2020-10-04-170101,170101,0,0,4,352,0.25,0.026279734,6
2020-10-05-170101,170101,5,1,1,357,0.0,0.08622353,0
2020-10-06-170101,170101,1,2,0,358,0.25,0.028737113,1
2020-10-07-170101,170101,2,0,1,360,0.75,0.07957424,2
2020-10-08-170101,170101,2,0,2,362,0.75,0.065792285,3
2020-10-09-170101,170101,1,1,3,363,1.0,0.07778111,4
2020-10-10-170101,170101,1,0,0,364,1.0,0.06038455,5
2020-10-11-170101,170101,0,0,0,364,0.0,0.022126144,6
2020-10-12-170101,170101,1,0,3,365,1.0,0.04669581,0
2020-10-13-170101,170101,0,0,1,365,0.25,0.034081258,1
2020-10-14-170101,170101,0,0,1,365,0.5,0.08280655,2
2020-10-15-170101,170101,0,0,2,365,0.25,0.013262699,3
2020-10-16-170101,170101,0,0,0,365,0.0,0.011220282,4
2020-10-17-170101,170101,0,0,0,365,0.25,0.013066672,5
2020-10-18-170101,170101,4,0,3,369,0.25,0.04121553,6
2020-10-19-170101,170101,1,2,0,370,0.25,0.041514255,0
2020-10-20-170101,170101,0,0,2,370,0.25,0.01496885,1
2020-10-21-170101,170101,1,0,1,371,0.25,0.065134004,2
2020-10-22-170101,170101,2,0,1,373,0.75,0.056620963,3
2020-10-23-170101,170101,3,0,1,376,1.25,0.07850149,4
2020-10-24-170101,170101,0,0,0,376,0.0,0.018930282,5
2020-10-25-170101,170101,0,0,1,376,0.5,0.03051861,6
2020-10-26-170101,170101,3,0,0,379,0.75,0.083951846,0
2020-10-27-170101,170101,1,0,0,380,1.0,0.04614453,1
2020-10-28-170101,170101,1,0,1,381,0.25,0.104086734,2
2020-10-29-170101,170101,2,0,1,383,1.0,0.08017505,3
2020-10-30-170101,170101,0,0,0,383,2.25,0.11235194,4
2020-10-31-170101,170101,0,0,0,383,1.0,0.084798835,5
2020-11-01-170101,170101,3,1,0,386,1.5,0.09089882,6
2020-11-02-170101,170101,0,0,0,386,0.5,0.030687612,0
2020-11-03-170101,170101,2,0,0,388,1.0,0.052852158,1
2020-11-04-170101,170101,1,1,0,389,1.5,0.100788705,2
2020-11-05-170101,170101,1,0,0,390,2.25,0.10557681,3
2020-11-06-170101,170101,1,1,0,391,2.5,0.102256715,4
2020-11-07-170101,170101,0,0,0,391,1.25,0.05191255,5
2020-11-08-170101,170101,1,0,0,392,2.25,0.050434016,6
2020-11-09-170101,170101,0,0,0,392,1.25,0.04476978,0
2020-11-10-170101,170101,0,1,0,392,1.5,0.06458174,1
2020-11-11-170101,170101,1,0,0,393,1.75,0.11177394,2
2020-11-12-170101,170101,1,1,0,394,1.75,0.10927776,3
2020-11-13-170101,170101,0,2,0,394,4.0,0.1057329,4
2020-03-01-170102,170102,1,0,2,1,0.0,0.51445866,6
2020-03-02-170102,170102,0,0,4,1,0.2222222222222222,0.045248084,0
2020-03-03-170102,170102,0,0,2,1,0.0,0.0018693979,1
2020-03-04-170102,170102,0,0,3,1,0.0,0.0007601427,2
2020-03-05-170102,170102,1,0,16,2,0.1111111111111111,0.7658963,3
2020-03-06-170102,170102,0,0,4,2,0.1111111111111111,0.019683018,4
2020-03-07-170102,170102,0,0,3,2,0.1111111111111111,0.013276261,5
2020-03-08-170102,170102,0,0,6,2,0.0,7.414368e-05,6
2020-03-09-170102,170102,0,0,17,2,0.1111111111111111,0.015066466,0
2020-03-10-170102,170102,1,0,12,3,0.0,0.7371905,1
2020-03-11-170102,170102,0,0,16,3,0.2222222222222222,0.16305012,2
2020-03-12-170102,170102,0,0,17,3,0.7777777777777778,0.12056916,3
2020-03-13-170102,170102,1,0,10,4,1.1111111111111112,1.5244803,4
2020-03-14-170102,170102,0,0,15,4,0.7777777777777778,0.06783957,5
2020-03-15-170102,170102,2,0,11,6,1.1111111111111112,0.52493435,6
2020-03-16-170102,170102,4,0,15,10,3.333333333333333,2.7840617,0
2020-03-17-170102,170102,2,0,9,12,5.0,1.8360816,1
2020-03-18-170102,170102,3,0,4,15,6.111111111111112,3.3799703,2
2020-03-19-170102,170102,16,0,13,31,6.888888888888888,8.481356,3
2020-03-20-170102,170102,4,0,3,35,5.666666666666668,3.180618,4
2020-03-21-170102,170102,3,0,6,38,3.111111111111111,1.4407214,5
2020-03-22-170102,170102,6,0,2,44,5.5555555555555545,2.457018,6
2020-03-23-170102,170102,17,0,8,61,11.222222222222221,9.883191,0
2020-03-24-170102,170102,12,0,3,73,6.777777777777778,6.407758,1
2020-03-25-170102,170102,16,0,5,89,8.888888888888891,9.462161,2
2020-03-26-170102,170102,17,0,7,106,8.666666666666666,9.632317,3
2020-03-27-170102,170102,10,0,11,116,8.888888888888891,6.826004,4
2020-03-28-170102,170102,15,0,8,131,3.555555555555556,6.2769623,5
2020-03-29-170102,170102,11,0,3,142,2.888888888888889,4.0164866,6
2020-03-30-170102,170102,15,0,8,157,6.888888888888888,7.197794,0
2020-03-31-170102,170102,9,0,12,166,5.111111111111111,5.201587,1
2020-04-01-170102,170102,4,0,8,170,5.666666666666668,3.1425202,2
2020-04-02-170102,170102,13,0,5,183,9.444444444444443,7.3939085,3
2020-04-03-170102,170102,3,0,6,186,4.666666666666667,2.5708337,4
2020-04-04-170102,170102,6,0,8,192,4.888888888888889,2.635681,5
2020-04-05-170102,170102,2,0,2,194,1.7777777777777777,0.83318347,6
2020-04-06-170102,170102,8,0,13,202,11.222222222222221,5.5726852,0
2020-04-07-170102,170102,3,0,4,205,3.4444444444444446,2.7561944,1
2020-04-08-170102,170102,5,0,12,210,3.2222222222222223,2.9211352,2
2020-04-09-170102,170102,7,0,4,217,2.2222222222222223,2.8819602,3
2020-04-10-170102,170102,11,0,6,228,4.111111111111111,4.886236,4
2020-04-11-170102,170102,8,0,2,236,1.3333333333333333,2.5396771,5
2020-04-12-170102,170102,3,0,2,239,3.333333333333333,1.6004652,6
2020-04-13-170102,170102,8,0,7,247,6.333333333333332,4.636765,0
2020-04-14-170102,170102,12,1,1,259,5.333333333333333,7.2561593,1
2020-04-15-170102,170102,8,0,9,267,6.0,5.832908,2
2020-04-16-170102,170102,5,0,3,272,2.333333333333333,2.8237896,3
2020-04-17-170102,170102,6,0,1,278,2.2222222222222223,3.3942904,4
2020-04-18-170102,170102,8,0,2,286,4.666666666666667,3.5093288,5
2020-04-19-170102,170102,2,0,0,288,3.4444444444444446,1.0215569,6
2020-04-20-170102,170102,13,0,6,301,5.666666666666668,7.231269,0
2020-04-21-170102,170102,4,0,3,305,2.1111111111111107,2.4885695,1
2020-04-22-170102,170102,12,0,5,317,4.333333333333333,6.9155517,2
2020-04-23-170102,170102,4,0,5,321,0.6666666666666666,1.511282,3
2020-04-24-170102,170102,6,0,6,327,2.7777777777777777,3.0375953,4
2020-04-25-170102,170102,2,0,1,329,0.6666666666666666,1.031648,5
2020-04-26-170102,170102,2,0,2,331,0.3333333333333333,0.7005485,6
2020-04-27-170102,170102,7,0,3,338,2.4444444444444446,3.7357965,0
2020-04-28-170102,170102,1,0,5,339,2.2222222222222223,1.254791,1
2020-04-29-170102,170102,9,0,3,348,2.888888888888889,4.706892,2
2020-04-30-170102,170102,3,0,3,351,3.2222222222222223,2.0624037,3
2020-05-01-170102,170102,1,0,1,352,0.5555555555555556,0.37945166,4
2020-05-02-170102,170102,2,0,2,354,1.3333333333333333,1.5760313,5
2020-05-03-170102,170102,0,0,0,354,0.4444444444444444,0.2702182,6
2020-05-04-170102,170102,6,0,6,360,1.7777777777777777,3.762359,0
2020-05-05-170102,170102,3,0,2,363,2.2222222222222223,2.202114,1
2020-05-06-170102,170102,5,0,2,368,1.7777777777777777,3.1722221,2
2020-05-07-170102,170102,5,0,3,373,2.4444444444444446,3.3397498,3
2020-05-08-170102,170102,6,0,1,379,2.2222222222222223,5.0269923,4
2020-05-09-170102,170102,1,0,2,380,1.0,0.61032337,5
2020-05-10-170102,170102,2,0,1,382,0.7777777777777778,0.9151011,6
2020-05-11-170102,170102,3,3,0,385,3.333333333333333,3.2742407,0
2020-05-12-170102,170102,5,0,2,390,2.333333333333333,2.508263,1
2020-05-13-170102,170102,3,0,7,393,1.8888888888888888,1.8959699,2
2020-05-14-170102,170102,3,0,2,396,2.7777777777777777,2.2408705,3
2020-05-15-170102,170102,1,0,0,397,2.4444444444444446,1.0796386,4
2020-05-16-170102,170102,2,0,0,399,1.3333333333333333,1.1240826,5
2020-05-17-170102,170102,0,0,0,399,1.1111111111111112,0.1308671,6
2020-05-18-170102,170102,6,0,0,405,4.111111111111111,4.8462358,0
2020-05-19-170102,170102,2,0,6,407,2.333333333333333,1.7006854,1
2020-05-20-170102,170102,2,0,1,409,2.2222222222222223,1.5187644,2
2020-05-21-170102,170102,3,0,2,412,2.555555555555556,2.487951,3
2020-05-22-170102,170102,1,0,2,413,2.6666666666666665,1.4013723,4
2020-05-23-170102,170102,2,0,1,415,1.3333333333333333,1.6174809,5
2020-05-24-170102,170102,1,0,0,416,1.0,0.5755351,6
2020-05-25-170102,170102,0,0,1,416,3.0,1.1416752,0
2020-05-26-170102,170102,2,0,0,418,3.111111111111111,1.9013463,1
2020-05-27-170102,170102,7,0,2,425,2.4444444444444446,4.952852,2
2020-05-28-170102,170102,2,2,2,427,1.7777777777777777,2.1638222,3
2020-05-29-170102,170102,0,1,1,427,1.1111111111111112,0.50526863,4
2020-05-30-170102,170102,0,0,1,427,0.2222222222222222,0.020943938,5
2020-05-31-170102,170102,0,0,0,427,0.1111111111111111,0.010322882,6
2020-06-01-170102,170102,0,0,2,427,0.8888888888888888,0.32940426,0
2020-06-02-170102,170102,6,0,3,433,1.5555555555555556,4.829044,1
2020-06-03-170102,170102,1,0,0,434,1.2222222222222223,1.1861277,2
2020-06-04-170102,170102,2,0,0,436,0.5555555555555556,2.1434875,3
2020-06-05-170102,170102,2,0,5,438,0.5555555555555556,1.4792926,4
2020-06-06-170102,170102,1,0,1,439,0.1111111111111111,0.59070873,5
2020-06-07-170102,170102,0,0,2,439,0.1111111111111111,0.011072426,6
2020-06-08-170102,170102,1,1,0,440,1.2222222222222223,1.0714049,0
2020-06-09-170102,170102,0,0,0,440,1.2222222222222223,0.62711304,1
2020-06-10-170102,170102,2,0,3,442,0.5555555555555556,1.6315703,2
2020-06-11-170102,170102,2,0,0,444,0.5555555555555556,1.4078299,3
2020-06-12-170102,170102,1,0,2,445,1.2222222222222223,1.0987132,4
2020-06-13-170102,170102,1,0,1,446,0.1111111111111111,0.5606727,5
2020-06-14-170102,170102,0,0,2,446,0.3333333333333333,0.026610715,6
2020-06-15-170102,170102,2,2,0,448,0.7777777777777778,1.561352,0
2020-06-16-170102,170102,3,0,1,451,0.8888888888888888,1.6703491,1
2020-06-17-170102,170102,0,0,2,451,1.1111111111111112,0.41104764,2
2020-06-18-170102,170102,0,0,0,451,0.5555555555555556,0.36438733,3
2020-06-19-170102,170102,5,0,0,456,1.2222222222222223,1.3778654,4
2020-06-20-170102,170102,1,0,1,457,0.3333333333333333,0.6636116,5
2020-06-21-170102,170102,2,0,0,459,0.1111111111111111,1.1010855,6
2020-06-22-170102,170102,0,0,1,459,0.7777777777777778,0.4253225,0
2020-06-23-170102,170102,0,0,1,459,0.8888888888888888,0.7462659,1
2020-06-24-170102,170102,3,1,0,462,0.4444444444444444,2.494557,2
2020-06-25-170102,170102,0,1,2,462,1.0,0.37783277,3
2020-06-26-170102,170102,2,0,0,464,0.6666666666666666,1.8162506,4
2020-06-27-170102,170102,1,0,0,465,0.3333333333333333,1.0660603,5
2020-06-28-170102,170102,2,0,0,467,0.2222222222222222,1.5147504,6
2020-06-29-170102,170102,0,0,0,467,0.1111111111111111,0.1051789,0
2020-06-30-170102,170102,1,0,0,468,0.1111111111111111,0.7944256,1
2020-07-01-170102,170102,2,0,0,470,0.2222222222222222,1.5572062,2
2020-07-02-170102,170102,0,0,0,470,0.7777777777777778,0.3958873,3
2020-07-03-170102,170102,0,0,1,470,0.3333333333333333,0.07749788,4
2020-07-04-170102,170102,1,0,0,471,0.3333333333333333,0.7408915,5
2020-07-05-170102,170102,0,0,0,471,0.1111111111111111,0.10318999,6
2020-07-06-170102,170102,1,0,0,472,0.4444444444444444,0.8979149,0
2020-07-07-170102,170102,1,0,0,473,0.1111111111111111,0.64853895,1
2020-07-08-170102,170102,0,0,0,473,0.1111111111111111,0.2094577,2
2020-07-09-170102,170102,2,0,1,475,0.6666666666666666,1.7865181,3
2020-07-10-170102,170102,0,0,0,475,0.5555555555555556,0.48487833,4
2020-07-11-170102,170102,0,0,0,475,0.4444444444444444,0.26793212,5
2020-07-12-170102,170102,0,0,0,475,0.1111111111111111,0.013329375,6
2020-07-13-170102,170102,0,0,0,475,0.4444444444444444,0.41884953,0
2020-07-14-170102,170102,0,0,0,475,0.4444444444444444,0.20514661,1
2020-07-15-170102,170102,0,0,2,475,1.0,0.22161262,2
2020-07-16-170102,170102,0,0,1,475,1.0,0.24715146,3
2020-07-17-170102,170102,1,1,1,476,0.4444444444444444,1.1513822,4
2020-07-18-170102,170102,0,0,1,476,0.4444444444444444,0.08339895,5
2020-07-19-170102,170102,0,0,1,476,0.6666666666666666,0.31939572,6
2020-07-20-170102,170102,0,0,3,476,0.7777777777777778,0.27572197,0
2020-07-21-170102,170102,0,0,0,476,0.5555555555555556,0.19035132,1
2020-07-22-170102,170102,0,0,0,476,0.7777777777777778,0.14098206,2
2020-07-23-170102,170102,1,0,1,477,0.7777777777777778,0.98995054,3
2020-07-24-170102,170102,0,0,1,477,0.8888888888888888,0.34627748,4
2020-07-25-170102,170102,0,0,0,477,0.1111111111111111,0.025524952,5
2020-07-26-170102,170102,0,0,0,477,0.2222222222222222,0.15803282,6
2020-07-27-170102,170102,0,1,0,477,0.5555555555555556,0.26752737,0
2020-07-28-170102,170102,0,0,3,477,1.1111111111111112,0.5487736,1
2020-07-29-170102,170102,2,0,3,479,0.4444444444444444,1.5030237,2
2020-07-30-170102,170102,1,0,1,480,1.0,1.0560721,3
2020-07-31-170102,170102,1,0,2,481,1.0,1.6014866,4
2020-08-01-170102,170102,1,0,8,482,0.1111111111111111,0.71029824,5
2020-08-02-170102,170102,1,0,0,483,0.3333333333333333,0.70210963,6
2020-08-03-170102,170102,3,0,3,486,0.6666666666666666,2.6745024,0
2020-08-04-170102,170102,0,0,9,486,0.4444444444444444,0.22342595,1
2020-08-05-170102,170102,0,0,8,486,1.4444444444444444,0.8156253,2
2020-08-06-170102,170102,1,0,5,487,1.0,1.1816452,3
2020-08-07-170102,170102,1,0,19,488,0.7777777777777778,0.9642474,4
2020-08-08-170102,170102,0,0,3,488,0.1111111111111111,0.08195166,5
2020-08-09-170102,170102,0,0,4,488,0.7777777777777778,0.32568917,6
2020-08-10-170102,170102,0,0,6,488,0.8888888888888888,0.8294538,0
2020-08-11-170102,170102,3,0,8,491,0.8888888888888888,2.8255327,1
2020-08-12-170102,170102,3,0,6,494,1.0,3.1115048,2
2020-08-13-170102,170102,1,0,2,495,0.8888888888888888,1.1226922,3
2020-08-14-170102,170102,2,0,9,497,1.1111111111111112,2.5414515,4
2020-08-15-170102,170102,8,0,4,505,0.5555555555555556,5.3462644,5
2020-08-16-170102,170102,0,0,1,505,0.3333333333333333,0.25636005,6
2020-08-17-170102,170102,3,0,2,508,2.1111111111111107,2.9105618,0
2020-08-18-170102,170102,9,0,6,517,1.3333333333333333,7.492206,1
2020-08-19-170102,170102,8,0,3,525,2.6666666666666665,7.9817877,2
2020-08-20-170102,170102,5,0,3,530,1.5555555555555556,2.2890446,3
2020-08-21-170102,170102,19,0,1,549,1.6666666666666667,15.9170065,4
2020-08-22-170102,170102,3,0,3,552,2.2222222222222223,3.142623,5
2020-08-23-170102,170102,4,0,0,556,1.4444444444444444,3.1131542,6
2020-08-24-170102,170102,6,0,4,562,2.4444444444444446,7.0833044,0
2020-08-25-170102,170102,8,1,2,570,3.7777777777777777,8.284138,1
2020-08-26-170102,170102,6,0,2,576,1.5555555555555556,3.797138,2
2020-08-27-170102,170102,2,0,1,578,2.2222222222222223,2.5330558,3
2020-08-28-170102,170102,9,0,8,587,1.5555555555555556,6.8513365,4
2020-08-29-170102,170102,4,0,0,591,1.3333333333333333,3.5777345,5
2020-08-30-170102,170102,1,0,1,592,0.7777777777777778,0.49747676,6
2020-08-31-170102,170102,2,0,3,594,2.333333333333333,3.47153,0
2020-09-01-170102,170102,6,0,1,600,1.7777777777777777,4.3325667,1
2020-09-02-170102,170102,3,0,5,603,4.666666666666667,4.73108,2
2020-09-03-170102,170102,3,0,5,606,2.333333333333333,3.2964067,3
2020-09-04-170102,170102,1,0,4,607,3.4444444444444446,3.594151,4
2020-09-05-170102,170102,3,0,2,610,2.2222222222222223,4.4828315,5
2020-09-06-170102,170102,0,0,3,610,1.8888888888888888,1.4066365,6
2020-09-07-170102,170102,4,0,1,614,4.0,4.69189,0
2020-09-08-170102,170102,2,0,5,616,4.222222222222221,3.7714577,1
2020-09-09-170102,170102,2,0,6,618,2.333333333333333,3.166063,2
2020-09-10-170102,170102,1,0,5,619,2.1111111111111107,2.1303153,3
2020-09-11-170102,170102,8,0,9,627,5.0,8.012981,4
2020-09-12-170102,170102,0,0,6,627,2.333333333333333,0.8077099,5
2020-09-13-170102,170102,1,0,0,628,1.1111111111111112,1.3002076,6
2020-09-14-170102,170102,3,1,3,631,5.5555555555555545,4.6301637,0
2020-09-15-170102,170102,1,0,3,632,3.888888888888889,1.9791815,1
2020-09-16-170102,170102,5,0,2,637,3.555555555555556,4.867494,2
2020-09-17-170102,170102,5,0,12,642,3.2222222222222223,4.9534945,3
2020-09-18-170102,170102,4,0,9,646,4.4444444444444455,4.5917687,4
2020-09-19-170102,170102,2,0,5,648,4.0,2.792221,5
2020-09-20-170102,170102,3,2,7,651,2.7777777777777777,1.7091328,6
2020-09-21-170102,170102,1,0,8,652,4.0,2.153238,0
2020-09-22-170102,170102,5,1,9,657,2.555555555555556,5.7196655,1
2020-09-23-170102,170102,6,0,3,663,6.222222222222222,5.9181156,2
2020-09-24-170102,170102,5,1,1,668,5.777777777777778,7.9198933,3
2020-09-25-170102,170102,9,0,4,677,6.0,4.9442964,4
2020-09-26-170102,170102,6,0,1,683,3.4444444444444446,5.301855,5
2020-09-27-170102,170102,0,0,1,683,0.7777777777777778,0.15778323,6
2020-09-28-170102,170102,3,0,0,686,3.0,2.977216,0
2020-09-29-170102,170102,3,0,2,689,1.7777777777777777,2.311948,1
2020-09-30-170102,170102,2,1,2,691,3.7777777777777777,2.524257,2
2020-10-01-170102,170102,12,0,0,703,2.7777777777777777,8.32571,3
2020-10-02-170102,170102,9,0,9,712,3.333333333333333,7.691458,4
2020-10-03-170102,170102,5,1,11,717,2.2222222222222223,3.808494,5
2020-10-04-170102,170102,7,0,2,724,0.7777777777777778,3.9657845,6
2020-10-05-170102,170102,8,1,6,732,1.6666666666666667,6.002553,0
2020-10-06-170102,170102,9,0,13,741,4.888888888888889,7.545001,1
2020-10-07-170102,170102,3,0,4,744,2.4444444444444446,3.329553,2
2020-10-08-170102,170102,1,0,9,745,2.6666666666666665,2.7238266,3
2020-10-09-170102,170102,4,0,7,749,4.0,5.784936,4
2020-10-10-170102,170102,1,0,22,750,2.6666666666666665,2.143274,5
2020-10-11-170102,170102,1,0,9,751,1.1111111111111112,0.8931643,6
2020-10-12-170102,170102,0,0,7,751,2.0,1.1862936,0
2020-10-13-170102,170102,2,0,17,753,3.0,2.8326242,1
2020-10-14-170102,170102,2,0,27,755,2.4444444444444446,3.464856,2
2020-10-15-170102,170102,0,0,18,755,4.0,1.6928695,3
2020-10-16-170102,170102,9,0,24,764,3.7777777777777777,1.2765468,4
2020-10-17-170102,170102,11,0,11,775,2.4444444444444446,7.4108067,5
2020-10-18-170102,170102,2,0,12,777,1.8888888888888888,1.6483829,6
2020-10-19-170102,170102,6,0,4,783,2.333333333333333,4.829276,0
2020-10-20-170102,170102,13,0,9,796,3.111111111111111,9.331392,1
2020-10-21-170102,170102,4,0,6,800,1.5555555555555556,3.9189453,2
2020-10-22-170102,170102,9,0,8,809,4.222222222222221,6.9197993,3
2020-10-23-170102,170102,7,0,25,816,3.2222222222222223,7.8824754,4
2020-10-24-170102,170102,22,0,9,838,2.7777777777777777,13.589905,5
2020-10-25-170102,170102,9,0,1,847,2.0,5.281187,6
2020-10-26-170102,170102,7,1,5,854,4.333333333333333,7.1660614,0
2020-10-27-170102,170102,17,0,10,871,3.7777777777777777,13.261203,1
2020-10-28-170102,170102,27,1,6,898,3.4444444444444446,18.394876,2
2020-10-29-170102,170102,18,0,6,916,5.777777777777778,17.138725,3
2020-10-30-170102,170102,24,0,12,940,4.666666666666667,16.758673,4
2020-10-31-170102,170102,11,1,0,951,5.0,8.78271,5
2020-11-01-170102,170102,12,3,0,963,2.6666666666666665,7.6210866,6
2020-11-02-170102,170102,4,0,0,967,2.7777777777777777,3.1163394,0
2020-11-03-170102,170102,9,0,0,976,4.333333333333333,8.236381,1
2020-11-04-170102,170102,6,0,0,982,4.0,5.6913843,2
2020-11-05-170102,170102,8,2,0,990,6.4444444444444455,9.164964,3
2020-11-06-170102,170102,25,2,0,1015,4.666666666666667,10.832566,4
2020-11-07-170102,170102,9,0,0,1024,2.1111111111111107,6.246614,5
2020-11-08-170102,170102,1,2,0,1025,1.1111111111111112,1.2887602,6
2020-11-09-170102,170102,5,1,0,1030,3.0,4.3506575,0
2020-11-10-170102,170102,10,0,0,1040,2.7777777777777777,7.168348,1
2020-11-11-170102,170102,6,0,0,1046,2.6666666666666665,5.600951,2
2020-11-12-170102,170102,6,0,0,1052,3.4444444444444446,6.7537966,3
2020-11-13-170102,170102,12,0,0,1064,4.4444444444444455,9.290023,4
2020-03-01-170103,170103,0,0,2,0,0.0,0.018359449,6
2020-03-02-170103,170103,0,0,17,0,0.0,0.0014784142,0
2020-03-03-170103,170103,0,0,9,0,0.0,0.017404623,1
2020-03-04-170103,170103,0,0,33,0,0.0,0.0012338642,2
2020-03-05-170103,170103,0,0,26,0,0.0,0.03028293,3
2020-03-06-170103,170103,1,0,48,1,0.0,0.0051078293,4
2020-03-07-170103,170103,0,1,15,1,0.0,0.006360158,5
2020-03-08-170103,170103,0,0,16,1,0.0,0.0002033286,6
2020-03-09-170103,170103,0,0,54,1,0.6666666666666666,0.005145137,0
2020-03-10-170103,170103,0,0,52,1,0.0,0.038590863,1
2020-03-11-170103,170103,3,1,33,4,1.3333333333333333,0.27220592,2
2020-03-12-170103,170103,0,1,34,4,0.6666666666666666,0.07867054,3
2020-03-13-170103,170103,1,0,33,5,3.333333333333333,0.48398998,4
2020-03-14-170103,170103,1,0,13,6,1.0,0.030365217,5
2020-03-15-170103,170103,2,0,15,8,1.0,0.039677385,6
2020-03-16-170103,170103,17,0,23,25,8.666666666666666,0.5749908,0
2020-03-17-170103,170103,9,1,28,34,7.333333333333332,0.24201222,1
2020-03-18-170103,170103,33,0,23,67,21.0,1.2890399,2
2020-03-19-170103,170103,26,0,20,93,17.0,0.91102034,3
2020-03-20-170103,170103,48,1,19,141,20.0,0.6555153,4
2020-03-21-170103,170103,15,0,6,156,10.0,0.15216358,5
2020-03-22-170103,170103,16,1,5,172,11.333333333333336,0.14935367,6
2020-03-23-170103,170103,54,0,19,226,28.0,1.9589641,0
2020-03-24-170103,170103,52,0,9,278,21.0,0.77507126,1
2020-03-25-170103,170103,33,0,17,311,20.666666666666668,1.0976405,2
2020-03-26-170103,170103,34,0,19,345,21.0,0.9826541,3
2020-03-27-170103,170103,33,0,8,378,24.0,0.74072796,4
2020-03-28-170103,170103,13,0,4,391,7.666666666666668,0.3029208,5
2020-03-29-170103,170103,15,0,2,406,5.666666666666668,0.21205714,6
2020-03-30-170103,170103,23,0,6,429,16.333333333333332,0.9059778,0
2020-03-31-170103,170103,28,0,13,457,13.666666666666664,1.1113809,1
2020-04-01-170103,170103,23,0,10,480,14.0,0.67752844,2
2020-04-02-170103,170103,20,0,7,500,12.666666666666664,1.3050817,3
2020-04-03-170103,170103,19,0,14,519,14.333333333333336,0.48740953,4
2020-04-04-170103,170103,6,0,1,525,4.333333333333333,0.124341585,5
2020-04-05-170103,170103,5,0,2,530,3.6666666666666665,0.12689246,6
2020-04-06-170103,170103,19,0,15,549,14.0,1.0706725,0
2020-04-07-170103,170103,9,0,9,558,11.333333333333336,0.7215157,1
2020-04-08-170103,170103,17,0,10,575,9.0,0.3109658,2
2020-04-09-170103,170103,19,0,3,594,7.666666666666668,0.35877928,3
2020-04-10-170103,170103,8,0,10,602,8.666666666666666,0.53014445,4
2020-04-11-170103,170103,4,0,0,606,3.6666666666666665,0.055858135,5
2020-04-12-170103,170103,2,0,0,608,3.6666666666666665,0.48348612,6
2020-04-13-170103,170103,6,0,8,614,6.333333333333332,0.4919097,0
2020-04-14-170103,170103,13,0,2,627,12.333333333333336,1.9974501,1
2020-04-15-170103,170103,10,0,7,637,6.333333333333332,0.61539966,2
2020-04-16-170103,170103,7,0,5,644,8.666666666666666,0.77218425,3
2020-04-17-170103,170103,14,0,2,658,7.333333333333332,0.3448539,4
2020-04-18-170103,170103,1,0,1,659,0.3333333333333333,0.15702717,5
2020-04-19-170103,170103,2,0,0,661,2.0,0.2834628,6
2020-04-20-170103,170103,15,0,15,676,8.666666666666666,0.95399404,0
2020-04-21-170103,170103,9,0,6,685,5.333333333333333,0.83497375,1
2020-04-22-170103,170103,10,0,7,695,5.666666666666668,0.33810678,2
2020-04-23-170103,170103,3,0,4,698,2.0,0.11311713,3
2020-04-24-170103,170103,10,0,5,708,3.6666666666666665,0.17185868,4
2020-04-25-170103,170103,0,0,2,708,0.6666666666666666,0.03264846,5
2020-04-26-170103,170103,0,0,1,708,1.6666666666666667,0.013203866,6
2020-04-27-170103,170103,8,0,9,716,4.333333333333333,0.2401504,0
2020-04-28-170103,170103,2,1,5,718,2.6666666666666665,0.2176617,1
2020-04-29-170103,170103,7,0,5,725,5.0,0.56510496,2
2020-04-30-170103,170103,5,0,6,730,3.0,0.28886023,3
2020-05-01-170103,170103,2,0,3,732,0.3333333333333333,0.009952544,4
2020-05-02-170103,170103,1,0,1,733,3.0,0.4635053,5
2020-05-03-170103,170103,0,0,1,733,1.0,0.0843639,6
2020-05-04-170103,170103,15,0,23,748,4.333333333333333,0.5216021,0
2020-05-05-170103,170103,6,0,2,754,4.333333333333333,0.2199787,1
2020-05-06-170103,170103,7,0,2,761,6.0,0.29139295,2
2020-05-07-170103,170103,4,0,11,765,3.333333333333333,0.44090557,3
2020-05-08-170103,170103,5,0,6,770,7.333333333333332,0.5456098,4
2020-05-09-170103,170103,2,0,0,772,0.6666666666666666,0.10823404,5
2020-05-10-170103,170103,1,0,2,773,1.3333333333333333,0.13198508,6
2020-05-11-170103,170103,9,0,9,782,10.0,0.87788075,0
2020-05-12-170103,170103,5,0,3,787,4.666666666666667,0.42743748,1
2020-05-13-170103,170103,5,0,3,792,2.6666666666666665,0.11583655,2
2020-05-14-170103,170103,6,0,11,798,2.333333333333333,0.3136947,3
2020-05-15-170103,170103,3,0,2,801,5.0,0.17670052,4
2020-05-16-170103,170103,1,0,0,802,1.0,0.036083777,5
2020-05-17-170103,170103,1,0,0,803,0.6666666666666666,0.07709825,6
2020-05-18-170103,170103,23,0,3,826,19.33333333333333,0.7861519,0
2020-05-19-170103,170103,2,0,7,828,2.6666666666666665,0.22467287,1
2020-05-20-170103,170103,2,0,4,830,2.0,0.16301215,2
2020-05-21-170103,170103,11,0,7,841,2.0,0.29582348,3
2020-05-22-170103,170103,6,0,3,847,2.0,0.26494718,4
2020-05-23-170103,170103,0,0,0,847,0.6666666666666666,0.13218583,5
2020-05-24-170103,170103,2,0,0,849,0.0,0.019297237,6
2020-05-25-170103,170103,9,0,3,858,2.0,0.14672714,0
2020-05-26-170103,170103,3,0,4,861,2.333333333333333,0.4214599,1
2020-05-27-170103,170103,3,0,1,864,1.3333333333333333,0.17884791,2
2020-05-28-170103,170103,11,0,4,875,3.0,0.58280635,3
2020-05-29-170103,170103,2,1,2,877,2.0,0.2186379,4
2020-05-30-170103,170103,0,0,0,877,0.0,0.013012722,5
2020-05-31-170103,170103,0,0,0,877,0.0,0.028896654,6
2020-06-01-170103,170103,3,1,2,880,2.0,0.033903785,0
2020-06-02-170103,170103,7,0,5,887,4.0,0.88600916,1
2020-06-03-170103,170103,4,0,2,891,1.6666666666666667,0.22970755,2
2020-06-04-170103,170103,7,0,3,898,1.3333333333333333,0.23689336,3
2020-06-05-170103,170103,3,0,0,901,1.6666666666666667,0.10576443,4
2020-06-06-170103,170103,0,0,0,901,0.0,0.020012671,5
2020-06-07-170103,170103,0,0,0,901,0.0,0.00066088635,6
2020-06-08-170103,170103,3,0,5,904,1.0,0.24277462,0
2020-06-09-170103,170103,4,0,2,908,1.0,0.22663295,1
2020-06-10-170103,170103,1,0,3,909,0.6666666666666666,0.05798513,2
2020-06-11-170103,170103,4,0,2,913,0.0,0.048848517,3
2020-06-12-170103,170103,2,0,2,915,1.6666666666666667,0.3852057,4
2020-06-13-170103,170103,0,0,0,915,0.3333333333333333,0.021745205,5
2020-06-14-170103,170103,0,2,0,915,0.0,0.0148725575,6
2020-06-15-170103,170103,2,0,1,917,1.3333333333333333,0.21983682,0
2020-06-16-170103,170103,5,0,1,922,1.3333333333333333,0.21892448,1
2020-06-17-170103,170103,2,0,4,924,1.3333333333333333,0.21930675,2
2020-06-18-170103,170103,3,0,1,927,0.0,0.061228633,3
2020-06-19-170103,170103,0,0,0,927,0.6666666666666666,0.19925123,4
2020-06-20-170103,170103,0,0,0,927,0.0,0.0517776,5
2020-06-21-170103,170103,0,0,0,927,0.0,0.0273839,6
2020-06-22-170103,170103,5,0,1,932,1.3333333333333333,0.1901977,0
2020-06-23-170103,170103,2,0,0,934,0.6666666666666666,0.2536312,1
2020-06-24-170103,170103,3,0,1,937,0.3333333333333333,0.13773714,2
2020-06-25-170103,170103,2,0,0,939,0.6666666666666666,0.07099514,3
2020-06-26-170103,170103,2,0,2,941,0.6666666666666666,0.10609253,4
2020-06-27-170103,170103,0,0,0,941,0.0,0.029122837,5
2020-06-28-170103,170103,0,0,0,941,1.0,0.16691084,6
2020-06-29-170103,170103,1,0,1,942,0.3333333333333333,0.12365679,0
2020-06-30-170103,170103,1,0,0,943,1.6666666666666667,0.04826929,1
2020-07-01-170103,170103,4,0,1,947,1.0,0.07015097,2
2020-07-02-170103,170103,1,0,0,948,0.6666666666666666,0.26161924,3
2020-07-03-170103,170103,0,0,2,948,0.6666666666666666,0.040054124,4
2020-07-04-170103,170103,0,0,0,948,0.0,0.024659226,5
2020-07-05-170103,170103,0,0,0,948,0.3333333333333333,0.007054966,6
2020-07-06-170103,170103,1,0,0,949,0.6666666666666666,0.084603034,0
2020-07-07-170103,170103,0,0,0,949,0.3333333333333333,0.12316023,1
2020-07-08-170103,170103,1,0,0,950,0.3333333333333333,0.041396417,2
2020-07-09-170103,170103,0,0,2,950,0.0,0.069833964,3
2020-07-10-170103,170103,2,0,0,952,1.0,0.4869045,4
2020-07-11-170103,170103,0,0,0,952,0.3333333333333333,0.08020392,5
2020-07-12-170103,170103,0,0,0,952,0.0,0.024975713,6
2020-07-13-170103,170103,1,0,3,953,0.3333333333333333,0.29425228,0
2020-07-14-170103,170103,0,0,0,953,0.0,0.13604395,1
2020-07-15-170103,170103,1,0,0,954,0.0,0.13202222,2
2020-07-16-170103,170103,0,0,2,954,0.0,0.05026275,3
2020-07-17-170103,170103,2,0,1,956,0.3333333333333333,0.37972772,4
2020-07-18-170103,170103,0,0,0,956,0.0,0.056647222,5
2020-07-19-170103,170103,0,0,0,956,0.0,0.024610285,6
2020-07-20-170103,170103,0,0,0,956,0.0,0.093228355,0
2020-07-21-170103,170103,0,0,1,956,0.0,0.02322795,1
2020-07-22-170103,170103,0,1,0,956,0.6666666666666666,0.07178518,2
2020-07-23-170103,170103,2,0,1,958,0.6666666666666666,0.14555275,3
2020-07-24-170103,170103,0,0,1,958,0.3333333333333333,0.033127032,4
2020-07-25-170103,170103,0,0,0,958,0.0,0.0042811697,5
2020-07-26-170103,170103,0,0,4,958,0.0,0.006093542,6
2020-07-27-170103,170103,3,0,5,961,0.0,0.1053756,0
2020-07-28-170103,170103,0,0,0,961,0.3333333333333333,0.1357392,1
2020-07-29-170103,170103,0,0,1,961,0.0,0.11044812,2
2020-07-30-170103,170103,2,0,1,963,0.0,0.06537866,3
2020-07-31-170103,170103,1,0,1,964,0.6666666666666666,0.5226249,4
2020-08-01-170103,170103,0,0,0,964,0.0,0.021881886,5
2020-08-02-170103,170103,0,0,0,964,0.0,0.054924283,6
2020-08-03-170103,170103,0,0,2,964,0.0,0.14010617,0
2020-08-04-170103,170103,1,0,0,965,0.0,0.11388522,1
2020-08-05-170103,170103,0,0,3,965,0.3333333333333333,0.45328984,2
2020-08-06-170103,170103,1,0,6,966,1.0,0.6535,3
2020-08-07-170103,170103,1,0,0,967,0.3333333333333333,0.49966347,4
2020-08-08-170103,170103,0,0,0,967,0.3333333333333333,0.2209209,5
2020-08-09-170103,170103,4,0,1,971,0.6666666666666666,0.17668712,6
2020-08-10-170103,170103,5,0,1,976,1.0,0.56766665,0
2020-08-11-170103,170103,0,0,2,976,0.3333333333333333,0.6403431,1
2020-08-12-170103,170103,1,0,2,977,2.0,1.1864966,2
2020-08-13-170103,170103,1,0,1,978,1.0,0.43310115,3
2020-08-14-170103,170103,1,0,2,979,1.6666666666666667,0.7964093,4
2020-08-15-170103,170103,0,0,0,979,0.6666666666666666,0.34160453,5
2020-08-16-170103,170103,0,0,4,979,0.6666666666666666,0.19234514,6
2020-08-17-170103,170103,2,0,3,981,0.3333333333333333,0.41752505,0
2020-08-18-170103,170103,0,0,0,981,0.3333333333333333,0.305033,1
2020-08-19-170103,170103,3,0,4,984,3.0,0.83120036,2
2020-08-20-170103,170103,6,0,6,990,3.6666666666666665,0.48869857,3
2020-08-21-170103,170103,0,0,6,990,0.0,0.82971674,4
2020-08-22-170103,170103,0,0,2,990,0.3333333333333333,0.32693622,5
2020-08-23-170103,170103,1,0,1,991,0.6666666666666666,0.28079787,6
2020-08-24-170103,170103,1,0,10,992,2.0,0.59165996,0
2020-08-25-170103,170103,2,0,7,994,1.3333333333333333,0.4791844,1
2020-08-26-170103,170103,2,0,2,996,1.0,0.4796348,2
2020-08-27-170103,170103,1,0,0,997,4.333333333333333,0.2510992,3
2020-08-28-170103,170103,2,0,7,999,1.3333333333333333,0.35845554,4
2020-08-29-170103,170103,0,1,0,999,0.6666666666666666,0.39313528,5
2020-08-30-170103,170103,4,0,14,1003,1.0,0.45441377,6
2020-08-31-170103,170103,3,0,1,1006,0.3333333333333333,0.2841452,0
2020-09-01-170103,170103,0,0,0,1006,0.6666666666666666,0.2459474,1
2020-09-02-170103,170103,4,0,9,1010,2.6666666666666665,0.20034495,2
2020-09-03-170103,170103,6,0,4,1016,3.0,0.56928927,3
2020-09-04-170103,170103,6,0,8,1022,2.6666666666666665,0.8936789,4
2020-09-05-170103,170103,2,0,4,1024,1.3333333333333333,0.19680496,5
2020-09-06-170103,170103,1,0,8,1025,1.6666666666666667,0.53790146,6
2020-09-07-170103,170103,10,0,9,1035,4.0,0.3822136,0
2020-09-08-170103,170103,7,0,1,1042,4.666666666666667,0.83946174,1
2020-09-09-170103,170103,2,0,4,1044,1.6666666666666667,0.6602912,2
2020-09-10-170103,170103,0,0,21,1044,2.6666666666666665,0.51383734,3
2020-09-11-170103,170103,7,0,8,1051,2.0,1.1953529,4
2020-09-12-170103,170103,0,0,3,1051,1.6666666666666667,0.08839996,5
2020-09-13-170103,170103,14,0,3,1065,2.333333333333333,0.21903165,6
2020-09-14-170103,170103,1,0,10,1066,4.666666666666667,1.1540809,0
2020-09-15-170103,170103,0,0,6,1066,2.0,0.39354813,1
2020-09-16-170103,170103,9,0,10,1075,2.6666666666666665,0.5397212,2
2020-09-17-170103,170103,4,0,8,1079,2.0,0.53050566,3
2020-09-18-170103,170103,8,0,12,1087,7.333333333333332,1.3615305,4
2020-09-19-170103,170103,4,1,9,1091,1.6666666666666667,0.16480379,5
2020-09-20-170103,170103,8,0,5,1099,6.0,0.14059326,6
2020-09-21-170103,170103,9,0,7,1108,4.0,0.36273807,0
2020-09-22-170103,170103,1,0,2,1109,1.6666666666666667,0.71347594,1
2020-09-23-170103,170103,4,0,9,1113,4.0,1.0546036,2
2020-09-24-170103,170103,21,0,2,1134,5.0,0.96634334,3
2020-09-25-170103,170103,8,0,8,1142,4.666666666666667,1.2774144,4
2020-09-26-170103,170103,3,0,2,1145,3.0,0.4273247,5
2020-09-27-170103,170103,3,0,2,1148,1.3333333333333333,0.06150491,6
2020-09-28-170103,170103,10,0,1,1158,6.0,0.82793313,0
2020-09-29-170103,170103,6,0,2,1164,1.3333333333333333,0.39219815,1
2020-09-30-170103,170103,10,0,3,1174,3.0,0.62181735,2
2020-10-01-170103,170103,8,0,0,1182,2.6666666666666665,0.57975775,3
2020-10-02-170103,170103,12,0,4,1194,5.666666666666668,0.85841805,4
2020-10-03-170103,170103,9,0,0,1203,4.333333333333333,0.5179786,5
2020-10-04-170103,170103,5,0,10,1208,3.0,0.27115414,6
2020-10-05-170103,170103,7,1,14,1215,2.0,0.4959931,0
2020-10-06-170103,170103,2,0,5,1217,2.333333333333333,0.49088836,1
2020-10-07-170103,170103,9,0,8,1226,4.333333333333333,0.32510725,2
2020-10-08-170103,170103,2,0,14,1228,2.0,0.4067156,3
2020-10-09-170103,170103,8,3,17,1236,5.333333333333333,1.7132595,4
2020-10-10-170103,170103,2,0,7,1238,4.0,0.5714816,5
2020-10-11-170103,170103,2,0,9,1240,3.0,0.23069584,6
2020-10-12-170103,170103,1,0,14,1241,1.3333333333333333,0.5088732,0
2020-10-13-170103,170103,2,0,7,1243,3.333333333333333,0.5284876,1
2020-10-14-170103,170103,3,0,13,1246,7.0,1.0758212,2
2020-10-15-170103,170103,0,0,20,1246,0.0,0.14784275,3
2020-10-16-170103,170103,4,0,17,1250,3.0,0.7263981,4
2020-10-17-170103,170103,0,0,7,1250,0.6666666666666666,0.38230863,5
2020-10-18-170103,170103,10,1,5,1260,4.333333333333333,0.24067397,6
2020-10-19-170103,170103,14,0,7,1274,6.666666666666668,1.290672,0
2020-10-20-170103,170103,5,0,11,1279,4.666666666666667,0.6470775,1
2020-10-21-170103,170103,8,0,8,1287,6.0,0.4248816,2
2020-10-22-170103,170103,14,0,11,1301,9.666666666666666,1.4814013,3
2020-10-23-170103,170103,17,0,16,1318,13.666666666666664,1.1813469,4
2020-10-24-170103,170103,7,0,13,1325,4.666666666666667,0.70135105,5
2020-10-25-170103,170103,9,0,7,1334,11.333333333333336,0.6919834,6
2020-10-26-170103,170103,14,0,10,1348,8.666666666666666,0.7265814,0
2020-10-27-170103,170103,7,1,3,1355,5.0,1.0418098,1
2020-10-28-170103,170103,13,1,7,1368,5.0,1.6035879,2
2020-10-29-170103,170103,20,0,11,1388,14.333333333333336,3.0787244,3
2020-10-30-170103,170103,17,0,3,1405,13.333333333333336,1.9142804,4
2020-10-31-170103,170103,7,2,0,1412,6.333333333333332,0.98555535,5
2020-11-01-170103,170103,5,0,0,1417,7.0,0.45709124,6
2020-11-02-170103,170103,7,0,0,1424,2.6666666666666665,0.27788693,0
2020-11-03-170103,170103,11,0,0,1435,5.333333333333333,2.3864896,1
2020-11-04-170103,170103,8,0,0,1443,12.0,1.9032321,2
2020-11-05-170103,170103,11,0,0,1454,9.333333333333334,2.281182,3
2020-11-06-170103,170103,16,1,0,1470,9.333333333333334,1.6231691,4
2020-11-07-170103,170103,13,0,0,1483,6.333333333333332,0.59992754,5
2020-11-08-170103,170103,7,0,0,1490,6.333333333333332,0.469831,6
2020-11-09-170103,170103,10,0,0,1500,6.666666666666668,0.24950762,0
2020-11-10-170103,170103,3,1,0,1503,4.0,0.31272703,1
2020-11-11-170103,170103,7,0,0,1510,5.333333333333333,0.62639725,2
2020-11-12-170103,170103,11,0,0,1521,6.0,0.6206296,3
2020-11-13-170103,170103,3,0,0,1524,4.666666666666667,0.84466517,4
2020-03-01-170104,170104,0,0,1,0,0.0,0.0053921742,6
2020-03-02-170104,170104,0,0,10,0,0.0,0.0010577923,0
2020-03-03-170104,170104,0,0,13,0,0.0,0.011951397,1
2020-03-04-170104,170104,0,0,22,0,0.0,0.00045932402,2
2020-03-05-170104,170104,0,0,22,0,0.0,0.008927666,3
2020-03-06-170104,170104,0,0,27,0,0.25,0.0033577567,4
2020-03-07-170104,170104,0,0,16,0,0.0,0.0050646383,5
2020-03-08-170104,170104,0,0,17,0,0.0,0.00042286332,6
2020-03-09-170104,170104,1,0,26,1,0.25,0.0032455472,0
2020-03-10-170104,170104,0,0,22,1,0.0,0.013843885,1
2020-03-11-170104,170104,2,0,32,3,1.25,0.084846966,2
2020-03-12-170104,170104,2,0,33,5,0.5,0.02850459,3
2020-03-13-170104,170104,5,0,33,10,1.5,0.22686957,4
2020-03-14-170104,170104,0,0,10,10,1.0,0.011474424,5
2020-03-15-170104,170104,1,0,6,11,1.25,0.018032318,6
2020-03-16-170104,170104,10,0,17,21,9.25,0.21080285,0
2020-03-17-170104,170104,13,0,18,34,6.0,0.09974558,1
2020-03-18-170104,170104,22,0,12,56,24.25,0.41965938,2
2020-03-19-170104,170104,22,2,13,78,28.75,0.4381953,3
2020-03-20-170104,170104,27,1,29,105,29.75,0.26379916,4
2020-03-21-170104,170104,16,0,7,121,9.5,0.06559581,5
2020-03-22-170104,170104,17,0,4,138,13.5,0.0720506,6
2020-03-23-170104,170104,26,0,12,164,41.75,0.7228195,0
2020-03-24-170104,170104,22,0,12,186,35.5,0.278746,1
2020-03-25-170104,170104,32,0,9,218,26.75,0.53054065,2
2020-03-26-170104,170104,33,0,7,251,23.0,0.38432625,3
2020-03-27-170104,170104,33,0,9,284,26.5,0.32358706,4
2020-03-28-170104,170104,10,0,4,294,9.0,0.11940868,5
2020-03-29-170104,170104,6,0,1,300,8.5,0.114891335,6
2020-03-30-170104,170104,17,0,6,317,21.0,0.399149,0
2020-03-31-170104,170104,18,0,5,335,21.5,0.4960811,1
2020-04-01-170104,170104,12,0,5,347,16.0,0.29756123,2
2020-04-02-170104,170104,13,0,9,360,16.5,0.4950669,3
2020-04-03-170104,170104,29,0,15,389,14.5,0.25065628,4
2020-04-04-170104,170104,7,0,0,396,4.5,0.040120736,5
2020-04-05-170104,170104,4,0,1,400,4.75,0.056547854,6
2020-04-06-170104,170104,12,0,8,412,18.25,0.45407346,0
2020-04-07-170104,170104,12,0,3,424,13.0,0.27900177,1
2020-04-08-170104,170104,9,0,8,433,11.25,0.12321625,2
2020-04-09-170104,170104,7,0,2,440,12.25,0.14980112,3
2020-04-10-170104,170104,9,0,5,449,8.0,0.21922623,4
2020-04-11-170104,170104,4,0,1,453,3.75,0.014599171,5
2020-04-12-170104,170104,1,0,1,454,4.25,0.20538591,6
2020-04-13-170104,170104,6,0,5,460,10.25,0.21322834,0
2020-04-14-170104,170104,5,0,4,465,15.5,0.809215,1
2020-04-15-170104,170104,5,0,7,470,10.75,0.2551335,2
2020-04-16-170104,170104,9,0,5,479,8.0,0.37999782,3
2020-04-17-170104,170104,15,0,0,494,7.0,0.16904125,4
2020-04-18-170104,170104,0,0,1,494,0.75,0.06220091,5
2020-04-19-170104,170104,1,0,2,495,2.25,0.124492235,6
2020-04-20-170104,170104,8,0,4,503,16.75,0.34651798,0
2020-04-21-170104,170104,3,0,5,506,7.25,0.3317441,1
2020-04-22-170104,170104,8,1,4,514,6.5,0.13355258,2
2020-04-23-170104,170104,2,0,1,516,1.75,0.042379152,3
2020-04-24-170104,170104,5,0,9,521,5.5,0.05099336,4
2020-04-25-170104,170104,1,0,0,522,0.75,0.013170738,5
2020-04-26-170104,170104,1,0,1,523,1.5,0.0033589755,6
2020-04-27-170104,170104,5,0,9,528,6.75,0.0753318,0
2020-04-28-170104,170104,4,0,2,532,2.5,0.08891751,1
2020-04-29-170104,170104,7,0,5,539,4.5,0.254298,2
2020-04-30-170104,170104,5,0,3,544,3.25,0.13251577,3
2020-05-01-170104,170104,0,0,6,544,0.75,0.0021716184,4
2020-05-02-170104,170104,1,0,1,545,2.5,0.2141109,5
2020-05-03-170104,170104,2,0,1,547,0.5,0.038598612,6
2020-05-04-170104,170104,4,0,27,551,9.0,0.2508868,0
2020-05-05-170104,170104,5,0,5,556,5.75,0.09383202,1
2020-05-06-170104,170104,4,0,3,560,7.75,0.12878779,2
2020-05-07-170104,170104,1,0,1,561,4.0,0.19055772,3
2020-05-08-170104,170104,9,0,1,570,6.25,0.27065077,4
2020-05-09-170104,170104,0,0,1,570,1.25,0.04585693,5
2020-05-10-170104,170104,1,0,0,571,1.5,0.05954339,6
2020-05-11-170104,170104,9,0,1,580,10.0,0.36747465,0
2020-05-12-170104,170104,2,0,3,582,5.75,0.19882914,1
2020-05-13-170104,170104,5,0,3,587,2.75,0.054983143,2
2020-05-14-170104,170104,3,5,5,590,4.25,0.13276097,3
2020-05-15-170104,170104,6,0,1,596,4.75,0.07488456,4
2020-05-16-170104,170104,1,0,0,597,2.0,0.02380933,5
2020-05-17-170104,170104,1,0,0,598,0.75,0.03440037,6
2020-05-18-170104,170104,27,0,2,625,18.5,0.36132672,0
2020-05-19-170104,170104,5,0,5,630,1.75,0.07845419,1
2020-05-20-170104,170104,3,0,1,633,2.5,0.098550715,2
2020-05-21-170104,170104,1,0,3,634,5.5,0.1454346,3
2020-05-22-170104,170104,1,0,2,635,3.25,0.13391982,4
2020-05-23-170104,170104,1,0,0,636,0.5,0.050100293,5
2020-05-24-170104,170104,0,0,0,636,1.25,0.008456966,6
2020-05-25-170104,170104,1,0,0,637,4.25,0.09247978,0
2020-05-26-170104,170104,3,0,1,640,2.75,0.15560897,1
2020-05-27-170104,170104,3,0,1,643,1.75,0.059238717,2
2020-05-28-170104,170104,5,2,0,648,4.25,0.26440182,3
2020-05-29-170104,170104,1,16,0,649,2.5,0.10947346,4
2020-05-30-170104,170104,0,0,0,649,0.0,0.0038317773,5
2020-05-31-170104,170104,0,0,0,649,0.0,0.017699527,6
2020-06-01-170104,170104,2,1,0,651,2.0,0.017587215,0
2020-06-02-170104,170104,5,0,0,656,4.5,0.35740802,1
2020-06-03-170104,170104,1,0,1,657,2.0,0.087902665,2
2020-06-04-170104,170104,3,0,0,660,2.75,0.10037095,3
2020-06-05-170104,170104,2,0,0,662,1.75,0.053022876,4
2020-06-06-170104,170104,0,1,0,662,0.0,0.008327955,5
2020-06-07-170104,170104,0,0,0,662,0.25,0.0001773563,6
2020-06-08-170104,170104,0,0,2,662,2.25,0.10864077,0
2020-06-09-170104,170104,1,0,0,663,1.5,0.10794063,1
2020-06-10-170104,170104,1,0,0,664,1.25,0.021670505,2
2020-06-11-170104,170104,0,0,2,664,1.0,0.015829157,3
2020-06-12-170104,170104,0,0,1,664,2.0,0.15555821,4
2020-06-13-170104,170104,0,0,0,664,0.25,0.007871767,5
2020-06-14-170104,170104,0,0,1,664,0.0,0.0069537377,6
2020-06-15-170104,170104,0,0,1,664,1.75,0.08631837,0
2020-06-16-170104,170104,0,0,1,664,3.0,0.09190783,1
2020-06-17-170104,170104,1,0,0,665,2.0,0.09757972,2
2020-06-18-170104,170104,0,0,1,665,1.25,0.024258431,3
2020-06-19-170104,170104,0,0,1,665,0.75,0.11682492,4
2020-06-20-170104,170104,0,0,0,665,0.25,0.021998683,5
2020-06-21-170104,170104,0,0,1,665,0.0,0.009551368,6
2020-06-22-170104,170104,2,0,2,667,2.5,0.08542585,0
2020-06-23-170104,170104,0,0,1,667,1.5,0.12084592,1
2020-06-24-170104,170104,0,0,0,667,1.25,0.067830205,2
2020-06-25-170104,170104,2,0,0,669,1.25,0.046258163,3
2020-06-26-170104,170104,1,0,0,670,1.25,0.052549943,4
2020-06-27-170104,170104,0,0,1,670,0.0,0.009393521,5
2020-06-28-170104,170104,1,0,0,671,0.5,0.0869075,6
2020-06-29-170104,170104,1,0,0,672,1.0,0.08317404,0
2020-06-30-170104,170104,1,1,0,673,1.75,0.018922323,1
2020-07-01-170104,170104,0,0,0,673,1.75,0.031257264,2
2020-07-02-170104,170104,1,0,0,674,0.5,0.114531696,3
2020-07-03-170104,170104,1,0,1,675,0.5,0.017734636,4
2020-07-04-170104,170104,0,0,0,675,0.25,0.011172039,5
2020-07-05-170104,170104,1,0,0,676,0.0,0.003471577,6
2020-07-06-170104,170104,2,0,0,678,0.5,0.042134542,0
2020-07-07-170104,170104,1,0,0,679,0.5,0.0801882,1
2020-07-08-170104,170104,0,0,0,679,0.5,0.021506874,2
2020-07-09-170104,170104,0,0,2,679,0.5,0.022794755,3
2020-07-10-170104,170104,0,0,0,679,1.25,0.1983534,4
2020-07-11-170104,170104,1,0,0,680,0.25,0.06747471,5
2020-07-12-170104,170104,0,0,0,680,0.25,0.023917072,6
2020-07-13-170104,170104,0,0,0,680,0.5,0.12320721,0
2020-07-14-170104,170104,0,0,1,680,0.0,0.09834861,1
2020-07-15-170104,170104,0,0,0,680,0.25,0.093098305,2
2020-07-16-170104,170104,0,0,0,680,0.25,0.024979709,3
2020-07-17-170104,170104,1,0,0,681,0.5,0.20791507,4
2020-07-18-170104,170104,0,0,0,681,0.25,0.035419922,5
2020-07-19-170104,170104,0,1,0,681,0.0,0.0120447185,6
2020-07-20-170104,170104,0,0,0,681,0.0,0.049034923,0
2020-07-21-170104,170104,0,0,0,681,0.0,0.007658643,1
2020-07-22-170104,170104,0,0,0,681,0.5,0.03832606,2
2020-07-23-170104,170104,2,0,2,683,0.5,0.09548682,3
2020-07-24-170104,170104,0,0,0,683,0.5,0.013052848,4
2020-07-25-170104,170104,0,0,1,683,0.0,0.0017117712,5
2020-07-26-170104,170104,0,0,1,683,0.0,0.0026837788,6
2020-07-27-170104,170104,0,0,0,683,0.75,0.087420635,0
2020-07-28-170104,170104,1,0,0,684,0.0,0.08418327,1
2020-07-29-170104,170104,0,0,0,684,0.25,0.049787056,2
2020-07-30-170104,170104,0,0,0,684,0.5,0.029815651,3
2020-07-31-170104,170104,0,0,3,684,0.75,0.23915738,4
2020-08-01-170104,170104,0,0,0,684,0.0,0.009420188,5
2020-08-02-170104,170104,0,0,1,684,0.0,0.028349914,6
2020-08-03-170104,170104,0,0,0,684,0.0,0.055618457,0
2020-08-04-170104,170104,0,0,0,684,0.25,0.07420777,1
2020-08-05-170104,170104,0,1,4,684,0.25,0.26356667,2
2020-08-06-170104,170104,2,0,6,686,0.5,0.3374885,3
2020-08-07-170104,170104,0,1,0,686,0.5,0.32474044,4
2020-08-08-170104,170104,1,0,0,687,0.0,0.121300936,5
2020-08-09-170104,170104,1,0,0,688,1.25,0.0979218,6
2020-08-10-170104,170104,0,0,2,688,2.5,0.26433074,0
2020-08-11-170104,170104,0,0,1,688,2.25,0.36239076,1
2020-08-12-170104,170104,0,0,1,688,3.75,0.5313312,2
2020-08-13-170104,170104,0,0,5,688,2.5,0.2634321,3
2020-08-14-170104,170104,3,0,0,691,1.5,0.44172245,4
2020-08-15-170104,170104,0,0,0,691,0.75,0.17683852,5
2020-08-16-170104,170104,1,0,0,692,0.25,0.10491275,6
2020-08-17-170104,170104,0,1,1,692,1.25,0.2797177,0
2020-08-18-170104,170104,0,0,2,692,0.5,0.18866493,1
2020-08-19-170104,170104,4,0,2,696,2.0,0.4201805,2
2020-08-20-170104,170104,6,0,2,702,3.0,0.26110366,3
2020-08-21-170104,170104,0,1,3,702,0.25,0.4485384,4
2020-08-22-170104,170104,0,0,2,702,0.5,0.21245794,5
2020-08-23-170104,170104,0,0,1,702,0.75,0.14804642,6
2020-08-24-170104,170104,2,0,2,704,1.5,0.2682215,0
2020-08-25-170104,170104,1,0,3,705,2.0,0.250032,1
2020-08-26-170104,170104,1,0,2,706,2.0,0.2354038,2
2020-08-27-170104,170104,5,0,1,711,3.0,0.13295482,3
2020-08-28-170104,170104,0,0,0,711,3.0,0.21471234,4
2020-08-29-170104,170104,0,0,5,711,0.5,0.24358405,5
2020-08-30-170104,170104,0,0,1,711,1.75,0.37029213,6
2020-08-31-170104,170104,1,0,6,712,1.5,0.111487806,0
2020-09-01-170104,170104,2,0,3,714,0.75,0.11044628,1
2020-09-02-170104,170104,2,0,3,716,2.75,0.070721366,2
2020-09-03-170104,170104,2,0,2,718,3.5,0.28569594,3
2020-09-04-170104,170104,3,0,8,721,4.0,0.37656045,4
2020-09-05-170104,170104,2,0,3,723,2.25,0.07913605,5
2020-09-06-170104,170104,1,0,9,724,1.25,0.2363293,6
2020-09-07-170104,170104,2,0,7,726,5.75,0.16649011,0
2020-09-08-170104,170104,3,0,2,729,5.0,0.37939987,1
2020-09-09-170104,170104,2,0,6,731,2.25,0.38781554,2
2020-09-10-170104,170104,1,0,3,732,2.5,0.22408804,3
2020-09-11-170104,170104,0,0,5,732,4.25,0.6192354,4
2020-09-12-170104,170104,5,0,4,737,0.25,0.045881595,5
2020-09-13-170104,170104,1,0,1,738,5.5,0.13907188,6
2020-09-14-170104,170104,6,0,6,744,3.5,0.6010175,0
2020-09-15-170104,170104,3,0,1,747,1.5,0.19561107,1
2020-09-16-170104,170104,3,0,3,750,4.5,0.30592772,2
2020-09-17-170104,170104,2,0,3,752,3.5,0.26337278,3
2020-09-18-170104,170104,8,1,6,760,6.75,0.6535645,4
2020-09-19-170104,170104,3,1,3,763,1.5,0.07702081,5
2020-09-20-170104,170104,9,0,7,772,5.25,0.08239509,6
2020-09-21-170104,170104,7,0,1,779,5.0,0.15529934,0
2020-09-22-170104,170104,2,0,2,781,1.75,0.32585037,1
2020-09-23-170104,170104,6,0,4,787,3.5,0.47493452,2
2020-09-24-170104,170104,3,1,5,790,10.25,0.42015392,3
2020-09-25-170104,170104,5,0,3,795,5.75,0.6374695,4
2020-09-26-170104,170104,4,0,6,799,2.5,0.27042893,5
2020-09-27-170104,170104,1,0,6,800,2.25,0.04400543,6
2020-09-28-170104,170104,6,0,0,806,6.75,0.38774872,0
2020-09-29-170104,170104,1,0,5,807,2.5,0.18612559,1
2020-09-30-170104,170104,3,0,10,810,5.0,0.3534017,2
2020-10-01-170104,170104,3,0,0,813,5.25,0.2570419,3
2020-10-02-170104,170104,6,0,2,819,8.0,0.47611436,4
2020-10-03-170104,170104,3,0,1,822,6.0,0.27189893,5
2020-10-04-170104,170104,7,1,2,829,3.25,0.19340652,6
2020-10-05-170104,170104,1,1,3,830,4.5,0.28073502,0
2020-10-06-170104,170104,2,0,6,832,3.25,0.23170246,1
2020-10-07-170104,170104,4,0,13,836,6.25,0.17608017,2
2020-10-08-170104,170104,5,0,11,841,1.5,0.24732856,3
2020-10-09-170104,170104,3,1,10,844,8.25,0.7996252,4
2020-10-10-170104,170104,6,0,6,850,3.75,0.39260513,5
2020-10-11-170104,170104,6,0,18,856,1.25,0.19896358,6
2020-10-12-170104,170104,0,0,4,856,1.5,0.2909221,0
2020-10-13-170104,170104,5,0,8,861,4.75,0.25535822,1
2020-10-14-170104,170104,10,0,6,871,5.75,0.4668249,2
2020-10-15-170104,170104,0,0,6,871,0.0,0.05606916,3
2020-10-16-170104,170104,2,0,10,873,4.5,0.29674333,4
2020-10-17-170104,170104,1,0,9,874,0.5,0.17982158,5
2020-10-18-170104,170104,2,0,10,876,7.25,0.1367168,6
2020-10-19-170104,170104,3,0,2,879,11.25,0.6144914,0
2020-10-20-170104,170104,6,0,5,885,4.25,0.24911128,1
2020-10-21-170104,170104,13,0,11,898,6.25,0.20545861,2
2020-10-22-170104,170104,11,0,5,909,9.75,0.64575887,3
2020-10-23-170104,170104,10,0,8,919,16.0,0.55018806,4
2020-10-24-170104,170104,6,0,11,925,5.0,0.30043802,5
2020-10-25-170104,170104,18,0,7,943,11.75,0.28544587,6
2020-10-26-170104,170104,4,0,11,947,12.5,0.3480435,0
2020-10-27-170104,170104,8,0,3,955,6.5,0.5088285,1
2020-10-28-170104,170104,6,0,3,961,7.75,0.6955249,2
2020-10-29-170104,170104,6,0,8,967,16.0,1.5305259,3
2020-10-30-170104,170104,10,0,6,977,14.0,0.85466033,4
2020-10-31-170104,170104,9,0,0,986,5.25,0.46936095,5
2020-11-01-170104,170104,10,0,0,996,5.75,0.26245862,6
2020-11-02-170104,170104,2,0,0,998,3.75,0.15432917,0
2020-11-03-170104,170104,5,0,0,1003,7.25,0.917032,1
2020-11-04-170104,170104,11,0,0,1014,10.25,0.6659087,2
2020-11-05-170104,170104,5,0,0,1019,11.25,0.93016005,3
2020-11-06-170104,170104,8,0,0,1027,12.25,0.85553396,4
2020-11-07-170104,170104,11,0,0,1038,7.5,0.30862185,5
2020-11-08-170104,170104,7,0,0,1045,6.0,0.286446,6
2020-11-09-170104,170104,11,0,0,1056,6.5,0.1354428,0
2020-11-10-170104,170104,3,0,0,1059,5.0,0.14034028,1
2020-11-11-170104,170104,3,0,0,1062,7.0,0.30105,2
2020-11-12-170104,170104,8,1,0,1070,9.0,0.25894314,3
2020-11-13-170104,170104,6,1,0,1076,3.5,0.43819427,4
2020-03-01-170105,170105,0,0,0,0,0.07142857142857142,0.050854735,6
2020-03-02-170105,170105,0,0,4,0,0.0,0.0020049666,0
2020-03-03-170105,170105,0,1,1,0,0.0,0.034791976,1
2020-03-04-170105,170105,0,0,11,0,0.07142857142857142,0.0039914073,2
2020-03-05-170105,170105,0,0,6,0,0.14285714285714285,0.07768572,3
2020-03-06-170105,170105,0,0,4,0,0.07142857142857142,0.0049914373,4
2020-03-07-170105,170105,0,0,1,0,0.0,0.0050670835,5
2020-03-08-170105,170105,0,1,0,0,0.0,0.00014038236,6
2020-03-09-170105,170105,0,0,13,0,0.14285714285714285,0.004099895,0
2020-03-10-170105,170105,0,0,6,0,0.2857142857142857,0.08507733,1
2020-03-11-170105,170105,1,0,7,1,0.5,0.51435816,2
2020-03-12-170105,170105,0,0,8,1,0.6428571428571429,0.21803738,3
2020-03-13-170105,170105,2,0,6,3,1.3571428571428572,1.4616506,4
2020-03-14-170105,170105,0,0,3,3,1.1428571428571428,0.10403244,5
2020-03-15-170105,170105,0,0,2,3,1.1428571428571428,0.16778424,6
2020-03-16-170105,170105,4,0,7,7,4.642857142857143,1.9762015,0
2020-03-17-170105,170105,1,0,9,8,4.5,0.95330745,1
2020-03-18-170105,170105,11,1,6,19,9.928571428571429,5.109845,2
2020-03-19-170105,170105,6,2,11,25,13.214285714285715,4.545815,3
2020-03-20-170105,170105,4,2,3,29,13.214285714285715,2.7125716,4
2020-03-21-170105,170105,1,0,2,30,5.0,0.69886845,5
2020-03-22-170105,170105,0,0,1,30,6.142857142857142,0.9337833,6
2020-03-23-170105,170105,13,0,10,43,17.0,7.152446,0
2020-03-24-170105,170105,6,0,5,49,13.857142857142858,3.4726706,1
2020-03-25-170105,170105,7,0,2,56,12.857142857142858,4.3160686,2
2020-03-26-170105,170105,8,0,5,64,11.357142857142858,4.5825415,3
2020-03-27-170105,170105,6,0,6,70,11.714285714285715,3.3115516,4
2020-03-28-170105,170105,3,0,0,73,5.071428571428571,1.9034165,5
2020-03-29-170105,170105,2,0,8,75,4.428571428571429,1.4589881,6
2020-03-30-170105,170105,7,0,3,82,9.357142857142858,4.2191687,0
2020-03-31-170105,170105,9,0,17,91,9.428571428571429,4.9470334,1
2020-04-01-170105,170105,6,0,3,97,7.571428571428571,3.3481166,2
2020-04-02-170105,170105,11,0,6,108,8.142857142857142,5.750398,3
2020-04-03-170105,170105,3,0,2,111,7.357142857142858,2.3140655,4
2020-04-04-170105,170105,2,0,1,113,2.642857142857143,0.65851545,5
2020-04-05-170105,170105,1,0,4,114,2.142857142857143,0.9017809,6
2020-04-06-170105,170105,10,0,9,124,7.7142857142857135,4.63511,0
2020-04-07-170105,170105,5,0,7,129,6.0,3.0126328,1
2020-04-08-170105,170105,2,0,1,131,5.071428571428571,1.3065376,2
2020-04-09-170105,170105,5,0,0,136,4.642857142857143,2.6614785,3
2020-04-10-170105,170105,6,0,0,142,5.428571428571429,3.4822445,4
2020-04-11-170105,170105,0,2,0,142,2.4285714285714284,0.34945163,5
2020-04-12-170105,170105,8,0,0,150,1.1428571428571428,3.3855808,6
2020-04-13-170105,170105,3,0,1,153,5.7142857142857135,2.1979938,0
2020-04-14-170105,170105,17,0,1,170,5.285714285714286,8.807276,1
2020-04-15-170105,170105,3,0,3,173,4.5,2.5489414,2
2020-04-16-170105,170105,6,0,2,179,3.7142857142857135,3.5904899,3
2020-04-17-170105,170105,2,0,0,181,4.642857142857143,1.576057,4
2020-04-18-170105,170105,1,0,5,182,0.8571428571428571,0.81457675,5
2020-04-19-170105,170105,4,0,1,186,0.8571428571428571,1.9805691,6
2020-04-20-170105,170105,9,0,3,195,6.357142857142858,4.4684477,0
2020-04-21-170105,170105,7,0,1,202,2.8571428571428568,3.3197012,1
2020-04-22-170105,170105,1,0,3,203,3.7857142857142856,1.9044883,2
2020-04-23-170105,170105,0,0,2,203,1.0714285714285714,0.6657996,3
2020-04-24-170105,170105,0,0,3,203,3.4285714285714284,0.8860423,4
2020-04-25-170105,170105,0,0,1,203,1.2857142857142858,0.35566807,5
2020-04-26-170105,170105,0,0,2,203,0.7857142857142857,0.072277315,6
2020-04-27-170105,170105,1,0,7,204,4.0,1.069991,0
2020-04-28-170105,170105,1,0,3,205,1.7142857142857142,0.9991063,1
2020-04-29-170105,170105,3,0,0,208,3.071428571428572,2.2360253,2
2020-04-30-170105,170105,2,0,2,210,1.6428571428571428,1.1420467,3
2020-05-01-170105,170105,0,0,1,210,0.35714285714285715,0.06973645,4
2020-05-02-170105,170105,5,0,0,215,0.6428571428571429,2.315513,5
2020-05-03-170105,170105,1,0,1,216,0.5,0.5618939,6
2020-05-04-170105,170105,3,0,5,219,3.6428571428571432,1.9048887,0
2020-05-05-170105,170105,1,0,1,220,2.4285714285714284,0.9330614,1
2020-05-06-170105,170105,3,0,0,223,3.071428571428572,1.3175441,2
2020-05-07-170105,170105,2,0,1,225,1.8571428571428568,1.9194665,3
2020-05-08-170105,170105,3,0,1,228,4.714285714285714,2.437548,4
2020-05-09-170105,170105,1,0,1,229,0.6428571428571429,0.6287272,5
2020-05-10-170105,170105,2,0,0,231,0.5714285714285714,1.0626215,6
2020-05-11-170105,170105,7,0,0,238,3.6428571428571432,3.9790516,0
2020-05-12-170105,170105,3,0,2,241,2.7857142857142856,1.8994975,1
2020-05-13-170105,170105,0,1,0,241,2.0,0.3498969,2
2020-05-14-170105,170105,2,0,2,243,1.7857142857142858,1.2239708,3
2020-05-15-170105,170105,1,0,1,244,2.357142857142857,0.743118,4
2020-05-16-170105,170105,0,0,0,244,0.9285714285714286,0.13538566,5
2020-05-17-170105,170105,1,0,0,245,0.2857142857142857,0.47243428,6
2020-05-18-170105,170105,5,0,0,250,8.0,3.375847,0
2020-05-19-170105,170105,1,0,5,251,1.2857142857142858,0.99331117,1
2020-05-20-170105,170105,0,0,1,251,1.4285714285714286,0.49042568,2
2020-05-21-170105,170105,1,0,1,252,2.2142857142857144,1.0359045,3
2020-05-22-170105,170105,1,1,0,253,1.8571428571428568,1.0787897,4
2020-05-23-170105,170105,1,0,0,254,0.2857142857142857,0.6513012,5
2020-05-24-170105,170105,0,1,0,254,0.5714285714285714,0.18655537,6
2020-05-25-170105,170105,0,0,1,254,1.7857142857142858,0.5485589,0
2020-05-26-170105,170105,2,0,1,256,1.4285714285714286,1.4206593,1
2020-05-27-170105,170105,0,0,0,256,1.6428571428571428,0.663784,2
2020-05-28-170105,170105,2,2,0,258,2.7857142857142856,2.1737182,3
2020-05-29-170105,170105,1,1,2,259,0.8571428571428571,0.7854567,4
2020-05-30-170105,170105,0,0,0,259,0.21428571428571427,0.04696891,5
2020-05-31-170105,170105,0,0,0,259,0.21428571428571427,0.2501049,6
2020-06-01-170105,170105,0,0,1,259,1.1428571428571428,0.18252313,0
2020-06-02-170105,170105,5,0,1,264,2.2142857142857144,3.0889633,1
2020-06-03-170105,170105,1,0,1,265,1.1428571428571428,0.89179957,2
2020-06-04-170105,170105,1,0,0,266,1.5,0.8069118,3
2020-06-05-170105,170105,0,0,0,266,1.0,0.2955919,4
2020-06-06-170105,170105,0,0,0,266,0.21428571428571427,0.08555211,5
2020-06-07-170105,170105,0,0,0,266,0.14285714285714285,0.0047854637,6
2020-06-08-170105,170105,1,0,1,267,1.2142857142857142,0.8376037,0
2020-06-09-170105,170105,1,0,1,268,0.7142857142857143,0.68553656,1
2020-06-10-170105,170105,0,0,0,268,0.7142857142857143,0.19576068,2
2020-06-11-170105,170105,0,0,0,268,0.6428571428571429,0.17418125,3
2020-06-12-170105,170105,2,0,0,270,0.8571428571428571,1.1765496,4
2020-06-13-170105,170105,0,0,0,270,0.2857142857142857,0.07658417,5
2020-06-14-170105,170105,0,0,1,270,0.35714285714285715,0.07248697,6
2020-06-15-170105,170105,1,0,0,271,0.6428571428571429,0.77675176,0
2020-06-16-170105,170105,1,0,0,272,1.2857142857142858,0.71430165,1
2020-06-17-170105,170105,1,1,1,273,1.0714285714285714,0.7468959,2
2020-06-18-170105,170105,0,0,1,273,0.9285714285714286,0.26174805,3
2020-06-19-170105,170105,0,0,0,273,0.8571428571428571,0.60756135,4
2020-06-20-170105,170105,0,0,0,273,0.35714285714285715,0.3778487,5
2020-06-21-170105,170105,0,0,0,273,0.42857142857142855,0.13745034,6
2020-06-22-170105,170105,1,0,0,274,0.9285714285714286,0.64696753,0
2020-06-23-170105,170105,1,0,0,275,0.5,0.79958564,1
2020-06-24-170105,170105,0,2,0,275,0.7857142857142857,0.51090163,2
2020-06-25-170105,170105,0,0,0,275,0.7142857142857143,0.15146412,3
2020-06-26-170105,170105,0,0,2,275,0.7142857142857143,0.5849125,4
2020-06-27-170105,170105,0,0,0,275,0.21428571428571427,0.1768518,5
2020-06-28-170105,170105,1,0,0,276,0.2857142857142857,0.9034628,6
2020-06-29-170105,170105,0,0,1,276,0.5714285714285714,0.21990511,0
2020-06-30-170105,170105,0,0,0,276,0.7142857142857143,0.2462267,1
2020-07-01-170105,170105,1,0,0,277,0.8571428571428571,0.35523304,2
2020-07-02-170105,170105,1,0,0,278,0.35714285714285715,0.89359343,3
2020-07-03-170105,170105,0,0,0,278,0.42857142857142855,0.2457264,4
2020-07-04-170105,170105,0,0,0,278,0.21428571428571427,0.12554795,5
2020-07-05-170105,170105,0,0,0,278,0.07142857142857142,0.051888607,6
2020-07-06-170105,170105,0,0,0,278,0.6428571428571429,0.33931416,0
2020-07-07-170105,170105,0,0,0,278,0.42857142857142855,0.23592816,1
2020-07-08-170105,170105,0,0,1,278,0.21428571428571427,0.12595253,2
2020-07-09-170105,170105,0,0,0,278,0.6428571428571429,0.24015431,3
2020-07-10-170105,170105,2,2,0,280,0.7857142857142857,1.9461994,4
2020-07-11-170105,170105,0,0,0,280,0.42857142857142855,0.5901125,5
2020-07-12-170105,170105,0,0,0,280,0.14285714285714285,0.071866594,6
2020-07-13-170105,170105,1,0,0,281,0.5714285714285714,0.98504806,0
2020-07-14-170105,170105,0,0,0,281,0.42857142857142855,0.43580008,1
2020-07-15-170105,170105,0,0,0,281,0.42857142857142855,0.2333598,2
2020-07-16-170105,170105,0,0,0,281,0.14285714285714285,0.24562225,3
2020-07-17-170105,170105,0,1,2,281,0.5714285714285714,1.5712357,4
2020-07-18-170105,170105,0,0,0,281,0.35714285714285715,0.5167023,5
2020-07-19-170105,170105,0,0,0,281,0.07142857142857142,0.09649664,6
2020-07-20-170105,170105,0,0,0,281,0.5714285714285714,0.5274994,0
2020-07-21-170105,170105,0,0,0,281,0.07142857142857142,0.059877563,1
2020-07-22-170105,170105,1,0,1,282,0.35714285714285715,0.3071606,2
2020-07-23-170105,170105,0,0,1,282,0.42857142857142855,0.34965107,3
2020-07-24-170105,170105,0,1,0,282,0.35714285714285715,0.08344562,4
2020-07-25-170105,170105,0,0,0,282,0.07142857142857142,0.015782593,5
2020-07-26-170105,170105,0,0,1,282,0.07142857142857142,0.025910698,6
2020-07-27-170105,170105,0,0,2,282,0.42857142857142855,0.3592192,0
2020-07-28-170105,170105,0,0,1,282,0.14285714285714285,0.39173797,1
2020-07-29-170105,170105,0,0,1,282,0.35714285714285715,0.323369,2
2020-07-30-170105,170105,0,0,0,282,0.5714285714285714,0.3161359,3
2020-07-31-170105,170105,2,0,2,284,0.35714285714285715,2.0505524,4
2020-08-01-170105,170105,0,1,1,284,0.07142857142857142,0.11168244,5
2020-08-02-170105,170105,0,0,1,284,0.14285714285714285,0.15928978,6
2020-08-03-170105,170105,0,0,0,284,0.5714285714285714,0.7027802,0
2020-08-04-170105,170105,0,0,0,284,0.35714285714285715,0.70686054,1
2020-08-05-170105,170105,1,0,1,285,0.5714285714285714,1.934219,2
2020-08-06-170105,170105,1,0,0,286,0.8571428571428571,2.461561,3
2020-08-07-170105,170105,0,0,0,286,0.9285714285714286,1.5430698,4
2020-08-08-170105,170105,0,0,1,286,1.2142857142857142,2.410295,5
2020-08-09-170105,170105,1,0,1,287,0.7857142857142857,1.0417571,6
2020-08-10-170105,170105,2,0,1,289,0.9285714285714286,2.289012,0
2020-08-11-170105,170105,1,0,0,290,1.5714285714285714,2.3154273,1
2020-08-12-170105,170105,1,0,1,291,1.7857142857142858,4.9924097,2
2020-08-13-170105,170105,0,0,0,291,2.0,2.2170284,3
2020-08-14-170105,170105,2,0,1,293,1.2142857142857142,3.7142375,4
2020-08-15-170105,170105,1,1,2,294,1.1428571428571428,2.145638,5
2020-08-16-170105,170105,1,0,2,295,0.35714285714285715,1.1211792,6
2020-08-17-170105,170105,0,0,0,295,1.4285714285714286,1.8800828,0
2020-08-18-170105,170105,0,0,0,295,1.2857142857142858,1.5397934,1
2020-08-19-170105,170105,1,0,2,296,2.2857142857142856,3.4786077,2
2020-08-20-170105,170105,0,0,0,296,2.4285714285714284,2.1540954,3
2020-08-21-170105,170105,0,0,2,296,2.2857142857142856,3.720492,4
2020-08-22-170105,170105,1,0,0,297,0.8571428571428571,1.8443594,5
2020-08-23-170105,170105,1,0,3,298,1.0,1.8816289,6
2020-08-24-170105,170105,1,0,0,299,1.7142857142857142,2.0106552,0
2020-08-25-170105,170105,0,0,5,299,2.4285714285714284,1.6574578,1
2020-08-26-170105,170105,1,0,1,300,2.2142857142857144,1.8336736,2
2020-08-27-170105,170105,0,0,2,300,2.642857142857143,0.96615016,3
2020-08-28-170105,170105,1,0,4,301,2.071428571428572,1.4047025,4
2020-08-29-170105,170105,2,1,0,303,1.0714285714285714,1.4485165,5
2020-08-30-170105,170105,2,0,1,305,1.1428571428571428,1.7034705,6
2020-08-31-170105,170105,0,0,5,305,2.0,0.7004757,0
2020-09-01-170105,170105,0,0,2,305,1.2857142857142858,0.77052826,1
2020-09-02-170105,170105,2,0,0,307,1.7857142857142858,0.5210223,2
2020-09-03-170105,170105,0,0,1,307,2.9285714285714284,1.5806953,3
2020-09-04-170105,170105,2,0,6,309,2.571428571428572,2.5003037,4
2020-09-05-170105,170105,0,0,0,309,1.8571428571428568,0.6862357,5
2020-09-06-170105,170105,3,0,0,312,1.2142857142857142,2.2759666,6
2020-09-07-170105,170105,0,0,1,312,3.3571428571428568,1.1348103,0
2020-09-08-170105,170105,5,0,2,317,2.642857142857143,3.0985725,1
2020-09-09-170105,170105,1,0,4,318,2.2142857142857144,1.8060684,2
2020-09-10-170105,170105,2,0,5,320,1.3571428571428572,1.9155756,3
2020-09-11-170105,170105,4,0,5,324,2.7142857142857144,3.9190338,4
2020-09-12-170105,170105,0,0,1,324,0.8571428571428571,0.25879875,5
2020-09-13-170105,170105,1,0,0,325,1.7857142857142858,0.86568147,6
2020-09-14-170105,170105,5,0,3,330,3.3571428571428568,3.9713364,0
2020-09-15-170105,170105,2,0,1,332,1.5,1.2813134,1
2020-09-16-170105,170105,0,0,3,332,3.6428571428571432,1.7199157,2
2020-09-17-170105,170105,1,0,2,333,2.4285714285714284,1.9284004,3
2020-09-18-170105,170105,6,0,3,339,4.285714285714286,4.180829,4
2020-09-19-170105,170105,0,0,3,339,1.7857142857142858,0.4965058,5
2020-09-20-170105,170105,0,0,1,339,3.0,0.3061268,6
2020-09-21-170105,170105,1,0,1,340,3.0,0.9262736,0
2020-09-22-170105,170105,2,0,2,342,2.2142857142857144,1.889154,1
2020-09-23-170105,170105,4,1,1,346,4.285714285714286,3.286051,2
2020-09-24-170105,170105,5,0,0,351,4.785714285714286,2.714271,3
2020-09-25-170105,170105,5,1,5,356,4.214285714285714,3.4304748,4
2020-09-26-170105,170105,1,0,3,357,2.571428571428572,1.4341793,5
2020-09-27-170105,170105,0,0,0,357,1.0,0.12590502,6
2020-09-28-170105,170105,3,0,4,360,3.4285714285714284,2.1652675,0
2020-09-29-170105,170105,1,0,1,361,1.8571428571428568,1.2080263,1
2020-09-30-170105,170105,3,0,5,364,3.8571428571428568,1.8538483,2
2020-10-01-170105,170105,2,0,0,366,3.7857142857142856,1.7285324,3
2020-10-02-170105,170105,3,0,4,369,4.428571428571429,2.2415044,4
2020-10-03-170105,170105,3,1,1,372,2.2857142857142856,1.8913599,5
2020-10-04-170105,170105,1,1,1,373,2.642857142857143,0.9451272,6
2020-10-05-170105,170105,1,1,6,374,2.357142857142857,1.4516953,0
2020-10-06-170105,170105,2,0,2,376,2.642857142857143,1.4130203,1
2020-10-07-170105,170105,1,0,0,377,2.7857142857142856,1.1515739,2
2020-10-08-170105,170105,0,1,7,377,1.7142857142857142,0.94160706,3
2020-10-09-170105,170105,5,0,6,382,3.1428571428571432,5.9496098,4
2020-10-10-170105,170105,3,0,3,385,1.6428571428571428,1.9960338,5
2020-10-11-170105,170105,0,0,6,385,1.3571428571428572,0.50126314,6
2020-10-12-170105,170105,4,0,2,389,0.5,2.259494,0
2020-10-13-170105,170105,1,0,3,390,2.9285714285714284,1.2307136,1
2020-10-14-170105,170105,5,0,4,395,3.0,3.071517,2
2020-10-15-170105,170105,0,0,20,395,0.5,0.32752115,3
2020-10-16-170105,170105,4,0,8,399,2.071428571428572,2.0785017,4
2020-10-17-170105,170105,1,0,5,400,1.3571428571428572,1.3650334,5
2020-10-18-170105,170105,1,0,1,401,2.8571428571428568,0.8686727,6
2020-10-19-170105,170105,6,1,1,407,4.428571428571429,3.657119,0
2020-10-20-170105,170105,2,0,7,409,3.071428571428572,2.0258527,1
2020-10-21-170105,170105,0,0,11,409,4.428571428571429,1.5128826,2
2020-10-22-170105,170105,7,0,12,416,4.571428571428571,4.017465,3
2020-10-23-170105,170105,6,0,6,422,6.642857142857142,3.451299,4
2020-10-24-170105,170105,3,1,3,425,3.571428571428572,2.8547754,5
2020-10-25-170105,170105,6,0,3,431,6.0,2.597706,6
2020-10-26-170105,170105,2,1,0,433,6.142857142857142,2.2548888,0
2020-10-27-170105,170105,3,1,0,436,4.428571428571429,3.1302555,1
2020-10-28-170105,170105,4,1,1,440,6.0,4.686742,2
2020-10-29-170105,170105,20,0,1,460,6.357142857142858,10.893103,3
2020-10-30-170105,170105,8,0,2,468,8.071428571428571,6.192244,4
2020-10-31-170105,170105,5,1,0,473,3.5,3.4776878,5
2020-11-01-170105,170105,1,0,0,474,5.7142857142857135,2.0854757,6
2020-11-02-170105,170105,1,0,0,475,2.142857142857143,1.0496064,0
2020-11-03-170105,170105,7,0,0,482,3.928571428571429,5.7652745,1
2020-11-04-170105,170105,11,1,0,493,5.357142857142857,4.284685,2
2020-11-05-170105,170105,12,0,0,505,6.7142857142857135,5.4805036,3
2020-11-06-170105,170105,6,1,0,511,8.071428571428571,5.2319026,4
2020-11-07-170105,170105,3,1,0,514,4.428571428571429,2.1220722,5
2020-11-08-170105,170105,3,1,0,517,2.7142857142857144,1.8052427,6
2020-11-09-170105,170105,0,0,0,517,3.7142857142857135,0.71713763,0
2020-11-10-170105,170105,0,0,0,517,3.3571428571428568,1.0523511,1
2020-11-11-170105,170105,1,2,0,518,4.214285714285714,2.2694314,2
2020-11-12-170105,170105,1,0,0,519,5.0,1.9704581,3
2020-11-13-170105,170105,2,2,0,521,4.0,2.3546865,4
2020-03-01-170106,170106,0,0,0,0,0.0,0.00011287253,6
2020-03-02-170106,170106,0,0,1,0,0.0,4.0057095e-08,0
2020-03-03-170106,170106,0,0,0,0,0.0,0.003132093,1
2020-03-04-170106,170106,0,0,1,0,0.0,5.490785e-06,2
2020-03-05-170106,170106,0,2,2,0,0.25,0.011403292,3
2020-03-06-170106,170106,0,0,1,0,0.0,9.659502e-05,4
2020-03-07-170106,170106,0,1,2,0,0.0,0.00020796954,5
2020-03-08-170106,170106,0,0,3,0,0.0,0.0,6
2020-03-09-170106,170106,0,0,4,0,0.0,4.7765934e-05,0
2020-03-10-170106,170106,0,0,2,0,0.0,0.00022188277,1
2020-03-11-170106,170106,0,0,4,0,0.0,0.013009801,2
2020-03-12-170106,170106,2,0,4,2,0.25,0.04435545,3
2020-03-13-170106,170106,1,0,1,3,0.75,0.1110183,4
2020-03-14-170106,170106,0,0,0,3,0.0,0.00012582456,5
2020-03-15-170106,170106,0,0,2,3,0.25,0.012946048,6
2020-03-16-170106,170106,1,0,5,4,1.5,0.08312347,0
2020-03-17-170106,170106,0,0,4,4,1.0,0.054766823,1
2020-03-18-170106,170106,1,0,3,5,2.0,0.19105682,2
2020-03-19-170106,170106,2,0,5,7,3.5,0.28582004,3
2020-03-20-170106,170106,1,0,2,8,3.75,0.106764935,4
2020-03-21-170106,170106,2,0,0,10,0.25,0.04434534,5
2020-03-22-170106,170106,3,0,1,13,0.75,0.039366543,6
2020-03-23-170106,170106,4,0,1,17,4.0,0.2324499,0
2020-03-24-170106,170106,2,0,2,19,2.25,0.1123697,1
2020-03-25-170106,170106,4,0,3,23,1.75,0.14295657,2
2020-03-26-170106,170106,4,0,7,27,3.0,0.1779684,3
2020-03-27-170106,170106,1,0,28,28,2.25,0.12293935,4
2020-03-28-170106,170106,0,0,1,28,1.25,0.04122469,5
2020-03-29-170106,170106,2,0,1,30,2.5,0.08066742,6
2020-03-30-170106,170106,5,0,3,35,2.75,0.20482026,0
2020-03-31-170106,170106,4,0,1,39,2.75,0.13334975,1
2020-04-01-170106,170106,3,0,1,42,5.75,0.19691528,2
2020-04-02-170106,170106,5,0,0,47,8.75,0.32525015,3
2020-04-03-170106,170106,2,0,0,49,4.0,0.16441888,4
2020-04-04-170106,170106,0,0,0,49,2.25,0.053318642,5
2020-04-05-170106,170106,1,0,0,50,1.25,0.042266686,6
2020-04-06-170106,170106,1,0,1,51,4.75,0.2254704,0
2020-04-07-170106,170106,2,0,1,53,5.0,0.26228768,1
2020-04-08-170106,170106,3,0,1,56,3.25,0.1782159,2
2020-04-09-170106,170106,7,0,0,63,1.25,0.08476982,3
2020-04-10-170106,170106,28,0,2,91,10.5,0.35344353,4
2020-04-11-170106,170106,1,0,2,92,2.0,0.048705574,5
2020-04-12-170106,170106,1,0,1,93,0.25,0.07147777,6
2020-04-13-170106,170106,3,0,0,96,3.0,0.11433651,0
2020-04-14-170106,170106,1,0,1,97,2.75,0.23165871,1
2020-04-15-170106,170106,1,0,0,98,2.5,0.10292915,2
2020-04-16-170106,170106,0,0,0,98,2.75,0.1375689,3
2020-04-17-170106,170106,0,0,1,98,2.0,0.10484388,4
2020-04-18-170106,170106,0,0,2,98,0.75,0.029016038,5
2020-04-19-170106,170106,0,0,1,98,0.75,0.05256828,6
2020-04-20-170106,170106,1,0,0,99,2.5,0.15497684,0
2020-04-21-170106,170106,1,0,1,100,1.5,0.12367657,1
2020-04-22-170106,170106,1,0,0,101,1.75,0.09330145,2
2020-04-23-170106,170106,0,0,4,101,0.0,0.01307293,3
2020-04-24-170106,170106,2,0,1,103,2.0,0.09894817,4
2020-04-25-170106,170106,2,0,3,105,0.75,0.051788237,5
2020-04-26-170106,170106,1,0,1,106,0.0,0.005429058,6
2020-04-27-170106,170106,0,0,1,106,2.0,0.09058892,0
2020-04-28-170106,170106,1,0,0,107,1.25,0.064715885,1
2020-04-29-170106,170106,0,0,1,107,2.25,0.14093697,2
2020-04-30-170106,170106,0,0,0,107,0.75,0.039756436,3
2020-05-01-170106,170106,1,0,0,108,0.25,0.00835096,4
2020-05-02-170106,170106,2,0,0,110,0.0,0.073646046,5
2020-05-03-170106,170106,1,0,0,111,0.25,0.02742868,6
2020-05-04-170106,170106,0,0,0,111,0.5,0.054825787,0
2020-05-05-170106,170106,1,0,0,112,0.25,0.035998326,1
2020-05-06-170106,170106,0,0,2,112,2.0,0.09035233,2
2020-05-07-170106,170106,4,0,0,116,0.25,0.108387165,3
2020-05-08-170106,170106,1,0,1,117,6.0,0.22611469,4
2020-05-09-170106,170106,3,0,0,120,1.25,0.07032359,5
2020-05-10-170106,170106,1,0,0,121,0.25,0.04990937,6
2020-05-11-170106,170106,1,0,0,122,1.25,0.15268287,0
2020-05-12-170106,170106,0,0,0,122,1.5,0.12261247,1
2020-05-13-170106,170106,1,0,0,123,0.75,0.048968557,2
2020-05-14-170106,170106,0,0,0,123,1.75,0.080448724,3
2020-05-15-170106,170106,0,0,0,123,1.25,0.058634657,4
2020-05-16-170106,170106,0,0,0,123,0.0,0.002123827,5
2020-05-17-170106,170106,0,0,0,123,0.25,0.021155275,6
2020-05-18-170106,170106,0,0,0,123,0.75,0.09695542,0
2020-05-19-170106,170106,0,0,0,123,0.75,0.060038093,1
2020-05-20-170106,170106,2,0,0,125,0.5,0.04173044,2
2020-05-21-170106,170106,0,0,0,125,0.5,0.050458394,3
2020-05-22-170106,170106,1,0,0,126,1.0,0.06985799,4
2020-05-23-170106,170106,0,0,0,126,0.0,0.010959208,5
2020-05-24-170106,170106,0,0,0,126,0.25,0.017829873,6
2020-05-25-170106,170106,0,0,0,126,2.25,0.09903473,0
2020-05-26-170106,170106,0,0,0,126,1.25,0.091506444,1
2020-05-27-170106,170106,0,0,0,126,0.5,0.015059791,2
2020-05-28-170106,170106,0,0,0,126,3.75,0.2173357,3
2020-05-29-170106,170106,0,0,0,126,0.25,0.02834098,4
2020-05-30-170106,170106,0,0,0,126,0.25,0.008701638,5
2020-05-31-170106,170106,0,0,0,126,0.75,0.039731782,6
2020-06-01-170106,170106,0,0,1,126,0.75,0.03926643,0
2020-06-02-170106,170106,0,0,0,126,1.25,0.13693792,1
2020-06-03-170106,170106,0,0,1,126,1.5,0.07442143,2
2020-06-04-170106,170106,0,0,2,126,0.0,0.014843115,3
2020-06-05-170106,170106,0,0,0,126,0.25,0.018584907,4
2020-06-06-170106,170106,0,1,1,126,0.5,0.02077851,5
2020-06-07-170106,170106,0,0,0,126,0.25,0.0024294013,6
2020-06-08-170106,170106,0,0,0,126,0.75,0.06600009,0
2020-06-09-170106,170106,0,0,0,126,0.5,0.036164075,1
2020-06-10-170106,170106,0,0,0,126,0.25,0.010432342,2
2020-06-11-170106,170106,0,0,0,126,1.0,0.015275941,3
2020-06-12-170106,170106,0,0,0,126,0.25,0.035246428,4
2020-06-13-170106,170106,0,0,0,126,0.0,0.00016638623,5
2020-06-14-170106,170106,0,0,0,126,0.5,0.020434687,6
2020-06-15-170106,170106,1,1,0,127,0.25,0.035928253,0
2020-06-16-170106,170106,0,0,0,127,0.5,0.03943033,1
2020-06-17-170106,170106,1,0,1,128,1.75,0.10454975,2
2020-06-18-170106,170106,2,0,0,130,1.75,0.093190975,3
2020-06-19-170106,170106,0,0,0,130,0.0,0.0047888523,4
2020-06-20-170106,170106,1,0,0,131,0.5,0.064264834,5
2020-06-21-170106,170106,0,0,0,131,1.0,0.042356025,6
2020-06-22-170106,170106,0,0,0,131,0.75,0.038047012,0
2020-06-23-170106,170106,0,0,0,131,0.25,0.03649701,1
2020-06-24-170106,170106,0,0,0,131,0.25,0.029920734,2
2020-06-25-170106,170106,0,1,0,131,0.5,0.020351266,3
2020-06-26-170106,170106,0,0,0,131,0.5,0.06971576,4
2020-06-27-170106,170106,0,0,0,131,0.25,0.016759098,5
2020-06-28-170106,170106,0,0,0,131,0.0,0.023289012,6
2020-06-29-170106,170106,0,0,0,131,0.25,0.035008706,0
2020-06-30-170106,170106,0,0,0,131,0.25,0.023900434,1
2020-07-01-170106,170106,1,0,0,132,0.25,0.034589935,2
2020-07-02-170106,170106,0,0,0,132,0.5,0.06090612,3
2020-07-03-170106,170106,0,0,0,132,0.25,0.020543175,4
2020-07-04-170106,170106,0,0,0,132,0.0,0.0031757383,5
2020-07-05-170106,170106,0,0,0,132,0.0,0.000111154724,6
2020-07-06-170106,170106,0,0,0,132,0.25,0.02953766,0
2020-07-07-170106,170106,0,0,1,132,0.0,0.015974166,1
2020-07-08-170106,170106,0,0,0,132,0.0,0.0036788404,2
2020-07-09-170106,170106,0,0,2,132,0.5,0.017197035,3
2020-07-10-170106,170106,0,2,0,132,0.75,0.11333274,4
2020-07-11-170106,170106,0,0,0,132,0.75,0.09988333,5
2020-07-12-170106,170106,0,0,0,132,0.25,0.0148873525,6
2020-07-13-170106,170106,0,0,0,132,0.5,0.05590058,0
2020-07-14-170106,170106,0,0,0,132,0.5,0.06339111,1
2020-07-15-170106,170106,0,0,0,132,0.25,0.017674502,2
2020-07-16-170106,170106,0,0,0,132,0.25,0.055119183,3
2020-07-17-170106,170106,0,0,1,132,0.75,0.119618885,4
2020-07-18-170106,170106,0,0,0,132,0.5,0.09225941,5
2020-07-19-170106,170106,0,0,0,132,0.0,7.2440314e-05,6
2020-07-20-170106,170106,0,0,0,132,0.75,0.071770966,0
2020-07-21-170106,170106,1,0,0,133,0.0,0.015330863,1
2020-07-22-170106,170106,0,0,1,133,0.25,0.033177525,2
2020-07-23-170106,170106,2,0,0,135,0.0,0.058754366,3
2020-07-24-170106,170106,0,0,1,135,0.0,0.0021547014,4
2020-07-25-170106,170106,0,0,0,135,0.0,0.00017301226,5
2020-07-26-170106,170106,0,0,0,135,0.25,0.011759052,6
2020-07-27-170106,170106,0,1,3,135,0.5,0.047258288,0
2020-07-28-170106,170106,0,0,4,135,0.0,0.02169199,1
2020-07-29-170106,170106,0,0,3,135,0.0,0.00828422,2
2020-07-30-170106,170106,0,0,1,135,0.25,0.033008732,3
2020-07-31-170106,170106,1,0,12,136,0.0,0.11657844,4
2020-08-01-170106,170106,0,0,0,136,0.0,0.0008650153,5
2020-08-02-170106,170106,0,0,0,136,0.0,0.004889251,6
2020-08-03-170106,170106,0,0,0,136,0.5,0.059446514,0
2020-08-04-170106,170106,0,0,1,136,0.75,0.1259934,1
2020-08-05-170106,170106,1,0,0,137,0.75,0.17808129,2
2020-08-06-170106,170106,0,0,1,137,1.0,0.34743685,3
2020-08-07-170106,170106,1,0,2,138,1.0,0.22334538,4
2020-08-08-170106,170106,0,0,0,138,2.75,0.48346078,5
2020-08-09-170106,170106,0,0,0,138,0.0,0.060413584,6
2020-08-10-170106,170106,3,0,0,141,0.25,0.19678986,0
2020-08-11-170106,170106,4,0,1,145,1.75,0.23988605,1
2020-08-12-170106,170106,3,0,0,148,2.0,0.58724725,2
2020-08-13-170106,170106,1,0,1,149,1.75,0.3378069,3
2020-08-14-170106,170106,12,0,0,161,1.25,0.47782534,4
2020-08-15-170106,170106,0,0,0,161,1.0,0.18429913,5
2020-08-16-170106,170106,0,0,1,161,0.75,0.0831967,6
2020-08-17-170106,170106,0,0,0,161,2.0,0.24892415,0
2020-08-18-170106,170106,1,0,1,162,0.75,0.114265375,1
2020-08-19-170106,170106,0,0,0,162,1.25,0.37546533,2
2020-08-20-170106,170106,1,0,0,163,1.75,0.26974046,3
2020-08-21-170106,170106,2,0,6,165,3.0,0.37279204,4
2020-08-22-170106,170106,0,0,0,165,0.5,0.1267323,5
2020-08-23-170106,170106,0,0,1,165,1.0,0.12595582,6
2020-08-24-170106,170106,0,0,0,165,1.25,0.112950966,0
2020-08-25-170106,170106,1,0,0,166,2.0,0.12493972,1
2020-08-26-170106,170106,0,0,0,166,2.75,0.20902911,2
2020-08-27-170106,170106,1,1,0,167,1.75,0.12473001,3
2020-08-28-170106,170106,0,0,1,167,0.5,0.09004536,4
2020-08-29-170106,170106,0,0,1,167,0.75,0.114798166,5
2020-08-30-170106,170106,1,0,0,168,0.75,0.103517465,6
2020-08-31-170106,170106,0,0,0,168,1.0,0.0636852,0
2020-09-01-170106,170106,1,0,0,169,0.5,0.06499676,1
2020-09-02-170106,170106,0,0,2,169,0.25,0.006819777,2
2020-09-03-170106,170106,0,0,0,169,4.25,0.29654673,3
2020-09-04-170106,170106,6,0,3,175,1.5,0.22706491,4
2020-09-05-170106,170106,0,0,0,175,2.75,0.14059561,5
2020-09-06-170106,170106,1,0,0,176,1.5,0.14450224,6
2020-09-07-170106,170106,0,0,2,176,1.5,0.12805273,0
2020-09-08-170106,170106,0,0,4,176,3.0,0.2878665,1
2020-09-09-170106,170106,0,0,1,176,2.75,0.22187035,2
2020-09-10-170106,170106,0,0,1,176,1.75,0.15396076,3
2020-09-11-170106,170106,1,0,1,177,1.75,0.17829832,4
2020-09-12-170106,170106,1,0,0,178,6.75,0.103513874,5
2020-09-13-170106,170106,0,0,0,178,0.5,0.06946062,6
2020-09-14-170106,170106,0,0,1,178,1.5,0.27877805,0
2020-09-15-170106,170106,0,0,0,178,3.25,0.16269827,1
2020-09-16-170106,170106,2,0,0,180,2.5,0.20216665,2
2020-09-17-170106,170106,0,0,1,180,1.0,0.16855997,3
2020-09-18-170106,170106,3,0,1,183,3.5,0.36546493,4
2020-09-19-170106,170106,0,0,0,183,0.75,0.03518658,5
2020-09-20-170106,170106,0,0,0,183,1.5,0.054202035,6
2020-09-21-170106,170106,2,0,0,185,1.5,0.12178397,0
2020-09-22-170106,170106,4,0,1,189,2.25,0.18216012,1
2020-09-23-170106,170106,1,0,0,190,5.25,0.27057558,2
2020-09-24-170106,170106,1,0,3,191,2.25,0.1721566,3
2020-09-25-170106,170106,1,0,2,192,4.5,0.24029577,4
2020-09-26-170106,170106,0,0,0,192,1.75,0.105824605,5
2020-09-27-170106,170106,0,0,0,192,0.0,0.004256652,6
2020-09-28-170106,170106,1,0,1,193,1.5,0.15370828,0
2020-09-29-170106,170106,0,0,0,193,2.0,0.16413014,1
2020-09-30-170106,170106,0,0,0,193,3.25,0.14006813,2
2020-10-01-170106,170106,1,0,0,194,2.25,0.15710306,3
2020-10-02-170106,170106,1,0,0,195,1.75,0.10972069,4
2020-10-03-170106,170106,0,0,0,195,0.75,0.091626465,5
2020-10-04-170106,170106,0,0,0,195,1.5,0.094069146,6
2020-10-05-170106,170106,0,0,0,195,2.25,0.12420033,0
2020-10-06-170106,170106,1,1,0,196,1.75,0.12225936,1
2020-10-07-170106,170106,0,0,1,196,2.5,0.19248687,2
2020-10-08-170106,170106,3,1,0,199,1.5,0.17296045,3
2020-10-09-170106,170106,2,0,2,201,1.25,0.27938965,4
2020-10-10-170106,170106,0,0,0,201,0.5,0.12876536,5
2020-10-11-170106,170106,0,0,0,201,0.25,0.045248322,6
2020-10-12-170106,170106,1,0,0,202,1.0,0.12387392,0
2020-10-13-170106,170106,0,0,0,202,1.25,0.104050115,1
2020-10-14-170106,170106,0,0,1,202,2.75,0.24585377,2
2020-10-15-170106,170106,0,0,2,202,1.0,0.03984474,3
2020-10-16-170106,170106,0,0,0,202,0.25,0.10631588,4
2020-10-17-170106,170106,0,0,0,202,0.25,0.03942115,5
2020-10-18-170106,170106,0,0,2,202,2.0,0.09436087,6
2020-10-19-170106,170106,0,0,0,202,1.25,0.21699849,0
2020-10-20-170106,170106,0,0,0,202,1.5,0.12151623,1
2020-10-21-170106,170106,1,1,0,203,1.75,0.2004265,2
2020-10-22-170106,170106,0,0,1,203,2.0,0.20198688,3
2020-10-23-170106,170106,2,0,2,205,4.5,0.25265968,4
2020-10-24-170106,170106,0,0,1,205,0.5,0.08380037,5
2020-10-25-170106,170106,0,0,2,205,1.75,0.14278261,6
2020-10-26-170106,170106,0,0,3,205,5.5,0.28436163,0
2020-10-27-170106,170106,0,0,2,205,2.75,0.19142635,1
2020-10-28-170106,170106,1,1,3,206,3.0,0.2823291,2
2020-10-29-170106,170106,2,0,1,208,3.0,0.369962,3
2020-10-30-170106,170106,0,0,3,208,7.75,0.5036891,4
2020-10-31-170106,170106,0,1,0,208,2.75,0.30752364,5
2020-11-01-170106,170106,2,0,0,210,7.5,0.38850647,6
2020-11-02-170106,170106,0,0,0,210,1.5,0.10212466,0
2020-11-03-170106,170106,0,1,0,210,3.0,0.26796016,1
2020-11-04-170106,170106,0,0,0,210,7.25,0.45907563,2
2020-11-05-170106,170106,1,0,0,211,7.5,0.42578235,3
2020-11-06-170106,170106,2,0,0,213,6.25,0.43630937,4
2020-11-07-170106,170106,1,0,0,214,3.0,0.17222373,5
2020-11-08-170106,170106,2,0,0,216,1.5,0.11830332,6
2020-11-09-170106,170106,3,0,0,219,1.75,0.13219447,0
2020-11-10-170106,170106,2,0,0,221,1.75,0.15721902,1
2020-11-11-170106,170106,3,0,0,224,4.5,0.3869519,2
2020-11-12-170106,170106,1,1,0,225,4.0,0.29778385,3
2020-11-13-170106,170106,3,1,0,228,5.25,0.21941437,4
2020-03-01-170107,170107,0,0,1,0,0.0,0.027471129,6
2020-03-02-170107,170107,0,0,4,0,0.0,0.0026641495,0
2020-03-03-170107,170107,0,0,6,0,0.0,0.04990036,1
2020-03-04-170107,170107,0,1,23,0,0.0,0.002119319,2
2020-03-05-170107,170107,0,0,60,0,0.0,0.031446185,3
2020-03-06-170107,170107,0,0,38,0,0.0,0.0069433223,4
2020-03-07-170107,170107,0,0,9,0,0.0,0.006885715,5
2020-03-08-170107,170107,0,0,21,0,0.0,0.00092884735,6
2020-03-09-170107,170107,0,0,55,0,0.5,0.008133366,0
2020-03-10-170107,170107,0,0,49,0,0.0,0.0353669,1
2020-03-11-170107,170107,0,0,44,0,1.0,0.30489352,2
2020-03-12-170107,170107,2,0,28,2,0.5,0.103600465,3
2020-03-13-170107,170107,0,0,34,2,2.75,0.7522732,4
2020-03-14-170107,170107,0,0,10,2,0.75,0.04106291,5
2020-03-15-170107,170107,1,0,8,3,0.75,0.069960594,6
2020-03-16-170107,170107,4,0,29,7,6.5,0.75508416,0
2020-03-17-170107,170107,6,0,35,13,5.5,0.34667718,1
2020-03-18-170107,170107,23,0,11,36,15.75,1.9386121,2
2020-03-19-170107,170107,60,0,21,96,13.0,1.7771535,3
2020-03-20-170107,170107,38,0,25,134,15.0,1.0313854,4
2020-03-21-170107,170107,9,0,6,143,8.0,0.24862683,5
2020-03-22-170107,170107,21,0,7,164,8.5,0.30410188,6
2020-03-23-170107,170107,55,0,24,219,21.0,2.8096354,0
2020-03-24-170107,170107,49,0,21,268,15.75,1.1144121,1
2020-03-25-170107,170107,44,0,10,312,16.0,2.024364,2
2020-03-26-170107,170107,28,0,14,340,15.75,1.4587181,3
2020-03-27-170107,170107,34,0,7,374,18.25,1.1076349,4
2020-03-28-170107,170107,10,0,4,384,5.75,0.45335764,5
2020-03-29-170107,170107,8,0,5,392,4.25,0.38999227,6
2020-03-30-170107,170107,29,0,22,421,12.25,1.5244417,0
2020-03-31-170107,170107,35,0,17,456,10.75,1.9857545,1
2020-04-01-170107,170107,11,0,19,467,10.5,1.2311515,2
2020-04-02-170107,170107,21,0,8,488,9.5,2.097216,3
2020-04-03-170107,170107,25,0,7,513,10.75,0.9401938,4
2020-04-04-170107,170107,6,0,1,519,3.25,0.14983103,5
2020-04-05-170107,170107,7,0,2,526,2.75,0.21109422,6
2020-04-06-170107,170107,24,0,34,550,10.75,1.7203757,0
2020-04-07-170107,170107,21,0,7,571,8.75,1.0810672,1
2020-04-08-170107,170107,10,0,7,581,6.75,0.48437038,2
2020-04-09-170107,170107,14,0,0,595,6.0,0.6443904,3
2020-04-10-170107,170107,7,0,6,602,6.75,0.94647056,4
2020-04-11-170107,170107,4,0,2,606,2.75,0.057611905,5
2020-04-12-170107,170107,5,1,2,611,2.75,0.8366066,6
2020-04-13-170107,170107,22,0,11,633,5.25,0.8818032,0
2020-04-14-170107,170107,17,0,4,650,9.25,3.067842,1
2020-04-15-170107,170107,19,0,3,669,4.75,0.9919229,2
2020-04-16-170107,170107,8,0,4,677,6.5,1.4477043,3
2020-04-17-170107,170107,7,0,0,684,5.5,0.65239936,4
2020-04-18-170107,170107,1,0,1,685,0.25,0.24172483,5
2020-04-19-170107,170107,2,0,1,687,1.5,0.45082358,6
2020-04-20-170107,170107,34,0,12,721,6.5,1.326629,0
2020-04-21-170107,170107,7,0,9,728,4.0,1.4149408,1
2020-04-22-170107,170107,7,0,10,735,4.25,0.54283357,2
2020-04-23-170107,170107,0,0,3,735,1.5,0.17000978,3
2020-04-24-170107,170107,6,0,7,741,2.75,0.22860453,4
2020-04-25-170107,170107,2,0,1,743,0.5,0.057344537,5
2020-04-26-170107,170107,2,0,2,745,1.25,0.010806748,6
2020-04-27-170107,170107,11,0,10,756,3.25,0.34790596,0
2020-04-28-170107,170107,4,0,6,760,2.5,0.3631707,1
2020-04-29-170107,170107,3,0,3,763,4.0,0.94470876,2
2020-04-30-170107,170107,4,0,7,767,2.25,0.5106986,3
2020-05-01-170107,170107,0,0,7,767,0.25,0.009814264,4
2020-05-02-170107,170107,1,0,5,768,2.25,0.77976835,5
2020-05-03-170107,170107,1,0,1,769,0.75,0.1582441,6
2020-05-04-170107,170107,12,0,20,781,3.25,1.010903,0
2020-05-05-170107,170107,9,0,2,790,3.25,0.3852629,1
2020-05-06-170107,170107,10,0,5,800,4.5,0.4850946,2
2020-05-07-170107,170107,3,0,6,803,2.5,0.8329703,3
2020-05-08-170107,170107,7,0,2,810,5.5,1.0093316,4
2020-05-09-170107,170107,1,0,1,811,0.5,0.19179396,5
2020-05-10-170107,170107,2,0,3,813,1.0,0.27672637,6
2020-05-11-170107,170107,10,0,3,823,7.75,1.584319,0
2020-05-12-170107,170107,6,0,4,829,3.5,0.76156753,1
2020-05-13-170107,170107,3,0,3,832,2.0,0.17586228,2
2020-05-14-170107,170107,7,1,2,839,1.75,0.5271659,3
2020-05-15-170107,170107,7,0,3,846,3.75,0.2967828,4
2020-05-16-170107,170107,5,0,0,851,0.75,0.08273649,5
2020-05-17-170107,170107,1,0,0,852,0.5,0.14436245,6
2020-05-18-170107,170107,20,1,1,872,14.75,1.4528029,0
2020-05-19-170107,170107,2,0,4,874,2.0,0.34095863,1
2020-05-20-170107,170107,5,0,0,879,1.5,0.36558294,2
2020-05-21-170107,170107,6,0,3,885,1.5,0.5614765,3
2020-05-22-170107,170107,2,0,1,887,1.5,0.5208266,4
2020-05-23-170107,170107,1,0,0,888,0.5,0.19551487,5
2020-05-24-170107,170107,3,0,1,891,0.0,0.03004092,6
2020-05-25-170107,170107,3,0,3,894,1.5,0.36542743,0
2020-05-26-170107,170107,4,0,0,898,1.75,0.7228934,1
2020-05-27-170107,170107,3,0,3,901,1.25,0.2228778,2
2020-05-28-170107,170107,2,0,0,903,2.25,1.0209723,3
2020-05-29-170107,170107,3,2,1,906,1.5,0.45966133,4
2020-05-30-170107,170107,0,0,0,906,0.0,0.016355079,5
2020-05-31-170107,170107,0,0,0,906,0.0,0.08503438,6
2020-06-01-170107,170107,1,0,1,907,1.5,0.06519533,0
2020-06-02-170107,170107,4,0,3,911,3.0,1.556688,1
2020-06-03-170107,170107,0,0,3,911,1.25,0.3830001,2
2020-06-04-170107,170107,3,0,2,914,1.0,0.39348826,3
2020-06-05-170107,170107,1,0,1,915,1.25,0.21073556,4
2020-06-06-170107,170107,0,1,1,915,0.0,0.033280157,5
2020-06-07-170107,170107,1,0,0,916,0.0,0.0015751519,6
2020-06-08-170107,170107,3,0,3,919,0.75,0.43926936,0
2020-06-09-170107,170107,0,0,2,919,0.75,0.44729918,1
2020-06-10-170107,170107,3,0,1,922,0.5,0.075276755,2
2020-06-11-170107,170107,0,0,3,922,0.0,0.05919718,3
2020-06-12-170107,170107,1,0,2,923,1.25,0.65725905,4
2020-06-13-170107,170107,0,0,0,923,0.25,0.026722115,5
2020-06-14-170107,170107,0,0,0,923,0.0,0.03070232,6
2020-06-15-170107,170107,1,0,3,924,1.0,0.36273104,0
2020-06-16-170107,170107,3,0,2,927,1.0,0.36519292,1
2020-06-17-170107,170107,3,0,0,930,1.0,0.39711678,2
2020-06-18-170107,170107,2,0,0,932,0.25,0.10646312,3
2020-06-19-170107,170107,1,0,1,933,0.75,0.47061056,4
2020-06-20-170107,170107,1,0,1,934,0.0,0.113365434,5
2020-06-21-170107,170107,0,0,0,934,0.0,0.043150976,6
2020-06-22-170107,170107,3,0,1,937,1.0,0.33323938,0
2020-06-23-170107,170107,2,0,2,939,0.5,0.479084,1
2020-06-24-170107,170107,1,0,0,940,0.25,0.2661014,2
2020-06-25-170107,170107,3,5,2,943,0.5,0.19919997,3
2020-06-26-170107,170107,2,0,0,945,0.5,0.18601623,4
2020-06-27-170107,170107,0,1,1,945,0.0,0.03702157,5
2020-06-28-170107,170107,0,0,1,945,0.75,0.38760465,6
2020-06-29-170107,170107,3,0,0,948,0.25,0.33061656,0
2020-06-30-170107,170107,2,0,0,950,1.25,0.08394826,1
2020-07-01-170107,170107,0,0,0,950,0.75,0.11488162,2
2020-07-02-170107,170107,0,1,1,950,0.5,0.40420976,3
2020-07-03-170107,170107,1,0,0,951,0.5,0.07694786,4
2020-07-04-170107,170107,1,0,1,952,0.0,0.031365637,5
2020-07-05-170107,170107,0,0,0,952,0.25,0.018286537,6
2020-07-06-170107,170107,1,0,0,953,0.5,0.15953372,0
2020-07-07-170107,170107,2,0,0,955,0.25,0.3305178,1
2020-07-08-170107,170107,0,0,0,955,0.25,0.080363624,2
2020-07-09-170107,170107,2,0,0,957,0.0,0.07965855,3
2020-07-10-170107,170107,0,0,1,957,0.75,0.85479957,4
2020-07-11-170107,170107,1,0,0,958,0.25,0.23427801,5
2020-07-12-170107,170107,1,0,0,959,0.0,0.09311245,6
2020-07-13-170107,170107,0,0,0,959,0.25,0.50153315,0
2020-07-14-170107,170107,0,0,0,959,0.0,0.3866538,1
2020-07-15-170107,170107,0,0,1,959,0.0,0.35371614,2
2020-07-16-170107,170107,1,0,0,960,0.0,0.09873626,3
2020-07-17-170107,170107,0,0,0,960,0.25,0.77701175,4
2020-07-18-170107,170107,1,0,0,961,0.0,0.13093205,5
2020-07-19-170107,170107,0,0,0,961,0.0,0.054226656,6
2020-07-20-170107,170107,0,0,0,961,0.0,0.16663104,0
2020-07-21-170107,170107,0,0,0,961,0.0,0.02465671,1
2020-07-22-170107,170107,0,0,0,961,0.5,0.14161517,2
2020-07-23-170107,170107,0,0,0,961,0.5,0.3387307,3
2020-07-24-170107,170107,1,0,0,962,0.25,0.036585316,4
2020-07-25-170107,170107,0,2,0,962,0.0,0.008977176,5
2020-07-26-170107,170107,0,0,0,962,0.0,0.013988765,6
2020-07-27-170107,170107,0,0,2,962,0.0,0.28880656,0
2020-07-28-170107,170107,0,0,8,962,0.25,0.3277571,1
2020-07-29-170107,170107,1,0,8,963,0.0,0.16806959,2
2020-07-30-170107,170107,0,0,6,963,0.0,0.12176509,3
2020-07-31-170107,170107,0,0,3,963,0.75,0.9419141,4
2020-08-01-170107,170107,0,0,1,963,0.0,0.023658326,5
2020-08-02-170107,170107,0,0,0,963,0.0,0.10956777,6
2020-08-03-170107,170107,0,0,2,963,0.0,0.20936531,0
2020-08-04-170107,170107,0,0,1,963,0.0,0.25856325,1
2020-08-05-170107,170107,0,0,0,963,0.5,0.9287449,2
2020-08-06-170107,170107,0,0,1,963,0.75,1.1354975,3
2020-08-07-170107,170107,0,0,1,963,0.25,1.1670343,4
2020-08-08-170107,170107,0,0,1,963,0.25,0.48126087,5
2020-08-09-170107,170107,0,0,0,963,0.5,0.37812763,6
2020-08-10-170107,170107,2,0,1,965,1.0,0.9361129,0
2020-08-11-170107,170107,8,0,3,973,0.25,1.3421283,1
2020-08-12-170107,170107,8,0,4,981,1.5,2.064189,2
2020-08-13-170107,170107,6,0,3,987,0.75,0.8981918,3
2020-08-14-170107,170107,3,0,6,990,1.25,1.5492463,4
2020-08-15-170107,170107,1,0,0,991,0.5,0.62575144,5
2020-08-16-170107,170107,0,0,0,991,0.5,0.38975278,6
2020-08-17-170107,170107,2,1,3,993,0.25,0.8353478,0
2020-08-18-170107,170107,1,0,3,994,0.25,0.48903805,1
2020-08-19-170107,170107,0,0,1,994,2.25,1.4061629,2
2020-08-20-170107,170107,1,0,1,995,2.75,0.87267685,3
2020-08-21-170107,170107,1,0,5,996,0.0,1.4781893,4
2020-08-22-170107,170107,1,0,5,997,0.5,0.63462853,5
2020-08-23-170107,170107,0,0,0,997,0.5,0.6061056,6
2020-08-24-170107,170107,1,1,3,998,1.75,0.9879243,0
2020-08-25-170107,170107,3,0,2,1001,2.0,0.8215946,1
2020-08-26-170107,170107,4,0,4,1005,0.75,0.7931661,2
2020-08-27-170107,170107,3,0,3,1008,3.75,0.35029218,3
2020-08-28-170107,170107,6,0,4,1014,1.0,0.6690997,4
2020-08-29-170107,170107,0,0,1,1014,0.5,0.87712,5
2020-08-30-170107,170107,0,0,2,1014,0.75,1.3542485,6
2020-08-31-170107,170107,3,0,5,1017,0.25,0.3502741,0
2020-09-01-170107,170107,3,0,3,1020,0.5,0.38925338,1
2020-09-02-170107,170107,1,0,4,1021,2.0,0.25125268,2
2020-09-03-170107,170107,1,1,6,1022,2.25,1.2127082,3
2020-09-04-170107,170107,5,0,5,1027,2.0,1.5497588,4
2020-09-05-170107,170107,5,0,0,1032,1.0,0.2483393,5
2020-09-06-170107,170107,0,0,4,1032,1.25,1.1070722,6
2020-09-07-170107,170107,3,0,6,1035,3.0,0.65235597,0
2020-09-08-170107,170107,2,0,3,1037,3.5,1.5625385,1
2020-09-09-170107,170107,4,0,4,1041,1.25,1.553646,2
2020-09-10-170107,170107,3,0,8,1044,2.25,0.93958825,3
2020-09-11-170107,170107,4,0,6,1048,1.75,2.2417862,4
2020-09-12-170107,170107,1,0,2,1049,1.25,0.13921714,5
2020-09-13-170107,170107,2,0,3,1051,1.75,0.59265864,6
2020-09-14-170107,170107,5,0,5,1056,3.75,2.1866167,0
2020-09-15-170107,170107,3,0,1,1059,1.75,0.73357105,1
2020-09-16-170107,170107,4,0,4,1063,3.0,1.2469616,2
2020-09-17-170107,170107,6,0,8,1069,1.5,0.90685374,3
2020-09-18-170107,170107,5,0,9,1074,5.5,2.4222064,4
2020-09-19-170107,170107,0,0,5,1074,2.0,0.2257006,5
2020-09-20-170107,170107,4,0,6,1078,4.5,0.35037315,6
2020-09-21-170107,170107,6,1,6,1084,3.25,0.56553996,0
2020-09-22-170107,170107,3,0,6,1087,1.5,1.3557429,1
2020-09-23-170107,170107,4,1,7,1091,3.0,1.8564587,2
2020-09-24-170107,170107,8,0,3,1099,3.75,1.6661478,3
2020-09-25-170107,170107,6,0,12,1105,3.5,2.537941,4
2020-09-26-170107,170107,2,0,7,1107,2.25,0.9244706,5
2020-09-27-170107,170107,3,0,0,1110,1.0,0.13809837,6
2020-09-28-170107,170107,5,0,1,1115,4.5,1.4730648,0
2020-09-29-170107,170107,1,0,12,1116,1.0,0.75591594,1
2020-09-30-170107,170107,4,0,9,1120,2.25,1.3469696,2
2020-10-01-170107,170107,8,0,0,1128,2.0,1.0417427,3
2020-10-02-170107,170107,9,0,7,1137,4.25,1.7746838,4
2020-10-03-170107,170107,5,0,1,1142,3.25,1.0414244,5
2020-10-04-170107,170107,6,0,8,1148,2.25,0.92697364,6
2020-10-05-170107,170107,6,0,14,1154,1.5,1.0347592,0
2020-10-06-170107,170107,6,0,4,1160,1.75,0.85338473,1
2020-10-07-170107,170107,7,0,12,1167,3.25,0.7319588,2
2020-10-08-170107,170107,3,0,7,1170,1.5,0.9048086,3
2020-10-09-170107,170107,12,2,16,1182,4.25,3.052988,4
2020-10-10-170107,170107,7,0,5,1189,3.0,1.3819674,5
2020-10-11-170107,170107,0,0,22,1189,2.25,0.640361,6
2020-10-12-170107,170107,1,0,14,1190,1.0,1.3035494,0
2020-10-13-170107,170107,12,0,12,1202,2.75,1.0093427,1
2020-10-14-170107,170107,9,0,9,1211,5.25,1.8161988,2
2020-10-15-170107,170107,0,0,7,1211,0.25,0.2533768,3
2020-10-16-170107,170107,7,0,9,1218,2.25,1.1786599,4
2020-10-17-170107,170107,1,0,4,1219,0.5,0.73500013,5
2020-10-18-170107,170107,8,0,7,1227,3.25,0.560532,6
2020-10-19-170107,170107,14,0,2,1241,5.0,2.3709216,0
2020-10-20-170107,170107,4,0,7,1245,3.5,0.9974266,1
2020-10-21-170107,170107,12,0,8,1257,4.5,0.84696645,2
2020-10-22-170107,170107,7,0,11,1264,7.25,2.475145,3
2020-10-23-170107,170107,16,0,13,1280,10.5,2.085599,4
2020-10-24-170107,170107,5,2,9,1285,3.5,1.2875363,5
2020-10-25-170107,170107,22,0,5,1307,8.5,1.4128275,6
2020-10-26-170107,170107,14,0,7,1321,6.75,1.2964789,0
2020-10-27-170107,170107,12,1,8,1333,3.75,1.8238391,1
2020-10-28-170107,170107,9,0,8,1342,3.75,2.5430794,2
2020-10-29-170107,170107,7,0,15,1349,11.0,6.1647854,3
2020-10-30-170107,170107,9,0,3,1358,10.0,3.3969402,4
2020-10-31-170107,170107,4,0,0,1362,4.75,1.9911705,5
2020-11-01-170107,170107,7,0,0,1369,5.25,1.2743039,6
2020-11-02-170107,170107,2,0,0,1371,2.25,0.6550709,0
2020-11-03-170107,170107,7,0,0,1378,4.0,3.7023518,1
2020-11-04-170107,170107,8,0,0,1386,9.0,2.7321653,2
2020-11-05-170107,170107,11,0,0,1397,7.0,3.9131143,3
2020-11-06-170107,170107,13,0,0,1410,7.25,3.2094378,4
2020-11-07-170107,170107,9,1,0,1419,4.75,1.3140508,5
2020-11-08-170107,170107,5,0,0,1424,4.75,1.3752651,6
2020-11-09-170107,170107,7,0,0,1431,5.5,0.48178387,0
2020-11-10-170107,170107,8,0,0,1439,3.25,0.5622158,1
2020-11-11-170107,170107,8,1,0,1447,4.25,1.2172707,2
2020-11-12-170107,170107,15,1,0,1462,5.25,1.1307671,3
2020-11-13-170107,170107,3,0,0,1465,4.5,1.8863128,4
2020-03-01-170108,170108,0,0,0,0,0.0,0.0022058939,6
2020-03-02-170108,170108,0,0,0,0,0.0,0.016134331,0
2020-03-03-170108,170108,0,1,0,0,0.2,0.14802387,1
2020-03-04-170108,170108,0,2,0,0,0.0,0.00057004485,2
2020-03-05-170108,170108,0,5,1,0,0.0,0.0009793954,3
2020-03-06-170108,170108,0,0,0,0,0.0,0.0008229653,4
2020-03-07-170108,170108,0,0,0,0,0.0,0.0008351405,5
2020-03-08-170108,170108,0,0,0,0,0.0,0.00014279051,6
2020-03-09-170108,170108,0,0,1,0,0.0,0.003326422,0
2020-03-10-170108,170108,0,0,0,0,0.0,0.0015723141,1
2020-03-11-170108,170108,0,0,2,0,0.0,0.01569219,2
2020-03-12-170108,170108,0,0,0,0,0.2,0.026912997,3
2020-03-13-170108,170108,1,0,3,1,0.6,0.6833373,4
2020-03-14-170108,170108,0,0,0,1,0.2,0.013953032,5
2020-03-15-170108,170108,0,0,2,1,0.8,0.12838002,6
2020-03-16-170108,170108,0,0,2,1,1.6,0.14185616,0
2020-03-17-170108,170108,0,1,3,1,2.2,0.12738375,1
2020-03-18-170108,170108,0,1,0,1,4.8,0.38588703,2
2020-03-19-170108,170108,1,0,4,2,4.6,1.2019922,3
2020-03-20-170108,170108,0,1,2,2,2.6,0.2901676,4
2020-03-21-170108,170108,0,0,1,2,0.8,0.08676964,5
2020-03-22-170108,170108,0,1,1,2,1.6,0.5467933,6
2020-03-23-170108,170108,1,0,5,3,8.2,1.7127441,0
2020-03-24-170108,170108,0,0,3,3,3.2,0.30406877,1
2020-03-25-170108,170108,2,0,3,5,7.4,1.9662824,2
2020-03-26-170108,170108,0,0,11,5,6.0,0.5128107,3
2020-03-27-170108,170108,3,0,2,8,8.0,1.844379,4
2020-03-28-170108,170108,0,0,1,8,2.0,0.043707874,5
2020-03-29-170108,170108,2,0,0,10,2.8,1.0871305,6
2020-03-30-170108,170108,2,0,6,12,6.4,1.8164121,0
2020-03-31-170108,170108,3,0,2,15,6.2,1.6880641,1
2020-04-01-170108,170108,0,0,17,15,6.4,0.41783834,2
2020-04-02-170108,170108,4,0,3,19,3.8,2.36605,3
2020-04-03-170108,170108,2,0,8,21,4.8,1.4762434,4
2020-04-04-170108,170108,1,0,0,22,2.0,0.56927127,5
2020-04-05-170108,170108,1,0,1,23,1.2,0.49634635,6
2020-04-06-170108,170108,5,0,3,28,5.8,3.0703847,0
2020-04-07-170108,170108,3,0,2,31,5.8,1.8074236,1
2020-04-08-170108,170108,3,0,0,34,3.0,1.9607669,2
2020-04-09-170108,170108,11,0,0,45,4.8,4.6778364,3
2020-04-10-170108,170108,2,0,0,47,1.2,0.99802005,4
2020-04-11-170108,170108,1,0,0,48,1.0,0.4407307,5
2020-04-12-170108,170108,0,2,0,48,1.4,0.07200634,6
2020-04-13-170108,170108,6,0,2,54,3.2,3.7583578,0
2020-04-14-170108,170108,2,0,1,56,3.4,1.5320246,1
2020-04-15-170108,170108,17,1,6,73,2.4,9.795884,2
2020-04-16-170108,170108,3,0,0,76,2.2,1.954688,3
2020-04-17-170108,170108,8,0,1,84,2.6,3.9995155,4
2020-04-18-170108,170108,0,0,0,84,0.8,0.2039472,5
2020-04-19-170108,170108,1,0,0,85,0.4,0.54335403,6
2020-04-20-170108,170108,3,0,1,88,2.2,1.9057282,0
2020-04-21-170108,170108,2,0,2,90,2.2,1.3353329,1
2020-04-22-170108,170108,0,0,1,90,1.2,0.2878192,2
2020-04-23-170108,170108,0,0,0,90,1.4,0.043615997,3
2020-04-24-170108,170108,0,0,1,90,1.4,0.086164095,4
2020-04-25-170108,170108,0,0,0,90,0.4,0.024248183,5
2020-04-26-170108,170108,0,0,1,90,0.2,0.0075983265,6
2020-04-27-170108,170108,2,0,0,92,2.4,1.2448536,0
2020-04-28-170108,170108,1,0,2,93,1.6,1.0347638,1
2020-04-29-170108,170108,6,0,1,99,2.2,3.8764694,2
2020-04-30-170108,170108,0,0,1,99,1.4,0.09751518,3
2020-05-01-170108,170108,1,0,0,100,0.6,0.31039414,4
2020-05-02-170108,170108,0,0,0,100,0.4,0.08300985,5
2020-05-03-170108,170108,0,0,0,100,0.0,0.011841168,6
2020-05-04-170108,170108,1,0,0,101,2.2,0.70632577,0
2020-05-05-170108,170108,2,0,0,103,1.4,1.3325313,1
2020-05-06-170108,170108,1,0,2,104,18.0,1.6792254,2
2020-05-07-170108,170108,0,0,2,104,6.0,0.65602255,3
2020-05-08-170108,170108,1,0,1,105,3.4,0.9767576,4
2020-05-09-170108,170108,0,0,2,105,0.0,0.017218158,5
2020-05-10-170108,170108,1,0,0,106,0.0,0.52896315,6
2020-05-11-170108,170108,0,0,0,106,3.2,0.20230825,0
2020-05-12-170108,170108,2,0,3,108,1.8,1.2789223,1
2020-05-13-170108,170108,1,0,1,109,2.4,0.8481736,2
2020-05-14-170108,170108,1,1,1,110,2.2,0.8640892,3
2020-05-15-170108,170108,0,0,0,110,0.6,0.04278099,4
2020-05-16-170108,170108,0,0,0,110,0.0,0.0077904356,5
2020-05-17-170108,170108,0,0,0,110,0.0,0.012450774,6
2020-05-18-170108,170108,0,2,0,110,1.0,0.61918443,0
2020-05-19-170108,170108,0,0,0,110,1.0,0.10316515,1
2020-05-20-170108,170108,2,0,1,112,1.0,1.6985315,2
2020-05-21-170108,170108,2,0,1,114,2.2,1.948886,3
2020-05-22-170108,170108,1,0,1,115,1.2,1.0678217,4
2020-05-23-170108,170108,2,0,1,117,0.2,1.2433766,5
2020-05-24-170108,170108,0,0,0,117,0.0,0.018202778,6
2020-05-25-170108,170108,0,0,2,117,0.6,0.26063517,0
2020-05-26-170108,170108,3,0,0,120,0.2,1.9032571,1
2020-05-27-170108,170108,1,0,0,121,0.6,0.69765705,2
2020-05-28-170108,170108,1,0,0,122,0.4,0.8706572,3
2020-05-29-170108,170108,0,11,0,122,1.2,0.06686447,4
2020-05-30-170108,170108,0,0,0,122,0.2,0.002709518,5
2020-05-31-170108,170108,0,0,0,122,0.0,0.0043709516,6
2020-06-01-170108,170108,0,0,0,122,1.4,0.09875752,0
2020-06-02-170108,170108,0,0,0,122,0.8,0.3423216,1
2020-06-03-170108,170108,1,0,1,123,0.8,0.6827078,2
2020-06-04-170108,170108,1,0,0,124,1.0,0.6784776,3
2020-06-05-170108,170108,1,0,1,125,0.6,0.86589813,4
2020-06-06-170108,170108,1,6,0,126,0.0,0.7419861,5
2020-06-07-170108,170108,0,1,0,126,0.0,0.00014137731,6
2020-06-08-170108,170108,2,0,0,128,0.6,1.4200169,0
2020-06-09-170108,170108,0,0,0,128,1.0,0.10749461,1
2020-06-10-170108,170108,0,0,2,128,0.2,0.030789401,2
2020-06-11-170108,170108,0,0,0,128,0.8,0.0344255,3
2020-06-12-170108,170108,0,0,1,128,0.2,0.04012145,4
2020-06-13-170108,170108,0,0,0,128,0.2,0.016068455,5
2020-06-14-170108,170108,0,0,0,128,0.2,0.010697218,6
2020-06-15-170108,170108,0,0,0,128,0.0,0.015840158,0
2020-06-16-170108,170108,0,0,0,128,0.4,0.05336349,1
2020-06-17-170108,170108,1,0,0,129,1.0,0.7872552,2
2020-06-18-170108,170108,0,0,1,129,0.6,0.048511907,3
2020-06-19-170108,170108,1,0,0,130,0.2,0.68321395,4
2020-06-20-170108,170108,0,0,0,130,0.0,0.005767019,5
2020-06-21-170108,170108,0,0,0,130,0.0,0.0011687573,6
2020-06-22-170108,170108,0,0,0,130,0.2,0.038362376,0
2020-06-23-170108,170108,0,0,0,130,0.2,0.060296882,1
2020-06-24-170108,170108,2,0,0,132,0.0,1.4550223,2
2020-06-25-170108,170108,0,0,0,132,0.2,0.074261084,3
2020-06-26-170108,170108,1,0,0,133,0.0,0.73612416,4
2020-06-27-170108,170108,0,0,0,133,0.4,0.05491159,5
2020-06-28-170108,170108,0,0,0,133,0.0,0.015061645,6
2020-06-29-170108,170108,0,0,0,133,0.8,0.7147524,0
2020-06-30-170108,170108,0,0,0,133,0.0,0.008785222,1
2020-07-01-170108,170108,0,0,0,133,0.2,0.0063008144,2
2020-07-02-170108,170108,1,0,0,134,0.2,0.888535,3
2020-07-03-170108,170108,0,0,0,134,0.2,0.022472931,4
2020-07-04-170108,170108,0,0,0,134,0.0,0.0029110098,5
2020-07-05-170108,170108,0,0,0,134,0.0,0.002517434,6
2020-07-06-170108,170108,0,0,0,134,0.4,0.2712603,0
2020-07-07-170108,170108,0,0,0,134,0.4,0.11717844,1
2020-07-08-170108,170108,0,0,0,134,0.2,0.21904585,2
2020-07-09-170108,170108,0,0,1,134,0.0,0.005906937,3
2020-07-10-170108,170108,0,0,0,134,0.0,0.0599814,4
2020-07-11-170108,170108,0,0,0,134,0.2,0.084281035,5
2020-07-12-170108,170108,0,0,0,134,0.2,0.22141063,6
2020-07-13-170108,170108,0,0,0,134,0.4,0.103437394,0
2020-07-14-170108,170108,0,0,6,134,0.8,0.35369912,1
2020-07-15-170108,170108,0,0,2,134,0.4,0.12682357,2
2020-07-16-170108,170108,0,0,0,134,0.2,0.034047227,3
2020-07-17-170108,170108,0,0,0,134,0.8,0.3297758,4
2020-07-18-170108,170108,0,0,0,134,0.0,0.033348806,5
2020-07-19-170108,170108,0,0,2,134,0.0,0.0029028964,6
2020-07-20-170108,170108,0,0,0,134,0.0,0.01402836,0
2020-07-21-170108,170108,0,0,0,134,0.0,0.020138236,1
2020-07-22-170108,170108,0,0,0,134,0.6,0.29961863,2
2020-07-23-170108,170108,1,0,12,135,0.6,1.3953751,3
2020-07-24-170108,170108,0,0,1,135,0.4,0.028537123,4
2020-07-25-170108,170108,0,0,0,135,0.0,0.0015019516,5
2020-07-26-170108,170108,0,0,0,135,0.2,0.012825949,6
2020-07-27-170108,170108,0,0,3,135,0.4,0.3249629,0
2020-07-28-170108,170108,6,0,1,141,1.2,5.5927944,1
2020-07-29-170108,170108,2,0,1,143,1.0,1.9237211,2
2020-07-30-170108,170108,0,0,4,143,0.4,0.016553504,3
2020-07-31-170108,170108,0,0,2,143,0.2,0.052366164,4
2020-08-01-170108,170108,0,0,4,143,0.4,0.075054824,5
2020-08-02-170108,170108,2,0,0,145,0.2,1.5446694,6
2020-08-03-170108,170108,0,0,3,145,0.6,0.06599431,0
2020-08-04-170108,170108,0,0,1,145,0.4,0.39510846,1
2020-08-05-170108,170108,0,0,4,145,0.6,0.5128957,2
2020-08-06-170108,170108,12,0,2,157,2.2,12.416721,3
2020-08-07-170108,170108,1,0,2,158,2.2,2.3627088,4
2020-08-08-170108,170108,0,0,2,158,0.2,0.26816922,5
2020-08-09-170108,170108,0,0,1,158,0.4,0.10621914,6
2020-08-10-170108,170108,3,0,2,161,1.2,3.6866891,0
2020-08-11-170108,170108,1,0,3,162,2.6,2.7470922,1
2020-08-12-170108,170108,1,0,0,163,1.2,1.6758125,2
2020-08-13-170108,170108,4,0,5,167,2.2,5.6638246,3
2020-08-14-170108,170108,2,0,4,169,1.0,2.8601027,4
2020-08-15-170108,170108,4,0,1,173,1.0,4.4296904,5
2020-08-16-170108,170108,0,0,1,173,0.4,0.20691061,6
2020-08-17-170108,170108,3,1,3,176,2.4,3.691068,0
2020-08-18-170108,170108,1,0,1,177,1.0,1.3369104,1
2020-08-19-170108,170108,4,0,1,181,2.2,4.740557,2
2020-08-20-170108,170108,2,0,0,183,13.0,2.9990876,3
2020-08-21-170108,170108,2,0,15,185,4.6,3.746013,4
2020-08-22-170108,170108,2,0,1,187,6.4,2.1763241,5
2020-08-23-170108,170108,1,0,3,188,0.8,1.1340215,6
2020-08-24-170108,170108,2,0,0,190,1.6,2.7119617,0
2020-08-25-170108,170108,3,1,0,193,2.6,3.2993455,1
2020-08-26-170108,170108,0,0,1,193,1.4,0.4160011,2
2020-08-27-170108,170108,5,0,0,198,1.0,4.80532,3
2020-08-28-170108,170108,4,0,0,202,1.0,3.1603866,4
2020-08-29-170108,170108,1,0,0,203,4.2,0.50010383,5
2020-08-30-170108,170108,1,0,0,204,1.2,1.2211357,6
2020-08-31-170108,170108,3,0,4,207,1.4,2.155369,0
2020-09-01-170108,170108,1,0,0,208,1.0,1.1877822,1
2020-09-02-170108,170108,1,0,0,209,1.6,0.88603026,2
2020-09-03-170108,170108,0,0,0,209,3.0,1.1280018,3
2020-09-04-170108,170108,15,0,1,224,2.6,11.356827,4
2020-09-05-170108,170108,1,0,0,225,0.8,1.0834488,5
2020-09-06-170108,170108,3,0,0,228,0.8,2.3202348,6
2020-09-07-170108,170108,0,0,0,228,1.6,0.43647087,0
2020-09-08-170108,170108,0,0,2,228,1.0,0.37737805,1
2020-09-09-170108,170108,1,0,0,229,4.0,2.3292959,2
2020-09-10-170108,170108,0,0,0,229,1.4,0.29433575,3
2020-09-11-170108,170108,0,0,0,229,2.6,0.6639142,4
2020-09-12-170108,170108,0,0,0,229,2.0,0.34872624,5
2020-09-13-170108,170108,0,0,0,229,1.0,0.19241281,6
2020-09-14-170108,170108,4,0,1,233,4.4,3.7369866,0
2020-09-15-170108,170108,0,0,0,233,2.6,0.68832046,1
2020-09-16-170108,170108,0,0,0,233,4.0,0.6651917,2
2020-09-17-170108,170108,0,0,0,233,4.4,0.57894367,3
2020-09-18-170108,170108,1,0,1,234,8.4,1.9469708,4
2020-09-19-170108,170108,0,0,0,234,3.6,0.45044395,5
2020-09-20-170108,170108,0,0,0,234,2.0,0.2019072,6
2020-09-21-170108,170108,0,0,4,234,3.6,0.77631605,0
2020-09-22-170108,170108,2,0,0,236,7.6,2.595609,1
2020-09-23-170108,170108,0,0,0,236,5.6,1.0043169,2
2020-09-24-170108,170108,0,0,6,236,9.4,1.7294216,3
2020-09-25-170108,170108,0,0,4,236,7.0,0.95989496,4
2020-09-26-170108,170108,0,0,2,236,1.4,0.3334983,5
2020-09-27-170108,170108,0,0,6,236,0.6,0.23208265,6
2020-09-28-170108,170108,1,0,1,237,6.6,1.6662863,0
2020-09-29-170108,170108,0,0,7,237,4.2,1.1537967,1
2020-09-30-170108,170108,0,0,0,237,6.2,0.89309376,2
2020-10-01-170108,170108,0,0,3,237,5.6,0.8186043,3
2020-10-02-170108,170108,1,0,3,238,5.6,0.6799939,4
2020-10-03-170108,170108,0,0,0,238,1.2,0.19003221,5
2020-10-04-170108,170108,0,1,3,238,3.8,0.29671055,6
2020-10-05-170108,170108,4,0,0,242,4.8,3.3862543,0
2020-10-06-170108,170108,0,1,0,242,3.4,0.44398722,1
2020-10-07-170108,170108,0,0,3,242,4.4,1.2158072,2
2020-10-08-170108,170108,6,0,2,248,4.4,5.2645693,3
2020-10-09-170108,170108,4,0,2,252,5.8,4.282618,4
2020-10-10-170108,170108,2,0,1,254,3.0,1.2463086,5
2020-10-11-170108,170108,6,0,1,260,2.8,5.0461955,6
2020-10-12-170108,170108,1,0,0,261,2.8,1.3926185,0
2020-10-13-170108,170108,7,0,3,268,3.6,5.80928,1
2020-10-14-170108,170108,0,0,2,268,2.2,1.020627,2
2020-10-15-170108,170108,3,0,0,271,4.0,2.2150922,3
2020-10-16-170108,170108,3,0,4,274,6.6,2.5104692,4
2020-10-17-170108,170108,0,0,0,274,1.4,0.20395018,5
2020-10-18-170108,170108,3,0,1,277,2.0,1.9909427,6
2020-10-19-170108,170108,0,0,1,277,6.0,1.177223,0
2020-10-20-170108,170108,0,0,5,277,4.6,0.517423,1
2020-10-21-170108,170108,3,0,0,280,3.6,2.1335456,2
2020-10-22-170108,170108,2,0,0,282,6.2,2.1291428,3
2020-10-23-170108,170108,2,0,3,284,6.6,1.805539,4
2020-10-24-170108,170108,1,0,1,285,3.0,0.87400204,5
2020-10-25-170108,170108,1,1,0,286,2.6,0.7991711,6
2020-10-26-170108,170108,0,0,0,286,3.6,0.40158454,0
2020-10-27-170108,170108,3,0,0,289,7.6,3.6825516,1
2020-10-28-170108,170108,2,3,2,291,6.4,2.1526647,2
2020-10-29-170108,170108,0,0,4,291,4.2,0.87444115,3
2020-10-30-170108,170108,4,0,2,295,7.2,3.5248063,4
2020-10-31-170108,170108,0,0,0,295,1.4,0.22613287,5
2020-11-01-170108,170108,1,0,0,296,1.8,1.5181268,6
2020-11-02-170108,170108,1,1,0,297,3.8,0.24893823,0
2020-11-03-170108,170108,5,1,0,302,4.4,3.698013,1
2020-11-04-170108,170108,0,1,0,302,6.2,0.6489768,2
2020-11-05-170108,170108,0,0,0,302,3.8,0.53160876,3
2020-11-06-170108,170108,3,0,0,305,4.6,2.409673,4
2020-11-07-170108,170108,1,0,0,306,1.8,0.7813476,5
2020-11-08-170108,170108,0,0,0,306,2.6,0.40284365,6
2020-11-09-170108,170108,0,0,0,306,1.8,0.28552145,0
2020-11-10-170108,170108,0,0,0,306,4.0,0.31882948,1
2020-11-11-170108,170108,2,0,0,308,5.8,1.7857472,2
2020-11-12-170108,170108,4,0,0,312,6.0,2.8057618,3
2020-11-13-170108,170108,2,0,0,314,8.2,1.6616843,4
2020-03-01-170109,170109,0,0,0,0,0.0,0.0009653461,6
2020-03-02-170109,170109,0,0,0,0,0.0,0.00030777373,0
2020-03-03-170109,170109,0,0,1,0,0.0,0.01723483,1
2020-03-04-170109,170109,0,1,3,0,0.0,0.0004246918,2
2020-03-05-170109,170109,0,0,8,0,0.2,0.008849288,3
2020-03-06-170109,170109,0,0,5,0,0.0,0.0012816945,4
2020-03-07-170109,170109,0,0,0,0,0.0,0.00017442227,5
2020-03-08-170109,170109,0,0,1,0,0.0,3.593284e-05,6
2020-03-09-170109,170109,0,0,3,0,0.0,0.00034543552,0
2020-03-10-170109,170109,0,0,2,0,0.0,0.0016762262,1
2020-03-11-170109,170109,0,0,0,0,0.2,0.20640421,2
2020-03-12-170109,170109,1,0,0,1,0.4,0.17494817,3
2020-03-13-170109,170109,2,0,1,3,0.6,0.7946925,4
2020-03-14-170109,170109,0,0,0,3,0.2,0.0050565847,5
2020-03-15-170109,170109,0,0,1,3,0.2,0.026278434,6
2020-03-16-170109,170109,0,0,3,3,1.8,0.82057846,0
2020-03-17-170109,170109,1,0,1,4,0.6,0.316855,1
2020-03-18-170109,170109,3,0,4,7,2.8,2.2562816,2
2020-03-19-170109,170109,8,0,3,15,2.6,2.0279443,3
2020-03-20-170109,170109,5,7,2,20,1.2,1.2100118,4
2020-03-21-170109,170109,0,0,0,20,0.8,0.21207158,5
2020-03-22-170109,170109,1,0,1,21,0.6,0.31860474,6
2020-03-23-170109,170109,3,0,0,24,5.2,2.8285613,0
2020-03-24-170109,170109,2,0,1,26,2.2,1.2549002,1
2020-03-25-170109,170109,0,0,0,26,4.2,1.3604125,2
2020-03-26-170109,170109,0,0,2,26,4.0,1.3599709,3
2020-03-27-170109,170109,1,0,5,27,2.4,1.0100027,4
2020-03-28-170109,170109,0,0,1,27,1.2,0.5028085,5
2020-03-29-170109,170109,1,0,1,28,1.6,0.61469525,6
2020-03-30-170109,170109,3,0,0,31,3.6,1.6550914,0
2020-03-31-170109,170109,1,0,2,32,4.6,1.9086728,1
2020-04-01-170109,170109,4,0,0,36,4.0,1.60292,2
2020-04-02-170109,170109,3,0,3,39,6.8,2.3611054,3
2020-04-03-170109,170109,2,0,2,41,2.8,1.1273803,4
2020-04-04-170109,170109,0,0,1,41,1.8,0.19919139,5
2020-04-05-170109,170109,1,0,2,42,0.8,0.43401277,6
2020-04-06-170109,170109,0,0,1,42,5.4,1.8492692,0
2020-04-07-170109,170109,1,0,0,43,4.6,1.3117924,1
2020-04-08-170109,170109,0,0,4,43,3.4,0.5042628,2
2020-04-09-170109,170109,2,0,0,45,2.4,1.137423,3
2020-04-10-170109,170109,5,0,5,50,9.0,1.7933553,4
2020-04-11-170109,170109,1,0,2,51,0.6,0.158458,5
2020-04-12-170109,170109,1,0,0,52,1.8,1.6159234,6
2020-04-13-170109,170109,0,0,2,52,2.4,0.7403863,0
2020-04-14-170109,170109,2,0,3,54,4.2,3.5518744,1
2020-04-15-170109,170109,0,0,3,54,1.8,0.775869,2
2020-04-16-170109,170109,3,0,0,57,1.6,1.722563,3
2020-04-17-170109,170109,2,0,0,59,1.6,0.7596529,4
2020-04-18-170109,170109,1,0,0,60,0.2,0.32197076,5
2020-04-19-170109,170109,2,0,1,62,1.0,1.1213975,6
2020-04-20-170109,170109,1,1,0,63,2.8,1.597514,0
2020-04-21-170109,170109,0,0,0,63,2.8,1.4516245,1
2020-04-22-170109,170109,4,0,3,67,0.6,0.7506711,2
2020-04-23-170109,170109,0,0,0,67,0.0,0.18230249,3
2020-04-24-170109,170109,5,0,1,72,0.8,0.67737544,4
2020-04-25-170109,170109,2,0,1,74,0.6,0.2932061,5
2020-04-26-170109,170109,0,0,1,74,0.2,0.005348232,6
2020-04-27-170109,170109,2,0,3,76,1.2,0.47614184,0
2020-04-28-170109,170109,3,1,2,79,0.4,0.47120908,1
2020-04-29-170109,170109,3,0,0,82,1.8,1.0581691,2
2020-04-30-170109,170109,0,0,0,82,0.8,0.29490998,3
2020-05-01-170109,170109,0,0,1,82,0.2,0.009875864,4
2020-05-02-170109,170109,0,0,0,82,1.4,0.7062356,5
2020-05-03-170109,170109,1,0,0,83,0.4,0.29277208,6
2020-05-04-170109,170109,0,0,1,83,1.2,0.4533088,0
2020-05-05-170109,170109,0,0,2,83,0.6,0.25880554,1
2020-05-06-170109,170109,3,0,0,86,0.8,0.6589496,2
2020-05-07-170109,170109,0,0,0,86,1.6,0.5933741,3
2020-05-08-170109,170109,1,0,0,87,4.8,1.0167489,4
2020-05-09-170109,170109,1,0,0,88,1.2,0.3700731,5
2020-05-10-170109,170109,1,0,1,89,0.6,0.5483305,6
2020-05-11-170109,170109,3,0,2,92,1.6,1.976943,0
2020-05-12-170109,170109,2,0,1,94,1.2,0.88741887,1
2020-05-13-170109,170109,0,0,0,94,0.8,0.061416414,2
2020-05-14-170109,170109,0,0,1,94,1.2,0.46549633,3
2020-05-15-170109,170109,1,0,0,95,0.6,0.36015898,4
2020-05-16-170109,170109,0,0,0,95,0.0,0.012720569,5
2020-05-17-170109,170109,0,0,2,95,0.4,0.2083326,6
2020-05-18-170109,170109,1,0,1,96,1.2,1.3341054,0
2020-05-19-170109,170109,2,0,0,98,0.2,0.5497288,1
2020-05-20-170109,170109,0,1,1,98,0.8,0.123103976,2
2020-05-21-170109,170109,0,0,0,98,0.8,0.3424959,3
2020-05-22-170109,170109,0,0,0,98,1.0,0.3324402,4
2020-05-23-170109,170109,0,0,0,98,0.2,0.22973813,5
2020-05-24-170109,170109,1,0,0,99,0.0,0.15429364,6
2020-05-25-170109,170109,2,0,1,101,1.2,0.4622458,0
2020-05-26-170109,170109,1,0,0,102,1.0,0.66766065,1
2020-05-27-170109,170109,0,0,0,102,0.2,0.024386242,2
2020-05-28-170109,170109,1,0,0,103,3.2,1.1085719,3
2020-05-29-170109,170109,0,1,0,103,0.2,0.28077933,4
2020-05-30-170109,170109,0,0,0,103,0.2,0.0077283815,5
2020-05-31-170109,170109,2,0,0,105,0.0,0.30503985,6
2020-06-01-170109,170109,1,0,1,106,0.4,0.1805866,0
2020-06-02-170109,170109,0,0,0,106,1.8,1.255272,1
2020-06-03-170109,170109,1,0,1,107,0.8,0.47778922,2
2020-06-04-170109,170109,0,0,1,107,0.4,0.24719667,3
2020-06-05-170109,170109,0,0,0,107,0.4,0.047327816,4
2020-06-06-170109,170109,0,3,2,107,0.4,0.02223762,5
2020-06-07-170109,170109,0,0,0,107,0.0,0.0010936462,6
2020-06-08-170109,170109,1,0,0,108,0.6,0.42030928,0
2020-06-09-170109,170109,0,0,0,108,0.6,0.28925988,1
2020-06-10-170109,170109,0,0,1,108,0.2,0.011859283,2
2020-06-11-170109,170109,0,0,0,108,0.4,0.012801791,3
2020-06-12-170109,170109,0,0,2,108,0.4,0.4358818,4
2020-06-13-170109,170109,0,0,0,108,0.0,0.0012025867,5
2020-06-14-170109,170109,0,0,0,108,0.4,0.0150937615,6
2020-06-15-170109,170109,1,0,0,109,0.4,0.3851744,0
2020-06-16-170109,170109,0,0,1,109,0.6,0.27218252,1
2020-06-17-170109,170109,1,0,1,110,1.4,0.44483113,2
2020-06-18-170109,170109,1,0,1,111,1.6,0.1988434,3
2020-06-19-170109,170109,0,0,1,111,0.0,0.07285461,4
2020-06-20-170109,170109,2,0,0,113,0.2,0.36757803,5
2020-06-21-170109,170109,0,0,0,113,0.8,0.033360984,6
2020-06-22-170109,170109,0,0,1,113,0.4,0.24970245,0
2020-06-23-170109,170109,0,0,0,113,0.2,0.30327633,1
2020-06-24-170109,170109,1,0,0,114,0.0,0.252062,2
2020-06-25-170109,170109,0,1,0,114,0.4,0.050805766,3
2020-06-26-170109,170109,2,0,2,116,0.0,0.48493168,4
2020-06-27-170109,170109,0,0,2,116,0.2,0.017325647,5
2020-06-28-170109,170109,0,1,0,116,0.2,0.3001108,6
2020-06-29-170109,170109,0,0,2,116,0.4,0.121672824,0
2020-06-30-170109,170109,1,0,1,117,0.0,0.1864759,1
2020-07-01-170109,170109,1,0,1,118,0.6,0.20339811,2
2020-07-02-170109,170109,1,0,1,119,0.4,0.49351498,3
2020-07-03-170109,170109,1,0,2,120,0.0,0.21830806,4
2020-07-04-170109,170109,0,0,2,120,0.0,0.0049389205,5
2020-07-05-170109,170109,0,0,0,120,0.0,0.0017470322,6
2020-07-06-170109,170109,1,0,3,121,0.0,0.22235067,0
2020-07-07-170109,170109,0,0,0,121,0.4,0.089256346,1
2020-07-08-170109,170109,0,1,1,121,0.0,0.032628555,2
2020-07-09-170109,170109,0,1,0,121,0.2,0.018638315,3
2020-07-10-170109,170109,2,0,0,123,0.6,1.030568,4
2020-07-11-170109,170109,2,0,0,125,0.0,0.5439617,5
2020-07-12-170109,170109,0,0,0,125,0.2,0.040447433,6
2020-07-13-170109,170109,2,0,1,127,0.2,0.52610123,0
2020-07-14-170109,170109,1,0,0,128,0.6,0.37721443,1
2020-07-15-170109,170109,1,0,0,129,0.4,0.092664786,2
2020-07-16-170109,170109,1,0,1,130,0.0,0.2445853,3
2020-07-17-170109,170109,2,0,0,132,0.0,0.95965284,4
2020-07-18-170109,170109,2,0,0,134,0.0,0.5419624,5
2020-07-19-170109,170109,0,0,0,134,0.0,0.0020244669,6
2020-07-20-170109,170109,3,0,2,137,0.0,0.4685331,0
2020-07-21-170109,170109,0,0,3,137,0.2,0.021124393,1
2020-07-22-170109,170109,1,0,3,138,0.2,0.25788388,2
2020-07-23-170109,170109,0,0,4,138,0.6,0.15056723,3
2020-07-24-170109,170109,0,0,3,138,0.0,0.011119435,4
2020-07-25-170109,170109,0,0,10,138,0.0,0.0028477386,5
2020-07-26-170109,170109,0,0,0,138,0.2,0.011258456,6
2020-07-27-170109,170109,1,0,1,139,0.2,0.31608167,0
2020-07-28-170109,170109,0,0,2,139,0.0,0.17267531,1
2020-07-29-170109,170109,0,0,4,139,0.0,0.054089516,2
2020-07-30-170109,170109,1,0,3,140,0.0,0.23159017,3
2020-07-31-170109,170109,0,0,5,140,0.6,0.7979599,4
2020-08-01-170109,170109,0,0,2,140,0.0,0.0062980074,5
2020-08-02-170109,170109,0,0,2,140,0.0,0.027953373,6
2020-08-03-170109,170109,2,0,6,142,0.0,0.46799302,0
2020-08-04-170109,170109,3,0,3,145,0.0,0.7603093,1
2020-08-05-170109,170109,3,0,4,148,0.8,1.2324023,2
2020-08-06-170109,170109,4,0,5,152,0.4,1.8636968,3
2020-08-07-170109,170109,3,0,4,155,1.2,1.1174426,4
2020-08-08-170109,170109,10,0,2,165,0.0,2.9485545,5
2020-08-09-170109,170109,0,0,3,165,0.2,0.42018056,6
2020-08-10-170109,170109,1,0,1,166,1.0,1.1920955,0
2020-08-11-170109,170109,2,0,2,168,2.2,1.3457353,1
2020-08-12-170109,170109,4,0,2,172,1.6,3.429595,2
2020-08-13-170109,170109,3,0,2,175,1.2,2.216714,3
2020-08-14-170109,170109,5,0,1,180,3.2,2.5413265,4
2020-08-15-170109,170109,2,0,0,182,0.6,1.08012,5
2020-08-16-170109,170109,2,0,0,184,0.4,0.6827905,6
2020-08-17-170109,170109,6,0,0,190,0.6,1.6950586,0
2020-08-18-170109,170109,3,0,1,193,0.2,0.7458353,1
2020-08-19-170109,170109,4,0,0,197,0.4,2.0194561,2
2020-08-20-170109,170109,5,0,3,202,0.6,1.611941,3
2020-08-21-170109,170109,4,0,0,206,1.6,1.6336255,4
2020-08-22-170109,170109,2,0,0,208,0.2,0.90595293,5
2020-08-23-170109,170109,3,0,0,211,0.4,1.2111713,6
2020-08-24-170109,170109,1,0,4,212,0.8,0.69397223,0
2020-08-25-170109,170109,2,0,4,214,0.8,0.45142508,1
2020-08-26-170109,170109,2,0,6,216,0.8,1.0280924,2
2020-08-27-170109,170109,2,0,0,218,1.2,0.42252338,3
2020-08-28-170109,170109,1,0,1,219,0.4,0.43723187,4
2020-08-29-170109,170109,0,0,0,219,1.4,0.5464999,5
2020-08-30-170109,170109,0,0,0,219,1.4,0.8051084,6
2020-08-31-170109,170109,0,0,3,219,0.6,0.13816431,0
2020-09-01-170109,170109,1,0,1,220,0.4,0.23988475,1
2020-09-02-170109,170109,0,0,4,220,0.4,0.027388206,2
2020-09-03-170109,170109,3,0,0,223,1.2,1.2403138,3
2020-09-04-170109,170109,0,0,3,223,2.8,0.9826498,4
2020-09-05-170109,170109,0,0,0,223,2.2,0.17799547,5
2020-09-06-170109,170109,0,0,0,223,2.0,0.9916049,6
2020-09-07-170109,170109,4,0,0,227,0.4,0.8026082,0
2020-09-08-170109,170109,4,0,0,231,2.6,1.818058,1
2020-09-09-170109,170109,6,0,2,237,1.8,1.2804579,2
2020-09-10-170109,170109,0,0,0,237,2.0,0.8304382,3
2020-09-11-170109,170109,1,0,1,238,2.2,1.7338188,4
2020-09-12-170109,170109,0,0,1,238,0.6,0.08853294,5
2020-09-13-170109,170109,0,0,0,238,0.8,0.41116524,6
2020-09-14-170109,170109,3,0,0,241,1.6,1.8703502,0
2020-09-15-170109,170109,1,1,3,242,1.4,0.8101391,1
2020-09-16-170109,170109,4,0,2,246,1.8,1.1613677,2
2020-09-17-170109,170109,0,0,2,246,0.2,1.1823944,3
2020-09-18-170109,170109,3,0,0,249,4.2,2.6727133,4
2020-09-19-170109,170109,0,1,1,249,0.4,0.05279333,5
2020-09-20-170109,170109,0,0,0,249,1.4,0.10048285,6
2020-09-21-170109,170109,0,0,1,249,1.8,0.39164484,0
2020-09-22-170109,170109,0,2,1,249,2.8,0.77864677,1
2020-09-23-170109,170109,2,0,6,251,4.0,1.5976827,2
2020-09-24-170109,170109,0,0,0,251,2.8,1.06909,3
2020-09-25-170109,170109,1,0,3,252,3.6,1.0892327,4
2020-09-26-170109,170109,1,0,0,253,1.0,0.5547032,5
2020-09-27-170109,170109,0,0,0,253,0.0,0.03711454,6
2020-09-28-170109,170109,0,0,1,253,1.6,0.81217605,0
2020-09-29-170109,170109,3,0,0,256,1.2,0.75955135,1
2020-09-30-170109,170109,2,0,6,258,1.6,0.83217037,2
2020-10-01-170109,170109,2,1,0,260,2.2,0.5436138,3
2020-10-02-170109,170109,0,0,0,260,2.0,0.4708646,4
2020-10-03-170109,170109,1,0,0,261,0.8,0.7644082,5
2020-10-04-170109,170109,0,0,1,261,1.4,0.30886886,6
2020-10-05-170109,170109,1,0,2,262,0.8,0.44468418,0
2020-10-06-170109,170109,1,0,1,263,1.6,0.43069884,1
2020-10-07-170109,170109,6,0,6,269,0.6,0.88782036,2
2020-10-08-170109,170109,0,1,2,269,1.4,0.47002387,3
2020-10-09-170109,170109,3,1,5,272,1.6,2.1732695,4
2020-10-10-170109,170109,0,0,0,272,0.8,0.8182167,5
2020-10-11-170109,170109,0,0,2,272,0.2,0.20193104,6
2020-10-12-170109,170109,1,0,9,273,1.4,0.8393207,0
2020-10-13-170109,170109,0,0,0,273,1.2,0.39031276,1
2020-10-14-170109,170109,6,0,4,279,2.0,1.5628959,2
2020-10-15-170109,170109,0,0,1,279,0.8,0.06125506,3
2020-10-16-170109,170109,0,0,8,279,1.0,0.6709727,4
2020-10-17-170109,170109,0,0,2,279,0.6,0.25743297,5
2020-10-18-170109,170109,1,0,3,280,0.8,0.36191416,6
2020-10-19-170109,170109,2,0,2,282,1.8,1.3850497,0
2020-10-20-170109,170109,1,0,1,283,1.4,0.62541574,1
2020-10-21-170109,170109,6,0,1,289,0.2,1.2177768,2
2020-10-22-170109,170109,2,0,2,291,2.2,1.401142,3
2020-10-23-170109,170109,5,0,3,296,3.6,1.3037978,4
2020-10-24-170109,170109,0,0,0,296,1.0,0.6600303,5
2020-10-25-170109,170109,2,1,2,298,2.4,1.0392101,6
2020-10-26-170109,170109,9,1,2,307,2.4,1.2197978,0
2020-10-27-170109,170109,0,0,1,307,2.6,0.82659036,1
2020-10-28-170109,170109,4,0,9,311,2.4,1.5516801,2
2020-10-29-170109,170109,1,0,6,312,6.2,3.5473602,3
2020-10-30-170109,170109,8,0,5,320,6.4,2.195194,4
2020-10-31-170109,170109,2,1,0,322,2.8,1.3343941,5
2020-11-01-170109,170109,3,1,0,325,5.6,0.9659355,6
2020-11-02-170109,170109,2,2,0,327,1.2,0.48006308,0
2020-11-03-170109,170109,1,1,0,328,3.4,2.3514886,1
2020-11-04-170109,170109,1,0,0,329,7.6,1.8262062,2
2020-11-05-170109,170109,2,1,0,331,8.6,2.1263912,3
2020-11-06-170109,170109,3,0,0,334,5.8,1.8815624,4
2020-11-07-170109,170109,0,0,0,334,3.2,0.7009383,5
2020-11-08-170109,170109,2,0,0,336,2.2,0.82002336,6
2020-11-09-170109,170109,2,0,0,338,1.6,0.29708353,0
2020-11-10-170109,170109,1,0,0,339,1.8,0.32982606,1
2020-11-11-170109,170109,9,0,0,348,2.6,1.502235,2
2020-11-12-170109,170109,6,0,0,354,2.4,1.0084305,3
2020-11-13-170109,170109,5,0,0,359,4.4,0.71768534,4
2020-03-01-170110,170110,0,0,0,0,0.0,7.4125855e-05,6
2020-03-02-170110,170110,0,0,0,0,0.0,1.6781564e-06,0
2020-03-03-170110,170110,0,0,0,0,0.0,0.0017514788,1
2020-03-04-170110,170110,0,2,9,0,0.0,2.8606452e-08,2
2020-03-05-170110,170110,0,0,1,0,0.0,0.00027421946,3
2020-03-06-170110,170110,0,0,0,0,0.0,5.538132e-07,4
2020-03-07-170110,170110,0,0,0,0,0.0,2.4929252e-08,5
2020-03-08-170110,170110,0,0,0,0,0.0,3.785307e-09,6
2020-03-09-170110,170110,0,0,0,0,0.0,3.515308e-05,0
2020-03-10-170110,170110,0,0,1,0,0.0,3.994866e-05,1
2020-03-11-170110,170110,0,0,10,0,0.0,0.000560634,2
2020-03-12-170110,170110,0,0,8,0,0.0,0.0026740627,3
2020-03-13-170110,170110,0,0,11,0,0.6666666666666666,0.005134894,4
2020-03-14-170110,170110,0,0,3,0,0.3333333333333333,0.00011508589,5
2020-03-15-170110,170110,0,0,1,0,0.0,0.001581344,6
2020-03-16-170110,170110,0,0,3,0,0.6666666666666666,0.0043255603,0
2020-03-17-170110,170110,0,0,3,0,0.3333333333333333,0.0005867197,1
2020-03-18-170110,170110,9,0,10,9,1.0,0.031391922,2
2020-03-19-170110,170110,1,0,1,10,2.0,0.017250232,3
2020-03-20-170110,170110,0,0,6,10,3.0,0.00925394,4
2020-03-21-170110,170110,0,0,1,10,0.6666666666666666,0.0007547785,5
2020-03-22-170110,170110,0,1,1,10,0.6666666666666666,0.02992658,6
2020-03-23-170110,170110,0,0,2,10,5.666666666666668,0.06618892,0
2020-03-24-170110,170110,1,0,1,11,1.3333333333333333,0.004928158,1
2020-03-25-170110,170110,10,0,2,21,5.0,0.024387138,2
2020-03-26-170110,170110,8,0,0,29,1.3333333333333333,0.01391,3
2020-03-27-170110,170110,11,0,1,40,2.0,0.027285622,4
2020-03-28-170110,170110,3,0,1,43,0.6666666666666666,0.0072270455,5
2020-03-29-170110,170110,1,0,0,44,2.333333333333333,0.03662798,6
2020-03-30-170110,170110,3,0,1,47,4.0,0.023376586,0
2020-03-31-170110,170110,3,0,0,50,4.333333333333333,0.006468498,1
2020-04-01-170110,170110,10,0,1,60,4.0,0.035204202,2
2020-04-02-170110,170110,1,0,2,61,6.666666666666668,0.069816835,3
2020-04-03-170110,170110,6,0,0,67,3.0,0.052748993,4
2020-04-04-170110,170110,1,0,0,68,1.0,0.0035923657,5
2020-04-05-170110,170110,1,0,0,69,1.0,0.0026258198,6
2020-04-06-170110,170110,2,0,1,71,4.0,0.2515582,0
2020-04-07-170110,170110,1,0,0,72,2.0,0.024246654,1
2020-04-08-170110,170110,2,0,0,74,1.3333333333333333,0.036182422,2
2020-04-09-170110,170110,0,0,0,74,4.666666666666667,0.07401993,3
2020-04-10-170110,170110,1,0,1,75,9.333333333333334,0.018797394,4
2020-04-11-170110,170110,1,0,1,76,2.0,0.04900655,5
2020-04-12-170110,170110,0,0,0,76,0.0,0.00053158944,6
2020-04-13-170110,170110,1,0,1,77,4.0,0.0061820587,0
2020-04-14-170110,170110,0,0,1,77,2.6666666666666665,0.026284235,1
2020-04-15-170110,170110,1,0,4,78,8.0,0.024211088,2
2020-04-16-170110,170110,2,0,1,80,3.0,0.012661288,3
2020-04-17-170110,170110,0,0,0,80,3.333333333333333,0.18605497,4
2020-04-18-170110,170110,0,0,0,80,0.6666666666666666,0.005243244,5
2020-04-19-170110,170110,0,0,0,80,0.3333333333333333,0.012282793,6
2020-04-20-170110,170110,1,0,0,81,2.6666666666666665,0.009139697,0
2020-04-21-170110,170110,0,1,0,81,1.3333333333333333,0.0019221575,1
2020-04-22-170110,170110,0,0,5,81,0.6666666666666666,0.007326969,2
2020-04-23-170110,170110,0,0,0,81,0.0,0.00016670726,3
2020-04-24-170110,170110,1,0,2,82,0.3333333333333333,0.0029796676,4
2020-04-25-170110,170110,1,0,0,83,0.0,0.0023354795,5
2020-04-26-170110,170110,0,0,0,83,0.0,0.0003124859,6
2020-04-27-170110,170110,1,0,3,84,1.0,0.042875957,0
2020-04-28-170110,170110,1,0,0,85,1.0,0.0094991885,1
2020-04-29-170110,170110,4,0,0,89,2.6666666666666665,0.06405411,2
2020-04-30-170110,170110,1,0,0,90,0.3333333333333333,0.0038126626,3
2020-05-01-170110,170110,0,0,2,90,0.6666666666666666,0.0073668296,4
2020-05-02-170110,170110,0,0,0,90,0.0,0.0014713361,5
2020-05-03-170110,170110,0,0,0,90,0.0,0.0006933271,6
2020-05-04-170110,170110,0,0,0,90,0.6666666666666666,0.00022687086,0
2020-05-05-170110,170110,0,0,1,90,1.3333333333333333,0.009390984,1
2020-05-06-170110,170110,5,0,0,95,1.6666666666666667,0.013068607,2
2020-05-07-170110,170110,0,0,0,95,0.3333333333333333,0.021701926,3
2020-05-08-170110,170110,2,0,0,97,2.0,0.01953793,4
2020-05-09-170110,170110,0,0,0,97,0.6666666666666666,0.0022374867,5
2020-05-10-170110,170110,0,0,0,97,0.3333333333333333,0.020306796,6
2020-05-11-170110,170110,3,0,0,100,0.6666666666666666,0.019550443,0
2020-05-12-170110,170110,0,0,0,100,1.0,0.0057687075,1
2020-05-13-170110,170110,0,0,2,100,0.3333333333333333,0.021835662,2
2020-05-14-170110,170110,0,2,0,100,1.3333333333333333,0.0036338377,3
2020-05-15-170110,170110,2,0,1,102,0.6666666666666666,0.0087331915,4
2020-05-16-170110,170110,0,0,0,102,0.0,6.0335753e-07,5
2020-05-17-170110,170110,0,0,0,102,0.0,1.2781917e-06,6
2020-05-18-170110,170110,0,0,0,102,0.3333333333333333,0.00081946317,0
2020-05-19-170110,170110,1,0,1,103,0.3333333333333333,0.003310214,1
2020-05-20-170110,170110,0,0,1,103,1.3333333333333333,0.0049247714,2
2020-05-21-170110,170110,0,0,1,103,1.0,0.001348403,3
2020-05-22-170110,170110,0,0,0,103,0.6666666666666666,0.0023343721,4
2020-05-23-170110,170110,0,0,0,103,0.6666666666666666,0.0010501863,5
2020-05-24-170110,170110,0,0,0,103,0.0,0.00011611574,6
2020-05-25-170110,170110,0,0,2,103,1.0,0.005670441,0
2020-05-26-170110,170110,0,0,0,103,1.3333333333333333,0.0028978654,1
2020-05-27-170110,170110,2,0,0,105,0.6666666666666666,0.014595625,2
2020-05-28-170110,170110,0,0,1,105,0.3333333333333333,0.007294658,3
2020-05-29-170110,170110,1,0,0,106,0.3333333333333333,0.0022599003,4
2020-05-30-170110,170110,0,0,0,106,0.0,0.00018451028,5
2020-05-31-170110,170110,0,0,0,106,0.3333333333333333,0.0009149171,6
2020-06-01-170110,170110,0,0,0,106,0.0,0.0014965595,0
2020-06-02-170110,170110,1,0,1,107,0.3333333333333333,0.027476791,1
2020-06-03-170110,170110,1,0,1,108,1.0,0.014779351,2
2020-06-04-170110,170110,1,0,1,109,0.6666666666666666,0.005708386,3
2020-06-05-170110,170110,0,0,0,109,0.6666666666666666,0.0053323912,4
2020-06-06-170110,170110,0,0,0,109,0.3333333333333333,0.012894609,5
2020-06-07-170110,170110,0,0,0,109,0.3333333333333333,0.00034461313,6
2020-06-08-170110,170110,2,0,0,111,0.6666666666666666,0.0100836875,0
2020-06-09-170110,170110,0,0,1,111,0.6666666666666666,0.0017865682,1
2020-06-10-170110,170110,0,0,0,111,0.0,0.00012932598,2
2020-06-11-170110,170110,1,0,0,112,0.6666666666666666,0.004175272,3
2020-06-12-170110,170110,0,0,0,112,0.3333333333333333,0.0017629165,4
2020-06-13-170110,170110,0,0,0,112,0.0,3.2800606e-05,5
2020-06-14-170110,170110,0,0,0,112,0.0,0.003122332,6
2020-06-15-170110,170110,0,0,0,112,0.0,0.0013299901,0
2020-06-16-170110,170110,1,0,0,113,0.0,0.00757062,1
2020-06-17-170110,170110,1,0,0,114,0.6666666666666666,0.0053848242,2
2020-06-18-170110,170110,1,0,0,115,0.0,0.0056007504,3
2020-06-19-170110,170110,0,0,0,115,0.3333333333333333,0.0012908485,4
2020-06-20-170110,170110,0,0,0,115,0.0,0.0025546902,5
2020-06-21-170110,170110,0,0,0,115,0.0,0.00013748261,6
2020-06-22-170110,170110,0,0,0,115,0.6666666666666666,0.0013505353,0
2020-06-23-170110,170110,1,0,0,116,0.3333333333333333,0.0043318896,1
2020-06-24-170110,170110,0,0,0,116,0.6666666666666666,0.0037915378,2
2020-06-25-170110,170110,0,2,0,116,0.6666666666666666,0.0038301456,3
2020-06-26-170110,170110,0,0,0,116,0.3333333333333333,0.0009978922,4
2020-06-27-170110,170110,0,1,0,116,0.0,0.00063192256,5
2020-06-28-170110,170110,0,0,0,116,0.0,0.00055567955,6
2020-06-29-170110,170110,0,0,0,116,0.3333333333333333,0.0019086556,0
2020-06-30-170110,170110,0,0,0,116,0.0,0.0013843488,1
2020-07-01-170110,170110,0,1,0,116,0.3333333333333333,0.0016565814,2
2020-07-02-170110,170110,0,0,0,116,0.3333333333333333,0.0043674596,3
2020-07-03-170110,170110,0,0,0,116,0.0,0.002732219,4
2020-07-04-170110,170110,0,0,0,116,0.0,0.0011858174,5
2020-07-05-170110,170110,0,0,0,116,0.0,2.0189258e-08,6
2020-07-06-170110,170110,0,0,0,116,0.0,0.016637757,0
2020-07-07-170110,170110,0,0,0,116,0.6666666666666666,0.0017486382,1
2020-07-08-170110,170110,0,0,0,116,0.0,0.0007559013,2
2020-07-09-170110,170110,0,0,0,116,0.3333333333333333,0.0017196172,3
2020-07-10-170110,170110,0,0,0,116,0.0,0.0032429702,4
2020-07-11-170110,170110,0,0,0,116,0.3333333333333333,0.0026254826,5
2020-07-12-170110,170110,0,0,0,116,0.0,0.009847253,6
2020-07-13-170110,170110,0,0,0,116,0.0,0.0026040082,0
2020-07-14-170110,170110,0,0,0,116,0.6666666666666666,0.015482624,1
2020-07-15-170110,170110,0,0,0,116,0.6666666666666666,0.0031451578,2
2020-07-16-170110,170110,0,0,0,116,0.0,0.0020556536,3
2020-07-17-170110,170110,0,0,0,116,0.3333333333333333,0.023506414,4
2020-07-18-170110,170110,0,0,0,116,0.0,0.0022159568,5
2020-07-19-170110,170110,0,0,0,116,0.0,0.00070981286,6
2020-07-20-170110,170110,0,0,0,116,0.0,0.0012952855,0
2020-07-21-170110,170110,0,0,0,116,0.0,0.002345684,1
2020-07-22-170110,170110,0,0,0,116,0.0,0.001437655,2
2020-07-23-170110,170110,0,0,0,116,0.6666666666666666,0.13652603,3
2020-07-24-170110,170110,0,0,0,116,0.0,0.0006054152,4
2020-07-25-170110,170110,0,0,0,116,0.0,0.0003055121,5
2020-07-26-170110,170110,0,0,2,116,0.0,0.000497412,6
2020-07-27-170110,170110,0,0,0,116,0.6666666666666666,0.0024670607,0
2020-07-28-170110,170110,0,0,1,116,2.0,0.122947395,1
2020-07-29-170110,170110,0,0,0,116,0.6666666666666666,0.01660355,2
2020-07-30-170110,170110,0,0,1,116,0.0,0.0013044822,3
2020-07-31-170110,170110,0,0,0,116,0.0,0.004579838,4
2020-08-01-170110,170110,0,0,1,116,0.0,0.001243649,5
2020-08-02-170110,170110,0,0,0,116,0.6666666666666666,0.06709829,6
2020-08-03-170110,170110,0,0,0,116,0.0,0.002773045,0
2020-08-04-170110,170110,0,0,0,116,0.0,0.0058829025,1
2020-08-05-170110,170110,0,0,5,116,0.6666666666666666,0.025652751,2
2020-08-06-170110,170110,0,0,49,116,4.333333333333333,0.054778926,3
2020-08-07-170110,170110,0,0,0,116,1.6666666666666667,0.11079819,4
2020-08-08-170110,170110,0,0,31,116,0.3333333333333333,0.008795144,5
2020-08-09-170110,170110,2,0,3,118,0.0,0.0066791144,6
2020-08-10-170110,170110,0,0,2,118,1.0,0.040212825,0
2020-08-11-170110,170110,1,0,2,119,2.0,0.04889241,1
2020-08-12-170110,170110,0,0,4,119,1.0,0.03032688,2
2020-08-13-170110,170110,1,0,0,120,1.6666666666666667,0.03911606,3
2020-08-14-170110,170110,0,0,2,120,1.3333333333333333,0.064927995,4
2020-08-15-170110,170110,1,0,11,121,1.3333333333333333,0.05509931,5
2020-08-16-170110,170110,0,0,0,121,0.0,0.003304015,6
2020-08-17-170110,170110,0,0,1,121,2.0,0.04177306,0
2020-08-18-170110,170110,0,0,0,121,0.3333333333333333,0.009261929,1
2020-08-19-170110,170110,5,0,0,126,1.3333333333333333,0.037445374,2
2020-08-20-170110,170110,49,0,2,175,0.6666666666666666,0.18349847,3
2020-08-21-170110,170110,0,0,3,175,2.0,0.02523878,4
2020-08-22-170110,170110,31,0,3,206,0.6666666666666666,0.078717366,5
2020-08-23-170110,170110,3,0,0,209,0.3333333333333333,0.0155214155,6
2020-08-24-170110,170110,2,0,0,211,1.6666666666666667,0.020988723,0
2020-08-25-170110,170110,2,0,0,213,2.6666666666666665,0.012823718,1
2020-08-26-170110,170110,4,0,0,217,2.6666666666666665,0.023431463,2
2020-08-27-170110,170110,0,1,1,217,1.6666666666666667,0.032629844,3
2020-08-28-170110,170110,2,0,2,219,1.3333333333333333,0.007589742,4
2020-08-29-170110,170110,11,2,0,230,1.6666666666666667,0.037020978,5
2020-08-30-170110,170110,0,1,2,230,2.0,0.014224067,6
2020-08-31-170110,170110,1,3,0,231,1.3333333333333333,0.014429999,0
2020-09-01-170110,170110,0,2,1,231,0.3333333333333333,0.015803635,1
2020-09-02-170110,170110,0,0,4,231,0.6666666666666666,0.002015438,2
2020-09-03-170110,170110,2,0,0,233,4.0,0.023995172,3
2020-09-04-170110,170110,3,0,10,236,5.0,0.037196867,4
2020-09-05-170110,170110,3,1,5,239,0.3333333333333333,0.031801652,5
2020-09-06-170110,170110,0,1,1,239,1.0,0.054401286,6
2020-09-07-170110,170110,0,0,0,239,1.3333333333333333,0.0116997715,0
2020-09-08-170110,170110,0,1,0,239,0.0,0.019099366,1
2020-09-09-170110,170110,0,1,0,239,2.6666666666666665,0.04135681,2
2020-09-10-170110,170110,1,1,0,240,0.3333333333333333,0.016629426,3
2020-09-11-170110,170110,2,0,0,242,2.0,0.04462466,4
2020-09-12-170110,170110,0,0,0,242,8.333333333333334,0.019298842,5
2020-09-13-170110,170110,2,0,0,244,0.3333333333333333,0.0071812114,6
2020-09-14-170110,170110,0,0,0,244,2.0,0.024436677,0
2020-09-15-170110,170110,1,0,0,245,3.0,0.01603423,1
2020-09-16-170110,170110,4,0,0,249,2.333333333333333,0.024088,2
2020-09-17-170110,170110,0,0,0,249,1.3333333333333333,0.012320925,3
2020-09-18-170110,170110,10,0,0,259,3.333333333333333,0.041725904,4
2020-09-19-170110,170110,5,1,0,264,0.3333333333333333,0.012742027,5
2020-09-20-170110,170110,1,0,0,265,0.3333333333333333,0.0031321177,6
2020-09-21-170110,170110,0,1,0,265,0.0,0.023664573,0
2020-09-22-170110,170110,0,1,0,265,1.6666666666666667,0.024310669,1
2020-09-23-170110,170110,0,1,1,265,2.6666666666666665,0.027909594,2
2020-09-24-170110,170110,0,1,0,265,0.3333333333333333,0.009777144,3
2020-09-25-170110,170110,0,0,2,265,2.333333333333333,0.008618824,4
2020-09-26-170110,170110,0,0,3,265,0.6666666666666666,0.013974076,5
2020-09-27-170110,170110,0,0,0,265,0.0,0.005720039,6
2020-09-28-170110,170110,0,0,2,265,1.0,0.011111147,0
2020-09-29-170110,170110,0,0,1,265,0.0,0.008255692,1
2020-09-30-170110,170110,0,0,0,265,2.6666666666666665,0.013329213,2
2020-10-01-170110,170110,0,0,0,265,1.0,0.009800492,3
2020-10-02-170110,170110,0,0,0,265,1.3333333333333333,0.0145722125,4
2020-10-03-170110,170110,0,1,0,265,1.0,0.0024471781,5
2020-10-04-170110,170110,0,1,0,265,0.0,0.009243069,6
2020-10-05-170110,170110,0,0,0,265,3.0,0.014507419,0
2020-10-06-170110,170110,0,0,1,265,0.3333333333333333,0.0045490637,1
2020-10-07-170110,170110,1,1,0,266,0.6666666666666666,0.0277536,2
2020-10-08-170110,170110,0,0,2,266,2.6666666666666665,0.072909,3
2020-10-09-170110,170110,2,0,2,268,1.6666666666666667,0.12616712,4
2020-10-10-170110,170110,3,0,0,271,1.0,0.021953236,5
2020-10-11-170110,170110,0,0,0,271,2.0,0.02961184,6
2020-10-12-170110,170110,2,0,3,273,0.6666666666666666,0.042483654,0
2020-10-13-170110,170110,1,0,3,274,2.333333333333333,0.27706093,1
2020-10-14-170110,170110,0,0,0,274,0.0,0.016348358,2
2020-10-15-170110,170110,0,0,2,274,1.0,0.0038486791,3
2020-10-16-170110,170110,0,0,2,274,1.0,0.027608063,4
2020-10-17-170110,170110,0,0,0,274,0.3333333333333333,0.009634871,5
2020-10-18-170110,170110,0,0,0,274,2.333333333333333,0.06647238,6
2020-10-19-170110,170110,0,0,0,274,0.6666666666666666,0.039256316,0
2020-10-20-170110,170110,1,0,1,275,0.0,0.006879682,1
2020-10-21-170110,170110,0,0,0,275,1.3333333333333333,0.011238245,2
2020-10-22-170110,170110,2,0,0,277,1.3333333333333333,0.019606123,3
2020-10-23-170110,170110,2,1,1,279,1.6666666666666667,0.05704973,4
2020-10-24-170110,170110,0,0,0,279,0.3333333333333333,0.013148627,5
2020-10-25-170110,170110,0,1,3,279,0.6666666666666666,0.012747046,6
2020-10-26-170110,170110,3,0,0,282,1.0,0.016348101,0
2020-10-27-170110,170110,3,0,2,285,1.3333333333333333,0.06099362,1
2020-10-28-170110,170110,0,0,0,285,1.0,0.058586355,2
2020-10-29-170110,170110,2,0,3,287,0.6666666666666666,0.020739805,3
2020-10-30-170110,170110,2,0,3,289,1.6666666666666667,0.03866346,4
2020-10-31-170110,170110,0,0,0,289,0.0,0.012886738,5
2020-11-01-170110,170110,0,0,0,289,1.6666666666666667,0.017288962,6
2020-11-02-170110,170110,0,0,0,289,0.6666666666666666,0.00467248,0
2020-11-03-170110,170110,1,0,0,290,2.6666666666666665,0.022989828,1
2020-11-04-170110,170110,0,0,0,290,0.3333333333333333,0.033011794,2
2020-11-05-170110,170110,0,0,0,290,1.3333333333333333,0.032622494,3
2020-11-06-170110,170110,1,0,0,291,1.3333333333333333,0.054843385,4
2020-11-07-170110,170110,0,0,0,291,0.3333333333333333,0.010249953,5
2020-11-08-170110,170110,3,0,0,294,1.3333333333333333,0.011354366,6
2020-11-09-170110,170110,0,0,0,294,0.0,0.008063078,0
2020-11-10-170110,170110,2,0,0,296,0.3333333333333333,0.015645543,1
2020-11-11-170110,170110,0,0,0,296,1.3333333333333333,0.032917764,2
2020-11-12-170110,170110,3,0,0,299,2.0,0.05610667,3
2020-11-13-170110,170110,3,0,0,302,1.0,0.03776159,4
2020-03-01-170111,170111,0,0,1,0,0.0,0.004377223,6
2020-03-02-170111,170111,0,0,7,0,0.0,0.00032348494,0
2020-03-03-170111,170111,0,0,4,0,0.0,0.00019670354,1
2020-03-04-170111,170111,0,0,8,0,0.0,0.0038893623,2
2020-03-05-170111,170111,0,0,12,0,0.5,0.012846977,3
2020-03-06-170111,170111,0,0,11,0,0.0,0.00024669597,4
2020-03-07-170111,170111,0,0,1,0,0.0,0.0007832495,5
2020-03-08-170111,170111,0,0,1,0,0.0,2.8751481e-05,6
2020-03-09-170111,170111,0,0,10,0,0.0,0.00018431706,0
2020-03-10-170111,170111,0,0,7,0,0.0,0.016192928,1
2020-03-11-170111,170111,1,0,7,1,0.5,0.17712714,2
2020-03-12-170111,170111,1,0,9,2,0.0,0.030768597,3
2020-03-13-170111,170111,1,0,5,3,1.0,0.32782513,4
2020-03-14-170111,170111,2,0,2,5,0.0,0.0425088,5
2020-03-15-170111,170111,1,0,2,6,0.0,0.022792505,6
2020-03-16-170111,170111,7,0,4,13,3.0,0.4648469,0
2020-03-17-170111,170111,4,2,7,17,1.5,0.2343322,1
2020-03-18-170111,170111,8,0,10,25,6.0,1.1849432,2
2020-03-19-170111,170111,12,0,5,37,3.5,0.915606,3
2020-03-20-170111,170111,11,0,4,48,2.5,0.677598,4
2020-03-21-170111,170111,1,1,1,49,0.5,0.12693866,5
2020-03-22-170111,170111,1,0,3,50,0.0,0.12467649,6
2020-03-23-170111,170111,10,0,9,60,8.0,1.5158268,0
2020-03-24-170111,170111,7,0,4,67,4.5,0.6937701,1
2020-03-25-170111,170111,7,0,3,74,4.5,1.0020989,2
2020-03-26-170111,170111,9,0,3,83,7.0,1.0633614,3
2020-03-27-170111,170111,5,0,11,88,5.0,0.60294414,4
2020-03-28-170111,170111,2,0,1,90,3.0,0.3286415,5
2020-03-29-170111,170111,2,0,0,92,2.5,0.26872736,6
2020-03-30-170111,170111,4,0,17,96,4.5,0.7951703,0
2020-03-31-170111,170111,7,2,2,103,6.5,1.2453679,1
2020-04-01-170111,170111,10,0,3,113,6.5,0.87249684,2
2020-04-02-170111,170111,5,0,5,118,13.0,1.3727586,3
2020-04-03-170111,170111,4,0,8,122,4.5,0.5391113,4
2020-04-04-170111,170111,1,0,0,123,4.0,0.17631318,5
2020-04-05-170111,170111,3,0,0,126,1.0,0.24435177,6
2020-04-06-170111,170111,9,0,5,135,9.0,1.1136312,0
2020-04-07-170111,170111,4,2,3,139,8.5,0.7857913,1
2020-04-08-170111,170111,3,0,2,142,5.5,0.36063865,2
2020-04-09-170111,170111,3,2,0,145,2.5,0.57660896,3
2020-04-10-170111,170111,11,0,6,156,8.5,0.63976777,4
2020-04-11-170111,170111,1,1,7,157,0.5,0.037828512,5
2020-04-12-170111,170111,0,0,1,157,4.0,0.8796047,6
2020-04-13-170111,170111,17,0,11,174,4.5,0.5535088,0
2020-04-14-170111,170111,2,0,1,176,10.0,2.275781,1
2020-04-15-170111,170111,3,0,2,179,2.5,0.33439192,2
2020-04-16-170111,170111,5,0,1,184,4.0,0.62394977,3
2020-04-17-170111,170111,8,0,1,192,3.5,0.3552835,4
2020-04-18-170111,170111,0,0,0,192,0.5,0.12169859,5
2020-04-19-170111,170111,0,0,3,192,2.5,0.41808066,6
2020-04-20-170111,170111,5,0,3,197,6.5,1.1058091,0
2020-04-21-170111,170111,3,0,2,200,6.0,0.8753214,1
2020-04-22-170111,170111,2,0,2,202,1.0,0.23628478,2
2020-04-23-170111,170111,0,1,2,202,0.0,0.1471195,3
2020-04-24-170111,170111,6,0,6,208,1.0,0.15087843,4
2020-04-25-170111,170111,7,0,1,215,0.5,0.106448084,5
2020-04-26-170111,170111,1,0,0,216,0.0,0.012794602,6
2020-04-27-170111,170111,11,0,2,227,3.0,0.2698679,0
2020-04-28-170111,170111,1,0,6,228,0.5,0.16753568,1
2020-04-29-170111,170111,2,0,0,230,4.0,0.40782472,2
2020-04-30-170111,170111,1,0,0,231,2.0,0.18966131,3
2020-05-01-170111,170111,1,0,3,232,0.0,0.010244262,4
2020-05-02-170111,170111,0,0,0,232,2.5,0.64203537,5
2020-05-03-170111,170111,3,0,0,235,0.5,0.14927718,6
2020-05-04-170111,170111,3,0,2,238,2.5,0.34193504,0
2020-05-05-170111,170111,2,0,2,240,0.5,0.18182065,1
2020-05-06-170111,170111,2,0,0,242,2.0,0.21891488,2
2020-05-07-170111,170111,2,0,3,244,1.5,0.3945389,3
2020-05-08-170111,170111,6,0,5,250,10.5,0.6659682,4
2020-05-09-170111,170111,1,0,0,251,1.5,0.148847,5
2020-05-10-170111,170111,0,0,0,251,1.0,0.24206507,6
2020-05-11-170111,170111,2,0,0,253,3.5,0.86691606,0
2020-05-12-170111,170111,6,0,1,259,3.0,0.43382782,1
2020-05-13-170111,170111,0,2,2,259,1.5,0.04324268,2
2020-05-14-170111,170111,0,0,2,259,2.0,0.261586,3
2020-05-15-170111,170111,3,0,0,262,1.5,0.19212674,4
2020-05-16-170111,170111,0,0,0,262,0.0,0.002698164,5
2020-05-17-170111,170111,0,0,0,262,1.0,0.15449095,6
2020-05-18-170111,170111,2,0,1,264,3.0,0.6824926,0
2020-05-19-170111,170111,2,0,1,266,0.5,0.19687705,1
2020-05-20-170111,170111,0,0,1,266,0.5,0.04034364,2
2020-05-21-170111,170111,3,0,1,269,1.5,0.21050186,3
2020-05-22-170111,170111,5,0,0,274,2.0,0.30169648,4
2020-05-23-170111,170111,0,0,0,274,0.5,0.15769821,5
2020-05-24-170111,170111,0,0,0,274,0.0,0.013507331,6
2020-05-25-170111,170111,0,0,6,274,2.0,0.06889739,0
2020-05-26-170111,170111,1,0,0,275,2.5,0.42408717,1
2020-05-27-170111,170111,2,0,1,277,0.5,0.07246241,2
2020-05-28-170111,170111,2,0,1,279,8.0,0.55358225,3
2020-05-29-170111,170111,0,5,2,279,0.5,0.16336817,4
2020-05-30-170111,170111,0,0,0,279,0.5,0.010868387,5
2020-05-31-170111,170111,0,0,1,279,0.0,0.021250276,6
2020-06-01-170111,170111,1,0,0,280,1.0,0.054519,0
2020-06-02-170111,170111,1,0,2,281,4.5,0.562787,1
2020-06-03-170111,170111,1,0,0,282,2.0,0.28218272,2
2020-06-04-170111,170111,1,0,0,283,0.5,0.22141863,3
2020-06-05-170111,170111,0,0,0,283,0.5,0.01936454,4
2020-06-06-170111,170111,0,0,0,283,1.0,0.023972552,5
2020-06-07-170111,170111,0,0,0,283,0.0,0.0034161021,6
2020-06-08-170111,170111,6,0,0,289,1.0,0.2552295,0
2020-06-09-170111,170111,0,0,0,289,1.0,0.14759657,1
2020-06-10-170111,170111,1,0,1,290,0.5,0.023778856,2
2020-06-11-170111,170111,1,0,0,291,1.0,0.02977178,3
2020-06-12-170111,170111,2,0,0,293,1.0,0.28696024,4
2020-06-13-170111,170111,0,0,1,293,0.0,0.005436282,5
2020-06-14-170111,170111,1,0,0,294,0.5,0.027030779,6
2020-06-15-170111,170111,0,2,0,294,0.5,0.11827487,0
2020-06-16-170111,170111,2,0,0,296,1.0,0.14981234,1
2020-06-17-170111,170111,0,0,2,296,3.0,0.20918307,2
2020-06-18-170111,170111,0,0,0,296,3.0,0.08881223,3
2020-06-19-170111,170111,0,0,1,296,0.0,0.008205817,4
2020-06-20-170111,170111,0,1,0,296,0.0,0.032623596,5
2020-06-21-170111,170111,0,0,0,296,2.0,0.060679033,6
2020-06-22-170111,170111,0,0,1,296,1.0,0.19286719,0
2020-06-23-170111,170111,0,0,0,296,0.5,0.16668963,1
2020-06-24-170111,170111,1,0,0,297,0.0,0.040962644,2
2020-06-25-170111,170111,0,1,1,297,0.5,0.02074754,3
2020-06-26-170111,170111,0,0,0,297,0.0,0.060702696,4
2020-06-27-170111,170111,1,0,0,298,0.5,0.051676482,5
2020-06-28-170111,170111,0,0,0,298,0.5,0.15431485,6
2020-06-29-170111,170111,0,0,3,298,0.5,0.021052444,0
2020-06-30-170111,170111,0,0,0,298,0.0,0.01913454,1
2020-07-01-170111,170111,2,0,1,300,0.5,0.05448467,2
2020-07-02-170111,170111,0,0,0,300,1.0,0.22580811,3
2020-07-03-170111,170111,1,0,1,301,0.0,0.04088425,4
2020-07-04-170111,170111,0,0,0,301,0.0,0.0041638077,5
2020-07-05-170111,170111,0,0,0,301,0.0,0.00058156863,6
2020-07-06-170111,170111,1,0,0,302,0.0,0.037148904,0
2020-07-07-170111,170111,0,0,0,302,0.0,0.0044591785,1
2020-07-08-170111,170111,0,0,1,302,0.0,0.007435359,2
2020-07-09-170111,170111,1,0,0,303,0.5,0.05115899,3
2020-07-10-170111,170111,0,0,2,303,1.5,0.4517348,4
2020-07-11-170111,170111,0,0,1,303,0.0,0.03966036,5
2020-07-12-170111,170111,0,0,0,303,0.5,0.0127326315,6
2020-07-13-170111,170111,3,0,1,306,0.5,0.20187534,0
2020-07-14-170111,170111,0,0,1,306,0.5,0.033273812,1
2020-07-15-170111,170111,1,0,0,307,0.0,0.024433825,2
2020-07-16-170111,170111,0,0,2,307,0.0,0.019700084,3
2020-07-17-170111,170111,1,1,0,308,0.0,0.2233226,4
2020-07-18-170111,170111,0,0,0,308,0.0,0.046676915,5
2020-07-19-170111,170111,0,0,0,308,0.0,0.00078569556,6
2020-07-20-170111,170111,0,1,2,308,0.0,0.04610685,0
2020-07-21-170111,170111,0,0,0,308,0.0,0.0080591235,1
2020-07-22-170111,170111,1,0,0,309,0.5,0.045239996,2
2020-07-23-170111,170111,0,0,2,309,0.0,0.0076983175,3
2020-07-24-170111,170111,2,0,0,311,0.0,0.02035002,4
2020-07-25-170111,170111,1,0,0,312,0.0,0.014655103,5
2020-07-26-170111,170111,0,0,2,312,0.5,0.014044078,6
2020-07-27-170111,170111,1,0,2,313,0.0,0.040427398,0
2020-07-28-170111,170111,1,0,1,314,0.0,0.028084368,1
2020-07-29-170111,170111,0,0,0,314,0.0,0.008005859,2
2020-07-30-170111,170111,2,0,8,316,0.0,0.0561215,3
2020-07-31-170111,170111,0,0,0,316,1.0,0.36204457,4
2020-08-01-170111,170111,0,0,2,316,0.0,0.0026395211,5
2020-08-02-170111,170111,0,0,0,316,0.0,0.006236955,6
2020-08-03-170111,170111,2,0,2,318,0.0,0.08111245,0
2020-08-04-170111,170111,0,0,2,318,0.0,0.057726648,1
2020-08-05-170111,170111,0,0,3,318,0.5,0.29593354,2
2020-08-06-170111,170111,2,0,0,320,0.5,0.31634417,3
2020-08-07-170111,170111,0,0,1,320,0.5,0.08097036,4
2020-08-08-170111,170111,0,0,1,320,0.0,0.28541607,5
2020-08-09-170111,170111,2,0,1,322,0.5,0.19934113,6
2020-08-10-170111,170111,2,0,3,324,1.0,0.37047687,0
2020-08-11-170111,170111,1,0,3,325,2.0,0.2954142,1
2020-08-12-170111,170111,0,0,8,325,1.5,0.87380415,2
2020-08-13-170111,170111,8,0,5,333,2.0,0.31490907,3
2020-08-14-170111,170111,0,0,5,333,1.0,0.47769168,4
2020-08-15-170111,170111,2,0,7,335,0.5,0.29020432,5
2020-08-16-170111,170111,0,0,2,335,1.0,0.2111914,6
2020-08-17-170111,170111,2,0,8,337,0.5,0.17913425,0
2020-08-18-170111,170111,2,0,2,339,0.0,0.11141836,1
2020-08-19-170111,170111,3,0,5,342,1.0,0.60820633,2
2020-08-20-170111,170111,0,0,10,342,1.0,0.37518656,3
2020-08-21-170111,170111,1,0,9,343,2.0,0.38954553,4
2020-08-22-170111,170111,1,0,1,344,0.5,0.2618373,5
2020-08-23-170111,170111,1,0,3,345,1.0,0.26899612,6
2020-08-24-170111,170111,3,0,4,348,1.5,0.31872764,0
2020-08-25-170111,170111,3,0,4,351,1.0,0.14557314,1
2020-08-26-170111,170111,8,1,4,359,1.5,0.33804184,2
2020-08-27-170111,170111,5,0,4,364,2.0,0.2286064,3
2020-08-28-170111,170111,5,0,2,369,1.0,0.115258746,4
2020-08-29-170111,170111,7,1,0,376,1.5,0.28236088,5
2020-08-30-170111,170111,2,0,0,378,1.5,0.3570893,6
2020-08-31-170111,170111,8,0,9,386,0.5,0.17249341,0
2020-09-01-170111,170111,2,0,3,388,0.0,0.06726513,1
2020-09-02-170111,170111,5,0,3,393,1.0,0.09120694,2
2020-09-03-170111,170111,10,0,10,403,0.0,0.17650957,3
2020-09-04-170111,170111,9,0,2,412,3.0,0.6069429,4
2020-09-05-170111,170111,1,0,7,413,5.0,0.2057477,5
2020-09-06-170111,170111,3,0,2,416,4.5,0.66074103,6
2020-09-07-170111,170111,4,0,4,420,0.0,0.19035561,0
2020-09-08-170111,170111,4,0,1,424,5.0,0.85542494,1
2020-09-09-170111,170111,4,0,7,428,2.0,0.34656203,2
2020-09-10-170111,170111,4,2,11,432,2.5,0.42625746,3
2020-09-11-170111,170111,2,0,5,434,2.0,0.6193926,4
2020-09-12-170111,170111,0,0,2,434,1.0,0.04923988,5
2020-09-13-170111,170111,0,1,3,434,0.5,0.19629811,6
2020-09-14-170111,170111,9,0,3,443,3.5,1.0724169,0
2020-09-15-170111,170111,3,0,4,446,2.0,0.27417168,1
2020-09-16-170111,170111,3,1,11,449,1.5,0.1808334,2
2020-09-17-170111,170111,10,0,5,459,0.5,0.37660956,3
2020-09-18-170111,170111,2,0,8,461,6.5,0.9516322,4
2020-09-19-170111,170111,7,1,0,468,0.0,0.11053234,5
2020-09-20-170111,170111,2,0,0,470,3.0,0.11403433,6
2020-09-21-170111,170111,4,0,2,474,3.0,0.25349966,0
2020-09-22-170111,170111,1,0,2,475,3.5,0.50230587,1
2020-09-23-170111,170111,7,0,1,482,8.5,0.9981242,2
2020-09-24-170111,170111,11,1,1,493,6.5,0.81054765,3
2020-09-25-170111,170111,5,1,1,498,7.5,0.82790333,4
2020-09-26-170111,170111,2,0,0,500,2.5,0.28149456,5
2020-09-27-170111,170111,3,0,2,503,0.0,0.0412821,6
2020-09-28-170111,170111,3,0,2,506,3.5,0.5201527,0
2020-09-29-170111,170111,4,0,4,510,2.0,0.27769214,1
2020-09-30-170111,170111,11,0,1,521,3.5,0.46136323,2
2020-10-01-170111,170111,5,0,3,526,4.0,0.31981027,3
2020-10-02-170111,170111,8,0,2,534,3.5,0.3436032,4
2020-10-03-170111,170111,0,0,2,534,1.5,0.39024955,5
2020-10-04-170111,170111,0,0,1,534,3.0,0.20187947,6
2020-10-05-170111,170111,2,0,5,536,2.0,0.17689745,0
2020-10-06-170111,170111,2,0,2,538,3.5,0.27554142,1
2020-10-07-170111,170111,1,1,8,539,0.5,0.14654575,2
2020-10-08-170111,170111,1,0,4,540,2.0,0.17079313,3
2020-10-09-170111,170111,1,2,1,541,3.0,1.2396702,4
2020-10-10-170111,170111,0,0,0,541,1.5,0.40128872,5
2020-10-11-170111,170111,2,0,6,543,0.5,0.051985104,6
2020-10-12-170111,170111,2,0,2,545,2.5,0.63430405,0
2020-10-13-170111,170111,4,0,1,549,3.0,0.21981622,1
2020-10-14-170111,170111,1,0,5,550,4.0,0.7545557,2
2020-10-15-170111,170111,3,0,2,553,1.5,0.07953721,3
2020-10-16-170111,170111,2,0,3,555,2.5,0.538788,4
2020-10-17-170111,170111,2,0,1,557,1.0,0.1947074,5
2020-10-18-170111,170111,1,0,4,558,1.5,0.18719181,6
2020-10-19-170111,170111,5,0,0,563,4.0,0.96703976,0
2020-10-20-170111,170111,2,0,8,565,3.5,0.34538776,1
2020-10-21-170111,170111,8,0,3,573,0.0,0.2573161,2
2020-10-22-170111,170111,4,0,11,577,5.0,1.1404461,3
2020-10-23-170111,170111,1,0,8,578,7.5,0.8129032,4
2020-10-24-170111,170111,0,0,3,578,2.5,0.58888215,5
2020-10-25-170111,170111,6,0,1,584,5.0,0.7058437,6
2020-10-26-170111,170111,2,1,2,586,6.0,0.5171848,0
2020-10-27-170111,170111,1,0,2,587,6.0,0.6024639,1
2020-10-28-170111,170111,5,1,4,592,5.5,1.0738944,2
2020-10-29-170111,170111,2,1,4,594,14.5,3.1733413,3
2020-10-30-170111,170111,3,0,2,597,12.5,1.3739505,4
2020-10-31-170111,170111,1,1,0,598,5.0,0.80657256,5
2020-11-01-170111,170111,4,2,0,602,11.0,0.45484614,6
2020-11-02-170111,170111,0,1,0,602,2.0,0.21301103,0
2020-11-03-170111,170111,8,1,0,610,7.0,1.5889779,1
2020-11-04-170111,170111,3,0,0,613,16.0,1.4817234,2
2020-11-05-170111,170111,11,0,0,624,17.0,1.6322821,3
2020-11-06-170111,170111,8,0,0,632,10.0,1.3378675,4
2020-11-07-170111,170111,3,0,0,635,5.5,0.5574071,5
2020-11-08-170111,170111,1,0,0,636,2.5,0.43581325,6
2020-11-09-170111,170111,2,0,0,638,1.5,0.09790361,0
2020-11-10-170111,170111,2,0,0,640,2.5,0.14142664,1
2020-11-11-170111,170111,4,1,0,644,3.0,0.39111337,2
2020-11-12-170111,170111,4,0,0,648,4.0,0.3689727,3
2020-11-13-170111,170111,2,1,0,650,4.5,0.3266078,4
2020-03-01-170112,170112,0,0,0,0,0.5,0.05258848,6
2020-03-02-170112,170112,0,0,1,0,0.0,0.0058641355,0
2020-03-03-170112,170112,0,0,1,0,0.0,0.00058189477,1
2020-03-04-170112,170112,0,1,1,0,0.0,0.0008628128,2
2020-03-05-170112,170112,0,7,1,0,0.25,0.056289375,3
2020-03-06-170112,170112,0,0,0,0,0.0,0.00045509043,4
2020-03-07-170112,170112,0,0,2,0,0.0,0.00065804995,5
2020-03-08-170112,170112,0,0,0,0,0.0,0.00024157384,6
2020-03-09-170112,170112,0,0,2,0,0.0,0.0007027587,0
2020-03-10-170112,170112,0,0,3,0,0.25,0.052691944,1
2020-03-11-170112,170112,0,0,5,0,0.0,0.023365162,2
2020-03-12-170112,170112,0,0,1,0,0.25,0.021722706,3
2020-03-13-170112,170112,1,0,3,1,0.5,0.23519377,4
2020-03-14-170112,170112,0,0,5,1,0.5,0.03237564,5
2020-03-15-170112,170112,0,0,5,1,0.5,0.09358471,6
2020-03-16-170112,170112,1,0,3,2,3.0,0.36146334,0
2020-03-17-170112,170112,1,0,3,3,2.0,0.25219348,1
2020-03-18-170112,170112,1,0,2,4,1.5,0.44004494,2
2020-03-19-170112,170112,1,0,5,5,4.5,0.9240658,3
2020-03-20-170112,170112,0,0,2,5,2.25,0.4096711,4
2020-03-21-170112,170112,2,0,0,7,2.0,0.26343656,5
2020-03-22-170112,170112,0,0,0,7,2.25,0.2571735,6
2020-03-23-170112,170112,2,0,4,9,7.5,1.2399244,0
2020-03-24-170112,170112,3,0,1,12,5.25,0.89676857,1
2020-03-25-170112,170112,5,0,0,17,6.75,1.2983528,2
2020-03-26-170112,170112,1,0,0,18,6.75,1.1552906,3
2020-03-27-170112,170112,3,0,12,21,5.0,0.91955435,4
2020-03-28-170112,170112,5,0,0,26,4.5,0.8456917,5
2020-03-29-170112,170112,5,0,3,31,3.5,0.5962495,6
2020-03-30-170112,170112,3,0,1,34,7.5,0.9737464,0
2020-03-31-170112,170112,3,0,1,37,5.0,0.86173373,1
2020-04-01-170112,170112,2,0,17,39,4.25,0.63363487,2
2020-04-02-170112,170112,5,0,3,44,4.0,0.9783466,3
2020-04-03-170112,170112,2,0,1,46,2.5,0.3954354,4
2020-04-04-170112,170112,0,0,0,46,2.5,0.33786094,5
2020-04-05-170112,170112,0,0,0,46,1.0,0.071106024,6
2020-04-06-170112,170112,4,0,0,50,4.0,0.953347,0
2020-04-07-170112,170112,1,0,0,51,1.5,0.43512896,1
2020-04-08-170112,170112,0,1,0,51,2.5,0.33851755,2
2020-04-09-170112,170112,0,0,0,51,2.25,0.28750306,3
2020-04-10-170112,170112,12,0,0,63,3.0,1.0614735,4
2020-04-11-170112,170112,0,0,0,63,2.5,0.24724229,5
2020-04-12-170112,170112,3,0,0,66,0.75,0.3597893,6
2020-04-13-170112,170112,1,0,0,67,3.25,0.4377622,0
2020-04-14-170112,170112,1,0,0,68,3.75,1.0044938,1
2020-04-15-170112,170112,17,0,1,85,2.25,1.4438354,2
2020-04-16-170112,170112,3,0,2,88,2.25,0.60081506,3
2020-04-17-170112,170112,1,0,0,89,2.75,0.36381888,4
2020-04-18-170112,170112,0,0,0,89,2.0,0.27243435,5
2020-04-19-170112,170112,0,0,0,89,1.25,0.1569402,6
2020-04-20-170112,170112,0,2,0,89,3.75,0.5133485,0
2020-04-21-170112,170112,0,0,0,89,2.0,0.3485883,1
2020-04-22-170112,170112,0,0,1,89,3.75,0.6482246,2
2020-04-23-170112,170112,0,0,1,89,1.25,0.15248924,3
2020-04-24-170112,170112,0,0,0,89,2.75,0.4069176,4
2020-04-25-170112,170112,0,0,0,89,0.75,0.079729214,5
2020-04-26-170112,170112,0,0,0,89,0.75,0.058711004,6
2020-04-27-170112,170112,0,0,2,89,2.0,0.33385083,0
2020-04-28-170112,170112,0,0,2,89,1.75,0.18864006,1
2020-04-29-170112,170112,1,0,0,90,3.25,0.6040631,2
2020-04-30-170112,170112,2,0,0,92,1.25,0.31874517,3
2020-05-01-170112,170112,0,0,1,92,0.5,0.039341964,4
2020-05-02-170112,170112,0,0,0,92,1.0,0.28619957,5
2020-05-03-170112,170112,0,0,0,92,0.0,0.04014172,6
2020-05-04-170112,170112,0,0,2,92,1.5,0.43837443,0
2020-05-05-170112,170112,0,0,0,92,1.0,0.22000225,1
2020-05-06-170112,170112,1,0,0,93,1.5,0.40600294,2
2020-05-07-170112,170112,1,0,0,94,1.75,0.42926475,3
2020-05-08-170112,170112,0,0,0,94,1.75,0.44773638,4
2020-05-09-170112,170112,0,0,0,94,0.5,0.06968447,5
2020-05-10-170112,170112,0,0,0,94,0.5,0.10122823,6
2020-05-11-170112,170112,2,1,2,96,1.25,0.48980618,0
2020-05-12-170112,170112,2,0,3,98,1.25,0.32629544,1
2020-05-13-170112,170112,0,0,0,98,0.75,0.18094657,2
2020-05-14-170112,170112,0,3,0,98,0.75,0.2280271,3
2020-05-15-170112,170112,1,0,0,99,0.75,0.16421412,4
2020-05-16-170112,170112,0,1,0,99,0.5,0.08634443,5
2020-05-17-170112,170112,0,0,0,99,0.0,0.017305296,6
2020-05-18-170112,170112,2,0,0,101,2.25,0.6849013,0
2020-05-19-170112,170112,0,0,0,101,0.5,0.17280462,1
2020-05-20-170112,170112,0,0,0,101,0.5,0.12426148,2
2020-05-21-170112,170112,0,0,0,101,0.75,0.19036901,3
2020-05-22-170112,170112,0,0,1,101,1.0,0.23821312,4
2020-05-23-170112,170112,0,0,0,101,0.5,0.10897299,5
2020-05-24-170112,170112,0,0,0,101,0.25,0.041644927,6
2020-05-25-170112,170112,2,0,0,103,0.75,0.2739732,0
2020-05-26-170112,170112,3,0,1,106,0.5,0.40922034,1
2020-05-27-170112,170112,0,0,1,106,2.5,0.5179887,2
2020-05-28-170112,170112,0,0,0,106,1.0,0.34533718,3
2020-05-29-170112,170112,0,10,0,106,0.0,0.12330193,4
2020-05-30-170112,170112,0,0,0,106,0.0,0.0027950131,5
2020-05-31-170112,170112,0,0,0,106,0.0,0.002761862,6
2020-06-01-170112,170112,0,0,0,106,0.0,0.02255653,0
2020-06-02-170112,170112,0,1,0,106,2.0,0.5374849,1
2020-06-03-170112,170112,0,0,0,106,0.75,0.17657022,2
2020-06-04-170112,170112,0,0,0,106,0.5,0.18481088,3
2020-06-05-170112,170112,1,0,0,107,1.25,0.19299407,4
2020-06-06-170112,170112,0,0,0,107,0.25,0.052786935,5
2020-06-07-170112,170112,0,0,0,107,0.0,0.00064473134,6
2020-06-08-170112,170112,0,0,0,107,0.5,0.12219791,0
2020-06-09-170112,170112,1,0,1,108,0.0,0.119379304,1
2020-06-10-170112,170112,1,0,1,109,0.75,0.22271107,2
2020-06-11-170112,170112,0,0,0,109,0.5,0.12990263,3
2020-06-12-170112,170112,0,0,0,109,0.5,0.21867222,4
2020-06-13-170112,170112,0,0,1,109,0.25,0.054762073,5
2020-06-14-170112,170112,0,0,1,109,0.0,0.0073560383,6
2020-06-15-170112,170112,0,0,0,109,0.5,0.14605537,0
2020-06-16-170112,170112,0,0,0,109,0.75,0.16898432,1
2020-06-17-170112,170112,0,0,0,109,0.25,0.062525764,2
2020-06-18-170112,170112,0,0,0,109,1.0,0.15979369,3
2020-06-19-170112,170112,0,0,0,109,2.5,0.30721474,4
2020-06-20-170112,170112,0,0,0,109,0.25,0.060369045,5
2020-06-21-170112,170112,0,0,0,109,0.5,0.10179147,6
2020-06-22-170112,170112,0,0,0,109,0.25,0.14413571,0
2020-06-23-170112,170112,1,0,0,110,0.75,0.3575387,1
2020-06-24-170112,170112,1,0,1,111,0.75,0.31396845,2
2020-06-25-170112,170112,0,2,0,111,0.25,0.047913246,3
2020-06-26-170112,170112,0,0,0,111,0.5,0.16201998,4
2020-06-27-170112,170112,1,0,0,112,0.25,0.17081182,5
2020-06-28-170112,170112,1,0,0,113,0.5,0.26067552,6
2020-06-29-170112,170112,0,0,0,113,0.0,0.00667843,0
2020-06-30-170112,170112,0,0,0,113,0.25,0.07126275,1
2020-07-01-170112,170112,0,0,0,113,0.5,0.14113858,2
2020-07-02-170112,170112,0,0,0,113,0.0,0.07494163,3
2020-07-03-170112,170112,0,0,0,113,0.0,0.009089252,4
2020-07-04-170112,170112,0,1,0,113,0.25,0.066256024,5
2020-07-05-170112,170112,0,0,0,113,0.25,0.08384136,6
2020-07-06-170112,170112,0,0,0,113,0.25,0.07139428,0
2020-07-07-170112,170112,0,1,0,113,0.25,0.0590172,1
2020-07-08-170112,170112,1,0,0,114,0.25,0.09977187,2
2020-07-09-170112,170112,0,0,0,114,0.75,0.15368639,3
2020-07-10-170112,170112,0,0,0,114,0.0,0.13205513,4
2020-07-11-170112,170112,0,0,0,114,0.5,0.16988696,5
2020-07-12-170112,170112,0,0,0,114,0.0,0.0026607944,6
2020-07-13-170112,170112,0,0,0,114,0.25,0.14655524,0
2020-07-14-170112,170112,0,0,0,114,0.0,0.03357626,1
2020-07-15-170112,170112,0,0,0,114,0.25,0.084295034,2
2020-07-16-170112,170112,0,0,0,114,0.5,0.06324047,3
2020-07-17-170112,170112,0,0,0,114,0.25,0.13095354,4
2020-07-18-170112,170112,0,0,0,114,0.0,0.011022849,5
2020-07-19-170112,170112,0,0,0,114,0.75,0.21118799,6
2020-07-20-170112,170112,0,0,0,114,0.25,0.10240915,0
2020-07-21-170112,170112,0,0,0,114,0.25,0.08901838,1
2020-07-22-170112,170112,0,0,0,114,0.0,0.008352775,2
2020-07-23-170112,170112,0,0,0,114,0.5,0.15680006,3
2020-07-24-170112,170112,0,0,0,114,0.0,0.05054507,4
2020-07-25-170112,170112,0,0,0,114,0.0,0.0010032833,5
2020-07-26-170112,170112,0,0,0,114,0.25,0.07770364,6
2020-07-27-170112,170112,0,0,0,114,0.0,0.033173148,0
2020-07-28-170112,170112,0,0,0,114,0.0,0.011478072,1
2020-07-29-170112,170112,0,0,0,114,0.5,0.126237,2
2020-07-30-170112,170112,0,0,0,114,0.5,0.10050138,3
2020-07-31-170112,170112,0,0,0,114,0.5,0.22334453,4
2020-08-01-170112,170112,0,0,0,114,0.25,0.0586489,5
2020-08-02-170112,170112,0,0,0,114,0.25,0.062213894,6
2020-08-03-170112,170112,0,0,0,114,0.75,0.27093676,0
2020-08-04-170112,170112,0,0,0,114,0.75,0.11606548,1
2020-08-05-170112,170112,0,0,2,114,0.25,0.1441146,2
2020-08-06-170112,170112,0,0,1,114,0.25,0.102884665,3
2020-08-07-170112,170112,0,0,0,114,0.5,0.16628398,4
2020-08-08-170112,170112,0,0,0,114,0.0,0.021020476,5
2020-08-09-170112,170112,0,0,1,114,0.0,0.039026093,6
2020-08-10-170112,170112,0,0,0,114,0.5,0.21093293,0
2020-08-11-170112,170112,0,0,0,114,1.25,0.34784913,1
2020-08-12-170112,170112,0,0,1,114,1.25,0.32833672,2
2020-08-13-170112,170112,0,0,1,114,0.75,0.17930295,3
2020-08-14-170112,170112,0,1,3,114,2.25,0.41137537,4
2020-08-15-170112,170112,0,0,4,114,2.25,0.48643318,5
2020-08-16-170112,170112,0,0,0,114,0.5,0.059431475,6
2020-08-17-170112,170112,0,0,1,114,1.0,0.23524582,0
2020-08-18-170112,170112,0,0,0,114,2.75,0.56432444,1
2020-08-19-170112,170112,2,0,1,116,2.5,0.8832542,2
2020-08-20-170112,170112,1,0,0,117,2.25,0.26169103,3
2020-08-21-170112,170112,0,0,4,117,5.75,1.2683569,4
2020-08-22-170112,170112,0,0,0,117,1.25,0.28381607,5
2020-08-23-170112,170112,1,0,0,118,1.25,0.3825036,6
2020-08-24-170112,170112,0,0,0,118,5.25,1.0665408,0
2020-08-25-170112,170112,0,0,0,118,7.5,1.3050189,1
2020-08-26-170112,170112,1,0,0,119,5.0,0.5838512,2
2020-08-27-170112,170112,1,0,1,120,4.5,0.5925853,3
2020-08-28-170112,170112,3,0,0,123,4.25,0.8541024,4
2020-08-29-170112,170112,4,0,0,127,1.75,0.6600718,5
2020-08-30-170112,170112,0,0,0,127,2.0,0.12537159,6
2020-08-31-170112,170112,1,0,0,128,3.0,0.498938,0
2020-09-01-170112,170112,0,0,1,128,4.5,0.48072287,1
2020-09-02-170112,170112,1,0,0,129,3.0,0.5550931,2
2020-09-03-170112,170112,0,1,0,129,2.0,0.39253873,3
2020-09-04-170112,170112,4,0,0,133,3.0,0.5708293,4
2020-09-05-170112,170112,0,0,0,133,3.25,0.5129763,5
2020-09-06-170112,170112,0,0,1,133,2.5,0.26788858,6
2020-09-07-170112,170112,0,0,0,133,3.75,0.45428488,0
2020-09-08-170112,170112,0,0,1,133,1.25,0.3256107,1
2020-09-09-170112,170112,0,0,3,133,1.0,0.2392046,2
2020-09-10-170112,170112,1,0,4,134,2.75,0.3988314,3
2020-09-11-170112,170112,0,0,1,134,7.25,0.9636354,4
2020-09-12-170112,170112,0,0,0,134,1.5,0.290066,5
2020-09-13-170112,170112,0,0,0,134,3.25,0.2840699,6
2020-09-14-170112,170112,0,0,0,134,3.25,0.6604346,0
2020-09-15-170112,170112,1,0,0,135,2.25,0.48343298,1
2020-09-16-170112,170112,0,0,0,135,3.25,0.763569,2
2020-09-17-170112,170112,0,0,0,135,2.75,0.61139655,3
2020-09-18-170112,170112,0,1,2,135,18.5,0.6757619,4
2020-09-19-170112,170112,0,0,0,135,8.0,0.77296376,5
2020-09-20-170112,170112,1,0,0,136,5.75,0.33325258,6
2020-09-21-170112,170112,0,0,1,136,3.0,0.3174772,0
2020-09-22-170112,170112,1,0,0,137,2.75,0.5540896,1
2020-09-23-170112,170112,3,1,0,140,3.75,0.94919825,2
2020-09-24-170112,170112,4,0,0,144,3.25,1.2457337,3
2020-09-25-170112,170112,1,0,0,145,3.0,0.73422766,4
2020-09-26-170112,170112,0,0,1,145,1.5,0.557761,5
2020-09-27-170112,170112,0,0,0,145,1.5,0.063357495,6
2020-09-28-170112,170112,0,0,2,145,1.75,0.37541008,0
2020-09-29-170112,170112,0,0,3,145,1.25,0.27999312,1
2020-09-30-170112,170112,0,0,1,145,3.5,0.48561588,2
2020-10-01-170112,170112,0,1,5,145,4.5,0.8107117,3
2020-10-02-170112,170112,2,0,1,147,3.0,1.0045701,4
2020-10-03-170112,170112,0,0,4,147,1.5,0.45866555,5
2020-10-04-170112,170112,0,0,0,147,2.5,0.38991386,6
2020-10-05-170112,170112,1,0,0,148,3.25,0.6392841,0
2020-10-06-170112,170112,0,0,1,148,2.75,0.8635487,1
2020-10-07-170112,170112,0,0,2,148,3.5,0.54512954,2
2020-10-08-170112,170112,0,0,1,148,2.25,0.42603508,3
2020-10-09-170112,170112,0,0,1,148,2.25,1.1154559,4
2020-10-10-170112,170112,1,0,0,149,0.75,0.28372768,5
2020-10-11-170112,170112,0,0,3,149,0.5,0.093602836,6
2020-10-12-170112,170112,2,0,1,151,0.75,0.28143135,0
2020-10-13-170112,170112,3,0,1,154,2.25,0.51952934,1
2020-10-14-170112,170112,1,0,0,155,2.25,0.39849815,2
2020-10-15-170112,170112,5,0,2,160,3.0,0.49966192,3
2020-10-16-170112,170112,1,0,3,161,5.25,0.42322445,4
2020-10-17-170112,170112,4,0,0,165,3.5,1.0143912,5
2020-10-18-170112,170112,0,0,1,165,2.25,0.21723117,6
2020-10-19-170112,170112,0,0,0,165,6.5,0.63733387,0
2020-10-20-170112,170112,1,2,0,166,4.75,0.9066697,1
2020-10-21-170112,170112,2,0,2,168,3.75,0.57989204,2
2020-10-22-170112,170112,1,0,3,169,6.5,0.82701004,3
2020-10-23-170112,170112,1,0,1,170,6.25,1.0530353,4
2020-10-24-170112,170112,0,0,0,170,7.0,1.0616264,5
2020-10-25-170112,170112,3,0,1,173,3.0,0.6237217,6
2020-10-26-170112,170112,1,0,0,174,7.25,1.0633936,0
2020-10-27-170112,170112,1,0,0,175,7.5,1.5152656,1
2020-10-28-170112,170112,0,0,2,175,8.0,1.5897725,2
2020-10-29-170112,170112,2,0,1,177,8.25,2.1251097,3
2020-10-30-170112,170112,3,0,2,180,8.5,2.193494,4
2020-10-31-170112,170112,0,0,0,180,4.0,1.0213025,5
2020-11-01-170112,170112,1,0,0,181,3.5,0.79905397,6
2020-11-02-170112,170112,0,0,0,181,2.75,0.41520107,0
2020-11-03-170112,170112,0,1,0,181,5.5,0.9424423,1
2020-11-04-170112,170112,2,0,0,183,6.75,0.9737044,2
2020-11-05-170112,170112,3,0,0,186,4.25,1.2007984,3
2020-11-06-170112,170112,1,0,0,187,10.5,1.3869442,4
2020-11-07-170112,170112,0,2,0,187,2.75,0.58283687,5
2020-11-08-170112,170112,1,0,0,188,1.75,0.21742177,6
2020-11-09-170112,170112,0,0,0,188,6.75,0.502213,0
2020-11-10-170112,170112,0,0,0,188,6.25,0.75601596,1
2020-11-11-170112,170112,2,0,0,190,3.25,0.753112,2
2020-11-12-170112,170112,1,1,0,191,6.75,1.1463767,3
2020-11-13-170112,170112,2,0,0,193,7.25,1.106804,4
2020-03-01-170113,170113,0,0,0,0,0.0,0.0020684584,6
2020-03-02-170113,170113,0,0,0,0,0.0,0.0034896976,0
2020-03-03-170113,170113,0,0,0,0,0.125,0.066487715,1
2020-03-04-170113,170113,0,0,0,0,0.0,0.00018756016,2
2020-03-05-170113,170113,0,3,2,0,0.0,0.00083637884,3
2020-03-06-170113,170113,0,0,0,0,0.0,0.0013220866,4
2020-03-07-170113,170113,0,0,1,0,0.0,0.0004828427,5
2020-03-08-170113,170113,0,0,0,0,0.0,0.00012504251,6
2020-03-09-170113,170113,0,0,6,0,0.0,0.00072669075,0
2020-03-10-170113,170113,0,0,0,0,0.0,0.001542225,1
2020-03-11-170113,170113,0,0,8,0,0.125,0.03821408,2
2020-03-12-170113,170113,0,1,0,0,0.125,0.021406442,3
2020-03-13-170113,170113,0,0,0,0,0.75,0.16507734,4
2020-03-14-170113,170113,1,0,0,1,0.0,0.0063962564,5
2020-03-15-170113,170113,0,0,0,1,0.25,0.07563779,6
2020-03-16-170113,170113,0,0,4,1,1.125,0.1934716,0
2020-03-17-170113,170113,0,0,5,1,0.375,0.089885585,1
2020-03-18-170113,170113,0,0,2,1,3.5,0.4942506,2
2020-03-19-170113,170113,2,0,1,3,3.0,0.64098877,3
2020-03-20-170113,170113,0,0,1,3,2.625,0.26807073,4
2020-03-21-170113,170113,1,3,0,4,0.25,0.116434604,5
2020-03-22-170113,170113,0,0,0,4,1.0,0.32311928,6
2020-03-23-170113,170113,6,0,2,10,4.625,1.3993254,0
2020-03-24-170113,170113,0,0,0,10,2.0,0.30958328,1
2020-03-25-170113,170113,8,0,0,18,3.375,0.9298104,2
2020-03-26-170113,170113,0,0,0,18,2.875,0.4100265,3
2020-03-27-170113,170113,0,0,0,18,3.375,0.44766513,4
2020-03-28-170113,170113,0,0,0,18,1.125,0.11645334,5
2020-03-29-170113,170113,0,0,0,18,1.875,0.2853036,6
2020-03-30-170113,170113,4,0,0,22,2.875,0.6642104,0
2020-03-31-170113,170113,5,0,0,27,3.0,0.67419726,1
2020-04-01-170113,170113,2,0,1,29,4.25,0.48906383,2
2020-04-02-170113,170113,1,0,0,30,5.125,0.8629032,3
2020-04-03-170113,170113,1,0,1,31,3.0,0.5099622,4
2020-04-04-170113,170113,0,0,0,31,0.875,0.07825701,5
2020-04-05-170113,170113,0,0,0,31,0.875,0.099305876,6
2020-04-06-170113,170113,2,0,0,33,4.25,1.0452138,0
2020-04-07-170113,170113,0,0,1,33,2.625,0.54013276,1
2020-04-08-170113,170113,0,0,0,33,1.75,0.37803444,2
2020-04-09-170113,170113,0,0,0,33,2.625,0.4975373,3
2020-04-10-170113,170113,0,0,0,33,5.25,0.37617242,4
2020-04-11-170113,170113,0,0,0,33,1.125,0.049748443,5
2020-04-12-170113,170113,0,0,0,33,1.25,0.2568995,6
2020-04-13-170113,170113,0,0,0,33,2.5,0.58052015,0
2020-04-14-170113,170113,0,0,0,33,3.375,0.9345351,1
2020-04-15-170113,170113,1,0,1,34,3.625,0.92788273,2
2020-04-16-170113,170113,0,0,0,34,2.625,0.6403935,3
2020-04-17-170113,170113,1,0,0,35,1.75,0.50417054,4
2020-04-18-170113,170113,0,0,0,35,0.75,0.1441356,5
2020-04-19-170113,170113,0,0,0,35,1.125,0.2818939,6
2020-04-20-170113,170113,0,0,1,35,2.5,0.48947832,0
2020-04-21-170113,170113,1,0,1,36,1.625,0.5317035,1
2020-04-22-170113,170113,0,0,0,36,1.0,0.20164415,2
2020-04-23-170113,170113,0,0,1,36,0.0,0.04728781,3
2020-04-24-170113,170113,0,0,1,36,0.875,0.07965645,4
2020-04-25-170113,170113,0,0,0,36,0.375,0.023304794,5
2020-04-26-170113,170113,0,0,0,36,0.0,0.0031734006,6
2020-04-27-170113,170113,0,0,0,36,1.0,0.14089045,0
2020-04-28-170113,170113,0,0,0,36,1.125,0.17833863,1
2020-04-29-170113,170113,1,0,0,37,2.25,0.42210764,2
2020-04-30-170113,170113,0,0,0,37,0.5,0.11593791,3
2020-05-01-170113,170113,0,0,0,37,0.25,0.03027025,4
2020-05-02-170113,170113,0,0,0,37,0.625,0.25424775,5
2020-05-03-170113,170113,0,0,0,37,0.25,0.05388064,6
2020-05-04-170113,170113,1,0,0,38,0.625,0.3537768,0
2020-05-05-170113,170113,1,0,0,39,0.5,0.22971246,1
2020-05-06-170113,170113,0,0,1,39,2.125,0.2857019,2
2020-05-07-170113,170113,1,0,1,40,0.625,0.4445449,3
2020-05-08-170113,170113,1,0,0,41,1.875,0.48690832,4
2020-05-09-170113,170113,0,0,0,41,0.5,0.045498535,5
2020-05-10-170113,170113,0,0,0,41,0.5,0.114616364,6
2020-05-11-170113,170113,0,0,1,41,1.875,0.30126178,0
2020-05-12-170113,170113,0,0,0,41,1.125,0.317071,1
2020-05-13-170113,170113,0,0,0,41,0.25,0.12807372,2
2020-05-14-170113,170113,0,1,0,41,1.125,0.20216179,3
2020-05-15-170113,170113,0,0,0,41,0.75,0.058819607,4
2020-05-16-170113,170113,0,0,0,41,0.125,0.028814597,5
2020-05-17-170113,170113,0,0,0,41,0.125,0.03733014,6
2020-05-18-170113,170113,0,0,0,41,1.25,0.47460592,0
2020-05-19-170113,170113,0,0,0,41,0.625,0.09773076,1
2020-05-20-170113,170113,1,0,0,42,0.75,0.42634562,2
2020-05-21-170113,170113,1,0,1,43,0.75,0.4735832,3
2020-05-22-170113,170113,0,0,1,43,0.75,0.35063985,4
2020-05-23-170113,170113,0,0,0,43,0.375,0.1118609,5
2020-05-24-170113,170113,0,0,0,43,0.125,0.0135619445,6
2020-05-25-170113,170113,1,0,0,44,0.75,0.18289535,0
2020-05-26-170113,170113,0,0,1,44,0.875,0.23905917,1
2020-05-27-170113,170113,0,0,0,44,0.5,0.05821448,2
2020-05-28-170113,170113,0,0,0,44,0.625,0.27996904,3
2020-05-29-170113,170113,0,2,0,44,0.5,0.117566615,4
2020-05-30-170113,170113,0,0,0,44,0.0,0.0005783567,5
2020-05-31-170113,170113,0,0,0,44,0.375,0.021800138,6
2020-06-01-170113,170113,0,0,0,44,0.125,0.025849257,0
2020-06-02-170113,170113,0,0,0,44,1.0,0.3118711,1
2020-06-03-170113,170113,0,0,0,44,0.75,0.09981111,2
2020-06-04-170113,170113,1,0,0,45,0.375,0.08886589,3
2020-06-05-170113,170113,1,0,0,46,0.125,0.13187478,4
2020-06-06-170113,170113,0,0,0,46,0.125,0.046717428,5
2020-06-07-170113,170113,0,0,0,46,0.125,0.00025646543,6
2020-06-08-170113,170113,0,0,0,46,0.875,0.15102099,0
2020-06-09-170113,170113,1,0,0,47,0.25,0.116438024,1
2020-06-10-170113,170113,0,0,0,47,0.0,0.010267876,2
2020-06-11-170113,170113,0,1,1,47,0.375,0.0042075277,3
2020-06-12-170113,170113,0,0,0,47,0.375,0.1157069,4
2020-06-13-170113,170113,0,0,0,47,0.0,0.0041418187,5
2020-06-14-170113,170113,0,1,0,47,0.125,0.0048066988,6
2020-06-15-170113,170113,0,0,1,47,0.25,0.05182173,0
2020-06-16-170113,170113,0,0,0,47,0.375,0.055984028,1
2020-06-17-170113,170113,0,1,1,47,0.625,0.10197194,2
2020-06-18-170113,170113,0,0,0,47,0.25,0.024626076,3
2020-06-19-170113,170113,0,0,0,47,0.125,0.22655348,4
2020-06-20-170113,170113,0,0,0,47,0.25,0.027874682,5
2020-06-21-170113,170113,0,0,0,47,0.0,0.0034239758,6
2020-06-22-170113,170113,0,0,0,47,0.375,0.055413928,0
2020-06-23-170113,170113,0,0,2,47,0.5,0.11611796,1
2020-06-24-170113,170113,0,0,0,47,0.5,0.17214723,2
2020-06-25-170113,170113,1,2,0,48,0.125,0.09696837,3
2020-06-26-170113,170113,0,0,0,48,0.375,0.092215076,4
2020-06-27-170113,170113,0,0,0,48,0.0,0.0032594788,5
2020-06-28-170113,170113,0,0,0,48,0.125,0.062330186,6
2020-06-29-170113,170113,1,1,0,49,0.375,0.324637,0
2020-06-30-170113,170113,0,0,2,49,0.125,0.01772346,1
2020-07-01-170113,170113,1,0,2,50,0.25,0.017801013,2
2020-07-02-170113,170113,0,0,0,50,0.375,0.12657475,3
2020-07-03-170113,170113,0,0,0,50,0.125,0.01988424,4
2020-07-04-170113,170113,0,0,0,50,0.0,0.0015026582,5
2020-07-05-170113,170113,0,0,0,50,0.0,0.0009356622,6
2020-07-06-170113,170113,0,0,0,50,0.25,0.116026856,0
2020-07-07-170113,170113,2,0,0,52,0.0,0.18137035,1
2020-07-08-170113,170113,0,0,0,52,0.125,0.11131373,2
2020-07-09-170113,170113,0,0,1,52,0.125,0.0042478447,3
2020-07-10-170113,170113,0,0,0,52,0.5,0.17544304,4
2020-07-11-170113,170113,0,0,0,52,0.5,0.11115783,5
2020-07-12-170113,170113,0,0,0,52,0.125,0.11792863,6
2020-07-13-170113,170113,0,0,1,52,0.5,0.13651322,0
2020-07-14-170113,170113,2,0,0,54,0.375,0.27394977,1
2020-07-15-170113,170113,2,0,0,56,0.125,0.18656619,2
2020-07-16-170113,170113,0,0,0,56,0.125,0.027232675,3
2020-07-17-170113,170113,0,0,0,56,0.625,0.31133184,4
2020-07-18-170113,170113,0,0,0,56,0.25,0.05193327,5
2020-07-19-170113,170113,0,0,0,56,0.0,0.0023314452,6
2020-07-20-170113,170113,0,0,0,56,0.375,0.043271564,0
2020-07-21-170113,170113,0,0,0,56,0.0,0.0054175113,1
2020-07-22-170113,170113,0,0,2,56,0.375,0.15761314,2
2020-07-23-170113,170113,1,0,1,57,0.375,0.38750488,3
2020-07-24-170113,170113,0,0,4,57,0.0,0.00353623,4
2020-07-25-170113,170113,0,0,0,57,0.0,0.00029667682,5
2020-07-26-170113,170113,0,0,0,57,0.0,0.0013733382,6
2020-07-27-170113,170113,1,0,0,58,0.375,0.2312869,0
2020-07-28-170113,170113,0,0,3,58,1.125,0.7162991,1
2020-07-29-170113,170113,0,0,1,58,0.5,0.22922751,2
2020-07-30-170113,170113,0,0,1,58,0.125,0.025871245,3
2020-07-31-170113,170113,0,0,2,58,0.25,0.24326429,4
2020-08-01-170113,170113,0,0,0,58,0.0,0.006270732,5
2020-08-02-170113,170113,0,0,0,58,0.25,0.15752903,6
2020-08-03-170113,170113,0,0,2,58,0.25,0.044933047,0
2020-08-04-170113,170113,0,0,0,58,0.5,0.19860016,1
2020-08-05-170113,170113,2,0,0,60,0.625,0.47363234,2
2020-08-06-170113,170113,1,0,0,61,2.375,1.4090768,3
2020-08-07-170113,170113,4,0,1,65,1.0,1.014862,4
2020-08-08-170113,170113,0,0,0,65,1.375,0.2439452,5
2020-08-09-170113,170113,0,0,0,65,0.375,0.094775505,6
2020-08-10-170113,170113,0,0,1,65,0.875,0.5674325,0
2020-08-11-170113,170113,3,0,1,68,1.625,1.4948424,1
2020-08-12-170113,170113,1,0,1,69,1.125,1.0454679,2
2020-08-13-170113,170113,1,0,0,70,1.25,0.9267181,3
2020-08-14-170113,170113,2,0,0,72,1.25,0.9557627,4
2020-08-15-170113,170113,0,0,3,72,1.25,0.44367108,5
2020-08-16-170113,170113,0,0,3,72,0.375,0.1396954,6
2020-08-17-170113,170113,2,0,0,74,1.25,0.6662094,0
2020-08-18-170113,170113,0,0,0,74,0.5,0.18965043,1
2020-08-19-170113,170113,0,0,0,74,2.0,0.74957573,2
2020-08-20-170113,170113,0,0,2,74,7.125,0.53710705,3
2020-08-21-170113,170113,1,0,0,75,1.375,0.8545709,4
2020-08-22-170113,170113,0,0,0,75,4.5,0.2944024,5
2020-08-23-170113,170113,0,0,0,75,1.125,0.21173611,6
2020-08-24-170113,170113,1,0,2,76,1.125,0.5150582,0
2020-08-25-170113,170113,1,0,0,77,1.5,0.52605784,1
2020-08-26-170113,170113,1,0,5,78,1.75,0.28494477,2
2020-08-27-170113,170113,0,0,1,78,1.125,0.45763063,3
2020-08-28-170113,170113,0,0,3,78,1.0,0.46720043,4
2020-08-29-170113,170113,3,0,0,81,2.0,0.4124256,5
2020-08-30-170113,170113,3,0,1,84,0.875,0.635276,6
2020-08-31-170113,170113,0,0,1,84,1.125,0.37845877,0
2020-09-01-170113,170113,0,0,1,84,0.5,0.22985753,1
2020-09-02-170113,170113,0,0,4,84,0.5,0.08631942,2
2020-09-03-170113,170113,2,0,0,86,3.25,0.7604445,3
2020-09-04-170113,170113,0,0,5,86,3.25,1.4065871,4
2020-09-05-170113,170113,0,0,0,86,0.625,0.20003413,5
2020-09-06-170113,170113,0,0,1,86,0.75,0.37264892,6
2020-09-07-170113,170113,2,0,0,88,0.75,0.2601519,0
2020-09-08-170113,170113,0,0,1,88,1.625,0.3822403,1
2020-09-09-170113,170113,5,0,2,93,1.625,0.69947654,2
2020-09-10-170113,170113,1,0,0,94,0.875,0.25175536,3
2020-09-11-170113,170113,3,0,1,97,1.875,0.7194285,4
2020-09-12-170113,170113,0,0,0,97,3.125,0.09075957,5
2020-09-13-170113,170113,1,0,0,98,0.625,0.18537448,6
2020-09-14-170113,170113,1,0,0,99,1.625,0.70803285,0
2020-09-15-170113,170113,1,0,0,100,2.0,0.3473691,1
2020-09-16-170113,170113,4,0,1,104,1.5,0.48860025,2
2020-09-17-170113,170113,0,0,2,104,0.875,0.31150737,3
2020-09-18-170113,170113,5,0,1,109,3.25,0.92263806,4
2020-09-19-170113,170113,0,0,1,109,1.0,0.11218782,5
2020-09-20-170113,170113,1,0,0,110,0.125,0.14175822,6
2020-09-21-170113,170113,0,0,0,110,0.5,0.2852239,0
2020-09-22-170113,170113,1,0,0,111,1.625,0.6085842,1
2020-09-23-170113,170113,2,1,0,113,2.125,0.5519567,2
2020-09-24-170113,170113,0,0,0,113,1.5,0.6402981,3
2020-09-25-170113,170113,1,0,0,114,2.375,0.78892547,4
2020-09-26-170113,170113,0,0,0,114,1.125,0.3576854,5
2020-09-27-170113,170113,0,0,0,114,0.125,0.10473356,6
2020-09-28-170113,170113,0,0,0,114,1.5,0.69265354,0
2020-09-29-170113,170113,0,0,0,114,1.125,0.3289906,1
2020-09-30-170113,170113,1,0,0,115,2.0,0.5171541,2
2020-10-01-170113,170113,2,0,0,117,0.75,0.38003415,3
2020-10-02-170113,170113,1,0,0,118,1.25,0.6325221,4
2020-10-03-170113,170113,1,0,1,119,0.75,0.22477183,5
2020-10-04-170113,170113,0,0,0,119,0.875,0.2661559,6
2020-10-05-170113,170113,0,0,1,119,1.875,0.59796834,0
2020-10-06-170113,170113,0,0,0,119,0.75,0.2071773,1
2020-10-07-170113,170113,0,1,0,119,1.625,0.42854092,2
2020-10-08-170113,170113,0,0,0,119,2.0,0.7727819,3
2020-10-09-170113,170113,0,1,0,119,2.125,1.1671813,4
2020-10-10-170113,170113,0,0,0,119,2.25,0.8340783,5
2020-10-11-170113,170113,0,0,1,119,1.375,0.721359,6
2020-10-12-170113,170113,0,0,0,119,1.75,0.48819152,0
2020-10-13-170113,170113,0,0,0,119,1.75,0.7797288,1
2020-10-14-170113,170113,0,0,0,119,1.75,0.43312526,2
2020-10-15-170113,170113,0,0,0,119,0.5,0.19796744,3
2020-10-16-170113,170113,0,0,1,119,0.875,0.4061722,4
2020-10-17-170113,170113,1,0,0,120,0.25,0.19135617,5
2020-10-18-170113,170113,0,0,1,120,1.375,0.27633548,6
2020-10-19-170113,170113,1,0,1,121,1.5,0.6312287,0
2020-10-20-170113,170113,0,0,1,121,0.5,0.17164792,1
2020-10-21-170113,170113,0,1,0,121,1.5,0.44131625,2
2020-10-22-170113,170113,0,0,3,121,2.0,0.56962556,3
2020-10-23-170113,170113,0,0,0,121,2.5,0.6236339,4
2020-10-24-170113,170113,0,0,0,121,0.625,0.30564234,5
2020-10-25-170113,170113,1,0,3,122,1.25,0.34680334,6
2020-10-26-170113,170113,0,0,0,122,2.25,0.31945792,0
2020-10-27-170113,170113,0,0,1,122,2.25,0.82264805,1
2020-10-28-170113,170113,0,0,1,122,1.875,0.64421666,2
2020-10-29-170113,170113,0,0,1,122,3.25,0.9341452,3
2020-10-30-170113,170113,1,0,1,123,3.875,1.0054398,4
2020-10-31-170113,170113,0,0,0,123,1.75,0.38682064,5
2020-11-01-170113,170113,1,0,0,124,2.0,0.562052,6
2020-11-02-170113,170113,1,0,0,125,0.625,0.18576859,0
2020-11-03-170113,170113,1,0,0,126,2.5,1.0618742,1
2020-11-04-170113,170113,0,0,0,126,2.5,0.46182087,2
2020-11-05-170113,170113,3,0,0,129,3.0,0.87788844,3
2020-11-06-170113,170113,0,0,0,129,3.625,0.937936,4
2020-11-07-170113,170113,0,0,0,129,1.5,0.3965829,5
2020-11-08-170113,170113,3,0,0,132,1.375,0.44482544,6
2020-11-09-170113,170113,0,0,0,132,0.5,0.09467546,0
2020-11-10-170113,170113,1,0,0,133,0.625,0.15288286,1
2020-11-11-170113,170113,1,0,0,134,2.0,0.3773572,2
2020-11-12-170113,170113,1,0,0,135,2.125,0.40370795,3
2020-11-13-170113,170113,1,0,0,136,2.875,0.5235044,4
2020-03-01-170114,170114,0,0,2,0,0.0,0.0018109358,6
2020-03-02-170114,170114,0,0,3,0,0.0,7.4329764e-05,0
2020-03-03-170114,170114,0,0,8,0,0.0,1.19157e-05,1
2020-03-04-170114,170114,1,0,4,1,0.0,0.00977762,2
2020-03-05-170114,170114,0,1,8,1,0.0,0.0020302988,3
2020-03-06-170114,170114,0,0,7,1,0.0,0.00074308424,4
2020-03-07-170114,170114,0,0,3,1,0.0,4.9047947e-05,5
2020-03-08-170114,170114,0,0,1,1,0.0,6.5604045e-06,6
2020-03-09-170114,170114,0,0,3,1,0.25,0.00023940444,0
2020-03-10-170114,170114,3,0,3,4,0.0,0.03058791,1
2020-03-11-170114,170114,0,0,3,4,0.5,0.06466316,2
2020-03-12-170114,170114,0,0,3,4,0.75,0.010827673,3
2020-03-13-170114,170114,2,0,2,6,2.0,0.239288,4
2020-03-14-170114,170114,5,0,2,11,1.75,0.039630458,5
2020-03-15-170114,170114,2,0,3,13,1.75,0.018957993,6
2020-03-16-170114,170114,3,0,4,16,5.25,0.20539175,0
2020-03-17-170114,170114,8,1,3,24,4.75,0.1125101,1
2020-03-18-170114,170114,4,0,6,28,12.75,0.4803003,2
2020-03-19-170114,170114,8,0,4,36,9.0,0.34477466,3
2020-03-20-170114,170114,7,0,1,43,11.5,0.2711764,4
2020-03-21-170114,170114,3,7,1,46,5.75,0.04591293,5
2020-03-22-170114,170114,1,1,1,47,6.5,0.041075476,6
2020-03-23-170114,170114,3,0,2,50,17.0,0.42011693,0
2020-03-24-170114,170114,3,0,2,53,13.5,0.29282206,1
2020-03-25-170114,170114,3,0,1,56,11.5,0.32481128,2
2020-03-26-170114,170114,3,0,0,59,11.5,0.30861542,3
2020-03-27-170114,170114,2,0,0,61,13.25,0.19566403,4
2020-03-28-170114,170114,2,0,2,63,7.0,0.094714075,5
2020-03-29-170114,170114,3,0,0,66,3.25,0.0711439,6
2020-03-30-170114,170114,4,0,1,70,11.0,0.35871136,0
2020-03-31-170114,170114,3,0,3,73,9.75,0.48836544,1
2020-04-01-170114,170114,6,0,1,79,8.0,0.31237778,2
2020-04-02-170114,170114,4,0,0,83,7.25,0.41689524,3
2020-04-03-170114,170114,1,0,1,84,6.0,0.16766067,4
2020-04-04-170114,170114,1,0,0,85,1.5,0.047803972,5
2020-04-05-170114,170114,1,0,0,86,3.0,0.07660823,6
2020-04-06-170114,170114,2,0,0,88,8.5,0.44939315,0
2020-04-07-170114,170114,2,0,0,90,6.25,0.20985956,1
2020-04-08-170114,170114,1,0,1,91,5.75,0.10806187,2
2020-04-09-170114,170114,0,0,2,91,5.75,0.23087816,3
2020-04-10-170114,170114,0,0,2,91,4.5,0.25875568,4
2020-04-11-170114,170114,2,0,1,93,3.0,0.019820796,5
2020-04-12-170114,170114,0,0,0,93,2.75,0.2421435,6
2020-04-13-170114,170114,1,1,0,94,4.75,0.14346348,0
2020-04-14-170114,170114,3,0,1,97,9.5,0.7722253,1
2020-04-15-170114,170114,1,0,0,98,4.5,0.13887662,2
2020-04-16-170114,170114,0,0,0,98,5.0,0.22902325,3
2020-04-17-170114,170114,1,0,0,99,2.25,0.103738286,4
2020-04-18-170114,170114,0,0,1,99,0.5,0.02860166,5
2020-04-19-170114,170114,0,0,0,99,2.0,0.12491327,6
2020-04-20-170114,170114,0,0,0,99,5.25,0.4358895,0
2020-04-21-170114,170114,0,0,0,99,4.25,0.3553144,1
2020-04-22-170114,170114,1,0,0,100,3.0,0.10902429,2
2020-04-23-170114,170114,2,0,0,102,1.75,0.05580497,3
2020-04-24-170114,170114,2,0,0,104,4.0,0.03551148,4
2020-04-25-170114,170114,1,0,0,105,0.75,0.025697786,5
2020-04-26-170114,170114,0,0,0,105,2.0,0.0021901464,6
2020-04-27-170114,170114,0,0,0,105,2.5,0.085396565,0
2020-04-28-170114,170114,1,0,1,106,2.25,0.06389472,1
2020-04-29-170114,170114,0,0,1,106,2.5,0.14731729,2
2020-04-30-170114,170114,0,0,0,106,1.75,0.035051633,3
2020-05-01-170114,170114,0,0,1,106,0.5,0.0016084269,4
2020-05-02-170114,170114,1,0,0,107,2.25,0.141283,5
2020-05-03-170114,170114,0,0,0,107,0.75,0.04920894,6
2020-05-04-170114,170114,0,0,3,107,2.5,0.10237703,0
2020-05-05-170114,170114,0,0,0,107,2.5,0.05956816,1
2020-05-06-170114,170114,0,0,0,107,4.5,0.06151996,2
2020-05-07-170114,170114,0,0,0,107,2.75,0.12614232,3
2020-05-08-170114,170114,0,1,1,107,5.0,0.21673599,4
2020-05-09-170114,170114,0,0,0,107,0.75,0.039233036,5
2020-05-10-170114,170114,0,0,0,107,0.75,0.09636678,6
2020-05-11-170114,170114,0,0,0,107,6.0,0.34187648,0
2020-05-12-170114,170114,1,0,0,108,4.25,0.16752551,1
2020-05-13-170114,170114,1,0,1,109,2.5,0.025042519,2
2020-05-14-170114,170114,0,0,0,109,3.0,0.0822494,3
2020-05-15-170114,170114,1,0,1,110,3.25,0.06878177,4
2020-05-16-170114,170114,0,0,0,110,1.0,0.0006308855,5
2020-05-17-170114,170114,0,0,0,110,0.75,0.038085815,6
2020-05-18-170114,170114,3,0,2,113,8.25,0.23899777,0
2020-05-19-170114,170114,0,0,0,113,1.5,0.065685965,1
2020-05-20-170114,170114,0,0,2,113,2.0,0.007439181,2
2020-05-21-170114,170114,0,0,2,113,2.0,0.052274466,3
2020-05-22-170114,170114,1,0,1,114,3.0,0.08410028,4
2020-05-23-170114,170114,0,0,0,114,1.5,0.041065414,5
2020-05-24-170114,170114,0,0,1,114,1.0,0.0030683435,6
2020-05-25-170114,170114,0,0,0,114,2.0,0.006751823,0
2020-05-26-170114,170114,0,0,1,114,1.75,0.11682337,1
2020-05-27-170114,170114,1,0,0,115,2.75,0.022486622,2
2020-05-28-170114,170114,0,3,0,115,1.5,0.16619854,3
2020-05-29-170114,170114,1,2,1,116,2.25,0.062689126,4
2020-05-30-170114,170114,0,0,1,116,0.5,0.001370049,5
2020-05-31-170114,170114,0,0,0,116,0.25,0.0022597006,6
2020-06-01-170114,170114,2,0,0,118,1.5,0.016189877,0
2020-06-02-170114,170114,0,0,0,118,2.5,0.27093977,1
2020-06-03-170114,170114,2,0,0,120,1.25,0.083752275,2
2020-06-04-170114,170114,2,0,0,122,1.0,0.1213233,3
2020-06-05-170114,170114,1,0,0,123,0.75,0.013668902,4
2020-06-06-170114,170114,0,0,0,123,1.25,0.0030705456,5
2020-06-07-170114,170114,1,0,0,124,0.0,0.010926014,6
2020-06-08-170114,170114,0,0,1,124,1.0,0.0711817,0
2020-06-09-170114,170114,1,0,1,125,0.75,0.078449205,1
2020-06-10-170114,170114,0,0,0,125,0.5,0.0072654253,2
2020-06-11-170114,170114,0,0,0,125,0.0,0.008103216,3
2020-06-12-170114,170114,1,0,0,126,2.25,0.110732615,4
2020-06-13-170114,170114,1,0,0,127,0.5,0.011284439,5
2020-06-14-170114,170114,0,1,0,127,0.75,0.0056338105,6
2020-06-15-170114,170114,0,0,1,127,1.0,0.054516878,0
2020-06-16-170114,170114,0,0,0,127,1.0,0.060482007,1
2020-06-17-170114,170114,0,0,0,127,1.5,0.05326839,2
2020-06-18-170114,170114,0,0,0,127,0.0,0.012157481,3
2020-06-19-170114,170114,0,0,0,127,1.0,0.0022839324,4
2020-06-20-170114,170114,0,0,0,127,0.25,0.006373967,5
2020-06-21-170114,170114,0,0,0,127,0.0,0.005756269,6
2020-06-22-170114,170114,1,0,0,128,0.5,0.06640412,0
2020-06-23-170114,170114,1,0,0,129,0.5,0.07290272,1
2020-06-24-170114,170114,0,0,1,129,0.25,0.009312831,2
2020-06-25-170114,170114,0,0,3,129,0.25,0.0055511105,3
2020-06-26-170114,170114,0,0,5,129,0.5,0.010552197,4
2020-06-27-170114,170114,0,0,0,129,0.0,0.007860371,5
2020-06-28-170114,170114,0,0,0,129,0.5,0.05991538,6
2020-06-29-170114,170114,1,0,1,130,0.25,0.01592634,0
2020-06-30-170114,170114,0,0,0,130,1.0,0.002886539,1
2020-07-01-170114,170114,0,0,1,130,0.75,0.011790078,2
2020-07-02-170114,170114,0,0,0,130,0.5,0.06925469,3
2020-07-03-170114,170114,0,0,0,130,0.5,0.009825016,4
2020-07-04-170114,170114,0,1,0,130,0.25,0.0015606375,5
2020-07-05-170114,170114,0,0,0,130,0.0,0.00023569058,6
2020-07-06-170114,170114,0,0,1,130,0.5,0.008925057,0
2020-07-07-170114,170114,0,0,1,130,0.0,0.0027446046,1
2020-07-08-170114,170114,1,0,2,131,0.25,0.014831775,2
2020-07-09-170114,170114,3,0,0,134,0.25,0.03831617,3
2020-07-10-170114,170114,5,0,0,139,0.75,0.2240066,4
2020-07-11-170114,170114,0,0,0,139,0.25,0.0055440553,5
2020-07-12-170114,170114,0,0,0,139,0.0,0.001032463,6
2020-07-13-170114,170114,1,0,0,140,0.25,0.0957227,0
2020-07-14-170114,170114,0,0,0,140,0.25,0.006600644,1
2020-07-15-170114,170114,1,0,0,141,0.0,0.014443525,2
2020-07-16-170114,170114,0,0,0,141,0.0,0.004695715,3
2020-07-17-170114,170114,0,0,1,141,0.0,0.06324525,4
2020-07-18-170114,170114,0,0,0,141,0.5,0.009850855,5
2020-07-19-170114,170114,0,0,1,141,0.25,0.0021790548,6
2020-07-20-170114,170114,1,0,0,142,1.0,0.027393982,0
2020-07-21-170114,170114,1,0,0,143,0.25,0.017093293,1
2020-07-22-170114,170114,2,0,0,145,0.5,0.03239009,2
2020-07-23-170114,170114,0,0,0,145,0.0,0.0044466453,3
2020-07-24-170114,170114,0,0,0,145,0.5,0.005880446,4
2020-07-25-170114,170114,0,0,5,145,0.25,0.005601821,5
2020-07-26-170114,170114,0,0,0,145,0.0,0.0013896291,6
2020-07-27-170114,170114,0,0,0,145,0.0,0.0067461454,0
2020-07-28-170114,170114,0,0,1,145,0.0,0.0070334417,1
2020-07-29-170114,170114,0,0,0,145,0.5,0.0038369521,2
2020-07-30-170114,170114,0,0,0,145,0.75,0.012313724,3
2020-07-31-170114,170114,1,1,0,146,1.5,0.16051948,4
2020-08-01-170114,170114,0,0,0,146,0.0,0.0029843017,5
2020-08-02-170114,170114,1,0,0,147,0.25,0.023308065,6
2020-08-03-170114,170114,0,0,0,147,0.5,0.013295238,0
2020-08-04-170114,170114,0,0,0,147,0.25,0.008673635,1
2020-08-05-170114,170114,0,0,1,147,0.75,0.091433346,2
2020-08-06-170114,170114,0,0,1,147,0.5,0.09743517,3
2020-08-07-170114,170114,0,0,1,147,0.75,0.018421901,4
2020-08-08-170114,170114,5,0,0,152,0.25,0.100808606,5
2020-08-09-170114,170114,0,1,0,152,1.25,0.061151776,6
2020-08-10-170114,170114,0,0,2,152,1.0,0.13320038,0
2020-08-11-170114,170114,1,0,1,153,0.75,0.0965272,1
2020-08-12-170114,170114,0,0,2,153,1.75,0.2852967,2
2020-08-13-170114,170114,0,0,2,153,1.25,0.054178823,3
2020-08-14-170114,170114,0,0,1,153,1.0,0.14777987,4
2020-08-15-170114,170114,0,0,0,153,1.25,0.07729633,5
2020-08-16-170114,170114,0,0,3,153,0.75,0.05998291,6
2020-08-17-170114,170114,0,0,8,153,0.5,0.046081293,0
2020-08-18-170114,170114,0,0,1,153,1.25,0.02340779,1
2020-08-19-170114,170114,1,0,3,154,1.75,0.23108591,2
2020-08-20-170114,170114,1,0,1,155,1.75,0.11068888,3
2020-08-21-170114,170114,1,0,1,156,0.25,0.12764685,4
2020-08-22-170114,170114,0,0,1,156,1.5,0.08726945,5
2020-08-23-170114,170114,0,0,4,156,1.25,0.09918452,6
2020-08-24-170114,170114,2,0,7,158,1.5,0.1553223,0
2020-08-25-170114,170114,1,0,3,159,2.0,0.048505407,1
2020-08-26-170114,170114,2,0,1,161,1.5,0.12310661,2
2020-08-27-170114,170114,2,0,0,163,2.5,0.049955197,3
2020-08-28-170114,170114,1,0,8,164,1.25,0.037744712,4
2020-08-29-170114,170114,0,0,0,164,0.5,0.113377586,5
2020-08-30-170114,170114,3,0,1,167,0.75,0.13955308,6
2020-08-31-170114,170114,8,0,10,175,0.75,0.10497116,0
2020-09-01-170114,170114,1,0,3,176,2.0,0.024774922,1
2020-09-02-170114,170114,3,0,6,179,3.0,0.042662527,2
2020-09-03-170114,170114,1,0,2,180,3.5,0.042875562,3
2020-09-04-170114,170114,1,0,9,181,2.5,0.16636969,4
2020-09-05-170114,170114,1,0,2,182,1.25,0.03764088,5
2020-09-06-170114,170114,4,0,0,186,1.25,0.26922518,6
2020-09-07-170114,170114,7,0,4,193,3.25,0.09374582,0
2020-09-08-170114,170114,3,0,9,196,3.25,0.29166782,1
2020-09-09-170114,170114,1,0,2,197,0.75,0.08033163,2
2020-09-10-170114,170114,0,0,0,197,2.0,0.16121356,3
2020-09-11-170114,170114,8,0,3,205,2.75,0.23976989,4
2020-09-12-170114,170114,0,0,0,205,1.25,0.021145238,5
2020-09-13-170114,170114,1,0,0,206,1.5,0.08579333,6
2020-09-14-170114,170114,10,0,3,216,3.5,0.4606552,0
2020-09-15-170114,170114,3,0,0,219,1.25,0.11238906,1
2020-09-16-170114,170114,6,0,2,225,1.5,0.086756565,2
2020-09-17-170114,170114,2,0,3,227,2.25,0.14017841,3
2020-09-18-170114,170114,9,0,0,236,4.0,0.48977134,4
2020-09-19-170114,170114,2,0,1,238,1.0,0.04904692,5
2020-09-20-170114,170114,0,0,0,238,2.25,0.015258595,6
2020-09-21-170114,170114,4,0,0,242,1.75,0.082012795,0
2020-09-22-170114,170114,9,0,2,251,1.0,0.21159047,1
2020-09-23-170114,170114,2,1,1,253,4.0,0.2788287,2
2020-09-24-170114,170114,0,0,1,253,3.5,0.2213279,3
2020-09-25-170114,170114,3,0,1,256,2.75,0.28134122,4
2020-09-26-170114,170114,0,0,0,256,2.5,0.056381587,5
2020-09-27-170114,170114,0,0,0,256,1.0,0.0092502115,6
2020-09-28-170114,170114,3,0,1,259,4.0,0.2187109,0
2020-09-29-170114,170114,0,0,0,259,1.25,0.07371121,1
2020-09-30-170114,170114,2,0,1,261,4.0,0.14704478,2
2020-10-01-170114,170114,3,0,0,264,2.0,0.09621372,3
2020-10-02-170114,170114,0,0,0,264,4.75,0.08178506,4
2020-10-03-170114,170114,1,0,0,265,2.5,0.17191225,5
2020-10-04-170114,170114,0,1,0,265,0.75,0.043876763,6
2020-10-05-170114,170114,0,0,0,265,1.5,0.058913946,0
2020-10-06-170114,170114,2,0,0,267,2.0,0.11801628,1
2020-10-07-170114,170114,1,0,1,268,2.25,0.05028281,2
2020-10-08-170114,170114,1,0,3,269,1.0,0.046949748,3
2020-10-09-170114,170114,1,0,0,270,5.5,0.4260447,4
2020-10-10-170114,170114,0,0,1,270,1.5,0.13422897,5
2020-10-11-170114,170114,0,0,1,270,1.5,0.028460912,6
2020-10-12-170114,170114,1,0,0,271,1.0,0.17428268,0
2020-10-13-170114,170114,0,0,3,271,3.75,0.097939625,1
2020-10-14-170114,170114,1,0,2,272,4.75,0.2637915,2
2020-10-15-170114,170114,0,0,5,272,0.25,0.020877685,3
2020-10-16-170114,170114,0,0,1,272,3.0,0.18139142,4
2020-10-17-170114,170114,0,0,2,272,1.5,0.07202412,5
2020-10-18-170114,170114,0,1,0,272,4.25,0.037970904,6
2020-10-19-170114,170114,0,0,2,272,7.0,0.33176023,0
2020-10-20-170114,170114,0,0,0,272,2.25,0.095802054,1
2020-10-21-170114,170114,1,0,1,273,2.75,0.055566266,2
2020-10-22-170114,170114,3,0,0,276,5.0,0.44264966,3
2020-10-23-170114,170114,0,0,2,276,8.5,0.24141239,4
2020-10-24-170114,170114,1,0,0,277,2.5,0.21978885,5
2020-10-25-170114,170114,1,0,0,278,5.0,0.22553916,6
2020-10-26-170114,170114,0,1,0,278,7.0,0.15199316,0
2020-10-27-170114,170114,3,0,2,281,3.25,0.26205343,1
2020-10-28-170114,170114,2,0,0,283,3.0,0.34470385,2
2020-10-29-170114,170114,5,0,0,288,9.5,1.1339569,3
2020-10-30-170114,170114,1,0,3,289,7.75,0.43931952,4
2020-10-31-170114,170114,2,0,0,291,4.0,0.30744416,5
2020-11-01-170114,170114,0,0,0,291,3.0,0.08087316,6
2020-11-02-170114,170114,2,0,0,293,2.25,0.08512302,0
2020-11-03-170114,170114,0,0,0,293,5.75,0.60397923,1
2020-11-04-170114,170114,1,0,0,294,6.5,0.48059395,2
2020-11-05-170114,170114,0,0,0,294,7.5,0.55042696,3
2020-11-06-170114,170114,2,1,0,296,6.75,0.5271669,4
2020-11-07-170114,170114,0,0,0,296,2.5,0.21805336,5
2020-11-08-170114,170114,0,0,0,296,3.0,0.16122703,6
2020-11-09-170114,170114,0,0,0,296,3.25,0.027378071,0
2020-11-10-170114,170114,2,0,0,298,3.0,0.051510654,1
2020-11-11-170114,170114,0,0,0,298,4.0,0.08505696,2
2020-11-12-170114,170114,0,0,0,298,7.75,0.09464829,3
2020-11-13-170114,170114,3,0,0,301,4.25,0.10752507,4
2020-03-01-170115,170115,0,0,0,0,0.4,0.055951737,6
2020-03-02-170115,170115,0,0,0,0,0.0,0.0064949202,0
2020-03-03-170115,170115,0,0,1,0,0.0,0.00072310667,1
2020-03-04-170115,170115,0,0,0,0,0.0,0.001085232,2
2020-03-05-170115,170115,0,2,1,0,0.2,0.05664962,3
2020-03-06-170115,170115,0,0,1,0,0.0,0.00044814326,4
2020-03-07-170115,170115,0,0,0,0,0.0,0.000794544,5
2020-03-08-170115,170115,0,0,0,0,0.0,0.00030361733,6
2020-03-09-170115,170115,0,0,3,0,0.0,0.0008339752,0
2020-03-10-170115,170115,0,0,3,0,0.2,0.052730013,1
2020-03-11-170115,170115,0,0,1,0,0.0,0.026107032,2
2020-03-12-170115,170115,0,0,3,0,0.2,0.026189225,3
2020-03-13-170115,170115,0,0,3,0,0.4,0.2615239,4
2020-03-14-170115,170115,0,0,1,0,0.4,0.03977189,5
2020-03-15-170115,170115,0,0,1,0,0.4,0.105961464,6
2020-03-16-170115,170115,0,0,2,0,2.8,0.3997256,0
2020-03-17-170115,170115,1,0,0,1,1.8,0.26445955,1
2020-03-18-170115,170115,0,0,3,1,1.4,0.47787496,2
2020-03-19-170115,170115,1,2,0,2,4.2,0.976902,3
2020-03-20-170115,170115,1,4,0,3,1.8,0.4495166,4
2020-03-21-170115,170115,0,0,2,3,2.0,0.2958492,5
2020-03-22-170115,170115,0,0,0,3,2.0,0.25550437,6
2020-03-23-170115,170115,3,0,2,6,6.6,1.3607917,0
2020-03-24-170115,170115,3,0,0,9,4.2,0.9930381,1
2020-03-25-170115,170115,1,0,1,10,6.2,1.4212928,2
2020-03-26-170115,170115,3,0,0,13,5.6,1.245791,3
2020-03-27-170115,170115,3,0,0,16,4.4,1.0067698,4
2020-03-28-170115,170115,1,0,0,17,4.8,0.9269964,5
2020-03-29-170115,170115,1,0,0,18,3.6,0.660135,6
2020-03-30-170115,170115,2,0,0,20,6.4,1.0732703,0
2020-03-31-170115,170115,0,0,0,20,4.6,0.9566122,1
2020-04-01-170115,170115,3,0,0,23,3.4,0.7203571,2
2020-04-02-170115,170115,0,0,0,23,4.2,1.0655566,3
2020-04-03-170115,170115,0,0,0,23,3.6,0.4419847,4
2020-04-04-170115,170115,2,0,0,25,2.0,0.36831188,5
2020-04-05-170115,170115,0,0,1,25,0.8,0.07396625,6
2020-04-06-170115,170115,2,0,0,27,4.0,1.073297,0
2020-04-07-170115,170115,0,2,0,27,2.2,0.48471394,1
2020-04-08-170115,170115,1,0,0,28,2.8,0.37088656,2
2020-04-09-170115,170115,0,0,0,28,1.6,0.30339092,3
2020-04-10-170115,170115,0,0,2,28,4.6,1.2036593,4
2020-04-11-170115,170115,0,0,0,28,2.4,0.26196685,5
2020-04-12-170115,170115,0,0,0,28,2.0,0.41623825,6
2020-04-13-170115,170115,0,0,1,28,3.4,0.45364678,0
2020-04-14-170115,170115,0,0,1,28,3.6,1.1131694,1
2020-04-15-170115,170115,0,0,1,28,5.6,1.59284,2
2020-04-16-170115,170115,0,0,0,28,2.6,0.6156562,3
2020-04-17-170115,170115,0,0,0,28,2.6,0.39014226,4
2020-04-18-170115,170115,0,0,1,28,1.6,0.27510646,5
2020-04-19-170115,170115,1,0,0,29,0.8,0.17516892,6
2020-04-20-170115,170115,0,0,0,29,3.0,0.5208234,0
2020-04-21-170115,170115,0,0,0,29,1.8,0.3909163,1
2020-04-22-170115,170115,0,0,1,29,3.2,0.6673764,2
2020-04-23-170115,170115,0,0,0,29,1.2,0.15255585,3
2020-04-24-170115,170115,2,0,0,31,2.6,0.4474496,4
2020-04-25-170115,170115,0,0,0,31,0.6,0.0798521,5
2020-04-26-170115,170115,0,0,0,31,0.6,0.05867699,6
2020-04-27-170115,170115,1,1,0,32,1.6,0.34571603,0
2020-04-28-170115,170115,1,0,0,33,1.2,0.21250346,1
2020-04-29-170115,170115,1,0,0,34,2.8,0.6582314,2
2020-04-30-170115,170115,0,0,0,34,1.4,0.33720365,3
2020-05-01-170115,170115,0,0,0,34,0.4,0.041094646,4
2020-05-02-170115,170115,1,0,0,35,0.6,0.29269654,5
2020-05-03-170115,170115,0,0,0,35,0.0,0.037296697,6
2020-05-04-170115,170115,0,0,1,35,1.2,0.4402874,0
2020-05-05-170115,170115,0,0,0,35,1.0,0.2197987,1
2020-05-06-170115,170115,1,0,0,36,1.2,0.44409505,2
2020-05-07-170115,170115,0,0,0,36,1.8,0.43870768,3
2020-05-08-170115,170115,0,0,1,36,1.8,0.45926636,4
2020-05-09-170115,170115,0,0,0,36,0.4,0.075252414,5
2020-05-10-170115,170115,0,1,0,36,0.4,0.10810404,6
2020-05-11-170115,170115,0,0,1,36,1.4,0.5463636,0
2020-05-12-170115,170115,0,0,0,36,1.4,0.35590762,1
2020-05-13-170115,170115,0,0,2,36,0.8,0.19378921,2
2020-05-14-170115,170115,0,0,0,36,0.8,0.24759807,3
2020-05-15-170115,170115,0,0,0,36,1.0,0.18606801,4
2020-05-16-170115,170115,0,0,0,36,0.4,0.09030419,5
2020-05-17-170115,170115,0,0,0,36,0.0,0.018513586,6
2020-05-18-170115,170115,1,0,0,37,2.2,0.7611032,0
2020-05-19-170115,170115,0,0,1,37,0.8,0.1847597,1
2020-05-20-170115,170115,0,0,1,37,0.4,0.1294621,2
2020-05-21-170115,170115,0,0,0,37,0.8,0.19749187,3
2020-05-22-170115,170115,1,0,1,38,0.8,0.24954362,4
2020-05-23-170115,170115,0,0,0,38,0.4,0.10915983,5
2020-05-24-170115,170115,0,0,0,38,0.2,0.041977283,6
2020-05-25-170115,170115,1,0,0,39,1.6,0.3201225,0
2020-05-26-170115,170115,0,0,0,39,1.4,0.47428197,1
2020-05-27-170115,170115,2,0,0,41,1.6,0.55683774,2
2020-05-28-170115,170115,0,3,0,41,1.8,0.3911019,3
2020-05-29-170115,170115,0,0,1,41,0.4,0.13214585,4
2020-05-30-170115,170115,0,0,0,41,0.0,0.0030627307,5
2020-05-31-170115,170115,0,0,0,41,0.0,0.0032208923,6
2020-06-01-170115,170115,0,0,0,41,0.2,0.024499023,0
2020-06-02-170115,170115,1,0,0,42,1.4,0.5824903,1
2020-06-03-170115,170115,1,0,0,43,0.6,0.19844657,2
2020-06-04-170115,170115,0,0,1,43,0.6,0.1930011,3
2020-06-05-170115,170115,1,0,1,44,1.0,0.20248549,4
2020-06-06-170115,170115,0,2,0,44,0.2,0.05450809,5
2020-06-07-170115,170115,0,0,0,44,0.0,0.00077253033,6
2020-06-08-170115,170115,0,0,1,44,0.8,0.1342322,0
2020-06-09-170115,170115,0,0,1,44,0.4,0.13827631,1
2020-06-10-170115,170115,0,0,0,44,1.0,0.24890244,2
2020-06-11-170115,170115,0,0,0,44,0.6,0.1369021,3
2020-06-12-170115,170115,1,0,0,45,0.2,0.23688789,4
2020-06-13-170115,170115,0,0,0,45,0.2,0.058427982,5
2020-06-14-170115,170115,0,0,0,45,0.0,0.0087299,6
2020-06-15-170115,170115,0,0,0,45,0.4,0.15488683,0
2020-06-16-170115,170115,0,0,0,45,0.8,0.1832726,1
2020-06-17-170115,170115,0,0,0,45,0.2,0.072177246,2
2020-06-18-170115,170115,1,1,0,46,0.6,0.19167477,3
2020-06-19-170115,170115,1,0,0,47,1.8,0.33161727,4
2020-06-20-170115,170115,0,0,0,47,0.2,0.06330417,5
2020-06-21-170115,170115,0,0,1,47,0.4,0.10619902,6
2020-06-22-170115,170115,1,0,0,48,0.0,0.17047426,0
2020-06-23-170115,170115,1,0,0,49,0.6,0.42645738,1
2020-06-24-170115,170115,0,0,0,49,0.8,0.34690613,2
2020-06-25-170115,170115,0,0,0,49,0.4,0.056102145,3
2020-06-26-170115,170115,0,0,0,49,0.6,0.16723867,4
2020-06-27-170115,170115,0,0,2,49,0.4,0.19250819,5
2020-06-28-170115,170115,0,0,0,49,0.6,0.294954,6
2020-06-29-170115,170115,0,0,1,49,0.0,0.007385339,0
2020-06-30-170115,170115,0,0,0,49,0.2,0.075070195,1
2020-07-01-170115,170115,0,0,1,49,0.4,0.14960794,2
2020-07-02-170115,170115,0,0,0,49,0.2,0.087333806,3
2020-07-03-170115,170115,0,0,0,49,0.0,0.009327965,4
2020-07-04-170115,170115,0,0,0,49,0.2,0.06810506,5
2020-07-05-170115,170115,1,0,3,50,0.0,0.101191685,6
2020-07-06-170115,170115,0,0,1,50,0.2,0.07404445,0
2020-07-07-170115,170115,0,0,1,50,0.2,0.062276598,1
2020-07-08-170115,170115,0,0,0,50,0.4,0.11878878,2
2020-07-09-170115,170115,0,0,1,50,0.6,0.16223302,3
2020-07-10-170115,170115,0,0,0,50,0.0,0.13276869,4
2020-07-11-170115,170115,2,0,0,52,0.0,0.20266305,5
2020-07-12-170115,170115,0,0,1,52,0.0,0.0032385057,6
2020-07-13-170115,170115,1,0,0,53,0.0,0.17467871,0
2020-07-14-170115,170115,0,0,0,53,0.2,0.039003965,1
2020-07-15-170115,170115,1,0,0,54,0.2,0.100805655,2
2020-07-16-170115,170115,0,0,0,54,0.8,0.0755276,3
2020-07-17-170115,170115,0,0,0,54,0.2,0.12020712,4
2020-07-18-170115,170115,0,0,0,54,0.0,0.012479311,5
2020-07-19-170115,170115,3,0,0,57,0.0,0.2523302,6
2020-07-20-170115,170115,1,0,0,58,0.2,0.12092388,0
2020-07-21-170115,170115,1,0,1,59,0.0,0.10701315,1
2020-07-22-170115,170115,0,0,0,59,0.0,0.009768812,2
2020-07-23-170115,170115,1,0,0,60,0.2,0.17666386,3
2020-07-24-170115,170115,0,0,0,60,0.4,0.056946073,4
2020-07-25-170115,170115,0,0,0,60,0.0,0.00113997,5
2020-07-26-170115,170115,1,0,0,61,0.0,0.09286047,6
2020-07-27-170115,170115,0,0,0,61,0.2,0.038733236,0
2020-07-28-170115,170115,0,0,1,61,0.0,0.010695642,1
2020-07-29-170115,170115,0,0,0,61,0.4,0.1312033,2
2020-07-30-170115,170115,0,0,0,61,0.8,0.10934237,3
2020-07-31-170115,170115,0,0,0,61,0.6,0.21206534,4
2020-08-01-170115,170115,0,1,0,61,0.2,0.06058914,5
2020-08-02-170115,170115,0,0,0,61,0.2,0.063957036,6
2020-08-03-170115,170115,0,0,0,61,0.6,0.2889914,0
2020-08-04-170115,170115,1,0,0,62,0.4,0.1394985,1
2020-08-05-170115,170115,0,0,0,62,0.4,0.16497329,2
2020-08-06-170115,170115,0,0,0,62,0.2,0.10864663,3
2020-08-07-170115,170115,0,0,0,62,0.8,0.13940223,4
2020-08-08-170115,170115,0,0,0,62,0.0,0.024724763,5
2020-08-09-170115,170115,0,0,0,62,0.0,0.04278941,6
2020-08-10-170115,170115,0,0,8,62,0.4,0.24822117,0
2020-08-11-170115,170115,1,0,7,63,0.8,0.38353226,1
2020-08-12-170115,170115,0,0,0,63,1.0,0.3480105,2
2020-08-13-170115,170115,0,0,0,63,1.4,0.20631342,3
2020-08-14-170115,170115,0,0,0,63,2.4,0.40137812,4
2020-08-15-170115,170115,0,0,0,63,1.8,0.4978879,5
2020-08-16-170115,170115,0,0,0,63,0.8,0.06878809,6
2020-08-17-170115,170115,0,0,0,63,1.2,0.2472193,0
2020-08-18-170115,170115,0,0,1,63,2.6,0.5680185,1
2020-08-19-170115,170115,0,0,4,63,4.0,0.95864075,2
2020-08-20-170115,170115,0,0,0,63,2.2,0.28697515,3
2020-08-21-170115,170115,0,0,1,63,5.0,1.2192587,4
2020-08-22-170115,170115,0,0,1,63,0.8,0.30267277,5
2020-08-23-170115,170115,0,0,0,63,1.6,0.41485772,6
2020-08-24-170115,170115,8,0,0,71,3.2,1.1926632,0
2020-08-25-170115,170115,7,0,1,78,4.0,1.4593247,1
2020-08-26-170115,170115,0,0,0,78,4.8,0.65930223,2
2020-08-27-170115,170115,0,0,0,78,3.6,0.69357926,3
2020-08-28-170115,170115,0,0,1,78,4.4,0.9035492,4
2020-08-29-170115,170115,0,0,0,78,2.6,0.74682504,5
2020-08-30-170115,170115,0,0,0,78,1.8,0.1458546,6
2020-08-31-170115,170115,0,0,1,78,3.4,0.5603777,0
2020-09-01-170115,170115,1,0,0,79,3.6,0.52185845,1
2020-09-02-170115,170115,4,0,0,83,2.2,0.616298,2
2020-09-03-170115,170115,0,0,0,83,2.4,0.43897563,3
2020-09-04-170115,170115,1,0,2,84,3.0,0.5977931,4
2020-09-05-170115,170115,1,0,0,85,3.6,0.5595277,5
2020-09-06-170115,170115,0,0,0,85,2.4,0.3126423,6
2020-09-07-170115,170115,0,0,0,85,5.8,0.49375337,0
2020-09-08-170115,170115,1,0,0,86,1.6,0.3533422,1
2020-09-09-170115,170115,0,0,0,86,1.6,0.25515103,2
2020-09-10-170115,170115,0,0,0,86,2.8,0.4596748,3
2020-09-11-170115,170115,1,0,1,87,6.8,0.9795636,4
2020-09-12-170115,170115,0,0,0,87,3.0,0.35009557,5
2020-09-13-170115,170115,0,0,0,87,3.6,0.3280048,6
2020-09-14-170115,170115,1,0,0,88,5.0,0.73623586,0
2020-09-15-170115,170115,0,0,1,88,3.8,0.5743016,1
2020-09-16-170115,170115,0,0,0,88,4.0,0.8719747,2
2020-09-17-170115,170115,0,0,0,88,4.4,0.6774267,3
2020-09-18-170115,170115,2,0,0,90,16.2,0.7675295,4
2020-09-19-170115,170115,0,0,0,90,8.0,0.90871346,5
2020-09-20-170115,170115,0,0,0,90,5.6,0.38523114,6
2020-09-21-170115,170115,0,0,0,90,2.8,0.3640306,0
2020-09-22-170115,170115,0,0,0,90,3.0,0.5917955,1
2020-09-23-170115,170115,0,0,0,90,7.4,1.0750802,2
2020-09-24-170115,170115,0,0,2,90,7.2,1.4039938,3
2020-09-25-170115,170115,1,0,0,91,5.8,0.7389919,4
2020-09-26-170115,170115,0,0,0,91,3.8,0.5964687,5
2020-09-27-170115,170115,0,0,0,91,1.4,0.07689944,6
2020-09-28-170115,170115,0,0,0,91,2.2,0.4166479,0
2020-09-29-170115,170115,1,0,1,92,1.6,0.31257808,1
2020-09-30-170115,170115,0,0,0,92,4.8,0.5604097,2
2020-10-01-170115,170115,0,0,1,92,5.0,0.86003953,3
2020-10-02-170115,170115,0,0,0,92,4.4,1.0360947,4
2020-10-03-170115,170115,0,0,0,92,2.2,0.49198607,5
2020-10-04-170115,170115,0,0,0,92,2.8,0.40804526,6
2020-10-05-170115,170115,0,0,0,92,3.4,0.684168,0
2020-10-06-170115,170115,0,0,0,92,5.0,0.94483614,1
2020-10-07-170115,170115,0,0,1,92,4.8,0.6284181,2
2020-10-08-170115,170115,2,0,2,94,2.2,0.4856049,3
2020-10-09-170115,170115,0,0,0,94,4.2,1.1680202,4
2020-10-10-170115,170115,0,0,1,94,1.4,0.31696284,5
2020-10-11-170115,170115,0,0,1,94,0.6,0.10165555,6
2020-10-12-170115,170115,0,0,0,94,1.2,0.3290181,0
2020-10-13-170115,170115,1,0,3,95,3.0,0.5957739,1
2020-10-14-170115,170115,0,0,0,95,2.8,0.43709353,2
2020-10-15-170115,170115,1,0,0,96,4.8,0.5956704,3
2020-10-16-170115,170115,0,0,2,96,6.0,0.45944884,4
2020-10-17-170115,170115,0,0,0,96,5.0,1.1138946,5
2020-10-18-170115,170115,0,0,0,96,2.6,0.24062341,6
2020-10-19-170115,170115,0,0,0,96,5.6,0.70381576,0
2020-10-20-170115,170115,0,0,1,96,5.4,0.96906483,1
2020-10-21-170115,170115,1,0,0,97,4.0,0.65643024,2
2020-10-22-170115,170115,2,0,1,99,6.6,0.9069346,3
2020-10-23-170115,170115,0,1,0,99,6.2,1.0870485,4
2020-10-24-170115,170115,1,0,0,100,5.8,1.0677584,5
2020-10-25-170115,170115,1,0,1,101,3.0,0.6772895,6
2020-10-26-170115,170115,0,0,0,101,10.8,1.1913157,0
2020-10-27-170115,170115,3,0,2,104,7.2,1.6541774,1
2020-10-28-170115,170115,0,0,0,104,8.2,1.6707228,2
2020-10-29-170115,170115,0,0,5,104,8.8,2.3280632,3
2020-10-30-170115,170115,2,0,0,106,10.4,2.2914948,4
2020-10-31-170115,170115,0,0,0,106,6.8,1.1004431,5
2020-11-01-170115,170115,0,0,0,106,5.2,0.84450334,6
2020-11-02-170115,170115,0,0,0,106,5.8,0.4555857,0
2020-11-03-170115,170115,1,0,0,107,5.8,1.0358961,1
2020-11-04-170115,170115,0,0,0,107,8.2,1.1135154,2
2020-11-05-170115,170115,1,0,0,108,6.8,1.340277,3
2020-11-06-170115,170115,0,0,0,108,9.4,1.443656,4
2020-11-07-170115,170115,0,0,0,108,3.8,0.60463965,5
2020-11-08-170115,170115,1,0,0,109,1.4,0.24417706,6
2020-11-09-170115,170115,0,0,0,109,6.2,0.55976546,0
2020-11-10-170115,170115,2,0,0,111,6.4,0.8214869,1
2020-11-11-170115,170115,0,0,0,111,4.4,0.8418686,2
2020-11-12-170115,170115,5,0,0,116,6.0,1.297059,3
2020-11-13-170115,170115,0,1,0,116,6.6,1.1531032,4
2020-03-01-170116,170116,0,0,1,0,0.0,2.8964201e-05,6
2020-03-02-170116,170116,0,0,2,0,0.0,1.658019e-07,0
2020-03-03-170116,170116,0,0,0,0,0.0,0.002490857,1
2020-03-04-170116,170116,0,0,1,0,0.0,2.4587032e-06,2
2020-03-05-170116,170116,0,7,2,0,0.0,0.004268571,3
2020-03-06-170116,170116,0,0,0,0,0.0,3.2621945e-05,4
2020-03-07-170116,170116,0,0,0,0,0.0,0.00034028586,5
2020-03-08-170116,170116,0,0,0,0,0.0,1.2806586e-08,6
2020-03-09-170116,170116,0,0,0,0,0.0,0.000100713354,0
2020-03-10-170116,170116,0,0,0,0,0.0,8.039961e-05,1
2020-03-11-170116,170116,0,0,0,0,0.0,0.006203281,2
2020-03-12-170116,170116,0,0,2,0,0.75,0.03626325,3
2020-03-13-170116,170116,0,0,1,0,1.0,0.06077428,4
2020-03-14-170116,170116,0,0,0,0,0.25,3.239484e-05,5
2020-03-15-170116,170116,1,0,1,1,0.0,0.010591043,6
2020-03-16-170116,170116,2,0,0,3,0.75,0.04771286,0
2020-03-17-170116,170116,0,0,1,3,0.5,0.025381083,1
2020-03-18-170116,170116,1,1,2,4,1.75,0.1112745,2
2020-03-19-170116,170116,2,0,2,6,3.75,0.1654321,3
2020-03-20-170116,170116,0,0,2,6,3.75,0.0623263,4
2020-03-21-170116,170116,0,0,1,6,1.0,0.02489534,5
2020-03-22-170116,170116,0,0,1,6,1.5,0.026278276,6
2020-03-23-170116,170116,0,0,6,6,5.75,0.12382406,0
2020-03-24-170116,170116,0,0,4,6,2.0,0.054880276,1
2020-03-25-170116,170116,0,0,3,6,4.25,0.10125589,2
2020-03-26-170116,170116,2,0,0,8,2.0,0.09204156,3
2020-03-27-170116,170116,1,0,0,9,1.25,0.057458658,4
2020-03-28-170116,170116,0,0,1,9,0.5,0.014908291,5
2020-03-29-170116,170116,1,0,0,10,2.0,0.04479603,6
2020-03-30-170116,170116,0,0,0,10,4.5,0.11592398,0
2020-03-31-170116,170116,1,0,0,11,3.75,0.09177944,1
2020-04-01-170116,170116,2,0,2,13,4.75,0.1265357,2
2020-04-02-170116,170116,2,0,0,15,6.0,0.16302915,3
2020-04-03-170116,170116,2,0,0,17,2.75,0.096594624,4
2020-04-04-170116,170116,1,0,0,18,0.5,0.020322157,5
2020-04-05-170116,170116,1,0,0,19,1.0,0.023750747,6
2020-04-06-170116,170116,6,0,0,25,2.0,0.13811879,0
2020-04-07-170116,170116,4,0,0,29,1.5,0.12475811,1
2020-04-08-170116,170116,3,0,0,32,1.0,0.088956594,2
2020-04-09-170116,170116,0,1,0,32,3.0,0.06513028,3
2020-04-10-170116,170116,0,0,0,32,14.75,0.24964234,4
2020-04-11-170116,170116,1,0,0,33,1.75,0.033006884,5
2020-04-12-170116,170116,0,0,0,33,0.5,0.029722303,6
2020-04-13-170116,170116,0,0,0,33,2.25,0.055999976,0
2020-04-14-170116,170116,0,0,0,33,2.25,0.10004492,1
2020-04-15-170116,170116,2,0,0,35,2.0,0.061904863,2
2020-04-16-170116,170116,0,0,0,35,2.25,0.06960514,3
2020-04-17-170116,170116,0,0,0,35,1.0,0.06307291,4
2020-04-18-170116,170116,0,0,0,35,0.75,0.015021651,5
2020-04-19-170116,170116,0,0,0,35,0.5,0.024379168,6
2020-04-20-170116,170116,0,0,0,35,1.75,0.07698381,0
2020-04-21-170116,170116,0,0,0,35,0.75,0.053148597,1
2020-04-22-170116,170116,0,0,0,35,1.75,0.05308598,2
2020-04-23-170116,170116,0,0,0,35,0.0,0.004539783,3
2020-04-24-170116,170116,0,0,1,35,2.0,0.055838242,4
2020-04-25-170116,170116,0,0,0,35,1.0,0.030119456,5
2020-04-26-170116,170116,0,0,0,35,0.25,0.0050035906,6
2020-04-27-170116,170116,0,0,0,35,0.75,0.04321451,0
2020-04-28-170116,170116,0,0,0,35,1.5,0.04049242,1
2020-04-29-170116,170116,0,0,0,35,1.25,0.07447045,2
2020-04-30-170116,170116,0,0,2,35,0.25,0.01618174,3
2020-05-01-170116,170116,0,0,0,35,0.5,0.008251396,4
2020-05-02-170116,170116,0,0,0,35,0.5,0.03406204,5
2020-05-03-170116,170116,0,0,0,35,0.5,0.017597964,6
2020-05-04-170116,170116,0,0,0,35,0.25,0.025902305,0
2020-05-05-170116,170116,0,0,0,35,0.75,0.019340174,1
2020-05-06-170116,170116,0,0,0,35,1.75,0.050457455,2
2020-05-07-170116,170116,0,0,0,35,1.25,0.079160355,3
2020-05-08-170116,170116,1,0,0,36,1.75,0.11382202,4
2020-05-09-170116,170116,0,0,0,36,1.5,0.042939875,5
2020-05-10-170116,170116,0,0,0,36,0.5,0.02427456,6
2020-05-11-170116,170116,0,1,1,36,1.5,0.0734677,0
2020-05-12-170116,170116,0,0,0,36,0.75,0.0650802,1
2020-05-13-170116,170116,0,0,0,36,0.25,0.024025157,2
2020-05-14-170116,170116,2,0,0,38,0.75,0.045495555,3
2020-05-15-170116,170116,0,0,0,38,0.75,0.028011627,4
2020-05-16-170116,170116,0,0,0,38,0.0,0.001299013,5
2020-05-17-170116,170116,0,0,0,38,0.0,0.006406546,6
2020-05-18-170116,170116,0,0,0,38,0.5,0.04717653,0
2020-05-19-170116,170116,0,0,0,38,0.75,0.029835073,1
2020-05-20-170116,170116,0,0,0,38,1.0,0.0367505,2
2020-05-21-170116,170116,0,0,0,38,0.25,0.024352204,3
2020-05-22-170116,170116,0,0,0,38,0.5,0.038458467,4
2020-05-23-170116,170116,0,0,0,38,0.0,0.004413019,5
2020-05-24-170116,170116,0,0,0,38,0.25,0.011581843,6
2020-05-25-170116,170116,1,0,1,39,1.25,0.050945334,0
2020-05-26-170116,170116,0,0,0,39,0.5,0.040794123,1
2020-05-27-170116,170116,0,0,0,39,0.25,0.010546248,2
2020-05-28-170116,170116,0,2,0,39,0.25,0.08577759,3
2020-05-29-170116,170116,0,0,0,39,0.25,0.012854872,4
2020-05-30-170116,170116,0,0,0,39,0.0,0.0033277068,5
2020-05-31-170116,170116,0,0,1,39,0.75,0.026966821,6
2020-06-01-170116,170116,0,0,0,39,0.25,0.020847896,0
2020-06-02-170116,170116,0,0,1,39,0.25,0.06730672,1
2020-06-03-170116,170116,0,0,0,39,0.75,0.03814253,2
2020-06-04-170116,170116,0,0,0,39,0.25,0.007886678,3
2020-06-05-170116,170116,0,0,0,39,0.25,0.011661054,4
2020-06-06-170116,170116,0,0,0,39,0.0,0.009396184,5
2020-06-07-170116,170116,0,0,0,39,0.25,0.0025766625,6
2020-06-08-170116,170116,1,0,0,40,0.25,0.038967174,0
2020-06-09-170116,170116,0,0,0,40,0.5,0.018382838,1
2020-06-10-170116,170116,0,0,0,40,0.0,0.004312498,2
2020-06-11-170116,170116,0,0,0,40,0.5,0.008354204,3
2020-06-12-170116,170116,0,0,0,40,0.25,0.015933923,4
2020-06-13-170116,170116,0,0,0,40,0.0,7.633666e-05,5
2020-06-14-170116,170116,1,0,0,41,0.0,0.014627572,6
2020-06-15-170116,170116,0,0,0,41,0.5,0.019496856,0
2020-06-16-170116,170116,1,0,0,42,0.0,0.025655393,1
2020-06-17-170116,170116,0,0,0,42,0.75,0.05188102,2
2020-06-18-170116,170116,0,0,0,42,0.75,0.04829016,3
2020-06-19-170116,170116,0,0,0,42,0.0,0.0046024835,4
2020-06-20-170116,170116,0,0,0,42,0.75,0.037324008,5
2020-06-21-170116,170116,0,0,0,42,0.0,0.017300496,6
2020-06-22-170116,170116,0,0,0,42,0.5,0.017021634,0
2020-06-23-170116,170116,0,0,0,42,0.25,0.017818166,1
2020-06-24-170116,170116,0,0,0,42,0.25,0.01936943,2
2020-06-25-170116,170116,0,0,0,42,0.5,0.013258448,3
2020-06-26-170116,170116,0,0,0,42,0.5,0.036686018,4
2020-06-27-170116,170116,0,0,0,42,0.0,0.0058596777,5
2020-06-28-170116,170116,0,0,0,42,0.0,0.009681364,6
2020-06-29-170116,170116,0,0,0,42,0.25,0.018276688,0
2020-06-30-170116,170116,0,0,0,42,0.25,0.013394602,1
2020-07-01-170116,170116,0,0,0,42,0.75,0.026511071,2
2020-07-02-170116,170116,0,0,0,42,0.25,0.030549001,3
2020-07-03-170116,170116,0,0,0,42,0.25,0.012655221,4
2020-07-04-170116,170116,0,0,0,42,0.0,0.0032028754,5
2020-07-05-170116,170116,0,0,0,42,0.0,0.00023440368,6
2020-07-06-170116,170116,0,0,0,42,0.25,0.019273542,0
2020-07-07-170116,170116,0,0,0,42,0.5,0.019050406,1
2020-07-08-170116,170116,0,0,0,42,0.0,0.0035542378,2
2020-07-09-170116,170116,0,0,0,42,0.25,0.008387413,3
2020-07-10-170116,170116,0,0,0,42,0.5,0.054485045,4
2020-07-11-170116,170116,0,0,0,42,0.75,0.053308308,5
2020-07-12-170116,170116,0,0,0,42,0.0,0.0078035994,6
2020-07-13-170116,170116,0,0,0,42,0.5,0.028221665,0
2020-07-14-170116,170116,0,0,0,42,0.75,0.032539815,1
2020-07-15-170116,170116,0,0,0,42,0.75,0.016610816,2
2020-07-16-170116,170116,0,0,0,42,0.25,0.021127794,3
2020-07-17-170116,170116,0,0,0,42,0.75,0.06303877,4
2020-07-18-170116,170116,0,0,0,42,0.5,0.04645506,5
2020-07-19-170116,170116,0,0,0,42,0.0,1.876825e-05,6
2020-07-20-170116,170116,0,0,0,42,0.75,0.035676274,0
2020-07-21-170116,170116,0,0,0,42,0.25,0.013604634,1
2020-07-22-170116,170116,0,0,0,42,0.25,0.023219807,2
2020-07-23-170116,170116,0,0,0,42,0.75,0.043290295,3
2020-07-24-170116,170116,0,0,0,42,0.0,0.001373363,4
2020-07-25-170116,170116,0,0,0,42,0.0,0.0001229515,5
2020-07-26-170116,170116,0,0,0,42,0.0,0.0056827753,6
2020-07-27-170116,170116,0,0,0,42,0.75,0.02835227,0
2020-07-28-170116,170116,0,0,0,42,0.0,0.017336061,1
2020-07-29-170116,170116,0,0,1,42,0.0,0.0098929545,2
2020-07-30-170116,170116,0,0,0,42,0.25,0.018282877,3
2020-07-31-170116,170116,0,0,0,42,0.25,0.049401116,4
2020-08-01-170116,170116,0,0,2,42,0.0,0.0011448199,5
2020-08-02-170116,170116,0,0,0,42,0.0,0.004078864,6
2020-08-03-170116,170116,0,0,0,42,0.5,0.035524353,0
2020-08-04-170116,170116,0,0,0,42,0.75,0.06522084,1
2020-08-05-170116,170116,0,1,0,42,1.5,0.115558,2
2020-08-06-170116,170116,0,0,0,42,1.25,0.17463662,3
2020-08-07-170116,170116,0,0,1,42,2.0,0.15091282,4
2020-08-08-170116,170116,0,0,0,42,2.75,0.22273552,5
2020-08-09-170116,170116,0,0,0,42,0.0,0.020163195,6
2020-08-10-170116,170116,0,0,0,42,1.0,0.11456663,0
2020-08-11-170116,170116,0,0,0,42,2.75,0.16250837,1
2020-08-12-170116,170116,1,0,0,43,2.25,0.28168026,2
2020-08-13-170116,170116,0,0,1,43,1.25,0.24172218,3
2020-08-14-170116,170116,0,0,0,43,4.75,0.3119365,4
2020-08-15-170116,170116,2,0,1,45,0.5,0.11790198,5
2020-08-16-170116,170116,0,0,0,45,0.5,0.038367186,6
2020-08-17-170116,170116,0,0,2,45,2.25,0.16336265,0
2020-08-18-170116,170116,0,0,1,45,1.0,0.07533844,1
2020-08-19-170116,170116,0,0,0,45,1.0,0.17031707,2
2020-08-20-170116,170116,0,0,4,45,1.5,0.17941107,3
2020-08-21-170116,170116,1,0,2,46,2.5,0.21980423,4
2020-08-22-170116,170116,0,0,1,46,0.5,0.075477175,5
2020-08-23-170116,170116,0,0,0,46,0.75,0.08159076,6
2020-08-24-170116,170116,0,0,0,46,1.0,0.07008717,0
2020-08-25-170116,170116,0,0,3,46,2.0,0.08678198,1
2020-08-26-170116,170116,0,0,0,46,2.5,0.11561236,2
2020-08-27-170116,170116,1,0,4,47,0.75,0.097594015,3
2020-08-28-170116,170116,0,0,3,47,0.25,0.06678032,4
2020-08-29-170116,170116,1,0,0,48,1.0,0.08756959,5
2020-08-30-170116,170116,0,0,2,48,1.5,0.06666233,6
2020-08-31-170116,170116,2,0,0,50,0.25,0.05781801,0
2020-09-01-170116,170116,1,0,2,51,0.5,0.061927464,1
2020-09-02-170116,170116,0,0,0,51,0.25,0.006506654,2
2020-09-03-170116,170116,4,0,0,55,3.75,0.20727451,3
2020-09-04-170116,170116,2,1,0,57,1.5,0.17395167,4
2020-09-05-170116,170116,1,0,2,58,0.0,0.07471232,5
2020-09-06-170116,170116,0,0,0,58,0.25,0.06580569,6
2020-09-07-170116,170116,0,0,1,58,2.0,0.082448244,0
2020-09-08-170116,170116,3,0,2,61,1.0,0.15236922,1
2020-09-09-170116,170116,0,0,0,61,3.25,0.15502004,2
2020-09-10-170116,170116,4,0,0,65,0.25,0.11153282,3
2020-09-11-170116,170116,3,0,1,68,2.0,0.13562356,4
2020-09-12-170116,170116,0,0,0,68,6.5,0.0936814,5
2020-09-13-170116,170116,2,0,0,70,0.25,0.062892154,6
2020-09-14-170116,170116,0,0,0,70,1.25,0.111805364,0
2020-09-15-170116,170116,2,0,2,72,2.5,0.10715613,1
2020-09-16-170116,170116,0,0,0,72,3.25,0.12581296,2
2020-09-17-170116,170116,0,0,0,72,1.0,0.096103214,3
2020-09-18-170116,170116,0,0,1,72,3.75,0.23851447,4
2020-09-19-170116,170116,2,0,0,74,0.25,0.03855542,5
2020-09-20-170116,170116,0,0,1,74,0.25,0.023876168,6
2020-09-21-170116,170116,1,1,0,75,0.5,0.07612443,0
2020-09-22-170116,170116,2,0,0,77,1.75,0.13101938,1
2020-09-23-170116,170116,0,0,2,77,2.75,0.1547545,2
2020-09-24-170116,170116,0,0,0,77,0.5,0.080887094,3
2020-09-25-170116,170116,1,1,0,78,2.25,0.1456869,4
2020-09-26-170116,170116,0,0,1,78,0.75,0.056153063,5
2020-09-27-170116,170116,0,0,0,78,0.0,0.004350803,6
2020-09-28-170116,170116,0,0,1,78,0.75,0.06586536,0
2020-09-29-170116,170116,2,0,0,80,0.75,0.08927051,1
2020-09-30-170116,170116,0,0,2,80,2.5,0.08120751,2
2020-10-01-170116,170116,0,0,1,80,1.5,0.09103528,3
2020-10-02-170116,170116,1,0,0,81,1.0,0.061148535,4
2020-10-03-170116,170116,0,0,0,81,1.0,0.052613262,5
2020-10-04-170116,170116,1,0,1,82,0.0,0.054710463,6
2020-10-05-170116,170116,0,0,0,82,1.5,0.1324424,0
2020-10-06-170116,170116,0,1,0,82,0.75,0.0647666,1
2020-10-07-170116,170116,2,0,0,84,2.0,0.14209569,2
2020-10-08-170116,170116,0,0,1,84,1.25,0.12096896,3
2020-10-09-170116,170116,0,0,1,84,1.5,0.16213304,4
2020-10-10-170116,170116,1,0,0,85,0.25,0.103417,5
2020-10-11-170116,170116,0,0,1,85,0.0,0.037373662,6
2020-10-12-170116,170116,1,0,0,86,0.75,0.08616454,0
2020-10-13-170116,170116,0,0,1,86,0.0,0.06628077,1
2020-10-14-170116,170116,2,0,0,88,1.5,0.15949382,2
2020-10-15-170116,170116,1,0,0,89,0.0,0.025647892,3
2020-10-16-170116,170116,0,0,6,89,0.0,0.04020952,4
2020-10-17-170116,170116,0,0,4,89,0.25,0.025328215,5
2020-10-18-170116,170116,1,0,3,90,1.25,0.072222106,6
2020-10-19-170116,170116,0,0,1,90,1.0,0.10385535,0
2020-10-20-170116,170116,0,0,2,90,0.25,0.04847814,1
2020-10-21-170116,170116,0,0,6,90,2.0,0.12723011,2
2020-10-22-170116,170116,1,0,5,91,1.0,0.11768136,3
2020-10-23-170116,170116,1,0,7,92,2.5,0.15618092,4
2020-10-24-170116,170116,0,0,4,92,0.0,0.043494508,5
2020-10-25-170116,170116,1,1,1,93,0.75,0.072085656,6
2020-10-26-170116,170116,0,0,2,93,3.0,0.17065223,0
2020-10-27-170116,170116,1,0,1,94,0.25,0.102716595,1
2020-10-28-170116,170116,0,1,3,94,1.5,0.19366278,2
2020-10-29-170116,170116,0,0,2,94,1.25,0.18807186,3
2020-10-30-170116,170116,6,0,9,100,2.25,0.2597677,4
2020-10-31-170116,170116,4,0,0,104,0.5,0.17755882,5
2020-11-01-170116,170116,3,0,0,107,2.25,0.2053372,6
2020-11-02-170116,170116,1,0,0,108,0.75,0.061918274,0
2020-11-03-170116,170116,2,0,0,110,1.0,0.13009384,1
2020-11-04-170116,170116,6,0,0,116,0.5,0.23488875,2
2020-11-05-170116,170116,5,0,0,121,1.75,0.23200712,3
2020-11-06-170116,170116,7,2,0,128,1.5,0.23078334,4
2020-11-07-170116,170116,4,0,0,132,0.25,0.10460852,5
2020-11-08-170116,170116,1,0,0,133,2.0,0.08912741,6
2020-11-09-170116,170116,2,1,0,135,1.25,0.08604226,0
2020-11-10-170116,170116,1,2,0,136,1.0,0.11558429,1
2020-11-11-170116,170116,3,2,0,139,3.5,0.22933099,2
2020-11-12-170116,170116,2,0,0,141,2.25,0.20366158,3
2020-11-13-170116,170116,9,0,0,150,2.25,0.17954998,4
2020-03-01-170117,170117,0,0,1,0,0.14285714285714285,0.00446438,6
2020-03-02-170117,170117,0,0,0,0,0.0,0.014849465,0
2020-03-03-170117,170117,1,0,0,1,0.0,0.15013535,1
2020-03-04-170117,170117,0,0,1,1,0.0,0.0008896385,2
2020-03-05-170117,170117,0,0,2,1,0.0,0.0013635978,3
2020-03-06-170117,170117,0,0,0,1,0.0,0.001039559,4
2020-03-07-170117,170117,0,0,0,1,0.0,0.00090453675,5
2020-03-08-170117,170117,0,0,4,1,0.0,0.00015051929,6
2020-03-09-170117,170117,0,0,4,1,0.0,0.0027181616,0
2020-03-10-170117,170117,0,0,0,1,0.0,0.003491162,1
2020-03-11-170117,170117,0,0,1,1,0.0,0.03276005,2
2020-03-12-170117,170117,0,0,1,1,0.2857142857142857,0.031508576,3
2020-03-13-170117,170117,0,0,1,1,0.2857142857142857,0.27692828,4
2020-03-14-170117,170117,0,0,0,1,0.5714285714285714,0.022330796,5
2020-03-15-170117,170117,1,0,1,2,0.5714285714285714,0.18171477,6
2020-03-16-170117,170117,0,0,1,2,2.0,0.23732656,0
2020-03-17-170117,170117,0,0,1,2,2.142857142857143,0.15545754,1
2020-03-18-170117,170117,1,0,0,3,2.571428571428572,0.57523847,2
2020-03-19-170117,170117,2,1,1,5,3.4285714285714284,0.92439926,3
2020-03-20-170117,170117,0,0,2,5,3.571428571428572,0.3206351,4
2020-03-21-170117,170117,0,2,0,5,2.4285714285714284,0.13014871,5
2020-03-22-170117,170117,4,0,0,9,2.571428571428572,0.74452335,6
2020-03-23-170117,170117,4,0,6,13,7.2857142857142865,1.8439248,0
2020-03-24-170117,170117,0,0,2,13,4.142857142857143,0.34944978,1
2020-03-25-170117,170117,1,0,2,14,7.7142857142857135,1.4947231,2
2020-03-26-170117,170117,1,0,0,15,5.285714285714286,0.7023473,3
2020-03-27-170117,170117,1,0,0,16,7.2857142857142865,0.8184239,4
2020-03-28-170117,170117,0,0,0,16,0.8571428571428571,0.09224795,5
2020-03-29-170117,170117,1,0,0,17,2.142857142857143,0.5414914,6
2020-03-30-170117,170117,1,0,2,18,7.857142857142858,1.0347949,0
2020-03-31-170117,170117,1,0,0,19,6.428571428571429,1.066933,1
2020-04-01-170117,170117,0,0,0,19,5.7142857142857135,0.54289424,2
2020-04-02-170117,170117,1,0,1,20,3.571428571428572,1.2012563,3
2020-04-03-170117,170117,2,0,0,22,3.2857142857142856,0.86047083,4
2020-04-04-170117,170117,0,0,1,22,0.7142857142857143,0.16091171,5
2020-04-05-170117,170117,0,0,1,22,1.2857142857142858,0.18960771,6
2020-04-06-170117,170117,6,0,1,28,3.7142857142857135,1.8713033,0
2020-04-07-170117,170117,2,0,2,30,1.8571428571428568,1.0048174,1
2020-04-08-170117,170117,2,3,1,32,2.571428571428572,0.85031873,2
2020-04-09-170117,170117,0,0,0,32,2.2857142857142856,1.2912946,3
2020-04-10-170117,170117,0,0,0,32,0.7142857142857143,0.4306462,4
2020-04-11-170117,170117,0,0,0,32,1.0,0.13733254,5
2020-04-12-170117,170117,0,0,0,32,0.14285714285714285,0.17746207,6
2020-04-13-170117,170117,2,0,1,34,2.571428571428572,1.258549,0
2020-04-14-170117,170117,0,0,0,34,2.4285714285714284,1.0706435,1
2020-04-15-170117,170117,0,0,1,34,5.428571428571429,2.5996401,2
2020-04-16-170117,170117,1,0,0,35,2.7142857142857144,0.82763046,3
2020-04-17-170117,170117,0,1,0,35,3.571428571428572,1.2408825,4
2020-04-18-170117,170117,1,0,0,36,1.2857142857142858,0.25909236,5
2020-04-19-170117,170117,1,0,0,37,1.1428571428571428,0.38166788,6
2020-04-20-170117,170117,1,0,0,38,1.7142857142857142,0.7893566,0
2020-04-21-170117,170117,2,0,0,40,2.4285714285714284,0.8821936,1
2020-04-22-170117,170117,1,1,1,41,2.0,0.37262136,2
2020-04-23-170117,170117,0,0,2,41,0.42857142857142855,0.047005124,3
2020-04-24-170117,170117,0,0,0,41,1.2857142857142858,0.10826815,4
2020-04-25-170117,170117,0,0,0,41,0.5714285714285714,0.03323348,5
2020-04-26-170117,170117,0,0,0,41,0.2857142857142857,0.0076792426,6
2020-04-27-170117,170117,1,0,0,42,1.7142857142857142,0.36372983,0
2020-04-28-170117,170117,0,0,1,42,2.0,0.3967782,1
2020-04-29-170117,170117,1,0,1,43,2.8571428571428568,0.89570045,2
2020-04-30-170117,170117,0,0,1,43,1.1428571428571428,0.10289996,3
2020-05-01-170117,170117,0,0,0,43,0.5714285714285714,0.095418185,4
2020-05-02-170117,170117,0,0,0,43,1.1428571428571428,0.19277693,5
2020-05-03-170117,170117,0,0,0,43,0.0,0.037222136,6
2020-05-04-170117,170117,0,0,3,43,4.714285714285714,0.50408494,0
2020-05-05-170117,170117,0,0,0,43,1.7142857142857142,0.47095114,1
2020-05-06-170117,170117,1,0,3,44,9.0,0.8567208,2
2020-05-07-170117,170117,2,0,3,46,2.4285714285714284,0.7608005,3
2020-05-08-170117,170117,0,0,2,46,2.571428571428572,0.60248893,4
2020-05-09-170117,170117,0,0,0,46,0.2857142857142857,0.039034672,5
2020-05-10-170117,170117,0,0,0,46,0.2857142857142857,0.19205491,6
2020-05-11-170117,170117,0,0,1,46,1.0,0.271368,0
2020-05-12-170117,170117,1,0,0,47,0.5714285714285714,0.57815987,1
2020-05-13-170117,170117,1,0,0,48,0.42857142857142855,0.36739177,2
2020-05-14-170117,170117,1,0,1,49,1.0,0.43574503,3
2020-05-15-170117,170117,0,0,0,49,0.5714285714285714,0.0609339,4
2020-05-16-170117,170117,0,0,0,49,0.14285714285714285,0.02348006,5
2020-05-17-170117,170117,0,0,0,49,0.14285714285714285,0.03191848,6
2020-05-18-170117,170117,3,0,0,52,0.8571428571428571,0.829777,0
2020-05-19-170117,170117,0,0,1,52,1.0,0.14675534,1
2020-05-20-170117,170117,3,0,0,55,0.8571428571428571,1.0488362,2
2020-05-21-170117,170117,3,0,0,58,1.0,1.1454815,3
2020-05-22-170117,170117,2,0,0,60,1.2857142857142858,0.7357955,4
2020-05-23-170117,170117,0,0,0,60,0.42857142857142855,0.29932562,5
2020-05-24-170117,170117,0,0,0,60,0.2857142857142857,0.031704254,6
2020-05-25-170117,170117,1,0,0,61,0.42857142857142855,0.32861966,0
2020-05-26-170117,170117,0,0,0,61,0.5714285714285714,0.5427326,1
2020-05-27-170117,170117,0,0,0,61,0.42857142857142855,0.21433273,2
2020-05-28-170117,170117,1,0,0,62,0.7142857142857143,0.50755364,3
2020-05-29-170117,170117,0,1,0,62,0.2857142857142857,0.0884713,4
2020-05-30-170117,170117,0,0,0,62,0.0,0.0010586305,5
2020-05-31-170117,170117,0,0,0,62,0.0,0.014272456,6
2020-06-01-170117,170117,0,0,0,62,1.0,0.07419462,0
2020-06-02-170117,170117,1,0,0,63,0.8571428571428571,0.43851078,1
2020-06-03-170117,170117,0,0,0,63,0.42857142857142855,0.21303749,2
2020-06-04-170117,170117,0,0,0,63,0.42857142857142855,0.20842169,3
2020-06-05-170117,170117,0,0,0,63,1.0,0.30377707,4
2020-06-06-170117,170117,0,3,0,63,0.42857142857142855,0.16949283,5
2020-06-07-170117,170117,0,0,0,63,0.0,0.00040812022,6
2020-06-08-170117,170117,0,0,0,63,0.42857142857142855,0.42536265,0
2020-06-09-170117,170117,0,0,0,63,0.42857142857142855,0.12375948,1
2020-06-10-170117,170117,0,0,0,63,0.2857142857142857,0.019058067,2
2020-06-11-170117,170117,0,0,0,63,0.0,0.005549938,3
2020-06-12-170117,170117,0,0,0,63,0.14285714285714285,0.08018358,4
2020-06-13-170117,170117,0,0,0,63,0.14285714285714285,0.013947502,5
2020-06-14-170117,170117,0,1,0,63,0.14285714285714285,0.011606115,6
2020-06-15-170117,170117,0,0,3,63,0.0,0.030814985,0
2020-06-16-170117,170117,0,0,0,63,0.5714285714285714,0.06347636,1
2020-06-17-170117,170117,0,0,0,63,0.42857142857142855,0.22301103,2
2020-06-18-170117,170117,0,0,0,63,0.5714285714285714,0.041777313,3
2020-06-19-170117,170117,0,0,0,63,0.8571428571428571,0.28355742,4
2020-06-20-170117,170117,0,0,0,63,0.0,0.016941441,5
2020-06-21-170117,170117,0,0,0,63,0.0,0.001815004,6
2020-06-22-170117,170117,0,0,1,63,0.0,0.044321653,0
2020-06-23-170117,170117,0,0,0,63,0.5714285714285714,0.106619485,1
2020-06-24-170117,170117,0,2,1,63,0.5714285714285714,0.45490637,2
2020-06-25-170117,170117,0,1,0,63,0.2857142857142857,0.11172022,3
2020-06-26-170117,170117,0,1,0,63,0.14285714285714285,0.23722519,4
2020-06-27-170117,170117,0,0,0,63,0.0,0.0045093712,5
2020-06-28-170117,170117,0,0,1,63,0.0,0.04099535,6
2020-06-29-170117,170117,3,0,0,66,0.2857142857142857,0.5875874,0
2020-06-30-170117,170117,0,0,1,66,0.0,0.014382966,1
2020-07-01-170117,170117,0,0,0,66,0.14285714285714285,0.012876562,2
2020-07-02-170117,170117,0,0,0,66,0.2857142857142857,0.2787926,3
2020-07-03-170117,170117,0,1,1,66,0.0,0.015840575,4
2020-07-04-170117,170117,0,0,0,66,0.0,0.0015504011,5
2020-07-05-170117,170117,0,0,0,66,0.0,0.00067375234,6
2020-07-06-170117,170117,1,0,0,67,0.14285714285714285,0.2531335,0
2020-07-07-170117,170117,0,0,0,67,0.2857142857142857,0.18740347,1
2020-07-08-170117,170117,1,0,1,68,0.14285714285714285,0.25425962,2
2020-07-09-170117,170117,0,0,2,68,0.14285714285714285,0.009442171,3
2020-07-10-170117,170117,0,0,0,68,0.0,0.12500924,4
2020-07-11-170117,170117,0,0,0,68,0.2857142857142857,0.10373171,5
2020-07-12-170117,170117,1,0,0,69,0.14285714285714285,0.25768295,6
2020-07-13-170117,170117,0,0,1,69,0.42857142857142855,0.14264132,0
2020-07-14-170117,170117,1,0,3,70,0.5714285714285714,0.40628472,1
2020-07-15-170117,170117,0,0,2,70,0.2857142857142857,0.2178835,2
2020-07-16-170117,170117,0,0,0,70,0.2857142857142857,0.036094222,3
2020-07-17-170117,170117,1,0,0,71,0.14285714285714285,0.3802099,4
2020-07-18-170117,170117,0,0,0,71,0.14285714285714285,0.048821077,5
2020-07-19-170117,170117,0,0,0,71,0.0,0.0011914597,6
2020-07-20-170117,170117,0,0,0,71,0.0,0.0287876,0
2020-07-21-170117,170117,0,0,1,71,0.14285714285714285,0.016020248,1
2020-07-22-170117,170117,1,0,1,72,0.2857142857142857,0.32805154,2
2020-07-23-170117,170117,2,0,2,74,0.2857142857142857,0.8250518,3
2020-07-24-170117,170117,0,1,3,74,0.0,0.004704984,4
2020-07-25-170117,170117,0,0,0,74,0.0,0.00058650825,5
2020-07-26-170117,170117,0,0,0,74,0.0,0.0022905483,6
2020-07-27-170117,170117,1,0,1,75,0.14285714285714285,0.40416098,0
2020-07-28-170117,170117,3,0,6,78,0.8571428571428571,1.9811364,1
2020-07-29-170117,170117,2,0,1,80,0.5714285714285714,0.71910167,2
2020-07-30-170117,170117,0,0,2,80,0.14285714285714285,0.027562736,3
2020-07-31-170117,170117,0,0,1,80,0.14285714285714285,0.13248548,4
2020-08-01-170117,170117,0,0,0,80,0.0,0.016826283,5
2020-08-02-170117,170117,0,0,0,80,0.5714285714285714,0.5263525,6
2020-08-03-170117,170117,0,0,0,80,0.0,0.03778289,0
2020-08-04-170117,170117,1,0,0,81,0.5714285714285714,0.37851822,1
2020-08-05-170117,170117,1,0,0,82,0.5714285714285714,0.6260895,2
2020-08-06-170117,170117,2,0,0,84,2.7142857142857144,3.8993165,3
2020-08-07-170117,170117,3,0,1,87,1.2857142857142858,1.780972,4
2020-08-08-170117,170117,0,0,0,87,0.7142857142857143,0.27355203,5
2020-08-09-170117,170117,0,0,1,87,0.5714285714285714,0.10485445,6
2020-08-10-170117,170117,1,0,1,88,1.0,1.3722532,0
2020-08-11-170117,170117,6,0,1,94,1.1428571428571428,2.8489923,1
2020-08-12-170117,170117,1,0,0,95,1.4285714285714286,1.7248813,2
2020-08-13-170117,170117,2,0,1,97,2.0,2.2200644,3
2020-08-14-170117,170117,1,0,0,98,2.7142857142857144,1.5490297,4
2020-08-15-170117,170117,0,0,0,98,1.1428571428571428,1.0889139,5
2020-08-16-170117,170117,0,0,1,98,0.8571428571428571,0.16597965,6
2020-08-17-170117,170117,0,0,2,98,1.7142857142857142,1.3283957,0
2020-08-18-170117,170117,0,0,1,98,1.0,0.4314745,1
2020-08-19-170117,170117,0,0,0,98,2.4285714285714284,1.5958506,2
2020-08-20-170117,170117,0,0,2,98,3.0,1.0871149,3
2020-08-21-170117,170117,1,0,2,99,3.2857142857142856,1.7346199,4
2020-08-22-170117,170117,0,0,0,99,0.5714285714285714,0.66116244,5
2020-08-23-170117,170117,1,0,0,100,0.5714285714285714,0.37894163,6
2020-08-24-170117,170117,1,0,0,101,2.4285714285714284,1.1580092,0
2020-08-25-170117,170117,1,0,1,102,4.0,1.405853,1
2020-08-26-170117,170117,0,0,3,102,3.4285714285714284,0.4510027,2
2020-08-27-170117,170117,1,1,0,103,3.7142857142857135,1.4377024,3
2020-08-28-170117,170117,0,0,1,103,3.0,1.1118784,4
2020-08-29-170117,170117,0,0,0,103,1.7142857142857142,0.5040224,5
2020-08-30-170117,170117,1,1,0,104,2.142857142857143,0.7996658,6
2020-08-31-170117,170117,2,0,0,106,2.8571428571428568,1.0274704,0
2020-09-01-170117,170117,1,0,2,107,2.571428571428572,0.6325819,1
2020-09-02-170117,170117,0,0,1,107,1.7142857142857142,0.31170544,2
2020-09-03-170117,170117,2,0,1,109,3.2857142857142856,1.2559787,3
2020-09-04-170117,170117,2,0,2,111,4.571428571428571,3.4913206,4
2020-09-05-170117,170117,0,0,0,111,2.0,0.48356527,5
2020-09-06-170117,170117,0,0,0,111,3.7142857142857135,0.8881316,6
2020-09-07-170117,170117,0,0,2,111,3.2857142857142856,0.42568338,0
2020-09-08-170117,170117,1,0,4,112,1.0,0.4478495,1
2020-09-09-170117,170117,3,0,2,115,1.7142857142857142,1.2405574,2
2020-09-10-170117,170117,0,0,4,115,3.0,0.3216963,3
2020-09-11-170117,170117,1,0,1,116,3.8571428571428568,0.772288,4
2020-09-12-170117,170117,0,0,0,116,2.571428571428572,0.26817507,5
2020-09-13-170117,170117,0,0,1,116,2.2857142857142856,0.2405137,6
2020-09-14-170117,170117,0,0,5,116,4.571428571428571,1.4012508,0
2020-09-15-170117,170117,2,0,1,118,2.142857142857143,0.6200716,1
2020-09-16-170117,170117,1,0,2,119,2.4285714285714284,0.7575203,2
2020-09-17-170117,170117,1,0,1,120,2.2857142857142856,0.56448543,3
2020-09-18-170117,170117,2,0,1,122,13.571428571428573,1.342581,4
2020-09-19-170117,170117,0,0,0,122,6.142857142857142,0.37072405,5
2020-09-20-170117,170117,0,0,0,122,3.8571428571428568,0.2123784,6
2020-09-21-170117,170117,2,0,3,124,3.4285714285714284,0.6065817,0
2020-09-22-170117,170117,4,0,0,128,4.285714285714286,1.3472415,1
2020-09-23-170117,170117,2,1,1,130,5.571428571428571,0.9171482,2
2020-09-24-170117,170117,4,0,4,134,6.142857142857142,1.3425303,3
2020-09-25-170117,170117,1,0,2,135,5.285714285714286,0.9341749,4
2020-09-26-170117,170117,0,0,4,135,2.142857142857143,0.35731518,5
2020-09-27-170117,170117,1,0,2,136,1.2857142857142858,0.21846381,6
2020-09-28-170117,170117,5,0,4,141,4.714285714285714,1.299566,0
2020-09-29-170117,170117,1,0,2,142,3.0,0.6405883,1
2020-09-30-170117,170117,2,0,0,144,5.571428571428571,0.8301971,2
2020-10-01-170117,170117,1,0,0,145,3.4285714285714284,0.6199382,3
2020-10-02-170117,170117,1,0,0,146,4.857142857142857,0.7089297,4
2020-10-03-170117,170117,0,0,0,146,0.8571428571428571,0.23280334,5
2020-10-04-170117,170117,0,0,1,146,3.4285714285714284,0.3186662,6
2020-10-05-170117,170117,3,0,3,149,4.857142857142857,1.5057926,0
2020-10-06-170117,170117,0,0,0,149,3.1428571428571432,0.402555,1
2020-10-07-170117,170117,1,0,1,150,2.571428571428572,0.86117375,2
2020-10-08-170117,170117,4,0,0,154,3.2857142857142856,2.0279143,3
2020-10-09-170117,170117,2,1,1,156,4.571428571428571,2.0683992,4
2020-10-10-170117,170117,4,0,0,160,3.1428571428571432,1.3284801,5
2020-10-11-170117,170117,2,0,0,162,3.1428571428571432,1.6574913,6
2020-10-12-170117,170117,4,0,0,166,1.7142857142857142,0.80915385,0
2020-10-13-170117,170117,2,0,7,168,4.285714285714286,2.1283395,1
2020-10-14-170117,170117,0,0,1,168,3.4285714285714284,0.6499906,2
2020-10-15-170117,170117,0,0,0,168,3.571428571428572,0.7101583,3
2020-10-16-170117,170117,0,0,2,168,7.2857142857142865,0.9034643,4
2020-10-17-170117,170117,0,0,0,168,1.7142857142857142,0.21214122,5
2020-10-18-170117,170117,1,0,0,169,2.2857142857142856,0.6506127,6
2020-10-19-170117,170117,3,0,0,172,5.857142857142858,0.99578726,0
2020-10-20-170117,170117,0,0,2,172,3.7142857142857135,0.42444226,1
2020-10-21-170117,170117,1,0,0,173,5.0,1.1947395,2
2020-10-22-170117,170117,0,0,0,173,7.0,1.1823982,3
2020-10-23-170117,170117,1,0,3,174,6.0,1.1086783,4
2020-10-24-170117,170117,0,0,0,174,2.571428571428572,0.49522176,5
2020-10-25-170117,170117,0,1,1,174,2.142857142857143,0.47520584,6
2020-10-26-170117,170117,0,2,0,174,4.571428571428571,0.5038053,0
2020-10-27-170117,170117,7,0,0,181,4.0,1.9497739,1
2020-10-28-170117,170117,1,3,0,182,5.142857142857143,0.9848346,2
2020-10-29-170117,170117,0,0,0,182,4.571428571428571,1.1512738,3
2020-10-30-170117,170117,2,0,1,184,4.857142857142857,1.729714,4
2020-10-31-170117,170117,0,0,0,184,2.0,0.35081026,5
2020-11-01-170117,170117,0,0,0,184,2.4285714285714284,0.6719324,6
2020-11-02-170117,170117,0,1,0,184,2.7142857142857144,0.21737997,0
2020-11-03-170117,170117,2,0,0,186,4.714285714285714,1.9716854,1
2020-11-04-170117,170117,0,1,0,186,6.428571428571429,0.60520303,2
2020-11-05-170117,170117,0,0,0,186,4.285714285714286,0.89131737,3
2020-11-06-170117,170117,3,0,0,189,6.7142857142857135,1.5628395,4
2020-11-07-170117,170117,0,1,0,189,2.0,0.43641087,5
2020-11-08-170117,170117,1,0,0,190,2.7142857142857144,0.5640401,6
2020-11-09-170117,170117,0,0,0,190,5.142857142857143,0.2532827,0
2020-11-10-170117,170117,0,0,0,190,4.0,0.30944398,1
2020-11-11-170117,170117,0,0,0,190,3.7142857142857135,0.70054626,2
2020-11-12-170117,170117,0,1,0,190,4.857142857142857,0.95428884,3
2020-11-13-170117,170117,1,0,0,191,4.428571428571429,0.7615089,4
2020-03-01-170118,170118,0,0,0,0,0.3333333333333333,0.02902258,6
2020-03-02-170118,170118,0,0,0,0,0.0,0.0023480684,0
2020-03-03-170118,170118,0,2,0,0,0.0,0.00024260537,1
2020-03-04-170118,170118,0,0,0,0,0.0,8.99663e-05,2
2020-03-05-170118,170118,0,2,1,0,0.16666666666666666,0.043105487,3
2020-03-06-170118,170118,0,0,0,0,0.0,0.00053685345,4
2020-03-07-170118,170118,0,1,2,0,0.0,0.00043242125,5
2020-03-08-170118,170118,0,0,0,0,0.0,1.1828744e-05,6
2020-03-09-170118,170118,0,0,0,0,0.0,0.0003979562,0
2020-03-10-170118,170118,0,0,0,0,0.16666666666666666,0.038590048,1
2020-03-11-170118,170118,0,0,2,0,0.16666666666666666,0.024273898,2
2020-03-12-170118,170118,0,0,0,0,0.5,0.009341099,3
2020-03-13-170118,170118,1,0,1,1,0.6666666666666666,0.13552152,4
2020-03-14-170118,170118,0,0,0,1,0.3333333333333333,0.008965566,5
2020-03-15-170118,170118,0,0,0,1,0.5,0.039195754,6
2020-03-16-170118,170118,0,0,0,1,3.5,0.21808602,0
2020-03-17-170118,170118,0,0,2,1,2.5,0.2305402,1
2020-03-18-170118,170118,0,0,0,1,7.166666666666668,0.3754901,2
2020-03-19-170118,170118,1,0,0,2,13.833333333333336,0.6380491,3
2020-03-20-170118,170118,0,1,0,2,8.5,0.26020247,4
2020-03-21-170118,170118,2,0,0,4,3.0,0.124199286,5
2020-03-22-170118,170118,0,3,0,4,5.0,0.27432722,6
2020-03-23-170118,170118,0,0,1,4,16.333333333333332,0.7710364,0
2020-03-24-170118,170118,0,0,1,4,12.666666666666664,0.4921546,1
2020-03-25-170118,170118,2,0,0,6,13.5,0.7174864,2
2020-03-26-170118,170118,0,0,1,6,10.333333333333334,0.7346727,3
2020-03-27-170118,170118,1,0,1,7,9.833333333333334,0.53359085,4
2020-03-28-170118,170118,0,1,0,7,6.0,0.44275463,5
2020-03-29-170118,170118,0,0,0,7,4.666666666666667,0.28586835,6
2020-03-30-170118,170118,0,0,2,7,11.166666666666664,0.5583914,0
2020-03-31-170118,170118,2,1,0,9,10.833333333333336,0.5105756,1
2020-04-01-170118,170118,0,0,0,9,5.5,0.30855054,2
2020-04-02-170118,170118,0,0,0,9,9.0,0.63160264,3
2020-04-03-170118,170118,0,0,0,9,6.666666666666668,0.21892145,4
2020-04-04-170118,170118,0,0,0,9,2.6666666666666665,0.174333,5
2020-04-05-170118,170118,0,0,0,9,2.0,0.06701555,6
2020-04-06-170118,170118,1,0,0,10,8.5,0.4926103,0
2020-04-07-170118,170118,1,3,0,11,5.333333333333333,0.26967365,1
2020-04-08-170118,170118,0,0,0,11,3.5,0.18888342,2
2020-04-09-170118,170118,1,0,0,12,4.5,0.23721924,3
2020-04-10-170118,170118,1,0,0,13,6.0,0.47032976,4
2020-04-11-170118,170118,0,0,0,13,2.333333333333333,0.13908398,5
2020-04-12-170118,170118,0,0,0,13,3.1666666666666665,0.20799291,6
2020-04-13-170118,170118,2,0,0,15,6.166666666666668,0.3278359,0
2020-04-14-170118,170118,0,0,2,15,8.333333333333334,0.71593374,1
2020-04-15-170118,170118,0,0,1,15,8.0,0.89489836,2
2020-04-16-170118,170118,0,0,0,15,4.666666666666667,0.71753204,3
2020-04-17-170118,170118,0,0,0,15,3.5,0.22197166,4
2020-04-18-170118,170118,0,0,0,15,1.6666666666666667,0.2005212,5
2020-04-19-170118,170118,0,0,0,15,1.6666666666666667,0.116753645,6
2020-04-20-170118,170118,0,1,0,15,9.666666666666666,0.48587927,0
2020-04-21-170118,170118,0,0,0,15,3.6666666666666665,0.23984197,1
2020-04-22-170118,170118,0,0,0,15,3.8333333333333335,0.516264,2
2020-04-23-170118,170118,0,0,0,15,0.8333333333333334,0.15206541,3
2020-04-24-170118,170118,0,0,0,15,2.5,0.18844782,4
2020-04-25-170118,170118,0,0,0,15,0.8333333333333334,0.06802258,5
2020-04-26-170118,170118,0,0,0,15,0.8333333333333334,0.044877168,6
2020-04-27-170118,170118,0,0,1,15,3.1666666666666665,0.22632727,0
2020-04-28-170118,170118,2,0,0,17,1.5,0.101415165,1
2020-04-29-170118,170118,1,0,0,18,3.0,0.3418457,2
2020-04-30-170118,170118,0,0,0,18,2.1666666666666665,0.29025584,3
2020-05-01-170118,170118,0,0,0,18,0.3333333333333333,0.028616088,4
2020-05-02-170118,170118,0,0,0,18,1.5,0.37082684,5
2020-05-03-170118,170118,0,0,0,18,0.3333333333333333,0.072583176,6
2020-05-04-170118,170118,0,0,1,18,3.5,0.5001234,0
2020-05-05-170118,170118,0,0,0,18,2.333333333333333,0.23898411,1
2020-05-06-170118,170118,0,0,0,18,3.1666666666666665,0.21867892,2
2020-05-07-170118,170118,0,0,0,18,2.1666666666666665,0.4541164,3
2020-05-08-170118,170118,0,0,0,18,2.833333333333333,0.34468365,4
2020-05-09-170118,170118,0,0,0,18,0.6666666666666666,0.051645678,5
2020-05-10-170118,170118,0,0,0,18,1.0,0.084331006,6
2020-05-11-170118,170118,1,0,0,19,3.8333333333333335,0.32666454,0
2020-05-12-170118,170118,0,0,0,19,2.6666666666666665,0.20534585,1
2020-05-13-170118,170118,0,0,1,19,1.0,0.10580239,2
2020-05-14-170118,170118,0,1,0,19,2.0,0.15012674,3
2020-05-15-170118,170118,0,0,0,19,2.0,0.079289526,4
2020-05-16-170118,170118,0,0,0,19,1.1666666666666667,0.053937383,5
2020-05-17-170118,170118,0,0,0,19,0.3333333333333333,0.022684257,6
2020-05-18-170118,170118,1,0,0,20,5.833333333333332,0.3923222,0
2020-05-19-170118,170118,0,0,0,20,0.8333333333333334,0.11566086,1
2020-05-20-170118,170118,0,0,0,20,1.1666666666666667,0.08719249,2
2020-05-21-170118,170118,0,0,0,20,1.6666666666666667,0.1448589,3
2020-05-22-170118,170118,0,0,0,20,1.0,0.24226114,4
2020-05-23-170118,170118,0,0,0,20,0.6666666666666666,0.09477967,5
2020-05-24-170118,170118,0,0,0,20,0.6666666666666666,0.030655535,6
2020-05-25-170118,170118,0,0,0,20,1.1666666666666667,0.079081975,0
2020-05-26-170118,170118,0,0,0,20,1.8333333333333333,0.16068652,1
2020-05-27-170118,170118,1,0,0,21,1.6666666666666667,0.2837308,2
2020-05-28-170118,170118,0,1,0,21,1.3333333333333333,0.19172108,3
2020-05-29-170118,170118,0,0,0,21,0.6666666666666666,0.13312112,4
2020-05-30-170118,170118,0,0,0,21,0.0,0.0040711607,5
2020-05-31-170118,170118,0,0,0,21,0.0,0.002210564,6
2020-06-01-170118,170118,0,0,0,21,0.16666666666666666,0.012029717,0
2020-06-02-170118,170118,0,0,0,21,2.6666666666666665,0.36674774,1
2020-06-03-170118,170118,0,0,0,21,0.5,0.09046191,2
2020-06-04-170118,170118,0,0,1,21,1.0,0.13407622,3
2020-06-05-170118,170118,0,0,1,21,1.0,0.15026464,4
2020-06-06-170118,170118,0,0,0,21,0.16666666666666666,0.034093887,5
2020-06-07-170118,170118,0,0,0,21,0.16666666666666666,0.0002529205,6
2020-06-08-170118,170118,0,0,0,21,1.0,0.07780528,0
2020-06-09-170118,170118,0,0,0,21,0.5,0.05809945,1
2020-06-10-170118,170118,0,0,0,21,1.1666666666666667,0.09413939,2
2020-06-11-170118,170118,0,0,0,21,0.3333333333333333,0.07803996,3
2020-06-12-170118,170118,0,0,0,21,0.6666666666666666,0.19688243,4
2020-06-13-170118,170118,0,0,0,21,0.16666666666666666,0.03156751,5
2020-06-14-170118,170118,0,0,0,21,0.0,0.0056259627,6
2020-06-15-170118,170118,0,0,0,21,0.6666666666666666,0.103245676,0
2020-06-16-170118,170118,0,0,0,21,1.3333333333333333,0.10692721,1
2020-06-17-170118,170118,0,0,0,21,0.8333333333333334,0.041157346,2
2020-06-18-170118,170118,1,0,0,22,0.6666666666666666,0.036340926,3
2020-06-19-170118,170118,1,0,0,23,1.6666666666666667,0.2633496,4
2020-06-20-170118,170118,0,0,0,23,0.3333333333333333,0.038822368,5
2020-06-21-170118,170118,0,0,0,23,0.3333333333333333,0.06290644,6
2020-06-22-170118,170118,0,0,0,23,0.6666666666666666,0.055102777,0
2020-06-23-170118,170118,0,0,0,23,1.0,0.10124458,1
2020-06-24-170118,170118,0,0,0,23,0.8333333333333334,0.14336658,2
2020-06-25-170118,170118,0,1,0,23,0.6666666666666666,0.016798986,3
2020-06-26-170118,170118,0,0,0,23,0.6666666666666666,0.11999305,4
2020-06-27-170118,170118,0,0,0,23,0.3333333333333333,0.06962038,5
2020-06-28-170118,170118,0,0,0,23,0.6666666666666666,0.12872483,6
2020-06-29-170118,170118,0,0,0,23,0.5,0.004081623,0
2020-06-30-170118,170118,0,0,0,23,0.5,0.04371762,1
2020-07-01-170118,170118,0,0,0,23,0.5,0.083629474,2
2020-07-02-170118,170118,0,0,0,23,0.16666666666666666,0.046793763,3
2020-07-03-170118,170118,0,0,0,23,0.16666666666666666,0.0144013,4
2020-07-04-170118,170118,0,0,0,23,0.3333333333333333,0.046657313,5
2020-07-05-170118,170118,0,0,0,23,0.0,0.016951524,6
2020-07-06-170118,170118,0,0,0,23,0.5,0.048803166,0
2020-07-07-170118,170118,0,0,0,23,0.5,0.036836628,1
2020-07-08-170118,170118,0,0,0,23,0.3333333333333333,0.024254587,2
2020-07-09-170118,170118,0,0,0,23,0.8333333333333334,0.093295984,3
2020-07-10-170118,170118,0,0,0,23,0.3333333333333333,0.22057554,4
2020-07-11-170118,170118,0,0,0,23,0.16666666666666666,0.044017673,5
2020-07-12-170118,170118,0,0,0,23,0.16666666666666666,0.00094136776,6
2020-07-13-170118,170118,0,0,0,23,0.16666666666666666,0.061662726,0
2020-07-14-170118,170118,0,0,0,23,0.0,0.0132848155,1
2020-07-15-170118,170118,0,0,0,23,0.0,0.021417864,2
2020-07-16-170118,170118,0,0,0,23,0.5,0.016962769,3
2020-07-17-170118,170118,0,0,1,23,0.16666666666666666,0.22853616,4
2020-07-18-170118,170118,0,0,0,23,0.16666666666666666,0.0112018315,5
2020-07-19-170118,170118,0,0,0,23,0.0,0.0462347,6
2020-07-20-170118,170118,0,0,0,23,0.0,0.034610398,0
2020-07-21-170118,170118,0,0,0,23,0.0,0.01804922,1
2020-07-22-170118,170118,0,0,1,23,0.16666666666666666,0.005753274,2
2020-07-23-170118,170118,0,0,0,23,0.16666666666666666,0.0634735,3
2020-07-24-170118,170118,0,0,0,23,0.16666666666666666,0.023937063,4
2020-07-25-170118,170118,0,0,0,23,0.0,0.000785325,5
2020-07-26-170118,170118,0,0,0,23,0.0,0.01579646,6
2020-07-27-170118,170118,0,0,1,23,0.0,0.011261315,0
2020-07-28-170118,170118,0,0,0,23,0.0,0.014109546,1
2020-07-29-170118,170118,0,0,0,23,0.5,0.08556153,2
2020-07-30-170118,170118,0,0,0,23,0.3333333333333333,0.05256924,3
2020-07-31-170118,170118,1,0,0,24,0.5,0.37242925,4
2020-08-01-170118,170118,0,0,0,24,0.16666666666666666,0.04043561,5
2020-08-02-170118,170118,0,0,0,24,0.16666666666666666,0.043144602,6
2020-08-03-170118,170118,0,0,0,24,0.5,0.1544431,0
2020-08-04-170118,170118,0,0,0,24,0.3333333333333333,0.027215306,1
2020-08-05-170118,170118,1,1,0,25,0.16666666666666666,0.09589037,2
2020-08-06-170118,170118,0,0,0,25,0.3333333333333333,0.10150135,3
2020-08-07-170118,170118,0,0,0,25,0.3333333333333333,0.3646578,4
2020-08-08-170118,170118,0,0,1,25,0.0,0.017513754,5
2020-08-09-170118,170118,0,0,0,25,0.16666666666666666,0.0581073,6
2020-08-10-170118,170118,1,0,1,26,0.8333333333333334,0.12855408,0
2020-08-11-170118,170118,0,0,4,26,2.1666666666666665,0.19316491,1
2020-08-12-170118,170118,0,0,0,26,2.333333333333333,0.2903766,2
2020-08-13-170118,170118,0,0,2,26,1.5,0.071512,3
2020-08-14-170118,170118,0,0,0,26,2.333333333333333,0.59613717,4
2020-08-15-170118,170118,0,0,0,26,1.8333333333333333,0.36299813,5
2020-08-16-170118,170118,0,0,0,26,0.5,0.0492774,6
2020-08-17-170118,170118,0,0,0,26,1.0,0.15230432,0
2020-08-18-170118,170118,0,0,0,26,2.0,0.41763327,1
2020-08-19-170118,170118,0,0,0,26,2.1666666666666665,0.49783617,2
2020-08-20-170118,170118,0,0,0,26,1.8333333333333333,0.15599144,3
2020-08-21-170118,170118,0,0,0,26,4.0,1.2759861,4
2020-08-22-170118,170118,1,0,0,27,1.0,0.20776753,5
2020-08-23-170118,170118,0,0,0,27,1.1666666666666667,0.22705942,6
2020-08-24-170118,170118,1,0,0,28,2.333333333333333,0.4740222,0
2020-08-25-170118,170118,4,0,0,32,4.0,0.5580442,1
2020-08-26-170118,170118,0,0,0,32,4.333333333333333,0.2605242,2
2020-08-27-170118,170118,2,0,1,34,3.6666666666666665,0.18091436,3
2020-08-28-170118,170118,0,0,1,34,4.5,0.61078477,4
2020-08-29-170118,170118,0,0,0,34,2.1666666666666665,0.2756994,5
2020-08-30-170118,170118,0,0,0,34,1.6666666666666667,0.08208921,6
2020-08-31-170118,170118,0,0,1,34,2.6666666666666665,0.20573677,0
2020-09-01-170118,170118,0,0,1,34,3.333333333333333,0.24826184,1
2020-09-02-170118,170118,0,0,4,34,2.0,0.2446261,2
2020-09-03-170118,170118,0,0,0,34,1.5,0.17132053,3
2020-09-04-170118,170118,0,0,0,34,3.6666666666666665,0.5647603,4
2020-09-05-170118,170118,0,0,3,34,2.833333333333333,0.25481066,5
2020-09-06-170118,170118,0,0,0,34,2.1666666666666665,0.14682436,6
2020-09-07-170118,170118,0,0,1,34,3.0,0.22769532,0
2020-09-08-170118,170118,0,0,1,34,1.8333333333333333,0.23351884,1
2020-09-09-170118,170118,0,0,0,34,1.5,0.15217999,2
2020-09-10-170118,170118,1,0,0,35,2.6666666666666665,0.18507771,3
2020-09-11-170118,170118,1,0,0,36,5.833333333333332,0.9894434,4
2020-09-12-170118,170118,0,0,0,36,1.1666666666666667,0.059665807,5
2020-09-13-170118,170118,0,0,0,36,2.6666666666666665,0.10540134,6
2020-09-14-170118,170118,1,0,0,37,3.5,0.37386122,0
2020-09-15-170118,170118,1,0,0,38,2.333333333333333,0.1301873,1
2020-09-16-170118,170118,4,0,0,42,2.333333333333333,0.282978,2
2020-09-17-170118,170118,0,0,0,42,3.0,0.29383636,3
2020-09-18-170118,170118,0,0,0,42,13.833333333333336,0.32325733,4
2020-09-19-170118,170118,3,0,0,45,4.833333333333333,0.20632698,5
2020-09-20-170118,170118,0,0,0,45,4.666666666666667,0.10260094,6
2020-09-21-170118,170118,1,0,0,46,3.0,0.12914857,0
2020-09-22-170118,170118,1,1,0,47,2.6666666666666665,0.33225945,1
2020-09-23-170118,170118,0,0,0,47,4.333333333333333,0.41933808,2
2020-09-24-170118,170118,0,1,0,47,5.0,0.52416927,3
2020-09-25-170118,170118,0,0,1,47,3.8333333333333335,0.88695025,4
2020-09-26-170118,170118,0,0,0,47,1.5,0.3207502,5
2020-09-27-170118,170118,0,0,0,47,1.5,0.012511507,6
2020-09-28-170118,170118,0,0,0,47,2.6666666666666665,0.2252654,0
2020-09-29-170118,170118,0,0,1,47,1.1666666666666667,0.1359584,1
2020-09-30-170118,170118,0,0,0,47,3.6666666666666665,0.19880906,2
2020-10-01-170118,170118,0,0,1,47,4.666666666666667,0.48193473,3
2020-10-02-170118,170118,0,0,0,47,4.833333333333333,0.92157954,4
2020-10-03-170118,170118,0,0,0,47,2.333333333333333,0.28990948,5
2020-10-04-170118,170118,0,1,0,47,2.833333333333333,0.2455394,6
2020-10-05-170118,170118,0,0,0,47,3.5,0.36922437,0
2020-10-06-170118,170118,0,0,0,47,3.1666666666666665,0.43100333,1
2020-10-07-170118,170118,0,0,0,47,3.6666666666666665,0.1788604,2
2020-10-08-170118,170118,0,1,0,47,1.6666666666666667,0.16055015,3
2020-10-09-170118,170118,1,0,1,48,4.166666666666667,1.1898204,4
2020-10-10-170118,170118,0,0,0,48,2.333333333333333,0.16775168,5
2020-10-11-170118,170118,0,0,0,48,0.3333333333333333,0.04962468,6
2020-10-12-170118,170118,0,0,1,48,1.6666666666666667,0.1483296,0
2020-10-13-170118,170118,1,0,0,49,3.8333333333333335,0.20213474,1
2020-10-14-170118,170118,0,0,0,49,4.0,0.26225552,2
2020-10-15-170118,170118,1,0,1,50,2.5,0.112485506,3
2020-10-16-170118,170118,0,0,0,50,5.5,0.4301118,4
2020-10-17-170118,170118,0,0,0,50,3.333333333333333,0.4874667,5
2020-10-18-170118,170118,0,0,0,50,3.0,0.11702683,6
2020-10-19-170118,170118,0,0,1,50,7.666666666666668,0.3873827,0
2020-10-20-170118,170118,0,0,0,50,4.333333333333333,0.53365606,1
2020-10-21-170118,170118,0,0,0,50,5.166666666666667,0.22399919,2
2020-10-22-170118,170118,0,0,0,50,6.5,0.50258684,3
2020-10-23-170118,170118,1,0,1,51,8.0,1.0160382,4
2020-10-24-170118,170118,0,0,0,51,5.833333333333332,0.8004003,5
2020-10-25-170118,170118,0,0,0,51,7.166666666666668,0.37212977,6
2020-10-26-170118,170118,1,0,2,52,7.5,0.45842004,0
2020-10-27-170118,170118,0,0,1,52,7.166666666666668,0.78929824,1
2020-10-28-170118,170118,0,0,1,52,7.666666666666668,1.025563,2
2020-10-29-170118,170118,1,0,3,53,10.333333333333334,1.3306563,3
2020-10-30-170118,170118,0,0,4,53,8.666666666666666,1.8283709,4
2020-10-31-170118,170118,0,0,0,53,4.166666666666667,0.608884,5
2020-11-01-170118,170118,0,0,0,53,4.0,0.4809696,6
2020-11-02-170118,170118,1,0,0,54,2.333333333333333,0.20846069,0
2020-11-03-170118,170118,0,0,0,54,5.833333333333332,0.5880291,1
2020-11-04-170118,170118,0,0,0,54,8.0,0.44735137,2
2020-11-05-170118,170118,0,0,0,54,7.0,0.6424867,3
2020-11-06-170118,170118,1,0,0,55,10.333333333333334,1.3045241,4
2020-11-07-170118,170118,0,0,0,55,3.8333333333333335,0.4035139,5
2020-11-08-170118,170118,0,0,0,55,2.6666666666666665,0.13290325,6
2020-11-09-170118,170118,2,0,0,57,5.333333333333333,0.2210775,0
2020-11-10-170118,170118,1,1,0,58,5.0,0.3838096,1
2020-11-11-170118,170118,1,0,0,59,3.8333333333333335,0.34446675,2
2020-11-12-170118,170118,3,0,0,62,6.0,0.45617864,3
2020-11-13-170118,170118,4,0,0,66,5.333333333333333,0.89381635,4
2020-03-01-170119,170119,0,0,0,0,0.0,0.0006042924,6
2020-03-02-170119,170119,0,0,2,0,0.0,4.860603e-09,0
2020-03-03-170119,170119,0,0,2,0,0.0,0.004376809,1
2020-03-04-170119,170119,0,0,1,0,0.0,0.00076010125,2
2020-03-05-170119,170119,1,2,1,1,0.0,0.18491057,3
2020-03-06-170119,170119,0,0,1,1,0.0,0.0020653764,4
2020-03-07-170119,170119,0,0,0,1,0.0,0.00024519127,5
2020-03-08-170119,170119,0,1,0,1,0.0,5.5431116e-08,6
2020-03-09-170119,170119,0,0,3,1,0.0,7.028661e-05,0
2020-03-10-170119,170119,0,0,3,1,0.0,0.0022490616,1
2020-03-11-170119,170119,0,0,2,1,0.5,0.033845745,2
2020-03-12-170119,170119,0,0,6,1,1.0,0.062388744,3
2020-03-13-170119,170119,0,0,4,1,1.5,0.14686307,4
2020-03-14-170119,170119,0,0,3,1,0.5,0.0077572376,5
2020-03-15-170119,170119,0,0,3,1,0.25,0.010021416,6
2020-03-16-170119,170119,2,0,2,3,3.0,0.43289754,0
2020-03-17-170119,170119,2,0,4,5,1.5,0.4130731,1
2020-03-18-170119,170119,1,0,7,6,5.75,0.45477307,2
2020-03-19-170119,170119,1,1,15,7,7.0,0.5277575,3
2020-03-20-170119,170119,1,1,6,8,5.25,0.38056415,4
2020-03-21-170119,170119,0,0,6,8,1.0,0.051005833,5
2020-03-22-170119,170119,0,0,1,8,1.25,0.05948155,6
2020-03-23-170119,170119,3,0,8,11,7.5,0.8302098,0
2020-03-24-170119,170119,3,0,12,14,4.25,0.42511332,1
2020-03-25-170119,170119,2,0,9,16,4.5,0.5348444,2
2020-03-26-170119,170119,6,0,0,22,5.25,1.080657,3
2020-03-27-170119,170119,4,0,11,26,3.25,0.66562885,4
2020-03-28-170119,170119,3,0,1,29,1.25,0.3851734,5
2020-03-29-170119,170119,3,0,0,32,1.75,0.33468714,6
2020-03-30-170119,170119,2,0,6,34,4.75,0.5212084,0
2020-03-31-170119,170119,4,0,3,38,5.25,0.7734255,1
2020-04-01-170119,170119,7,0,2,45,5.75,1.1667465,2
2020-04-02-170119,170119,15,0,2,60,6.0,2.411142,3
2020-04-03-170119,170119,6,0,5,66,2.75,0.9858234,4
2020-04-04-170119,170119,6,0,0,72,0.75,0.80954385,5
2020-04-05-170119,170119,1,0,1,73,1.5,0.19785541,6
2020-04-06-170119,170119,8,0,4,81,5.0,1.1849879,0
2020-04-07-170119,170119,12,1,5,93,3.0,1.7870018,1
2020-04-08-170119,170119,9,0,1,102,2.0,1.3551983,2
2020-04-09-170119,170119,0,2,0,102,4.25,0.17693523,3
2020-04-10-170119,170119,11,0,2,113,12.5,1.9440683,4
2020-04-11-170119,170119,1,0,1,114,0.75,0.18262054,5
2020-04-12-170119,170119,0,0,0,114,2.5,0.16825493,6
2020-04-13-170119,170119,6,0,5,120,5.75,0.9397844,0
2020-04-14-170119,170119,3,0,0,123,5.5,0.8887868,1
2020-04-15-170119,170119,2,0,5,125,1.75,0.38960898,2
2020-04-16-170119,170119,2,0,2,127,3.5,0.4771005,3
2020-04-17-170119,170119,5,0,0,132,3.0,0.8567343,4
2020-04-18-170119,170119,0,0,0,132,0.5,0.03822509,5
2020-04-19-170119,170119,1,0,0,133,1.5,0.24441111,6
2020-04-20-170119,170119,4,0,2,137,4.0,0.91098255,0
2020-04-21-170119,170119,5,0,0,142,2.75,0.96267885,1
2020-04-22-170119,170119,1,0,1,143,2.0,0.27314588,2
2020-04-23-170119,170119,0,0,1,143,0.0,0.020025367,3
2020-04-24-170119,170119,2,0,18,145,3.25,0.5104824,4
2020-04-25-170119,170119,1,0,2,146,2.75,0.35320258,5
2020-04-26-170119,170119,0,0,0,146,0.5,0.012039228,6
2020-04-27-170119,170119,5,1,0,151,3.5,0.8324731,0
2020-04-28-170119,170119,0,0,3,151,1.5,0.078455,1
2020-04-29-170119,170119,5,0,3,156,2.0,0.78465515,2
2020-04-30-170119,170119,2,0,2,158,0.75,0.28748295,3
2020-05-01-170119,170119,0,0,2,158,0.5,0.01629247,4
2020-05-02-170119,170119,0,0,0,158,1.75,0.11427054,5
2020-05-03-170119,170119,0,0,1,158,1.5,0.052577894,6
2020-05-04-170119,170119,2,0,1,160,1.5,0.34898275,0
2020-05-05-170119,170119,0,0,0,160,1.0,0.054296263,1
2020-05-06-170119,170119,1,0,1,161,2.0,0.26198637,2
2020-05-07-170119,170119,1,0,2,162,2.0,0.27922767,3
2020-05-08-170119,170119,18,0,3,180,2.75,2.891379,4
2020-05-09-170119,170119,2,0,0,182,1.5,0.3548894,5
2020-05-10-170119,170119,0,0,0,182,1.0,0.07301543,6
2020-05-11-170119,170119,0,0,4,182,3.25,0.27249548,0
2020-05-12-170119,170119,3,0,3,185,2.75,0.49250722,1
2020-05-13-170119,170119,3,0,1,188,0.25,0.43665373,2
2020-05-14-170119,170119,2,0,14,190,0.5,0.35097235,3
2020-05-15-170119,170119,2,0,0,192,1.25,0.2555027,4
2020-05-16-170119,170119,0,1,1,192,0.0,0.00082599564,5
2020-05-17-170119,170119,1,0,0,193,0.25,0.12790872,6
2020-05-18-170119,170119,1,0,2,194,2.0,0.26904848,0
2020-05-19-170119,170119,0,0,4,194,1.25,0.09663414,1
2020-05-20-170119,170119,1,0,3,195,0.5,0.15220152,2
2020-05-21-170119,170119,2,0,0,197,1.0,0.29662523,3
2020-05-22-170119,170119,3,1,1,200,1.75,0.44352493,4
2020-05-23-170119,170119,0,0,2,200,0.25,0.024970826,5
2020-05-24-170119,170119,0,0,0,200,0.25,0.022910012,6
2020-05-25-170119,170119,4,0,1,204,0.5,0.5667585,0
2020-05-26-170119,170119,3,0,1,207,1.0,0.44223228,1
2020-05-27-170119,170119,1,0,1,208,0.5,0.15188006,2
2020-05-28-170119,170119,14,0,2,222,1.25,2.3131273,3
2020-05-29-170119,170119,0,2,0,222,0.25,0.03130521,4
2020-05-30-170119,170119,1,0,0,223,0.0,0.15054807,5
2020-05-31-170119,170119,0,1,1,223,0.5,0.044264384,6
2020-06-01-170119,170119,2,0,0,225,0.5,0.31239867,0
2020-06-02-170119,170119,4,1,1,229,1.5,0.5148711,1
2020-06-03-170119,170119,3,0,5,232,0.75,0.37288138,2
2020-06-04-170119,170119,0,0,6,232,0.5,0.04546001,3
2020-06-05-170119,170119,1,1,0,233,0.0,0.18324456,4
2020-06-06-170119,170119,2,0,0,235,0.0,0.23980929,5
2020-06-07-170119,170119,0,0,4,235,0.0,0.0008917271,6
2020-06-08-170119,170119,1,0,1,236,2.0,0.24466845,0
2020-06-09-170119,170119,1,0,0,237,0.25,0.19212653,1
2020-06-10-170119,170119,1,0,0,238,0.25,0.1709752,2
2020-06-11-170119,170119,2,0,1,240,0.25,0.17034967,3
2020-06-12-170119,170119,0,0,0,240,1.0,0.07307288,4
2020-06-13-170119,170119,0,0,1,240,0.0,0.000603734,5
2020-06-14-170119,170119,1,0,0,241,0.25,0.14746647,6
2020-06-15-170119,170119,0,0,1,241,0.75,0.053030252,0
2020-06-16-170119,170119,1,0,0,242,0.75,0.19584407,1
2020-06-17-170119,170119,5,0,0,247,0.75,0.91872245,2
2020-06-18-170119,170119,6,0,1,253,0.75,1.0780413,3
2020-06-19-170119,170119,0,0,0,253,0.0,0.0031111091,4
2020-06-20-170119,170119,0,0,0,253,0.75,0.0777964,5
2020-06-21-170119,170119,4,0,0,257,0.0,0.5697101,6
2020-06-22-170119,170119,1,0,0,258,0.25,0.23028293,0
2020-06-23-170119,170119,0,0,0,258,0.25,0.042722892,1
2020-06-24-170119,170119,0,0,0,258,0.5,0.03905708,2
2020-06-25-170119,170119,1,1,1,259,0.0,0.1863548,3
2020-06-26-170119,170119,0,0,1,259,0.5,0.10517951,4
2020-06-27-170119,170119,1,0,0,260,0.25,0.25933263,5
2020-06-28-170119,170119,0,0,1,260,0.25,0.034852345,6
2020-06-29-170119,170119,1,0,0,261,0.0,0.18843849,0
2020-06-30-170119,170119,0,0,1,261,0.25,0.035508443,1
2020-07-01-170119,170119,0,0,0,261,1.25,0.06025295,2
2020-07-02-170119,170119,1,0,0,262,0.5,0.24342139,3
2020-07-03-170119,170119,0,0,0,262,0.5,0.039351303,4
2020-07-04-170119,170119,0,0,0,262,0.0,0.0012479668,5
2020-07-05-170119,170119,0,0,0,262,0.0,5.9872134e-05,6
2020-07-06-170119,170119,0,0,0,262,0.5,0.04043886,0
2020-07-07-170119,170119,0,0,0,262,0.0,0.0043021413,1
2020-07-08-170119,170119,0,2,0,262,0.0,0.0044899327,2
2020-07-09-170119,170119,1,0,0,263,0.25,0.19431888,3
2020-07-10-170119,170119,1,0,0,264,1.0,0.3241097,4
2020-07-11-170119,170119,0,0,0,264,0.5,0.060814682,5
2020-07-12-170119,170119,1,0,1,265,0.0,0.18579988,6
2020-07-13-170119,170119,0,0,0,265,1.5,0.072842754,0
2020-07-14-170119,170119,1,0,0,266,0.25,0.23304239,1
2020-07-15-170119,170119,0,0,0,266,0.5,0.009296208,2
2020-07-16-170119,170119,0,0,0,266,0.25,0.048124753,3
2020-07-17-170119,170119,0,1,0,266,0.75,0.13168801,4
2020-07-18-170119,170119,0,0,0,266,0.5,0.08836019,5
2020-07-19-170119,170119,0,0,0,266,0.0,0.0019238206,6
2020-07-20-170119,170119,0,0,0,266,0.75,0.068597965,0
2020-07-21-170119,170119,0,0,0,266,0.25,0.018215396,1
2020-07-22-170119,170119,0,0,0,266,0.75,0.04479714,2
2020-07-23-170119,170119,0,0,0,266,0.5,0.049627475,3
2020-07-24-170119,170119,0,0,1,266,0.5,0.007489086,4
2020-07-25-170119,170119,0,0,0,266,0.25,0.003769442,5
2020-07-26-170119,170119,1,0,0,267,0.0,0.2082976,6
2020-07-27-170119,170119,0,1,0,267,0.5,0.045819305,0
2020-07-28-170119,170119,0,0,3,267,0.25,0.028089864,1
2020-07-29-170119,170119,0,0,2,267,0.0,0.005438013,2
2020-07-30-170119,170119,0,0,4,267,0.75,0.048110157,3
2020-07-31-170119,170119,0,0,0,267,0.75,0.12362862,4
2020-08-01-170119,170119,0,0,0,267,0.0,0.0021492606,5
2020-08-02-170119,170119,0,0,1,267,0.0,0.008873655,6
2020-08-03-170119,170119,0,0,1,267,1.0,0.10412702,0
2020-08-04-170119,170119,0,0,0,267,0.75,0.13528527,1
2020-08-05-170119,170119,0,0,1,267,1.25,0.19455482,2
2020-08-06-170119,170119,0,0,2,267,1.75,0.27169925,3
2020-08-07-170119,170119,1,0,4,268,1.0,0.3920095,4
2020-08-08-170119,170119,0,0,0,268,2.5,0.48068553,5
2020-08-09-170119,170119,0,0,1,268,0.75,0.050502367,6
2020-08-10-170119,170119,0,0,2,268,2.0,0.22680803,0
2020-08-11-170119,170119,3,0,2,271,2.0,0.8752845,1
2020-08-12-170119,170119,2,0,2,273,2.0,0.9227042,2
2020-08-13-170119,170119,4,0,4,277,3.0,1.1661314,3
2020-08-14-170119,170119,0,0,1,277,4.75,0.6409034,4
2020-08-15-170119,170119,0,0,1,277,1.25,0.17779455,5
2020-08-16-170119,170119,1,0,1,278,0.75,0.28354865,6
2020-08-17-170119,170119,1,0,1,279,2.0,0.48586085,0
2020-08-18-170119,170119,0,0,0,279,1.5,0.16780512,1
2020-08-19-170119,170119,1,0,0,280,2.0,0.5480097,2
2020-08-20-170119,170119,2,0,0,282,1.5,0.7064457,3
2020-08-21-170119,170119,4,0,4,286,1.75,0.95966834,4
2020-08-22-170119,170119,0,0,10,286,1.0,0.14466812,5
2020-08-23-170119,170119,1,0,6,287,1.25,0.32843417,6
2020-08-24-170119,170119,2,0,0,289,1.25,0.49040872,0
2020-08-25-170119,170119,2,0,5,291,1.5,0.47343725,1
2020-08-26-170119,170119,2,0,3,293,2.75,0.5860893,2
2020-08-27-170119,170119,4,0,3,297,2.0,1.0751686,3
2020-08-28-170119,170119,1,0,0,298,1.75,0.31470358,4
2020-08-29-170119,170119,1,0,2,299,2.25,0.29459333,5
2020-08-30-170119,170119,1,0,0,300,1.25,0.29027438,6
2020-08-31-170119,170119,1,0,2,301,2.0,0.2432745,0
2020-09-01-170119,170119,0,0,2,301,1.0,0.06765667,1
2020-09-02-170119,170119,0,0,3,301,1.75,0.026333699,2
2020-09-03-170119,170119,0,0,0,301,3.25,0.23458873,3
2020-09-04-170119,170119,4,0,7,305,4.25,0.9641261,4
2020-09-05-170119,170119,10,0,0,315,0.25,1.9483327,5
2020-09-06-170119,170119,6,0,6,321,1.75,1.1284308,6
2020-09-07-170119,170119,0,0,5,321,2.0,0.15348475,0
2020-09-08-170119,170119,5,0,5,326,3.25,1.0426973,1
2020-09-09-170119,170119,3,0,13,329,2.75,0.68813115,2
2020-09-10-170119,170119,3,0,8,332,1.5,0.6415688,3
2020-09-11-170119,170119,0,0,10,332,2.0,0.2454441,4
2020-09-12-170119,170119,2,0,4,334,0.25,0.37851495,5
2020-09-13-170119,170119,0,0,0,334,0.25,0.052214544,6
2020-09-14-170119,170119,2,0,4,336,4.25,0.6438429,0
2020-09-15-170119,170119,2,0,3,338,1.5,0.45697826,1
2020-09-16-170119,170119,3,0,4,341,2.25,0.642769,2
2020-09-17-170119,170119,0,0,6,341,2.75,0.2071951,3
2020-09-18-170119,170119,7,0,4,348,3.5,0.40467468,4
2020-09-19-170119,170119,0,0,0,348,1.75,0.03983731,5
2020-09-20-170119,170119,6,0,5,354,0.5,0.89072275,6
2020-09-21-170119,170119,5,0,3,359,1.75,0.97583234,0
2020-09-22-170119,170119,5,0,5,364,1.75,1.0084233,1
2020-09-23-170119,170119,13,1,0,377,3.5,2.3508134,2
2020-09-24-170119,170119,8,0,4,385,4.25,1.5493901,3
2020-09-25-170119,170119,10,1,1,395,3.0,1.4232472,4
2020-09-26-170119,170119,4,0,0,399,1.0,0.7225324,5
2020-09-27-170119,170119,0,0,1,399,0.75,0.01059085,6
2020-09-28-170119,170119,4,0,1,403,1.75,0.86725926,0
2020-09-29-170119,170119,3,0,5,406,2.0,0.66787165,1
2020-09-30-170119,170119,4,0,3,410,4.0,0.6192906,2
2020-10-01-170119,170119,6,0,3,416,2.5,1.1224228,3
2020-10-02-170119,170119,4,0,1,420,3.0,0.9874541,4
2020-10-03-170119,170119,0,1,1,420,1.0,0.12032771,5
2020-10-04-170119,170119,5,1,2,425,0.25,0.7818691,6
2020-10-05-170119,170119,3,1,2,428,1.0,0.5657594,0
2020-10-06-170119,170119,5,0,5,433,1.5,0.95127493,1
2020-10-07-170119,170119,0,0,0,433,2.0,0.18909374,2
2020-10-08-170119,170119,4,0,3,437,1.0,0.90747947,3
2020-10-09-170119,170119,1,0,9,438,2.75,0.6842257,4
2020-10-10-170119,170119,0,0,2,438,0.75,0.10664829,5
2020-10-11-170119,170119,1,0,4,439,0.5,0.17778185,6
2020-10-12-170119,170119,1,0,10,440,2.0,0.3049529,0
2020-10-13-170119,170119,5,0,9,445,1.25,0.8688035,1
2020-10-14-170119,170119,3,0,7,448,3.0,0.44989866,2
2020-10-15-170119,170119,3,0,9,451,0.75,0.35464442,3
2020-10-16-170119,170119,1,0,17,452,1.5,0.28697422,4
2020-10-17-170119,170119,1,0,5,453,0.75,0.19404888,5
2020-10-18-170119,170119,2,0,21,455,0.75,0.34224933,6
2020-10-19-170119,170119,2,1,3,457,3.25,0.58169186,0
2020-10-20-170119,170119,5,0,7,462,1.25,0.80105895,1
2020-10-21-170119,170119,0,1,21,462,3.75,0.29468998,2
2020-10-22-170119,170119,3,0,22,465,3.25,0.82024884,3
2020-10-23-170119,170119,9,0,14,474,3.5,1.6745281,4
2020-10-24-170119,170119,2,0,8,476,0.75,0.42382103,5
2020-10-25-170119,170119,4,0,2,480,3.5,0.8030418,6
2020-10-26-170119,170119,10,1,3,490,3.25,2.1093311,0
2020-10-27-170119,170119,9,0,5,499,1.0,1.6223389,1
2020-10-28-170119,170119,7,1,5,506,3.5,1.3816054,2
2020-10-29-170119,170119,9,0,7,515,6.25,1.6953535,3
2020-10-30-170119,170119,17,0,7,532,4.75,3.4398332,4
2020-10-31-170119,170119,5,1,0,537,2.0,1.1113585,5
2020-11-01-170119,170119,21,0,0,558,2.5,3.660699,6
2020-11-02-170119,170119,3,0,0,561,0.75,0.52443355,0
2020-11-03-170119,170119,7,0,0,568,4.0,1.4533261,1
2020-11-04-170119,170119,21,2,0,589,3.75,3.43892,2
2020-11-05-170119,170119,22,1,0,611,6.5,3.7756047,3
2020-11-06-170119,170119,14,3,0,625,4.75,2.7267678,4
2020-11-07-170119,170119,8,1,0,633,1.75,1.2087806,5
2020-11-08-170119,170119,2,2,0,635,2.0,0.4175182,6
2020-11-09-170119,170119,3,1,0,638,1.75,0.67525345,0
2020-11-10-170119,170119,5,0,0,643,1.25,1.0382284,1
2020-11-11-170119,170119,5,1,0,648,4.25,1.4482673,2
2020-11-12-170119,170119,7,0,0,655,3.0,1.651367,3
2020-11-13-170119,170119,7,0,0,662,3.0,0.6106141,4
2020-03-01-170120,170120,0,0,0,0,0.0,0.0008103519,6
2020-03-02-170120,170120,0,0,1,0,0.0,0.00049755146,0
2020-03-03-170120,170120,0,0,0,0,0.25,0.025224708,1
2020-03-04-170120,170120,0,0,0,0,0.0,1.6020633e-05,2
2020-03-05-170120,170120,0,0,1,0,0.0,0.0042010583,3
2020-03-06-170120,170120,0,0,3,0,0.0,0.0007339886,4
2020-03-07-170120,170120,0,0,0,0,0.0,0.00020527974,5
2020-03-08-170120,170120,0,0,1,0,0.0,6.318689e-05,6
2020-03-09-170120,170120,0,0,6,0,0.0,0.0001477157,0
2020-03-10-170120,170120,0,0,3,0,0.0,0.00058523234,1
2020-03-11-170120,170120,0,0,2,0,0.25,0.02087902,2
2020-03-12-170120,170120,0,0,0,0,0.0,0.0101269465,3
2020-03-13-170120,170120,0,0,1,0,0.5,0.07405192,4
2020-03-14-170120,170120,0,0,1,0,0.25,0.0014936683,5
2020-03-15-170120,170120,0,0,2,0,0.25,0.027399395,6
2020-03-16-170120,170120,1,0,1,1,1.0,0.09721219,0
2020-03-17-170120,170120,0,0,1,1,0.25,0.11520123,1
2020-03-18-170120,170120,0,0,2,1,3.5,0.25200686,2
2020-03-19-170120,170120,1,0,4,2,2.5,0.30555874,3
2020-03-20-170120,170120,3,0,1,5,1.25,0.13568151,4
2020-03-21-170120,170120,0,3,0,5,0.5,0.06001892,5
2020-03-22-170120,170120,1,0,0,6,1.0,0.210918,6
2020-03-23-170120,170120,6,0,0,12,6.0,0.6878125,0
2020-03-24-170120,170120,3,0,2,15,1.5,0.15918258,1
2020-03-25-170120,170120,2,0,1,17,4.25,0.42493555,2
2020-03-26-170120,170120,0,0,0,17,2.5,0.1822708,3
2020-03-27-170120,170120,1,0,2,18,1.75,0.19286676,4
2020-03-28-170120,170120,1,0,0,19,1.0,0.064535804,5
2020-03-29-170120,170120,2,0,1,21,0.75,0.12049983,6
2020-03-30-170120,170120,1,0,2,22,3.0,0.30750048,0
2020-03-31-170120,170120,1,0,0,23,3.75,0.31012806,1
2020-04-01-170120,170120,2,0,0,25,2.0,0.25251657,2
2020-04-02-170120,170120,4,0,0,29,3.5,0.41646716,3
2020-04-03-170120,170120,1,0,1,30,1.5,0.22819474,4
2020-04-04-170120,170120,0,0,1,30,0.5,0.031580366,5
2020-04-05-170120,170120,0,0,1,30,0.25,0.041811008,6
2020-04-06-170120,170120,0,0,0,30,4.5,0.4548386,0
2020-04-07-170120,170120,2,0,1,32,1.75,0.23054202,1
2020-04-08-170120,170120,1,5,0,33,1.0,0.1438391,2
2020-04-09-170120,170120,0,0,0,33,1.25,0.16876364,3
2020-04-10-170120,170120,2,0,0,35,1.5,0.19260451,4
2020-04-11-170120,170120,0,0,0,35,0.0,0.015897425,5
2020-04-12-170120,170120,1,0,0,36,2.0,0.14546052,6
2020-04-13-170120,170120,2,0,0,38,1.25,0.2265057,0
2020-04-14-170120,170120,0,0,1,38,4.25,0.47850412,1
2020-04-15-170120,170120,0,0,0,38,1.0,0.5615346,2
2020-04-16-170120,170120,0,0,0,38,2.25,0.6354884,3
2020-04-17-170120,170120,1,0,0,39,0.75,0.17909484,4
2020-04-18-170120,170120,1,0,0,40,0.5,0.06260637,5
2020-04-19-170120,170120,1,0,0,41,1.25,0.13733433,6
2020-04-20-170120,170120,0,1,1,41,2.5,0.22337541,0
2020-04-21-170120,170120,1,1,0,42,2.5,0.23971047,1
2020-04-22-170120,170120,0,0,0,42,0.5,0.17418167,2
2020-04-23-170120,170120,0,0,1,42,0.0,0.059308246,3
2020-04-24-170120,170120,0,0,3,42,0.0,0.038765535,4
2020-04-25-170120,170120,0,0,0,42,0.0,0.02436433,5
2020-04-26-170120,170120,0,0,0,42,0.0,0.0049303165,6
2020-04-27-170120,170120,0,0,0,42,0.5,0.04804184,0
2020-04-28-170120,170120,1,0,0,43,0.25,0.06838526,1
2020-04-29-170120,170120,0,0,0,43,1.25,0.16701573,2
2020-04-30-170120,170120,0,0,0,43,0.5,0.15582262,3
2020-05-01-170120,170120,0,0,0,43,0.0,0.013122526,4
2020-05-02-170120,170120,0,0,1,43,1.25,0.2896894,5
2020-05-03-170120,170120,0,0,0,43,0.25,0.059904158,6
2020-05-04-170120,170120,1,0,0,44,1.0,0.34123278,0
2020-05-05-170120,170120,0,0,0,44,0.5,0.16686967,1
2020-05-06-170120,170120,0,0,0,44,1.0,0.08330376,2
2020-05-07-170120,170120,1,0,0,45,1.25,0.35956347,3
2020-05-08-170120,170120,3,0,1,48,1.0,0.24399024,4
2020-05-09-170120,170120,0,0,0,48,0.25,0.02485219,5
2020-05-10-170120,170120,0,0,0,48,0.5,0.0514411,6
2020-05-11-170120,170120,0,0,0,48,1.75,0.16305256,0
2020-05-12-170120,170120,0,0,0,48,1.0,0.13672525,1
2020-05-13-170120,170120,0,0,0,48,0.25,0.03927974,2
2020-05-14-170120,170120,0,0,0,48,0.75,0.07918529,3
2020-05-15-170120,170120,0,0,1,48,0.25,0.03088984,4
2020-05-16-170120,170120,1,0,0,49,0.0,0.015888916,5
2020-05-17-170120,170120,0,0,0,49,0.25,0.020407172,6
2020-05-18-170120,170120,0,0,0,49,2.25,0.20890401,0
2020-05-19-170120,170120,0,0,0,49,0.25,0.04590405,1
2020-05-20-170120,170120,0,0,0,49,1.0,0.15148613,2
2020-05-21-170120,170120,0,0,0,49,1.25,0.17061247,3
2020-05-22-170120,170120,1,0,0,50,0.75,0.23968635,4
2020-05-23-170120,170120,0,0,0,50,0.25,0.036871918,5
2020-05-24-170120,170120,0,0,0,50,0.0,0.00501929,6
2020-05-25-170120,170120,0,0,0,50,0.5,0.07944501,0
2020-05-26-170120,170120,0,0,0,50,0.5,0.09035325,1
2020-05-27-170120,170120,0,0,0,50,0.0,0.012216565,2
2020-05-28-170120,170120,0,0,0,50,0.75,0.12107934,3
2020-05-29-170120,170120,1,0,0,51,0.25,0.12606207,4
2020-05-30-170120,170120,0,0,0,51,0.0,0.0002490983,5
2020-05-31-170120,170120,0,1,0,51,0.0,0.012433392,6
2020-06-01-170120,170120,0,0,0,51,0.0,0.007936739,0
2020-06-02-170120,170120,0,0,0,51,1.5,0.15000136,1
2020-06-03-170120,170120,0,0,0,51,0.25,0.039341446,2
2020-06-04-170120,170120,0,0,0,51,0.5,0.032796655,3
2020-06-05-170120,170120,0,0,0,51,0.25,0.09370754,4
2020-06-06-170120,170120,0,2,0,51,0.0,0.010099487,5
2020-06-07-170120,170120,0,0,0,51,0.0,0.00011786231,6
2020-06-08-170120,170120,0,0,0,51,0.25,0.047241263,0
2020-06-09-170120,170120,0,0,1,51,0.75,0.06076801,1
2020-06-10-170120,170120,0,0,1,51,0.0,0.00439277,2
2020-06-11-170120,170120,0,0,0,51,0.0,0.0020693163,3
2020-06-12-170120,170120,0,0,0,51,0.5,0.13235717,4
2020-06-13-170120,170120,0,0,0,51,0.0,0.0010258403,5
2020-06-14-170120,170120,0,0,0,51,0.0,0.0017338039,6
2020-06-15-170120,170120,0,1,0,51,0.25,0.029934593,0
2020-06-16-170120,170120,0,0,0,51,0.5,0.028747559,1
2020-06-17-170120,170120,0,0,0,51,0.25,0.039553683,2
2020-06-18-170120,170120,0,0,0,51,0.0,0.010996309,3
2020-06-19-170120,170120,0,0,0,51,0.25,0.23340179,4
2020-06-20-170120,170120,0,0,0,51,0.0,0.01605396,5
2020-06-21-170120,170120,0,0,0,51,0.0,0.002002824,6
2020-06-22-170120,170120,0,0,0,51,0.25,0.030658849,0
2020-06-23-170120,170120,1,0,0,52,0.25,0.06260549,1
2020-06-24-170120,170120,1,0,0,53,0.0,0.057424754,2
2020-06-25-170120,170120,0,0,0,53,0.25,0.049572542,3
2020-06-26-170120,170120,0,0,0,53,0.0,0.05015781,4
2020-06-27-170120,170120,0,1,1,53,0.0,0.0015772312,5
2020-06-28-170120,170120,0,0,0,53,0.25,0.035537314,6
2020-06-29-170120,170120,0,0,1,53,1.0,0.14050718,0
2020-06-30-170120,170120,0,0,1,53,0.0,0.009780005,1
2020-07-01-170120,170120,0,0,0,53,0.5,0.010006429,2
2020-07-02-170120,170120,0,1,0,53,0.25,0.048859555,3
2020-07-03-170120,170120,0,0,1,53,0.0,0.016963039,4
2020-07-04-170120,170120,0,0,0,53,0.0,0.00078930694,5
2020-07-05-170120,170120,0,0,0,53,0.0,0.0005265441,6
2020-07-06-170120,170120,0,0,0,53,0.5,0.045074657,0
2020-07-07-170120,170120,0,0,0,53,0.5,0.0952872,1
2020-07-08-170120,170120,0,0,0,53,0.25,0.041886233,2
2020-07-09-170120,170120,0,0,0,53,0.0,0.0016308494,3
2020-07-10-170120,170120,0,0,0,53,0.5,0.19674978,4
2020-07-11-170120,170120,1,0,0,54,0.0,0.059723526,5
2020-07-12-170120,170120,0,0,0,54,0.25,0.04576969,6
2020-07-13-170120,170120,1,0,0,55,0.25,0.0715382,0
2020-07-14-170120,170120,1,0,0,56,0.75,0.12924361,1
2020-07-15-170120,170120,0,0,0,56,0.5,0.09502413,2
2020-07-16-170120,170120,0,0,0,56,0.0,0.01336213,3
2020-07-17-170120,170120,1,0,0,57,0.25,0.253053,4
2020-07-18-170120,170120,0,0,0,57,0.0,0.027859358,5
2020-07-19-170120,170120,0,0,0,57,0.0,0.0013701257,6
2020-07-20-170120,170120,0,0,0,57,0.0,0.02462884,0
2020-07-21-170120,170120,0,0,0,57,0.0,0.0016049594,1
2020-07-22-170120,170120,0,0,0,57,0.5,0.06311759,2
2020-07-23-170120,170120,0,0,0,57,0.75,0.15296699,3
2020-07-24-170120,170120,0,0,1,57,0.0,0.004135428,4
2020-07-25-170120,170120,0,0,0,57,0.0,0.00012256006,5
2020-07-26-170120,170120,0,0,0,57,0.0,0.00061763043,6
2020-07-27-170120,170120,0,0,0,57,0.5,0.1018226,0
2020-07-28-170120,170120,0,0,0,57,0.75,0.22841547,1
2020-07-29-170120,170120,0,0,0,57,0.5,0.062958986,2
2020-07-30-170120,170120,0,0,0,57,0.0,0.013494402,3
2020-07-31-170120,170120,0,0,0,57,0.5,0.3005734,4
2020-08-01-170120,170120,0,0,0,57,0.0,0.002064579,5
2020-08-02-170120,170120,0,0,0,57,0.0,0.039433457,6
2020-08-03-170120,170120,0,0,0,57,0.0,0.024636053,0
2020-08-04-170120,170120,0,0,0,57,0.25,0.083687015,1
2020-08-05-170120,170120,0,0,2,57,1.0,0.23254208,2
2020-08-06-170120,170120,0,0,1,57,1.0,0.44909608,3
2020-08-07-170120,170120,1,0,0,58,1.75,0.66840327,4
2020-08-08-170120,170120,0,0,0,58,0.0,0.12559937,5
2020-08-09-170120,170120,0,0,0,58,0.25,0.048975248,6
2020-08-10-170120,170120,0,0,0,58,0.75,0.20444459,0
2020-08-11-170120,170120,0,0,0,58,2.5,0.62988985,1
2020-08-12-170120,170120,0,0,0,58,0.75,0.4724513,2
2020-08-13-170120,170120,0,0,0,58,0.75,0.3364088,3
2020-08-14-170120,170120,0,0,0,58,1.25,0.7197839,4
2020-08-15-170120,170120,0,0,0,58,0.25,0.15794918,5
2020-08-16-170120,170120,0,0,1,58,0.25,0.07082625,6
2020-08-17-170120,170120,0,0,0,58,0.5,0.2737365,0
2020-08-18-170120,170120,0,0,0,58,0.0,0.071580134,1
2020-08-19-170120,170120,2,0,0,60,0.25,0.29594573,2
2020-08-20-170120,170120,1,0,5,61,0.0,0.21880022,3
2020-08-21-170120,170120,0,0,2,61,0.5,0.61284375,4
2020-08-22-170120,170120,0,0,0,61,0.25,0.11212837,5
2020-08-23-170120,170120,0,0,0,61,0.5,0.09215364,6
2020-08-24-170120,170120,0,0,0,61,0.75,0.19604366,0
2020-08-25-170120,170120,0,0,0,61,1.0,0.17364451,1
2020-08-26-170120,170120,0,0,0,61,0.5,0.13107194,2
2020-08-27-170120,170120,0,0,0,61,0.75,0.12546635,3
2020-08-28-170120,170120,0,0,1,61,0.25,0.32217786,4
2020-08-29-170120,170120,0,0,0,61,1.25,0.20741254,5
2020-08-30-170120,170120,1,0,0,62,1.5,0.31670055,6
2020-08-31-170120,170120,0,0,0,62,0.5,0.12301473,0
2020-09-01-170120,170120,0,0,0,62,0.25,0.073709935,1
2020-09-02-170120,170120,0,0,0,62,0.5,0.01886149,2
2020-09-03-170120,170120,5,0,1,67,1.0,0.3434971,3
2020-09-04-170120,170120,2,0,0,69,1.0,0.73838997,4
2020-09-05-170120,170120,0,0,0,69,0.0,0.07210617,5
2020-09-06-170120,170120,0,0,0,69,0.75,0.13586764,6
2020-09-07-170120,170120,0,0,0,69,0.5,0.118024476,0
2020-09-08-170120,170120,0,0,1,69,1.5,0.19452342,1
2020-09-09-170120,170120,0,0,3,69,2.25,0.30577406,2
2020-09-10-170120,170120,0,0,2,69,0.75,0.124956354,3
2020-09-11-170120,170120,1,0,5,70,2.0,0.7238521,4
2020-09-12-170120,170120,0,0,5,70,0.0,0.026926098,5
2020-09-13-170120,170120,0,0,0,70,0.5,0.09157559,6
2020-09-14-170120,170120,0,0,1,70,1.5,0.29222855,0
2020-09-15-170120,170120,0,0,2,70,1.25,0.15139222,1
2020-09-16-170120,170120,0,0,2,70,1.5,0.22661895,2
2020-09-17-170120,170120,1,0,0,71,0.5,0.13479537,3
2020-09-18-170120,170120,0,0,2,71,3.25,0.43840268,4
2020-09-19-170120,170120,0,1,0,71,0.0,0.028637609,5
2020-09-20-170120,170120,0,0,5,71,0.25,0.06665871,6
2020-09-21-170120,170120,0,1,1,71,0.75,0.11273256,0
2020-09-22-170120,170120,1,0,2,72,1.75,0.23416252,1
2020-09-23-170120,170120,3,0,0,75,2.0,0.24870448,2
2020-09-24-170120,170120,2,0,4,77,2.25,0.25534606,3
2020-09-25-170120,170120,5,0,0,82,1.75,0.7869881,4
2020-09-26-170120,170120,5,0,4,87,0.25,0.18940617,5
2020-09-27-170120,170120,0,0,3,87,0.25,0.041902278,6
2020-09-28-170120,170120,1,0,0,88,2.25,0.29438484,0
2020-09-29-170120,170120,2,0,3,90,0.75,0.1370597,1
2020-09-30-170120,170120,2,0,1,92,1.75,0.23650238,2
2020-10-01-170120,170120,0,0,0,92,1.25,0.17262928,3
2020-10-02-170120,170120,2,0,0,94,2.0,0.6526106,4
2020-10-03-170120,170120,0,1,1,94,1.0,0.11803283,5
2020-10-04-170120,170120,5,0,0,99,0.25,0.13465212,6
2020-10-05-170120,170120,1,0,0,100,1.0,0.20837389,0
2020-10-06-170120,170120,2,0,0,102,0.5,0.08643951,1
2020-10-07-170120,170120,0,0,1,102,0.5,0.17530951,2
2020-10-08-170120,170120,4,0,0,106,1.0,0.25948644,3
2020-10-09-170120,170120,0,0,0,106,1.75,0.99682224,4
2020-10-10-170120,170120,4,0,1,110,1.75,0.38260752,5
2020-10-11-170120,170120,3,0,0,113,0.5,0.27030635,6
2020-10-12-170120,170120,0,0,1,113,2.0,0.22017711,0
2020-10-13-170120,170120,3,0,0,116,0.75,0.25204772,1
2020-10-14-170120,170120,1,0,3,117,1.25,0.20346598,2
2020-10-15-170120,170120,0,0,1,117,0.0,0.043795217,3
2020-10-16-170120,170120,0,0,1,117,1.0,0.37014,4
2020-10-17-170120,170120,1,0,3,118,0.5,0.09883751,5
2020-10-18-170120,170120,0,0,5,118,0.5,0.10167906,6
2020-10-19-170120,170120,0,0,0,118,2.5,0.29077375,0
2020-10-20-170120,170120,0,0,0,118,0.5,0.060806565,1
2020-10-21-170120,170120,1,0,1,119,1.0,0.14387314,2
2020-10-22-170120,170120,0,0,4,119,1.75,0.22859707,3
2020-10-23-170120,170120,0,0,5,119,2.0,0.65468204,4
2020-10-24-170120,170120,1,0,4,120,0.75,0.13922729,5
2020-10-25-170120,170120,0,0,0,120,2.0,0.16830076,6
2020-10-26-170120,170120,1,0,0,121,0.5,0.14717153,0
2020-10-27-170120,170120,0,0,1,121,2.5,0.30117676,1
2020-10-28-170120,170120,3,0,0,124,1.5,0.30048242,2
2020-10-29-170120,170120,1,0,0,125,5.25,0.46871167,3
2020-10-30-170120,170120,1,0,1,126,2.75,0.9812381,4
2020-10-31-170120,170120,3,0,0,129,1.25,0.20905577,5
2020-11-01-170120,170120,5,0,0,134,0.75,0.2844275,6
2020-11-02-170120,170120,0,0,0,134,0.75,0.094586745,0
2020-11-03-170120,170120,0,0,0,134,2.5,0.4537204,1
2020-11-04-170120,170120,1,0,0,135,2.75,0.22744405,2
2020-11-05-170120,170120,4,0,0,139,3.75,0.46314532,3
2020-11-06-170120,170120,5,0,0,144,2.5,0.8771045,4
2020-11-07-170120,170120,4,0,0,148,0.75,0.20519298,5
2020-11-08-170120,170120,0,0,0,148,2.0,0.22127405,6
2020-11-09-170120,170120,0,0,0,148,0.0,0.031265616,0
2020-11-10-170120,170120,1,0,0,149,0.25,0.062304053,1
2020-11-11-170120,170120,0,0,0,149,0.5,0.16126394,2
2020-11-12-170120,170120,0,0,0,149,0.5,0.14811939,3
2020-11-13-170120,170120,1,0,0,150,1.0,0.4926625,4
2020-03-01-170121,170121,0,0,0,0,0.2,4.848225e-06,6
2020-03-02-170121,170121,0,0,0,0,0.0,2.3762407e-06,0
2020-03-03-170121,170121,0,0,0,0,0.2,1.2094618e-05,1
2020-03-04-170121,170121,0,0,2,0,0.0,1.0765549e-06,2
2020-03-05-170121,170121,0,0,0,0,0.0,0.0076182606,3
2020-03-06-170121,170121,0,0,1,0,0.0,3.4004077e-07,4
2020-03-07-170121,170121,0,0,0,0,0.0,1.3870664e-07,5
2020-03-08-170121,170121,0,0,0,0,0.0,9.373723e-08,6
2020-03-09-170121,170121,0,0,1,0,0.0,1.1831057e-06,0
2020-03-10-170121,170121,0,0,0,0,0.0,3.08732e-06,1
2020-03-11-170121,170121,0,0,1,0,0.2,4.3477803e-06,2
2020-03-12-170121,170121,0,0,1,0,0.2,1.1748879e-05,3
2020-03-13-170121,170121,0,0,0,0,0.6,2.9106424e-05,4
2020-03-14-170121,170121,0,0,1,0,0.4,2.1764006e-05,5
2020-03-15-170121,170121,0,0,0,0,0.2,2.87667e-05,6
2020-03-16-170121,170121,0,0,0,0,2.6,0.00010546228,0
2020-03-17-170121,170121,0,0,0,0,1.2,0.1504061,1
2020-03-18-170121,170121,2,0,0,2,3.0,0.00011371106,2
2020-03-19-170121,170121,0,0,1,2,2.0,0.00015126023,3
2020-03-20-170121,170121,1,0,0,3,2.2,0.00013076338,4
2020-03-21-170121,170121,0,0,0,3,1.2,7.0539674e-05,5
2020-03-22-170121,170121,0,0,0,3,1.6,0.17971416,6
2020-03-23-170121,170121,1,0,0,4,6.6,0.00032994055,0
2020-03-24-170121,170121,0,0,0,4,3.0,0.0001601295,1
2020-03-25-170121,170121,1,0,0,5,4.0,0.00030973018,2
2020-03-26-170121,170121,1,0,0,6,3.2,0.00020403328,3
2020-03-27-170121,170121,0,0,0,6,3.0,0.00025904807,4
2020-03-28-170121,170121,1,0,0,7,1.2,2.6857255e-05,5
2020-03-29-170121,170121,0,0,0,7,1.4,6.888795e-05,6
2020-03-30-170121,170121,0,0,0,7,4.4,0.00026521608,0
2020-03-31-170121,170121,0,0,0,7,4.4,0.00021404655,1
2020-04-01-170121,170121,0,0,0,7,3.6,0.00018470129,2
2020-04-02-170121,170121,1,0,2,8,3.8,0.00015448358,3
2020-04-03-170121,170121,0,0,0,8,2.6,0.00014132378,4
2020-04-04-170121,170121,0,0,0,8,0.8,3.1225467e-05,5
2020-04-05-170121,170121,0,0,0,8,0.6,3.470516e-05,6
2020-04-06-170121,170121,0,0,0,8,4.4,0.0002302,0
2020-04-07-170121,170121,0,1,0,8,2.4,0.00010552962,1
2020-04-08-170121,170121,0,0,0,8,1.8,0.00012216318,2
2020-04-09-170121,170121,0,0,0,8,1.4,0.00011036788,3
2020-04-10-170121,170121,0,0,0,8,1.8,4.9591483e-05,4
2020-04-11-170121,170121,0,0,0,8,0.4,2.8729675e-05,5
2020-04-12-170121,170121,0,0,0,8,1.8,2.4948e-05,6
2020-04-13-170121,170121,0,0,0,8,2.4,0.00014326445,0
2020-04-14-170121,170121,0,0,0,8,4.0,0.00016277374,1
2020-04-15-170121,170121,0,0,0,8,0.8,0.5377124,2
2020-04-16-170121,170121,2,0,0,10,2.2,0.6356895,3
2020-04-17-170121,170121,0,0,0,10,1.6,0.0001519844,4
2020-04-18-170121,170121,0,0,0,10,0.6,5.136672e-05,5
2020-04-19-170121,170121,0,0,0,10,1.6,5.3717373e-05,6
2020-04-20-170121,170121,0,0,0,10,2.4,0.000102267826,0
2020-04-21-170121,170121,0,0,0,10,2.8,0.00013228388,1
2020-04-22-170121,170121,0,0,0,10,1.0,0.1751366,2
2020-04-23-170121,170121,0,0,0,10,0.2,0.06827241,3
2020-04-24-170121,170121,0,0,0,10,0.6,5.7746027e-05,4
2020-04-25-170121,170121,0,0,0,10,0.2,0.026352823,5
2020-04-26-170121,170121,0,0,0,10,0.2,0.0075551546,6
2020-04-27-170121,170121,0,0,0,10,0.4,7.200319e-05,0
2020-04-28-170121,170121,0,1,0,10,1.4,7.6926706e-05,1
2020-04-29-170121,170121,0,0,0,10,1.4,0.00012930617,2
2020-04-30-170121,170121,0,0,0,10,0.8,0.1852216,3
2020-05-01-170121,170121,0,0,0,10,0.2,0.009712331,4
2020-05-02-170121,170121,0,0,0,10,1.2,0.2946496,5
2020-05-03-170121,170121,0,1,0,10,0.2,0.05861481,6
2020-05-04-170121,170121,0,1,1,10,0.8,0.34272596,0
2020-05-05-170121,170121,0,0,0,10,0.4,0.14761703,1
2020-05-06-170121,170121,0,0,0,10,0.8,0.00033175317,2
2020-05-07-170121,170121,0,0,0,10,1.4,0.32292813,3
2020-05-08-170121,170121,0,0,0,10,1.4,9.9950536e-05,4
2020-05-09-170121,170121,0,1,0,10,0.4,1.3045689e-05,5
2020-05-10-170121,170121,0,0,0,10,0.4,1.8780538e-05,6
2020-05-11-170121,170121,0,0,0,10,1.8,6.646522e-05,0
2020-05-12-170121,170121,0,0,0,10,0.8,6.322506e-05,1
2020-05-13-170121,170121,0,0,0,10,0.2,3.8334376e-05,2
2020-05-14-170121,170121,0,1,0,10,0.6,5.6279547e-05,3
2020-05-15-170121,170121,0,0,0,10,0.6,3.2475673e-05,4
2020-05-16-170121,170121,0,0,0,10,0.2,2.5135198e-06,5
2020-05-17-170121,170121,0,0,0,10,0.2,7.0571223e-06,6
2020-05-18-170121,170121,1,0,0,11,2.0,9.1382746e-05,0
2020-05-19-170121,170121,0,0,0,11,0.2,4.0242834e-05,1
2020-05-20-170121,170121,0,0,0,11,0.6,8.722114e-05,2
2020-05-21-170121,170121,0,0,0,11,0.8,9.263281e-05,3
2020-05-22-170121,170121,0,0,0,11,1.2,0.19940132,4
2020-05-23-170121,170121,0,0,0,11,0.2,2.2514858e-05,5
2020-05-24-170121,170121,0,0,0,11,0.0,1.0340891e-05,6
2020-05-25-170121,170121,0,0,0,11,0.6,4.3182667e-05,0
2020-05-26-170121,170121,0,0,1,11,0.4,4.6088688e-05,1
2020-05-27-170121,170121,0,0,0,11,0.2,2.7762877e-05,2
2020-05-28-170121,170121,0,0,0,11,1.0,7.068491e-05,3
2020-05-29-170121,170121,0,1,0,11,0.4,0.12033995,4
2020-05-30-170121,170121,0,0,0,11,0.0,1.7899922e-07,5
2020-05-31-170121,170121,0,0,0,11,0.0,1.713475e-06,6
2020-06-01-170121,170121,0,0,0,11,0.0,3.3249722e-05,0
2020-06-02-170121,170121,0,0,1,11,1.4,7.534999e-05,1
2020-06-03-170121,170121,0,0,0,11,0.4,2.877685e-05,2
2020-06-04-170121,170121,0,0,0,11,0.2,2.0852156e-05,3
2020-06-05-170121,170121,0,0,1,11,0.4,0.0885216,4
2020-06-06-170121,170121,0,0,0,11,0.0,2.3060193e-05,5
2020-06-07-170121,170121,0,0,0,11,0.0,1.2383033e-06,6
2020-06-08-170121,170121,0,0,0,11,0.4,3.6945636e-05,0
2020-06-09-170121,170121,1,0,0,12,0.2,1.5679541e-05,1
2020-06-10-170121,170121,0,0,0,12,0.2,1.1113652e-05,2
2020-06-11-170121,170121,0,0,0,12,0.0,2.3477544e-06,3
2020-06-12-170121,170121,0,0,0,12,0.4,0.1333297,4
2020-06-13-170121,170121,0,0,0,12,0.0,2.3268083e-06,5
2020-06-14-170121,170121,0,0,0,12,0.0,2.0360972e-06,6
2020-06-15-170121,170121,0,4,0,12,0.2,5.1706916e-06,0
2020-06-16-170121,170121,1,0,0,13,0.2,2.2609478e-05,1
2020-06-17-170121,170121,0,0,0,13,0.4,2.7803331e-05,2
2020-06-18-170121,170121,0,0,0,13,0.6,2.2632816e-05,3
2020-06-19-170121,170121,1,0,0,14,0.8,0.23980814,4
2020-06-20-170121,170121,0,0,0,14,0.0,2.0683938e-06,5
2020-06-21-170121,170121,0,0,0,14,0.0,4.2186696e-07,6
2020-06-22-170121,170121,0,0,1,14,0.2,1.361752e-05,0
2020-06-23-170121,170121,0,0,0,14,0.8,3.419454e-05,1
2020-06-24-170121,170121,0,0,0,14,0.2,3.914842e-05,2
2020-06-25-170121,170121,0,3,0,14,0.2,1.8578457e-05,3
2020-06-26-170121,170121,0,0,0,14,0.0,0.03716297,4
2020-06-27-170121,170121,0,0,0,14,0.0,6.737115e-07,5
2020-06-28-170121,170121,0,0,0,14,0.2,5.098428e-06,6
2020-06-29-170121,170121,0,0,0,14,0.6,5.7243262e-05,0
2020-06-30-170121,170121,0,0,0,14,0.0,3.3504678e-06,1
2020-07-01-170121,170121,0,0,0,14,0.2,2.7463634e-06,2
2020-07-02-170121,170121,0,0,0,14,0.2,2.8333588e-05,3
2020-07-03-170121,170121,0,0,0,14,0.0,0.01187694,4
2020-07-04-170121,170121,0,0,0,14,0.0,6.750155e-07,5
2020-07-05-170121,170121,0,0,0,14,0.0,2.750199e-07,6
2020-07-06-170121,170121,1,0,0,15,0.2,2.0079591e-05,0
2020-07-07-170121,170121,0,0,0,15,0.0,1.8923824e-05,1
2020-07-08-170121,170121,0,1,0,15,0.4,2.6945832e-05,2
2020-07-09-170121,170121,0,0,0,15,0.2,1.0287742e-05,3
2020-07-10-170121,170121,0,0,0,15,0.4,0.19513816,4
2020-07-11-170121,170121,0,0,0,15,0.2,1.2162677e-05,5
2020-07-12-170121,170121,0,0,0,15,0.2,2.7192025e-05,6
2020-07-13-170121,170121,0,0,0,15,0.4,2.3912366e-05,0
2020-07-14-170121,170121,0,0,0,15,0.4,3.7867314e-05,1
2020-07-15-170121,170121,0,0,0,15,0.0,1.9830162e-05,2
2020-07-16-170121,170121,0,0,0,15,0.4,2.0075468e-05,3
2020-07-17-170121,170121,0,0,0,15,0.4,0.1923521,4
2020-07-18-170121,170121,0,0,0,15,0.0,1.1959876e-05,5
2020-07-19-170121,170121,0,0,0,15,0.0,5.0373177e-07,6
2020-07-20-170121,170121,0,0,0,15,0.0,3.7963564e-06,0
2020-07-21-170121,170121,0,0,0,15,0.0,9.4497445e-06,1
2020-07-22-170121,170121,0,0,0,15,0.4,3.2798558e-05,2
2020-07-23-170121,170121,0,0,0,15,0.4,6.323177e-05,3
2020-07-24-170121,170121,0,0,0,15,0.0,0.0047902614,4
2020-07-25-170121,170121,0,0,0,15,0.0,2.7489483e-07,5
2020-07-26-170121,170121,0,0,0,15,0.0,6.054936e-07,6
2020-07-27-170121,170121,0,0,0,15,0.2,3.31334e-05,0
2020-07-28-170121,170121,0,0,0,15,0.6,0.0001424536,1
2020-07-29-170121,170121,0,0,0,15,0.4,5.379353e-05,2
2020-07-30-170121,170121,0,0,0,15,0.2,1.2388298e-05,3
2020-07-31-170121,170121,0,0,0,15,0.6,0.31621185,4
2020-08-01-170121,170121,0,0,0,15,0.0,5.1072307e-06,5
2020-08-02-170121,170121,0,0,0,15,0.0,5.0909417e-05,6
2020-08-03-170121,170121,0,0,0,15,0.0,7.658481e-06,0
2020-08-04-170121,170121,0,0,0,15,0.6,6.0062914e-05,1
2020-08-05-170121,170121,0,1,0,15,0.6,8.313539e-05,2
2020-08-06-170121,170121,0,0,0,15,0.6,0.0002958309,3
2020-08-07-170121,170121,0,0,0,15,1.0,0.44377774,4
2020-08-08-170121,170121,0,0,0,15,0.0,6.406877e-05,5
2020-08-09-170121,170121,0,0,0,15,0.2,3.0338915e-05,6
2020-08-10-170121,170121,0,0,0,15,1.0,0.00013382711,0
2020-08-11-170121,170121,0,0,2,15,1.6,0.00026479602,1
2020-08-12-170121,170121,0,0,0,15,0.8,0.00023339082,2
2020-08-13-170121,170121,0,0,2,15,0.8,0.00024123253,3
2020-08-14-170121,170121,0,0,0,15,2.0,0.56756914,4
2020-08-15-170121,170121,0,0,0,15,0.4,8.309058e-05,5
2020-08-16-170121,170121,0,0,0,15,0.6,4.71053e-05,6
2020-08-17-170121,170121,0,0,0,15,0.2,0.00013693626,0
2020-08-18-170121,170121,0,0,0,15,0.4,7.350239e-05,1
2020-08-19-170121,170121,0,0,0,15,1.0,0.00017263312,2
2020-08-20-170121,170121,0,0,0,15,1.0,0.00018196154,3
2020-08-21-170121,170121,0,0,0,15,1.0,0.52921826,4
2020-08-22-170121,170121,0,0,0,15,0.6,7.8183926e-05,5
2020-08-23-170121,170121,0,0,0,15,0.6,5.7940524e-05,6
2020-08-24-170121,170121,0,0,0,15,1.8,0.00017428327,0
2020-08-25-170121,170121,2,0,0,17,3.2,0.0002210939,1
2020-08-26-170121,170121,0,0,0,17,3.0,0.00016414929,2
2020-08-27-170121,170121,2,0,0,19,3.4,0.0002411661,3
2020-08-28-170121,170121,0,0,0,19,1.8,0.30257127,4
2020-08-29-170121,170121,0,0,0,19,1.0,9.5963755e-05,5
2020-08-30-170121,170121,0,0,0,19,2.2,0.000121063254,6
2020-08-31-170121,170121,0,0,0,19,2.4,0.00021822785,0
2020-09-01-170121,170121,0,0,0,19,2.4,0.00018042393,1
2020-09-02-170121,170121,0,0,1,19,1.4,7.872488e-05,2
2020-09-03-170121,170121,0,0,0,19,2.4,0.00020747342,3
2020-09-04-170121,170121,0,0,0,19,3.2,0.4833651,4
2020-09-05-170121,170121,0,0,0,19,1.8,0.0001042897,5
2020-09-06-170121,170121,0,0,0,19,2.6,0.00022848207,6
2020-09-07-170121,170121,0,0,0,19,2.2,0.00016954617,0
2020-09-08-170121,170121,0,0,0,19,1.6,8.400153e-05,1
2020-09-09-170121,170121,0,0,0,19,1.2,0.00013034567,2
2020-09-10-170121,170121,0,0,0,19,2.4,0.00011662313,3
2020-09-11-170121,170121,0,0,0,19,5.2,0.69655687,4
2020-09-12-170121,170121,0,0,0,19,1.2,0.0001316424,5
2020-09-13-170121,170121,0,0,0,19,2.6,0.00012449715,6
2020-09-14-170121,170121,0,0,1,19,2.8,0.00021298994,0
2020-09-15-170121,170121,0,0,1,19,2.4,0.00012155692,1
2020-09-16-170121,170121,1,0,1,20,1.8,0.00021085823,2
2020-09-17-170121,170121,0,0,0,20,1.8,0.00016554161,3
2020-09-18-170121,170121,0,0,3,20,15.2,0.00026460894,4
2020-09-19-170121,170121,0,1,0,20,6.0,0.0002521641,5
2020-09-20-170121,170121,0,0,0,20,4.0,0.00014602032,6
2020-09-21-170121,170121,0,0,0,20,2.8,0.00016262045,0
2020-09-22-170121,170121,0,0,0,20,2.6,0.00016004828,1
2020-09-23-170121,170121,0,0,0,20,3.6,0.00018622748,2
2020-09-24-170121,170121,0,0,0,20,3.8,0.00023844551,3
2020-09-25-170121,170121,0,0,0,20,2.6,0.77094465,4
2020-09-26-170121,170121,0,0,0,20,1.2,8.23085e-05,5
2020-09-27-170121,170121,0,0,0,20,1.4,6.2205436e-05,6
2020-09-28-170121,170121,1,0,0,21,2.6,0.00018163411,0
2020-09-29-170121,170121,1,0,0,22,1.0,9.39415e-05,1
2020-09-30-170121,170121,1,0,0,23,3.8,0.00019409807,2
2020-10-01-170121,170121,0,0,0,23,1.8,0.00013602122,3
2020-10-02-170121,170121,3,0,0,26,1.8,0.6517249,4
2020-10-03-170121,170121,0,0,0,26,0.8,4.45089e-05,5
2020-10-04-170121,170121,0,0,0,26,1.8,5.7446887e-05,6
2020-10-05-170121,170121,0,0,0,26,2.0,0.00020186462,0
2020-10-06-170121,170121,0,0,0,26,1.2,9.72966e-05,1
2020-10-07-170121,170121,0,0,3,26,2.6,0.00019025324,2
2020-10-08-170121,170121,0,0,0,26,2.8,0.00020976474,3
2020-10-09-170121,170121,0,0,1,26,2.4,0.96988595,4
2020-10-10-170121,170121,0,0,0,26,2.6,0.00016373905,5
2020-10-11-170121,170121,0,0,1,26,1.2,0.00017075131,6
2020-10-12-170121,170121,0,0,0,26,2.2,9.882135e-05,0
2020-10-13-170121,170121,0,0,0,26,2.4,0.0002334726,1
2020-10-14-170121,170121,0,0,1,26,2.6,0.00016522454,2
2020-10-15-170121,170121,0,0,1,26,2.2,0.00015427668,3
2020-10-16-170121,170121,0,0,0,26,3.2,0.4274966,4
2020-10-17-170121,170121,0,0,0,26,1.0,6.7627145e-05,5
2020-10-18-170121,170121,0,0,1,26,1.8,9.9205456e-05,6
2020-10-19-170121,170121,0,0,1,26,5.8,0.0002708581,0
2020-10-20-170121,170121,0,0,0,26,1.6,0.00013300202,1
2020-10-21-170121,170121,3,0,0,29,2.4,0.0002435311,2
2020-10-22-170121,170121,0,0,0,29,4.4,0.00027451487,3
2020-10-23-170121,170121,1,0,1,30,5.0,0.7624557,4
2020-10-24-170121,170121,0,0,0,30,1.8,9.8794706e-05,5
2020-10-25-170121,170121,1,0,1,31,1.6,9.080963e-05,6
2020-10-26-170121,170121,0,0,0,31,5.0,0.00018869224,0
2020-10-27-170121,170121,0,0,0,31,4.0,0.0002561171,1
2020-10-28-170121,170121,1,0,0,32,2.6,0.0001828733,2
2020-10-29-170121,170121,1,1,0,33,7.2,0.00028499626,3
2020-10-30-170121,170121,0,0,0,33,3.8,1.0674592,4
2020-10-31-170121,170121,0,0,0,33,2.6,7.93017e-05,5
2020-11-01-170121,170121,1,0,0,34,1.6,9.92179e-05,6
2020-11-02-170121,170121,1,0,0,35,1.6,6.66174e-05,0
2020-11-03-170121,170121,0,0,0,35,4.2,0.00028242564,1
2020-11-04-170121,170121,0,0,0,35,6.6,0.0002334206,2
2020-11-05-170121,170121,0,0,0,35,4.8,0.00020604675,3
2020-11-06-170121,170121,1,0,0,36,6.2,0.9075,4
2020-11-07-170121,170121,0,0,0,36,1.8,6.684161e-05,5
2020-11-08-170121,170121,1,0,0,37,1.8,0.00012039431,6
2020-11-09-170121,170121,0,0,0,37,4.4,0.00020345245,0
2020-11-10-170121,170121,0,0,0,37,2.8,0.00013331548,1
2020-11-11-170121,170121,0,0,0,37,1.6,0.00015806161,2
2020-11-12-170121,170121,0,0,0,37,3.4,0.0001889501,3
2020-11-13-170121,170121,0,0,0,37,4.2,0.48639846,4
2020-03-01-170122,170122,0,0,2,0,0.0,0.019965138,6
2020-03-02-170122,170122,0,0,12,0,0.0,0.0013347538,0
2020-03-03-170122,170122,0,0,8,0,0.0,0.021303,1
2020-03-04-170122,170122,0,0,30,0,0.2,0.0014569253,2
2020-03-05-170122,170122,0,0,23,0,0.0,0.029537076,3
2020-03-06-170122,170122,0,0,29,0,0.2,0.0046896394,4
2020-03-07-170122,170122,0,0,13,0,0.0,0.006174946,5
2020-03-08-170122,170122,0,0,17,0,0.0,0.0003009473,6
2020-03-09-170122,170122,1,0,45,1,0.2,0.00487072,0
2020-03-10-170122,170122,0,0,35,1,0.6,0.03691248,1
2020-03-11-170122,170122,1,0,23,2,1.2,0.26909357,2
2020-03-12-170122,170122,0,0,22,2,0.8,0.080831565,3
2020-03-13-170122,170122,3,0,33,5,2.0,0.50638217,4
2020-03-14-170122,170122,3,0,10,8,1.2,0.03027716,5
2020-03-15-170122,170122,2,0,9,10,1.2,0.04669274,6
2020-03-16-170122,170122,12,0,25,22,7.6,0.5909955,0
2020-03-17-170122,170122,8,0,14,30,7.4,0.24556486,1
2020-03-18-170122,170122,30,0,24,60,18.6,1.3415744,2
2020-03-19-170122,170122,23,0,14,83,24.4,1.027834,3
2020-03-20-170122,170122,29,0,11,112,24.8,0.69148946,4
2020-03-21-170122,170122,13,0,4,125,8.8,0.15820248,5
2020-03-22-170122,170122,17,0,6,142,11.0,0.15429406,6
2020-03-23-170122,170122,45,0,20,187,30.2,2.0311017,0
2020-03-24-170122,170122,35,0,17,222,26.4,0.8001174,1
2020-03-25-170122,170122,23,0,16,245,23.8,1.1833556,2
2020-03-26-170122,170122,22,0,11,267,21.2,1.0199419,3
2020-03-27-170122,170122,33,0,11,300,21.6,0.7837594,4
2020-03-28-170122,170122,10,0,7,310,7.6,0.32093725,5
2020-03-29-170122,170122,9,0,2,319,6.8,0.22924705,6
2020-03-30-170122,170122,25,0,10,344,16.0,1.0615833,0
2020-03-31-170122,170122,14,0,15,358,18.6,1.2594644,1
2020-04-01-170122,170122,24,0,11,382,11.6,0.781507,2
2020-04-02-170122,170122,14,0,11,396,13.8,1.3368837,3
2020-04-03-170122,170122,11,0,5,407,15.4,0.5526956,4
2020-04-04-170122,170122,4,0,0,411,4.4,0.1265152,5
2020-04-05-170122,170122,6,0,1,417,3.6,0.14730051,6
2020-04-06-170122,170122,20,0,9,437,13.4,1.1220028,0
2020-04-07-170122,170122,17,0,6,454,9.8,0.7694088,1
2020-04-08-170122,170122,16,1,8,470,7.8,0.32813475,2
2020-04-09-170122,170122,11,0,4,481,9.0,0.41657868,3
2020-04-10-170122,170122,11,0,6,492,6.0,0.54591215,4
2020-04-11-170122,170122,7,0,1,499,2.8,0.055344906,5
2020-04-12-170122,170122,2,0,4,501,3.2,0.5577027,6
2020-04-13-170122,170122,10,0,7,511,7.6,0.53782827,0
2020-04-14-170122,170122,15,0,3,526,11.0,2.0798278,1
2020-04-15-170122,170122,11,0,5,537,7.6,0.64781845,2
2020-04-16-170122,170122,11,0,2,548,6.0,0.83473116,3
2020-04-17-170122,170122,5,0,1,553,7.8,0.38388056,4
2020-04-18-170122,170122,0,1,3,553,0.6,0.16305296,5
2020-04-19-170122,170122,1,0,0,554,1.8,0.29859686,6
2020-04-20-170122,170122,9,0,6,563,13.2,0.9731988,0
2020-04-21-170122,170122,6,0,7,569,5.2,0.9140004,1
2020-04-22-170122,170122,8,0,11,577,5.4,0.35157537,2
2020-04-23-170122,170122,4,0,7,581,1.4,0.12197968,3
2020-04-24-170122,170122,6,0,10,587,4.6,0.16836575,4
2020-04-25-170122,170122,1,0,1,588,0.8,0.034904223,5
2020-04-26-170122,170122,4,0,1,592,0.6,0.011744836,6
2020-04-27-170122,170122,7,0,14,599,5.0,0.26654297,0
2020-04-28-170122,170122,3,0,9,602,2.4,0.22602963,1
2020-04-29-170122,170122,5,0,3,607,4.0,0.6043043,2
2020-04-30-170122,170122,2,0,2,609,3.2,0.31617418,3
2020-05-01-170122,170122,1,0,8,610,0.4,0.0097613,4
2020-05-02-170122,170122,3,0,2,613,1.8,0.52350545,5
2020-05-03-170122,170122,0,1,0,613,0.8,0.093341626,6
2020-05-04-170122,170122,6,0,26,619,6.8,0.5604943,0
2020-05-05-170122,170122,7,0,2,626,4.2,0.22772725,1
2020-05-06-170122,170122,11,0,3,637,4.8,0.306205,2
2020-05-07-170122,170122,7,0,4,644,2.0,0.48365498,3
2020-05-08-170122,170122,10,0,4,654,4.8,0.60393405,4
2020-05-09-170122,170122,1,0,0,655,0.8,0.113138825,5
2020-05-10-170122,170122,1,0,0,656,1.2,0.15677401,6
2020-05-11-170122,170122,14,0,5,670,7.0,1.0089371,0
2020-05-12-170122,170122,9,0,2,679,3.4,0.45199367,1
2020-05-13-170122,170122,3,0,1,682,2.8,0.134006,2
2020-05-14-170122,170122,2,0,2,684,3.6,0.33548972,3
2020-05-15-170122,170122,8,0,4,692,3.6,0.19759898,4
2020-05-16-170122,170122,2,0,0,694,1.4,0.04039102,5
2020-05-17-170122,170122,0,0,0,694,0.8,0.08573616,6
2020-05-18-170122,170122,26,0,4,720,15.6,0.87419224,0
2020-05-19-170122,170122,2,0,2,722,2.0,0.24017465,1
2020-05-20-170122,170122,3,0,3,725,2.0,0.18379499,2
2020-05-21-170122,170122,4,0,0,729,3.8,0.31677952,3
2020-05-22-170122,170122,4,0,3,733,2.2,0.30383232,4
2020-05-23-170122,170122,0,0,0,733,0.6,0.13963608,5
2020-05-24-170122,170122,0,0,0,733,1.0,0.02087753,6
2020-05-25-170122,170122,5,0,2,738,2.6,0.171247,0
2020-05-26-170122,170122,2,0,1,740,2.4,0.4501016,1
2020-05-27-170122,170122,1,0,1,741,2.0,0.17945366,2
2020-05-28-170122,170122,2,0,0,743,4.0,0.625956,3
2020-05-29-170122,170122,4,0,3,747,1.6,0.24480708,4
2020-05-30-170122,170122,0,0,1,747,0.0,0.0141683025,5
2020-05-31-170122,170122,0,0,0,747,0.0,0.03858836,6
2020-06-01-170122,170122,4,0,3,751,1.6,0.039925583,0
2020-06-02-170122,170122,2,0,3,753,4.2,0.9740175,1
2020-06-03-170122,170122,3,0,2,756,1.6,0.2462554,2
2020-06-04-170122,170122,0,0,0,756,3.2,0.26381353,3
2020-06-05-170122,170122,3,0,2,759,1.4,0.121774554,4
2020-06-06-170122,170122,0,0,0,759,0.0,0.020357195,5
2020-06-07-170122,170122,0,0,0,759,0.4,0.0006999954,6
2020-06-08-170122,170122,2,0,1,761,1.4,0.2659961,0
2020-06-09-170122,170122,1,0,1,762,1.4,0.25538102,1
2020-06-10-170122,170122,1,0,1,763,1.0,0.058219038,2
2020-06-11-170122,170122,0,0,0,763,0.8,0.048411895,3
2020-06-12-170122,170122,3,0,1,766,1.2,0.4264414,4
2020-06-13-170122,170122,1,0,0,767,0.2,0.022324516,5
2020-06-14-170122,170122,0,0,1,767,0.0,0.016524378,6
2020-06-15-170122,170122,3,0,0,770,0.8,0.23088828,0
2020-06-16-170122,170122,3,0,4,773,1.8,0.23659989,1
2020-06-17-170122,170122,2,0,2,775,1.4,0.24727178,2
2020-06-18-170122,170122,0,0,0,775,1.0,0.064248756,3
2020-06-19-170122,170122,2,0,1,777,0.2,0.23603995,4
2020-06-20-170122,170122,0,0,0,777,0.2,0.059787113,5
2020-06-21-170122,170122,0,0,0,777,0.0,0.02913385,6
2020-06-22-170122,170122,1,0,0,778,2.4,0.20714979,0
2020-06-23-170122,170122,1,0,0,779,1.2,0.2694155,1
2020-06-24-170122,170122,1,0,1,780,0.8,0.15133417,2
2020-06-25-170122,170122,0,2,0,780,1.4,0.08676702,3
2020-06-26-170122,170122,1,0,1,781,1.0,0.11225124,4
2020-06-27-170122,170122,0,0,0,781,0.0,0.030277291,5
2020-06-28-170122,170122,1,0,0,782,0.4,0.20585054,6
2020-06-29-170122,170122,0,0,0,782,1.2,0.15069607,0
2020-06-30-170122,170122,4,0,0,786,0.8,0.052390505,1
2020-07-01-170122,170122,2,0,0,788,1.0,0.073852755,2
2020-07-02-170122,170122,0,0,0,788,0.6,0.27423397,3
2020-07-03-170122,170122,1,0,0,789,0.4,0.04578996,4
2020-07-04-170122,170122,0,0,0,789,0.2,0.025232213,5
2020-07-05-170122,170122,0,0,0,789,0.2,0.008239962,6
2020-07-06-170122,170122,0,0,0,789,0.8,0.0918626,0
2020-07-07-170122,170122,0,0,0,789,0.6,0.15668502,1
2020-07-08-170122,170122,1,0,1,790,0.4,0.047055837,2
2020-07-09-170122,170122,0,0,0,790,1.0,0.06699414,3
2020-07-10-170122,170122,1,0,1,791,1.8,0.5241008,4
2020-07-11-170122,170122,0,0,0,791,0.4,0.09958447,5
2020-07-12-170122,170122,0,0,0,791,0.2,0.037494197,6
2020-07-13-170122,170122,0,0,0,791,0.6,0.31775868,0
2020-07-14-170122,170122,0,0,0,791,0.0,0.16730304,1
2020-07-15-170122,170122,0,0,0,791,0.4,0.1516286,2
2020-07-16-170122,170122,0,0,0,791,0.2,0.056017693,3
2020-07-17-170122,170122,0,1,0,791,0.6,0.4276677,4
2020-07-18-170122,170122,0,0,0,791,0.2,0.06655628,5
2020-07-19-170122,170122,0,0,0,791,0.0,0.03012167,6
2020-07-20-170122,170122,0,0,0,791,0.2,0.10248846,0
2020-07-21-170122,170122,0,0,0,791,0.2,0.021879356,1
2020-07-22-170122,170122,1,0,0,792,0.6,0.07799851,2
2020-07-23-170122,170122,0,0,0,792,0.8,0.17269225,3
2020-07-24-170122,170122,1,0,1,793,0.2,0.032764588,4
2020-07-25-170122,170122,0,0,0,793,0.0,0.005225194,5
2020-07-26-170122,170122,0,0,0,793,0.0,0.006985969,6
2020-07-27-170122,170122,0,0,1,793,0.6,0.12973122,0
2020-07-28-170122,170122,0,0,0,793,0.2,0.15949818,1
2020-07-29-170122,170122,0,0,5,793,0.2,0.114659905,2
2020-07-30-170122,170122,0,0,3,793,0.4,0.0664703,3
2020-07-31-170122,170122,0,0,0,793,0.8,0.5802615,4
2020-08-01-170122,170122,0,0,1,793,0.0,0.021320613,5
2020-08-02-170122,170122,0,0,0,793,0.2,0.06300321,6
2020-08-03-170122,170122,0,0,1,793,0.0,0.14747623,0
2020-08-04-170122,170122,0,0,1,793,0.2,0.13643761,1
2020-08-05-170122,170122,0,0,4,793,0.2,0.49722528,2
2020-08-06-170122,170122,0,0,5,793,0.8,0.6929166,3
2020-08-07-170122,170122,1,0,0,794,0.2,0.5853188,4
2020-08-08-170122,170122,0,0,0,794,1.2,0.24577354,5
2020-08-09-170122,170122,0,0,1,794,1.2,0.20775047,6
2020-08-10-170122,170122,1,1,3,795,1.8,0.61668354,0
2020-08-11-170122,170122,0,0,3,795,2.0,0.73178697,1
2020-08-12-170122,170122,5,0,1,800,2.0,1.2466829,2
2020-08-13-170122,170122,3,0,8,803,1.4,0.4813182,3
2020-08-14-170122,170122,0,0,3,803,1.8,0.87871134,4
2020-08-15-170122,170122,1,0,0,804,0.4,0.37050998,5
2020-08-16-170122,170122,0,0,1,804,0.4,0.22080785,6
2020-08-17-170122,170122,1,0,0,805,0.8,0.45271483,0
2020-08-18-170122,170122,1,0,0,806,0.2,0.31089452,1
2020-08-19-170122,170122,4,0,4,810,1.8,0.89001083,2
2020-08-20-170122,170122,5,0,7,815,2.8,0.5256784,3
2020-08-21-170122,170122,0,0,3,815,0.4,0.8687751,4
2020-08-22-170122,170122,0,0,2,815,0.4,0.35627773,5
2020-08-23-170122,170122,1,0,1,816,0.4,0.32742888,6
2020-08-24-170122,170122,3,0,10,819,1.4,0.65332466,0
2020-08-25-170122,170122,3,0,6,822,1.4,0.51753247,1
2020-08-26-170122,170122,1,0,2,823,2.0,0.52579325,2
2020-08-27-170122,170122,8,0,5,831,2.2,0.24360186,3
2020-08-28-170122,170122,3,0,2,834,2.0,0.3909063,4
2020-08-29-170122,170122,0,0,0,834,0.4,0.43060035,5
2020-08-30-170122,170122,1,0,5,835,1.8,0.5596594,6
2020-08-31-170122,170122,0,0,3,835,3.0,0.28581613,0
2020-09-01-170122,170122,0,0,1,835,1.2,0.26376125,1
2020-09-02-170122,170122,4,0,5,839,2.4,0.20717588,2
2020-09-03-170122,170122,7,0,3,846,2.0,0.6436569,3
2020-09-04-170122,170122,3,0,8,849,3.4,0.9810739,4
2020-09-05-170122,170122,2,0,2,851,2.0,0.19147472,5
2020-09-06-170122,170122,1,0,9,852,1.8,0.60650456,6
2020-09-07-170122,170122,10,0,4,862,4.4,0.4059671,0
2020-09-08-170122,170122,6,0,1,868,4.0,0.9008443,1
2020-09-09-170122,170122,2,0,2,870,2.0,0.7840969,2
2020-09-10-170122,170122,5,0,7,875,1.2,0.55930877,3
2020-09-11-170122,170122,2,0,4,877,4.6,1.279777,4
2020-09-12-170122,170122,0,0,4,877,1.2,0.089843415,5
2020-09-13-170122,170122,5,0,3,882,3.8,0.27985358,6
2020-09-14-170122,170122,3,0,9,885,5.4,1.3038144,0
2020-09-15-170122,170122,1,0,2,886,2.2,0.44316515,1
2020-09-16-170122,170122,5,0,3,891,4.4,0.646852,2
2020-09-17-170122,170122,3,0,3,894,3.0,0.55180883,3
2020-09-18-170122,170122,8,0,8,902,7.2,1.5061095,4
2020-09-19-170122,170122,2,0,7,904,1.8,0.17054892,5
2020-09-20-170122,170122,9,1,1,913,4.2,0.16366495,6
2020-09-21-170122,170122,4,0,4,917,5.4,0.38722238,0
2020-09-22-170122,170122,1,0,3,918,3.4,0.77506185,1
2020-09-23-170122,170122,2,0,8,920,4.0,1.1489464,2
2020-09-24-170122,170122,7,1,1,927,7.4,1.0587337,3
2020-09-25-170122,170122,4,0,8,931,5.4,1.4231253,4
2020-09-26-170122,170122,4,0,3,935,2.0,0.48118663,5
2020-09-27-170122,170122,3,0,3,938,1.4,0.07234533,6
2020-09-28-170122,170122,9,0,0,947,5.4,0.9140894,0
2020-09-29-170122,170122,2,0,4,949,1.8,0.44606593,1
2020-09-30-170122,170122,3,0,6,952,4.4,0.710681,2
2020-10-01-170122,170122,3,0,0,955,4.8,0.6393613,3
2020-10-02-170122,170122,8,0,3,963,6.0,0.9609737,4
2020-10-03-170122,170122,7,0,0,970,4.2,0.5741457,5
2020-10-04-170122,170122,1,0,10,971,3.8,0.35668847,6
2020-10-05-170122,170122,4,0,11,975,3.0,0.55905354,0
2020-10-06-170122,170122,3,0,6,978,2.8,0.5143671,1
2020-10-07-170122,170122,8,0,5,986,4.4,0.37182298,2
2020-10-08-170122,170122,1,1,11,987,2.2,0.4486324,3
2020-10-09-170122,170122,8,1,25,995,5.8,1.8885648,4
2020-10-10-170122,170122,3,0,5,998,3.6,0.6693491,5
2020-10-11-170122,170122,3,0,10,1001,1.6,0.26275206,6
2020-10-12-170122,170122,0,0,20,1001,1.4,0.63954943,0
2020-10-13-170122,170122,4,0,4,1005,4.0,0.5771866,1
2020-10-14-170122,170122,6,0,5,1011,5.6,1.1369035,2
2020-10-15-170122,170122,0,0,17,1011,0.0,0.15852259,3
2020-10-16-170122,170122,3,0,22,1014,3.4,0.7618206,4
2020-10-17-170122,170122,0,0,5,1014,0.6,0.41884157,5
2020-10-18-170122,170122,10,0,10,1024,4.2,0.29341325,6
2020-10-19-170122,170122,11,0,5,1035,7.4,1.4343214,0
2020-10-20-170122,170122,6,0,4,1041,3.4,0.6969802,1
2020-10-21-170122,170122,5,0,14,1046,6.8,0.4539656,2
2020-10-22-170122,170122,11,0,11,1057,8.4,1.6036074,3
2020-10-23-170122,170122,25,0,14,1082,9.8,1.2758974,4
2020-10-24-170122,170122,5,0,5,1087,4.4,0.7676028,5
2020-10-25-170122,170122,10,0,9,1097,11.2,0.80627155,6
2020-10-26-170122,170122,20,0,9,1117,6.8,0.78383857,0
2020-10-27-170122,170122,4,0,9,1121,6.6,1.1859901,1
2020-10-28-170122,170122,5,0,12,1126,6.8,1.677121,2
2020-10-29-170122,170122,17,0,9,1143,11.6,3.4492226,3
2020-10-30-170122,170122,22,0,6,1165,9.0,2.0529222,4
2020-10-31-170122,170122,5,0,0,1170,5.4,1.1131523,5
2020-11-01-170122,170122,10,1,0,1180,4.6,0.5770357,6
2020-11-02-170122,170122,5,0,0,1185,2.8,0.3271565,0
2020-11-03-170122,170122,4,0,0,1189,6.0,2.4830356,1
2020-11-04-170122,170122,14,0,0,1203,7.8,1.9907949,2
2020-11-05-170122,170122,11,0,0,1214,7.8,2.5017676,3
2020-11-06-170122,170122,14,2,0,1228,9.0,1.776327,4
2020-11-07-170122,170122,5,3,0,1233,7.2,0.71440506,5
2020-11-08-170122,170122,9,1,0,1242,4.4,0.61815834,6
2020-11-09-170122,170122,9,0,0,1251,5.6,0.27582657,0
2020-11-10-170122,170122,9,0,0,1260,3.2,0.33792853,1
2020-11-11-170122,170122,12,0,0,1272,3.8,0.7259626,2
2020-11-12-170122,170122,9,0,0,1281,7.0,0.6664152,3
2020-11-13-170122,170122,6,1,0,1287,3.4,0.9508728,4
2020-03-01-170201,170201,0,0,0,0,0.0,0.000532571,6
2020-03-02-170201,170201,0,0,4,0,0.5,0.00077486597,0
2020-03-03-170201,170201,0,0,8,0,0.0,0.0019209652,1
2020-03-04-170201,170201,1,0,27,1,0.0,0.0061753513,2
2020-03-05-170201,170201,0,1,25,1,0.0,0.0021521493,3
2020-03-06-170201,170201,0,0,15,1,0.0,0.00785128,4
2020-03-07-170201,170201,0,2,15,1,0.0,0.0038951903,5
2020-03-08-170201,170201,0,0,10,1,0.0,0.00045489942,6
2020-03-09-170201,170201,0,0,29,1,0.0,0.32158494,0
2020-03-10-170201,170201,1,1,27,2,0.5,0.09810938,1
2020-03-11-170201,170201,0,0,23,2,0.5,1.413293,2
2020-03-12-170201,170201,0,0,9,2,2.5,1.440728,3
2020-03-13-170201,170201,5,0,16,7,1.5,0.19073787,4
2020-03-14-170201,170201,6,0,7,13,6.0,4.45028,5
2020-03-15-170201,170201,0,0,6,13,2.0,0.25939602,6
2020-03-16-170201,170201,4,0,17,17,6.5,5.156124,0
2020-03-17-170201,170201,8,0,16,25,9.0,7.871924,1
2020-03-18-170201,170201,27,0,13,52,13.0,5.5803795,2
2020-03-19-170201,170201,25,2,7,77,11.5,10.1886425,3
2020-03-20-170201,170201,15,1,7,92,12.0,4.209853,4
2020-03-21-170201,170201,15,0,2,107,5.5,0.90527475,5
2020-03-22-170201,170201,10,0,1,117,3.0,0.9401171,6
2020-03-23-170201,170201,29,0,12,146,24.5,21.142645,0
2020-03-24-170201,170201,27,2,8,173,13.5,9.887686,1
2020-03-25-170201,170201,23,0,11,196,19.5,13.701968,2
2020-03-26-170201,170201,9,0,3,205,15.5,9.19465,3
2020-03-27-170201,170201,16,0,4,221,13.5,9.962665,4
2020-03-28-170201,170201,7,0,1,228,4.0,2.745487,5
2020-03-29-170201,170201,6,0,1,234,3.0,1.7406273,6
2020-03-30-170201,170201,17,0,10,251,22.0,8.122037,0
2020-03-31-170201,170201,16,0,42,267,13.0,8.200416,1
2020-04-01-170201,170201,13,0,5,280,13.0,8.784215,2
2020-04-02-170201,170201,7,0,4,287,3.0,1.7569094,3
2020-04-03-170201,170201,7,0,5,294,9.0,3.3135197,4
2020-04-04-170201,170201,2,0,1,296,2.0,1.2702382,5
2020-04-05-170201,170201,1,0,2,297,0.5,0.061244488,6
2020-04-06-170201,170201,12,0,5,309,9.0,2.4533422,0
2020-04-07-170201,170201,8,0,5,317,7.5,4.424804,1
2020-04-08-170201,170201,11,0,3,328,5.0,3.8437462,2
2020-04-09-170201,170201,3,0,0,331,3.5,1.3819782,3
2020-04-10-170201,170201,4,0,6,335,2.0,0.59411937,4
2020-04-11-170201,170201,1,0,0,336,1.5,0.67095417,5
2020-04-12-170201,170201,1,0,0,337,2.0,0.7032464,6
2020-04-13-170201,170201,10,0,7,347,7.0,4.277627,0
2020-04-14-170201,170201,42,0,3,389,47.5,5.325631,1
2020-04-15-170201,170201,5,0,6,394,2.0,1.2863069,2
2020-04-16-170201,170201,4,0,3,398,2.5,2.6907165,3
2020-04-17-170201,170201,5,0,1,403,13.5,17.593742,4
2020-04-18-170201,170201,1,0,0,404,0.5,0.13962075,5
2020-04-19-170201,170201,2,0,1,406,2.0,1.1282051,6
2020-04-20-170201,170201,5,0,7,411,5.5,5.448598,0
2020-04-21-170201,170201,5,0,3,416,1.5,1.1506202,1
2020-04-22-170201,170201,3,0,2,419,1.0,0.23964702,2
2020-04-23-170201,170201,0,0,2,419,1.0,0.08349479,3
2020-04-24-170201,170201,6,0,6,425,3.0,1.95246,4
2020-04-25-170201,170201,0,0,3,425,0.5,0.0033726445,5
2020-04-26-170201,170201,0,0,0,425,1.0,1.20503,6
2020-04-27-170201,170201,7,1,3,432,4.5,2.8039248,0
2020-04-28-170201,170201,3,0,3,435,4.0,1.0533639,1
2020-04-29-170201,170201,6,0,7,441,2.5,3.8100717,2
2020-04-30-170201,170201,3,1,2,444,1.0,0.4146858,3
2020-05-01-170201,170201,1,0,6,445,0.0,0.13978776,4
2020-05-02-170201,170201,0,0,0,445,0.5,0.033650037,5
2020-05-03-170201,170201,1,1,0,446,0.0,0.059988845,6
2020-05-04-170201,170201,7,0,4,453,4.5,4.396191,0
2020-05-05-170201,170201,3,0,6,456,2.0,0.25758377,1
2020-05-06-170201,170201,2,0,4,458,3.0,2.2022724,2
2020-05-07-170201,170201,2,0,4,460,3.0,0.4494478,3
2020-05-08-170201,170201,6,0,3,466,3.5,1.3668871,4
2020-05-09-170201,170201,3,0,1,469,0.0,0.8096569,5
2020-05-10-170201,170201,0,0,0,469,0.5,0.75843817,6
2020-05-11-170201,170201,3,0,4,472,2.0,1.2204703,0
2020-05-12-170201,170201,3,0,5,475,2.5,0.063976265,1
2020-05-13-170201,170201,7,0,1,482,4.5,4.159201,2
2020-05-14-170201,170201,2,0,3,484,2.0,1.2628837,3
2020-05-15-170201,170201,6,0,3,490,5.5,1.0664241,4
2020-05-16-170201,170201,0,0,0,490,0.5,0.015470088,5
2020-05-17-170201,170201,0,0,0,490,0.0,0.029856954,6
2020-05-18-170201,170201,4,1,2,494,5.5,4.732779,0
2020-05-19-170201,170201,6,0,12,500,4.0,2.3657444,1
2020-05-20-170201,170201,4,0,2,504,5.0,4.5535793,2
2020-05-21-170201,170201,4,0,1,508,2.5,2.4807496,3
2020-05-22-170201,170201,3,0,2,511,2.5,0.077461466,4
2020-05-23-170201,170201,1,0,0,512,0.0,0.043119084,5
2020-05-24-170201,170201,0,0,0,512,0.0,0.004661885,6
2020-05-25-170201,170201,4,0,1,516,2.5,4.022901,0
2020-05-26-170201,170201,5,0,3,521,4.0,2.5380561,1
2020-05-27-170201,170201,1,0,1,522,1.5,0.76976794,2
2020-05-28-170201,170201,3,2,2,525,1.5,0.9122802,3
2020-05-29-170201,170201,3,0,0,528,1.5,2.5316339,4
2020-05-30-170201,170201,0,0,0,528,0.0,0.002235943,5
2020-05-31-170201,170201,0,0,0,528,0.0,0.0022522968,6
2020-06-01-170201,170201,2,0,4,530,1.5,1.2448658,0
2020-06-02-170201,170201,12,0,0,542,0.5,0.14761996,1
2020-06-03-170201,170201,2,0,0,544,2.5,2.6471457,2
2020-06-04-170201,170201,1,0,0,545,3.0,0.19725025,3
2020-06-05-170201,170201,2,0,2,547,0.5,0.10540743,4
2020-06-06-170201,170201,0,2,1,547,0.0,0.13776392,5
2020-06-07-170201,170201,0,0,0,547,0.0,0.0022155335,6
2020-06-08-170201,170201,1,0,0,548,1.0,0.11787503,0
2020-06-09-170201,170201,3,0,2,551,0.0,0.12922378,1
2020-06-10-170201,170201,1,1,2,552,0.5,0.023813996,2
2020-06-11-170201,170201,2,0,2,554,0.0,0.076862894,3
2020-06-12-170201,170201,0,0,1,554,0.5,0.073002286,4
2020-06-13-170201,170201,0,0,0,554,0.0,0.002944946,5
2020-06-14-170201,170201,0,0,0,554,0.0,0.0055939737,6
2020-06-15-170201,170201,4,0,1,558,0.0,0.013169321,0
2020-06-16-170201,170201,0,1,5,558,0.0,0.13598715,1
2020-06-17-170201,170201,0,0,1,558,1.0,0.03624364,2
2020-06-18-170201,170201,0,0,0,558,0.5,0.06210109,3
2020-06-19-170201,170201,2,0,0,560,0.5,1.9395857,4
2020-06-20-170201,170201,1,0,0,561,0.0,0.32315025,5
2020-06-21-170201,170201,0,0,0,561,0.0,0.003875617,6
2020-06-22-170201,170201,0,0,1,561,0.5,1.7089031,0
2020-06-23-170201,170201,2,0,3,563,0.5,1.3783222,1
2020-06-24-170201,170201,2,0,1,565,0.5,0.17273094,2
2020-06-25-170201,170201,2,0,2,567,1.0,0.036929686,3
2020-06-26-170201,170201,1,0,1,568,0.5,0.4258268,4
2020-06-27-170201,170201,0,0,0,568,0.0,0.020346632,5
2020-06-28-170201,170201,0,0,0,568,0.0,0.02035672,6
2020-06-29-170201,170201,1,0,0,569,0.5,1.3685858,0
2020-06-30-170201,170201,5,0,0,574,0.5,0.35169667,1
2020-07-01-170201,170201,1,0,0,575,1.5,1.3453633,2
2020-07-02-170201,170201,0,0,2,575,0.0,0.13900238,3
2020-07-03-170201,170201,0,0,0,575,0.0,0.12466133,4
2020-07-04-170201,170201,0,0,1,575,0.5,0.032294925,5
2020-07-05-170201,170201,0,0,2,575,1.0,0.0005953133,6
2020-07-06-170201,170201,1,0,1,576,1.5,0.05562042,0
2020-07-07-170201,170201,3,0,2,579,0.5,0.14119019,1
2020-07-08-170201,170201,1,0,1,580,0.5,0.053361293,2
2020-07-09-170201,170201,2,0,2,582,0.5,0.27639386,3
2020-07-10-170201,170201,1,0,0,583,1.0,1.6754742,4
2020-07-11-170201,170201,0,0,0,583,0.0,0.0011792805,5
2020-07-12-170201,170201,0,0,3,583,0.0,0.10033359,6
2020-07-13-170201,170201,0,0,6,583,0.5,0.12885039,0
2020-07-14-170201,170201,0,0,7,583,0.5,0.26774272,1
2020-07-15-170201,170201,0,0,5,583,1.0,0.14496294,2
2020-07-16-170201,170201,2,0,8,585,1.0,0.14994687,3
2020-07-17-170201,170201,0,0,33,585,1.5,0.03303638,4
2020-07-18-170201,170201,1,0,7,586,0.0,0.017987024,5
2020-07-19-170201,170201,2,0,4,588,0.0,0.08068037,6
2020-07-20-170201,170201,1,0,38,589,1.0,1.3917863,0
2020-07-21-170201,170201,2,0,27,591,0.5,1.677941,1
2020-07-22-170201,170201,1,0,28,592,1.0,0.045972254,2
2020-07-23-170201,170201,2,0,49,594,0.5,0.05337279,3
2020-07-24-170201,170201,0,0,34,594,0.5,1.4420354,4
2020-07-25-170201,170201,0,0,11,594,0.5,1.2178973,5
2020-07-26-170201,170201,3,0,17,597,1.5,0.011885654,6
2020-07-27-170201,170201,6,0,46,603,0.0,0.04034344,0
2020-07-28-170201,170201,7,0,31,610,2.0,2.623594,1
2020-07-29-170201,170201,5,0,15,615,3.0,0.22215833,2
2020-07-30-170201,170201,8,0,29,623,2.5,1.5023198,3
2020-07-31-170201,170201,33,0,33,656,3.5,1.5200891,4
2020-08-01-170201,170201,7,0,7,663,6.0,2.4045877,5
2020-08-02-170201,170201,4,0,5,667,0.5,0.20121972,6
2020-08-03-170201,170201,38,0,31,705,11.0,7.553865,0
2020-08-04-170201,170201,27,0,37,732,14.0,9.407357,1
2020-08-05-170201,170201,28,0,28,760,16.0,19.502945,2
2020-08-06-170201,170201,49,0,20,809,25.0,21.46788,3
2020-08-07-170201,170201,34,0,17,843,12.0,12.085734,4
2020-08-08-170201,170201,11,0,7,854,19.0,6.782355,5
2020-08-09-170201,170201,17,0,3,871,17.5,9.4087715,6
2020-08-10-170201,170201,46,0,8,917,35.5,21.74525,0
2020-08-11-170201,170201,31,0,16,948,13.0,19.755083,1
2020-08-12-170201,170201,15,0,5,963,11.5,8.094373,2
2020-08-13-170201,170201,29,0,13,992,17.0,4.6224604,3
2020-08-14-170201,170201,33,0,7,1025,12.5,10.177412,4
2020-08-15-170201,170201,7,0,4,1032,8.0,8.979062,5
2020-08-16-170201,170201,5,0,2,1037,1.5,0.98547405,6
2020-08-17-170201,170201,31,0,8,1068,26.0,36.466423,0
2020-08-18-170201,170201,37,0,5,1105,15.5,10.262734,1
2020-08-19-170201,170201,28,0,7,1133,13.0,11.02697,2
2020-08-20-170201,170201,20,1,10,1153,8.0,12.639471,3
2020-08-21-170201,170201,17,0,2,1170,12.5,7.610207,4
2020-08-22-170201,170201,7,0,6,1177,0.5,1.4261144,5
2020-08-23-170201,170201,3,1,3,1180,4.5,4.3861804,6
2020-08-24-170201,170201,8,0,8,1188,6.0,4.1961164,0
2020-08-25-170201,170201,16,0,5,1204,6.0,2.068088,1
2020-08-26-170201,170201,5,0,12,1209,10.0,8.387632,2
2020-08-27-170201,170201,13,0,11,1222,7.0,5.637478,3
2020-08-28-170201,170201,7,0,6,1229,6.0,4.6222963,4
2020-08-29-170201,170201,4,0,0,1233,0.5,1.0525185,5
2020-08-30-170201,170201,2,0,4,1235,1.0,1.6778817,6
2020-08-31-170201,170201,8,0,7,1243,5.5,1.8525634,0
2020-09-01-170201,170201,5,1,1,1248,0.5,0.57729954,1
2020-09-02-170201,170201,7,0,3,1255,14.0,1.9101139,2
2020-09-03-170201,170201,10,1,12,1265,4.5,8.865568,3
2020-09-04-170201,170201,2,0,4,1267,5.0,5.31411,4
2020-09-05-170201,170201,6,1,5,1273,1.5,1.8415804,5
2020-09-06-170201,170201,3,0,4,1276,2.5,4.3215446,6
2020-09-07-170201,170201,8,0,7,1284,5.5,1.7532624,0
2020-09-08-170201,170201,5,1,17,1289,4.0,4.748314,1
2020-09-09-170201,170201,12,0,9,1301,3.5,4.3551955,2
2020-09-10-170201,170201,11,0,8,1312,16.0,26.682104,3
2020-09-11-170201,170201,6,0,6,1318,13.5,22.570415,4
2020-09-12-170201,170201,0,0,4,1318,3.5,2.225558,5
2020-09-13-170201,170201,4,0,3,1322,6.5,7.14388,6
2020-09-14-170201,170201,7,0,9,1329,7.0,1.9199501,0
2020-09-15-170201,170201,1,0,2,1330,5.5,9.107551,1
2020-09-16-170201,170201,3,0,10,1333,7.0,4.875777,2
2020-09-17-170201,170201,12,0,12,1345,7.5,7.186195,3
2020-09-18-170201,170201,4,0,6,1349,11.5,4.898786,4
2020-09-19-170201,170201,5,0,3,1354,6.0,3.46106,5
2020-09-20-170201,170201,4,1,7,1358,7.0,6.736927,6
2020-09-21-170201,170201,7,1,21,1365,9.0,8.906342,0
2020-09-22-170201,170201,17,0,13,1382,7.5,1.9512032,1
2020-09-23-170201,170201,9,1,19,1391,8.0,2.2006643,2
2020-09-24-170201,170201,8,0,16,1399,8.0,2.781916,3
2020-09-25-170201,170201,6,0,29,1405,6.0,6.1348166,4
2020-09-26-170201,170201,4,1,4,1409,3.0,2.7358959,5
2020-09-27-170201,170201,3,0,7,1412,1.5,1.5876787,6
2020-09-28-170201,170201,9,0,10,1421,6.5,3.6793475,0
2020-09-29-170201,170201,2,0,17,1423,3.5,4.8597064,1
2020-09-30-170201,170201,10,0,22,1433,5.5,0.9752613,2
2020-10-01-170201,170201,12,0,24,1445,3.5,4.325855,3
2020-10-02-170201,170201,6,0,40,1451,4.5,4.269692,4
2020-10-03-170201,170201,3,2,5,1454,3.5,1.3815929,5
2020-10-04-170201,170201,7,1,15,1461,5.5,2.745751,6
2020-10-05-170201,170201,21,0,33,1482,5.0,0.4134396,0
2020-10-06-170201,170201,13,0,20,1495,7.5,2.5901012,1
2020-10-07-170201,170201,19,1,31,1514,7.0,3.624981,2
2020-10-08-170201,170201,16,0,21,1530,9.0,3.902271,3
2020-10-09-170201,170201,29,0,31,1559,8.5,3.1925359,4
2020-10-10-170201,170201,4,0,6,1563,3.0,3.8700202,5
2020-10-11-170201,170201,7,0,9,1570,3.5,3.7693567,6
2020-10-12-170201,170201,10,0,23,1580,6.0,6.1342554,0
2020-10-13-170201,170201,17,0,19,1597,9.0,6.210177,1
2020-10-14-170201,170201,22,0,27,1619,7.5,5.2511764,2
2020-10-15-170201,170201,24,0,22,1643,11.0,3.8899212,3
2020-10-16-170201,170201,40,0,31,1683,4.5,4.0919027,4
2020-10-17-170201,170201,5,0,9,1688,0.0,1.0049193,5
2020-10-18-170201,170201,15,0,8,1703,5.5,5.613721,6
2020-10-19-170201,170201,33,0,6,1736,14.5,12.379079,0
2020-10-20-170201,170201,20,0,22,1756,8.5,3.990302,1
2020-10-21-170201,170201,31,0,23,1787,15.5,9.280415,2
2020-10-22-170201,170201,21,0,19,1808,15.0,7.9993415,3
2020-10-23-170201,170201,31,0,17,1839,19.5,1.974408,4
2020-10-24-170201,170201,6,2,14,1845,4.5,2.5079875,5
2020-10-25-170201,170201,9,2,8,1854,5.0,3.0866644,6
2020-10-26-170201,170201,23,0,16,1877,14.0,9.603413,0
2020-10-27-170201,170201,19,1,13,1896,10.5,6.4726043,1
2020-10-28-170201,170201,27,2,32,1923,12.0,15.05258,2
2020-10-29-170201,170201,22,0,19,1945,16.5,13.634104,3
2020-10-30-170201,170201,31,0,19,1976,11.0,13.966349,4
2020-10-31-170201,170201,9,0,0,1985,5.0,5.2960095,5
2020-11-01-170201,170201,8,0,0,1993,4.5,6.2987785,6
2020-11-02-170201,170201,6,1,0,1999,8.5,8.276448,0
2020-11-03-170201,170201,22,0,0,2021,18.5,22.482883,1
2020-11-04-170201,170201,23,0,0,2044,10.0,5.7042794,2
2020-11-05-170201,170201,19,0,0,2063,19.5,14.336903,3
2020-11-06-170201,170201,17,0,0,2080,16.0,21.746092,4
2020-11-07-170201,170201,14,0,0,2094,5.5,6.207542,5
2020-11-08-170201,170201,8,0,0,2102,3.0,4.2744308,6
2020-11-09-170201,170201,16,1,0,2118,9.5,10.812291,0
2020-11-10-170201,170201,13,0,0,2131,6.0,6.050039,1
2020-11-11-170201,170201,32,0,0,2163,10.5,11.929011,2
2020-11-12-170201,170201,19,0,0,2182,12.5,17.751299,3
2020-11-13-170201,170201,19,1,0,2201,6.0,6.3523884,4
2020-03-01-170202,170202,0,0,0,0,0.0,0.0006442116,6
2020-03-02-170202,170202,0,0,5,0,0.1111111111111111,0.0027615158,0
2020-03-03-170202,170202,0,0,9,0,0.0,0.008493976,1
2020-03-04-170202,170202,0,1,6,0,0.1111111111111111,0.007285531,2
2020-03-05-170202,170202,0,0,10,0,0.0,0.004717336,3
2020-03-06-170202,170202,0,0,4,0,0.0,0.007914285,4
2020-03-07-170202,170202,0,0,1,0,0.0,0.0071022282,5
2020-03-08-170202,170202,0,0,1,0,0.0,0.0005726352,6
2020-03-09-170202,170202,0,0,25,0,0.1111111111111111,0.26697814,0
2020-03-10-170202,170202,0,0,12,0,0.3333333333333333,0.15258762,1
2020-03-11-170202,170202,1,0,18,1,0.0,0.9086993,2
2020-03-12-170202,170202,1,0,9,2,0.6666666666666666,0.9802064,3
2020-03-13-170202,170202,0,0,10,2,1.3333333333333333,0.30495024,4
2020-03-14-170202,170202,5,0,4,7,1.5555555555555556,3.1839056,5
2020-03-15-170202,170202,0,0,3,7,1.4444444444444444,0.29777533,6
2020-03-16-170202,170202,5,0,11,12,3.0,3.9319003,0
2020-03-17-170202,170202,9,0,11,21,3.0,5.46188,1
2020-03-18-170202,170202,6,0,14,27,7.5555555555555545,4.4110456,2
2020-03-19-170202,170202,10,1,2,37,7.333333333333332,7.2284985,3
2020-03-20-170202,170202,4,0,4,41,5.777777777777778,3.6867876,4
2020-03-21-170202,170202,1,0,2,42,4.777777777777779,1.1430054,5
2020-03-22-170202,170202,1,0,0,43,4.4444444444444455,1.1492187,6
2020-03-23-170202,170202,25,0,3,68,9.444444444444443,15.854131,0
2020-03-24-170202,170202,12,0,5,80,7.888888888888888,7.9975886,1
2020-03-25-170202,170202,18,0,4,98,6.4444444444444455,10.429099,2
2020-03-26-170202,170202,9,0,2,107,5.4444444444444455,7.213629,3
2020-03-27-170202,170202,10,0,1,117,5.4444444444444455,7.633732,4
2020-03-28-170202,170202,4,0,1,121,2.4444444444444446,2.3331742,5
2020-03-29-170202,170202,3,0,1,124,1.6666666666666667,1.3962076,6
2020-03-30-170202,170202,11,0,5,135,6.666666666666668,6.0810833,0
2020-03-31-170202,170202,11,0,6,146,4.888888888888889,5.9066067,1
2020-04-01-170202,170202,14,0,1,160,4.888888888888889,6.5660744,2
2020-04-02-170202,170202,2,0,3,162,2.888888888888889,1.8196993,3
2020-04-03-170202,170202,4,0,19,166,3.2222222222222223,2.7936053,4
2020-04-04-170202,170202,2,0,0,168,1.1111111111111112,1.0216066,5
2020-04-05-170202,170202,0,0,2,168,0.6666666666666666,0.1877614,6
2020-04-06-170202,170202,3,0,6,171,4.222222222222221,2.0389104,0
2020-04-07-170202,170202,5,1,1,176,2.6666666666666665,3.2583535,1
2020-04-08-170202,170202,4,1,0,180,2.6666666666666665,2.8503287,2
2020-04-09-170202,170202,2,0,0,182,1.3333333333333333,1.0779555,3
2020-04-10-170202,170202,1,0,2,183,1.8888888888888888,0.6158934,4
2020-04-11-170202,170202,1,2,0,184,0.7777777777777778,0.52285284,5
2020-04-12-170202,170202,1,0,2,185,2.333333333333333,0.9334591,6
2020-04-13-170202,170202,5,0,3,190,3.0,3.039221,0
2020-04-14-170202,170202,6,0,2,196,15.333333333333336,4.1350665,1
2020-04-15-170202,170202,1,0,4,197,2.1111111111111107,1.4325813,2
2020-04-16-170202,170202,3,0,0,200,1.8888888888888888,2.1704001,3
2020-04-17-170202,170202,19,0,0,219,2.6666666666666665,12.268157,4
2020-04-18-170202,170202,0,0,0,219,0.7777777777777778,0.2534506,5
2020-04-19-170202,170202,2,0,0,221,0.4444444444444444,0.77817273,6
2020-04-20-170202,170202,6,0,5,227,1.6666666666666667,3.989437,0
2020-04-21-170202,170202,1,2,0,228,1.6666666666666667,1.080519,1
2020-04-22-170202,170202,0,0,2,228,0.8888888888888888,0.29929546,2
2020-04-23-170202,170202,0,1,0,228,1.0,0.24047092,3
2020-04-24-170202,170202,2,0,0,230,1.7777777777777777,1.5344023,4
2020-04-25-170202,170202,0,0,0,230,0.2222222222222222,0.014822912,5
2020-04-26-170202,170202,2,0,0,232,0.4444444444444444,0.831543,6
2020-04-27-170202,170202,3,0,1,235,1.5555555555555556,2.126434,0
2020-04-28-170202,170202,2,0,0,237,1.6666666666666667,0.8995402,1
2020-04-29-170202,170202,4,0,4,241,1.3333333333333333,2.7123165,2
2020-04-30-170202,170202,0,0,1,241,1.6666666666666667,0.575243,3
2020-05-01-170202,170202,0,0,1,241,0.7777777777777778,0.18554273,4
2020-05-02-170202,170202,0,0,0,241,0.3333333333333333,0.10313633,5
2020-05-03-170202,170202,0,0,0,241,0.5555555555555556,0.14766529,6
2020-05-04-170202,170202,5,0,5,246,2.0,3.2062185,0
2020-05-05-170202,170202,0,1,2,246,1.1111111111111112,0.40979734,1
2020-05-06-170202,170202,2,0,4,248,1.0,1.6826606,2
2020-05-07-170202,170202,0,0,2,248,1.7777777777777777,0.6863903,3
2020-05-08-170202,170202,0,0,0,248,2.0,1.1410207,4
2020-05-09-170202,170202,0,0,0,248,0.4444444444444444,0.6006917,5
2020-05-10-170202,170202,0,2,0,248,0.3333333333333333,0.5810613,6
2020-05-11-170202,170202,1,1,3,249,1.1111111111111112,1.0848112,0
2020-05-12-170202,170202,0,0,2,249,1.0,0.111887984,1
2020-05-13-170202,170202,4,0,0,253,1.8888888888888888,2.9961004,2
2020-05-14-170202,170202,1,2,0,254,1.3333333333333333,1.1913751,3
2020-05-15-170202,170202,1,0,2,255,1.8888888888888888,0.77372,4
2020-05-16-170202,170202,0,0,0,255,0.3333333333333333,0.050630268,5
2020-05-17-170202,170202,0,0,0,255,0.2222222222222222,0.09768868,6
2020-05-18-170202,170202,5,0,1,260,1.8888888888888888,3.5390904,0
2020-05-19-170202,170202,2,0,0,262,2.1111111111111107,1.8735855,1
2020-05-20-170202,170202,4,0,2,266,1.8888888888888888,3.4168437,2
2020-05-21-170202,170202,2,0,1,268,1.1111111111111112,1.8260393,3
2020-05-22-170202,170202,0,0,0,268,1.1111111111111112,0.12841138,4
2020-05-23-170202,170202,0,0,0,268,0.7777777777777778,0.11213487,5
2020-05-24-170202,170202,0,0,0,268,0.3333333333333333,0.049386624,6
2020-05-25-170202,170202,3,0,0,271,1.1111111111111112,3.034268,0
2020-05-26-170202,170202,2,0,0,273,2.1111111111111107,1.8026301,1
2020-05-27-170202,170202,0,1,0,273,1.4444444444444444,0.9104463,2
2020-05-28-170202,170202,0,1,0,273,1.2222222222222223,0.88133806,3
2020-05-29-170202,170202,2,2,0,275,0.5555555555555556,1.8070923,4
2020-05-30-170202,170202,0,0,0,275,0.0,0.0047709993,5
2020-05-31-170202,170202,0,0,0,275,0.1111111111111111,0.0054513044,6
2020-06-01-170202,170202,1,0,0,276,0.6666666666666666,0.86324096,0
2020-06-02-170202,170202,0,0,0,276,1.8888888888888888,0.2132467,1
2020-06-03-170202,170202,2,0,0,278,0.8888888888888888,1.9586382,2
2020-06-04-170202,170202,1,0,0,279,1.2222222222222223,0.34935033,3
2020-06-05-170202,170202,0,0,1,279,0.4444444444444444,0.17448628,4
2020-06-06-170202,170202,0,0,0,279,0.3333333333333333,0.24315017,5
2020-06-07-170202,170202,0,0,0,279,0.0,0.010450087,6
2020-06-08-170202,170202,0,0,1,279,0.4444444444444444,0.15998907,0
2020-06-09-170202,170202,0,0,1,279,0.6666666666666666,0.18893476,1
2020-06-10-170202,170202,0,0,0,279,0.2222222222222222,0.04152571,2
2020-06-11-170202,170202,0,0,0,279,0.6666666666666666,0.1436051,3
2020-06-12-170202,170202,0,0,0,279,0.3333333333333333,0.1049297,4
2020-06-13-170202,170202,0,0,0,279,0.0,0.008378183,5
2020-06-14-170202,170202,0,0,0,279,0.1111111111111111,0.015196545,6
2020-06-15-170202,170202,0,0,1,279,0.4444444444444444,0.022223055,0
2020-06-16-170202,170202,0,0,0,279,0.3333333333333333,0.20423429,1
2020-06-17-170202,170202,0,0,2,279,0.3333333333333333,0.066544965,2
2020-06-18-170202,170202,0,1,0,279,0.3333333333333333,0.099774934,3
2020-06-19-170202,170202,1,0,0,280,0.7777777777777778,1.4201854,4
2020-06-20-170202,170202,0,0,0,280,0.3333333333333333,0.31573954,5
2020-06-21-170202,170202,0,0,0,280,0.0,0.0056902007,6
2020-06-22-170202,170202,1,0,0,281,0.2222222222222222,1.1985636,0
2020-06-23-170202,170202,1,0,0,282,0.4444444444444444,0.9659325,1
2020-06-24-170202,170202,0,0,0,282,0.8888888888888888,0.2638233,2
2020-06-25-170202,170202,0,0,0,282,0.4444444444444444,0.052651692,3
2020-06-26-170202,170202,0,0,1,282,0.6666666666666666,0.46535003,4
2020-06-27-170202,170202,0,0,0,282,0.0,0.025734995,5
2020-06-28-170202,170202,0,0,0,282,0.0,0.025737083,6
2020-06-29-170202,170202,1,0,0,283,0.3333333333333333,0.96251386,0
2020-06-30-170202,170202,0,0,1,283,1.1111111111111112,0.38554832,1
2020-07-01-170202,170202,2,0,1,285,0.3333333333333333,0.91803503,2
2020-07-02-170202,170202,0,0,1,285,0.3333333333333333,0.17286198,3
2020-07-03-170202,170202,0,0,0,285,0.7777777777777778,0.20965728,4
2020-07-04-170202,170202,0,0,0,285,0.2222222222222222,0.060840596,5
2020-07-05-170202,170202,0,0,0,285,0.2222222222222222,0.0007095359,6
2020-07-06-170202,170202,0,0,1,285,0.7777777777777778,0.06468452,0
2020-07-07-170202,170202,0,1,0,285,0.5555555555555556,0.18045413,1
2020-07-08-170202,170202,0,0,0,285,0.4444444444444444,0.09212938,2
2020-07-09-170202,170202,0,0,0,285,0.4444444444444444,0.26644662,3
2020-07-10-170202,170202,1,0,1,286,0.5555555555555556,1.2352402,4
2020-07-11-170202,170202,0,0,1,286,0.1111111111111111,0.0012794422,5
2020-07-12-170202,170202,0,0,0,286,0.2222222222222222,0.18097284,6
2020-07-13-170202,170202,0,0,0,286,0.3333333333333333,0.20500013,0
2020-07-14-170202,170202,1,0,1,287,0.3333333333333333,0.38912553,1
2020-07-15-170202,170202,1,0,0,288,0.6666666666666666,0.22092472,2
2020-07-16-170202,170202,1,0,1,289,0.6666666666666666,0.23193625,3
2020-07-17-170202,170202,0,0,2,289,0.3333333333333333,0.051264122,4
2020-07-18-170202,170202,0,0,3,289,0.1111111111111111,0.041414317,5
2020-07-19-170202,170202,0,1,0,289,0.4444444444444444,0.14861733,6
2020-07-20-170202,170202,1,0,6,290,0.2222222222222222,0.99319386,0
2020-07-21-170202,170202,0,1,5,290,0.5555555555555556,1.2306591,1
2020-07-22-170202,170202,0,0,12,290,0.5555555555555556,0.1122146,2
2020-07-23-170202,170202,0,0,15,290,0.7777777777777778,0.07259853,3
2020-07-24-170202,170202,1,0,10,291,0.0,1.031631,4
2020-07-25-170202,170202,1,0,8,292,0.2222222222222222,0.91680753,5
2020-07-26-170202,170202,0,0,14,292,0.8888888888888888,0.015436212,6
2020-07-27-170202,170202,0,0,27,292,0.6666666666666666,0.04702511,0
2020-07-28-170202,170202,1,0,18,293,1.1111111111111112,1.8078246,1
2020-07-29-170202,170202,0,0,9,293,1.7777777777777777,0.33916518,2
2020-07-30-170202,170202,1,0,11,294,1.5555555555555556,1.1408863,3
2020-07-31-170202,170202,2,0,9,296,5.0,1.1519341,4
2020-08-01-170202,170202,3,0,10,299,2.1111111111111107,1.8830289,5
2020-08-02-170202,170202,0,0,1,299,0.7777777777777778,0.34495252,6
2020-08-03-170202,170202,6,0,35,305,6.222222222222222,5.345533,0
2020-08-04-170202,170202,5,0,11,310,5.888888888888888,6.8713675,1
2020-08-05-170202,170202,12,0,11,322,5.5555555555555545,14.968043,2
2020-08-06-170202,170202,15,1,9,337,9.888888888888891,15.666288,3
2020-08-07-170202,170202,10,0,8,347,5.5555555555555545,8.844073,4
2020-08-08-170202,170202,8,0,1,355,5.0,5.67462,5
2020-08-09-170202,170202,14,0,4,369,4.4444444444444455,7.6736703,6
2020-08-10-170202,170202,27,0,5,396,10.555555555555557,16.000584,0
2020-08-11-170202,170202,18,0,3,414,5.111111111111111,15.05431,1
2020-08-12-170202,170202,9,0,6,423,5.222222222222221,7.291712,2
2020-08-13-170202,170202,11,0,7,434,8.11111111111111,4.3664517,3
2020-08-14-170202,170202,9,0,4,443,8.555555555555555,8.6677475,4
2020-08-15-170202,170202,10,0,0,453,2.888888888888889,7.917877,5
2020-08-16-170202,170202,1,0,1,454,2.2222222222222223,1.5219417,6
2020-08-17-170202,170202,35,0,1,489,6.333333333333332,27.110619,0
2020-08-18-170202,170202,11,1,0,500,7.888888888888888,8.040333,1
2020-08-19-170202,170202,11,0,1,511,6.5555555555555545,8.56441,2
2020-08-20-170202,170202,9,1,3,520,4.666666666666667,10.248903,3
2020-08-21-170202,170202,8,0,3,528,5.4444444444444455,6.0652695,4
2020-08-22-170202,170202,1,0,1,529,2.2222222222222223,1.7360946,5
2020-08-23-170202,170202,4,0,1,533,2.333333333333333,3.9529593,6
2020-08-24-170202,170202,5,0,2,538,3.333333333333333,3.8964698,0
2020-08-25-170202,170202,3,0,3,541,5.222222222222221,2.1227684,1
2020-08-26-170202,170202,6,0,2,547,3.4444444444444446,6.228494,2
2020-08-27-170202,170202,7,0,20,554,4.111111111111111,4.306406,3
2020-08-28-170202,170202,4,0,17,558,3.0,3.9830089,4
2020-08-29-170202,170202,0,0,1,558,2.888888888888889,1.681854,5
2020-08-30-170202,170202,1,0,8,559,2.555555555555556,1.9061931,6
2020-08-31-170202,170202,1,1,2,560,2.7777777777777777,1.35406,0
2020-09-01-170202,170202,0,1,8,560,1.8888888888888888,0.78805995,1
2020-09-02-170202,170202,1,0,0,561,4.666666666666667,1.6885781,2
2020-09-03-170202,170202,3,0,4,564,5.0,6.9225063,3
2020-09-04-170202,170202,3,0,6,567,3.0,4.0864267,4
2020-09-05-170202,170202,1,0,5,568,1.3333333333333333,1.5052162,5
2020-09-06-170202,170202,1,0,8,569,2.7777777777777777,3.7730646,6
2020-09-07-170202,170202,2,1,7,571,3.2222222222222223,1.5484756,0
2020-09-08-170202,170202,3,0,2,574,3.111111111111111,3.4761608,1
2020-09-09-170202,170202,2,0,1,576,3.4444444444444446,3.4742692,2
2020-09-10-170202,170202,20,0,4,596,4.4444444444444455,18.872795,3
2020-09-11-170202,170202,17,1,3,613,4.777777777777779,15.481064,4
2020-09-12-170202,170202,1,0,2,614,2.888888888888889,2.630931,5
2020-09-13-170202,170202,8,0,2,622,2.0,5.37952,6
2020-09-14-170202,170202,2,0,1,624,4.0,1.7738426,0
2020-09-15-170202,170202,8,0,1,632,3.4444444444444446,7.743782,1
2020-09-16-170202,170202,0,0,1,632,5.333333333333333,4.409008,2
2020-09-17-170202,170202,4,0,3,636,4.666666666666667,5.2305665,3
2020-09-18-170202,170202,6,0,1,642,4.4444444444444455,3.6267114,4
2020-09-19-170202,170202,5,2,1,647,2.1111111111111107,2.3989868,5
2020-09-20-170202,170202,8,1,4,655,2.555555555555556,4.9969344,6
2020-09-21-170202,170202,7,1,0,662,3.6666666666666665,5.99845,0
2020-09-22-170202,170202,2,1,1,664,5.111111111111111,1.5962092,1
2020-09-23-170202,170202,1,1,2,665,4.333333333333333,1.9785695,2
2020-09-24-170202,170202,4,2,2,669,3.555555555555556,2.058667,3
2020-09-25-170202,170202,3,0,1,672,4.888888888888889,4.762615,4
2020-09-26-170202,170202,2,2,4,674,1.7777777777777777,2.2418756,5
2020-09-27-170202,170202,2,0,4,676,1.1111111111111112,1.3505399,6
2020-09-28-170202,170202,1,1,6,677,4.333333333333333,3.022184,0
2020-09-29-170202,170202,1,0,5,678,3.0,4.2823157,1
2020-09-30-170202,170202,1,0,2,679,3.888888888888889,1.1147989,2
2020-10-01-170202,170202,3,0,3,682,3.6666666666666665,3.3618734,3
2020-10-02-170202,170202,1,1,4,683,5.111111111111111,3.5756204,4
2020-10-03-170202,170202,1,0,0,684,2.555555555555556,1.3361813,5
2020-10-04-170202,170202,4,0,6,688,3.111111111111111,2.3221087,6
2020-10-05-170202,170202,0,0,9,688,4.666666666666667,0.65983456,0
2020-10-06-170202,170202,1,0,2,689,4.888888888888889,2.3690152,1
2020-10-07-170202,170202,2,0,7,691,4.888888888888889,3.253145,2
2020-10-08-170202,170202,2,1,8,693,8.11111111111111,3.7069328,3
2020-10-09-170202,170202,1,1,5,694,6.777777777777778,2.601438,4
2020-10-10-170202,170202,4,0,1,698,2.1111111111111107,3.1865451,5
2020-10-11-170202,170202,4,0,3,702,2.4444444444444446,3.2934582,6
2020-10-12-170202,170202,6,0,8,708,3.0,4.8641796,0
2020-10-13-170202,170202,5,0,4,713,5.0,4.6237245,1
2020-10-14-170202,170202,2,0,10,715,7.111111111111112,4.7075796,2
2020-10-15-170202,170202,3,0,11,718,6.111111111111112,3.2970424,3
2020-10-16-170202,170202,4,0,15,722,7.888888888888888,3.49167,4
2020-10-17-170202,170202,0,0,3,722,2.0,1.1886863,5
2020-10-18-170202,170202,6,2,5,728,3.4444444444444446,4.2005315,6
2020-10-19-170202,170202,9,0,9,737,7.5555555555555545,8.67246,0
2020-10-20-170202,170202,2,0,17,739,4.888888888888889,3.051536,1
2020-10-21-170202,170202,7,0,2,746,8.777777777777779,6.89711,2
2020-10-22-170202,170202,8,0,8,754,7.0,5.7515407,3
2020-10-23-170202,170202,5,0,17,759,9.888888888888891,2.1342034,4
2020-10-24-170202,170202,1,0,5,760,3.0,2.4014275,5
2020-10-25-170202,170202,3,1,3,763,3.0,2.4382007,6
2020-10-26-170202,170202,8,1,9,771,7.222222222222222,6.8450174,0
2020-10-27-170202,170202,4,1,3,775,6.0,5.014437,1
2020-10-28-170202,170202,10,1,10,785,10.888888888888891,11.490993,2
2020-10-29-170202,170202,11,1,18,796,9.111111111111109,10.37325,3
2020-10-30-170202,170202,15,0,3,811,9.0,10.198599,4
2020-10-31-170202,170202,3,0,0,814,5.4444444444444455,4.492129,5
2020-11-01-170202,170202,5,2,0,819,4.4444444444444455,5.161754,6
2020-11-02-170202,170202,9,1,0,828,3.888888888888889,6.017722,0
2020-11-03-170202,170202,17,0,0,845,8.444444444444445,14.980652,1
2020-11-04-170202,170202,2,2,0,847,8.0,4.877231,2
2020-11-05-170202,170202,8,2,0,855,9.555555555555557,10.636969,3
2020-11-06-170202,170202,17,1,0,872,7.888888888888888,15.68237,4
2020-11-07-170202,170202,5,1,0,877,4.888888888888889,4.4219394,5
2020-11-08-170202,170202,3,1,0,880,5.222222222222221,3.633462,6
2020-11-09-170202,170202,9,0,0,889,4.888888888888889,7.3609996,0
2020-11-10-170202,170202,3,0,0,892,5.888888888888888,4.9490757,1
2020-11-11-170202,170202,10,0,0,902,7.0,9.024349,2
2020-11-12-170202,170202,18,0,0,920,5.0,12.720559,3
2020-11-13-170202,170202,3,1,0,923,6.333333333333332,5.214305,4
2020-03-01-170203,170203,0,0,4,0,0.0,0.00011929795,6
2020-03-02-170203,170203,1,0,8,1,0.0,0.00017354675,0
2020-03-03-170203,170203,0,0,9,1,0.0,0.0004301742,1
2020-03-04-170203,170203,0,1,20,1,0.5,0.0013832033,2
2020-03-05-170203,170203,0,1,13,1,0.0,0.00048195955,3
2020-03-06-170203,170203,0,0,20,1,0.0,0.0017584867,4
2020-03-07-170203,170203,0,0,10,1,0.0,0.00087248324,5
2020-03-08-170203,170203,0,0,5,1,0.0,0.000101888814,6
2020-03-09-170203,170203,0,0,24,1,0.0,0.07202705,0
2020-03-10-170203,170203,1,0,15,2,0.5,0.021974938,1
2020-03-11-170203,170203,0,0,21,2,0.5,0.3165361,2
2020-03-12-170203,170203,4,1,22,6,0.5,0.32267973,3
2020-03-13-170203,170203,3,0,17,9,2.5,0.04271993,4
2020-03-14-170203,170203,7,0,4,16,5.5,0.9967378,5
2020-03-15-170203,170203,4,0,3,20,0.0,0.05810137,6
2020-03-16-170203,170203,8,0,33,28,4.5,1.1548449,0
2020-03-17-170203,170203,9,0,15,37,8.5,1.763096,1
2020-03-18-170203,170203,20,0,12,57,16.5,1.2498605,2
2020-03-19-170203,170203,13,0,4,70,17.5,2.2819777,3
2020-03-20-170203,170203,20,0,14,90,9.5,0.942906,4
2020-03-21-170203,170203,10,0,2,100,8.0,0.20276663,5
2020-03-22-170203,170203,5,0,1,105,5.5,0.21057262,6
2020-03-23-170203,170203,24,0,15,129,27.0,4.735402,0
2020-03-24-170203,170203,15,0,10,144,19.5,2.2145958,1
2020-03-25-170203,170203,21,1,6,165,20.5,3.068872,2
2020-03-26-170203,170203,22,0,5,187,9.0,2.059376,3
2020-03-27-170203,170203,17,1,3,204,13.0,2.231366,4
2020-03-28-170203,170203,4,0,2,208,5.5,0.6149197,5
2020-03-29-170203,170203,3,0,3,211,4.5,0.38985765,6
2020-03-30-170203,170203,33,0,9,244,14.0,1.8191084,0
2020-03-31-170203,170203,15,0,89,259,13.5,1.8366653,1
2020-04-01-170203,170203,12,0,3,271,13.5,1.9674146,2
2020-04-02-170203,170203,4,0,2,275,4.5,0.39351308,3
2020-04-03-170203,170203,14,0,8,289,5.5,0.7421408,4
2020-04-04-170203,170203,2,0,1,291,2.0,0.28449982,5
2020-04-05-170203,170203,1,0,2,292,0.5,0.013718928,6
2020-04-06-170203,170203,15,0,5,307,7.5,0.54948074,0
2020-04-07-170203,170203,10,3,2,317,6.5,0.9910394,1
2020-04-08-170203,170203,6,0,2,323,7.5,0.8608897,2
2020-04-09-170203,170203,5,0,2,328,2.5,0.30952463,3
2020-04-10-170203,170203,3,0,4,331,2.5,0.13306926,4
2020-04-11-170203,170203,2,0,1,333,1.0,0.15027586,5
2020-04-12-170203,170203,3,0,0,336,1.0,0.15751459,6
2020-04-13-170203,170203,9,0,6,345,7.5,0.95806885,0
2020-04-14-170203,170203,89,0,6,434,24.0,1.1928036,1
2020-04-15-170203,170203,3,0,1,437,3.0,0.2881031,2
2020-04-16-170203,170203,2,0,2,439,3.5,0.60264134,3
2020-04-17-170203,170203,8,1,0,447,12.0,3.9405322,4
2020-04-18-170203,170203,1,0,1,448,0.5,0.031275213,5
2020-04-19-170203,170203,2,0,0,450,2.0,0.25268722,6
2020-04-20-170203,170203,5,0,4,455,5.5,1.2203293,0
2020-04-21-170203,170203,2,0,4,457,3.0,0.25771037,1
2020-04-22-170203,170203,2,0,4,459,1.5,0.053676523,2
2020-04-23-170203,170203,2,0,6,461,0.0,0.01870323,3
2020-04-24-170203,170203,4,0,7,465,4.0,0.43730018,4
2020-04-25-170203,170203,1,0,0,466,0.0,0.00075524603,5
2020-04-26-170203,170203,0,0,1,466,1.0,0.26989293,6
2020-04-27-170203,170203,6,0,3,472,5.0,0.6280049,0
2020-04-28-170203,170203,6,0,5,478,2.5,0.2359257,1
2020-04-29-170203,170203,1,0,5,479,5.0,0.85334724,2
2020-04-30-170203,170203,2,0,3,481,1.5,0.09288511,3
2020-05-01-170203,170203,0,1,10,481,0.5,0.031311385,4
2020-05-02-170203,170203,1,0,1,482,0.0,0.007538138,5
2020-05-03-170203,170203,0,0,0,482,0.5,0.013437599,6
2020-05-04-170203,170203,4,0,6,486,6.0,0.98463225,0
2020-05-05-170203,170203,4,0,6,490,1.5,0.057695054,1
2020-05-06-170203,170203,4,0,6,494,2.0,0.49325183,2
2020-05-07-170203,170203,6,0,3,500,1.0,0.10067189,3
2020-05-08-170203,170203,7,0,5,507,3.0,0.30615062,4
2020-05-09-170203,170203,0,0,0,507,1.5,0.18134244,5
2020-05-10-170203,170203,1,0,0,508,0.0,0.1698705,6
2020-05-11-170203,170203,3,0,2,511,2.0,0.27335683,0
2020-05-12-170203,170203,5,0,6,516,1.5,0.014329359,1
2020-05-13-170203,170203,5,0,3,521,5.5,0.93154854,2
2020-05-14-170203,170203,3,0,3,524,1.5,0.28285846,3
2020-05-15-170203,170203,10,0,1,534,3.5,0.2388499,4
2020-05-16-170203,170203,1,0,0,535,0.0,0.00346489,5
2020-05-17-170203,170203,0,0,0,535,0.0,0.006688279,6
2020-05-18-170203,170203,6,0,2,541,4.5,1.0600144,0
2020-05-19-170203,170203,6,0,1,547,4.0,0.5298641,1
2020-05-20-170203,170203,6,0,3,553,4.0,1.0198704,2
2020-05-21-170203,170203,3,0,5,556,3.0,0.55562097,3
2020-05-22-170203,170203,5,0,1,561,1.5,0.017350301,4
2020-05-23-170203,170203,0,0,0,561,0.5,0.009658679,5
2020-05-24-170203,170203,0,0,0,561,0.0,0.0010443528,6
2020-05-25-170203,170203,2,0,2,563,3.5,0.9010234,0
2020-05-26-170203,170203,6,0,0,569,3.5,0.5684514,1
2020-05-27-170203,170203,3,0,1,572,0.5,0.17241357,2
2020-05-28-170203,170203,3,1,0,575,1.5,0.20433219,3
2020-05-29-170203,170203,1,0,1,576,2.5,0.5670167,4
2020-05-30-170203,170203,0,0,0,576,0.0,0.0005007135,5
2020-05-31-170203,170203,0,0,0,576,0.0,0.00050450914,6
2020-06-01-170203,170203,2,2,0,578,1.5,0.27881432,0
2020-06-02-170203,170203,1,0,0,579,6.0,0.033064507,1
2020-06-03-170203,170203,3,0,2,582,2.0,0.59289014,2
2020-06-04-170203,170203,5,0,1,587,1.0,0.04418154,3
2020-06-05-170203,170203,1,0,0,588,1.0,0.02360958,4
2020-06-06-170203,170203,0,0,0,588,0.0,0.030858016,5
2020-06-07-170203,170203,0,2,0,588,0.0,0.0004961574,6
2020-06-08-170203,170203,2,0,0,590,0.5,0.02640199,0
2020-06-09-170203,170203,0,2,0,590,1.5,0.028944474,1
2020-06-10-170203,170203,1,0,1,591,0.5,0.0053336383,2
2020-06-11-170203,170203,0,0,2,591,1.0,0.01721536,3
2020-06-12-170203,170203,1,0,1,592,0.0,0.016350206,4
2020-06-13-170203,170203,0,0,0,592,0.0,0.00065963384,5
2020-06-14-170203,170203,0,0,0,592,0.0,0.0012528764,6
2020-06-15-170203,170203,0,0,0,592,2.0,0.0029498024,0
2020-06-16-170203,170203,0,0,1,592,0.0,0.030457925,1
2020-06-17-170203,170203,2,0,1,594,0.0,0.008117688,2
2020-06-18-170203,170203,1,0,0,595,0.0,0.013909448,3
2020-06-19-170203,170203,0,0,0,595,1.5,0.43441674,4
2020-06-20-170203,170203,0,0,1,595,0.5,0.072379515,5
2020-06-21-170203,170203,0,0,2,595,0.0,0.0008679877,6
2020-06-22-170203,170203,0,0,3,595,0.5,0.38274962,0
2020-06-23-170203,170203,0,0,1,595,1.5,0.3087039,1
2020-06-24-170203,170203,1,0,1,596,1.0,0.038688675,2
2020-06-25-170203,170203,2,0,1,598,1.0,0.008271344,3
2020-06-26-170203,170203,1,0,1,599,0.5,0.09537746,4
2020-06-27-170203,170203,0,0,0,599,0.0,0.0045572435,5
2020-06-28-170203,170203,0,0,0,599,0.0,0.0045592277,6
2020-06-29-170203,170203,0,0,1,599,1.0,0.30652454,0
2020-06-30-170203,170203,1,0,0,600,2.5,0.07877357,1
2020-07-01-170203,170203,1,0,1,601,1.5,0.30132303,2
2020-07-02-170203,170203,0,0,1,601,0.0,0.031133445,3
2020-07-03-170203,170203,0,0,3,601,0.0,0.027921569,4
2020-07-04-170203,170203,1,0,0,602,0.0,0.007233831,5
2020-07-05-170203,170203,2,0,0,604,0.0,0.00013335359,6
2020-07-06-170203,170203,3,0,1,607,0.5,0.012456606,0
2020-07-07-170203,170203,1,0,1,608,1.5,0.031623963,1
2020-07-08-170203,170203,1,0,2,609,0.5,0.011951284,2
2020-07-09-170203,170203,1,0,1,610,1.0,0.061907507,3
2020-07-10-170203,170203,1,0,0,611,1.0,0.37526047,4
2020-07-11-170203,170203,0,0,0,611,0.0,0.0002641383,5
2020-07-12-170203,170203,0,0,3,611,0.0,0.022473296,6
2020-07-13-170203,170203,1,0,0,612,0.0,0.028860927,0
2020-07-14-170203,170203,0,0,3,612,0.5,0.059970394,1
2020-07-15-170203,170203,1,0,6,613,0.5,0.032469347,2
2020-07-16-170203,170203,1,0,4,614,1.5,0.03358462,3
2020-07-17-170203,170203,3,0,5,617,0.0,0.007399425,4
2020-07-18-170203,170203,0,0,9,617,0.5,0.0040287995,5
2020-07-19-170203,170203,0,0,1,617,1.0,0.01807075,6
2020-07-20-170203,170203,1,0,16,618,1.0,0.3117199,0
2020-07-21-170203,170203,1,0,23,619,1.0,0.375815,1
2020-07-22-170203,170203,2,0,20,621,0.5,0.010296481,2
2020-07-23-170203,170203,1,0,35,622,1.0,0.011953596,3
2020-07-24-170203,170203,0,1,14,622,0.5,0.3229748,4
2020-07-25-170203,170203,0,0,30,622,0.5,0.2727738,5
2020-07-26-170203,170203,3,0,21,625,1.5,0.0026619611,6
2020-07-27-170203,170203,0,0,44,625,3.0,0.009035462,0
2020-07-28-170203,170203,3,0,8,628,4.0,0.58760864,1
2020-07-29-170203,170203,6,0,14,634,2.5,0.049758412,2
2020-07-30-170203,170203,4,0,23,638,4.5,0.336476,3
2020-07-31-170203,170203,5,1,16,643,17.5,0.34045643,4
2020-08-01-170203,170203,9,0,6,652,5.0,0.538563,5
2020-08-02-170203,170203,1,0,2,653,2.0,0.04506868,6
2020-08-03-170203,170203,16,0,17,669,22.0,1.6918564,0
2020-08-04-170203,170203,23,0,20,692,16.0,2.1069906,1
2020-08-05-170203,170203,20,0,15,712,20.0,4.3681393,2
2020-08-06-170203,170203,35,0,7,747,32.0,4.8082247,3
2020-08-07-170203,170203,14,0,17,761,22.0,2.7068715,4
2020-08-08-170203,170203,30,0,0,791,9.5,1.5190846,5
2020-08-09-170203,170203,21,0,5,812,15.5,2.1073244,6
2020-08-10-170203,170203,44,0,7,856,36.5,4.8703313,0
2020-08-11-170203,170203,8,0,9,864,24.5,4.424611,1
2020-08-12-170203,170203,14,0,14,878,12.0,1.8129559,2
2020-08-13-170203,170203,23,0,7,901,20.0,1.0352993,3
2020-08-14-170203,170203,16,0,8,917,21.0,2.2794614,4
2020-08-15-170203,170203,6,0,1,923,8.5,2.011067,5
2020-08-16-170203,170203,2,1,1,925,3.0,0.22072586,6
2020-08-17-170203,170203,17,0,10,942,33.0,8.16744,0
2020-08-18-170203,170203,20,0,1,962,24.0,2.2985651,1
2020-08-19-170203,170203,15,0,27,977,19.5,2.469742,2
2020-08-20-170203,170203,7,0,6,984,14.5,2.8308978,3
2020-08-21-170203,170203,17,0,7,1001,12.5,1.7044761,4
2020-08-22-170203,170203,0,0,2,1001,4.0,0.3194068,5
2020-08-23-170203,170203,5,0,4,1006,3.5,0.9823894,6
2020-08-24-170203,170203,7,0,9,1013,6.5,0.939828,0
2020-08-25-170203,170203,9,0,5,1022,9.5,0.46319965,1
2020-08-26-170203,170203,14,0,5,1036,5.5,1.8785973,2
2020-08-27-170203,170203,7,0,12,1043,10.0,1.2626363,3
2020-08-28-170203,170203,8,0,10,1051,5.5,1.0352783,4
2020-08-29-170203,170203,1,0,6,1052,2.0,0.23574878,5
2020-08-30-170203,170203,1,0,5,1053,1.5,0.3758074,6
2020-08-31-170203,170203,10,0,12,1063,4.5,0.41492307,0
2020-09-01-170203,170203,1,0,3,1064,2.5,0.12930419,1
2020-09-02-170203,170203,27,0,14,1091,4.0,0.4278133,2
2020-09-03-170203,170203,6,0,11,1097,6.5,1.9856434,3
2020-09-04-170203,170203,7,0,17,1104,2.5,1.1902112,4
2020-09-05-170203,170203,2,0,7,1106,3.5,0.41246834,5
2020-09-06-170203,170203,4,0,6,1110,2.0,0.9679339,6
2020-09-07-170203,170203,9,0,11,1119,5.0,0.39268062,0
2020-09-08-170203,170203,5,0,13,1124,4.0,1.0634844,1
2020-09-09-170203,170203,5,0,15,1129,7.0,0.9754459,2
2020-09-10-170203,170203,12,0,12,1141,15.5,5.97602,3
2020-09-11-170203,170203,10,1,9,1151,11.5,5.0551353,4
2020-09-12-170203,170203,6,0,4,1157,0.5,0.49846804,5
2020-09-13-170203,170203,5,0,1,1162,6.0,1.6000308,6
2020-09-14-170203,170203,12,0,12,1174,4.5,0.43001533,0
2020-09-15-170203,170203,3,0,6,1177,4.5,2.039851,1
2020-09-16-170203,170203,14,0,10,1191,1.5,1.092059,2
2020-09-17-170203,170203,11,0,4,1202,8.0,1.6095002,3
2020-09-18-170203,170203,17,0,8,1219,5.0,1.097191,4
2020-09-19-170203,170203,7,1,6,1226,5.0,0.7751797,5
2020-09-20-170203,170203,6,1,7,1232,6.0,1.5088807,6
2020-09-21-170203,170203,11,1,10,1243,7.0,1.9947553,0
2020-09-22-170203,170203,13,1,14,1256,9.5,0.43701786,1
2020-09-23-170203,170203,15,0,12,1271,5.0,0.49288413,2
2020-09-24-170203,170203,12,0,16,1283,6.0,0.6230682,3
2020-09-25-170203,170203,9,1,16,1292,4.5,1.3740339,4
2020-09-26-170203,170203,4,1,2,1296,3.0,0.61276984,5
2020-09-27-170203,170203,1,0,3,1297,2.5,0.3555979,6
2020-09-28-170203,170203,12,0,6,1309,5.0,0.82408434,0
2020-09-29-170203,170203,6,0,13,1315,1.5,1.0884663,1
2020-09-30-170203,170203,10,0,13,1325,5.5,0.21843764,2
2020-10-01-170203,170203,4,0,19,1329,7.5,0.96887296,3
2020-10-02-170203,170203,8,0,5,1337,3.5,0.9562976,4
2020-10-03-170203,170203,6,0,0,1343,2.0,0.30943844,5
2020-10-04-170203,170203,7,0,5,1350,5.5,0.6149696,6
2020-10-05-170203,170203,10,0,20,1360,10.5,0.09260372,0
2020-10-06-170203,170203,14,0,15,1374,7.0,0.58011454,1
2020-10-07-170203,170203,12,1,24,1386,10.5,0.81190044,2
2020-10-08-170203,170203,16,0,22,1402,9.0,0.87400657,3
2020-10-09-170203,170203,16,2,34,1418,15.0,0.7150426,4
2020-10-10-170203,170203,2,0,8,1420,4.0,0.8667747,5
2020-10-11-170203,170203,3,0,7,1423,5.5,0.84422463,6
2020-10-12-170203,170203,6,0,20,1429,8.0,1.3738904,0
2020-10-13-170203,170203,13,0,17,1442,11.0,1.3908962,1
2020-10-14-170203,170203,13,0,14,1455,12.0,1.1761374,2
2020-10-15-170203,170203,19,0,22,1474,13.5,0.8712437,3
2020-10-16-170203,170203,5,0,7,1479,22.0,0.9164678,4
2020-10-17-170203,170203,0,0,7,1479,2.5,0.22507446,5
2020-10-18-170203,170203,5,0,4,1484,10.5,1.2573048,6
2020-10-19-170203,170203,20,0,8,1504,21.0,2.7725604,0
2020-10-20-170203,170203,15,0,20,1519,11.0,0.89372027,1
2020-10-21-170203,170203,24,0,18,1543,19.0,2.078551,2
2020-10-22-170203,170203,22,0,31,1565,14.5,1.7916163,3
2020-10-23-170203,170203,34,0,15,1599,18.0,0.44220975,4
2020-10-24-170203,170203,8,0,6,1607,3.5,0.56173503,5
2020-10-25-170203,170203,7,0,3,1614,6.0,0.6913221,6
2020-10-26-170203,170203,20,1,10,1634,15.5,2.150894,0
2020-10-27-170203,170203,17,0,9,1651,11.5,1.4496765,1
2020-10-28-170203,170203,14,1,11,1665,18.5,3.3713484,2
2020-10-29-170203,170203,22,1,7,1687,16.5,3.0536537,3
2020-10-30-170203,170203,7,0,9,1694,23.0,3.1280656,4
2020-10-31-170203,170203,7,0,0,1701,6.0,1.186154,5
2020-11-01-170203,170203,4,0,0,1705,6.5,1.4107319,6
2020-11-02-170203,170203,8,2,0,1713,7.5,1.8536797,0
2020-11-03-170203,170203,20,0,0,1733,19.5,5.0354934,1
2020-11-04-170203,170203,18,0,0,1751,12.5,1.2776086,2
2020-11-05-170203,170203,31,0,0,1782,13.5,3.2110898,3
2020-11-06-170203,170203,15,0,0,1797,17.0,4.8704886,4
2020-11-07-170203,170203,6,0,0,1803,9.5,1.3903149,5
2020-11-08-170203,170203,3,2,0,1806,5.5,0.9573474,6
2020-11-09-170203,170203,10,0,0,1816,12.5,2.421635,0
2020-11-10-170203,170203,9,0,0,1825,8.0,1.3550509,1
2020-11-11-170203,170203,11,2,0,1836,21.0,2.6717782,2
2020-11-12-170203,170203,7,0,0,1843,18.5,3.9757812,3
2020-11-13-170203,170203,9,2,0,1852,11.0,1.4227626,4
2020-03-01-170204,170204,0,0,1,0,0.0,5.596905e-05,6
2020-03-02-170204,170204,1,0,6,1,0.0,0.07712787,0
2020-03-03-170204,170204,2,1,8,3,0.0,0.15326034,1
2020-03-04-170204,170204,0,0,10,3,0.25,0.023292363,2
2020-03-05-170204,170204,0,0,10,3,0.0,0.001705072,3
2020-03-06-170204,170204,0,0,6,3,0.5,0.024308087,4
2020-03-07-170204,170204,0,0,4,3,1.75,0.0070317225,5
2020-03-08-170204,170204,0,0,1,3,0.25,6.95507e-07,6
2020-03-09-170204,170204,1,0,18,4,1.0,0.2769111,0
2020-03-10-170204,170204,0,0,6,4,3.5,0.019391239,1
2020-03-11-170204,170204,0,0,9,4,0.5,0.08668921,2
2020-03-12-170204,170204,2,0,9,6,1.25,0.1940656,3
2020-03-13-170204,170204,2,0,8,8,2.25,0.3407021,4
2020-03-14-170204,170204,6,0,7,14,1.5,0.4739603,5
2020-03-15-170204,170204,1,0,1,15,0.75,0.070233494,6
2020-03-16-170204,170204,6,0,9,21,4.0,0.29343712,0
2020-03-17-170204,170204,8,0,4,29,3.75,0.74705154,1
2020-03-18-170204,170204,10,0,3,39,4.75,0.8082795,2
2020-03-19-170204,170204,10,0,2,49,7.25,0.9009039,3
2020-03-20-170204,170204,6,0,4,55,8.25,0.7377553,4
2020-03-21-170204,170204,4,0,0,59,3.5,0.30091932,5
2020-03-22-170204,170204,1,0,5,60,2.75,0.07298716,6
2020-03-23-170204,170204,18,0,3,78,11.0,1.8963639,0
2020-03-24-170204,170204,6,0,3,84,11.75,1.283255,1
2020-03-25-170204,170204,9,0,4,93,9.25,1.2418042,2
2020-03-26-170204,170204,9,0,2,102,7.75,0.9328271,3
2020-03-27-170204,170204,8,0,1,110,6.75,0.8963873,4
2020-03-28-170204,170204,7,0,1,117,2.5,0.40305513,5
2020-03-29-170204,170204,1,0,0,118,1.0,0.06136295,6
2020-03-30-170204,170204,9,0,0,127,8.0,0.86164814,0
2020-03-31-170204,170204,4,0,2,131,6.75,0.74961644,1
2020-04-01-170204,170204,3,0,1,134,4.5,0.5703226,2
2020-04-02-170204,170204,2,0,1,136,7.0,0.8565119,3
2020-04-03-170204,170204,4,0,2,140,6.25,0.8042204,4
2020-04-04-170204,170204,0,0,0,140,1.75,3.905389e-05,5
2020-04-05-170204,170204,5,0,0,145,0.75,0.17603028,6
2020-04-06-170204,170204,3,1,1,148,6.5,0.623168,0
2020-04-07-170204,170204,3,0,2,151,5.25,0.6644416,1
2020-04-08-170204,170204,4,1,0,155,4.5,0.00014833546,2
2020-04-09-170204,170204,2,0,0,157,5.5,0.00032314687,3
2020-04-10-170204,170204,1,0,1,158,2.5,0.15803388,4
2020-04-11-170204,170204,1,0,2,159,1.0,0.08883754,5
2020-04-12-170204,170204,0,0,1,159,0.25,0.0218325,6
2020-04-13-170204,170204,0,0,1,159,3.25,0.45105892,0
2020-04-14-170204,170204,2,0,3,161,3.0,0.00014225376,1
2020-04-15-170204,170204,1,0,3,162,4.25,0.3946656,2
2020-04-16-170204,170204,1,0,0,163,6.0,0.3700004,3
2020-04-17-170204,170204,2,0,1,165,3.25,0.00010751748,4
2020-04-18-170204,170204,0,0,0,165,1.0,0.047931585,5
2020-04-19-170204,170204,0,0,0,165,0.75,0.10194267,6
2020-04-20-170204,170204,1,0,0,166,2.25,0.40239188,0
2020-04-21-170204,170204,2,0,0,168,2.75,0.34525013,1
2020-04-22-170204,170204,0,0,0,168,2.0,0.27090013,2
2020-04-23-170204,170204,0,0,3,168,1.0,0.004640087,3
2020-04-24-170204,170204,1,0,1,169,1.5,0.22952265,4
2020-04-25-170204,170204,2,0,0,171,1.0,2.0695448e-05,5
2020-04-26-170204,170204,1,0,0,172,1.0,4.7236812e-05,6
2020-04-27-170204,170204,1,0,1,173,1.25,0.2157488,0
2020-04-28-170204,170204,3,0,1,176,2.75,0.2682261,1
2020-04-29-170204,170204,3,0,4,179,1.5,0.23865019,2
2020-04-30-170204,170204,0,1,2,179,2.25,5.584704e-05,3
2020-05-01-170204,170204,1,0,1,180,0.75,2.1104399e-05,4
2020-05-02-170204,170204,0,0,0,180,0.75,5.687498e-06,5
2020-05-03-170204,170204,0,0,0,180,0.5,1.1909658e-05,6
2020-05-04-170204,170204,0,0,1,180,2.75,8.967939e-05,0
2020-05-05-170204,170204,0,0,0,180,2.75,0.0001241782,1
2020-05-06-170204,170204,0,0,0,180,2.75,9.8778546e-05,2
2020-05-07-170204,170204,3,0,2,183,3.5,0.27740213,3
2020-05-08-170204,170204,1,0,2,184,1.5,0.25286648,4
2020-05-09-170204,170204,0,0,0,184,0.0,0.003327271,5
2020-05-10-170204,170204,0,0,0,184,0.5,4.9959617e-05,6
2020-05-11-170204,170204,1,0,3,185,3.0,0.19030859,0
2020-05-12-170204,170204,1,0,0,186,2.0,5.751015e-05,1
2020-05-13-170204,170204,4,0,0,190,3.75,0.5624841,2
2020-05-14-170204,170204,2,0,0,192,2.75,0.356631,3
2020-05-15-170204,170204,1,0,2,193,2.25,0.00010919515,4
2020-05-16-170204,170204,0,1,0,193,0.0,0.0007713529,5
2020-05-17-170204,170204,0,0,0,193,0.0,0.00023716467,6
2020-05-18-170204,170204,1,0,1,194,2.5,0.00011121918,0
2020-05-19-170204,170204,0,0,0,194,0.75,0.05647349,1
2020-05-20-170204,170204,0,1,2,194,1.5,0.12384799,2
2020-05-21-170204,170204,2,0,0,196,1.5,0.38812304,3
2020-05-22-170204,170204,2,0,0,198,1.0,6.0603244e-05,4
2020-05-23-170204,170204,0,0,0,198,0.0,0.00034644039,5
2020-05-24-170204,170204,0,0,0,198,0.0,0.00019299607,6
2020-05-25-170204,170204,3,0,0,201,2.0,0.00011297147,0
2020-05-26-170204,170204,0,0,0,201,2.25,0.057032175,1
2020-05-27-170204,170204,0,0,0,201,1.75,0.041945074,2
2020-05-28-170204,170204,0,0,0,201,1.0,0.091403104,3
2020-05-29-170204,170204,2,1,2,203,0.5,5.430082e-05,4
2020-05-30-170204,170204,0,0,0,203,0.0,2.4000983e-05,5
2020-05-31-170204,170204,0,0,0,203,0.0,0.00023184177,6
2020-06-01-170204,170204,1,0,0,204,2.0,7.306178e-05,0
2020-06-02-170204,170204,0,0,0,204,0.5,0.03388144,1
2020-06-03-170204,170204,2,0,0,206,0.75,0.19641094,2
2020-06-04-170204,170204,0,0,0,206,1.75,0.11931625,3
2020-06-05-170204,170204,0,0,0,206,0.5,4.8600738e-05,4
2020-06-06-170204,170204,0,0,0,206,0.0,0.0024500657,5
2020-06-07-170204,170204,0,0,1,206,0.0,0.00014376352,6
2020-06-08-170204,170204,0,0,0,206,0.75,4.9734324e-05,0
2020-06-09-170204,170204,0,0,0,206,0.0,0.011940919,1
2020-06-10-170204,170204,0,1,0,206,0.75,0.1358791,2
2020-06-11-170204,170204,0,0,0,206,0.75,0.09528113,3
2020-06-12-170204,170204,2,0,0,208,1.0,0.000121691985,4
2020-06-13-170204,170204,0,0,0,208,0.0,0.0015762125,5
2020-06-14-170204,170204,0,0,0,208,0.0,0.0020841523,6
2020-06-15-170204,170204,0,0,0,208,0.0,1.9454828e-06,0
2020-06-16-170204,170204,0,0,0,208,0.5,0.08962785,1
2020-06-17-170204,170204,0,0,0,208,0.25,0.0320907,2
2020-06-18-170204,170204,0,0,0,208,0.25,5.1404357e-05,3
2020-06-19-170204,170204,0,0,0,208,0.0,3.867268e-06,4
2020-06-20-170204,170204,0,0,0,208,0.0,0.0053543877,5
2020-06-21-170204,170204,1,0,0,209,0.0,0.038566165,6
2020-06-22-170204,170204,0,0,0,209,0.0,6.563755e-06,0
2020-06-23-170204,170204,0,0,0,209,0.25,0.057375595,1
2020-06-24-170204,170204,0,0,0,209,0.0,0.047582928,2
2020-06-25-170204,170204,0,0,0,209,0.25,0.017438825,3
2020-06-26-170204,170204,0,1,0,209,0.75,2.1742368e-05,4
2020-06-27-170204,170204,0,0,0,209,0.25,0.034802318,5
2020-06-28-170204,170204,0,0,0,209,0.0,4.919215e-07,6
2020-06-29-170204,170204,0,0,0,209,0.0,2.2935149e-06,0
2020-06-30-170204,170204,0,0,0,209,0.75,0.12044064,1
2020-07-01-170204,170204,0,0,0,209,0.75,0.16821487,2
2020-07-02-170204,170204,0,0,0,209,0.0,0.007249691,3
2020-07-03-170204,170204,0,0,1,209,1.25,0.0001894509,4
2020-07-04-170204,170204,0,0,0,209,0.0,0.0003019297,5
2020-07-05-170204,170204,0,0,0,209,0.0,0.0007263915,6
2020-07-06-170204,170204,0,0,1,209,0.75,5.4409516e-05,0
2020-07-07-170204,170204,0,0,0,209,0.0,0.03848612,1
2020-07-08-170204,170204,0,0,0,209,1.0,0.15663423,2
2020-07-09-170204,170204,0,0,0,209,1.0,0.1682766,3
2020-07-10-170204,170204,0,0,0,209,0.25,4.4829005e-05,4
2020-07-11-170204,170204,0,0,0,209,0.25,0.0021937802,5
2020-07-12-170204,170204,0,0,0,209,0.0,0.00687825,6
2020-07-13-170204,170204,0,0,0,209,0.0,3.6345982e-06,0
2020-07-14-170204,170204,0,0,0,209,0.25,0.08131167,1
2020-07-15-170204,170204,0,0,0,209,0.25,0.02791753,2
2020-07-16-170204,170204,0,0,0,209,0.5,0.08667044,3
2020-07-17-170204,170204,1,0,0,210,0.0,9.51497e-06,4
2020-07-18-170204,170204,0,0,0,210,0.5,0.12633304,5
2020-07-19-170204,170204,0,0,0,210,0.0,0.017883766,6
2020-07-20-170204,170204,1,0,2,211,0.0,7.783372e-06,0
2020-07-21-170204,170204,0,0,1,211,0.0,0.019522674,1
2020-07-22-170204,170204,0,0,10,211,0.25,0.0020319084,2
2020-07-23-170204,170204,0,0,3,211,1.0,0.04727549,3
2020-07-24-170204,170204,0,0,10,211,0.75,6.5096165e-06,4
2020-07-25-170204,170204,0,0,1,211,0.5,0.0040291105,5
2020-07-26-170204,170204,0,0,1,211,1.25,0.0081469305,6
2020-07-27-170204,170204,0,0,0,211,0.25,2.8333969e-05,0
2020-07-28-170204,170204,0,0,2,211,0.5,0.1143217,1
2020-07-29-170204,170204,0,0,4,211,1.0,0.1484657,2
2020-07-30-170204,170204,0,0,4,211,1.75,0.14812824,3
2020-07-31-170204,170204,0,0,0,211,1.0,4.2423242e-05,4
2020-08-01-170204,170204,0,0,1,211,0.5,0.022442149,5
2020-08-02-170204,170204,0,0,1,211,0.5,0.09397164,6
2020-08-03-170204,170204,2,0,4,213,0.5,8.6425855e-05,0
2020-08-04-170204,170204,1,0,8,214,1.0,0.2921756,1
2020-08-05-170204,170204,10,0,2,224,1.25,1.3985193,2
2020-08-06-170204,170204,3,0,0,227,1.0,0.7026658,3
2020-08-07-170204,170204,10,0,2,237,0.75,7.346386e-05,4
2020-08-08-170204,170204,1,0,2,238,2.25,0.34800285,5
2020-08-09-170204,170204,1,0,0,239,0.0,0.5518474,6
2020-08-10-170204,170204,0,0,1,239,4.0,0.00028719183,0
2020-08-11-170204,170204,2,0,1,241,2.0,0.6604349,1
2020-08-12-170204,170204,4,0,0,245,3.0,0.40736005,2
2020-08-13-170204,170204,4,0,1,249,2.75,0.7427397,3
2020-08-14-170204,170204,0,0,0,249,2.5,0.0002844981,4
2020-08-15-170204,170204,1,0,0,250,1.0,0.1806044,5
2020-08-16-170204,170204,1,0,0,251,2.5,0.28982314,6
2020-08-17-170204,170204,4,0,0,255,4.0,0.00015415272,0
2020-08-18-170204,170204,8,0,1,263,3.25,0.00045973837,1
2020-08-19-170204,170204,2,0,2,265,4.5,0.5866286,2
2020-08-20-170204,170204,0,0,0,265,4.5,0.31353056,3
2020-08-21-170204,170204,2,0,0,267,4.25,0.0005943376,4
2020-08-22-170204,170204,2,0,1,269,2.5,0.3153616,5
2020-08-23-170204,170204,0,0,0,269,0.75,0.07285444,6
2020-08-24-170204,170204,1,0,3,270,5.0,0.00030242075,0
2020-08-25-170204,170204,1,0,1,271,4.5,0.36839718,1
2020-08-26-170204,170204,0,0,3,271,3.25,0.109493606,2
2020-08-27-170204,170204,1,0,1,272,4.0,0.37909666,3
2020-08-28-170204,170204,0,0,0,272,4.0,0.00019973288,4
2020-08-29-170204,170204,0,0,0,272,1.0,0.17032771,5
2020-08-30-170204,170204,0,0,0,272,3.25,2.5109892e-05,6
2020-08-31-170204,170204,0,0,0,272,1.25,0.00023874287,0
2020-09-01-170204,170204,1,0,3,273,4.5,0.0001652855,1
2020-09-02-170204,170204,2,0,0,275,5.0,0.3505073,2
2020-09-03-170204,170204,0,0,3,275,3.75,0.29500648,3
2020-09-04-170204,170204,0,0,0,275,3.5,0.00012732715,4
2020-09-05-170204,170204,1,0,0,276,3.0,0.5261496,5
2020-09-06-170204,170204,0,0,1,276,1.0,8.524198e-05,6
2020-09-07-170204,170204,3,0,4,279,6.25,0.00012145545,0
2020-09-08-170204,170204,1,0,3,280,3.0,0.7467123,1
2020-09-09-170204,170204,3,0,4,283,4.0,0.35501942,2
2020-09-10-170204,170204,1,0,2,284,4.0,0.00016992979,3
2020-09-11-170204,170204,0,0,2,284,5.5,0.00017305154,4
2020-09-12-170204,170204,0,0,0,284,5.25,0.27159047,5
2020-09-13-170204,170204,0,0,0,284,3.25,8.043225e-05,6
2020-09-14-170204,170204,0,0,1,284,6.25,7.626648e-05,0
2020-09-15-170204,170204,3,0,3,287,12.5,0.73902124,1
2020-09-16-170204,170204,0,0,3,287,10.25,0.2428444,2
2020-09-17-170204,170204,3,0,1,290,11.5,0.41675884,3
2020-09-18-170204,170204,0,0,1,290,11.5,0.00023501308,4
2020-09-19-170204,170204,0,0,0,290,3.25,0.008122532,5
2020-09-20-170204,170204,1,0,0,291,3.25,3.7212667e-05,6
2020-09-21-170204,170204,4,0,2,295,16.75,0.00016640211,0
2020-09-22-170204,170204,3,1,1,298,11.75,0.43976942,1
2020-09-23-170204,170204,4,0,2,302,10.75,0.39459422,2
2020-09-24-170204,170204,2,0,2,304,11.75,0.1518599,3
2020-09-25-170204,170204,2,0,2,306,22.25,0.000115723895,4
2020-09-26-170204,170204,0,0,1,306,4.0,0.46172306,5
2020-09-27-170204,170204,0,0,0,306,2.25,0.08811608,6
2020-09-28-170204,170204,1,0,4,307,12.25,0.00013885782,0
2020-09-29-170204,170204,3,0,4,310,8.25,0.3755161,1
2020-09-30-170204,170204,3,0,6,313,9.0,0.6811227,2
2020-10-01-170204,170204,1,0,14,314,15.0,0.5371882,3
2020-10-02-170204,170204,1,0,12,315,10.25,0.00014510793,4
2020-10-03-170204,170204,0,0,3,315,3.0,0.074914694,5
2020-10-04-170204,170204,0,0,3,315,4.5,0.1405303,6
2020-10-05-170204,170204,2,1,12,317,6.5,0.00019492119,0
2020-10-06-170204,170204,1,0,9,318,7.25,0.6603374,1
2020-10-07-170204,170204,2,0,11,320,8.75,0.7514281,2
2020-10-08-170204,170204,2,0,9,322,7.25,0.590727,3
2020-10-09-170204,170204,2,0,6,324,4.25,0.00014915084,4
2020-10-10-170204,170204,1,0,11,325,1.25,0.2206149,5
2020-10-11-170204,170204,0,0,11,325,0.75,0.06622163,6
2020-10-12-170204,170204,4,0,3,329,2.75,5.3755048e-05,0
2020-10-13-170204,170204,4,0,5,333,8.25,0.52508444,1
2020-10-14-170204,170204,6,0,4,339,6.5,1.1259383,2
2020-10-15-170204,170204,14,0,4,353,5.0,4.5894904,3
2020-10-16-170204,170204,12,0,3,365,7.5,0.00041188023,4
2020-10-17-170204,170204,3,0,2,368,2.5,0.52308345,5
2020-10-18-170204,170204,3,0,2,371,0.75,0.48830283,6
2020-10-19-170204,170204,12,0,0,383,6.5,0.00025614642,0
2020-10-20-170204,170204,9,0,1,392,4.75,0.9209619,1
2020-10-21-170204,170204,11,0,3,403,7.75,2.0518794,2
2020-10-22-170204,170204,9,0,0,412,8.5,1.7304415,3
2020-10-23-170204,170204,6,0,2,418,8.0,0.00023051164,4
2020-10-24-170204,170204,11,3,1,429,2.0,0.98978007,5
2020-10-25-170204,170204,11,1,0,440,6.0,0.40406522,6
2020-10-26-170204,170204,3,1,3,443,7.5,0.0003412013,0
2020-10-27-170204,170204,5,0,1,448,7.0,0.00034168764,1
2020-10-28-170204,170204,4,0,1,452,13.5,1.3111371,2
2020-10-29-170204,170204,4,0,1,456,8.75,0.949066,3
2020-10-30-170204,170204,3,0,1,459,8.75,0.00057140813,4
2020-10-31-170204,170204,2,0,0,461,5.75,0.0005435761,5
2020-11-01-170204,170204,2,0,0,463,2.75,0.3244281,6
2020-11-02-170204,170204,0,0,0,463,4.75,0.00013953944,0
2020-11-03-170204,170204,1,0,0,464,7.25,0.00034987702,1
2020-11-04-170204,170204,3,1,0,467,5.25,0.787934,2
2020-11-05-170204,170204,0,2,0,467,4.25,0.5635053,3
2020-11-06-170204,170204,2,0,0,469,6.25,0.00038145762,4
2020-11-07-170204,170204,1,0,0,470,4.75,0.00016598337,5
2020-11-08-170204,170204,0,1,0,470,6.0,0.0003607562,6
2020-11-09-170204,170204,3,0,0,473,9.0,0.00027915326,0
2020-11-10-170204,170204,1,1,0,474,9.75,0.00051391067,1
2020-11-11-170204,170204,1,0,0,475,4.25,0.56292546,2
2020-11-12-170204,170204,1,1,0,476,7.75,0.00035479313,3
2020-11-13-170204,170204,1,0,0,477,7.5,0.00043006183,4
2020-03-01-170205,170205,0,0,1,0,0.0,4.5653946e-06,6
2020-03-02-170205,170205,0,0,0,0,0.14285714285714285,0.09110548,0
2020-03-03-170205,170205,0,0,2,0,0.2857142857142857,0.1475948,1
2020-03-04-170205,170205,0,0,4,0,0.14285714285714285,0.06193097,2
2020-03-05-170205,170205,0,2,8,0,0.0,0.00013909326,3
2020-03-06-170205,170205,0,0,8,0,0.2857142857142857,0.07257206,4
2020-03-07-170205,170205,0,0,6,0,1.0,0.12551914,5
2020-03-08-170205,170205,0,0,1,0,0.14285714285714285,0.016077513,6
2020-03-09-170205,170205,2,0,18,2,0.42857142857142855,1.0409662,0
2020-03-10-170205,170205,0,0,18,2,2.0,0.26850668,1
2020-03-11-170205,170205,1,0,12,3,0.14285714285714285,0.5035774,2
2020-03-12-170205,170205,0,0,8,3,0.7142857142857143,0.23254134,3
2020-03-13-170205,170205,2,0,9,5,1.1428571428571428,1.2844718,4
2020-03-14-170205,170205,1,0,6,6,1.7142857142857142,1.0211867,5
2020-03-15-170205,170205,1,0,1,7,0.5714285714285714,0.44064316,6
2020-03-16-170205,170205,0,0,11,7,3.2857142857142856,0.626453,0
2020-03-17-170205,170205,2,0,8,9,3.2857142857142856,1.583,1
2020-03-18-170205,170205,4,1,8,13,4.0,2.4661248,2
2020-03-19-170205,170205,8,0,13,21,5.0,4.4554806,3
2020-03-20-170205,170205,8,1,11,29,5.428571428571429,4.125207,4
2020-03-21-170205,170205,6,0,1,35,2.0,2.093807,5
2020-03-22-170205,170205,1,0,1,36,2.7142857142857144,0.47448295,6
2020-03-23-170205,170205,18,0,8,54,6.571428571428571,7.874386,0
2020-03-24-170205,170205,18,1,7,72,5.428571428571429,7.822199,1
2020-03-25-170205,170205,12,0,3,84,6.0,6.817169,2
2020-03-26-170205,170205,8,0,11,92,5.428571428571429,3.8806343,3
2020-03-27-170205,170205,9,0,3,101,3.7142857142857135,4.251407,4
2020-03-28-170205,170205,6,0,1,107,1.5714285714285714,2.3513093,5
2020-03-29-170205,170205,1,0,0,108,0.5714285714285714,0.38744035,6
2020-03-30-170205,170205,11,0,7,119,5.0,4.639153,0
2020-03-31-170205,170205,8,0,3,127,3.2857142857142856,4.0926027,1
2020-04-01-170205,170205,8,0,3,135,2.7142857142857144,3.1273522,2
2020-04-02-170205,170205,13,0,4,148,2.4285714285714284,5.4726615,3
2020-04-03-170205,170205,11,0,2,159,3.571428571428572,6.813025,4
2020-04-04-170205,170205,1,0,1,160,1.0,0.46674305,5
2020-04-05-170205,170205,1,0,2,161,1.0,0.53640306,6
2020-04-06-170205,170205,8,0,3,169,3.571428571428572,4.276932,0
2020-04-07-170205,170205,7,0,2,176,2.8571428571428568,3.502543,1
2020-04-08-170205,170205,3,1,4,179,2.7142857142857144,1.4111165,2
2020-04-09-170205,170205,11,2,0,190,2.142857142857143,4.262902,3
2020-04-10-170205,170205,3,2,2,193,1.2857142857142858,1.068951,4
2020-04-11-170205,170205,1,0,0,194,0.8571428571428571,0.47518635,5
2020-04-12-170205,170205,0,0,2,194,0.14285714285714285,0.015525712,6
2020-04-13-170205,170205,7,0,1,201,1.1428571428571428,3.2461646,0
2020-04-14-170205,170205,3,0,1,204,1.4285714285714286,1.6128937,1
2020-04-15-170205,170205,3,0,1,207,2.142857142857143,2.164326,2
2020-04-16-170205,170205,4,0,0,211,2.2857142857142856,2.5755184,3
2020-04-17-170205,170205,2,0,1,213,1.7142857142857142,1.0975448,4
2020-04-18-170205,170205,1,0,0,214,0.42857142857142855,0.42366612,5
2020-04-19-170205,170205,2,0,0,216,0.14285714285714285,0.68318737,6
2020-04-20-170205,170205,3,1,2,219,1.8571428571428568,1.8431622,0
2020-04-21-170205,170205,2,0,3,221,1.5714285714285714,1.1856686,1
2020-04-22-170205,170205,4,1,2,225,0.5714285714285714,1.7263875,2
2020-04-23-170205,170205,0,0,0,225,0.42857142857142855,0.030637352,3
2020-04-24-170205,170205,2,0,1,227,0.7142857142857143,0.9899373,4
2020-04-25-170205,170205,0,0,0,227,0.8571428571428571,0.05533934,5
2020-04-26-170205,170205,2,0,2,229,0.7142857142857143,0.65271497,6
2020-04-27-170205,170205,1,0,1,230,0.8571428571428571,0.6418713,0
2020-04-28-170205,170205,1,0,1,231,2.4285714285714284,0.88900864,1
2020-04-29-170205,170205,1,0,2,232,1.2857142857142858,0.83422667,2
2020-04-30-170205,170205,0,1,2,232,0.8571428571428571,0.12624496,3
2020-05-01-170205,170205,1,0,2,233,0.5714285714285714,0.21059904,4
2020-05-02-170205,170205,0,0,0,233,0.5714285714285714,0.055586588,5
2020-05-03-170205,170205,0,0,0,233,0.14285714285714285,0.013793259,6
2020-05-04-170205,170205,2,0,2,235,1.2857142857142858,1.0086294,0
2020-05-05-170205,170205,3,0,0,238,1.1428571428571428,1.6691515,1
2020-05-06-170205,170205,2,0,1,240,1.2857142857142858,1.185048,2
2020-05-07-170205,170205,0,0,1,240,2.7142857142857144,0.5195311,3
2020-05-08-170205,170205,1,0,1,241,1.1428571428571428,0.81475663,4
2020-05-09-170205,170205,0,0,0,241,0.14285714285714285,0.00836308,5
2020-05-10-170205,170205,2,0,0,243,0.0,0.7399426,6
2020-05-11-170205,170205,1,0,2,244,1.8571428571428568,0.7808046,0
2020-05-12-170205,170205,1,0,0,245,1.2857142857142858,0.7262652,1
2020-05-13-170205,170205,2,0,0,247,3.1428571428571432,1.754933,2
2020-05-14-170205,170205,2,0,0,249,2.2857142857142856,1.353307,3
2020-05-15-170205,170205,2,0,1,251,1.4285714285714286,1.1852642,4
2020-05-16-170205,170205,0,0,0,251,0.0,6.2958774e-05,5
2020-05-17-170205,170205,0,0,0,251,0.0,0.0038251225,6
2020-05-18-170205,170205,2,0,2,253,1.4285714285714286,1.3829461,0
2020-05-19-170205,170205,0,0,0,253,0.7142857142857143,0.17065144,1
2020-05-20-170205,170205,1,0,1,254,0.8571428571428571,0.7599969,2
2020-05-21-170205,170205,1,0,1,255,1.2857142857142858,0.9497039,3
2020-05-22-170205,170205,1,0,1,256,1.0,0.78009,4
2020-05-23-170205,170205,0,0,0,256,0.14285714285714285,0.0036341515,5
2020-05-24-170205,170205,0,0,0,256,0.0,0.00010317038,6
2020-05-25-170205,170205,2,0,1,258,1.2857142857142858,1.4614933,0
2020-05-26-170205,170205,0,0,0,258,1.2857142857142858,0.22078693,1
2020-05-27-170205,170205,0,0,2,258,1.2857142857142858,0.20505758,2
2020-05-28-170205,170205,0,1,1,258,1.0,0.27075472,3
2020-05-29-170205,170205,1,1,3,259,0.8571428571428571,0.74289995,4
2020-05-30-170205,170205,0,0,0,259,0.0,0.00048626467,5
2020-05-31-170205,170205,0,0,0,259,0.14285714285714285,0.00434274,6
2020-06-01-170205,170205,2,0,0,261,1.2857142857142858,1.1488173,0
2020-06-02-170205,170205,0,0,1,261,0.5714285714285714,0.17310126,1
2020-06-03-170205,170205,1,1,0,262,0.8571428571428571,0.8174591,2
2020-06-04-170205,170205,1,0,1,263,1.0,0.677207,3
2020-06-05-170205,170205,1,0,0,264,0.2857142857142857,0.6128104,4
2020-06-06-170205,170205,0,1,0,264,0.2857142857142857,0.014839342,5
2020-06-07-170205,170205,0,0,0,264,0.14285714285714285,0.0031284997,6
2020-06-08-170205,170205,1,0,0,265,0.5714285714285714,0.61684036,0
2020-06-09-170205,170205,0,0,0,265,0.14285714285714285,0.028191527,1
2020-06-10-170205,170205,2,0,0,267,0.42857142857142855,1.2892162,2
2020-06-11-170205,170205,1,0,0,268,0.5714285714285714,0.6447197,3
2020-06-12-170205,170205,3,0,0,271,0.2857142857142857,1.441186,4
2020-06-13-170205,170205,0,0,0,271,0.0,0.007918006,5
2020-06-14-170205,170205,0,0,0,271,0.2857142857142857,0.068758994,6
2020-06-15-170205,170205,0,0,0,271,0.14285714285714285,0.024381364,0
2020-06-16-170205,170205,1,0,1,272,0.42857142857142855,0.68645555,1
2020-06-17-170205,170205,0,0,2,272,0.2857142857142857,0.09063977,2
2020-06-18-170205,170205,1,0,0,273,0.0,0.6167153,3
2020-06-19-170205,170205,0,0,4,273,0.14285714285714285,0.018290732,4
2020-06-20-170205,170205,0,0,0,273,0.0,0.006685491,5
2020-06-21-170205,170205,0,0,0,273,0.2857142857142857,0.10319353,6
2020-06-22-170205,170205,0,0,0,273,0.0,0.023603177,0
2020-06-23-170205,170205,0,0,0,273,0.2857142857142857,0.12952924,1
2020-06-24-170205,170205,0,0,2,273,0.14285714285714285,0.1627088,2
2020-06-25-170205,170205,0,1,2,273,0.14285714285714285,0.02057525,3
2020-06-26-170205,170205,0,0,1,273,0.42857142857142855,0.12702726,4
2020-06-27-170205,170205,0,0,0,273,0.14285714285714285,0.08295588,5
2020-06-28-170205,170205,0,0,0,273,0.0,0.00035315854,6
2020-06-29-170205,170205,0,0,0,273,0.0,0.029793601,0
2020-06-30-170205,170205,1,0,1,274,0.2857142857142857,0.81325,1
2020-07-01-170205,170205,2,0,0,276,0.14285714285714285,1.4655895,2
2020-07-02-170205,170205,0,0,0,276,0.14285714285714285,0.017802503,3
2020-07-03-170205,170205,4,0,0,280,0.14285714285714285,2.8094625,4
2020-07-04-170205,170205,0,0,1,280,0.14285714285714285,0.0008031296,5
2020-07-05-170205,170205,0,0,0,280,0.2857142857142857,0.014243008,6
2020-07-06-170205,170205,0,0,0,280,0.5714285714285714,0.1390947,0
2020-07-07-170205,170205,0,0,0,280,0.14285714285714285,0.06713247,1
2020-07-08-170205,170205,2,0,0,282,0.42857142857142855,1.5192212,2
2020-07-09-170205,170205,2,0,0,284,0.42857142857142855,1.4343673,3
2020-07-10-170205,170205,1,4,0,285,0.0,0.6711164,4
2020-07-11-170205,170205,0,0,0,285,0.14285714285714285,0.025549283,5
2020-07-12-170205,170205,0,0,0,285,0.0,0.03305131,6
2020-07-13-170205,170205,0,0,0,285,0.0,0.009287016,0
2020-07-14-170205,170205,1,0,1,286,0.14285714285714285,0.7945287,1
2020-07-15-170205,170205,0,0,1,286,0.5714285714285714,0.13285768,2
2020-07-16-170205,170205,0,0,1,286,0.2857142857142857,0.84077495,3
2020-07-17-170205,170205,0,0,0,286,0.14285714285714285,0.030064953,4
2020-07-18-170205,170205,1,0,0,287,0.14285714285714285,0.93473846,5
2020-07-19-170205,170205,0,0,0,287,0.14285714285714285,0.20374763,6
2020-07-20-170205,170205,0,0,2,287,0.5714285714285714,0.047785528,0
2020-07-21-170205,170205,0,0,0,287,0.14285714285714285,0.16133879,1
2020-07-22-170205,170205,0,0,2,287,0.14285714285714285,0.021774994,2
2020-07-23-170205,170205,0,0,3,287,0.5714285714285714,0.1533457,3
2020-07-24-170205,170205,0,0,0,287,0.5714285714285714,0.072251126,4
2020-07-25-170205,170205,0,0,1,287,0.42857142857142855,0.073503695,5
2020-07-26-170205,170205,0,0,0,287,0.5714285714285714,0.10827486,6
2020-07-27-170205,170205,0,0,2,287,0.2857142857142857,0.103797525,0
2020-07-28-170205,170205,1,0,1,288,0.7142857142857143,0.8709738,1
2020-07-29-170205,170205,1,0,0,289,0.5714285714285714,1.0033256,2
2020-07-30-170205,170205,1,0,0,290,1.0,0.34421507,3
2020-07-31-170205,170205,0,0,0,290,1.1428571428571428,0.21252668,4
2020-08-01-170205,170205,0,0,1,290,0.5714285714285714,0.12979145,5
2020-08-02-170205,170205,0,1,0,290,1.0,0.3914021,6
2020-08-03-170205,170205,2,0,1,292,1.2857142857142858,1.1041934,0
2020-08-04-170205,170205,0,0,6,292,2.0,1.199086,1
2020-08-05-170205,170205,2,0,3,294,3.2857142857142856,3.831864,2
2020-08-06-170205,170205,3,0,0,297,2.2857142857142856,3.103418,3
2020-08-07-170205,170205,0,0,5,297,3.1428571428571432,0.5828752,4
2020-08-08-170205,170205,1,0,0,298,1.5714285714285714,1.4866217,5
2020-08-09-170205,170205,0,0,0,298,1.0,0.85399944,6
2020-08-10-170205,170205,2,0,3,300,2.4285714285714284,2.2086606,0
2020-08-11-170205,170205,1,0,2,301,3.4285714285714284,1.7984936,1
2020-08-12-170205,170205,0,0,0,301,4.0,1.0337934,2
2020-08-13-170205,170205,0,0,1,301,3.2857142857142856,2.147199,3
2020-08-14-170205,170205,0,0,2,301,1.1428571428571428,0.37671062,4
2020-08-15-170205,170205,1,0,1,302,1.1428571428571428,1.0709225,5
2020-08-16-170205,170205,0,0,0,302,1.0,0.6353827,6
2020-08-17-170205,170205,1,0,4,303,2.8571428571428568,1.272106,0
2020-08-18-170205,170205,6,0,0,309,2.571428571428572,4.817225,1
2020-08-19-170205,170205,3,0,3,312,3.0,3.2735386,2
2020-08-20-170205,170205,0,0,1,312,4.285714285714286,0.974475,3
2020-08-21-170205,170205,5,0,1,317,3.2857142857142856,5.128954,4
2020-08-22-170205,170205,0,0,4,317,0.8571428571428571,0.6679887,5
2020-08-23-170205,170205,0,0,2,317,1.5714285714285714,0.2613608,6
2020-08-24-170205,170205,3,0,0,320,2.7142857142857144,3.8206317,0
2020-08-25-170205,170205,2,0,4,322,2.2857142857142856,1.6471559,1
2020-08-26-170205,170205,0,0,2,322,3.2857142857142856,0.51559323,2
2020-08-27-170205,170205,1,0,0,323,3.1428571428571432,2.2926095,3
2020-08-28-170205,170205,2,0,1,325,4.857142857142857,2.3723993,4
2020-08-29-170205,170205,1,0,1,326,0.5714285714285714,1.0096222,5
2020-08-30-170205,170205,0,0,0,326,2.7142857142857144,0.32559517,6
2020-08-31-170205,170205,4,0,0,330,0.7142857142857143,3.020599,0
2020-09-01-170205,170205,0,0,4,330,3.4285714285714284,0.9471502,1
2020-09-02-170205,170205,3,0,1,333,3.2857142857142856,2.0803185,2
2020-09-03-170205,170205,1,0,1,334,1.4285714285714286,1.7735282,3
2020-09-04-170205,170205,1,0,3,335,1.8571428571428568,1.1635882,4
2020-09-05-170205,170205,4,0,0,339,1.4285714285714286,4.2357583,5
2020-09-06-170205,170205,2,0,1,341,0.2857142857142857,1.1851972,6
2020-09-07-170205,170205,0,0,2,341,4.142857142857143,0.566149,0
2020-09-08-170205,170205,4,0,2,345,1.1428571428571428,3.6587386,1
2020-09-09-170205,170205,2,0,0,347,2.8571428571428568,2.042233,2
2020-09-10-170205,170205,0,0,0,347,2.8571428571428568,1.2122467,3
2020-09-11-170205,170205,1,0,2,348,4.142857142857143,1.4482607,4
2020-09-12-170205,170205,1,0,5,349,3.571428571428572,1.7027652,5
2020-09-13-170205,170205,0,0,0,349,2.4285714285714284,0.35230586,6
2020-09-14-170205,170205,0,0,0,349,4.714285714285714,0.5593049,0
2020-09-15-170205,170205,4,0,0,353,8.857142857142858,2.6857176,1
2020-09-16-170205,170205,1,0,3,354,6.857142857142858,1.3510687,2
2020-09-17-170205,170205,1,0,1,355,8.142857142857142,1.829909,3
2020-09-18-170205,170205,3,0,3,358,7.142857142857142,3.1456182,4
2020-09-19-170205,170205,0,0,0,358,2.2857142857142856,0.19734292,5
2020-09-20-170205,170205,1,0,1,359,3.0,0.35104287,6
2020-09-21-170205,170205,2,1,2,361,10.714285714285714,2.107253,0
2020-09-22-170205,170205,2,0,3,363,8.0,2.5556393,1
2020-09-23-170205,170205,0,1,3,363,7.7142857142857135,1.4092606,2
2020-09-24-170205,170205,0,0,1,363,8.0,1.0433036,3
2020-09-25-170205,170205,2,1,0,365,13.571428571428573,1.2129635,4
2020-09-26-170205,170205,5,0,0,370,1.8571428571428568,3.4040449,5
2020-09-27-170205,170205,0,0,0,370,1.4285714285714286,0.7032326,6
2020-09-28-170205,170205,0,1,0,370,7.2857142857142865,1.7277918,0
2020-09-29-170205,170205,0,1,1,370,5.428571428571429,1.3046693,1
2020-09-30-170205,170205,3,0,5,373,5.285714285714286,2.3919275,2
2020-10-01-170205,170205,1,0,1,374,9.285714285714286,2.2856576,3
2020-10-02-170205,170205,3,0,2,377,6.428571428571429,1.8741618,4
2020-10-03-170205,170205,0,0,0,377,1.7142857142857142,0.28977567,5
2020-10-04-170205,170205,1,0,1,378,2.571428571428572,0.77326953,6
2020-10-05-170205,170205,2,0,2,380,4.285714285714286,2.1484466,0
2020-10-06-170205,170205,3,2,2,383,5.428571428571429,2.9157708,1
2020-10-07-170205,170205,3,0,4,386,5.0,3.23958,2
2020-10-08-170205,170205,1,0,5,387,4.285714285714286,2.8477254,3
2020-10-09-170205,170205,0,0,1,387,2.7142857142857144,0.74622685,4
2020-10-10-170205,170205,0,0,0,387,0.7142857142857143,0.46014518,5
2020-10-11-170205,170205,0,0,1,387,0.5714285714285714,0.16644418,6
2020-10-12-170205,170205,0,0,0,387,2.2857142857142856,0.29252806,0
2020-10-13-170205,170205,1,0,4,388,5.571428571428571,1.9091848,1
2020-10-14-170205,170205,5,0,5,393,3.1428571428571432,4.1605587,2
2020-10-15-170205,170205,1,0,4,394,5.142857142857143,6.57699,3
2020-10-16-170205,170205,2,0,4,396,5.7142857142857135,2.9117155,4
2020-10-17-170205,170205,0,0,5,396,1.8571428571428568,0.8357826,5
2020-10-18-170205,170205,1,0,0,397,1.1428571428571428,0.87512696,6
2020-10-19-170205,170205,2,0,0,399,5.142857142857143,2.25,0
2020-10-20-170205,170205,2,0,3,401,4.285714285714286,2.542338,1
2020-10-21-170205,170205,4,0,3,405,6.0,4.146985,2
2020-10-22-170205,170205,5,0,1,410,6.571428571428571,4.9140716,3
2020-10-23-170205,170205,1,0,3,411,6.142857142857142,1.4663393,4
2020-10-24-170205,170205,0,0,2,411,2.571428571428572,1.2118691,5
2020-10-25-170205,170205,1,0,1,412,4.714285714285714,1.4839891,6
2020-10-26-170205,170205,0,0,0,412,4.142857142857143,1.3161281,0
2020-10-27-170205,170205,4,1,4,416,4.571428571428571,3.099284,1
2020-10-28-170205,170205,5,0,4,421,4.714285714285714,5.319739,2
2020-10-29-170205,170205,4,1,1,425,4.142857142857143,3.8450196,3
2020-10-30-170205,170205,4,0,4,429,3.8571428571428568,4.096172,4
2020-10-31-170205,170205,5,0,0,434,1.4285714285714286,3.2780225,5
2020-11-01-170205,170205,0,1,0,434,1.4285714285714286,0.68149906,6
2020-11-02-170205,170205,0,0,0,434,2.8571428571428568,0.61963594,0
2020-11-03-170205,170205,3,0,0,437,4.0,2.5448,1
2020-11-04-170205,170205,3,1,0,440,3.2857142857142856,3.1568346,2
2020-11-05-170205,170205,1,0,0,441,2.142857142857143,1.6255809,3
2020-11-06-170205,170205,3,0,0,444,3.571428571428572,1.947747,4
2020-11-07-170205,170205,2,0,0,446,2.7142857142857144,1.4659078,5
2020-11-08-170205,170205,1,0,0,447,1.7142857142857142,1.09078,6
2020-11-09-170205,170205,0,0,0,447,6.2857142857142865,1.4675577,0
2020-11-10-170205,170205,4,0,0,451,5.0,2.9510946,1
2020-11-11-170205,170205,4,0,0,455,3.8571428571428568,3.1222858,2
2020-11-12-170205,170205,1,0,0,456,4.0,1.9579248,3
2020-11-13-170205,170205,4,0,0,460,5.285714285714286,3.1315343,4
2020-03-01-170206,170206,0,0,1,0,0.2,3.803613e-06,6
2020-03-02-170206,170206,0,0,10,0,0.0,0.004583622,0
2020-03-03-170206,170206,0,1,4,0,0.2,0.01464649,1
2020-03-04-170206,170206,0,1,19,0,0.2,0.15992613,2
2020-03-05-170206,170206,0,0,18,0,0.6,0.0010946542,3
2020-03-06-170206,170206,1,0,35,1,0.2,0.1847113,4
2020-03-07-170206,170206,0,0,7,1,0.2,0.0037277665,5
2020-03-08-170206,170206,0,0,10,1,0.2,0.0013210144,6
2020-03-09-170206,170206,0,1,22,1,0.4,0.30811223,0
2020-03-10-170206,170206,0,0,15,1,2.4,0.020319797,1
2020-03-11-170206,170206,1,0,21,2,1.6,0.07516281,2
2020-03-12-170206,170206,2,0,14,4,1.4,0.03696684,3
2020-03-13-170206,170206,1,0,31,5,3.6,0.25436875,4
2020-03-14-170206,170206,2,0,7,7,1.2,0.288589,5
2020-03-15-170206,170206,1,0,4,8,4.2,0.09116621,6
2020-03-16-170206,170206,10,0,23,18,10.4,0.19572634,0
2020-03-17-170206,170206,4,0,21,22,10.6,0.40670577,1
2020-03-18-170206,170206,19,0,13,41,20.2,0.5277593,2
2020-03-19-170206,170206,18,0,11,59,19.2,0.761724,3
2020-03-20-170206,170206,35,0,12,94,22.6,1.083433,4
2020-03-21-170206,170206,7,0,1,101,9.2,0.12971494,5
2020-03-22-170206,170206,10,0,1,111,9.6,0.10309692,6
2020-03-23-170206,170206,22,0,8,133,28.2,0.8758522,0
2020-03-24-170206,170206,15,0,11,148,21.4,0.78030294,1
2020-03-25-170206,170206,21,0,9,169,18.8,0.65223724,2
2020-03-26-170206,170206,14,0,4,183,19.0,0.67833465,3
2020-03-27-170206,170206,31,0,8,214,15.4,0.65189713,4
2020-03-28-170206,170206,7,0,2,221,7.6,0.08711768,5
2020-03-29-170206,170206,4,0,0,225,6.2,0.09729981,6
2020-03-30-170206,170206,23,0,7,248,16.2,0.48685443,0
2020-03-31-170206,170206,21,0,8,269,10.4,0.19896564,1
2020-04-01-170206,170206,13,0,9,282,12.4,0.26038808,2
2020-04-02-170206,170206,11,0,15,293,10.8,0.39453375,3
2020-04-03-170206,170206,12,0,2,305,12.6,0.4655825,4
2020-04-04-170206,170206,1,0,4,306,5.2,0.00202772,5
2020-04-05-170206,170206,1,0,3,307,3.2,0.052420516,6
2020-04-06-170206,170206,8,0,3,315,10.8,0.46054256,0
2020-04-07-170206,170206,11,10,8,326,7.4,0.4252774,1
2020-04-08-170206,170206,9,1,4,335,8.2,0.47170958,2
2020-04-09-170206,170206,4,0,3,339,5.8,0.51750255,3
2020-04-10-170206,170206,8,0,6,347,15.4,0.16602321,4
2020-04-11-170206,170206,2,0,2,349,5.8,0.12271331,5
2020-04-12-170206,170206,0,0,0,349,3.8,0.03481876,6
2020-04-13-170206,170206,7,0,8,356,10.2,0.32495806,0
2020-04-14-170206,170206,8,0,6,364,9.6,0.29808617,1
2020-04-15-170206,170206,9,0,5,373,15.6,0.48414594,2
2020-04-16-170206,170206,15,0,3,388,6.4,0.23200531,3
2020-04-17-170206,170206,2,0,2,390,17.8,0.20182124,4
2020-04-18-170206,170206,4,0,2,394,3.4,0.053244557,5
2020-04-19-170206,170206,3,0,0,397,5.2,0.17533869,6
2020-04-20-170206,170206,3,0,2,400,8.8,0.36856169,0
2020-04-21-170206,170206,8,0,1,408,6.4,0.2105712,1
2020-04-22-170206,170206,4,0,5,412,10.6,0.07320429,2
2020-04-23-170206,170206,3,0,3,415,3.6,0.005116748,3
2020-04-24-170206,170206,6,0,6,421,5.0,0.24451424,4
2020-04-25-170206,170206,2,0,0,423,2.0,0.09188928,5
2020-04-26-170206,170206,0,0,1,423,1.4,0.05865506,6
2020-04-27-170206,170206,8,0,5,431,6.0,0.26800805,0
2020-04-28-170206,170206,6,0,3,437,5.0,0.09883799,1
2020-04-29-170206,170206,5,0,7,442,5.2,0.27688396,2
2020-04-30-170206,170206,3,0,6,445,2.8,0.16920893,3
2020-05-01-170206,170206,2,0,11,447,1.2,0.0024034102,4
2020-05-02-170206,170206,2,0,5,449,1.6,0.062730856,5
2020-05-03-170206,170206,0,0,0,449,1.2,0.0024342814,6
2020-05-04-170206,170206,2,0,9,451,4.2,0.29390267,0
2020-05-05-170206,170206,1,0,4,452,4.4,0.20056324,1
2020-05-06-170206,170206,5,0,5,457,5.0,0.17559421,2
2020-05-07-170206,170206,3,0,4,460,3.2,0.15409298,3
2020-05-08-170206,170206,6,0,6,466,4.4,0.4317906,4
2020-05-09-170206,170206,0,0,1,466,0.4,0.002050528,5
2020-05-10-170206,170206,1,0,0,467,0.6,0.027536059,6
2020-05-11-170206,170206,5,0,11,472,7.0,0.19512708,0
2020-05-12-170206,170206,3,0,6,475,4.4,0.22290327,1
2020-05-13-170206,170206,7,0,5,482,8.4,0.45448187,2
2020-05-14-170206,170206,6,0,3,488,8.8,0.65580356,3
2020-05-15-170206,170206,11,0,0,499,6.6,0.25670987,4
2020-05-16-170206,170206,5,0,0,504,1.8,7.57755e-06,5
2020-05-17-170206,170206,0,0,0,504,0.0,0.0024194964,6
2020-05-18-170206,170206,9,0,0,513,5.8,0.29298228,0
2020-05-19-170206,170206,4,0,2,517,5.2,0.26548102,1
2020-05-20-170206,170206,5,0,1,522,4.4,0.17548533,2
2020-05-21-170206,170206,4,0,7,526,3.8,0.16808087,3
2020-05-22-170206,170206,6,0,7,532,3.4,0.09367953,4
2020-05-23-170206,170206,1,0,0,533,0.8,2.6676726e-05,5
2020-05-24-170206,170206,0,0,0,533,0.0,0.00017271806,6
2020-05-25-170206,170206,11,0,5,544,6.6,0.36071038,0
2020-05-26-170206,170206,6,0,2,550,3.6,0.18168686,1
2020-05-27-170206,170206,5,0,1,555,3.6,0.2157821,2
2020-05-28-170206,170206,3,0,2,558,2.8,0.45307562,3
2020-05-29-170206,170206,0,0,4,558,3.0,0.1060506,4
2020-05-30-170206,170206,0,0,0,558,0.0,0.00014976748,5
2020-05-31-170206,170206,0,0,0,558,0.0,0.0020117166,6
2020-06-01-170206,170206,0,2,1,558,3.6,0.016114501,0
2020-06-02-170206,170206,2,0,0,560,1.4,0.13360244,1
2020-06-03-170206,170206,1,0,0,561,2.4,0.034851,2
2020-06-04-170206,170206,7,0,0,568,1.6,0.07172747,3
2020-06-05-170206,170206,7,0,0,575,2.0,0.0998731,4
2020-06-06-170206,170206,0,0,1,575,1.6,0.016311733,5
2020-06-07-170206,170206,0,0,0,575,0.4,7.617461e-05,6
2020-06-08-170206,170206,5,0,1,580,2.2,0.20249698,0
2020-06-09-170206,170206,2,0,0,582,1.4,0.062370718,1
2020-06-10-170206,170206,1,0,0,583,2.8,0.020639295,2
2020-06-11-170206,170206,2,0,0,585,0.8,0.20949192,3
2020-06-12-170206,170206,4,0,2,589,1.4,0.16953154,4
2020-06-13-170206,170206,0,0,0,589,0.0,0.010287627,5
2020-06-14-170206,170206,0,1,0,589,0.0,0.0012137267,6
2020-06-15-170206,170206,1,0,0,590,1.8,0.014520214,0
2020-06-16-170206,170206,0,0,0,590,1.6,0.08498948,1
2020-06-17-170206,170206,0,0,0,590,2.2,0.21256225,2
2020-06-18-170206,170206,0,0,0,590,1.2,0.15073697,3
2020-06-19-170206,170206,0,0,0,590,0.2,0.0052445084,4
2020-06-20-170206,170206,1,0,0,591,0.2,0.0075384737,5
2020-06-21-170206,170206,0,0,2,591,0.4,0.015033912,6
2020-06-22-170206,170206,1,0,0,592,1.4,0.048577845,0
2020-06-23-170206,170206,0,0,0,592,1.2,0.26132625,1
2020-06-24-170206,170206,0,0,0,592,1.4,0.27851707,2
2020-06-25-170206,170206,0,1,1,592,2.2,0.064179316,3
2020-06-26-170206,170206,2,0,2,594,1.6,0.24360302,4
2020-06-27-170206,170206,0,0,0,594,0.0,0.17945282,5
2020-06-28-170206,170206,0,0,1,594,0.2,0.006893606,6
2020-06-29-170206,170206,0,0,0,594,0.2,0.002065555,0
2020-06-30-170206,170206,0,0,0,594,0.8,0.22816104,1
2020-07-01-170206,170206,0,0,1,594,1.0,0.012518638,2
2020-07-02-170206,170206,0,0,0,594,0.2,0.019339362,3
2020-07-03-170206,170206,0,0,3,594,0.6,0.19454192,4
2020-07-04-170206,170206,0,0,4,594,0.0,0.00060637755,5
2020-07-05-170206,170206,2,0,0,596,0.0,0.0019396937,6
2020-07-06-170206,170206,0,0,0,596,0.2,0.024190798,0
2020-07-07-170206,170206,0,0,0,596,0.6,0.14372699,1
2020-07-08-170206,170206,0,0,1,596,0.4,0.025426533,2
2020-07-09-170206,170206,1,0,1,597,0.2,0.031849388,3
2020-07-10-170206,170206,2,0,4,599,0.4,0.0135121895,4
2020-07-11-170206,170206,0,0,0,599,0.0,0.00095084857,5
2020-07-12-170206,170206,1,0,0,600,0.2,0.07308693,6
2020-07-13-170206,170206,0,0,1,600,0.8,0.00612523,0
2020-07-14-170206,170206,0,0,3,600,0.6,0.07325605,1
2020-07-15-170206,170206,1,0,0,601,3.4,0.15754606,2
2020-07-16-170206,170206,0,0,0,601,0.8,0.039124552,3
2020-07-17-170206,170206,3,0,4,604,1.6,0.08832502,4
2020-07-18-170206,170206,4,0,0,608,0.8,0.11974008,5
2020-07-19-170206,170206,0,0,0,608,0.6,0.026776424,6
2020-07-20-170206,170206,0,0,3,608,1.2,0.054711137,0
2020-07-21-170206,170206,0,1,4,608,1.0,0.010746592,1
2020-07-22-170206,170206,1,0,3,609,0.8,0.01856471,2
2020-07-23-170206,170206,1,0,3,610,0.8,0.16020629,3
2020-07-24-170206,170206,4,0,2,614,0.4,0.013580329,4
2020-07-25-170206,170206,0,0,4,614,0.4,0.0049616215,5
2020-07-26-170206,170206,0,0,0,614,0.2,0.0028248704,6
2020-07-27-170206,170206,1,0,1,615,3.6,0.3053047,0
2020-07-28-170206,170206,3,0,1,618,1.2,0.06534019,1
2020-07-29-170206,170206,0,0,5,618,2.2,0.30123582,2
2020-07-30-170206,170206,0,0,3,618,3.6,0.670446,3
2020-07-31-170206,170206,4,1,2,622,3.8,0.4950804,4
2020-08-01-170206,170206,0,0,3,622,0.8,0.14220886,5
2020-08-02-170206,170206,0,0,2,622,0.0,0.43429795,6
2020-08-03-170206,170206,3,0,2,625,2.8,0.19114232,0
2020-08-04-170206,170206,4,0,4,629,1.4,0.9673527,1
2020-08-05-170206,170206,3,0,3,632,3.0,1.1348296,2
2020-08-06-170206,170206,3,0,2,635,3.4,0.27975437,3
2020-08-07-170206,170206,2,0,5,637,2.6,0.4925051,4
2020-08-08-170206,170206,4,0,0,641,2.0,0.5231892,5
2020-08-09-170206,170206,0,0,0,641,2.2,0.0364321,6
2020-08-10-170206,170206,1,0,10,642,3.0,0.9528674,0
2020-08-11-170206,170206,1,0,6,643,3.8,0.5553865,1
2020-08-12-170206,170206,5,0,1,648,4.4,1.1312611,2
2020-08-13-170206,170206,3,0,2,651,5.4,0.9122903,3
2020-08-14-170206,170206,2,0,5,653,3.0,0.56105,4
2020-08-15-170206,170206,3,0,2,656,2.6,0.19771594,5
2020-08-16-170206,170206,2,0,1,658,0.8,0.69423336,6
2020-08-17-170206,170206,2,0,8,660,2.4,0.48103744,0
2020-08-18-170206,170206,4,0,5,664,5.8,1.1341211,1
2020-08-19-170206,170206,3,0,6,667,3.6,0.6882817,2
2020-08-20-170206,170206,2,0,4,669,2.6,0.7640512,3
2020-08-21-170206,170206,5,0,2,674,3.2,1.2010447,4
2020-08-22-170206,170206,0,0,2,674,2.8,0.6168135,5
2020-08-23-170206,170206,0,0,2,674,1.4,0.2765073,6
2020-08-24-170206,170206,10,0,3,684,8.0,0.89656174,0
2020-08-25-170206,170206,6,0,3,690,6.0,0.76639754,1
2020-08-26-170206,170206,1,0,3,691,6.0,0.514731,2
2020-08-27-170206,170206,2,0,2,693,6.4,0.53465027,3
2020-08-28-170206,170206,5,1,8,698,4.8,0.8866705,4
2020-08-29-170206,170206,2,0,2,700,0.6,0.26762497,5
2020-08-30-170206,170206,1,0,5,701,3.0,0.1253141,6
2020-08-31-170206,170206,8,0,6,709,5.2,0.31955826,0
2020-09-01-170206,170206,5,0,4,714,4.8,2.3515174,1
2020-09-02-170206,170206,6,0,3,720,6.4,0.71626836,2
2020-09-03-170206,170206,4,0,8,724,6.6,0.39327365,3
2020-09-04-170206,170206,2,0,0,726,7.4,0.504104,4
2020-09-05-170206,170206,2,1,1,728,3.8,0.13417475,5
2020-09-06-170206,170206,2,0,2,730,1.6,0.111646116,6
2020-09-07-170206,170206,3,0,3,733,5.6,0.31132698,0
2020-09-08-170206,170206,3,0,10,736,6.6,1.2887479,1
2020-09-09-170206,170206,3,0,5,739,6.4,0.47442377,2
2020-09-10-170206,170206,2,0,7,741,12.2,0.39925385,3
2020-09-11-170206,170206,8,0,1,749,8.4,0.9841971,4
2020-09-12-170206,170206,2,0,0,751,2.6,0.6451514,5
2020-09-13-170206,170206,5,0,1,756,2.8,0.25633278,6
2020-09-14-170206,170206,6,0,7,762,9.0,0.5238266,0
2020-09-15-170206,170206,4,0,2,766,15.2,1.6955918,1
2020-09-16-170206,170206,3,0,3,769,11.0,0.58030605,2
2020-09-17-170206,170206,8,0,5,777,15.0,0.60568565,3
2020-09-18-170206,170206,0,0,4,777,15.8,1.0562385,4
2020-09-19-170206,170206,1,2,3,778,2.8,0.01568444,5
2020-09-20-170206,170206,2,0,2,780,1.4,0.22183487,6
2020-09-21-170206,170206,3,0,4,783,18.0,0.56506586,0
2020-09-22-170206,170206,10,2,3,793,14.6,0.58761173,1
2020-09-23-170206,170206,5,1,5,798,15.8,0.7363297,2
2020-09-24-170206,170206,7,1,5,805,10.0,0.33585647,3
2020-09-25-170206,170206,1,0,17,806,15.8,0.93847454,4
2020-09-26-170206,170206,0,0,4,806,0.0,0.48516512,5
2020-09-27-170206,170206,1,0,3,807,1.4,0.12814224,6
2020-09-28-170206,170206,7,0,7,814,8.2,0.7456469,0
2020-09-29-170206,170206,2,0,13,816,3.8,0.9545795,1
2020-09-30-170206,170206,3,0,14,819,9.2,0.7247526,2
2020-10-01-170206,170206,5,0,16,824,8.0,0.5171125,3
2020-10-02-170206,170206,4,1,10,828,12.8,0.4752063,4
2020-10-03-170206,170206,3,0,5,831,3.0,0.44992974,5
2020-10-04-170206,170206,2,0,1,833,6.0,0.38433546,6
2020-10-05-170206,170206,4,0,13,837,6.8,1.5420693,0
2020-10-06-170206,170206,3,1,16,840,6.6,1.1645129,1
2020-10-07-170206,170206,5,0,19,845,10.4,2.2725496,2
2020-10-08-170206,170206,5,0,10,850,10.8,0.743776,3
2020-10-09-170206,170206,17,0,9,867,18.0,1.6152691,4
2020-10-10-170206,170206,4,0,2,871,2.2,0.30476388,5
2020-10-11-170206,170206,3,0,5,874,5.4,0.3238527,6
2020-10-12-170206,170206,7,0,23,881,6.2,0.48133045,0
2020-10-13-170206,170206,13,0,25,894,16.0,0.75158066,1
2020-10-14-170206,170206,14,0,22,908,11.4,1.4309628,2
2020-10-15-170206,170206,16,0,9,924,18.2,2.627557,3
2020-10-16-170206,170206,10,0,12,934,18.6,4.34853,4
2020-10-17-170206,170206,5,0,8,939,4.8,0.83123654,5
2020-10-18-170206,170206,1,0,27,940,4.2,0.28651103,6
2020-10-19-170206,170206,13,0,16,953,23.4,2.1776829,0
2020-10-20-170206,170206,16,0,26,969,17.0,1.6275172,1
2020-10-21-170206,170206,19,0,18,988,19.8,2.2946768,2
2020-10-22-170206,170206,10,0,20,998,17.8,2.5740995,3
2020-10-23-170206,170206,9,0,32,1007,18.6,1.9115747,4
2020-10-24-170206,170206,2,3,10,1009,5.8,0.68941784,5
2020-10-25-170206,170206,5,0,21,1014,9.2,0.5552407,6
2020-10-26-170206,170206,23,1,28,1037,30.2,2.3619838,0
2020-10-27-170206,170206,25,0,17,1062,19.2,2.3130338,1
2020-10-28-170206,170206,22,0,19,1084,21.2,2.6572692,2
2020-10-29-170206,170206,9,0,16,1093,22.4,1.7157736,3
2020-10-30-170206,170206,12,0,35,1105,24.8,2.4284751,4
2020-10-31-170206,170206,8,0,0,1113,9.6,0.9205367,5
2020-11-01-170206,170206,27,0,0,1140,19.8,0.7448532,6
2020-11-02-170206,170206,16,1,0,1156,12.6,1.0064662,0
2020-11-03-170206,170206,26,0,0,1182,25.4,1.9803789,1
2020-11-04-170206,170206,18,1,0,1200,28.4,2.2459805,2
2020-11-05-170206,170206,20,1,0,1220,26.4,1.6915463,3
2020-11-06-170206,170206,32,2,0,1252,37.2,1.8097287,4
2020-11-07-170206,170206,10,1,0,1262,13.2,1.0787868,5
2020-11-08-170206,170206,21,0,0,1283,16.0,1.0972463,6
2020-11-09-170206,170206,28,0,0,1311,29.0,3.2226605,0
2020-11-10-170206,170206,17,2,0,1328,21.2,1.9714528,1
2020-11-11-170206,170206,19,1,0,1347,18.4,1.3092437,2
2020-11-12-170206,170206,16,1,0,1363,27.0,2.8290403,3
2020-11-13-170206,170206,35,2,0,1398,25.6,2.0767217,4
2020-03-01-170207,170207,0,0,6,0,0.25,8.663015e-06,6
2020-03-02-170207,170207,0,0,12,0,0.0,0.00190313,0
2020-03-03-170207,170207,0,0,11,0,0.0,0.0034670283,1
2020-03-04-170207,170207,0,0,23,0,0.25,0.06451101,2
2020-03-05-170207,170207,0,0,26,0,0.5,0.00011948274,3
2020-03-06-170207,170207,0,2,26,0,0.5,0.06478003,4
2020-03-07-170207,170207,0,0,8,0,0.25,0.00076791464,5
2020-03-08-170207,170207,0,0,6,0,0.25,0.00041092667,6
2020-03-09-170207,170207,0,0,26,0,0.75,0.13656761,0
2020-03-10-170207,170207,4,0,25,4,1.25,0.006606543,1
2020-03-11-170207,170207,0,0,22,4,2.0,0.03787561,2
2020-03-12-170207,170207,1,0,17,5,1.75,0.017670631,3
2020-03-13-170207,170207,0,1,13,5,2.0,0.110331185,4
2020-03-14-170207,170207,2,0,6,7,1.5,0.1362313,5
2020-03-15-170207,170207,6,0,8,13,2.5,0.041278116,6
2020-03-16-170207,170207,12,0,15,25,9.25,0.11200418,0
2020-03-17-170207,170207,11,0,15,36,7.25,0.22475205,1
2020-03-18-170207,170207,23,1,16,59,12.75,0.26721585,2
2020-03-19-170207,170207,26,0,12,85,14.75,0.36205322,3
2020-03-20-170207,170207,26,0,7,111,22.0,0.553184,4
2020-03-21-170207,170207,8,0,2,119,7.5,0.06185878,5
2020-03-22-170207,170207,6,0,1,125,8.5,0.04789591,6
2020-03-23-170207,170207,26,0,12,151,18.5,0.45353347,0
2020-03-24-170207,170207,25,0,8,176,15.5,0.39170834,1
2020-03-25-170207,170207,22,0,13,198,13.25,0.3683776,2
2020-03-26-170207,170207,17,0,6,215,15.5,0.3622988,3
2020-03-27-170207,170207,13,0,48,228,16.25,0.36233586,4
2020-03-28-170207,170207,6,0,1,234,5.75,0.037828542,5
2020-03-29-170207,170207,8,0,0,242,3.75,0.051035766,6
2020-03-30-170207,170207,15,0,15,257,11.75,0.27562788,0
2020-03-31-170207,170207,15,0,7,272,11.25,0.124414764,1
2020-04-01-170207,170207,16,0,12,288,9.0,0.13193294,2
2020-04-02-170207,170207,12,0,6,300,8.25,0.18556616,3
2020-04-03-170207,170207,7,0,5,307,10.75,0.22799782,4
2020-04-04-170207,170207,2,0,3,309,2.75,0.0023691058,5
2020-04-05-170207,170207,1,0,1,310,2.5,0.02925135,6
2020-04-06-170207,170207,12,0,3,322,9.0,0.24724583,0
2020-04-07-170207,170207,8,2,5,330,6.5,0.20552596,1
2020-04-08-170207,170207,13,0,3,343,6.75,0.22306558,2
2020-04-09-170207,170207,6,0,0,349,4.25,0.20805506,3
2020-04-10-170207,170207,48,1,4,397,5.75,0.080676004,4
2020-04-11-170207,170207,1,0,0,398,1.75,0.049308814,5
2020-04-12-170207,170207,0,0,1,398,1.0,0.017392555,6
2020-04-13-170207,170207,15,0,3,413,5.75,0.1600192,0
2020-04-14-170207,170207,7,0,2,420,7.5,0.13942556,1
2020-04-15-170207,170207,12,0,3,432,7.25,0.27926043,2
2020-04-16-170207,170207,6,0,1,438,6.5,0.12707905,3
2020-04-17-170207,170207,5,0,0,443,5.75,0.11109683,4
2020-04-18-170207,170207,3,0,2,446,2.75,0.027261855,5
2020-04-19-170207,170207,1,0,0,447,2.25,0.0836955,6
2020-04-20-170207,170207,3,0,3,450,5.25,0.22203423,0
2020-04-21-170207,170207,5,0,4,455,4.75,0.10474173,1
2020-04-22-170207,170207,3,0,4,458,3.5,0.046548907,2
2020-04-23-170207,170207,0,0,5,458,3.0,0.0011834978,3
2020-04-24-170207,170207,4,0,5,462,4.25,0.12448021,4
2020-04-25-170207,170207,0,0,2,462,1.75,0.05378105,5
2020-04-26-170207,170207,1,0,1,463,1.25,0.029072046,6
2020-04-27-170207,170207,3,1,11,466,5.75,0.16374788,0
2020-04-28-170207,170207,2,0,4,468,4.0,0.0498477,1
2020-04-29-170207,170207,3,0,9,471,3.5,0.1260541,2
2020-04-30-170207,170207,1,0,3,472,2.25,0.083032764,3
2020-05-01-170207,170207,0,0,9,472,0.75,0.0014187304,4
2020-05-02-170207,170207,2,0,4,474,0.5,0.03295622,5
2020-05-03-170207,170207,0,0,0,474,0.5,0.0014915816,6
2020-05-04-170207,170207,3,0,4,477,3.0,0.15852252,0
2020-05-05-170207,170207,4,0,2,481,2.25,0.10568638,1
2020-05-06-170207,170207,4,0,1,485,4.25,0.095751576,2
2020-05-07-170207,170207,5,0,4,490,2.25,0.07081251,3
2020-05-08-170207,170207,5,0,3,495,4.25,0.23147994,4
2020-05-09-170207,170207,2,0,1,497,0.0,0.0008280135,5
2020-05-10-170207,170207,1,0,0,498,0.25,0.0080576185,6
2020-05-11-170207,170207,11,1,7,509,4.5,0.10194822,0
2020-05-12-170207,170207,4,0,1,513,3.5,0.094629414,1
2020-05-13-170207,170207,9,0,1,522,6.75,0.25204605,2
2020-05-14-170207,170207,3,0,3,525,7.75,0.31522948,3
2020-05-15-170207,170207,9,0,2,534,6.0,0.14901812,4
2020-05-16-170207,170207,4,0,0,538,2.0,1.5903164e-05,5
2020-05-17-170207,170207,0,0,0,538,0.0,0.0011702476,6
2020-05-18-170207,170207,4,1,3,542,5.0,0.14649658,0
2020-05-19-170207,170207,2,0,0,544,4.75,0.12492798,1
2020-05-20-170207,170207,1,0,3,545,4.25,0.085864775,2
2020-05-21-170207,170207,4,0,2,549,3.75,0.091566175,3
2020-05-22-170207,170207,3,0,2,552,2.5,0.050968654,4
2020-05-23-170207,170207,1,0,1,553,0.25,3.4201887e-05,5
2020-05-24-170207,170207,0,0,0,553,0.0,0.00030213885,6
2020-05-25-170207,170207,7,0,3,560,6.5,0.16707247,0
2020-05-26-170207,170207,1,0,0,561,2.25,0.08981848,1
2020-05-27-170207,170207,1,0,1,562,4.0,0.09799797,2
2020-05-28-170207,170207,3,3,1,565,3.0,0.19797584,3
2020-05-29-170207,170207,2,1,4,567,1.0,0.050359227,4
2020-05-30-170207,170207,0,0,0,567,0.0,0.00022460679,5
2020-05-31-170207,170207,0,0,0,567,0.0,0.0006753172,6
2020-06-01-170207,170207,3,0,2,570,1.0,0.0066385698,0
2020-06-02-170207,170207,0,0,2,570,1.25,0.07771072,1
2020-06-03-170207,170207,3,0,5,573,1.5,0.016298534,2
2020-06-04-170207,170207,2,0,1,575,2.25,0.03790625,3
2020-06-05-170207,170207,2,0,0,577,2.25,0.04215819,4
2020-06-06-170207,170207,1,0,0,578,1.25,0.0089414455,5
2020-06-07-170207,170207,0,0,1,578,0.0,1.8055178e-05,6
2020-06-08-170207,170207,3,0,3,581,2.25,0.08730223,0
2020-06-09-170207,170207,0,0,2,581,1.25,0.026626773,1
2020-06-10-170207,170207,1,0,3,582,2.25,0.012420088,2
2020-06-11-170207,170207,1,0,6,583,1.5,0.0925986,3
2020-06-12-170207,170207,4,0,4,587,1.25,0.08237752,4
2020-06-13-170207,170207,0,0,0,587,0.0,0.004377451,5
2020-06-14-170207,170207,0,1,1,587,0.0,0.0005918547,6
2020-06-15-170207,170207,2,0,0,589,0.75,0.0048037227,0
2020-06-16-170207,170207,2,0,2,591,0.25,0.037873082,1
2020-06-17-170207,170207,5,0,2,596,1.25,0.09738457,2
2020-06-18-170207,170207,1,0,1,597,0.5,0.06099413,3
2020-06-19-170207,170207,0,0,0,597,0.25,0.0028947855,4
2020-06-20-170207,170207,0,0,0,597,0.25,0.004766064,5
2020-06-21-170207,170207,1,0,0,598,0.0,0.0061607775,6
2020-06-22-170207,170207,3,0,1,601,1.0,0.029194424,0
2020-06-23-170207,170207,2,0,1,603,0.75,0.116965875,1
2020-06-24-170207,170207,3,0,1,606,0.5,0.1175929,2
2020-06-25-170207,170207,6,0,0,612,0.5,0.028300641,3
2020-06-26-170207,170207,4,0,0,616,1.25,0.10145522,4
2020-06-27-170207,170207,0,0,0,616,0.25,0.06410557,5
2020-06-28-170207,170207,1,1,0,617,0.0,0.0008357455,6
2020-06-29-170207,170207,0,0,0,617,0.0,0.0020454603,0
2020-06-30-170207,170207,2,0,0,619,0.5,0.09150154,1
2020-07-01-170207,170207,2,0,1,621,0.5,0.00814877,2
2020-07-02-170207,170207,1,0,2,622,0.0,0.005651505,3
2020-07-03-170207,170207,0,0,0,622,0.25,0.07223609,4
2020-07-04-170207,170207,0,0,0,622,0.0,0.00023160831,5
2020-07-05-170207,170207,0,0,0,622,0.5,0.0007491877,6
2020-07-06-170207,170207,1,0,0,623,0.0,0.012484067,0
2020-07-07-170207,170207,1,0,2,624,0.25,0.059145026,1
2020-07-08-170207,170207,1,0,0,625,0.25,0.011111553,2
2020-07-09-170207,170207,0,0,1,625,0.75,0.016968057,3
2020-07-10-170207,170207,0,0,1,625,0.75,0.005194242,4
2020-07-11-170207,170207,0,0,0,625,0.0,0.0002598027,5
2020-07-12-170207,170207,0,0,0,625,0.25,0.03285466,6
2020-07-13-170207,170207,0,0,4,625,0.75,0.0027976627,0
2020-07-14-170207,170207,0,0,1,625,0.5,0.034090713,1
2020-07-15-170207,170207,1,0,3,626,3.75,0.06480773,2
2020-07-16-170207,170207,2,0,2,628,0.0,0.014155618,3
2020-07-17-170207,170207,0,0,5,628,1.25,0.036894623,4
2020-07-18-170207,170207,0,0,1,628,1.75,0.04274851,5
2020-07-19-170207,170207,0,0,0,628,0.5,0.01100332,6
2020-07-20-170207,170207,0,0,1,628,1.0,0.027594874,0
2020-07-21-170207,170207,2,0,2,630,0.5,0.0042878366,1
2020-07-22-170207,170207,0,0,1,630,0.75,0.0056658085,2
2020-07-23-170207,170207,1,0,2,631,0.5,0.06597435,3
2020-07-24-170207,170207,1,0,6,632,1.0,0.0056627677,4
2020-07-25-170207,170207,0,0,2,632,0.5,0.0013677602,5
2020-07-26-170207,170207,0,0,2,632,0.25,0.0018771238,6
2020-07-27-170207,170207,4,0,2,636,2.25,0.13797805,0
2020-07-28-170207,170207,1,0,6,637,1.0,0.032451905,1
2020-07-29-170207,170207,3,0,5,640,1.25,0.138473,2
2020-07-30-170207,170207,2,0,9,642,3.75,0.2817802,3
2020-07-31-170207,170207,5,0,4,647,2.75,0.20018312,4
2020-08-01-170207,170207,1,0,2,648,0.25,0.044804998,5
2020-08-02-170207,170207,0,0,1,648,0.25,0.18289211,6
2020-08-03-170207,170207,1,0,1,649,1.5,0.08497572,0
2020-08-04-170207,170207,2,0,2,651,2.75,0.40790057,1
2020-08-05-170207,170207,1,0,1,652,2.75,0.43227965,2
2020-08-06-170207,170207,2,0,3,654,2.75,0.12489387,3
2020-08-07-170207,170207,6,0,1,660,2.5,0.20588309,4
2020-08-08-170207,170207,2,0,2,662,1.75,0.19657749,5
2020-08-09-170207,170207,2,0,1,664,1.0,0.021899663,6
2020-08-10-170207,170207,2,0,4,666,3.25,0.39890084,0
2020-08-11-170207,170207,6,0,3,672,2.25,0.2349021,1
2020-08-12-170207,170207,5,0,4,677,3.75,0.4369699,2
2020-08-13-170207,170207,9,0,8,686,3.25,0.34921065,3
2020-08-14-170207,170207,4,0,4,690,0.75,0.22101198,4
2020-08-15-170207,170207,2,0,0,692,2.5,0.07361283,5
2020-08-16-170207,170207,1,0,0,693,1.25,0.25281435,6
2020-08-17-170207,170207,1,0,1,694,1.25,0.2046469,0
2020-08-18-170207,170207,2,0,0,696,4.5,0.50063896,1
2020-08-19-170207,170207,1,0,2,697,3.0,0.27661687,2
2020-08-20-170207,170207,3,0,4,700,2.0,0.3128572,3
2020-08-21-170207,170207,1,0,1,701,3.25,0.5015374,4
2020-08-22-170207,170207,2,0,2,703,0.75,0.22422269,5
2020-08-23-170207,170207,1,0,1,704,1.0,0.10841271,6
2020-08-24-170207,170207,4,0,7,708,6.75,0.36414537,0
2020-08-25-170207,170207,3,0,1,711,5.5,0.32093078,1
2020-08-26-170207,170207,4,0,3,715,5.5,0.21789277,2
2020-08-27-170207,170207,8,0,14,723,4.5,0.20365499,3
2020-08-28-170207,170207,4,0,10,727,5.75,0.37855414,4
2020-08-29-170207,170207,0,0,2,727,1.0,0.09890662,5
2020-08-30-170207,170207,0,0,1,727,2.25,0.052143015,6
2020-08-31-170207,170207,1,0,9,728,5.0,0.103461556,0
2020-09-01-170207,170207,0,0,7,728,6.25,0.9808845,1
2020-09-02-170207,170207,2,0,11,730,4.75,0.2899061,2
2020-09-03-170207,170207,4,0,9,734,4.5,0.15583917,3
2020-09-04-170207,170207,1,0,12,735,6.5,0.22228773,4
2020-09-05-170207,170207,2,0,1,737,3.25,0.046905115,5
2020-09-06-170207,170207,1,0,2,738,2.0,0.043358795,6
2020-09-07-170207,170207,7,0,20,745,2.0,0.15626794,0
2020-09-08-170207,170207,1,0,15,746,4.75,0.51229304,1
2020-09-09-170207,170207,3,0,12,749,3.5,0.19987316,2
2020-09-10-170207,170207,14,0,10,763,8.25,0.1735401,3
2020-09-11-170207,170207,10,0,15,773,7.25,0.37217999,4
2020-09-12-170207,170207,2,0,0,775,1.75,0.22280812,5
2020-09-13-170207,170207,1,0,1,776,2.0,0.10867147,6
2020-09-14-170207,170207,9,1,3,785,4.75,0.22599216,0
2020-09-15-170207,170207,7,0,2,792,14.0,0.6914113,1
2020-09-16-170207,170207,11,0,2,803,9.75,0.2769975,2
2020-09-17-170207,170207,9,0,10,812,13.0,0.2658146,3
2020-09-18-170207,170207,12,0,10,824,11.0,0.44070718,4
2020-09-19-170207,170207,1,0,0,825,2.5,0.0057227886,5
2020-09-20-170207,170207,2,0,2,827,1.25,0.08270444,6
2020-09-21-170207,170207,20,0,4,847,12.0,0.2558763,0
2020-09-22-170207,170207,15,1,4,862,13.0,0.25643826,1
2020-09-23-170207,170207,12,0,12,874,10.75,0.35779336,2
2020-09-24-170207,170207,10,0,10,884,7.75,0.14285143,3
2020-09-25-170207,170207,15,0,11,899,10.75,0.4053315,4
2020-09-26-170207,170207,0,0,2,899,0.75,0.1665913,5
2020-09-27-170207,170207,1,0,5,900,0.5,0.053357158,6
2020-09-28-170207,170207,3,0,5,903,7.0,0.33252287,0
2020-09-29-170207,170207,2,0,14,905,3.75,0.42502916,1
2020-09-30-170207,170207,2,0,16,907,4.75,0.29464173,2
2020-10-01-170207,170207,10,0,12,917,5.75,0.2344965,3
2020-10-02-170207,170207,10,0,13,927,10.0,0.20570542,4
2020-10-03-170207,170207,0,0,9,927,2.5,0.1560385,5
2020-10-04-170207,170207,2,0,2,929,3.5,0.15089189,6
2020-10-05-170207,170207,4,0,25,933,6.5,0.68202287,0
2020-10-06-170207,170207,4,1,12,937,6.75,0.5901826,1
2020-10-07-170207,170207,12,0,19,949,8.75,1.0277795,2
2020-10-08-170207,170207,10,1,11,959,6.75,0.31903026,3
2020-10-09-170207,170207,11,0,17,970,17.75,0.6294269,4
2020-10-10-170207,170207,2,0,6,972,2.5,0.109172285,5
2020-10-11-170207,170207,5,0,11,977,3.5,0.111072086,6
2020-10-12-170207,170207,5,0,14,982,5.5,0.19780618,0
2020-10-13-170207,170207,14,0,20,996,10.0,0.34379983,1
2020-10-14-170207,170207,16,0,12,1012,8.25,0.6800586,2
2020-10-15-170207,170207,12,0,17,1024,16.0,1.215343,3
2020-10-16-170207,170207,13,0,19,1037,15.25,1.7952563,4
2020-10-17-170207,170207,9,0,5,1046,3.75,0.3173659,5
2020-10-18-170207,170207,2,0,6,1048,2.25,0.12478252,6
2020-10-19-170207,170207,25,0,21,1073,15.5,1.0708731,0
2020-10-20-170207,170207,12,0,23,1085,13.0,0.7544988,1
2020-10-21-170207,170207,19,0,27,1104,20.0,1.0557086,2
2020-10-22-170207,170207,11,0,24,1115,16.25,1.1606923,3
2020-10-23-170207,170207,17,0,30,1132,13.25,0.8726694,4
2020-10-24-170207,170207,6,0,14,1138,4.0,0.30097696,5
2020-10-25-170207,170207,11,0,10,1149,6.5,0.28779677,6
2020-10-26-170207,170207,14,0,30,1163,24.5,1.253354,0
2020-10-27-170207,170207,20,3,17,1183,16.5,1.0687767,1
2020-10-28-170207,170207,12,0,13,1195,21.25,1.3269547,2
2020-10-29-170207,170207,17,1,30,1212,14.5,0.8031651,3
2020-10-30-170207,170207,19,2,22,1231,19.0,1.1874272,4
2020-10-31-170207,170207,5,1,0,1236,8.75,0.3835171,5
2020-11-01-170207,170207,6,1,0,1242,18.75,0.27661315,6
2020-11-02-170207,170207,21,1,0,1263,8.75,0.50255704,0
2020-11-03-170207,170207,23,2,0,1286,19.75,0.9280248,1
2020-11-04-170207,170207,27,1,0,1313,15.5,0.965364,2
2020-11-05-170207,170207,24,2,0,1337,20.75,0.8083503,3
2020-11-06-170207,170207,30,1,0,1367,20.75,0.87505156,4
2020-11-07-170207,170207,14,1,0,1381,11.75,0.4855938,5
2020-11-08-170207,170207,10,0,0,1391,14.0,0.5954167,6
2020-11-09-170207,170207,30,1,0,1421,23.75,1.5019715,0
2020-11-10-170207,170207,17,2,0,1438,18.5,0.94657075,1
2020-11-11-170207,170207,13,1,0,1451,17.25,0.66064036,2
2020-11-12-170207,170207,30,1,0,1481,18.25,1.3250564,3
2020-11-13-170207,170207,22,1,0,1503,23.25,1.066512,4
2020-03-01-170208,170208,0,0,0,0,0.08333333333333333,7.8708996e-05,6
2020-03-02-170208,170208,0,0,1,0,0.3333333333333333,0.042535108,0
2020-03-03-170208,170208,0,0,3,0,0.3333333333333333,0.08704534,1
2020-03-04-170208,170208,1,2,3,1,0.08333333333333333,0.60052514,2
2020-03-05-170208,170208,0,0,6,1,0.16666666666666666,0.0015596222,3
2020-03-06-170208,170208,1,0,11,2,0.0,0.56409466,4
2020-03-07-170208,170208,0,0,1,2,0.08333333333333333,0.008126561,5
2020-03-08-170208,170208,0,0,0,2,0.16666666666666666,0.0040036887,6
2020-03-09-170208,170208,1,0,6,3,0.6666666666666666,1.3738877,0
2020-03-10-170208,170208,0,0,7,3,1.5,0.07144359,1
2020-03-11-170208,170208,0,0,7,3,1.0833333333333333,0.42621082,2
2020-03-12-170208,170208,0,0,9,3,1.5,0.30425406,3
2020-03-13-170208,170208,0,1,5,3,2.25,1.3011906,4
2020-03-14-170208,170208,2,0,2,5,2.25,1.817497,5
2020-03-15-170208,170208,0,0,0,5,2.9166666666666665,0.49578077,6
2020-03-16-170208,170208,1,0,2,6,7.25,1.4697944,0
2020-03-17-170208,170208,3,0,1,9,7.583333333333332,2.9299457,1
2020-03-18-170208,170208,3,0,3,12,11.666666666666664,3.4393272,2
2020-03-19-170208,170208,6,0,2,18,13.666666666666664,5.039342,3
2020-03-20-170208,170208,11,1,3,29,12.25,6.866661,4
2020-03-21-170208,170208,1,0,0,30,5.75,0.9359747,5
2020-03-22-170208,170208,0,0,1,30,5.333333333333333,0.63063437,6
2020-03-23-170208,170208,6,0,7,36,16.833333333333332,6.681501,0
2020-03-24-170208,170208,7,0,4,43,14.5,5.459904,1
2020-03-25-170208,170208,7,0,6,50,11.083333333333336,4.86468,2
2020-03-26-170208,170208,9,0,1,59,9.5,4.9501333,3
2020-03-27-170208,170208,5,0,1,64,11.75,4.822375,4
2020-03-28-170208,170208,2,0,1,66,4.25,0.69913983,5
2020-03-29-170208,170208,0,0,0,66,4.0,0.7606785,6
2020-03-30-170208,170208,2,0,1,68,10.083333333333334,3.978155,0
2020-03-31-170208,170208,1,0,2,69,8.083333333333334,2.1063895,1
2020-04-01-170208,170208,3,0,2,72,6.666666666666668,1.9466572,2
2020-04-02-170208,170208,2,0,0,74,7.666666666666668,2.7684088,3
2020-04-03-170208,170208,3,0,1,77,7.416666666666668,3.2267802,4
2020-04-04-170208,170208,0,0,1,77,2.1666666666666665,0.09709802,5
2020-04-05-170208,170208,1,1,1,78,2.833333333333333,0.48038208,6
2020-04-06-170208,170208,7,0,1,85,7.083333333333332,3.11203,0
2020-04-07-170208,170208,4,0,0,89,4.416666666666667,2.7787163,1
2020-04-08-170208,170208,6,0,0,95,5.666666666666668,2.6446917,2
2020-04-09-170208,170208,1,1,0,96,6.916666666666668,3.482481,3
2020-04-10-170208,170208,1,0,2,97,9.0,1.1124138,4
2020-04-11-170208,170208,1,0,2,98,1.9166666666666667,0.64889073,5
2020-04-12-170208,170208,0,0,1,98,1.0,0.23617217,6
2020-04-13-170208,170208,1,0,3,99,7.25,2.4237194,0
2020-04-14-170208,170208,2,0,0,101,5.083333333333333,1.7465299,1
2020-04-15-170208,170208,2,0,0,103,6.833333333333332,3.3908513,2
2020-04-16-170208,170208,0,0,2,103,5.166666666666667,1.7767353,3
2020-04-17-170208,170208,1,0,0,104,4.416666666666667,1.5274166,4
2020-04-18-170208,170208,1,0,0,105,1.0833333333333333,0.31903264,5
2020-04-19-170208,170208,1,0,0,106,1.8333333333333333,1.256159,6
2020-04-20-170208,170208,1,1,3,107,4.583333333333333,2.706814,0
2020-04-21-170208,170208,0,0,1,107,3.8333333333333335,1.3830515,1
2020-04-22-170208,170208,0,0,1,107,3.8333333333333335,0.78525746,2
2020-04-23-170208,170208,0,0,1,107,1.0833333333333333,0.048670202,3
2020-04-24-170208,170208,2,0,4,109,2.833333333333333,1.568134,4
2020-04-25-170208,170208,2,0,0,111,0.9166666666666666,0.5744876,5
2020-04-26-170208,170208,1,0,0,112,1.1666666666666667,0.35858318,6
2020-04-27-170208,170208,3,0,2,115,3.8333333333333335,2.1442003,0
2020-04-28-170208,170208,0,0,1,115,3.083333333333333,0.69355196,1
2020-04-29-170208,170208,0,0,4,115,3.083333333333333,1.6033285,2
2020-04-30-170208,170208,2,0,5,117,2.4166666666666665,0.8626249,3
2020-05-01-170208,170208,0,0,2,117,0.5,0.045678895,4
2020-05-02-170208,170208,0,0,0,117,0.5,0.36427233,5
2020-05-03-170208,170208,0,0,0,117,0.5833333333333334,0.019666888,6
2020-05-04-170208,170208,3,0,1,120,2.0,1.9110694,0
2020-05-05-170208,170208,1,0,1,121,2.6666666666666665,1.3254472,1
2020-05-06-170208,170208,1,0,2,122,2.5,1.2387011,2
2020-05-07-170208,170208,1,0,1,123,2.4166666666666665,0.91568035,3
2020-05-08-170208,170208,4,0,0,127,2.6666666666666665,2.7485907,4
2020-05-09-170208,170208,0,0,0,127,0.25,0.042467985,5
2020-05-10-170208,170208,0,0,0,127,0.4166666666666667,0.13083479,6
2020-05-11-170208,170208,2,1,2,129,3.1666666666666665,1.1923664,0
2020-05-12-170208,170208,1,0,1,130,2.75,1.0348083,1
2020-05-13-170208,170208,4,0,2,134,5.0,2.890326,2
2020-05-14-170208,170208,5,0,3,139,4.666666666666667,3.4230235,3
2020-05-15-170208,170208,2,0,0,141,4.666666666666667,1.7392595,4
2020-05-16-170208,170208,0,0,0,141,0.8333333333333334,0.00202546,5
2020-05-17-170208,170208,0,0,0,141,0.08333333333333333,0.039887145,6
2020-05-18-170208,170208,1,0,0,142,4.666666666666667,1.7226293,0
2020-05-19-170208,170208,1,0,0,143,3.083333333333333,1.3969427,1
2020-05-20-170208,170208,2,0,1,145,2.25,1.0383378,2
2020-05-21-170208,170208,1,0,0,146,3.4166666666666665,1.1589597,3
2020-05-22-170208,170208,0,0,0,146,2.6666666666666665,0.6844828,4
2020-05-23-170208,170208,0,0,0,146,0.08333333333333333,0.002327647,5
2020-05-24-170208,170208,0,0,0,146,0.08333333333333333,0.0062017883,6
2020-05-25-170208,170208,2,0,1,148,3.1666666666666665,1.7457106,0
2020-05-26-170208,170208,1,0,0,149,1.5833333333333333,1.0238162,1
2020-05-27-170208,170208,2,0,0,151,1.5833333333333333,1.047483,2
2020-05-28-170208,170208,3,2,1,154,1.4166666666666667,2.0505438,3
2020-05-29-170208,170208,0,0,0,154,1.75,0.57722694,4
2020-05-30-170208,170208,0,0,0,154,0.0,0.003447192,5
2020-05-31-170208,170208,0,0,0,154,0.0,0.012163096,6
2020-06-01-170208,170208,0,0,0,154,1.0833333333333333,0.15145081,0
2020-06-02-170208,170208,0,0,0,154,1.0833333333333333,0.8751448,1
2020-06-03-170208,170208,1,0,1,155,1.25,0.33659366,2
2020-06-04-170208,170208,0,0,0,155,1.1666666666666667,0.47893134,3
2020-06-05-170208,170208,0,0,0,155,1.25,0.46783322,4
2020-06-06-170208,170208,0,0,0,155,0.5833333333333334,0.08915252,5
2020-06-07-170208,170208,0,0,0,155,0.0,0.0004903025,6
2020-06-08-170208,170208,1,0,0,156,1.0,0.9268673,0
2020-06-09-170208,170208,0,0,1,156,0.8333333333333334,0.27691036,1
2020-06-10-170208,170208,0,0,0,156,1.1666666666666667,0.2566647,2
2020-06-11-170208,170208,1,0,0,157,1.25,1.0461532,3
2020-06-12-170208,170208,0,0,1,157,1.0833333333333333,0.87780195,4
2020-06-13-170208,170208,0,0,1,157,0.0,0.047188684,5
2020-06-14-170208,170208,0,0,0,157,0.25,0.011536439,6
2020-06-15-170208,170208,0,0,0,157,1.0,0.11037209,0
2020-06-16-170208,170208,0,0,1,157,0.6666666666666666,0.4786217,1
2020-06-17-170208,170208,1,0,0,158,1.0,0.96512973,2
2020-06-18-170208,170208,0,0,0,158,0.8333333333333334,0.67666656,3
2020-06-19-170208,170208,0,0,1,158,0.16666666666666666,0.04623508,4
2020-06-20-170208,170208,0,0,0,158,0.0,0.046717703,5
2020-06-21-170208,170208,0,0,0,158,0.25,0.10416443,6
2020-06-22-170208,170208,0,0,0,158,0.8333333333333334,0.31190127,0
2020-06-23-170208,170208,1,0,0,159,0.4166666666666667,1.156446,1
2020-06-24-170208,170208,0,0,0,159,1.0,1.2037375,2
2020-06-25-170208,170208,0,1,1,159,0.8333333333333334,0.30250004,3
2020-06-26-170208,170208,1,0,0,160,0.75,1.0675011,4
2020-06-27-170208,170208,1,0,0,161,0.16666666666666666,0.73410773,5
2020-06-28-170208,170208,0,0,0,161,0.08333333333333333,0.0059071467,6
2020-06-29-170208,170208,0,0,0,161,0.0,0.022102563,0
2020-06-30-170208,170208,1,0,0,162,0.5,0.9602088,1
2020-07-01-170208,170208,0,0,1,162,0.75,0.19425455,2
2020-07-02-170208,170208,0,0,0,162,0.08333333333333333,0.058285333,3
2020-07-03-170208,170208,1,0,0,163,0.4166666666666667,0.84385586,4
2020-07-04-170208,170208,0,0,1,163,0.0,0.005988243,5
2020-07-05-170208,170208,0,0,0,163,0.0,0.013767535,6
2020-07-06-170208,170208,0,0,0,163,0.25,0.14107494,0
2020-07-07-170208,170208,0,0,0,163,0.5833333333333334,0.6178525,1
2020-07-08-170208,170208,0,0,0,163,0.5,0.25826064,2
2020-07-09-170208,170208,1,0,1,164,0.6666666666666666,0.34384456,3
2020-07-10-170208,170208,0,0,0,164,0.25,0.11108135,4
2020-07-11-170208,170208,0,0,0,164,0.08333333333333333,0.0025706256,5
2020-07-12-170208,170208,0,0,0,164,0.25,0.39052838,6
2020-07-13-170208,170208,0,0,1,164,0.75,0.023359751,0
2020-07-14-170208,170208,0,0,0,164,0.5,0.44739056,1
2020-07-15-170208,170208,1,0,1,165,1.5833333333333333,0.67833126,2
2020-07-16-170208,170208,0,0,3,165,0.4166666666666667,0.21799202,3
2020-07-17-170208,170208,0,0,1,165,0.8333333333333334,0.36839116,4
2020-07-18-170208,170208,1,0,0,166,0.5833333333333334,0.5668712,5
2020-07-19-170208,170208,0,0,1,166,0.25,0.14034982,6
2020-07-20-170208,170208,0,0,0,166,0.8333333333333334,0.2701801,0
2020-07-21-170208,170208,0,0,2,166,0.9166666666666666,0.1024321,1
2020-07-22-170208,170208,0,0,2,166,0.6666666666666666,0.06901836,2
2020-07-23-170208,170208,1,0,0,167,0.4166666666666667,0.6724346,3
2020-07-24-170208,170208,0,0,3,167,0.5,0.11301367,4
2020-07-25-170208,170208,0,0,2,167,0.3333333333333333,0.028155597,5
2020-07-26-170208,170208,0,0,0,167,0.3333333333333333,0.018233893,6
2020-07-27-170208,170208,1,0,7,168,1.3333333333333333,1.4887108,0
2020-07-28-170208,170208,0,0,1,168,0.6666666666666666,0.43566027,1
2020-07-29-170208,170208,1,0,5,169,1.25,1.5709008,2
2020-07-30-170208,170208,3,0,2,172,2.333333333333333,2.9629593,3
2020-07-31-170208,170208,1,0,0,173,1.75,2.0399296,4
2020-08-01-170208,170208,0,0,0,173,0.4166666666666667,0.49564078,5
2020-08-02-170208,170208,1,0,2,174,0.3333333333333333,2.1006858,6
2020-08-03-170208,170208,0,0,1,174,1.4166666666666667,1.0479854,0
2020-08-04-170208,170208,2,0,3,176,2.4166666666666665,4.6227922,1
2020-08-05-170208,170208,2,0,4,178,3.333333333333333,5.3657246,2
2020-08-06-170208,170208,0,0,3,178,2.1666666666666665,1.7510839,3
2020-08-07-170208,170208,3,0,3,181,2.1666666666666665,2.4401615,4
2020-08-08-170208,170208,2,0,2,183,1.5833333333333333,2.4385507,5
2020-08-09-170208,170208,0,0,1,183,0.6666666666666666,0.39555314,6
2020-08-10-170208,170208,7,0,6,190,1.6666666666666667,4.491469,0
2020-08-11-170208,170208,1,0,3,191,3.25,2.7828755,1
2020-08-12-170208,170208,5,0,4,196,3.75,4.828073,2
2020-08-13-170208,170208,2,0,6,198,3.333333333333333,4.1777782,3
2020-08-14-170208,170208,0,0,5,198,2.083333333333333,2.4430299,4
2020-08-15-170208,170208,0,0,1,198,1.3333333333333333,1.1133937,5
2020-08-16-170208,170208,2,0,1,200,1.6666666666666667,3.1102135,6
2020-08-17-170208,170208,1,0,0,201,2.1666666666666665,2.3050704,0
2020-08-18-170208,170208,3,0,11,204,4.333333333333333,5.7835083,1
2020-08-19-170208,170208,4,0,1,208,2.083333333333333,3.2864773,2
2020-08-20-170208,170208,3,0,0,211,1.8333333333333333,3.554894,3
2020-08-21-170208,170208,3,0,1,214,2.833333333333333,5.651282,4
2020-08-22-170208,170208,2,0,1,216,2.4166666666666665,2.733111,5
2020-08-23-170208,170208,1,0,0,217,1.0833333333333333,1.062362,6
2020-08-24-170208,170208,6,0,0,223,4.416666666666667,3.8975658,0
2020-08-25-170208,170208,3,0,1,226,3.75,3.5884557,1
2020-08-26-170208,170208,4,0,1,230,3.4166666666666665,2.2904973,2
2020-08-27-170208,170208,6,0,1,236,2.833333333333333,2.4224687,3
2020-08-28-170208,170208,5,0,1,241,2.25,4.1038427,4
2020-08-29-170208,170208,1,0,2,242,0.9166666666666666,1.2311412,5
2020-08-30-170208,170208,1,0,0,243,1.5,0.5767391,6
2020-08-31-170208,170208,0,0,3,243,3.6666666666666665,1.2252343,0
2020-09-01-170208,170208,11,0,10,254,3.083333333333333,9.720226,1
2020-09-02-170208,170208,1,0,9,255,4.666666666666667,3.0123198,2
2020-09-03-170208,170208,0,0,12,255,4.0,1.849876,3
2020-09-04-170208,170208,1,0,7,256,4.333333333333333,2.2449672,4
2020-09-05-170208,170208,1,0,1,257,2.4166666666666665,0.84198976,5
2020-09-06-170208,170208,0,0,1,257,1.5,0.46000385,6
2020-09-07-170208,170208,0,0,5,257,3.9166666666666665,1.5352843,0
2020-09-08-170208,170208,1,0,7,258,4.916666666666667,5.2238364,1
2020-09-09-170208,170208,1,0,5,259,3.75,2.248602,2
2020-09-10-170208,170208,1,0,3,260,7.333333333333332,2.1109614,3
2020-09-11-170208,170208,1,0,5,261,5.333333333333333,3.81279,4
2020-09-12-170208,170208,2,0,3,263,2.1666666666666665,2.5681295,5
2020-09-13-170208,170208,0,0,0,263,2.333333333333333,1.1327606,6
2020-09-14-170208,170208,3,0,3,266,4.666666666666667,2.2225618,0
2020-09-15-170208,170208,10,0,7,276,9.583333333333334,6.8980465,1
2020-09-16-170208,170208,9,0,5,285,6.666666666666668,2.7519968,2
2020-09-17-170208,170208,12,0,3,297,7.583333333333332,2.9600317,3
2020-09-18-170208,170208,7,0,4,304,7.583333333333332,4.4172244,4
2020-09-19-170208,170208,1,0,2,305,1.25,0.07601541,5
2020-09-20-170208,170208,1,0,2,306,1.25,0.74986994,6
2020-09-21-170208,170208,5,0,5,311,8.916666666666666,2.4620678,0
2020-09-22-170208,170208,7,0,6,318,7.916666666666668,2.7465532,1
2020-09-23-170208,170208,5,0,9,323,8.25,3.6110451,2
2020-09-24-170208,170208,3,1,4,326,5.25,1.4338605,3
2020-09-25-170208,170208,5,0,5,331,6.916666666666668,3.9263616,4
2020-09-26-170208,170208,3,0,1,334,0.75,2.007159,5
2020-09-27-170208,170208,0,0,1,334,0.5833333333333334,0.58664113,6
2020-09-28-170208,170208,3,0,3,337,4.5,3.2537503,0
2020-09-29-170208,170208,7,0,2,344,2.833333333333333,4.0000806,1
2020-09-30-170208,170208,5,0,4,349,4.0,3.373014,2
2020-10-01-170208,170208,3,0,10,352,5.25,2.4099107,3
2020-10-02-170208,170208,4,0,9,356,7.416666666666668,2.057612,4
2020-10-03-170208,170208,2,0,5,358,1.5,1.5607237,5
2020-10-04-170208,170208,2,0,1,360,1.9166666666666667,1.6910263,6
2020-10-05-170208,170208,5,0,9,365,3.9166666666666665,6.5956244,0
2020-10-06-170208,170208,6,0,8,371,4.916666666666667,6.0692635,1
2020-10-07-170208,170208,9,0,11,380,6.333333333333332,10.274322,2
2020-10-08-170208,170208,4,0,14,384,5.583333333333332,3.374464,3
2020-10-09-170208,170208,5,2,10,389,10.25,5.954187,4
2020-10-10-170208,170208,1,0,3,390,2.1666666666666665,1.2531241,5
2020-10-11-170208,170208,1,0,4,391,3.083333333333333,1.4782434,6
2020-10-12-170208,170208,3,0,10,394,4.75,2.150982,0
2020-10-13-170208,170208,2,0,10,396,9.416666666666666,3.6250806,1
2020-10-14-170208,170208,4,0,11,400,6.0,7.4592233,2
2020-10-15-170208,170208,10,0,7,410,10.333333333333334,13.387305,3
2020-10-16-170208,170208,9,0,8,419,9.75,16.823317,4
2020-10-17-170208,170208,5,0,2,424,2.25,3.5715566,5
2020-10-18-170208,170208,1,0,2,425,2.0,1.6727314,6
2020-10-19-170208,170208,9,0,9,434,12.833333333333336,10.476731,0
2020-10-20-170208,170208,8,0,6,442,8.916666666666666,7.946909,1
2020-10-21-170208,170208,11,0,5,453,14.416666666666664,10.531799,2
2020-10-22-170208,170208,14,0,8,467,13.083333333333336,11.628805,3
2020-10-23-170208,170208,10,0,7,477,10.0,8.146056,4
2020-10-24-170208,170208,3,0,10,480,5.583333333333332,3.8863535,5
2020-10-25-170208,170208,4,0,5,484,6.333333333333332,3.2020547,6
2020-10-26-170208,170208,10,0,18,494,15.416666666666664,12.1621685,0
2020-10-27-170208,170208,10,0,10,504,12.333333333333336,10.30406,1
2020-10-28-170208,170208,11,1,6,515,15.333333333333336,13.376791,2
2020-10-29-170208,170208,7,0,11,522,12.916666666666664,8.351128,3
2020-10-30-170208,170208,8,0,14,530,15.333333333333336,11.858797,4
2020-10-31-170208,170208,2,0,0,532,8.083333333333334,4.373104,5
2020-11-01-170208,170208,2,0,0,534,11.416666666666664,3.2029033,6
2020-11-02-170208,170208,9,0,0,543,8.333333333333334,5.810163,0
2020-11-03-170208,170208,6,0,0,549,15.25,9.154773,1
2020-11-04-170208,170208,5,0,0,554,12.916666666666664,9.459634,2
2020-11-05-170208,170208,8,1,0,562,14.0,7.6828103,3
2020-11-06-170208,170208,7,1,0,569,18.5,8.605316,4
2020-11-07-170208,170208,10,0,0,579,8.333333333333334,4.760576,5
2020-11-08-170208,170208,5,0,0,584,9.833333333333334,5.9846797,6
2020-11-09-170208,170208,18,0,0,602,18.0,13.675191,0
2020-11-10-170208,170208,10,1,0,612,13.75,8.93224,1
2020-11-11-170208,170208,6,1,0,618,12.5,6.760625,2
2020-11-12-170208,170208,11,1,0,629,15.916666666666664,13.385339,3
2020-11-13-170208,170208,14,0,0,643,18.58333333333333,10.59101,4
2020-03-01-170209,170209,0,0,3,0,0.0,0.00012457378,6
2020-03-02-170209,170209,0,0,3,0,0.0,0.023128396,0
2020-03-03-170209,170209,0,0,7,0,0.1,0.048525997,1
2020-03-04-170209,170209,0,0,6,0,0.2,0.29793137,2
2020-03-05-170209,170209,0,0,12,0,0.1,0.0014919837,3
2020-03-06-170209,170209,0,1,11,0,0.2,0.29691526,4
2020-03-07-170209,170209,0,0,4,0,0.1,0.012258221,5
2020-03-08-170209,170209,0,0,7,0,0.0,0.006787133,6
2020-03-09-170209,170209,2,0,16,2,0.2,2.5133762,0
2020-03-10-170209,170209,1,0,11,3,1.1,0.2130158,1
2020-03-11-170209,170209,1,1,11,4,0.9,0.975449,2
2020-03-12-170209,170209,0,0,4,4,0.9,0.4396432,3
2020-03-13-170209,170209,4,0,14,8,2.0,2.4318805,4
2020-03-14-170209,170209,5,0,2,13,0.7,2.8205528,5
2020-03-15-170209,170209,3,0,5,16,1.5,2.373284,6
2020-03-16-170209,170209,3,0,18,19,4.3,3.5634816,0
2020-03-17-170209,170209,7,0,8,26,6.3,7.5292244,1
2020-03-18-170209,170209,6,0,9,32,10.3,5.9018493,2
2020-03-19-170209,170209,12,2,11,44,8.5,6.589517,3
2020-03-20-170209,170209,11,3,9,55,9.5,11.606478,4
2020-03-21-170209,170209,4,0,0,59,4.6,2.4197252,5
2020-03-22-170209,170209,7,1,2,66,4.9,2.982348,6
2020-03-23-170209,170209,16,0,2,82,13.6,9.99961,0
2020-03-24-170209,170209,11,0,7,93,11.1,7.5689425,1
2020-03-25-170209,170209,11,0,9,104,8.9,8.093769,2
2020-03-26-170209,170209,4,0,32,108,9.3,4.4015374,3
2020-03-27-170209,170209,14,0,11,122,10.5,8.267335,4
2020-03-28-170209,170209,2,0,3,124,3.4,1.134398,5
2020-03-29-170209,170209,5,0,2,129,3.2,2.388228,6
2020-03-30-170209,170209,18,0,10,147,8.3,8.705743,0
2020-03-31-170209,170209,8,0,4,155,5.8,4.063352,1
2020-04-01-170209,170209,9,0,15,164,5.4,4.4948044,2
2020-04-02-170209,170209,11,0,8,175,5.9,5.525085,3
2020-04-03-170209,170209,9,0,3,184,6.6,8.818994,4
2020-04-04-170209,170209,0,0,0,184,3.7,0.28441104,5
2020-04-05-170209,170209,2,0,8,186,2.0,0.9559165,6
2020-04-06-170209,170209,2,0,8,188,5.0,4.2302012,0
2020-04-07-170209,170209,7,0,6,195,3.9,3.9880843,1
2020-04-08-170209,170209,9,6,3,204,4.5,5.0918,2
2020-04-09-170209,170209,32,0,0,236,3.0,12.458252,3
2020-04-10-170209,170209,11,0,3,247,4.0,3.4157112,4
2020-04-11-170209,170209,3,0,0,250,5.4,1.411535,5
2020-04-12-170209,170209,2,0,1,252,2.6,2.0739572,6
2020-04-13-170209,170209,10,0,6,262,5.2,4.4349504,0
2020-04-14-170209,170209,4,0,3,266,5.0,4.1526613,1
2020-04-15-170209,170209,15,0,6,281,6.9,7.231238,2
2020-04-16-170209,170209,8,0,0,289,3.8,4.2770305,3
2020-04-17-170209,170209,3,0,0,292,8.6,3.6605113,4
2020-04-18-170209,170209,0,0,0,292,1.1,0.0959652,5
2020-04-19-170209,170209,8,0,0,300,2.7,6.1389813,6
2020-04-20-170209,170209,8,0,1,308,4.9,8.129658,0
2020-04-21-170209,170209,6,0,3,314,4.1,3.345122,1
2020-04-22-170209,170209,3,0,0,317,5.7,1.4868407,2
2020-04-23-170209,170209,0,0,1,317,1.8,0.16464889,3
2020-04-24-170209,170209,3,0,5,320,2.8,2.2172687,4
2020-04-25-170209,170209,0,0,0,320,1.3,0.24123327,5
2020-04-26-170209,170209,1,0,1,321,0.9,0.4195459,6
2020-04-27-170209,170209,6,0,0,327,3.2,2.3188543,0
2020-04-28-170209,170209,3,0,3,330,2.9,2.2003396,1
2020-04-29-170209,170209,6,0,4,336,3.0,5.066032,2
2020-04-30-170209,170209,0,0,5,336,3.0,0.9982026,3
2020-05-01-170209,170209,0,0,3,336,0.7,0.060327824,4
2020-05-02-170209,170209,0,0,0,336,1.1,0.24916753,5
2020-05-03-170209,170209,0,0,0,336,0.8,0.17589842,6
2020-05-04-170209,170209,1,0,5,337,2.7,1.765915,0
2020-05-05-170209,170209,3,0,4,340,2.8,2.0294669,1
2020-05-06-170209,170209,0,0,1,340,3.3,0.8236568,2
2020-05-07-170209,170209,1,0,2,341,2.2,1.0515264,3
2020-05-08-170209,170209,5,0,3,346,2.8,2.608112,4
2020-05-09-170209,170209,0,0,0,346,0.1,0.032327425,5
2020-05-10-170209,170209,1,1,0,347,0.2,0.44970486,6
2020-05-11-170209,170209,0,0,2,347,3.8,0.94076395,0
2020-05-12-170209,170209,3,0,1,350,2.3,1.6046674,1
2020-05-13-170209,170209,4,0,1,354,4.5,3.0528226,2
2020-05-14-170209,170209,5,0,1,359,4.8,4.278257,3
2020-05-15-170209,170209,3,0,1,362,3.4,2.3669927,4
2020-05-16-170209,170209,0,0,0,362,0.4,0.00011368432,5
2020-05-17-170209,170209,0,0,0,362,0.3,0.09791466,6
2020-05-18-170209,170209,5,0,0,367,3.8,3.0523484,0
2020-05-19-170209,170209,4,0,3,371,2.9,2.286595,1
2020-05-20-170209,170209,1,0,0,372,3.4,1.9121519,2
2020-05-21-170209,170209,2,0,2,374,2.3,1.3890675,3
2020-05-22-170209,170209,3,0,1,377,2.1,2.0198202,4
2020-05-23-170209,170209,0,0,0,377,0.3,0.003022147,5
2020-05-24-170209,170209,0,0,0,377,0.0,0.0011691003,6
2020-05-25-170209,170209,2,0,0,379,2.5,1.5881165,0
2020-05-26-170209,170209,1,0,1,380,2.8,1.0914177,1
2020-05-27-170209,170209,1,0,0,381,2.1,1.8030505,2
2020-05-28-170209,170209,1,1,1,382,1.6,1.5886898,3
2020-05-29-170209,170209,1,1,2,383,1.9,1.5975354,4
2020-05-30-170209,170209,0,0,0,383,0.0,0.0011857376,5
2020-05-31-170209,170209,0,0,1,383,0.0,0.01334619,6
2020-06-01-170209,170209,0,0,0,383,1.7,0.08862226,0
2020-06-02-170209,170209,3,0,1,386,1.4,1.6923602,1
2020-06-03-170209,170209,0,0,1,386,1.3,0.44498146,2
2020-06-04-170209,170209,2,0,2,388,1.2,0.9404898,3
2020-06-05-170209,170209,1,0,0,389,1.1,1.3120794,4
2020-06-06-170209,170209,0,1,0,389,0.7,0.21319526,5
2020-06-07-170209,170209,0,0,0,389,0.2,0.00010606018,6
2020-06-08-170209,170209,0,1,1,389,1.0,0.7653397,0
2020-06-09-170209,170209,1,0,1,390,0.9,0.5428323,1
2020-06-10-170209,170209,0,0,3,390,1.4,0.2780495,2
2020-06-11-170209,170209,1,0,1,391,0.7,0.89723957,3
2020-06-12-170209,170209,2,0,1,393,0.3,2.1519203,4
2020-06-13-170209,170209,0,0,1,393,0.2,0.15735139,5
2020-06-14-170209,170209,1,0,0,394,0.0,0.0029979725,6
2020-06-15-170209,170209,0,0,0,394,1.1,0.065395325,0
2020-06-16-170209,170209,1,0,1,395,1.0,0.86378324,1
2020-06-17-170209,170209,1,0,1,396,0.7,1.3800983,2
2020-06-18-170209,170209,2,0,0,398,0.7,1.2964327,3
2020-06-19-170209,170209,0,0,0,398,0.2,0.06614144,4
2020-06-20-170209,170209,0,0,0,398,0.2,0.14445576,5
2020-06-21-170209,170209,0,0,0,398,0.2,0.06910708,6
2020-06-22-170209,170209,1,0,0,399,0.4,0.5600561,0
2020-06-23-170209,170209,1,0,2,400,0.6,1.4789923,1
2020-06-24-170209,170209,3,0,0,403,0.6,3.5668094,2
2020-06-25-170209,170209,1,1,0,404,0.3,0.6002221,3
2020-06-26-170209,170209,1,0,0,405,0.6,1.5365123,4
2020-06-27-170209,170209,1,0,0,406,0.1,0.7096839,5
2020-06-28-170209,170209,0,0,1,406,0.0,0.008652623,6
2020-06-29-170209,170209,0,0,0,406,0.1,0.025197782,0
2020-06-30-170209,170209,1,0,1,407,0.3,0.7775196,1
2020-07-01-170209,170209,1,0,0,408,0.5,0.10668424,2
2020-07-02-170209,170209,0,0,0,408,0.0,0.14792462,3
2020-07-03-170209,170209,0,0,1,408,0.6,0.4157479,4
2020-07-04-170209,170209,0,0,0,408,0.1,0.0025189205,5
2020-07-05-170209,170209,0,0,0,408,0.0,0.005886026,6
2020-07-06-170209,170209,0,0,0,408,0.4,0.21822575,0
2020-07-07-170209,170209,2,0,0,410,0.4,1.1732459,1
2020-07-08-170209,170209,0,0,0,410,0.3,0.22562714,2
2020-07-09-170209,170209,0,0,0,410,0.6,0.3210019,3
2020-07-10-170209,170209,0,0,0,410,0.2,0.10110216,4
2020-07-11-170209,170209,0,0,0,410,0.1,0.0017383321,5
2020-07-12-170209,170209,1,0,0,411,0.4,0.712884,6
2020-07-13-170209,170209,0,1,3,411,0.4,0.034745034,0
2020-07-14-170209,170209,1,0,1,412,0.7,0.7218155,1
2020-07-15-170209,170209,0,0,3,412,0.9,0.56169003,2
2020-07-16-170209,170209,0,0,3,412,0.8,0.32863986,3
2020-07-17-170209,170209,1,0,5,413,1.0,1.0627191,4
2020-07-18-170209,170209,0,0,3,413,0.3,0.22696161,5
2020-07-19-170209,170209,0,0,2,413,0.4,0.2061021,6
2020-07-20-170209,170209,0,0,3,413,0.7,0.595791,0
2020-07-21-170209,170209,0,0,14,413,0.2,0.06171646,1
2020-07-22-170209,170209,0,0,9,413,0.5,0.17244166,2
2020-07-23-170209,170209,0,0,3,413,0.7,0.4923885,3
2020-07-24-170209,170209,0,1,1,413,0.6,0.12281814,4
2020-07-25-170209,170209,0,0,5,413,0.2,0.020039562,5
2020-07-26-170209,170209,0,0,0,413,0.4,0.026458832,6
2020-07-27-170209,170209,3,0,2,416,1.3,2.0080235,0
2020-07-28-170209,170209,1,0,6,417,0.6,0.61237967,1
2020-07-29-170209,170209,3,0,10,420,1.2,2.7537751,2
2020-07-30-170209,170209,3,0,4,423,1.7,3.101142,3
2020-07-31-170209,170209,5,0,5,428,1.6,4.3717756,4
2020-08-01-170209,170209,3,0,3,431,0.4,1.164249,5
2020-08-02-170209,170209,2,0,7,433,0.3,5.628785,6
2020-08-03-170209,170209,3,0,5,436,1.8,1.5493462,0
2020-08-04-170209,170209,14,0,13,450,0.5,8.047469,1
2020-08-05-170209,170209,9,0,2,459,1.5,10.773196,2
2020-08-06-170209,170209,3,0,3,462,1.4,2.6437504,3
2020-08-07-170209,170209,1,0,10,463,1.1,2.4511983,4
2020-08-08-170209,170209,5,0,5,468,1.4,3.4286277,5
2020-08-09-170209,170209,0,0,1,468,0.6,0.23107834,6
2020-08-10-170209,170209,2,0,10,470,2.4,3.213801,0
2020-08-11-170209,170209,6,0,6,476,2.3,4.7468967,1
2020-08-12-170209,170209,10,0,5,486,3.2,10.734749,2
2020-08-13-170209,170209,4,0,4,490,3.4,6.3069553,3
2020-08-14-170209,170209,5,0,3,495,2.6,7.1783605,4
2020-08-15-170209,170209,3,0,2,498,1.3,3.0162444,5
2020-08-16-170209,170209,7,0,0,505,1.6,6.032307,6
2020-08-17-170209,170209,5,0,3,510,1.8,3.394974,0
2020-08-18-170209,170209,13,0,8,523,3.9,8.5092945,1
2020-08-19-170209,170209,2,0,6,525,3.0,4.5938077,2
2020-08-20-170209,170209,3,0,4,528,2.3,3.6414099,3
2020-08-21-170209,170209,10,0,4,538,2.7,12.205707,4
2020-08-22-170209,170209,5,0,2,543,2.4,4.990594,5
2020-08-23-170209,170209,1,0,1,544,1.7,2.2365441,6
2020-08-24-170209,170209,10,0,5,554,5.2,4.7426186,0
2020-08-25-170209,170209,6,1,15,560,4.0,3.9330652,1
2020-08-26-170209,170209,5,0,2,565,2.6,2.5788107,2
2020-08-27-170209,170209,4,1,9,569,3.5,1.7240893,3
2020-08-28-170209,170209,3,0,4,572,2.2,4.724316,4
2020-08-29-170209,170209,2,0,5,574,0.6,1.8581529,5
2020-08-30-170209,170209,0,0,3,574,1.7,0.4356948,6
2020-08-31-170209,170209,3,0,4,577,2.9,1.801605,0
2020-09-01-170209,170209,8,0,21,585,3.7,10.963234,1
2020-09-02-170209,170209,6,0,9,591,3.3,6.921366,2
2020-09-03-170209,170209,4,1,6,595,5.7,2.5743713,3
2020-09-04-170209,170209,4,0,3,599,4.1,4.9258904,4
2020-09-05-170209,170209,2,0,3,601,2.4,0.970574,5
2020-09-06-170209,170209,1,0,6,602,0.9,0.74248224,6
2020-09-07-170209,170209,5,0,9,607,3.9,3.1693888,0
2020-09-08-170209,170209,15,1,6,622,4.0,7.8171787,1
2020-09-09-170209,170209,2,0,13,624,4.2,4.129274,2
2020-09-10-170209,170209,9,0,4,633,5.0,4.483852,3
2020-09-11-170209,170209,4,0,9,637,3.8,8.31614,4
2020-09-12-170209,170209,5,0,0,642,2.4,4.1534824,5
2020-09-13-170209,170209,3,0,2,645,2.1,2.9598408,6
2020-09-14-170209,170209,4,0,2,649,4.8,2.6296089,0
2020-09-15-170209,170209,21,1,3,670,6.6,11.518207,1
2020-09-16-170209,170209,9,0,2,679,4.9,7.3958616,2
2020-09-17-170209,170209,6,0,6,685,7.6,2.4647884,3
2020-09-18-170209,170209,3,0,6,688,7.4,6.2376914,4
2020-09-19-170209,170209,3,1,2,691,1.0,0.087333165,5
2020-09-20-170209,170209,6,0,4,697,1.3,2.1167972,6
2020-09-21-170209,170209,9,1,9,706,6.8,3.4015198,0
2020-09-22-170209,170209,6,0,9,712,6.2,2.7581756,1
2020-09-23-170209,170209,13,0,13,725,7.7,8.29225,2
2020-09-24-170209,170209,4,0,7,729,5.1,1.7917131,3
2020-09-25-170209,170209,9,0,13,738,5.5,8.678515,4
2020-09-26-170209,170209,0,0,2,738,0.7,1.0282817,5
2020-09-27-170209,170209,2,0,3,740,1.0,1.4654884,6
2020-09-28-170209,170209,2,0,4,742,5.1,2.1541092,0
2020-09-29-170209,170209,3,1,4,745,3.5,3.1709957,1
2020-09-30-170209,170209,2,0,7,747,6.0,2.6687844,2
2020-10-01-170209,170209,6,1,10,753,3.4,3.5433753,3
2020-10-02-170209,170209,6,0,9,759,5.3,4.533974,4
2020-10-03-170209,170209,2,0,2,761,2.0,1.7648553,5
2020-10-04-170209,170209,4,0,3,765,2.4,2.4166873,6
2020-10-05-170209,170209,9,3,15,774,2.8,6.591019,0
2020-10-06-170209,170209,9,1,8,783,4.1,6.1341033,1
2020-10-07-170209,170209,13,1,12,796,5.7,16.319132,2
2020-10-08-170209,170209,7,0,16,803,5.2,4.1941805,3
2020-10-09-170209,170209,13,2,13,816,9.0,11.060339,4
2020-10-10-170209,170209,2,0,9,818,1.7,1.6272525,5
2020-10-11-170209,170209,3,0,6,821,3.9,2.4600472,6
2020-10-12-170209,170209,4,0,21,825,4.3,2.7749379,0
2020-10-13-170209,170209,4,0,18,829,7.3,3.900188,1
2020-10-14-170209,170209,7,0,13,836,6.1,14.253945,2
2020-10-15-170209,170209,10,0,4,846,9.0,10.730662,3
2020-10-16-170209,170209,9,0,13,855,9.5,15.330121,4
2020-10-17-170209,170209,2,0,10,857,2.5,2.8504834,5
2020-10-18-170209,170209,3,0,10,860,1.6,2.151564,6
2020-10-19-170209,170209,15,1,8,875,10.8,10.050588,0
2020-10-20-170209,170209,8,1,16,883,9.4,7.3352156,1
2020-10-21-170209,170209,12,0,12,895,9.5,16.662582,2
2020-10-22-170209,170209,16,0,9,911,9.5,12.961731,3
2020-10-23-170209,170209,13,0,17,924,18.1,11.474981,4
2020-10-24-170209,170209,9,1,2,933,3.9,5.6552086,5
2020-10-25-170209,170209,6,0,18,939,5.8,4.5037127,6
2020-10-26-170209,170209,21,0,19,960,17.5,15.381685,0
2020-10-27-170209,170209,18,0,11,978,12.6,11.925866,1
2020-10-28-170209,170209,13,1,5,991,16.1,22.981815,2
2020-10-29-170209,170209,4,0,29,995,16.5,10.013992,3
2020-10-30-170209,170209,13,1,18,1008,15.5,21.431072,4
2020-10-31-170209,170209,10,0,0,1018,6.2,7.392347,5
2020-11-01-170209,170209,10,1,0,1028,10.3,6.697589,6
2020-11-02-170209,170209,8,0,0,1036,6.4,5.443708,0
2020-11-03-170209,170209,16,1,0,1052,13.3,10.891815,1
2020-11-04-170209,170209,12,3,0,1064,14.2,17.572456,2
2020-11-05-170209,170209,9,0,0,1073,13.1,9.418416,3
2020-11-06-170209,170209,17,0,0,1090,21.4,18.55462,4
2020-11-07-170209,170209,2,0,0,1092,7.6,3.2298832,5
2020-11-08-170209,170209,18,1,0,1110,10.6,9.921735,6
2020-11-09-170209,170209,19,1,0,1129,16.6,13.982934,0
2020-11-10-170209,170209,11,0,0,1140,13.1,8.642725,1
2020-11-11-170209,170209,5,0,0,1145,9.7,8.493531,2
2020-11-12-170209,170209,29,0,0,1174,13.6,17.77018,3
2020-11-13-170209,170209,18,0,0,1192,17.5,23.718536,4
2020-03-01-170210,170210,0,0,1,0,0.0,0.0,6
2020-03-02-170210,170210,1,0,4,1,1.0,0.03531732,0
2020-03-03-170210,170210,0,0,2,1,0.0,2.0246794e-07,1
2020-03-04-170210,170210,0,0,4,1,0.0,0.0024891307,2
2020-03-05-170210,170210,0,0,0,1,0.0,0.0002026807,3
2020-03-06-170210,170210,0,0,1,1,0.0,0.0049951263,4
2020-03-07-170210,170210,0,2,2,1,0.0,0.020552248,5
2020-03-08-170210,170210,0,0,0,1,0.0,0.0025561517,6
2020-03-09-170210,170210,0,0,5,1,0.0,0.013087938,0
2020-03-10-170210,170210,0,0,2,1,0.0,0.05642763,1
2020-03-11-170210,170210,2,0,1,3,2.0,0.08613824,2
2020-03-12-170210,170210,1,1,1,4,1.0,0.05221722,3
2020-03-13-170210,170210,1,0,1,5,1.0,0.057600945,4
2020-03-14-170210,170210,1,0,1,6,1.0,0.03794658,5
2020-03-15-170210,170210,1,0,1,7,1.0,0.026458155,6
2020-03-16-170210,170210,4,0,1,11,4.0,0.1272849,0
2020-03-17-170210,170210,2,0,0,13,2.0,0.09674384,1
2020-03-18-170210,170210,4,0,4,17,4.0,0.17412694,2
2020-03-19-170210,170210,0,0,0,17,0.0,0.0423082,3
2020-03-20-170210,170210,1,0,2,18,1.0,0.069598846,4
2020-03-21-170210,170210,2,0,0,20,2.0,0.06603392,5
2020-03-22-170210,170210,0,0,0,20,0.0,0.007195049,6
2020-03-23-170210,170210,5,1,0,25,5.0,0.1906042,0
2020-03-24-170210,170210,2,0,1,27,2.0,0.19770463,1
2020-03-25-170210,170210,1,0,0,28,1.0,0.08702624,2
2020-03-26-170210,170210,1,0,0,29,1.0,0.06151002,3
2020-03-27-170210,170210,1,0,1,30,1.0,0.06352851,4
2020-03-28-170210,170210,1,0,0,31,1.0,0.029180713,5
2020-03-29-170210,170210,1,0,2,32,1.0,0.018910324,6
2020-03-30-170210,170210,1,0,0,33,1.0,0.062348142,0
2020-03-31-170210,170210,0,0,0,33,0.0,0.047288615,1
2020-04-01-170210,170210,4,0,0,37,4.0,0.11770175,2
2020-04-02-170210,170210,0,0,0,37,0.0,0.021350477,3
2020-04-03-170210,170210,2,0,0,39,2.0,0.09889949,4
2020-04-04-170210,170210,0,0,0,39,0.0,0.009535466,5
2020-04-05-170210,170210,0,0,0,39,0.0,0.0016460947,6
2020-04-06-170210,170210,0,0,0,39,0.0,0.030517412,0
2020-04-07-170210,170210,1,0,0,40,1.0,0.054222375,1
2020-04-08-170210,170210,0,0,1,40,0.0,0.022084758,2
2020-04-09-170210,170210,0,0,0,40,0.0,0.036438674,3
2020-04-10-170210,170210,1,0,0,41,1.0,0.02708366,4
2020-04-11-170210,170210,0,0,0,41,0.0,0.0038407394,5
2020-04-12-170210,170210,2,0,0,43,2.0,0.033605393,6
2020-04-13-170210,170210,0,0,0,43,0.0,0.010927734,0
2020-04-14-170210,170210,0,0,1,43,0.0,0.019079642,1
2020-04-15-170210,170210,0,0,0,43,0.0,0.02133565,2
2020-04-16-170210,170210,0,0,0,43,0.0,0.02600583,3
2020-04-17-170210,170210,0,0,1,43,0.0,0.009657936,4
2020-04-18-170210,170210,0,0,0,43,0.0,0.0015382228,5
2020-04-19-170210,170210,0,0,0,43,0.0,0.00075404457,6
2020-04-20-170210,170210,0,0,0,43,0.0,0.026536817,0
2020-04-21-170210,170210,0,1,0,43,0.0,0.024296902,1
2020-04-22-170210,170210,1,0,1,44,1.0,0.044048097,2
2020-04-23-170210,170210,0,0,0,44,0.0,0.0063305385,3
2020-04-24-170210,170210,0,0,0,44,0.0,0.008026589,4
2020-04-25-170210,170210,0,0,0,44,0.0,0.0028177123,5
2020-04-26-170210,170210,0,0,0,44,0.0,0.0017540689,6
2020-04-27-170210,170210,0,0,0,44,0.0,0.0065201432,0
2020-04-28-170210,170210,1,0,0,45,1.0,0.044923168,1
2020-04-29-170210,170210,0,0,1,45,0.0,0.028842058,2
2020-04-30-170210,170210,0,0,0,45,0.0,0.010610809,3
2020-05-01-170210,170210,1,0,0,46,1.0,0.026604692,4
2020-05-02-170210,170210,0,0,0,46,0.0,0.0037032613,5
2020-05-03-170210,170210,0,0,0,46,0.0,0.000753452,6
2020-05-04-170210,170210,0,0,1,46,0.0,0.019974438,0
2020-05-05-170210,170210,0,0,0,46,0.0,0.02721385,1
2020-05-06-170210,170210,1,0,0,47,1.0,0.06044781,2
2020-05-07-170210,170210,0,0,1,47,0.0,0.024356773,3
2020-05-08-170210,170210,0,0,0,47,0.0,0.00747617,4
2020-05-09-170210,170210,0,0,0,47,0.0,0.00038351316,5
2020-05-10-170210,170210,0,0,0,47,0.0,0.005122264,6
2020-05-11-170210,170210,0,0,0,47,0.0,0.019619478,0
2020-05-12-170210,170210,0,0,0,47,0.0,0.015889397,1
2020-05-13-170210,170210,1,0,0,48,1.0,0.076076254,2
2020-05-14-170210,170210,0,0,0,48,0.0,0.031253505,3
2020-05-15-170210,170210,0,0,1,48,0.0,0.02350992,4
2020-05-16-170210,170210,0,0,0,48,0.0,0.0,5
2020-05-17-170210,170210,0,0,0,48,0.0,0.0,6
2020-05-18-170210,170210,1,0,0,49,1.0,0.061316177,0
2020-05-19-170210,170210,0,0,0,49,0.0,0.01035522,1
2020-05-20-170210,170210,0,0,0,49,0.0,0.010617903,2
2020-05-21-170210,170210,1,0,0,50,1.0,0.061431147,3
2020-05-22-170210,170210,0,0,0,50,0.0,0.008648756,4
2020-05-23-170210,170210,0,0,0,50,0.0,5.697082e-06,5
2020-05-24-170210,170210,0,0,0,50,0.0,0.0,6
2020-05-25-170210,170210,0,0,0,50,0.0,0.017705005,0
2020-05-26-170210,170210,0,0,0,50,0.0,0.016456602,1
2020-05-27-170210,170210,0,0,0,50,0.0,0.016749008,2
2020-05-28-170210,170210,0,1,0,50,0.0,0.01845647,3
2020-05-29-170210,170210,1,0,0,51,1.0,0.0523403,4
2020-05-30-170210,170210,0,0,0,51,0.0,0.0,5
2020-05-31-170210,170210,0,0,0,51,0.0,3.9992665e-05,6
2020-06-01-170210,170210,0,0,0,51,0.0,0.019471796,0
2020-06-02-170210,170210,0,0,0,51,0.0,0.0062026093,1
2020-06-03-170210,170210,0,0,0,51,0.0,0.012015586,2
2020-06-04-170210,170210,0,0,0,51,0.0,0.014593989,3
2020-06-05-170210,170210,0,0,0,51,0.0,0.0071927314,4
2020-06-06-170210,170210,0,0,0,51,0.0,0.0036331373,5
2020-06-07-170210,170210,0,0,0,51,0.0,6.9568937e-06,6
2020-06-08-170210,170210,0,0,0,51,0.0,0.009114249,0
2020-06-09-170210,170210,0,1,0,51,0.0,2.1706677e-05,1
2020-06-10-170210,170210,0,0,0,51,0.0,0.0088813575,2
2020-06-11-170210,170210,0,0,0,51,0.0,0.0048442967,3
2020-06-12-170210,170210,0,0,0,51,0.0,0.013595215,4
2020-06-13-170210,170210,0,0,0,51,0.0,0.00014989902,5
2020-06-14-170210,170210,0,1,0,51,0.0,0.0014250241,6
2020-06-15-170210,170210,0,2,0,51,0.0,0.0013735854,0
2020-06-16-170210,170210,0,0,0,51,0.0,0.0058551887,1
2020-06-17-170210,170210,0,0,0,51,0.0,0.0016195367,2
2020-06-18-170210,170210,0,0,0,51,0.0,0.0062058214,3
2020-06-19-170210,170210,0,0,0,51,0.0,0.0021732757,4
2020-06-20-170210,170210,0,0,0,51,0.0,0.00062126585,5
2020-06-21-170210,170210,0,1,0,51,0.0,0.0013060254,6
2020-06-22-170210,170210,0,0,0,51,0.0,0.0017113655,0
2020-06-23-170210,170210,0,0,0,51,0.0,0.0038997645,1
2020-06-24-170210,170210,0,0,0,51,0.0,0.004863102,2
2020-06-25-170210,170210,0,0,0,51,0.0,0.00096913654,3
2020-06-26-170210,170210,0,0,0,51,0.0,0.010060745,4
2020-06-27-170210,170210,0,0,0,51,0.0,0.0028403925,5
2020-06-28-170210,170210,0,0,0,51,0.0,0.0033520758,6
2020-06-29-170210,170210,0,0,0,51,0.0,0.0033017807,0
2020-06-30-170210,170210,0,0,0,51,0.0,0.014341409,1
2020-07-01-170210,170210,0,0,0,51,0.0,0.014627065,2
2020-07-02-170210,170210,0,0,1,51,0.0,0.0008877014,3
2020-07-03-170210,170210,0,0,1,51,0.0,0.008293045,4
2020-07-04-170210,170210,0,0,0,51,0.0,1.9089855e-08,5
2020-07-05-170210,170210,0,0,0,51,0.0,0.00010831394,6
2020-07-06-170210,170210,0,0,0,51,0.0,0.0046348195,0
2020-07-07-170210,170210,0,0,0,51,0.0,0.0009921794,1
2020-07-08-170210,170210,0,0,0,51,0.0,0.012879658,2
2020-07-09-170210,170210,0,0,0,51,0.0,0.01286625,3
2020-07-10-170210,170210,0,0,0,51,0.0,0.005125833,4
2020-07-11-170210,170210,0,0,0,51,0.0,0.0039279643,5
2020-07-12-170210,170210,0,0,0,51,0.0,0.00060298294,6
2020-07-13-170210,170210,0,0,0,51,0.0,4.9400936e-05,0
2020-07-14-170210,170210,0,0,0,51,0.0,0.0024963317,1
2020-07-15-170210,170210,0,0,0,51,0.0,0.0033283667,2
2020-07-16-170210,170210,1,0,1,52,1.0,0.04947336,3
2020-07-17-170210,170210,1,0,0,53,1.0,0.040285148,4
2020-07-18-170210,170210,0,0,0,53,0.0,0.004855965,5
2020-07-19-170210,170210,0,0,0,53,0.0,0.00083144766,6
2020-07-20-170210,170210,0,0,0,53,0.0,0.0025421048,0
2020-07-21-170210,170210,0,0,0,53,0.0,0.0009718982,1
2020-07-22-170210,170210,0,0,1,53,0.0,0.00026494154,2
2020-07-23-170210,170210,0,0,1,53,0.0,0.010367759,3
2020-07-24-170210,170210,0,0,0,53,0.0,0.007559103,4
2020-07-25-170210,170210,0,0,0,53,0.0,0.008565999,5
2020-07-26-170210,170210,0,0,0,53,0.0,0.015313613,6
2020-07-27-170210,170210,0,0,1,53,0.0,0.0019040979,0
2020-07-28-170210,170210,0,0,2,53,0.0,0.0077556134,1
2020-07-29-170210,170210,0,0,0,53,0.0,0.01949346,2
2020-07-30-170210,170210,1,0,0,54,1.0,0.016205203,3
2020-07-31-170210,170210,0,0,0,54,0.0,0.010432035,4
2020-08-01-170210,170210,0,0,0,54,0.0,0.013675076,5
2020-08-02-170210,170210,0,0,0,54,0.0,0.01063176,6
2020-08-03-170210,170210,0,0,0,54,0.0,0.0069113476,0
2020-08-04-170210,170210,0,0,0,54,0.0,0.018311925,1
2020-08-05-170210,170210,1,0,0,55,1.0,0.109167114,2
2020-08-06-170210,170210,1,0,0,56,1.0,0.07432101,3
2020-08-07-170210,170210,0,0,0,56,0.0,0.015028966,4
2020-08-08-170210,170210,0,0,0,56,0.0,0.01883707,5
2020-08-09-170210,170210,0,0,0,56,0.0,0.007057177,6
2020-08-10-170210,170210,1,0,0,57,1.0,0.06637244,0
2020-08-11-170210,170210,2,0,0,59,2.0,0.077182986,1
2020-08-12-170210,170210,0,0,0,59,0.0,0.058238905,2
2020-08-13-170210,170210,0,0,0,59,0.0,0.03520318,3
2020-08-14-170210,170210,0,0,0,59,0.0,0.017850474,4
2020-08-15-170210,170210,0,0,0,59,0.0,0.028841214,5
2020-08-16-170210,170210,0,0,0,59,0.0,0.04010731,6
2020-08-17-170210,170210,0,0,0,59,0.0,0.05916642,0
2020-08-18-170210,170210,0,0,0,59,0.0,0.043269068,1
2020-08-19-170210,170210,0,0,1,59,0.0,0.055447694,2
2020-08-20-170210,170210,0,0,0,59,0.0,0.038911313,3
2020-08-21-170210,170210,0,0,0,59,0.0,0.061994597,4
2020-08-22-170210,170210,0,0,0,59,0.0,0.008138503,5
2020-08-23-170210,170210,0,0,2,59,0.0,0.011028739,6
2020-08-24-170210,170210,0,0,0,59,0.0,0.065928906,0
2020-08-25-170210,170210,0,0,0,59,0.0,0.060115345,1
2020-08-26-170210,170210,0,0,0,59,0.0,0.09270349,2
2020-08-27-170210,170210,0,0,0,59,0.0,0.036464553,3
2020-08-28-170210,170210,0,0,0,59,0.0,0.04715473,4
2020-08-29-170210,170210,0,0,0,59,0.0,0.012205034,5
2020-08-30-170210,170210,0,0,1,59,0.0,0.031059988,6
2020-08-31-170210,170210,0,0,0,59,0.0,0.011793484,0
2020-09-01-170210,170210,0,0,0,59,0.0,0.0546948,1
2020-09-02-170210,170210,1,0,1,60,1.0,0.09481129,2
2020-09-03-170210,170210,0,0,1,60,0.0,0.052582026,3
2020-09-04-170210,170210,0,0,0,60,0.0,0.05265858,4
2020-09-05-170210,170210,0,0,0,60,0.0,0.061827682,5
2020-09-06-170210,170210,2,0,0,62,2.0,0.017357506,6
2020-09-07-170210,170210,0,0,0,62,0.0,0.060356658,0
2020-09-08-170210,170210,0,0,0,62,0.0,0.045176625,1
2020-09-09-170210,170210,0,0,2,62,0.0,0.063797764,2
2020-09-10-170210,170210,0,0,4,62,0.0,0.06739408,3
2020-09-11-170210,170210,0,0,1,62,0.0,0.09748978,4
2020-09-12-170210,170210,0,0,0,62,0.0,0.090815745,5
2020-09-13-170210,170210,1,0,0,63,1.0,0.08971882,6
2020-09-14-170210,170210,0,0,0,63,0.0,0.05349874,0
2020-09-15-170210,170210,0,0,0,63,0.0,0.14713624,1
2020-09-16-170210,170210,1,0,0,64,1.0,0.09762246,2
2020-09-17-170210,170210,1,0,0,65,1.0,0.06901583,3
2020-09-18-170210,170210,0,0,0,65,0.0,0.1443417,4
2020-09-19-170210,170210,0,0,0,65,0.0,0.018330874,5
2020-09-20-170210,170210,0,0,0,65,0.0,0.017154492,6
2020-09-21-170210,170210,0,0,0,65,0.0,0.18000431,0
2020-09-22-170210,170210,0,0,1,65,0.0,0.11080454,1
2020-09-23-170210,170210,2,0,2,67,2.0,0.07473289,2
2020-09-24-170210,170210,4,0,1,71,4.0,0.14169654,3
2020-09-25-170210,170210,1,0,3,72,1.0,0.18280801,4
2020-09-26-170210,170210,0,0,1,72,0.0,0.02768612,5
2020-09-27-170210,170210,0,0,0,72,0.0,0.010915572,6
2020-09-28-170210,170210,0,0,0,72,0.0,0.17185467,0
2020-09-29-170210,170210,0,0,0,72,0.0,0.11109615,1
2020-09-30-170210,170210,0,0,0,72,0.0,0.081594124,2
2020-10-01-170210,170210,0,0,1,72,0.0,0.18168068,3
2020-10-02-170210,170210,0,0,0,72,0.0,0.07024445,4
2020-10-03-170210,170210,0,0,0,72,0.0,0.01141901,5
2020-10-04-170210,170210,0,0,1,72,0.0,0.026091749,6
2020-10-05-170210,170210,0,0,0,72,0.0,0.069996856,0
2020-10-06-170210,170210,1,0,0,73,1.0,0.10837283,1
2020-10-07-170210,170210,2,2,1,75,2.0,0.095897555,2
2020-10-08-170210,170210,1,0,1,76,1.0,0.116624594,3
2020-10-09-170210,170210,3,0,1,79,3.0,0.04148938,4
2020-10-10-170210,170210,1,0,0,80,1.0,0.048567433,5
2020-10-11-170210,170210,0,0,0,80,0.0,0.010037462,6
2020-10-12-170210,170210,0,0,1,80,0.0,0.019337304,0
2020-10-13-170210,170210,0,0,0,80,0.0,0.102898076,1
2020-10-14-170210,170210,0,0,0,80,0.0,0.116923355,2
2020-10-15-170210,170210,1,0,1,81,1.0,0.105435155,3
2020-10-16-170210,170210,0,0,2,81,0.0,0.10262145,4
2020-10-17-170210,170210,0,0,1,81,0.0,0.03532763,5
2020-10-18-170210,170210,1,0,0,82,1.0,0.06494505,6
2020-10-19-170210,170210,0,0,0,82,0.0,0.076194145,0
2020-10-20-170210,170210,0,0,1,82,0.0,0.037435446,1
2020-10-21-170210,170210,1,0,0,83,1.0,0.120167285,2
2020-10-22-170210,170210,1,0,1,84,1.0,0.055854473,3
2020-10-23-170210,170210,1,0,1,85,1.0,0.052900754,4
2020-10-24-170210,170210,0,0,0,85,0.0,0.004100654,5
2020-10-25-170210,170210,0,0,0,85,0.0,0.046139248,6
2020-10-26-170210,170210,1,0,2,86,1.0,0.12064169,0
2020-10-27-170210,170210,0,0,1,86,0.0,0.10761005,1
2020-10-28-170210,170210,0,1,0,86,0.0,0.10405762,2
2020-10-29-170210,170210,1,0,1,87,1.0,0.054367315,3
2020-10-30-170210,170210,2,0,0,89,2.0,0.16787535,4
2020-10-31-170210,170210,1,0,0,90,1.0,0.06578213,5
2020-11-01-170210,170210,0,0,0,90,0.0,0.008974913,6
2020-11-02-170210,170210,0,0,0,90,0.0,0.04230139,0
2020-11-03-170210,170210,1,0,0,91,1.0,0.068324886,1
2020-11-04-170210,170210,0,0,0,91,0.0,0.04831834,2
2020-11-05-170210,170210,1,0,0,92,1.0,0.028177578,3
2020-11-06-170210,170210,1,0,0,93,1.0,0.052826136,4
2020-11-07-170210,170210,0,0,0,93,0.0,0.017028967,5
2020-11-08-170210,170210,0,0,0,93,0.0,0.02070516,6
2020-11-09-170210,170210,2,0,0,95,2.0,0.13410707,0
2020-11-10-170210,170210,1,0,0,96,1.0,0.12865461,1
2020-11-11-170210,170210,0,0,0,96,0.0,0.054523025,2
2020-11-12-170210,170210,1,0,0,97,1.0,0.057397995,3
2020-11-13-170210,170210,0,0,0,97,0.0,0.048043415,4
2020-03-01-170211,170211,0,0,0,0,0.0,5.8133487e-08,6
2020-03-02-170211,170211,0,0,0,0,0.0,0.0015391763,0
2020-03-03-170211,170211,0,0,0,0,0.0,0.00185131,1
2020-03-04-170211,170211,0,0,0,0,0.0,0.014598816,2
2020-03-05-170211,170211,0,0,0,0,0.0,2.9352232e-05,3
2020-03-06-170211,170211,0,0,3,0,0.0,0.009835583,4
2020-03-07-170211,170211,0,0,0,0,0.0,0.0049792407,5
2020-03-08-170211,170211,0,0,1,0,0.0,0.00043325225,6
2020-03-09-170211,170211,0,0,2,0,0.2,0.087186426,0
2020-03-10-170211,170211,0,0,2,0,0.0,0.008813581,1
2020-03-11-170211,170211,0,0,1,0,0.0,0.040675685,2
2020-03-12-170211,170211,1,0,3,1,0.0,0.08475088,3
2020-03-13-170211,170211,0,0,1,1,0.4,0.09203366,4
2020-03-14-170211,170211,0,0,0,1,0.2,0.060453005,5
2020-03-15-170211,170211,0,0,0,1,0.4,0.029933138,6
2020-03-16-170211,170211,0,0,0,1,0.4,0.041288182,0
2020-03-17-170211,170211,0,0,0,1,0.8,0.13525644,1
2020-03-18-170211,170211,0,1,7,1,1.6,0.22184838,2
2020-03-19-170211,170211,0,0,1,1,1.2,0.33334786,3
2020-03-20-170211,170211,3,0,2,4,2.2,0.5409485,4
2020-03-21-170211,170211,0,0,2,4,0.6,0.14213806,5
2020-03-22-170211,170211,1,0,0,5,2.2,0.11398178,6
2020-03-23-170211,170211,2,0,0,7,1.4,0.722044,0
2020-03-24-170211,170211,2,1,0,9,1.2,0.67245024,1
2020-03-25-170211,170211,1,0,1,10,1.8,0.472519,2
2020-03-26-170211,170211,3,0,0,13,1.8,0.49196202,3
2020-03-27-170211,170211,1,0,1,14,1.2,0.34263608,4
2020-03-28-170211,170211,0,1,0,14,0.0,0.09866292,5
2020-03-29-170211,170211,0,0,0,14,0.2,0.021983154,6
2020-03-30-170211,170211,0,0,2,14,1.0,0.30800462,0
2020-03-31-170211,170211,0,0,2,14,1.4,0.21507378,1
2020-04-01-170211,170211,7,0,1,21,1.6,0.5742202,2
2020-04-02-170211,170211,1,0,0,22,0.4,0.42894164,3
2020-04-03-170211,170211,2,0,0,24,1.2,0.5174358,4
2020-04-04-170211,170211,2,0,0,26,0.6,0.15725762,5
2020-04-05-170211,170211,0,0,0,26,0.2,0.025623849,6
2020-04-06-170211,170211,0,0,0,26,1.4,0.3366167,0
2020-04-07-170211,170211,0,0,1,26,0.8,0.27262998,1
2020-04-08-170211,170211,1,2,1,27,1.4,0.17980136,2
2020-04-09-170211,170211,0,0,0,27,0.6,0.24242261,3
2020-04-10-170211,170211,1,0,0,28,1.0,0.12258876,4
2020-04-11-170211,170211,0,0,0,28,0.4,0.046669006,5
2020-04-12-170211,170211,0,0,0,28,0.2,0.0063218456,6
2020-04-13-170211,170211,2,0,0,30,0.6,0.3432437,0
2020-04-14-170211,170211,2,0,0,32,0.2,0.24920706,1
2020-04-15-170211,170211,1,0,0,33,0.4,0.21802743,2
2020-04-16-170211,170211,0,0,0,33,0.4,0.13611116,3
2020-04-17-170211,170211,0,0,0,33,0.0,0.07040338,4
2020-04-18-170211,170211,0,0,0,33,0.0,0.025606206,5
2020-04-19-170211,170211,0,0,0,33,0.0,0.047281884,6
2020-04-20-170211,170211,0,0,0,33,1.2,0.2518838,0
2020-04-21-170211,170211,1,0,0,34,0.2,0.1430659,1
2020-04-22-170211,170211,1,0,0,35,0.4,0.21691594,2
2020-04-23-170211,170211,0,0,0,35,0.2,0.013200514,3
2020-04-24-170211,170211,0,0,0,35,0.2,0.09612308,4
2020-04-25-170211,170211,0,0,0,35,0.6,0.029097896,5
2020-04-26-170211,170211,0,0,0,35,0.4,0.046840742,6
2020-04-27-170211,170211,0,0,0,35,0.4,0.10071942,0
2020-04-28-170211,170211,0,0,1,35,0.8,0.077868015,1
2020-04-29-170211,170211,0,0,0,35,0.4,0.08917748,2
2020-04-30-170211,170211,0,0,0,35,0.0,0.01626591,3
2020-05-01-170211,170211,0,0,0,35,0.4,0.025139384,4
2020-05-02-170211,170211,0,0,0,35,0.2,0.010834171,5
2020-05-03-170211,170211,0,0,0,35,0.0,0.0005008763,6
2020-05-04-170211,170211,0,0,0,35,0.2,0.08713775,0
2020-05-05-170211,170211,0,0,0,35,0.0,0.11270844,1
2020-05-06-170211,170211,0,0,1,35,0.2,0.102680914,2
2020-05-07-170211,170211,0,0,0,35,0.4,0.04229001,3
2020-05-08-170211,170211,0,0,0,35,0.4,0.089998126,4
2020-05-09-170211,170211,0,0,0,35,0.2,0.011832321,5
2020-05-10-170211,170211,0,1,0,35,0.0,0.035918895,6
2020-05-11-170211,170211,0,0,0,35,0.4,0.0641357,0
2020-05-12-170211,170211,1,2,0,36,0.0,0.11726062,1
2020-05-13-170211,170211,0,0,0,36,1.2,0.19082075,2
2020-05-14-170211,170211,0,0,0,36,0.8,0.17532866,3
2020-05-15-170211,170211,0,0,0,36,0.0,0.0919925,4
2020-05-16-170211,170211,0,0,0,36,0.0,0.0006793908,5
2020-05-17-170211,170211,0,0,0,36,0.0,0.0058852965,6
2020-05-18-170211,170211,0,0,0,36,0.4,0.13056111,0
2020-05-19-170211,170211,0,0,0,36,0.4,0.06271812,1
2020-05-20-170211,170211,1,0,0,37,0.2,0.12417007,2
2020-05-21-170211,170211,0,0,2,37,0.4,0.078309126,3
2020-05-22-170211,170211,0,0,0,37,0.6,0.0824685,4
2020-05-23-170211,170211,0,0,0,37,0.2,0.009210161,5
2020-05-24-170211,170211,0,0,0,37,0.0,0.002090227,6
2020-05-25-170211,170211,0,0,1,37,0.0,0.114216745,0
2020-05-26-170211,170211,0,0,0,37,1.0,0.07937842,1
2020-05-27-170211,170211,0,0,0,37,0.4,0.05700285,2
2020-05-28-170211,170211,0,0,0,37,0.6,0.07587936,3
2020-05-29-170211,170211,0,1,0,37,0.2,0.06720135,4
2020-05-30-170211,170211,0,0,0,37,0.0,0.0002750822,5
2020-05-31-170211,170211,0,0,0,37,0.2,0.0074297376,6
2020-06-01-170211,170211,0,0,1,37,0.6,0.108584754,0
2020-06-02-170211,170211,0,0,0,37,0.6,0.05724433,1
2020-06-03-170211,170211,0,0,0,37,0.2,0.060761824,2
2020-06-04-170211,170211,2,0,0,39,0.4,0.21794716,3
2020-06-05-170211,170211,0,0,1,39,0.2,0.05736992,4
2020-06-06-170211,170211,0,1,0,39,0.4,0.022166722,5
2020-06-07-170211,170211,0,1,0,39,0.2,0.007913516,6
2020-06-08-170211,170211,1,0,0,40,0.4,0.07743173,0
2020-06-09-170211,170211,0,0,0,40,0.2,0.02185163,1
2020-06-10-170211,170211,0,0,0,40,0.0,0.09359467,2
2020-06-11-170211,170211,0,0,0,40,0.4,0.09166602,3
2020-06-12-170211,170211,0,0,0,40,0.0,0.11750017,4
2020-06-13-170211,170211,0,2,0,40,0.0,0.003330737,5
2020-06-14-170211,170211,0,0,0,40,0.2,0.010642444,6
2020-06-15-170211,170211,1,0,0,41,0.2,0.09924032,0
2020-06-16-170211,170211,0,0,1,41,0.4,0.06755779,1
2020-06-17-170211,170211,0,0,0,41,0.2,0.028741863,2
2020-06-18-170211,170211,0,0,0,41,0.0,0.040362373,3
2020-06-19-170211,170211,1,0,0,42,0.2,0.111390114,4
2020-06-20-170211,170211,0,0,0,42,0.0,0.0036169356,5
2020-06-21-170211,170211,0,0,0,42,0.2,0.013283069,6
2020-06-22-170211,170211,0,0,1,42,0.0,0.008783994,0
2020-06-23-170211,170211,0,0,1,42,0.2,0.034105632,1
2020-06-24-170211,170211,0,0,1,42,0.0,0.017325103,2
2020-06-25-170211,170211,0,1,0,42,0.0,0.010134008,3
2020-06-26-170211,170211,0,0,1,42,0.0,0.028374303,4
2020-06-27-170211,170211,0,0,0,42,0.0,0.022381693,5
2020-06-28-170211,170211,0,0,0,42,0.0,0.0002499405,6
2020-06-29-170211,170211,0,0,0,42,0.0,0.0013111721,0
2020-06-30-170211,170211,1,1,1,43,0.0,0.15632837,1
2020-07-01-170211,170211,0,0,0,43,0.0,0.08788944,2
2020-07-02-170211,170211,0,0,0,43,0.2,0.017237825,3
2020-07-03-170211,170211,0,0,0,43,0.0,0.20820096,4
2020-07-04-170211,170211,0,0,0,43,0.2,0.0011119889,5
2020-07-05-170211,170211,0,0,0,43,0.4,0.022866316,6
2020-07-06-170211,170211,1,0,0,44,0.4,0.048020244,0
2020-07-07-170211,170211,1,0,0,45,0.2,0.11524555,1
2020-07-08-170211,170211,1,0,1,46,0.4,0.23353916,2
2020-07-09-170211,170211,0,0,0,46,0.2,0.14127733,3
2020-07-10-170211,170211,1,0,0,47,0.0,0.14998405,4
2020-07-11-170211,170211,0,0,0,47,0.0,0.0018535622,5
2020-07-12-170211,170211,0,0,0,47,0.0,0.007766628,6
2020-07-13-170211,170211,0,0,0,47,0.0,0.0030028147,0
2020-07-14-170211,170211,1,0,0,48,0.2,0.17083636,1
2020-07-15-170211,170211,0,0,0,48,0.8,0.04650957,2
2020-07-16-170211,170211,0,0,0,48,0.2,0.062126074,3
2020-07-17-170211,170211,0,0,0,48,0.0,0.010479127,4
2020-07-18-170211,170211,0,0,1,48,0.0,0.08273313,5
2020-07-19-170211,170211,0,0,0,48,0.0,0.082977824,6
2020-07-20-170211,170211,0,0,0,48,0.6,0.05743109,0
2020-07-21-170211,170211,0,0,1,48,0.0,0.079949565,1
2020-07-22-170211,170211,1,1,4,49,0.2,0.112912215,2
2020-07-23-170211,170211,0,0,0,49,0.0,0.023024503,3
2020-07-24-170211,170211,0,0,9,49,0.2,0.02429877,4
2020-07-25-170211,170211,0,0,0,49,0.2,0.019027602,5
2020-07-26-170211,170211,0,0,2,49,0.0,0.003927248,6
2020-07-27-170211,170211,0,0,1,49,0.2,0.05278525,0
2020-07-28-170211,170211,0,0,3,49,0.8,0.11364678,1
2020-07-29-170211,170211,0,0,5,49,0.2,0.09564795,2
2020-07-30-170211,170211,0,0,2,49,0.4,0.10424771,3
2020-07-31-170211,170211,0,0,0,49,0.4,0.053359464,4
2020-08-01-170211,170211,1,0,0,50,0.4,0.1365987,5
2020-08-02-170211,170211,0,0,0,50,0.8,0.1928794,6
2020-08-03-170211,170211,0,0,1,50,1.2,0.24904236,0
2020-08-04-170211,170211,1,0,1,51,1.4,0.6073543,1
2020-08-05-170211,170211,4,0,2,55,2.4,0.8969954,2
2020-08-06-170211,170211,0,0,2,55,2.4,0.42491528,3
2020-08-07-170211,170211,9,0,11,64,1.6,1.2543309,4
2020-08-08-170211,170211,0,0,5,64,1.2,0.23100127,5
2020-08-09-170211,170211,2,0,0,66,1.0,0.29487845,6
2020-08-10-170211,170211,1,0,0,67,1.4,0.46936935,0
2020-08-11-170211,170211,3,0,1,70,4.8,0.66673493,1
2020-08-12-170211,170211,5,0,3,75,3.4,0.91825193,2
2020-08-13-170211,170211,2,0,1,77,2.8,1.1200598,3
2020-08-14-170211,170211,0,0,0,77,1.2,0.13198216,4
2020-08-15-170211,170211,0,0,1,77,0.8,0.15521728,5
2020-08-16-170211,170211,0,0,1,77,0.2,0.108175814,6
2020-08-17-170211,170211,1,0,2,78,0.4,0.2345978,0
2020-08-18-170211,170211,1,0,0,79,1.2,0.6287601,1
2020-08-19-170211,170211,2,0,2,81,2.6,0.77359486,2
2020-08-20-170211,170211,2,0,0,83,3.6,0.70993423,3
2020-08-21-170211,170211,11,0,0,94,2.2,1.6384437,4
2020-08-22-170211,170211,5,0,1,99,0.2,0.5846551,5
2020-08-23-170211,170211,0,0,0,99,1.2,0.112398185,6
2020-08-24-170211,170211,0,0,1,99,0.6,0.4189878,0
2020-08-25-170211,170211,1,0,0,100,0.8,0.2845059,1
2020-08-26-170211,170211,3,0,9,103,2.4,0.45333484,2
2020-08-27-170211,170211,1,0,0,104,2.4,0.4432434,3
2020-08-28-170211,170211,0,0,1,104,4.2,0.6006831,4
2020-08-29-170211,170211,1,0,0,105,0.6,0.23103061,5
2020-08-30-170211,170211,1,0,1,106,1.2,0.19989838,6
2020-08-31-170211,170211,2,0,3,108,1.8,0.42717618,0
2020-09-01-170211,170211,0,0,7,108,1.6,0.2437542,1
2020-09-02-170211,170211,2,0,1,110,1.6,0.4220666,2
2020-09-03-170211,170211,0,0,3,110,1.2,0.1721383,3
2020-09-04-170211,170211,0,0,2,110,0.6,0.19358061,4
2020-09-05-170211,170211,1,0,2,111,1.8,0.4840843,5
2020-09-06-170211,170211,0,0,0,111,0.2,0.09777077,6
2020-09-07-170211,170211,1,0,1,112,1.0,0.15968779,0
2020-09-08-170211,170211,0,0,1,112,0.6,0.33016935,1
2020-09-09-170211,170211,9,0,2,121,1.0,0.9183078,2
2020-09-10-170211,170211,0,0,2,121,1.2,0.18906799,3
2020-09-11-170211,170211,1,0,1,122,1.8,0.42475224,4
2020-09-12-170211,170211,0,0,0,122,0.8,0.3028982,5
2020-09-13-170211,170211,1,0,0,123,1.0,0.16381551,6
2020-09-14-170211,170211,3,0,2,126,2.0,0.3650641,0
2020-09-15-170211,170211,7,0,0,133,3.0,0.8961478,1
2020-09-16-170211,170211,1,0,3,134,2.0,0.21606189,2
2020-09-17-170211,170211,3,0,1,137,2.0,0.49226353,3
2020-09-18-170211,170211,2,0,0,139,1.4,0.47968835,4
2020-09-19-170211,170211,2,0,0,141,0.6,0.22522528,5
2020-09-20-170211,170211,0,0,0,141,1.6,0.04605527,6
2020-09-21-170211,170211,1,0,0,142,1.2,0.3068421,0
2020-09-22-170211,170211,1,0,3,143,1.6,0.311444,1
2020-09-23-170211,170211,2,0,0,145,1.4,0.2581815,2
2020-09-24-170211,170211,2,0,1,147,2.2,0.25042334,3
2020-09-25-170211,170211,1,1,1,148,0.8,0.17193575,4
2020-09-26-170211,170211,0,0,1,148,0.4,0.2558531,5
2020-09-27-170211,170211,0,0,0,148,0.2,0.062140986,6
2020-09-28-170211,170211,2,0,0,150,0.4,0.310624,0
2020-09-29-170211,170211,0,0,0,150,0.6,0.14138402,1
2020-09-30-170211,170211,3,0,2,153,0.4,0.40693086,2
2020-10-01-170211,170211,1,0,1,154,1.0,0.22324592,3
2020-10-02-170211,170211,0,0,1,154,1.0,0.17831594,4
2020-10-03-170211,170211,0,0,0,154,0.0,0.036331642,5
2020-10-04-170211,170211,0,0,3,154,0.4,0.07843208,6
2020-10-05-170211,170211,0,0,0,154,1.0,0.28198227,0
2020-10-06-170211,170211,3,0,0,157,2.2,0.555558,1
2020-10-07-170211,170211,0,1,3,157,0.8,0.3658759,2
2020-10-08-170211,170211,1,0,1,158,0.2,0.24290594,3
2020-10-09-170211,170211,1,0,0,159,0.4,0.2114034,4
2020-10-10-170211,170211,1,0,2,160,0.0,0.13220155,5
2020-10-11-170211,170211,0,0,0,160,0.2,0.06744052,6
2020-10-12-170211,170211,0,0,1,160,0.2,0.08161356,0
2020-10-13-170211,170211,0,0,0,160,1.4,0.33502057,1
2020-10-14-170211,170211,2,0,12,162,0.2,0.49000722,2
2020-10-15-170211,170211,1,0,3,163,0.8,0.5026582,3
2020-10-16-170211,170211,1,0,3,164,0.8,0.65889007,4
2020-10-17-170211,170211,0,0,5,164,0.4,0.11936259,5
2020-10-18-170211,170211,3,0,4,167,0.8,0.30753732,6
2020-10-19-170211,170211,0,0,1,167,0.0,0.378507,0
2020-10-20-170211,170211,0,0,8,167,1.8,0.27852947,1
2020-10-21-170211,170211,3,0,6,170,1.8,0.7035484,2
2020-10-22-170211,170211,1,0,6,171,3.0,0.5301637,3
2020-10-23-170211,170211,0,0,4,171,1.4,0.40410647,4
2020-10-24-170211,170211,2,1,3,173,0.4,0.26538962,5
2020-10-25-170211,170211,0,0,4,173,0.4,0.1076899,6
2020-10-26-170211,170211,1,0,12,174,1.0,0.379853,0
2020-10-27-170211,170211,0,0,6,174,1.2,0.39065617,1
2020-10-28-170211,170211,12,1,7,186,1.0,1.2927628,2
2020-10-29-170211,170211,3,0,5,189,1.8,0.50668395,3
2020-10-30-170211,170211,3,0,5,192,1.6,0.8124003,4
2020-10-31-170211,170211,5,0,0,197,1.0,0.65667117,5
2020-11-01-170211,170211,4,0,0,201,1.6,0.5766564,6
2020-11-02-170211,170211,1,0,0,202,1.4,0.27742645,0
2020-11-03-170211,170211,8,0,0,210,1.0,0.9061788,1
2020-11-04-170211,170211,6,0,0,216,2.0,0.76218206,2
2020-11-05-170211,170211,6,0,0,222,1.4,0.7463805,3
2020-11-06-170211,170211,4,0,0,226,1.8,0.6238908,4
2020-11-07-170211,170211,3,0,0,229,0.2,0.5877536,5
2020-11-08-170211,170211,4,0,0,233,1.0,0.43364793,6
2020-11-09-170211,170211,12,0,0,245,1.6,1.0700614,0
2020-11-10-170211,170211,6,0,0,251,2.2,0.65625453,1
2020-11-11-170211,170211,7,1,0,258,2.4,0.8485945,2
2020-11-12-170211,170211,5,0,0,263,3.0,0.5255874,3
2020-11-13-170211,170211,5,0,0,268,3.4,0.7367453,4
2020-03-01-170212,170212,0,0,4,0,0.25,0.00013070254,6
2020-03-02-170212,170212,0,0,16,0,0.75,0.022464659,0
2020-03-03-170212,170212,0,0,9,0,0.5,0.03138093,1
2020-03-04-170212,170212,0,0,16,0,0.75,0.6105244,2
2020-03-05-170212,170212,0,0,15,0,0.25,0.00070642546,3
2020-03-06-170212,170212,0,0,10,0,0.25,0.6060832,4
2020-03-07-170212,170212,0,1,2,0,0.0,0.008234061,5
2020-03-08-170212,170212,0,0,4,0,0.25,0.0051462944,6
2020-03-09-170212,170212,0,0,21,0,0.5,1.4420884,0
2020-03-10-170212,170212,1,0,13,1,2.25,0.060776547,1
2020-03-11-170212,170212,1,0,13,2,0.75,0.40720004,2
2020-03-12-170212,170212,1,0,10,3,1.75,0.16589995,3
2020-03-13-170212,170212,4,0,11,7,2.5,1.1732736,4
2020-03-14-170212,170212,5,0,3,12,2.5,1.5277898,5
2020-03-15-170212,170212,4,0,7,16,3.25,0.5005501,6
2020-03-16-170212,170212,16,0,10,32,9.0,1.2921398,0
2020-03-17-170212,170212,9,0,12,41,13.0,2.8450193,1
2020-03-18-170212,170212,16,0,6,57,17.25,3.2607725,2
2020-03-19-170212,170212,15,0,12,72,20.0,4.329699,3
2020-03-20-170212,170212,10,0,7,82,17.25,6.4513774,4
2020-03-21-170212,170212,2,0,1,84,7.0,0.65693545,5
2020-03-22-170212,170212,4,0,5,88,8.75,0.46961835,6
2020-03-23-170212,170212,21,0,13,109,19.5,5.1919465,0
2020-03-24-170212,170212,13,0,6,122,21.5,4.2337403,1
2020-03-25-170212,170212,13,0,6,135,16.5,4.1832585,2
2020-03-26-170212,170212,10,0,3,145,12.5,3.8849304,3
2020-03-27-170212,170212,11,0,6,156,20.0,4.0422807,4
2020-03-28-170212,170212,3,0,3,159,5.75,0.4326467,5
2020-03-29-170212,170212,7,0,2,166,3.75,0.5332136,6
2020-03-30-170212,170212,10,0,8,176,13.0,2.821419,0
2020-03-31-170212,170212,12,0,6,188,8.0,1.4453868,1
2020-04-01-170212,170212,6,0,10,194,6.25,1.4795694,2
2020-04-02-170212,170212,12,0,6,206,7.25,2.1076353,3
2020-04-03-170212,170212,7,0,1,213,8.5,2.784079,4
2020-04-04-170212,170212,1,0,2,214,3.0,0.028066775,5
2020-04-05-170212,170212,5,0,1,219,3.75,0.3295715,6
2020-04-06-170212,170212,13,1,4,232,9.0,2.8575695,0
2020-04-07-170212,170212,6,0,4,238,5.0,2.2816038,1
2020-04-08-170212,170212,6,0,4,244,7.0,2.4879417,2
2020-04-09-170212,170212,3,0,0,247,4.75,2.2931764,3
2020-04-10-170212,170212,6,0,4,253,7.0,0.8366755,4
2020-04-11-170212,170212,3,0,1,256,3.25,0.5105644,5
2020-04-12-170212,170212,2,0,1,258,1.0,0.26033172,6
2020-04-13-170212,170212,8,0,4,266,8.75,1.867521,0
2020-04-14-170212,170212,6,0,2,272,5.75,1.6365516,1
2020-04-15-170212,170212,10,0,4,282,14.75,2.8328104,2
2020-04-16-170212,170212,6,0,3,288,7.0,1.2997723,3
2020-04-17-170212,170212,1,0,0,289,5.5,1.195914,4
2020-04-18-170212,170212,2,0,0,291,1.0,0.26268423,5
2020-04-19-170212,170212,1,0,1,292,1.75,1.1736206,6
2020-04-20-170212,170212,4,0,0,296,6.5,2.5347414,0
2020-04-21-170212,170212,4,0,1,300,3.75,0.97577566,1
2020-04-22-170212,170212,4,0,0,304,5.5,0.4361912,2
2020-04-23-170212,170212,0,0,1,304,0.5,0.013852986,3
2020-04-24-170212,170212,4,0,0,308,4.0,1.2079444,4
2020-04-25-170212,170212,1,0,0,309,1.5,0.529268,5
2020-04-26-170212,170212,1,0,1,310,1.5,0.2966881,6
2020-04-27-170212,170212,4,0,4,314,5.75,1.6940857,0
2020-04-28-170212,170212,2,0,4,316,5.0,0.5613573,1
2020-04-29-170212,170212,4,0,9,320,2.5,1.3263094,2
2020-04-30-170212,170212,3,0,5,323,5.75,0.8064658,3
2020-05-01-170212,170212,0,0,6,323,0.75,0.0070939637,4
2020-05-02-170212,170212,0,0,2,323,0.75,0.33364233,5
2020-05-03-170212,170212,1,0,0,324,0.75,0.01496214,6
2020-05-04-170212,170212,0,0,4,324,3.75,1.614716,0
2020-05-05-170212,170212,1,0,5,325,4.75,0.9890212,1
2020-05-06-170212,170212,0,0,3,325,3.75,0.9567392,2
2020-05-07-170212,170212,1,0,5,326,4.25,0.7140618,3
2020-05-08-170212,170212,0,0,4,326,5.25,2.2498653,4
2020-05-09-170212,170212,0,0,0,326,0.0,0.008254025,5
2020-05-10-170212,170212,1,0,0,327,0.0,0.07957088,6
2020-05-11-170212,170212,4,0,3,331,3.25,0.98591536,0
2020-05-12-170212,170212,4,0,7,335,3.25,0.901072,1
2020-05-13-170212,170212,9,0,3,344,5.5,2.4706874,2
2020-05-14-170212,170212,5,0,3,349,7.0,2.9956555,3
2020-05-15-170212,170212,6,0,2,355,6.25,1.4787213,4
2020-05-16-170212,170212,2,0,0,357,0.5,0.0005703031,5
2020-05-17-170212,170212,0,0,0,357,0.0,0.011255832,6
2020-05-18-170212,170212,4,0,3,361,8.75,1.4143721,0
2020-05-19-170212,170212,5,0,1,366,3.25,1.1570708,1
2020-05-20-170212,170212,3,0,0,369,4.0,0.8925839,2
2020-05-21-170212,170212,5,0,1,374,5.25,0.93990403,3
2020-05-22-170212,170212,4,0,2,378,6.25,0.5855875,4
2020-05-23-170212,170212,0,0,0,378,0.0,0.0010161028,5
2020-05-24-170212,170212,0,0,0,378,0.25,0.00082450075,6
2020-05-25-170212,170212,3,0,0,381,3.5,1.6145142,0
2020-05-26-170212,170212,7,0,3,388,1.75,0.8951914,1
2020-05-27-170212,170212,3,0,2,391,1.75,0.96652055,2
2020-05-28-170212,170212,3,1,1,394,2.0,1.8825811,3
2020-05-29-170212,170212,2,0,0,396,2.25,0.49829483,4
2020-05-30-170212,170212,0,0,0,396,0.0,0.0013806269,5
2020-05-31-170212,170212,0,0,0,396,0.0,0.006494973,6
2020-06-01-170212,170212,3,0,1,399,0.5,0.066670895,0
2020-06-02-170212,170212,1,0,1,400,1.0,0.72722775,1
2020-06-03-170212,170212,0,0,1,400,1.5,0.1452871,2
2020-06-04-170212,170212,1,0,0,401,1.5,0.3673764,3
2020-06-05-170212,170212,2,0,0,403,2.5,0.43372998,4
2020-06-06-170212,170212,0,0,0,403,0.25,0.084020995,5
2020-06-07-170212,170212,0,0,0,403,0.0,0.00083117484,6
2020-06-08-170212,170212,0,0,2,403,1.75,0.80224407,0
2020-06-09-170212,170212,3,0,0,406,1.25,0.25097463,1
2020-06-10-170212,170212,2,0,1,408,0.75,0.1280709,2
2020-06-11-170212,170212,1,0,0,409,3.25,0.855669,3
2020-06-12-170212,170212,0,0,2,409,0.0,0.79995555,4
2020-06-13-170212,170212,0,0,0,409,0.0,0.037403103,5
2020-06-14-170212,170212,0,0,0,409,0.5,0.0062972144,6
2020-06-15-170212,170212,1,0,0,410,2.0,0.030948415,0
2020-06-16-170212,170212,1,0,1,411,0.5,0.34829542,1
2020-06-17-170212,170212,1,0,1,412,0.5,0.9331083,2
2020-06-18-170212,170212,0,0,0,412,1.0,0.5758235,3
2020-06-19-170212,170212,0,0,0,412,0.75,0.024424797,4
2020-06-20-170212,170212,0,1,0,412,0.0,0.050404944,5
2020-06-21-170212,170212,0,0,0,412,0.0,0.06502765,6
2020-06-22-170212,170212,2,0,0,414,0.5,0.2769943,0
2020-06-23-170212,170212,0,0,2,414,0.25,1.1150268,1
2020-06-24-170212,170212,1,0,1,415,0.75,1.1920785,2
2020-06-25-170212,170212,0,0,1,415,0.25,0.2661071,3
2020-06-26-170212,170212,2,0,0,417,0.25,0.9467614,4
2020-06-27-170212,170212,0,0,0,417,0.5,0.589262,5
2020-06-28-170212,170212,0,0,0,417,0.25,0.004091168,6
2020-06-29-170212,170212,0,0,5,417,0.0,0.021365816,0
2020-06-30-170212,170212,1,0,0,418,0.25,0.85930055,1
2020-07-01-170212,170212,1,0,2,419,0.5,0.075738035,2
2020-07-02-170212,170212,0,0,0,419,0.0,0.048549395,3
2020-07-03-170212,170212,0,1,4,419,1.0,0.64675957,4
2020-07-04-170212,170212,0,0,1,419,0.0,0.0014903534,5
2020-07-05-170212,170212,0,0,0,419,0.0,0.007963587,6
2020-07-06-170212,170212,0,0,2,419,0.0,0.12389774,0
2020-07-07-170212,170212,2,0,2,421,0.25,0.5383349,1
2020-07-08-170212,170212,1,0,3,422,0.0,0.110344164,2
2020-07-09-170212,170212,1,0,2,423,1.0,0.14034583,3
2020-07-10-170212,170212,0,0,0,423,0.25,0.051759623,4
2020-07-11-170212,170212,0,0,0,423,0.25,0.0018892455,5
2020-07-12-170212,170212,0,0,0,423,0.0,0.3181303,6
2020-07-13-170212,170212,5,0,1,428,0.25,0.028072357,0
2020-07-14-170212,170212,0,0,0,428,0.5,0.32361978,1
2020-07-15-170212,170212,2,0,1,430,1.75,0.59023625,2
2020-07-16-170212,170212,0,0,4,430,0.75,0.13894568,3
2020-07-17-170212,170212,4,0,2,434,0.75,0.35316262,4
2020-07-18-170212,170212,1,0,0,435,1.0,0.37914354,5
2020-07-19-170212,170212,0,0,0,435,0.25,0.099409156,6
2020-07-20-170212,170212,2,0,2,437,1.0,0.25995168,0
2020-07-21-170212,170212,2,0,3,439,1.0,0.038036544,1
2020-07-22-170212,170212,3,0,5,442,0.75,0.0589324,2
2020-07-23-170212,170212,2,0,2,444,1.5,0.60005987,3
2020-07-24-170212,170212,0,0,1,444,1.25,0.041286744,4
2020-07-25-170212,170212,0,0,2,444,0.75,0.010094092,5
2020-07-26-170212,170212,0,0,1,444,0.5,0.016745199,6
2020-07-27-170212,170212,1,0,1,445,0.75,1.3110204,0
2020-07-28-170212,170212,0,0,2,445,2.0,0.31357288,1
2020-07-29-170212,170212,1,0,5,446,2.5,1.3797587,2
2020-07-30-170212,170212,4,0,2,450,2.5,2.6366131,3
2020-07-31-170212,170212,2,0,1,452,1.75,2.0670018,4
2020-08-01-170212,170212,0,0,0,452,0.0,0.3896356,5
2020-08-02-170212,170212,0,0,0,452,0.5,1.746689,6
2020-08-03-170212,170212,2,0,4,454,0.75,0.8131598,0
2020-08-04-170212,170212,3,0,1,457,1.25,4.0145802,1
2020-08-05-170212,170212,5,0,3,462,2.25,4.3852935,2
2020-08-06-170212,170212,2,0,2,464,1.25,1.1647754,3
2020-08-07-170212,170212,1,0,4,465,1.25,1.9127415,4
2020-08-08-170212,170212,2,0,3,467,1.75,1.7206278,5
2020-08-09-170212,170212,1,0,3,468,0.25,0.19738264,6
2020-08-10-170212,170212,1,0,10,469,4.5,3.758346,0
2020-08-11-170212,170212,2,0,4,471,4.25,2.0973282,1
2020-08-12-170212,170212,5,0,6,476,5.25,4.3148384,2
2020-08-13-170212,170212,2,0,0,478,2.5,3.2740657,3
2020-08-14-170212,170212,1,0,2,479,2.0,2.2519999,4
2020-08-15-170212,170212,0,0,2,479,0.25,0.6922667,5
2020-08-16-170212,170212,0,0,5,479,2.0,2.3197064,6
2020-08-17-170212,170212,4,0,6,483,3.25,1.8458027,0
2020-08-18-170212,170212,1,0,5,484,4.0,4.7434506,1
2020-08-19-170212,170212,3,0,8,487,2.75,2.6757333,2
2020-08-20-170212,170212,2,0,3,489,2.5,3.054827,3
2020-08-21-170212,170212,4,0,2,493,2.25,4.705786,4
2020-08-22-170212,170212,3,0,1,496,3.5,1.9518906,5
2020-08-23-170212,170212,3,0,3,499,1.0,1.0561534,6
2020-08-24-170212,170212,10,0,9,509,5.5,3.5062933,0
2020-08-25-170212,170212,4,0,2,513,3.5,2.942816,1
2020-08-26-170212,170212,6,0,3,519,3.0,2.075076,2
2020-08-27-170212,170212,0,0,13,519,6.5,1.9114892,3
2020-08-28-170212,170212,2,0,6,521,2.75,3.462301,4
2020-08-29-170212,170212,2,0,9,523,2.75,0.9315285,5
2020-08-30-170212,170212,5,0,12,528,2.75,0.49731523,6
2020-08-31-170212,170212,6,0,18,534,6.75,0.9894055,0
2020-09-01-170212,170212,5,0,18,539,7.5,9.16949,1
2020-09-02-170212,170212,8,0,15,547,5.5,2.7593198,2
2020-09-03-170212,170212,3,0,14,550,5.75,1.3739969,3
2020-09-04-170212,170212,2,0,17,552,6.0,2.203621,4
2020-09-05-170212,170212,1,0,0,553,2.25,0.4570235,5
2020-09-06-170212,170212,3,0,3,556,1.75,0.41046116,6
2020-09-07-170212,170212,9,0,17,565,4.5,1.5043954,0
2020-09-08-170212,170212,2,0,13,567,6.5,4.4815636,1
2020-09-09-170212,170212,3,0,13,570,8.0,1.8677796,2
2020-09-10-170212,170212,13,0,9,583,5.75,1.4588897,3
2020-09-11-170212,170212,6,1,8,589,6.5,3.4133651,4
2020-09-12-170212,170212,9,0,2,598,2.0,2.0744226,5
2020-09-13-170212,170212,12,0,0,610,2.75,1.1177461,6
2020-09-14-170212,170212,18,0,11,628,7.75,2.1120908,0
2020-09-15-170212,170212,18,0,9,646,9.25,6.104654,1
2020-09-16-170212,170212,15,0,12,661,6.5,2.677014,2
2020-09-17-170212,170212,14,0,9,675,12.5,2.4254718,3
2020-09-18-170212,170212,17,0,13,692,7.25,4.1582494,4
2020-09-19-170212,170212,0,0,5,692,1.0,0.038578447,5
2020-09-20-170212,170212,3,1,3,695,1.0,0.756185,6
2020-09-21-170212,170212,17,0,5,712,8.5,2.4034085,0
2020-09-22-170212,170212,13,0,15,725,8.75,2.3894467,1
2020-09-23-170212,170212,13,0,7,738,7.5,3.6068776,2
2020-09-24-170212,170212,9,0,6,747,5.0,1.3140923,3
2020-09-25-170212,170212,8,0,11,755,4.5,3.872383,4
2020-09-26-170212,170212,2,0,7,757,1.25,1.4791214,5
2020-09-27-170212,170212,0,0,2,757,1.0,0.5308547,6
2020-09-28-170212,170212,11,0,12,768,6.0,3.1080382,0
2020-09-29-170212,170212,9,0,36,777,5.5,4.002601,1
2020-09-30-170212,170212,12,0,7,789,5.25,2.6245947,2
2020-10-01-170212,170212,9,0,21,798,7.25,2.2061622,3
2020-10-02-170212,170212,13,1,12,811,8.75,1.9852669,4
2020-10-03-170212,170212,5,0,2,816,2.5,1.3181692,5
2020-10-04-170212,170212,3,0,5,819,1.25,1.5093986,6
2020-10-05-170212,170212,5,1,23,824,4.0,6.4421525,0
2020-10-06-170212,170212,15,0,14,839,5.0,5.734757,1
2020-10-07-170212,170212,7,0,19,846,6.75,10.101712,2
2020-10-08-170212,170212,6,1,17,852,8.0,2.918101,3
2020-10-09-170212,170212,11,3,8,863,13.5,5.8831987,4
2020-10-10-170212,170212,7,0,7,870,2.25,0.96230483,5
2020-10-11-170212,170212,2,0,4,872,4.5,1.0379083,6
2020-10-12-170212,170212,12,0,22,884,7.75,1.9383,0
2020-10-13-170212,170212,36,0,18,920,8.25,3.166223,1
2020-10-14-170212,170212,7,0,18,927,4.75,6.5769057,2
2020-10-15-170212,170212,21,0,25,948,13.25,11.834092,3
2020-10-16-170212,170212,12,0,17,960,10.75,16.636967,4
2020-10-17-170212,170212,2,0,4,962,2.5,2.80125,5
2020-10-18-170212,170212,5,0,14,967,1.5,1.2084259,6
2020-10-19-170212,170212,23,0,4,990,14.25,10.051689,0
2020-10-20-170212,170212,14,0,30,1004,12.5,6.9537477,1
2020-10-21-170212,170212,19,0,21,1023,21.5,10.192826,2
2020-10-22-170212,170212,17,0,15,1040,19.75,11.174413,3
2020-10-23-170212,170212,8,1,28,1048,16.75,8.166569,4
2020-10-24-170212,170212,7,0,10,1055,6.0,2.7933543,5
2020-10-25-170212,170212,4,0,11,1059,11.0,2.9301686,6
2020-10-26-170212,170212,22,1,33,1081,18.75,11.799512,0
2020-10-27-170212,170212,18,0,11,1099,19.75,10.274964,1
2020-10-28-170212,170212,18,1,16,1117,21.25,12.801896,2
2020-10-29-170212,170212,25,1,15,1142,19.0,7.6113725,3
2020-10-30-170212,170212,17,1,19,1159,21.25,11.409871,4
2020-10-31-170212,170212,4,0,0,1163,9.0,3.4654524,5
2020-11-01-170212,170212,14,3,0,1177,17.5,2.7338688,6
2020-11-02-170212,170212,4,1,0,1181,20.0,5.056376,0
2020-11-03-170212,170212,30,0,0,1211,20.0,8.478826,1
2020-11-04-170212,170212,21,0,0,1232,17.0,9.301185,2
2020-11-05-170212,170212,15,0,0,1247,22.5,7.6933947,3
2020-11-06-170212,170212,28,0,0,1275,32.25,8.925043,4
2020-11-07-170212,170212,10,0,0,1285,16.75,4.6579595,5
2020-11-08-170212,170212,11,0,0,1296,12.75,5.719528,6
2020-11-09-170212,170212,33,0,0,1329,26.25,14.21497,0
2020-11-10-170212,170212,11,1,0,1340,23.25,9.279117,1
2020-11-11-170212,170212,16,1,0,1356,22.5,6.267253,2
2020-11-12-170212,170212,15,3,0,1371,22.0,12.461924,3
2020-11-13-170212,170212,19,0,0,1390,38.5,10.465396,4
2020-03-01-170213,170213,1,0,3,1,0.25,1.1608197e-05,6
2020-03-02-170213,170213,0,0,12,1,0.75,0.0019025285,0
2020-03-03-170213,170213,0,0,20,1,0.5,0.002625478,1
2020-03-04-170213,170213,1,0,16,2,0.25,0.050148,2
2020-03-05-170213,170213,1,2,19,3,0.5,5.957446e-05,3
2020-03-06-170213,170213,0,0,16,3,0.0,0.049757726,4
2020-03-07-170213,170213,0,0,6,3,0.0,0.00070129486,5
2020-03-08-170213,170213,0,0,16,3,0.5,0.0004491148,6
2020-03-09-170213,170213,0,0,19,3,0.75,0.120477065,0
2020-03-10-170213,170213,2,0,20,5,2.75,0.004972487,1
2020-03-11-170213,170213,0,0,19,5,2.5,0.03419022,2
2020-03-12-170213,170213,1,0,16,6,2.5,0.013510004,3
2020-03-13-170213,170213,4,0,22,10,3.5,0.09879115,4
2020-03-14-170213,170213,2,0,8,12,3.25,0.12886721,5
2020-03-15-170213,170213,3,0,3,15,5.0,0.043036316,6
2020-03-16-170213,170213,12,0,16,27,12.75,0.10982917,0
2020-03-17-170213,170213,20,0,9,47,12.0,0.24505605,1
2020-03-18-170213,170213,16,0,6,63,20.25,0.27921146,2
2020-03-19-170213,170213,19,0,8,82,22.75,0.3708213,3
2020-03-20-170213,170213,16,0,8,98,21.25,0.5484311,4
2020-03-21-170213,170213,6,0,2,104,9.75,0.054875117,5
2020-03-22-170213,170213,16,1,3,120,8.75,0.039648153,6
2020-03-23-170213,170213,19,0,4,139,25.75,0.44115502,0
2020-03-24-170213,170213,20,2,5,159,23.5,0.3565032,1
2020-03-25-170213,170213,19,0,5,178,17.25,0.3539956,2
2020-03-26-170213,170213,16,0,2,194,14.25,0.32491335,3
2020-03-27-170213,170213,22,0,4,216,20.0,0.34209856,4
2020-03-28-170213,170213,8,1,5,224,6.0,0.036778558,5
2020-03-29-170213,170213,3,0,1,227,6.75,0.045178298,6
2020-03-30-170213,170213,16,0,5,243,14.5,0.23564434,0
2020-03-31-170213,170213,9,0,3,252,11.0,0.123159245,1
2020-04-01-170213,170213,6,0,35,258,8.5,0.12569691,2
2020-04-02-170213,170213,8,0,9,266,10.0,0.17942676,3
2020-04-03-170213,170213,8,0,3,274,10.75,0.23856777,4
2020-04-04-170213,170213,2,0,2,276,3.25,0.002362976,5
2020-04-05-170213,170213,3,0,2,279,6.0,0.0278355,6
2020-04-06-170213,170213,4,0,7,283,13.75,0.24079445,0
2020-04-07-170213,170213,5,2,0,288,6.0,0.19242,1
2020-04-08-170213,170213,5,1,2,293,7.5,0.21017683,2
2020-04-09-170213,170213,2,0,0,295,6.5,0.19629623,3
2020-04-10-170213,170213,4,0,3,299,9.0,0.07012249,4
2020-04-11-170213,170213,5,0,0,304,3.0,0.042640615,5
2020-04-12-170213,170213,1,0,1,305,2.0,0.023089504,6
2020-04-13-170213,170213,5,0,1,310,11.25,0.15977752,0
2020-04-14-170213,170213,3,0,5,313,8.25,0.13974003,1
2020-04-15-170213,170213,35,0,0,348,11.75,0.23558183,2
2020-04-16-170213,170213,9,0,3,357,8.0,0.10855642,3
2020-04-17-170213,170213,3,0,1,360,7.5,0.10005264,4
2020-04-18-170213,170213,2,0,0,362,1.75,0.02129352,5
2020-04-19-170213,170213,2,0,0,364,2.0,0.10290597,6
2020-04-20-170213,170213,7,0,4,371,7.25,0.21467918,0
2020-04-21-170213,170213,0,0,6,371,6.0,0.080611855,1
2020-04-22-170213,170213,2,0,4,373,7.25,0.03586637,2
2020-04-23-170213,170213,0,0,2,373,1.75,0.0012296508,3
2020-04-24-170213,170213,3,1,4,376,4.0,0.09937991,4
2020-04-25-170213,170213,0,0,0,376,1.5,0.04298331,5
2020-04-26-170213,170213,1,0,0,377,1.25,0.024555277,6
2020-04-27-170213,170213,1,0,2,378,7.25,0.1408536,0
2020-04-28-170213,170213,5,0,2,383,5.75,0.047624364,1
2020-04-29-170213,170213,0,1,2,383,4.75,0.11195352,2
2020-04-30-170213,170213,3,0,4,386,5.75,0.06604081,3
2020-05-01-170213,170213,1,0,1,387,0.75,0.00048476685,4
2020-05-02-170213,170213,0,0,1,387,0.75,0.027315654,5
2020-05-03-170213,170213,0,0,0,387,1.5,0.0012200908,6
2020-05-04-170213,170213,4,0,5,391,3.25,0.13343087,0
2020-05-05-170213,170213,6,0,1,397,4.5,0.081321925,1
2020-05-06-170213,170213,4,0,3,401,4.25,0.07865269,2
2020-05-07-170213,170213,2,0,3,403,4.5,0.059358515,3
2020-05-08-170213,170213,4,0,10,407,3.5,0.18493992,4
2020-05-09-170213,170213,0,0,0,407,0.0,0.0006826989,5
2020-05-10-170213,170213,0,0,0,407,0.25,0.0067933714,6
2020-05-11-170213,170213,2,0,4,409,5.25,0.080439456,0
2020-05-12-170213,170213,2,2,2,411,5.0,0.07442411,1
2020-05-13-170213,170213,2,0,0,413,8.0,0.20330024,2
2020-05-14-170213,170213,4,0,1,417,9.25,0.24584712,3
2020-05-15-170213,170213,1,0,1,418,8.5,0.12201919,4
2020-05-16-170213,170213,1,0,0,419,1.0,5.243954e-05,5
2020-05-17-170213,170213,0,0,0,419,0.0,0.0009257393,6
2020-05-18-170213,170213,5,0,2,424,10.25,0.116672605,0
2020-05-19-170213,170213,1,0,0,425,5.5,0.09507559,1
2020-05-20-170213,170213,3,0,1,428,4.75,0.07437504,2
2020-05-21-170213,170213,3,0,1,431,6.0,0.078026615,3
2020-05-22-170213,170213,10,0,3,441,5.75,0.04973416,4
2020-05-23-170213,170213,0,0,0,441,0.0,9.356126e-05,5
2020-05-24-170213,170213,0,0,0,441,0.25,2.9427292e-05,6
2020-05-25-170213,170213,4,0,1,445,5.0,0.13254291,0
2020-05-26-170213,170213,2,0,2,447,3.25,0.07395802,1
2020-05-27-170213,170213,0,0,2,447,3.25,0.079731144,2
2020-05-28-170213,170213,1,0,5,448,3.0,0.15435909,3
2020-05-29-170213,170213,1,2,0,449,3.0,0.041300576,4
2020-05-30-170213,170213,0,0,0,449,0.0,9.5331176e-05,5
2020-05-31-170213,170213,0,0,0,449,0.0,0.00054608844,6
2020-06-01-170213,170213,2,0,2,451,1.5,0.0055132066,0
2020-06-02-170213,170213,0,0,1,451,1.5,0.060013916,1
2020-06-03-170213,170213,1,0,0,452,1.5,0.011744089,2
2020-06-04-170213,170213,1,0,0,453,1.5,0.030200372,3
2020-06-05-170213,170213,3,0,2,456,2.5,0.036305737,4
2020-06-06-170213,170213,0,2,0,456,0.75,0.0067799445,5
2020-06-07-170213,170213,0,0,0,456,0.0,7.822199e-05,6
2020-06-08-170213,170213,1,0,1,457,2.0,0.06538885,0
2020-06-09-170213,170213,2,0,0,459,2.0,0.02068715,1
2020-06-10-170213,170213,2,0,0,461,1.0,0.01059421,2
2020-06-11-170213,170213,5,0,0,466,2.25,0.06988196,3
2020-06-12-170213,170213,0,0,0,466,0.25,0.065778606,4
2020-06-13-170213,170213,0,0,0,466,0.0,0.0030095733,5
2020-06-14-170213,170213,0,0,1,466,0.5,0.0005193228,6
2020-06-15-170213,170213,2,0,0,468,1.75,0.0023793306,0
2020-06-16-170213,170213,1,0,0,469,0.75,0.028535081,1
2020-06-17-170213,170213,0,0,1,469,0.75,0.076487504,2
2020-06-18-170213,170213,0,0,0,469,1.5,0.047630988,3
2020-06-19-170213,170213,2,0,2,471,0.25,0.0019424186,4
2020-06-20-170213,170213,0,0,0,471,0.0,0.0041657,5
2020-06-21-170213,170213,0,0,0,471,0.0,0.0054445635,6
2020-06-22-170213,170213,1,0,0,472,1.0,0.022685697,0
2020-06-23-170213,170213,0,0,0,472,0.0,0.09168547,1
2020-06-24-170213,170213,0,0,0,472,1.25,0.099102356,2
2020-06-25-170213,170213,0,0,0,472,0.75,0.021942006,3
2020-06-26-170213,170213,0,0,0,472,1.0,0.077383086,4
2020-06-27-170213,170213,0,0,0,472,0.25,0.04806476,5
2020-06-28-170213,170213,1,0,0,473,0.0,0.00031375594,6
2020-06-29-170213,170213,0,0,0,473,0.0,0.0017699171,0
2020-06-30-170213,170213,0,0,0,473,0.5,0.070302956,1
2020-07-01-170213,170213,1,0,3,474,0.5,0.0060506724,2
2020-07-02-170213,170213,0,0,1,474,0.0,0.0039471365,3
2020-07-03-170213,170213,2,0,1,476,0.25,0.052457567,4
2020-07-04-170213,170213,0,0,0,476,0.0,0.00010975142,5
2020-07-05-170213,170213,0,0,1,476,0.0,0.0006681356,6
2020-07-06-170213,170213,0,0,1,476,0.0,0.010153037,0
2020-07-07-170213,170213,0,0,0,476,1.0,0.044146866,1
2020-07-08-170213,170213,0,1,1,476,0.25,0.00903021,2
2020-07-09-170213,170213,0,0,3,476,1.0,0.01105751,3
2020-07-10-170213,170213,0,0,1,476,0.5,0.0042583053,4
2020-07-11-170213,170213,0,0,1,476,0.25,0.00015053738,5
2020-07-12-170213,170213,0,0,0,476,0.0,0.026283454,6
2020-07-13-170213,170213,0,0,1,476,2.0,0.00231235,0
2020-07-14-170213,170213,0,0,4,476,0.75,0.026664304,1
2020-07-15-170213,170213,3,0,6,479,3.75,0.04796201,2
2020-07-16-170213,170213,1,0,2,480,0.5,0.011440824,3
2020-07-17-170213,170213,1,0,5,481,1.5,0.02925029,4
2020-07-18-170213,170213,0,0,0,481,1.5,0.03058061,5
2020-07-19-170213,170213,1,0,0,482,0.25,0.008072795,6
2020-07-20-170213,170213,1,0,0,483,1.5,0.02139718,0
2020-07-21-170213,170213,0,0,2,483,1.75,0.003063231,1
2020-07-22-170213,170213,1,0,1,484,1.25,0.004930121,2
2020-07-23-170213,170213,3,0,0,487,1.0,0.04877702,3
2020-07-24-170213,170213,1,0,0,488,1.0,0.0032129625,4
2020-07-25-170213,170213,1,0,0,489,0.5,0.00080422696,5
2020-07-26-170213,170213,0,0,1,489,0.5,0.0013343022,6
2020-07-27-170213,170213,1,0,7,490,1.25,0.10761904,0
2020-07-28-170213,170213,4,0,3,494,1.25,0.02583708,1
2020-07-29-170213,170213,6,0,5,500,1.25,0.114042,2
2020-07-30-170213,170213,2,0,3,502,4.0,0.21586865,3
2020-07-31-170213,170213,5,0,2,507,1.75,0.17253736,4
2020-08-01-170213,170213,0,0,0,507,0.0,0.03190513,5
2020-08-02-170213,170213,0,0,1,507,0.25,0.14436366,6
2020-08-03-170213,170213,0,0,4,507,1.75,0.06696339,0
2020-08-04-170213,170213,2,0,4,509,2.25,0.332966,1
2020-08-05-170213,170213,1,0,2,510,3.25,0.36628982,2
2020-08-06-170213,170213,0,0,0,510,3.0,0.09546772,3
2020-08-07-170213,170213,0,0,3,510,2.0,0.15588573,4
2020-08-08-170213,170213,0,0,4,510,2.0,0.13953309,5
2020-08-09-170213,170213,1,0,0,511,1.0,0.015862195,6
2020-08-10-170213,170213,7,0,4,518,2.25,0.30722424,0
2020-08-11-170213,170213,3,0,2,521,4.5,0.17140391,1
2020-08-12-170213,170213,5,0,1,526,5.0,0.35749602,2
2020-08-13-170213,170213,3,0,13,529,2.75,0.2682977,3
2020-08-14-170213,170213,2,0,3,531,1.75,0.18709297,4
2020-08-15-170213,170213,0,0,7,531,1.25,0.056972876,5
2020-08-16-170213,170213,1,0,4,532,1.5,0.19021963,6
2020-08-17-170213,170213,4,0,10,536,3.25,0.15024774,0
2020-08-18-170213,170213,4,0,5,540,3.5,0.38932848,1
2020-08-19-170213,170213,2,0,1,542,2.5,0.2201471,2
2020-08-20-170213,170213,0,0,8,542,2.75,0.25159392,3
2020-08-21-170213,170213,3,0,6,545,2.5,0.38502967,4
2020-08-22-170213,170213,4,0,1,549,2.75,0.1581478,5
2020-08-23-170213,170213,0,0,2,549,2.0,0.0871613,6
2020-08-24-170213,170213,4,0,3,553,7.25,0.28951466,0
2020-08-25-170213,170213,2,0,8,555,5.25,0.23957564,1
2020-08-26-170213,170213,1,0,11,556,6.25,0.17003714,2
2020-08-27-170213,170213,13,0,7,569,3.5,0.15671794,3
2020-08-28-170213,170213,3,0,5,572,3.75,0.28155768,4
2020-08-29-170213,170213,7,0,2,579,1.5,0.07646959,5
2020-08-30-170213,170213,4,0,3,583,4.5,0.04064469,6
2020-08-31-170213,170213,10,0,14,593,6.75,0.08207809,0
2020-09-01-170213,170213,5,0,11,598,6.0,0.7515136,1
2020-09-02-170213,170213,1,0,4,599,9.25,0.22752908,2
2020-09-03-170213,170213,8,0,16,607,7.0,0.11151994,3
2020-09-04-170213,170213,6,0,4,613,8.0,0.18220882,4
2020-09-05-170213,170213,1,0,0,614,3.25,0.037843842,5
2020-09-06-170213,170213,2,0,3,616,2.25,0.033932377,6
2020-09-07-170213,170213,3,0,16,619,7.25,0.12421089,0
2020-09-08-170213,170213,8,0,7,627,7.0,0.36548084,1
2020-09-09-170213,170213,11,0,2,638,7.0,0.15296175,2
2020-09-10-170213,170213,7,0,3,645,12.5,0.117386766,3
2020-09-11-170213,170213,5,0,3,650,10.0,0.27943873,4
2020-09-12-170213,170213,2,0,0,652,3.5,0.17012508,5
2020-09-13-170213,170213,3,0,1,655,5.25,0.093422934,6
2020-09-14-170213,170213,14,0,4,669,9.75,0.17266384,0
2020-09-15-170213,170213,11,0,5,680,16.75,0.4976337,1
2020-09-16-170213,170213,4,0,2,684,12.5,0.22038925,2
2020-09-17-170213,170213,16,0,5,700,14.75,0.19707485,3
2020-09-18-170213,170213,4,2,8,704,14.75,0.3408791,4
2020-09-19-170213,170213,0,0,2,704,2.5,0.0029064855,5
2020-09-20-170213,170213,3,1,0,707,1.0,0.062223915,6
2020-09-21-170213,170213,16,0,3,723,16.25,0.19738126,0
2020-09-22-170213,170213,7,0,6,730,14.75,0.19550663,1
2020-09-23-170213,170213,2,0,3,732,14.0,0.29889247,2
2020-09-24-170213,170213,3,1,6,735,8.75,0.107481696,3
2020-09-25-170213,170213,3,1,15,738,10.75,0.31822932,4
2020-09-26-170213,170213,0,0,1,738,1.0,0.11987065,5
2020-09-27-170213,170213,1,0,3,739,1.0,0.044089723,6
2020-09-28-170213,170213,4,0,8,743,9.5,0.25391364,0
2020-09-29-170213,170213,5,0,5,748,5.5,0.32759216,1
2020-09-30-170213,170213,2,0,5,750,8.25,0.21295244,2
2020-10-01-170213,170213,5,0,15,755,10.75,0.18078724,3
2020-10-02-170213,170213,8,0,13,763,16.75,0.16310914,4
2020-10-03-170213,170213,2,1,1,765,3.75,0.10583982,5
2020-10-04-170213,170213,0,0,2,765,3.75,0.12546094,6
2020-10-05-170213,170213,3,0,12,768,6.75,0.5287253,0
2020-10-06-170213,170213,6,0,10,774,8.0,0.47104377,1
2020-10-07-170213,170213,3,0,21,777,9.75,0.8325333,2
2020-10-08-170213,170213,6,0,11,783,10.25,0.23800336,3
2020-10-09-170213,170213,15,1,17,798,16.25,0.48282468,4
2020-10-10-170213,170213,1,0,1,799,4.25,0.078039914,5
2020-10-11-170213,170213,3,0,17,802,4.5,0.08559165,6
2020-10-12-170213,170213,8,0,13,810,8.75,0.16004686,0
2020-10-13-170213,170213,5,0,20,815,18.25,0.2585496,1
2020-10-14-170213,170213,5,0,22,820,6.75,0.53981835,2
2020-10-15-170213,170213,15,0,25,835,20.5,0.972351,3
2020-10-16-170213,170213,13,0,21,848,13.25,1.3564019,4
2020-10-17-170213,170213,1,0,3,849,2.25,0.22642478,5
2020-10-18-170213,170213,2,0,20,851,3.5,0.09968977,6
2020-10-19-170213,170213,12,0,16,863,21.25,0.8196931,0
2020-10-20-170213,170213,10,0,15,873,14.25,0.5669022,1
2020-10-21-170213,170213,21,0,19,894,25.25,0.8393796,2
2020-10-22-170213,170213,11,0,21,905,24.75,0.9188391,3
2020-10-23-170213,170213,17,0,31,922,16.75,0.6673643,4
2020-10-24-170213,170213,1,0,17,923,8.5,0.22744173,5
2020-10-25-170213,170213,17,0,17,940,10.0,0.24222162,6
2020-10-26-170213,170213,13,0,12,953,26.0,0.9637131,0
2020-10-27-170213,170213,20,0,22,973,21.0,0.84672546,1
2020-10-28-170213,170213,22,1,17,995,24.5,1.0492153,2
2020-10-29-170213,170213,25,0,19,1020,23.5,0.62281066,3
2020-10-30-170213,170213,21,1,30,1041,26.75,0.93487644,4
2020-10-31-170213,170213,3,1,0,1044,13.0,0.28217632,5
2020-11-01-170213,170213,20,1,0,1064,22.75,0.22654162,6
2020-11-02-170213,170213,16,1,0,1080,16.5,0.4153661,0
2020-11-03-170213,170213,15,0,0,1095,28.5,0.689004,1
2020-11-04-170213,170213,19,1,0,1114,23.0,0.7665879,2
2020-11-05-170213,170213,21,0,0,1135,28.25,0.63001716,3
2020-11-06-170213,170213,31,2,0,1166,35.5,0.74043584,4
2020-11-07-170213,170213,17,1,0,1183,16.0,0.37996513,5
2020-11-08-170213,170213,17,1,0,1200,13.75,0.46797225,6
2020-11-09-170213,170213,12,0,0,1212,33.5,1.1643813,0
2020-11-10-170213,170213,22,1,0,1234,25.0,0.76517016,1
2020-11-11-170213,170213,17,0,0,1251,27.25,0.51157564,2
2020-11-12-170213,170213,19,0,0,1270,25.25,1.0232744,3
2020-11-13-170213,170213,30,1,0,1300,38.25,0.8633676,4
2020-03-01-170214,170214,0,0,1,0,0.3333333333333333,0.00013735969,6
2020-03-02-170214,170214,0,0,7,0,0.0,0.021832233,0
2020-03-03-170214,170214,0,0,11,0,0.0,0.029937174,1
2020-03-04-170214,170214,0,0,22,0,0.3333333333333333,0.5637072,2
2020-03-05-170214,170214,0,0,14,0,0.6666666666666666,0.00069070276,3
2020-03-06-170214,170214,0,1,14,0,0.3333333333333333,0.5592831,4
2020-03-07-170214,170214,0,0,9,0,0.0,0.008115206,5
2020-03-08-170214,170214,0,0,4,0,0.16666666666666666,0.0052945693,6
2020-03-09-170214,170214,0,0,14,0,0.8333333333333334,1.372589,0
2020-03-10-170214,170214,5,0,21,5,1.1666666666666667,0.0558094,1
2020-03-11-170214,170214,2,0,14,7,1.5,0.39116585,2
2020-03-12-170214,170214,0,0,5,7,0.8333333333333334,0.15099801,3
2020-03-13-170214,170214,2,0,25,9,3.1666666666666665,1.1326926,4
2020-03-14-170214,170214,1,0,3,10,2.6666666666666665,1.4804827,5
2020-03-15-170214,170214,1,0,6,11,3.0,0.5009886,6
2020-03-16-170214,170214,7,0,10,18,8.333333333333334,1.266531,0
2020-03-17-170214,170214,11,0,8,29,9.833333333333334,2.8516698,1
2020-03-18-170214,170214,22,0,4,51,13.666666666666664,3.234481,2
2020-03-19-170214,170214,14,0,7,65,13.5,4.2952747,3
2020-03-20-170214,170214,14,0,7,79,16.5,6.321825,4
2020-03-21-170214,170214,9,0,5,88,5.666666666666668,0.6260549,5
2020-03-22-170214,170214,4,1,5,92,7.666666666666668,0.4572957,6
2020-03-23-170214,170214,14,0,6,106,19.5,5.088306,0
2020-03-24-170214,170214,21,0,5,127,14.333333333333336,4.083742,1
2020-03-25-170214,170214,14,0,7,141,14.166666666666664,4.068374,2
2020-03-26-170214,170214,5,0,7,146,13.166666666666664,3.699862,3
2020-03-27-170214,170214,25,0,4,171,14.5,3.9370923,4
2020-03-28-170214,170214,3,0,4,174,5.833333333333332,0.42430818,5
2020-03-29-170214,170214,6,0,0,180,5.0,0.5224663,6
2020-03-30-170214,170214,10,0,7,190,13.166666666666664,2.6865897,0
2020-03-31-170214,170214,8,0,3,198,8.0,1.4248458,1
2020-04-01-170214,170214,4,0,4,202,7.833333333333332,1.4506491,2
2020-04-02-170214,170214,7,0,3,209,8.166666666666666,2.0733447,3
2020-04-03-170214,170214,7,0,4,216,8.833333333333334,2.7659676,4
2020-04-04-170214,170214,5,0,0,221,2.1666666666666665,0.027102325,5
2020-04-05-170214,170214,5,0,3,226,3.8333333333333335,0.3198785,6
2020-04-06-170214,170214,6,0,9,232,7.833333333333332,2.757467,0
2020-04-07-170214,170214,5,0,4,237,5.833333333333332,2.2077942,1
2020-04-08-170214,170214,7,20,5,244,6.333333333333332,2.4135265,2
2020-04-09-170214,170214,7,0,0,251,8.333333333333334,2.2843328,3
2020-04-10-170214,170214,4,0,5,255,5.666666666666668,0.8039916,4
2020-04-11-170214,170214,4,0,0,259,5.833333333333332,0.48656905,5
2020-04-12-170214,170214,0,0,1,259,3.333333333333333,0.27479592,6
2020-04-13-170214,170214,7,0,6,266,7.0,1.8548565,0
2020-04-14-170214,170214,3,0,5,269,5.333333333333333,1.61641,1
2020-04-15-170214,170214,4,0,3,273,18.5,2.6773546,2
2020-04-16-170214,170214,3,0,6,276,6.333333333333332,1.2384294,3
2020-04-17-170214,170214,4,0,1,280,12.833333333333336,1.140499,4
2020-04-18-170214,170214,0,0,1,280,2.833333333333333,0.23668817,5
2020-04-19-170214,170214,3,0,0,283,5.666666666666668,1.214065,6
2020-04-20-170214,170214,9,1,3,292,6.833333333333332,2.4713929,0
2020-04-21-170214,170214,4,0,9,296,3.8333333333333335,0.9112679,1
2020-04-22-170214,170214,5,0,4,301,7.5,0.40429184,2
2020-04-23-170214,170214,0,0,8,301,1.6666666666666667,0.014592734,3
2020-04-24-170214,170214,5,0,3,306,3.6666666666666665,1.1191518,4
2020-04-25-170214,170214,0,0,0,306,1.1666666666666667,0.4784765,5
2020-04-26-170214,170214,1,0,0,307,0.6666666666666666,0.2778393,6
2020-04-27-170214,170214,6,0,2,313,5.166666666666667,1.5987837,0
2020-04-28-170214,170214,5,0,4,318,3.8333333333333335,0.54915595,1
2020-04-29-170214,170214,3,0,6,321,3.6666666666666665,1.2866255,2
2020-04-30-170214,170214,6,0,5,327,2.5,0.7403777,3
2020-05-01-170214,170214,1,0,6,328,0.6666666666666666,0.00463229,4
2020-05-02-170214,170214,1,0,0,329,0.0,0.30601817,5
2020-05-03-170214,170214,0,0,0,329,0.8333333333333334,0.013613273,6
2020-05-04-170214,170214,3,0,10,332,3.1666666666666665,1.5061125,0
2020-05-05-170214,170214,9,0,4,341,3.5,0.91533655,1
2020-05-06-170214,170214,4,0,3,345,2.833333333333333,0.88421816,2
2020-05-07-170214,170214,8,0,4,353,1.6666666666666667,0.6734212,3
2020-05-08-170214,170214,3,0,7,356,3.0,2.0805886,4
2020-05-09-170214,170214,0,0,0,356,0.0,0.007699291,5
2020-05-10-170214,170214,0,0,0,356,0.5,0.078958526,6
2020-05-11-170214,170214,2,0,2,358,3.1666666666666665,0.899092,0
2020-05-12-170214,170214,4,0,1,362,3.0,0.8406514,1
2020-05-13-170214,170214,6,0,3,368,5.333333333333333,2.2885764,2
2020-05-14-170214,170214,5,0,1,373,7.333333333333332,2.7620938,3
2020-05-15-170214,170214,6,1,2,379,4.166666666666667,1.3779702,4
2020-05-16-170214,170214,0,0,0,379,0.6666666666666666,0.0006347221,5
2020-05-17-170214,170214,0,0,0,379,0.0,0.010391579,6
2020-05-18-170214,170214,10,0,0,389,4.666666666666667,1.3171929,0
2020-05-19-170214,170214,4,0,3,393,3.6666666666666665,1.0702441,1
2020-05-20-170214,170214,3,0,1,396,3.0,0.84549916,2
2020-05-21-170214,170214,4,0,3,400,2.5,0.884544,3
2020-05-22-170214,170214,7,0,1,407,4.5,0.5737249,4
2020-05-23-170214,170214,0,0,0,407,0.3333333333333333,0.0011341736,5
2020-05-24-170214,170214,0,0,0,407,0.0,7.4646584e-07,6
2020-05-25-170214,170214,2,0,1,409,5.333333333333333,1.4894816,0
2020-05-26-170214,170214,1,0,0,410,3.1666666666666665,0.83567107,1
2020-05-27-170214,170214,3,1,0,413,2.5,0.8996499,2
2020-05-28-170214,170214,1,1,2,414,2.5,1.7328957,3
2020-05-29-170214,170214,2,0,0,416,2.0,0.46818793,4
2020-05-30-170214,170214,0,0,0,416,0.0,0.0009137219,5
2020-05-31-170214,170214,0,0,0,416,0.0,0.006248428,6
2020-06-01-170214,170214,0,0,2,416,2.1666666666666665,0.062243182,0
2020-06-02-170214,170214,3,2,0,419,1.3333333333333333,0.67830026,1
2020-06-03-170214,170214,1,0,0,420,0.6666666666666666,0.13045548,2
2020-06-04-170214,170214,3,0,1,423,1.1666666666666667,0.34045053,3
2020-06-05-170214,170214,1,0,1,424,1.6666666666666667,0.41457996,4
2020-06-06-170214,170214,0,0,0,424,0.5,0.07529499,5
2020-06-07-170214,170214,0,4,0,424,0.3333333333333333,0.0009614588,6
2020-06-08-170214,170214,1,0,0,425,1.1666666666666667,0.7307953,0
2020-06-09-170214,170214,0,0,0,425,1.5,0.23379132,1
2020-06-10-170214,170214,0,0,1,425,1.1666666666666667,0.11974005,2
2020-06-11-170214,170214,2,0,0,427,1.5,0.7823617,3
2020-06-12-170214,170214,0,0,0,427,0.6666666666666666,0.7410153,4
2020-06-13-170214,170214,0,0,0,427,0.0,0.033390265,5
2020-06-14-170214,170214,0,0,0,427,0.16666666666666666,0.0058507835,6
2020-06-15-170214,170214,2,0,0,429,0.8333333333333334,0.025376849,0
2020-06-16-170214,170214,0,0,0,429,1.1666666666666667,0.32070187,1
2020-06-17-170214,170214,0,0,1,429,0.8333333333333334,0.8588291,2
2020-06-18-170214,170214,1,0,0,430,1.1666666666666667,0.5393039,3
2020-06-19-170214,170214,1,0,1,431,0.3333333333333333,0.02128778,4
2020-06-20-170214,170214,0,0,0,431,0.0,0.047125526,5
2020-06-21-170214,170214,0,0,0,431,0.0,0.06206968,6
2020-06-22-170214,170214,0,0,0,431,1.0,0.25508246,0
2020-06-23-170214,170214,0,0,1,431,0.5,1.0323615,1
2020-06-24-170214,170214,1,0,0,432,1.0,1.1256698,2
2020-06-25-170214,170214,0,1,0,432,1.0,0.24785206,3
2020-06-26-170214,170214,0,0,0,432,1.0,0.86739385,4
2020-06-27-170214,170214,0,0,1,432,0.3333333333333333,0.53795964,5
2020-06-28-170214,170214,0,0,0,432,0.16666666666666666,0.0033390708,6
2020-06-29-170214,170214,0,0,0,432,0.0,0.02001114,0
2020-06-30-170214,170214,0,0,1,432,0.8333333333333334,0.7882734,1
2020-07-01-170214,170214,1,0,1,433,0.6666666666666666,0.06654123,2
2020-07-02-170214,170214,0,0,1,433,0.0,0.044119563,3
2020-07-03-170214,170214,1,0,2,434,0.8333333333333334,0.58380055,4
2020-07-04-170214,170214,0,0,0,434,0.0,0.0011271562,5
2020-07-05-170214,170214,0,0,0,434,0.0,0.007626447,6
2020-07-06-170214,170214,0,0,1,434,0.0,0.11398465,0
2020-07-07-170214,170214,1,0,0,435,1.0,0.49672678,1
2020-07-08-170214,170214,0,0,0,435,0.16666666666666666,0.10127391,2
2020-07-09-170214,170214,0,0,2,435,0.3333333333333333,0.12047936,3
2020-07-10-170214,170214,0,0,3,435,0.3333333333333333,0.047929052,4
2020-07-11-170214,170214,1,0,0,436,0.0,0.0016500084,5
2020-07-12-170214,170214,0,0,2,436,0.16666666666666666,0.29723623,6
2020-07-13-170214,170214,0,0,1,436,1.1666666666666667,0.026048848,0
2020-07-14-170214,170214,1,0,2,437,0.3333333333333333,0.30098265,1
2020-07-15-170214,170214,1,0,2,438,2.833333333333333,0.5347155,2
2020-07-16-170214,170214,1,0,3,439,0.16666666666666666,0.1288489,3
2020-07-17-170214,170214,2,0,1,441,1.1666666666666667,0.33123532,4
2020-07-18-170214,170214,0,0,0,441,0.6666666666666666,0.33882123,5
2020-07-19-170214,170214,0,0,0,441,0.5,0.09001559,6
2020-07-20-170214,170214,1,0,2,442,0.6666666666666666,0.24138704,0
2020-07-21-170214,170214,0,0,1,442,0.5,0.033985827,1
2020-07-22-170214,170214,0,0,0,442,0.6666666666666666,0.056346387,2
2020-07-23-170214,170214,2,0,1,444,1.3333333333333333,0.54390377,3
2020-07-24-170214,170214,3,0,1,447,0.16666666666666666,0.034615252,4
2020-07-25-170214,170214,0,0,1,447,0.16666666666666666,0.008819045,5
2020-07-26-170214,170214,2,0,0,449,0.0,0.014644058,6
2020-07-27-170214,170214,1,0,2,450,2.0,1.2102637,0
2020-07-28-170214,170214,2,0,6,452,1.3333333333333333,0.29174864,1
2020-07-29-170214,170214,2,0,2,454,2.1666666666666665,1.2892805,2
2020-07-30-170214,170214,3,0,1,457,3.5,2.422505,3
2020-07-31-170214,170214,1,0,2,458,3.5,1.9652842,4
2020-08-01-170214,170214,0,0,0,458,0.5,0.35925436,5
2020-08-02-170214,170214,0,0,1,458,0.5,1.6326509,6
2020-08-03-170214,170214,2,0,1,460,2.1666666666666665,0.75511235,0
2020-08-04-170214,170214,1,0,3,461,4.333333333333333,3.77343,1
2020-08-05-170214,170214,0,0,0,461,3.8333333333333335,4.170891,2
2020-08-06-170214,170214,1,0,0,462,2.0,1.0725485,3
2020-08-07-170214,170214,1,0,0,463,1.6666666666666667,1.7425843,4
2020-08-08-170214,170214,1,0,0,464,2.5,1.5555025,5
2020-08-09-170214,170214,0,0,1,464,1.3333333333333333,0.17544621,6
2020-08-10-170214,170214,2,0,3,466,4.166666666666667,3.4411547,0
2020-08-11-170214,170214,6,0,4,472,2.6666666666666665,1.9231734,1
2020-08-12-170214,170214,2,0,1,474,5.666666666666668,4.0496593,2
2020-08-13-170214,170214,1,0,2,475,2.833333333333333,3.013698,3
2020-08-14-170214,170214,2,0,1,477,1.5,2.126201,4
2020-08-15-170214,170214,0,0,0,477,1.5,0.64351195,5
2020-08-16-170214,170214,1,0,1,478,1.8333333333333333,2.1383815,6
2020-08-17-170214,170214,1,0,5,479,3.0,1.6791354,0
2020-08-18-170214,170214,3,0,3,482,4.833333333333333,4.379184,1
2020-08-19-170214,170214,0,0,2,482,3.0,2.4782994,2
2020-08-20-170214,170214,0,0,8,482,1.6666666666666667,2.8341281,3
2020-08-21-170214,170214,0,0,3,482,4.333333333333333,4.320728,4
2020-08-22-170214,170214,0,0,3,482,2.6666666666666665,1.7620459,5
2020-08-23-170214,170214,1,0,3,483,1.6666666666666667,0.9836339,6
2020-08-24-170214,170214,3,0,4,486,7.666666666666668,3.2698817,0
2020-08-25-170214,170214,4,0,9,490,4.833333333333333,2.675095,1
2020-08-26-170214,170214,1,0,8,491,5.166666666666667,1.9085423,2
2020-08-27-170214,170214,2,0,9,493,5.833333333333332,1.7596992,3
2020-08-28-170214,170214,1,0,7,494,4.333333333333333,3.1421108,4
2020-08-29-170214,170214,0,0,1,494,2.333333333333333,0.8602098,5
2020-08-30-170214,170214,1,0,2,495,3.5,0.45519754,6
2020-08-31-170214,170214,5,0,5,500,5.166666666666667,0.9304214,0
2020-09-01-170214,170214,3,0,7,503,6.833333333333332,8.436546,1
2020-09-02-170214,170214,2,0,4,505,5.833333333333332,2.5674496,2
2020-09-03-170214,170214,8,0,7,513,5.666666666666668,1.2433655,3
2020-09-04-170214,170214,3,0,11,516,5.5,2.060288,4
2020-09-05-170214,170214,3,0,1,519,2.0,0.42854926,5
2020-09-06-170214,170214,3,0,0,522,1.3333333333333333,0.38328934,6
2020-09-07-170214,170214,4,0,9,526,4.833333333333333,1.4037446,0
2020-09-08-170214,170214,9,0,10,535,7.166666666666668,4.0892596,1
2020-09-09-170214,170214,8,0,12,543,4.833333333333333,1.7173895,2
2020-09-10-170214,170214,9,0,7,552,9.833333333333334,1.3012744,3
2020-09-11-170214,170214,7,0,3,559,5.5,3.1369355,4
2020-09-12-170214,170214,1,0,1,560,4.166666666666667,1.911826,5
2020-09-13-170214,170214,2,0,1,562,3.1666666666666665,1.065342,6
2020-09-14-170214,170214,5,0,10,567,9.5,1.9357473,0
2020-09-15-170214,170214,7,0,6,574,17.166666666666668,5.5724053,1
2020-09-16-170214,170214,4,0,9,578,10.833333333333336,2.4861586,2
2020-09-17-170214,170214,7,0,9,585,14.0,2.1973352,3
2020-09-18-170214,170214,11,0,14,596,11.5,3.8272943,4
2020-09-19-170214,170214,1,2,2,597,2.6666666666666665,0.030546222,5
2020-09-20-170214,170214,0,1,1,597,2.5,0.70201886,6
2020-09-21-170214,170214,9,0,2,606,15.833333333333336,2.219941,0
2020-09-22-170214,170214,10,1,5,616,10.833333333333336,2.1936655,1
2020-09-23-170214,170214,12,1,11,628,11.0,3.3853517,2
2020-09-24-170214,170214,7,0,7,635,6.5,1.2051092,3
2020-09-25-170214,170214,3,0,19,638,9.833333333333334,3.5854719,4
2020-09-26-170214,170214,1,0,4,639,0.8333333333333334,1.3338777,5
2020-09-27-170214,170214,1,0,11,640,1.0,0.50089514,6
2020-09-28-170214,170214,10,0,10,650,5.666666666666668,2.8418558,0
2020-09-29-170214,170214,6,0,4,656,5.0,3.6727488,1
2020-09-30-170214,170214,9,0,7,665,6.166666666666668,2.3720386,2
2020-10-01-170214,170214,9,0,11,674,6.666666666666668,2.0298855,3
2020-10-02-170214,170214,14,0,7,688,11.666666666666664,1.8367528,4
2020-10-03-170214,170214,2,0,2,690,2.833333333333333,1.1702725,5
2020-10-04-170214,170214,1,0,0,691,4.166666666666667,1.4246067,6
2020-10-05-170214,170214,2,0,12,693,6.833333333333332,5.944437,0
2020-10-06-170214,170214,5,0,5,698,8.833333333333334,5.299083,1
2020-10-07-170214,170214,11,1,13,709,10.166666666666666,9.391767,2
2020-10-08-170214,170214,7,0,13,716,9.0,2.6631005,3
2020-10-09-170214,170214,19,1,20,735,14.166666666666664,5.4301333,4
2020-10-10-170214,170214,4,0,11,739,2.5,0.8694575,5
2020-10-11-170214,170214,11,0,11,750,3.1666666666666665,0.9675343,6
2020-10-12-170214,170214,10,0,22,760,5.833333333333332,1.8068229,0
2020-10-13-170214,170214,4,0,18,764,12.333333333333336,2.8953984,1
2020-10-14-170214,170214,7,0,15,771,7.333333333333332,6.071656,2
2020-10-15-170214,170214,11,0,9,782,17.666666666666668,10.93509,3
2020-10-16-170214,170214,7,0,21,789,13.666666666666664,15.167399,4
2020-10-17-170214,170214,2,0,9,791,2.5,2.5150135,5
2020-10-18-170214,170214,0,0,14,791,3.5,1.1259767,6
2020-10-19-170214,170214,12,0,16,803,17.833333333333332,9.169072,0
2020-10-20-170214,170214,5,0,19,808,11.0,6.340861,1
2020-10-21-170214,170214,13,0,18,821,17.333333333333332,9.457842,2
2020-10-22-170214,170214,13,0,23,834,16.166666666666668,10.342311,3
2020-10-23-170214,170214,20,1,29,854,13.666666666666664,7.480175,4
2020-10-24-170214,170214,11,0,14,865,4.833333333333333,2.5453365,5
2020-10-25-170214,170214,11,0,14,876,8.833333333333334,2.7375472,6
2020-10-26-170214,170214,22,0,28,898,20.5,10.798677,0
2020-10-27-170214,170214,18,0,28,916,16.333333333333332,9.547369,1
2020-10-28-170214,170214,15,1,15,931,18.166666666666668,11.776852,2
2020-10-29-170214,170214,9,1,13,940,18.0,6.9842234,3
2020-10-30-170214,170214,21,0,24,961,18.666666666666668,10.499798,4
2020-10-31-170214,170214,9,0,0,970,7.333333333333332,3.1570067,5
2020-11-01-170214,170214,14,0,0,984,14.0,2.5677743,6
2020-11-02-170214,170214,16,0,0,1000,9.833333333333334,4.671089,0
2020-11-03-170214,170214,19,1,0,1019,18.83333333333333,7.6889944,1
2020-11-04-170214,170214,18,0,0,1037,19.5,8.648603,2
2020-11-05-170214,170214,23,0,0,1060,19.666666666666668,7.0690107,3
2020-11-06-170214,170214,29,0,0,1089,24.0,8.390302,4
2020-11-07-170214,170214,14,0,0,1103,10.333333333333334,4.2482595,5
2020-11-08-170214,170214,14,2,0,1117,13.833333333333336,5.251223,6
2020-11-09-170214,170214,28,0,0,1145,22.83333333333333,13.062622,0
2020-11-10-170214,170214,28,1,0,1173,16.833333333333332,8.626431,1
2020-11-11-170214,170214,15,1,0,1188,14.833333333333336,5.7221546,2
2020-11-12-170214,170214,13,2,0,1201,22.0,11.497285,3
2020-11-13-170214,170214,24,3,0,1225,23.0,9.739604,4
2020-03-01-170215,170215,0,0,0,0,0.0,2.3827738e-09,6
2020-03-02-170215,170215,0,0,0,0,0.0,0.00036857754,0
2020-03-03-170215,170215,0,1,0,0,0.0,0.0017586251,1
2020-03-04-170215,170215,0,0,0,0,0.0,0.0005509256,2
2020-03-05-170215,170215,0,0,0,0,0.0,0.0016917202,3
2020-03-06-170215,170215,0,0,0,0,0.0,0.00063055445,4
2020-03-07-170215,170215,0,0,0,0,0.0,0.00050873327,5
2020-03-08-170215,170215,0,0,0,0,0.0,3.5771736e-05,6
2020-03-09-170215,170215,0,0,1,0,0.0,0.01718376,0
2020-03-10-170215,170215,0,0,0,0,0.0,0.0126460865,1
2020-03-11-170215,170215,0,0,0,0,0.25,0.0887931,2
2020-03-12-170215,170215,0,0,0,0,1.0,0.11688464,3
2020-03-13-170215,170215,0,0,1,0,0.5,0.044232965,4
2020-03-14-170215,170215,0,0,1,0,1.25,0.35730463,5
2020-03-15-170215,170215,0,0,0,0,1.75,0.010945496,6
2020-03-16-170215,170215,0,0,0,0,2.75,0.27385437,0
2020-03-17-170215,170215,0,0,0,0,3.75,0.44799533,1
2020-03-18-170215,170215,0,0,0,0,5.25,0.39987758,2
2020-03-19-170215,170215,0,0,0,0,6.25,0.55974287,3
2020-03-20-170215,170215,0,1,0,0,3.25,0.3287851,4
2020-03-21-170215,170215,0,0,0,0,2.25,0.072504774,5
2020-03-22-170215,170215,0,0,0,0,3.5,0.050923616,6
2020-03-23-170215,170215,1,0,0,1,9.5,1.4891797,0
2020-03-24-170215,170215,0,0,0,1,6.5,0.71104527,1
2020-03-25-170215,170215,0,0,0,1,6.5,1.1198688,2
2020-03-26-170215,170215,0,0,0,1,3.75,0.59678435,3
2020-03-27-170215,170215,1,0,0,2,3.75,0.8111262,4
2020-03-28-170215,170215,1,0,0,3,1.5,0.24200636,5
2020-03-29-170215,170215,0,0,0,3,1.75,0.11559454,6
2020-03-30-170215,170215,0,0,0,3,4.0,0.6274499,0
2020-03-31-170215,170215,0,0,0,3,4.25,0.54694784,1
2020-04-01-170215,170215,0,0,0,3,5.0,0.6944246,2
2020-04-02-170215,170215,0,0,0,3,2.5,0.13689865,3
2020-04-03-170215,170215,0,0,0,3,1.5,0.2668458,4
2020-04-04-170215,170215,0,0,0,3,1.0,0.09479536,5
2020-04-05-170215,170215,0,0,0,3,0.25,0.0047334093,6
2020-04-06-170215,170215,0,0,0,3,1.25,0.20029351,0
2020-04-07-170215,170215,0,0,0,3,2.5,0.3050694,1
2020-04-08-170215,170215,0,3,0,3,2.0,0.29131982,2
2020-04-09-170215,170215,0,0,0,3,1.0,0.0954028,3
2020-04-10-170215,170215,0,1,0,3,2.25,0.03841302,4
2020-04-11-170215,170215,0,0,0,3,0.75,0.033017814,5
2020-04-12-170215,170215,0,0,0,3,1.75,0.053781845,6
2020-04-13-170215,170215,0,0,0,3,2.25,0.27333447,0
2020-04-14-170215,170215,0,0,0,3,2.25,0.41647804,1
2020-04-15-170215,170215,0,0,1,3,0.5,0.11980134,2
2020-04-16-170215,170215,0,0,0,3,2.75,0.29972836,3
2020-04-17-170215,170215,0,0,0,3,5.0,1.0133927,4
2020-04-18-170215,170215,0,0,0,3,0.0,0.0036450804,5
2020-04-19-170215,170215,0,0,0,3,0.75,0.059041794,6
2020-04-20-170215,170215,0,0,0,3,1.75,0.45777622,0
2020-04-21-170215,170215,0,2,0,3,1.25,0.07834418,1
2020-04-22-170215,170215,0,0,0,3,0.75,0.028005013,2
2020-04-23-170215,170215,0,0,0,3,0.75,0.004085816,3
2020-04-24-170215,170215,0,0,0,3,1.75,0.14577945,4
2020-04-25-170215,170215,0,0,0,3,0.5,0.0044586062,5
2020-04-26-170215,170215,0,0,0,3,0.75,0.064593755,6
2020-04-27-170215,170215,0,0,0,3,1.0,0.18840586,0
2020-04-28-170215,170215,0,0,0,3,1.5,0.09009962,1
2020-04-29-170215,170215,1,0,0,4,1.75,0.2900052,2
2020-04-30-170215,170215,0,0,0,4,1.25,0.019207899,3
2020-05-01-170215,170215,0,0,0,4,1.5,0.0071328925,4
2020-05-02-170215,170215,0,0,0,4,0.0,0.0032212473,5
2020-05-03-170215,170215,0,0,0,4,0.5,0.0059349807,6
2020-05-04-170215,170215,0,0,0,4,2.0,0.29028428,0
2020-05-05-170215,170215,0,0,0,4,0.0,0.040069666,1
2020-05-06-170215,170215,0,0,0,4,1.0,0.1508559,2
2020-05-07-170215,170215,0,0,0,4,0.5,0.037635695,3
2020-05-08-170215,170215,0,0,0,4,0.0,0.08282734,4
2020-05-09-170215,170215,0,1,0,4,0.0,0.055345103,5
2020-05-10-170215,170215,0,1,0,4,0.0,0.048494056,6
2020-05-11-170215,170215,0,0,0,4,0.5,0.08409104,0
2020-05-12-170215,170215,0,0,0,4,0.5,0.010764152,1
2020-05-13-170215,170215,0,0,0,4,1.5,0.2510498,2
2020-05-14-170215,170215,0,0,1,4,1.0,0.07755091,3
2020-05-15-170215,170215,0,0,0,4,1.0,0.07558299,4
2020-05-16-170215,170215,0,0,0,4,0.0,0.0005844305,5
2020-05-17-170215,170215,0,0,0,4,0.0,0.0029711695,6
2020-05-18-170215,170215,0,0,0,4,2.0,0.3400012,0
2020-05-19-170215,170215,0,0,0,4,0.75,0.18239465,1
2020-05-20-170215,170215,0,0,0,4,1.5,0.38785252,2
2020-05-21-170215,170215,0,0,0,4,0.5,0.1693591,3
2020-05-22-170215,170215,0,0,0,4,0.5,0.0056318664,4
2020-05-23-170215,170215,0,0,0,4,0.0,0.0006382487,5
2020-05-24-170215,170215,0,0,0,4,0.0,0.00083278416,6
2020-05-25-170215,170215,0,0,0,4,0.75,0.29669368,0
2020-05-26-170215,170215,0,0,0,4,1.5,0.17700996,1
2020-05-27-170215,170215,0,0,0,4,1.0,0.04009161,2
2020-05-28-170215,170215,1,0,0,5,0.0,0.06449593,3
2020-05-29-170215,170215,0,1,0,5,0.5,0.17622004,4
2020-05-30-170215,170215,0,0,0,5,0.0,0.001981694,5
2020-05-31-170215,170215,0,1,0,5,0.25,0.001259884,6
2020-06-01-170215,170215,0,0,0,5,0.5,0.08396078,0
2020-06-02-170215,170215,0,0,0,5,1.0,0.015061404,1
2020-06-03-170215,170215,0,1,0,5,0.75,0.17631844,2
2020-06-04-170215,170215,0,0,0,5,0.5,0.01979945,3
2020-06-05-170215,170215,0,0,0,5,0.0,0.017367877,4
2020-06-06-170215,170215,0,6,0,5,0.0,0.008203421,5
2020-06-07-170215,170215,0,0,0,5,0.0,0.0012115918,6
2020-06-08-170215,170215,0,0,0,5,0.0,0.007968734,0
2020-06-09-170215,170215,0,0,0,5,0.5,0.01055937,1
2020-06-10-170215,170215,0,0,0,5,0.0,0.008611238,2
2020-06-11-170215,170215,0,0,0,5,0.25,0.008116701,3
2020-06-12-170215,170215,0,0,0,5,0.25,0.019509917,4
2020-06-13-170215,170215,0,0,0,5,0.0,0.00020567526,5
2020-06-14-170215,170215,0,0,0,5,0.25,0.0015502796,6
2020-06-15-170215,170215,0,1,0,5,0.0,4.3301723e-05,0
2020-06-16-170215,170215,0,0,0,5,0.5,0.023764519,1
2020-06-17-170215,170215,0,0,0,5,0.0,0.008690862,2
2020-06-18-170215,170215,0,0,0,5,0.25,0.009883448,3
2020-06-19-170215,170215,0,0,0,5,0.75,0.09950616,4
2020-06-20-170215,170215,0,0,0,5,0.0,0.0116620185,5
2020-06-21-170215,170215,0,0,0,5,0.0,0.0014814326,6
2020-06-22-170215,170215,0,0,0,5,0.5,0.09714947,0
2020-06-23-170215,170215,0,0,0,5,0.5,0.09393841,1
2020-06-24-170215,170215,0,0,0,5,0.0,0.0131331775,2
2020-06-25-170215,170215,0,1,0,5,0.25,0.0057830913,3
2020-06-26-170215,170215,0,0,0,5,0.0,0.020572167,4
2020-06-27-170215,170215,0,0,0,5,0.0,0.0032069518,5
2020-06-28-170215,170215,0,0,0,5,0.0,0.001342085,6
2020-06-29-170215,170215,0,0,0,5,0.25,0.08590079,0
2020-06-30-170215,170215,0,0,0,5,0.0,0.011304343,1
2020-07-01-170215,170215,0,0,0,5,0.5,0.09023181,2
2020-07-02-170215,170215,0,0,0,5,0.75,0.015493694,3
2020-07-03-170215,170215,0,0,0,5,0.5,0.013553288,4
2020-07-04-170215,170215,0,0,0,5,0.0,0.0017003088,5
2020-07-05-170215,170215,0,0,0,5,0.0,1.3375871e-05,6
2020-07-06-170215,170215,0,0,0,5,0.75,0.015549912,0
2020-07-07-170215,170215,0,1,0,5,0.5,0.011776939,1
2020-07-08-170215,170215,0,0,0,5,0.25,0.017232573,2
2020-07-09-170215,170215,0,0,0,5,0.0,0.011554736,3
2020-07-10-170215,170215,0,0,0,5,0.25,0.101905994,4
2020-07-11-170215,170215,0,0,0,5,0.0,2.4244944e-08,5
2020-07-12-170215,170215,0,0,0,5,0.0,0.012525719,6
2020-07-13-170215,170215,0,0,0,5,0.0,0.016253652,0
2020-07-14-170215,170215,0,0,0,5,0.25,0.02297388,1
2020-07-15-170215,170215,0,0,0,5,0.25,0.014096071,2
2020-07-16-170215,170215,0,0,0,5,0.75,0.03222661,3
2020-07-17-170215,170215,0,0,0,5,0.0,0.004612867,4
2020-07-18-170215,170215,0,0,0,5,0.0,0.003055777,5
2020-07-19-170215,170215,0,0,0,5,0.0,0.019919721,6
2020-07-20-170215,170215,0,0,0,5,0.25,0.1093838,0
2020-07-21-170215,170215,0,0,0,5,0.25,0.1142976,1
2020-07-22-170215,170215,0,0,0,5,0.25,0.01714453,2
2020-07-23-170215,170215,0,0,0,5,0.75,0.0145211145,3
2020-07-24-170215,170215,0,0,0,5,0.5,0.09594349,4
2020-07-25-170215,170215,0,0,0,5,0.75,0.12003981,5
2020-07-26-170215,170215,0,0,1,5,0.5,0.0038880438,6
2020-07-27-170215,170215,0,0,0,5,0.0,0.00824955,0
2020-07-28-170215,170215,0,0,0,5,0.25,0.19727735,1
2020-07-29-170215,170215,0,0,0,5,0.25,0.027412975,2
2020-07-30-170215,170215,0,0,0,5,1.0,0.124608114,3
2020-07-31-170215,170215,0,0,2,5,1.25,0.12808065,4
2020-08-01-170215,170215,0,0,0,5,1.25,0.23201731,5
2020-08-02-170215,170215,0,0,0,5,0.0,0.031375945,6
2020-08-03-170215,170215,0,0,0,5,1.5,0.535346,0
2020-08-04-170215,170215,0,0,0,5,2.0,0.74046814,1
2020-08-05-170215,170215,0,0,1,5,3.0,1.7509358,2
2020-08-06-170215,170215,0,0,0,5,4.25,1.6093243,3
2020-08-07-170215,170215,0,0,0,5,2.5,0.9629261,4
2020-08-08-170215,170215,0,0,1,5,2.5,0.5962313,5
2020-08-09-170215,170215,1,0,0,6,5.0,0.9532107,6
2020-08-10-170215,170215,0,0,0,6,8.0,1.8252887,0
2020-08-11-170215,170215,0,0,0,6,5.25,1.615016,1
2020-08-12-170215,170215,0,0,0,6,4.0,0.645442,2
2020-08-13-170215,170215,0,0,1,6,4.25,0.5811364,3
2020-08-14-170215,170215,2,0,0,8,4.75,1.0149688,4
2020-08-15-170215,170215,0,0,0,8,2.75,1.0109494,5
2020-08-16-170215,170215,0,0,0,8,1.5,0.20855182,6
2020-08-17-170215,170215,0,0,0,8,9.0,3.375681,0
2020-08-18-170215,170215,0,0,0,8,3.25,0.8941849,1
2020-08-19-170215,170215,1,0,0,9,3.75,0.8707656,2
2020-08-20-170215,170215,0,0,0,9,3.5,1.212925,3
2020-08-21-170215,170215,0,0,0,9,3.0,0.63788784,4
2020-08-22-170215,170215,1,0,0,10,2.0,0.3364245,5
2020-08-23-170215,170215,0,0,0,10,1.0,0.43360347,6
2020-08-24-170215,170215,0,0,0,10,1.75,0.31525654,0
2020-08-25-170215,170215,0,0,0,10,2.75,0.18446317,1
2020-08-26-170215,170215,0,0,2,10,2.25,0.6097996,2
2020-08-27-170215,170215,1,0,0,11,2.0,0.44013226,3
2020-08-28-170215,170215,0,0,1,11,1.0,0.31939724,4
2020-08-29-170215,170215,0,0,1,11,0.75,0.118784994,5
2020-08-30-170215,170215,0,0,0,11,0.25,0.13515738,6
2020-08-31-170215,170215,0,0,0,11,0.75,0.11252261,0
2020-09-01-170215,170215,0,0,1,11,0.25,0.06350906,1
2020-09-02-170215,170215,0,0,0,11,1.5,0.19889483,2
2020-09-03-170215,170215,0,0,0,11,2.75,0.5959465,3
2020-09-04-170215,170215,0,0,0,11,1.5,0.37977508,4
2020-09-05-170215,170215,0,0,0,11,0.75,0.12530562,5
2020-09-06-170215,170215,0,0,1,11,0.25,0.24672468,6
2020-09-07-170215,170215,0,0,1,11,2.25,0.16972731,0
2020-09-08-170215,170215,0,0,0,11,2.25,0.3242137,1
2020-09-09-170215,170215,2,0,0,13,1.0,0.30139196,2
2020-09-10-170215,170215,0,0,0,13,6.0,2.0630262,3
2020-09-11-170215,170215,1,0,0,14,5.5,1.4045893,4
2020-09-12-170215,170215,1,0,0,15,1.0,0.2834079,5
2020-09-13-170215,170215,0,0,0,15,3.0,0.56746584,6
2020-09-14-170215,170215,0,0,0,15,1.0,0.19924909,0
2020-09-15-170215,170215,1,0,0,16,2.75,0.82082474,1
2020-09-16-170215,170215,0,0,0,16,0.75,0.27119666,2
2020-09-17-170215,170215,0,0,0,16,2.0,0.47081733,3
2020-09-18-170215,170215,0,0,0,16,2.5,0.28546575,4
2020-09-19-170215,170215,0,0,1,16,1.75,0.21552591,5
2020-09-20-170215,170215,1,0,0,17,2.0,0.5205454,6
2020-09-21-170215,170215,1,0,0,18,2.0,0.5632035,0
2020-09-22-170215,170215,0,0,3,18,1.0,0.113767646,1
2020-09-23-170215,170215,0,2,0,18,0.25,0.20967841,2
2020-09-24-170215,170215,0,0,0,18,1.25,0.18530646,3
2020-09-25-170215,170215,0,0,0,18,1.5,0.3265656,4
2020-09-26-170215,170215,0,0,0,18,1.75,0.20565437,5
2020-09-27-170215,170215,0,0,1,18,0.5,0.14412673,6
2020-09-28-170215,170215,0,0,1,18,1.5,0.20997274,0
2020-09-29-170215,170215,0,0,0,18,0.75,0.285822,1
2020-09-30-170215,170215,0,0,1,18,1.5,0.07405535,2
2020-10-01-170215,170215,0,0,0,18,0.75,0.31880367,3
2020-10-02-170215,170215,0,0,0,18,0.5,0.269153,4
2020-10-03-170215,170215,1,0,0,19,0.25,0.14002562,5
2020-10-04-170215,170215,0,0,0,19,1.25,0.238272,6
2020-10-05-170215,170215,0,0,0,19,0.25,0.04459462,0
2020-10-06-170215,170215,3,0,0,22,0.5,0.23975042,1
2020-10-07-170215,170215,0,0,3,22,1.75,0.38627616,2
2020-10-08-170215,170215,0,0,1,22,2.75,0.2991083,3
2020-10-09-170215,170215,0,0,3,22,1.75,0.265254,4
2020-10-10-170215,170215,0,0,0,22,1.75,0.3696705,5
2020-10-11-170215,170215,1,0,4,23,2.0,0.48078638,6
2020-10-12-170215,170215,1,0,2,24,1.5,0.6196089,0
2020-10-13-170215,170215,0,0,6,24,2.25,0.4858699,1
2020-10-14-170215,170215,1,0,1,25,2.0,0.40847534,2
2020-10-15-170215,170215,0,0,2,25,1.0,0.28232765,3
2020-10-16-170215,170215,0,0,0,25,3.25,0.38405943,4
2020-10-17-170215,170215,0,0,7,25,1.0,0.15129058,5
2020-10-18-170215,170215,0,0,6,25,2.5,0.5581488,6
2020-10-19-170215,170215,0,0,5,25,2.25,0.7796346,0
2020-10-20-170215,170215,0,0,3,25,1.5,0.28103793,1
2020-10-21-170215,170215,3,0,0,28,3.5,0.6148652,2
2020-10-22-170215,170215,1,0,2,29,3.5,0.5976046,3
2020-10-23-170215,170215,3,0,0,32,3.5,0.28171745,4
2020-10-24-170215,170215,0,0,0,32,1.0,0.1913976,5
2020-10-25-170215,170215,4,0,1,36,1.75,0.330881,6
2020-10-26-170215,170215,2,0,1,38,4.5,0.63153076,0
2020-10-27-170215,170215,6,0,2,44,2.25,0.5620824,1
2020-10-28-170215,170215,1,0,2,45,10.5,1.1830051,2
2020-10-29-170215,170215,2,0,0,47,6.5,1.0236934,3
2020-10-30-170215,170215,0,0,2,47,9.25,0.94143504,4
2020-10-31-170215,170215,7,1,0,54,4.25,0.5052227,5
2020-11-01-170215,170215,6,0,0,60,3.0,0.68962926,6
2020-11-02-170215,170215,5,0,0,65,6.0,0.7574902,0
2020-11-03-170215,170215,3,0,0,68,6.0,1.315005,1
2020-11-04-170215,170215,0,0,0,68,4.75,0.40028518,2
2020-11-05-170215,170215,2,0,0,70,3.25,0.7161047,3
2020-11-06-170215,170215,0,0,0,70,7.75,1.6484699,4
2020-11-07-170215,170215,0,0,0,70,5.0,0.39348936,5
2020-11-08-170215,170215,1,0,0,71,8.75,0.4543772,6
2020-11-09-170215,170215,1,0,0,72,4.75,0.7040254,0
2020-11-10-170215,170215,2,0,0,74,5.0,0.42542857,1
2020-11-11-170215,170215,2,0,0,76,4.0,0.81685257,2
2020-11-12-170215,170215,0,0,0,76,7.75,1.4117986,3
2020-11-13-170215,170215,2,0,0,78,2.75,0.46559185,4
2020-03-01-170216,170216,0,0,0,0,0.0,0.0005030462,6
2020-03-02-170216,170216,0,0,2,0,0.0,0.01842356,0
2020-03-03-170216,170216,0,0,4,0,0.0,0.029313806,1
2020-03-04-170216,170216,0,0,3,0,0.0,0.025106063,2
2020-03-05-170216,170216,0,0,6,0,0.0,0.0031917398,3
2020-03-06-170216,170216,0,0,4,0,0.0,0.025813226,4
2020-03-07-170216,170216,0,0,7,0,0.0,0.00361074,5
2020-03-08-170216,170216,0,0,5,0,0.0,0.0029691258,6
2020-03-09-170216,170216,0,0,11,0,0.42857142857142855,0.39067402,0
2020-03-10-170216,170216,1,0,8,1,0.14285714285714285,0.5312845,1
2020-03-11-170216,170216,0,0,4,1,0.2857142857142857,0.21734671,2
2020-03-12-170216,170216,0,0,5,1,0.42857142857142855,0.32881016,3
2020-03-13-170216,170216,1,0,3,2,1.0,1.2184943,4
2020-03-14-170216,170216,0,0,2,2,1.8571428571428568,0.7145705,5
2020-03-15-170216,170216,0,0,1,2,0.7142857142857143,0.37246418,6
2020-03-16-170216,170216,2,0,5,4,2.2857142857142856,2.1186392,0
2020-03-17-170216,170216,4,0,4,8,2.7142857142857144,3.154563,1
2020-03-18-170216,170216,3,0,6,11,2.2857142857142856,1.4842293,2
2020-03-19-170216,170216,6,0,5,17,4.142857142857143,4.224236,3
2020-03-20-170216,170216,4,0,6,21,2.8571428571428568,3.3383682,4
2020-03-21-170216,170216,7,0,1,28,1.1428571428571428,3.1455126,5
2020-03-22-170216,170216,5,0,2,33,2.142857142857143,2.2760973,6
2020-03-23-170216,170216,11,0,6,44,6.7142857142857135,7.687786,0
2020-03-24-170216,170216,8,0,0,52,4.142857142857143,6.290618,1
2020-03-25-170216,170216,4,0,3,56,5.0,4.860425,2
2020-03-26-170216,170216,5,0,2,61,3.0,4.0744247,3
2020-03-27-170216,170216,3,0,2,64,5.0,3.9941401,4
2020-03-28-170216,170216,2,1,2,66,1.2857142857142858,1.3047045,5
2020-03-29-170216,170216,1,0,8,67,1.4285714285714286,0.81599516,6
2020-03-30-170216,170216,5,0,1,72,4.714285714285714,3.7395318,0
2020-03-31-170216,170216,4,0,3,76,3.7142857142857135,2.7754028,1
2020-04-01-170216,170216,6,0,7,82,3.7142857142857135,2.9938803,2
2020-04-02-170216,170216,5,0,2,87,2.4285714285714284,2.9663877,3
2020-04-03-170216,170216,6,0,4,93,2.0,3.4758196,4
2020-04-04-170216,170216,1,0,0,94,0.5714285714285714,0.63845706,5
2020-04-05-170216,170216,2,0,0,96,0.8571428571428571,0.75432646,6
2020-04-06-170216,170216,6,1,0,102,0.8571428571428571,2.519287,0
2020-04-07-170216,170216,0,0,3,102,2.7142857142857144,1.4006683,1
2020-04-08-170216,170216,3,1,0,105,2.2857142857142856,2.427373,2
2020-04-09-170216,170216,2,1,2,107,5.142857142857143,2.2242832,3
2020-04-10-170216,170216,2,0,0,109,2.142857142857143,1.5081061,4
2020-04-11-170216,170216,2,0,0,111,0.5714285714285714,0.9579402,5
2020-04-12-170216,170216,8,0,0,119,0.7142857142857143,2.8019888,6
2020-04-13-170216,170216,1,0,0,120,2.2857142857142856,0.69533485,0
2020-04-14-170216,170216,3,0,2,123,1.7142857142857142,1.3391676,1
2020-04-15-170216,170216,7,1,1,130,2.4285714285714284,3.7144432,2
2020-04-16-170216,170216,2,0,3,132,3.0,1.9017622,3
2020-04-17-170216,170216,4,0,0,136,3.4285714285714284,3.6216524,4
2020-04-18-170216,170216,0,0,1,136,0.14285714285714285,0.08993295,5
2020-04-19-170216,170216,0,0,2,136,1.4285714285714286,0.5031485,6
2020-04-20-170216,170216,0,0,0,136,2.4285714285714284,1.7274197,0
2020-04-21-170216,170216,3,0,2,139,1.2857142857142858,1.9654242,1
2020-04-22-170216,170216,0,0,2,139,0.7142857142857143,0.41148114,2
2020-04-23-170216,170216,2,0,3,141,0.2857142857142857,0.71017534,3
2020-04-24-170216,170216,0,0,1,141,0.8571428571428571,0.5862146,4
2020-04-25-170216,170216,0,0,0,141,0.14285714285714285,0.047822487,5
2020-04-26-170216,170216,0,0,0,141,0.42857142857142855,0.13722433,6
2020-04-27-170216,170216,0,0,3,141,1.2857142857142858,0.5321949,0
2020-04-28-170216,170216,2,0,0,143,0.8571428571428571,1.1002659,1
2020-04-29-170216,170216,1,0,2,144,1.5714285714285714,1.2376122,2
2020-04-30-170216,170216,3,0,3,147,0.5714285714285714,1.5491896,3
2020-05-01-170216,170216,0,0,0,147,0.2857142857142857,0.11059346,4
2020-05-02-170216,170216,1,0,0,148,0.0,0.3899507,5
2020-05-03-170216,170216,2,0,1,150,0.2857142857142857,0.7697818,6
2020-05-04-170216,170216,0,0,3,150,1.2857142857142858,0.7220947,0
2020-05-05-170216,170216,2,0,1,152,0.5714285714285714,1.2719083,1
2020-05-06-170216,170216,2,0,2,154,0.42857142857142855,1.2306427,2
2020-05-07-170216,170216,3,0,0,157,0.2857142857142857,1.679041,3
2020-05-08-170216,170216,1,0,0,158,0.8571428571428571,0.53553927,4
2020-05-09-170216,170216,0,0,0,158,0.0,0.07308376,5
2020-05-10-170216,170216,0,0,0,158,0.2857142857142857,0.17210558,6
2020-05-11-170216,170216,3,0,1,161,0.42857142857142855,1.4710649,0
2020-05-12-170216,170216,0,0,2,161,0.7142857142857143,0.25261322,1
2020-05-13-170216,170216,2,0,2,163,1.2857142857142858,1.7768192,2
2020-05-14-170216,170216,3,0,0,166,0.8571428571428571,1.815215,3
2020-05-15-170216,170216,0,0,0,166,0.7142857142857143,0.43896005,4
2020-05-16-170216,170216,0,0,0,166,0.0,0.0026730532,5
2020-05-17-170216,170216,1,0,0,167,0.0,0.3679119,6
2020-05-18-170216,170216,3,0,0,170,1.8571428571428568,1.3194064,0
2020-05-19-170216,170216,1,0,1,171,1.0,0.52751607,1
2020-05-20-170216,170216,2,0,1,173,0.8571428571428571,1.7921647,2
2020-05-21-170216,170216,0,0,2,173,1.1428571428571428,0.5328576,3
2020-05-22-170216,170216,0,0,1,173,0.8571428571428571,0.21388827,4
2020-05-23-170216,170216,0,0,2,173,0.0,0.00096039224,5
2020-05-24-170216,170216,0,0,0,173,0.0,0.0013250678,6
2020-05-25-170216,170216,1,0,1,174,0.8571428571428571,0.8051284,0
2020-05-26-170216,170216,2,0,1,176,0.8571428571428571,0.3774103,1
2020-05-27-170216,170216,2,0,0,178,0.42857142857142855,1.3011355,2
2020-05-28-170216,170216,0,1,0,178,0.7142857142857143,0.6649616,3
2020-05-29-170216,170216,0,0,0,178,0.8571428571428571,0.69402045,4
2020-05-30-170216,170216,0,0,0,178,0.0,0.0004487289,5
2020-05-31-170216,170216,0,0,0,178,0.0,0.0021520294,6
2020-06-01-170216,170216,0,1,0,178,0.14285714285714285,0.10645895,0
2020-06-02-170216,170216,1,0,1,179,0.5714285714285714,0.2977354,1
2020-06-03-170216,170216,1,0,0,180,0.42857142857142855,0.92803645,2
2020-06-04-170216,170216,2,0,2,182,0.5714285714285714,1.2064197,3
2020-06-05-170216,170216,1,0,0,183,0.2857142857142857,0.65253973,4
2020-06-06-170216,170216,2,1,1,185,0.0,0.8645631,5
2020-06-07-170216,170216,0,3,0,185,0.0,0.00014026217,6
2020-06-08-170216,170216,1,0,0,186,0.0,0.28828388,0
2020-06-09-170216,170216,1,0,0,187,0.14285714285714285,0.27550688,1
2020-06-10-170216,170216,0,1,2,187,0.14285714285714285,0.19059771,2
2020-06-11-170216,170216,0,0,0,187,0.2857142857142857,0.12511404,3
2020-06-12-170216,170216,0,0,2,187,0.5714285714285714,0.2882541,4
2020-06-13-170216,170216,0,0,0,187,0.14285714285714285,0.18251131,5
2020-06-14-170216,170216,0,0,0,187,0.14285714285714285,0.0006894581,6
2020-06-15-170216,170216,0,0,0,187,0.0,0.005706497,0
2020-06-16-170216,170216,1,0,0,188,0.5714285714285714,0.3064127,1
2020-06-17-170216,170216,0,0,0,188,0.14285714285714285,0.13185272,2
2020-06-18-170216,170216,2,0,0,190,1.0,0.37277487,3
2020-06-19-170216,170216,0,0,0,190,0.5714285714285714,0.3915288,4
2020-06-20-170216,170216,1,0,0,191,0.14285714285714285,0.572961,5
2020-06-21-170216,170216,0,0,0,191,0.0,0.012370834,6
2020-06-22-170216,170216,0,0,1,191,0.42857142857142855,0.21642508,0
2020-06-23-170216,170216,0,0,1,191,0.2857142857142857,0.14693817,1
2020-06-24-170216,170216,2,0,0,193,0.7142857142857143,0.8661009,2
2020-06-25-170216,170216,0,0,0,193,0.14285714285714285,0.09171035,3
2020-06-26-170216,170216,2,0,0,195,0.2857142857142857,0.84220326,4
2020-06-27-170216,170216,0,0,0,195,0.14285714285714285,0.025533868,5
2020-06-28-170216,170216,0,1,1,195,0.0,0.0007183655,6
2020-06-29-170216,170216,0,0,1,195,0.14285714285714285,0.09428706,0
2020-06-30-170216,170216,0,0,2,195,0.2857142857142857,0.16216965,1
2020-07-01-170216,170216,0,0,1,195,0.42857142857142855,0.12767024,2
2020-07-02-170216,170216,0,0,1,195,0.14285714285714285,0.494046,3
2020-07-03-170216,170216,0,0,0,195,0.0,0.08701145,4
2020-07-04-170216,170216,0,0,0,195,0.0,0.003014246,5
2020-07-05-170216,170216,0,0,1,195,0.0,0.00097455573,6
2020-07-06-170216,170216,1,0,0,196,0.42857142857142855,0.13942812,0
2020-07-07-170216,170216,1,0,0,197,0.2857142857142857,0.40970924,1
2020-07-08-170216,170216,0,0,0,197,0.14285714285714285,0.11298954,2
2020-07-09-170216,170216,0,0,0,197,0.2857142857142857,0.39309096,3
2020-07-10-170216,170216,0,0,0,197,0.2857142857142857,0.289857,4
2020-07-11-170216,170216,0,0,0,197,0.14285714285714285,0.00073953613,5
2020-07-12-170216,170216,1,0,0,198,0.14285714285714285,0.60647696,6
2020-07-13-170216,170216,1,0,0,199,0.0,0.23372534,0
2020-07-14-170216,170216,2,1,0,201,0.42857142857142855,0.5886452,1
2020-07-15-170216,170216,1,0,2,202,0.14285714285714285,0.58778673,2
2020-07-16-170216,170216,1,0,0,203,0.2857142857142857,0.6451725,3
2020-07-17-170216,170216,0,0,0,203,0.14285714285714285,0.12882638,4
2020-07-18-170216,170216,0,0,0,203,0.0,0.029562406,5
2020-07-19-170216,170216,1,0,1,204,0.0,0.54829895,6
2020-07-20-170216,170216,0,0,0,204,0.14285714285714285,0.13102871,0
2020-07-21-170216,170216,0,0,0,204,0.2857142857142857,0.23808755,1
2020-07-22-170216,170216,0,0,1,204,0.14285714285714285,0.10736764,2
2020-07-23-170216,170216,0,0,2,204,0.14285714285714285,0.27663505,3
2020-07-24-170216,170216,0,0,1,204,0.14285714285714285,0.15460572,4
2020-07-25-170216,170216,0,0,0,204,0.14285714285714285,0.14083092,5
2020-07-26-170216,170216,0,0,0,204,0.14285714285714285,0.0077861943,6
2020-07-27-170216,170216,0,0,0,204,0.5714285714285714,0.09010878,0
2020-07-28-170216,170216,0,0,1,204,0.42857142857142855,0.2493814,1
2020-07-29-170216,170216,2,0,2,206,0.42857142857142855,0.95179147,2
2020-07-30-170216,170216,0,0,4,206,0.7142857142857143,0.61420995,3
2020-07-31-170216,170216,0,0,2,206,1.0,0.69280183,4
2020-08-01-170216,170216,0,0,5,206,1.0,0.47353387,5
2020-08-02-170216,170216,1,0,3,207,0.42857142857142855,1.5637928,6
2020-08-03-170216,170216,0,0,5,207,1.4285714285714286,0.8305774,0
2020-08-04-170216,170216,0,0,3,207,3.0,1.3843082,1
2020-08-05-170216,170216,1,0,4,208,3.1428571428571432,4.060395,2
2020-08-06-170216,170216,2,0,2,210,2.8571428571428568,3.956695,3
2020-08-07-170216,170216,1,0,7,211,1.7142857142857142,1.6864464,4
2020-08-08-170216,170216,0,0,1,211,2.2857142857142856,1.9965447,5
2020-08-09-170216,170216,0,0,8,211,2.142857142857143,1.0277528,6
2020-08-10-170216,170216,0,0,9,211,4.571428571428571,2.3644574,0
2020-08-11-170216,170216,1,0,3,212,3.8571428571428568,3.0661411,1
2020-08-12-170216,170216,2,0,2,214,4.0,5.5305157,2
2020-08-13-170216,170216,4,0,0,218,3.571428571428572,3.8641129,3
2020-08-14-170216,170216,2,0,4,220,3.1428571428571432,4.1209674,4
2020-08-15-170216,170216,5,0,1,225,2.4285714285714284,4.984998,5
2020-08-16-170216,170216,3,0,1,228,1.8571428571428568,3.2291024,6
2020-08-17-170216,170216,5,0,0,233,6.142857142857142,4.6559625,0
2020-08-18-170216,170216,3,0,1,236,4.571428571428571,2.2225716,1
2020-08-19-170216,170216,4,0,2,240,2.571428571428572,4.129198,2
2020-08-20-170216,170216,2,0,0,242,3.571428571428572,5.405885,3
2020-08-21-170216,170216,7,0,1,249,3.7142857142857135,6.5566597,4
2020-08-22-170216,170216,1,0,1,250,1.8571428571428568,2.5331376,5
2020-08-23-170216,170216,8,0,0,258,1.0,4.3778,6
2020-08-24-170216,170216,9,0,4,267,2.8571428571428568,2.5303931,0
2020-08-25-170216,170216,3,0,1,270,2.142857142857143,1.3476231,1
2020-08-26-170216,170216,2,0,4,272,1.8571428571428568,2.0647457,2
2020-08-27-170216,170216,0,0,9,272,2.142857142857143,1.2857938,3
2020-08-28-170216,170216,4,0,7,276,1.7142857142857142,3.5793483,4
2020-08-29-170216,170216,1,0,11,277,1.0,1.4433134,5
2020-08-30-170216,170216,1,0,2,278,1.1428571428571428,0.86491895,6
2020-08-31-170216,170216,0,0,5,278,1.2857142857142858,0.45643547,0
2020-09-01-170216,170216,1,0,7,279,1.4285714285714286,0.70262897,1
2020-09-02-170216,170216,2,0,3,281,1.8571428571428568,2.426843,2
2020-09-03-170216,170216,0,0,5,281,5.428571428571429,3.7928174,3
2020-09-04-170216,170216,1,0,3,282,2.0,1.8313173,4
2020-09-05-170216,170216,1,0,1,283,0.7142857142857143,1.1107477,5
2020-09-06-170216,170216,0,0,3,283,3.1428571428571432,1.9521472,6
2020-09-07-170216,170216,4,0,5,287,1.8571428571428568,1.0259256,0
2020-09-08-170216,170216,1,0,3,288,5.142857142857143,1.1143234,1
2020-09-09-170216,170216,4,0,4,292,1.8571428571428568,3.814283,2
2020-09-10-170216,170216,9,0,6,301,5.0,6.819593,3
2020-09-11-170216,170216,7,0,0,308,4.714285714285714,5.8094044,4
2020-09-12-170216,170216,11,0,2,319,1.4285714285714286,5.744425,5
2020-09-13-170216,170216,2,0,1,321,2.0,1.8804849,6
2020-09-14-170216,170216,5,0,3,326,1.2857142857142858,0.5366968,0
2020-09-15-170216,170216,7,0,2,333,6.428571428571429,3.7858417,1
2020-09-16-170216,170216,3,0,4,336,3.4285714285714284,4.3669567,2
2020-09-17-170216,170216,5,0,3,341,2.2857142857142856,3.2772741,3
2020-09-18-170216,170216,3,0,5,344,3.2857142857142856,2.3376555,4
2020-09-19-170216,170216,1,0,1,345,1.4285714285714286,0.49391842,5
2020-09-20-170216,170216,3,0,1,348,3.0,2.075881,6
2020-09-21-170216,170216,5,0,1,353,3.2857142857142856,1.8794408,0
2020-09-22-170216,170216,3,0,4,356,1.4285714285714286,0.6546349,1
2020-09-23-170216,170216,4,1,2,360,2.571428571428572,3.1886408,2
2020-09-24-170216,170216,6,0,2,366,1.4285714285714286,1.2629753,3
2020-09-25-170216,170216,0,0,1,366,3.0,2.1863248,4
2020-09-26-170216,170216,2,0,2,368,0.7142857142857143,1.5105149,5
2020-09-27-170216,170216,1,0,1,369,1.1428571428571428,0.9802918,6
2020-09-28-170216,170216,3,0,1,372,1.8571428571428568,1.1601063,0
2020-09-29-170216,170216,2,0,1,374,2.8571428571428568,2.4492645,1
2020-09-30-170216,170216,4,0,8,378,1.5714285714285714,1.2275001,2
2020-10-01-170216,170216,3,0,2,381,2.4285714285714284,1.8117362,3
2020-10-02-170216,170216,5,0,4,386,1.5714285714285714,2.570332,4
2020-10-03-170216,170216,1,2,1,387,1.1428571428571428,0.8608287,5
2020-10-04-170216,170216,1,1,1,388,1.8571428571428568,0.9162679,6
2020-10-05-170216,170216,1,1,6,389,1.8571428571428568,0.4571806,0
2020-10-06-170216,170216,4,0,1,393,2.8571428571428568,1.433721,1
2020-10-07-170216,170216,2,1,3,395,3.1428571428571432,3.4066153,2
2020-10-08-170216,170216,2,1,3,397,2.142857142857143,1.7158756,3
2020-10-09-170216,170216,1,0,6,398,2.571428571428572,1.8063331,4
2020-10-10-170216,170216,2,0,1,400,1.4285714285714286,1.9775182,5
2020-10-11-170216,170216,1,0,0,401,1.1428571428571428,1.2748705,6
2020-10-12-170216,170216,1,0,4,402,2.0,1.2291081,0
2020-10-13-170216,170216,1,0,3,403,1.8571428571428568,0.9405553,1
2020-10-14-170216,170216,8,0,14,411,3.7142857142857135,5.730162,2
2020-10-15-170216,170216,2,0,10,413,3.0,3.0818443,3
2020-10-16-170216,170216,4,0,13,417,3.4285714285714284,1.6702509,4
2020-10-17-170216,170216,1,0,3,418,1.0,1.2688198,5
2020-10-18-170216,170216,1,0,6,419,1.4285714285714286,1.1041474,6
2020-10-19-170216,170216,6,0,0,425,4.571428571428571,3.4507227,0
2020-10-20-170216,170216,1,0,7,426,2.571428571428572,1.0991378,1
2020-10-21-170216,170216,3,1,10,429,4.714285714285714,4.876832,2
2020-10-22-170216,170216,3,0,6,432,4.857142857142857,3.6848395,3
2020-10-23-170216,170216,6,0,15,438,3.8571428571428568,4.527746,4
2020-10-24-170216,170216,1,0,1,439,2.8571428571428568,1.9789938,5
2020-10-25-170216,170216,0,0,2,439,2.2857142857142856,1.1100851,6
2020-10-26-170216,170216,4,1,4,443,6.428571428571429,2.2960908,0
2020-10-27-170216,170216,3,1,4,446,4.714285714285714,2.2375517,1
2020-10-28-170216,170216,14,0,5,460,9.857142857142858,10.2581415,2
2020-10-29-170216,170216,10,0,2,470,5.857142857142858,7.386695,3
2020-10-30-170216,170216,13,0,6,483,8.428571428571429,8.834543,4
2020-10-31-170216,170216,3,0,0,486,5.285714285714286,4.858021,5
2020-11-01-170216,170216,6,2,0,492,4.714285714285714,5.196839,6
2020-11-02-170216,170216,0,0,0,492,3.1428571428571432,1.0367751,0
2020-11-03-170216,170216,7,1,0,499,7.7142857142857135,4.71458,1
2020-11-04-170216,170216,10,0,0,509,5.0,7.35255,2
2020-11-05-170216,170216,6,1,0,515,7.2857142857142865,7.457156,3
2020-11-06-170216,170216,15,0,0,530,10.0,9.924862,4
2020-11-07-170216,170216,1,0,0,531,3.4285714285714284,2.1285691,5
2020-11-08-170216,170216,2,0,0,533,6.7142857142857135,3.5104036,6
2020-11-09-170216,170216,4,0,0,537,5.285714285714286,2.2303257,0
2020-11-10-170216,170216,4,1,0,541,6.2857142857142865,3.297051,1
2020-11-11-170216,170216,5,0,0,546,3.2857142857142856,5.1932054,2
2020-11-12-170216,170216,2,0,0,548,9.714285714285714,5.103189,3
2020-11-13-170216,170216,6,1,0,554,9.142857142857142,8.8529415,4
2020-03-01-170217,170217,1,0,6,1,0.14285714285714285,2.3879993e-05,6
2020-03-02-170217,170217,0,0,12,1,0.42857142857142855,0.0061321347,0
2020-03-03-170217,170217,0,0,10,1,0.2857142857142857,0.00926965,1
2020-03-04-170217,170217,0,0,15,1,0.42857142857142855,0.20074345,2
2020-03-05-170217,170217,2,1,21,3,0.2857142857142857,0.00019835123,3
2020-03-06-170217,170217,0,0,33,3,0.42857142857142855,0.19984148,4
2020-03-07-170217,170217,0,0,16,3,0.0,0.0021612083,5
2020-03-08-170217,170217,1,0,12,4,0.14285714285714285,0.0011142303,6
2020-03-09-170217,170217,2,0,29,6,0.2857142857142857,0.42983902,0
2020-03-10-170217,170217,3,1,22,9,1.8571428571428568,0.020413622,1
2020-03-11-170217,170217,6,0,16,15,0.7142857142857143,0.117622055,2
2020-03-12-170217,170217,3,0,22,18,1.4285714285714286,0.057105187,3
2020-03-13-170217,170217,4,0,16,22,2.0,0.33281553,4
2020-03-14-170217,170217,2,0,8,24,2.0,0.42844155,5
2020-03-15-170217,170217,6,0,8,30,3.1428571428571432,0.12252059,6
2020-03-16-170217,170217,12,0,14,42,9.142857142857142,0.34399822,0
2020-03-17-170217,170217,10,0,10,52,11.0,0.6865975,1
2020-03-18-170217,170217,15,0,12,67,19.571428571428573,0.8231735,2
2020-03-19-170217,170217,21,0,9,88,18.857142857142858,1.0912492,3
2020-03-20-170217,170217,33,0,13,121,21.142857142857142,1.7158322,4
2020-03-21-170217,170217,16,0,2,137,6.857142857142858,0.19597012,5
2020-03-22-170217,170217,12,0,8,149,8.285714285714286,0.1308962,6
2020-03-23-170217,170217,29,0,17,178,21.714285714285715,1.3854842,0
2020-03-24-170217,170217,22,0,7,200,19.857142857142858,1.200578,1
2020-03-25-170217,170217,16,0,7,216,18.285714285714285,1.148115,2
2020-03-26-170217,170217,22,0,7,238,14.142857142857142,1.1502218,3
2020-03-27-170217,170217,16,0,7,254,20.428571428571427,1.1086985,4
2020-03-28-170217,170217,8,0,2,262,6.857142857142858,0.1150806,5
2020-03-29-170217,170217,8,0,3,270,4.857142857142857,0.14509654,6
2020-03-30-170217,170217,14,0,8,284,15.571428571428573,0.8424037,0
2020-03-31-170217,170217,10,0,9,294,10.857142857142858,0.3781265,1
2020-04-01-170217,170217,12,0,15,306,9.285714285714286,0.39528152,2
2020-04-02-170217,170217,9,0,7,315,8.428571428571429,0.55492216,3
2020-04-03-170217,170217,13,0,11,328,9.428571428571429,0.6990097,4
2020-04-04-170217,170217,2,0,4,330,3.2857142857142856,0.007966715,5
2020-04-05-170217,170217,8,0,3,338,3.0,0.091621056,6
2020-04-06-170217,170217,17,0,7,355,8.571428571428571,0.80657625,0
2020-04-07-170217,170217,7,3,5,362,6.428571428571429,0.64050496,1
2020-04-08-170217,170217,7,1,5,369,7.857142857142858,0.6906585,2
2020-04-09-170217,170217,7,0,5,376,4.857142857142857,0.58024216,3
2020-04-10-170217,170217,7,0,1,383,12.714285714285715,0.24448016,4
2020-04-11-170217,170217,2,0,1,385,5.285714285714286,0.152478,5
2020-04-12-170217,170217,3,0,0,388,2.2857142857142856,0.04825212,6
2020-04-13-170217,170217,8,0,6,396,9.571428571428571,0.47436213,0
2020-04-14-170217,170217,9,0,6,405,6.571428571428571,0.42175677,1
2020-04-15-170217,170217,15,0,5,420,16.285714285714285,0.8680105,2
2020-04-16-170217,170217,7,0,2,427,8.142857142857142,0.38808593,3
2020-04-17-170217,170217,11,0,1,438,12.428571428571427,0.35334635,4
2020-04-18-170217,170217,4,0,0,442,2.7142857142857144,0.092568964,5
2020-04-19-170217,170217,3,0,2,445,4.285714285714286,0.24347563,6
2020-04-20-170217,170217,7,0,5,452,6.571428571428571,0.6916359,0
2020-04-21-170217,170217,5,0,5,457,5.142857142857143,0.31070808,1
2020-04-22-170217,170217,5,0,7,462,8.571428571428571,0.14258395,2
2020-04-23-170217,170217,5,0,3,467,1.4285714285714286,0.0025451013,3
2020-04-24-170217,170217,1,0,1,468,5.0,0.39365974,4
2020-04-25-170217,170217,1,0,0,469,1.5714285714285714,0.18475816,5
2020-04-26-170217,170217,0,0,0,469,1.0,0.093489245,6
2020-04-27-170217,170217,6,1,8,475,6.428571428571429,0.5197389,0
2020-04-28-170217,170217,6,0,6,481,5.0,0.15141325,1
2020-04-29-170217,170217,5,0,7,486,3.571428571428572,0.37016577,2
2020-04-30-170217,170217,2,0,13,488,4.571428571428571,0.26958245,3
2020-05-01-170217,170217,1,0,6,489,1.0,0.0044754464,4
2020-05-02-170217,170217,0,0,1,489,1.0,0.11166086,5
2020-05-03-170217,170217,2,0,0,491,0.7142857142857143,0.005113992,6
2020-05-04-170217,170217,5,0,8,496,3.7142857142857135,0.51342136,0
2020-05-05-170217,170217,5,0,6,501,4.142857142857143,0.32333684,1
2020-05-06-170217,170217,7,0,5,508,4.142857142857143,0.31311,2
2020-05-07-170217,170217,3,0,2,511,3.8571428571428568,0.21932735,3
2020-05-08-170217,170217,1,0,4,512,5.142857142857143,0.7367371,4
2020-05-09-170217,170217,0,0,0,512,0.2857142857142857,0.0026100571,5
2020-05-10-170217,170217,0,5,0,512,0.42857142857142855,0.02052596,6
2020-05-11-170217,170217,8,0,9,520,4.571428571428571,0.33605355,0
2020-05-12-170217,170217,6,1,2,526,3.1428571428571432,0.28728098,1
2020-05-13-170217,170217,7,0,5,533,6.2857142857142865,0.8044862,2
2020-05-14-170217,170217,13,0,5,546,7.0,0.98965,3
2020-05-15-170217,170217,6,0,2,552,7.428571428571429,0.4739841,4
2020-05-16-170217,170217,1,0,0,553,1.5714285714285714,6.5004395e-05,5
2020-05-17-170217,170217,0,0,0,553,0.0,0.0036743865,6
2020-05-18-170217,170217,8,0,3,561,7.571428571428571,0.45415944,0
2020-05-19-170217,170217,6,0,1,567,3.4285714285714284,0.37968376,1
2020-05-20-170217,170217,5,0,2,572,3.7142857142857135,0.27030367,2
2020-05-21-170217,170217,2,0,0,574,4.428571428571429,0.2910122,3
2020-05-22-170217,170217,4,0,1,578,5.7142857142857135,0.15676285,4
2020-05-23-170217,170217,0,0,2,578,0.5714285714285714,0.00011302961,5
2020-05-24-170217,170217,0,0,0,578,0.14285714285714285,0.0011092785,6
2020-05-25-170217,170217,9,0,3,587,6.2857142857142865,0.5324333,0
2020-05-26-170217,170217,2,0,2,589,2.8571428571428568,0.28497767,1
2020-05-27-170217,170217,5,0,1,594,2.4285714285714284,0.3103093,2
2020-05-28-170217,170217,5,0,1,599,2.2857142857142856,0.62500936,3
2020-05-29-170217,170217,2,0,1,601,2.4285714285714284,0.15571842,4
2020-05-30-170217,170217,0,0,0,601,0.0,0.00084953377,5
2020-05-31-170217,170217,0,0,0,601,0.0,0.0018598492,6
2020-06-01-170217,170217,3,0,0,604,1.4285714285714286,0.021112502,0
2020-06-02-170217,170217,1,0,1,605,1.2857142857142858,0.23298348,1
2020-06-03-170217,170217,2,0,1,607,1.4285714285714286,0.051920243,2
2020-06-04-170217,170217,0,0,2,607,2.571428571428572,0.12025983,3
2020-06-05-170217,170217,1,0,0,608,3.1428571428571432,0.12773722,4
2020-06-06-170217,170217,2,0,0,610,0.42857142857142855,0.030285573,5
2020-06-07-170217,170217,0,0,0,610,0.2857142857142857,5.550332e-05,6
2020-06-08-170217,170217,3,0,1,613,2.4285714285714284,0.27487376,0
2020-06-09-170217,170217,2,0,0,615,1.1428571428571428,0.08093831,1
2020-06-10-170217,170217,1,0,1,616,1.0,0.040476922,2
2020-06-11-170217,170217,1,0,2,617,2.2857142857142856,0.29014423,3
2020-06-12-170217,170217,1,0,2,618,1.2857142857142858,0.2614755,4
2020-06-13-170217,170217,0,0,0,618,0.0,0.013670435,5
2020-06-14-170217,170217,0,0,0,618,0.2857142857142857,0.002025096,6
2020-06-15-170217,170217,0,0,0,618,1.8571428571428568,0.013737329,0
2020-06-16-170217,170217,1,0,1,619,1.0,0.11613051,1
2020-06-17-170217,170217,1,0,0,620,1.1428571428571428,0.31025133,2
2020-06-18-170217,170217,2,0,0,622,1.1428571428571428,0.18203448,3
2020-06-19-170217,170217,0,0,0,622,0.42857142857142855,0.009427443,4
2020-06-20-170217,170217,0,0,0,622,0.14285714285714285,0.016015802,5
2020-06-21-170217,170217,0,0,0,622,0.14285714285714285,0.019120922,6
2020-06-22-170217,170217,1,0,0,623,1.0,0.092529185,0
2020-06-23-170217,170217,0,0,1,623,0.5714285714285714,0.3644776,1
2020-06-24-170217,170217,1,0,0,624,1.0,0.36599773,2
2020-06-25-170217,170217,2,0,0,626,1.4285714285714286,0.08565355,3
2020-06-26-170217,170217,2,0,1,628,1.0,0.31968248,4
2020-06-27-170217,170217,0,0,0,628,0.2857142857142857,0.20111968,5
2020-06-28-170217,170217,0,0,0,628,0.2857142857142857,0.0018330634,6
2020-06-29-170217,170217,0,0,2,628,0.0,0.0066980375,0
2020-06-30-170217,170217,1,0,1,629,0.5714285714285714,0.28865433,1
2020-07-01-170217,170217,0,0,10,629,0.7142857142857143,0.028632073,2
2020-07-02-170217,170217,0,0,0,629,0.14285714285714285,0.016853439,3
2020-07-03-170217,170217,0,0,0,629,0.8571428571428571,0.22724995,4
2020-07-04-170217,170217,0,0,2,629,0.0,0.00076721725,5
2020-07-05-170217,170217,0,0,1,629,0.2857142857142857,0.0023117117,6
2020-07-06-170217,170217,0,0,1,629,0.14285714285714285,0.04125914,0
2020-07-07-170217,170217,1,0,1,630,0.42857142857142855,0.1785705,1
2020-07-08-170217,170217,0,0,0,630,0.14285714285714285,0.03701039,2
2020-07-09-170217,170217,0,0,0,630,0.7142857142857143,0.056440692,3
2020-07-10-170217,170217,1,0,0,631,0.5714285714285714,0.016868833,4
2020-07-11-170217,170217,0,0,0,631,0.14285714285714285,0.000722858,5
2020-07-12-170217,170217,0,1,0,631,0.14285714285714285,0.1012637,6
2020-07-13-170217,170217,2,0,3,633,0.14285714285714285,0.009087954,0
2020-07-14-170217,170217,1,0,1,634,0.2857142857142857,0.10460082,1
2020-07-15-170217,170217,10,0,1,644,1.4285714285714286,0.20544307,2
2020-07-16-170217,170217,0,0,7,644,0.7142857142857143,0.045073524,3
2020-07-17-170217,170217,0,0,4,644,1.0,0.11082773,4
2020-07-18-170217,170217,2,0,0,646,1.1428571428571428,0.1369617,5
2020-07-19-170217,170217,1,0,0,647,0.2857142857142857,0.03471297,6
2020-07-20-170217,170217,1,0,2,648,0.5714285714285714,0.0844887,0
2020-07-21-170217,170217,1,0,5,649,0.8571428571428571,0.0138423005,1
2020-07-22-170217,170217,0,0,2,649,0.5714285714285714,0.017418534,2
2020-07-23-170217,170217,0,0,5,649,1.4285714285714286,0.2084959,3
2020-07-24-170217,170217,0,0,5,649,1.4285714285714286,0.017477,4
2020-07-25-170217,170217,0,0,1,649,0.42857142857142855,0.0038636671,5
2020-07-26-170217,170217,0,0,3,649,0.2857142857142857,0.0064064297,6
2020-07-27-170217,170217,3,0,4,652,1.5714285714285714,0.43253303,0
2020-07-28-170217,170217,1,0,3,653,2.0,0.101340964,1
2020-07-29-170217,170217,1,0,4,654,2.0,0.43813086,2
2020-07-30-170217,170217,7,0,4,661,2.0,0.8822592,3
2020-07-31-170217,170217,4,0,0,665,2.8571428571428568,0.6193219,4
2020-08-01-170217,170217,0,0,4,665,0.14285714285714285,0.13028312,5
2020-08-02-170217,170217,0,0,1,665,0.2857142857142857,0.5547821,6
2020-08-03-170217,170217,2,0,1,667,1.8571428571428568,0.2636207,0
2020-08-04-170217,170217,5,0,4,672,1.5714285714285714,1.249699,1
2020-08-05-170217,170217,2,0,2,674,2.4285714285714284,1.3086786,2
2020-08-06-170217,170217,5,0,2,679,1.7142857142857142,0.38748378,3
2020-08-07-170217,170217,5,0,3,684,1.8571428571428568,0.65572965,4
2020-08-08-170217,170217,1,0,0,685,2.571428571428572,0.6050897,5
2020-08-09-170217,170217,3,0,2,688,0.8571428571428571,0.072575286,6
2020-08-10-170217,170217,4,0,7,692,3.571428571428572,1.2682154,0
2020-08-11-170217,170217,3,1,8,695,3.571428571428572,0.70862013,1
2020-08-12-170217,170217,4,0,12,699,5.142857142857143,1.3513298,2
2020-08-13-170217,170217,4,0,7,703,3.4285714285714284,1.0903289,3
2020-08-14-170217,170217,0,0,10,703,2.142857142857143,0.69415295,4
2020-08-15-170217,170217,4,0,1,707,1.1428571428571428,0.22518815,5
2020-08-16-170217,170217,1,0,7,708,1.5714285714285714,0.7696956,6
2020-08-17-170217,170217,1,0,4,709,2.7142857142857144,0.63677716,0
2020-08-18-170217,170217,4,0,5,713,3.7142857142857135,1.5660862,1
2020-08-19-170217,170217,2,0,9,715,2.8571428571428568,0.87180394,2
2020-08-20-170217,170217,2,0,10,717,2.142857142857143,0.9896996,3
2020-08-21-170217,170217,3,0,13,720,2.571428571428572,1.5800904,4
2020-08-22-170217,170217,0,0,5,720,2.571428571428572,0.68946767,5
2020-08-23-170217,170217,2,0,1,722,1.1428571428571428,0.33829856,6
2020-08-24-170217,170217,7,0,5,729,6.428571428571429,1.1198124,0
2020-08-25-170217,170217,8,0,9,737,4.142857142857143,1.0145537,1
2020-08-26-170217,170217,12,0,5,749,2.8571428571428568,0.69121945,2
2020-08-27-170217,170217,7,0,22,756,5.857142857142858,0.6348536,3
2020-08-28-170217,170217,10,0,14,766,3.2857142857142856,1.2004174,4
2020-08-29-170217,170217,1,0,1,767,2.0,0.30727863,5
2020-08-30-170217,170217,7,0,1,774,2.2857142857142856,0.1679918,6
2020-08-31-170217,170217,4,0,7,778,6.2857142857142865,0.30760497,0
2020-09-01-170217,170217,5,0,33,783,6.0,3.051308,1
2020-09-02-170217,170217,9,0,22,792,5.7142857142857135,0.8879895,2
2020-09-03-170217,170217,10,0,23,802,5.7142857142857135,0.48107708,3
2020-09-04-170217,170217,13,0,24,815,4.857142857142857,0.6981771,4
2020-09-05-170217,170217,5,0,7,820,2.142857142857143,0.14360787,5
2020-09-06-170217,170217,1,0,1,821,1.5714285714285714,0.13020165,6
2020-09-07-170217,170217,5,0,35,826,5.0,0.48061693,0
2020-09-08-170217,170217,9,0,25,835,5.428571428571429,1.5311422,1
2020-09-09-170217,170217,5,0,20,840,6.428571428571429,0.6241131,2
2020-09-10-170217,170217,22,0,12,862,6.571428571428571,0.5331993,3
2020-09-11-170217,170217,14,0,25,876,6.7142857142857135,1.1427313,4
2020-09-12-170217,170217,1,0,0,877,2.571428571428572,0.6878989,5
2020-09-13-170217,170217,1,0,1,878,2.4285714285714284,0.33222753,6
2020-09-14-170217,170217,7,0,10,885,8.142857142857142,0.7124478,0
2020-09-15-170217,170217,33,0,3,918,8.285714285714286,2.0903502,1
2020-09-16-170217,170217,22,0,7,940,6.571428571428571,0.86923647,2
2020-09-17-170217,170217,23,1,13,963,11.428571428571427,0.8445931,3
2020-09-18-170217,170217,24,0,31,987,7.857142857142858,1.3820461,4
2020-09-19-170217,170217,7,2,4,994,1.5714285714285714,0.01842647,5
2020-09-20-170217,170217,1,0,9,995,1.2857142857142858,0.24619623,6
2020-09-21-170217,170217,35,2,14,1030,10.0,0.7909675,0
2020-09-22-170217,170217,25,0,9,1055,9.571428571428571,0.80230457,1
2020-09-23-170217,170217,20,0,17,1075,8.571428571428571,1.128465,2
2020-09-24-170217,170217,12,0,13,1087,6.428571428571429,0.44207662,3
2020-09-25-170217,170217,25,1,20,1112,6.142857142857142,1.2698631,4
2020-09-26-170217,170217,0,0,3,1112,0.7142857142857143,0.521866,5
2020-09-27-170217,170217,1,0,2,1113,1.1428571428571428,0.1639141,6
2020-09-28-170217,170217,10,1,3,1123,5.428571428571429,1.0521009,0
2020-09-29-170217,170217,3,0,11,1126,4.142857142857143,1.3418676,1
2020-09-30-170217,170217,7,0,10,1133,5.0,0.9205277,2
2020-10-01-170217,170217,13,0,33,1146,6.857142857142858,0.7347022,3
2020-10-02-170217,170217,31,0,20,1177,8.142857142857142,0.6518677,4
2020-10-03-170217,170217,4,0,3,1181,2.142857142857143,0.48668417,5
2020-10-04-170217,170217,9,0,6,1190,2.2857142857142856,0.46389222,6
2020-10-05-170217,170217,14,0,26,1204,4.142857142857143,2.1275668,0
2020-10-06-170217,170217,9,0,11,1213,5.0,1.8857096,1
2020-10-07-170217,170217,17,2,28,1230,8.0,3.2604816,2
2020-10-08-170217,170217,13,1,28,1243,9.285714285714286,0.9964074,3
2020-10-09-170217,170217,20,1,19,1263,14.714285714285715,1.9435349,4
2020-10-10-170217,170217,3,0,7,1266,2.2857142857142856,0.33836067,5
2020-10-11-170217,170217,2,0,13,1268,4.857142857142857,0.3338447,6
2020-10-12-170217,170217,3,0,30,1271,6.857142857142858,0.6190045,0
2020-10-13-170217,170217,11,0,17,1282,10.857142857142858,1.0743666,1
2020-10-14-170217,170217,10,0,28,1292,8.571428571428571,2.1713283,2
2020-10-15-170217,170217,33,0,25,1325,14.0,3.8843474,3
2020-10-16-170217,170217,20,0,34,1345,12.142857142857142,5.69238,4
2020-10-17-170217,170217,3,0,17,1348,3.7142857142857135,1.0013348,5
2020-10-18-170217,170217,6,1,29,1354,1.8571428571428568,0.38790107,6
2020-10-19-170217,170217,26,0,7,1380,16.714285714285715,3.4351485,0
2020-10-20-170217,170217,11,0,25,1391,13.285714285714285,2.3799431,1
2020-10-21-170217,170217,28,0,27,1419,19.571428571428573,3.3044093,2
2020-10-22-170217,170217,28,0,37,1447,15.857142857142858,3.6526992,3
2020-10-23-170217,170217,19,0,23,1466,15.428571428571427,2.7603116,4
2020-10-24-170217,170217,7,1,14,1473,4.857142857142857,0.9622722,5
2020-10-25-170217,170217,13,0,15,1486,9.857142857142858,0.9297394,6
2020-10-26-170217,170217,30,0,26,1516,19.857142857142858,3.999884,0
2020-10-27-170217,170217,17,0,28,1533,19.857142857142858,3.3182974,1
2020-10-28-170217,170217,28,1,26,1561,19.428571428571427,4.2601333,2
2020-10-29-170217,170217,25,0,28,1586,17.714285714285715,2.5547717,3
2020-10-30-170217,170217,34,0,24,1620,19.285714285714285,3.8024125,4
2020-10-31-170217,170217,17,0,0,1637,8.142857142857142,1.1935693,5
2020-11-01-170217,170217,29,0,0,1666,16.0,0.855471,6
2020-11-02-170217,170217,7,0,0,1673,18.857142857142858,1.6616739,0
2020-11-03-170217,170217,25,1,0,1698,21.428571428571427,2.950717,1
2020-11-04-170217,170217,27,0,0,1725,20.857142857142858,3.0014427,2
2020-11-05-170217,170217,37,0,0,1762,23.142857142857146,2.571485,3
2020-11-06-170217,170217,23,1,0,1785,32.714285714285715,2.7739327,4
2020-11-07-170217,170217,14,0,0,1799,14.285714285714285,1.589258,5
2020-11-08-170217,170217,15,0,0,1814,14.142857142857142,1.9205505,6
2020-11-09-170217,170217,26,0,0,1840,27.42857142857143,4.74456,0
2020-11-10-170217,170217,28,0,0,1868,20.857142857142858,2.9855528,1
2020-11-11-170217,170217,26,1,0,1894,20.142857142857142,2.130991,2
2020-11-12-170217,170217,28,1,0,1922,23.42857142857143,4.1049113,3
2020-11-13-170217,170217,24,4,0,1946,34.857142857142854,3.3590133,4
2020-03-01-170218,170218,0,0,3,0,0.0,0.00014314469,6
2020-03-02-170218,170218,0,0,14,0,0.0,0.009862323,0
2020-03-03-170218,170218,0,0,12,0,0.14285714285714285,0.025843969,1
2020-03-04-170218,170218,0,0,14,0,0.2857142857142857,0.40834057,2
2020-03-05-170218,170218,0,2,14,0,0.14285714285714285,0.00095391873,3
2020-03-06-170218,170218,0,0,9,0,0.42857142857142855,0.37288868,4
2020-03-07-170218,170218,1,0,6,1,0.0,0.0032581908,5
2020-03-08-170218,170218,0,0,12,1,0.0,0.0039258106,6
2020-03-09-170218,170218,0,0,17,1,0.5714285714285714,0.8828593,0
2020-03-10-170218,170218,2,0,18,3,1.1428571428571428,0.034045596,1
2020-03-11-170218,170218,1,0,9,4,1.1428571428571428,0.28993613,2
2020-03-12-170218,170218,2,0,17,6,1.0,0.10261287,3
2020-03-13-170218,170218,3,0,13,9,2.2857142857142856,0.8796599,4
2020-03-14-170218,170218,0,0,6,9,2.142857142857143,0.9345274,5
2020-03-15-170218,170218,3,0,3,12,2.8571428571428568,0.36481068,6
2020-03-16-170218,170218,14,0,8,26,6.2857142857142865,0.9696342,0
2020-03-17-170218,170218,12,0,13,38,7.571428571428571,1.9616504,1
2020-03-18-170218,170218,14,0,8,52,15.714285714285715,2.134873,2
2020-03-19-170218,170218,14,0,11,66,14.714285714285715,3.0742698,3
2020-03-20-170218,170218,9,0,15,75,19.714285714285715,4.294065,4
2020-03-21-170218,170218,6,0,8,81,5.7142857142857135,0.40963563,5
2020-03-22-170218,170218,12,0,0,93,6.857142857142858,0.5680485,6
2020-03-23-170218,170218,17,0,4,110,22.0,3.8157194,0
2020-03-24-170218,170218,18,0,4,128,15.857142857142858,3.1802378,1
2020-03-25-170218,170218,9,0,5,137,16.285714285714285,2.9609363,2
2020-03-26-170218,170218,17,0,5,154,13.857142857142858,2.5552878,3
2020-03-27-170218,170218,13,0,7,167,16.714285714285715,3.1404138,4
2020-03-28-170218,170218,6,0,2,173,5.428571428571429,0.2899674,5
2020-03-29-170218,170218,3,0,1,176,5.142857142857143,0.5660941,6
2020-03-30-170218,170218,8,0,7,184,16.285714285714285,2.422296,0
2020-03-31-170218,170218,13,0,11,197,10.142857142857142,1.1738304,1
2020-04-01-170218,170218,8,0,3,205,10.285714285714286,1.1935644,2
2020-04-02-170218,170218,11,0,4,216,9.571428571428571,1.6208178,3
2020-04-03-170218,170218,15,0,9,231,9.428571428571429,1.8277928,4
2020-04-04-170218,170218,8,0,2,239,3.2857142857142856,0.01719622,5
2020-04-05-170218,170218,0,0,2,239,2.142857142857143,0.22822738,6
2020-04-06-170218,170218,4,0,10,243,7.857142857142858,1.4871552,0
2020-04-07-170218,170218,4,0,6,247,7.857142857142858,1.502741,1
2020-04-08-170218,170218,5,0,5,252,8.142857142857142,1.6616715,2
2020-04-09-170218,170218,5,0,4,257,8.0,2.1566753,3
2020-04-10-170218,170218,7,0,8,264,13.142857142857142,0.6796881,4
2020-04-11-170218,170218,2,0,2,266,7.0,0.32499784,5
2020-04-12-170218,170218,1,0,4,267,2.571428571428572,0.20515718,6
2020-04-13-170218,170218,7,0,6,274,9.285714285714286,1.4884887,0
2020-04-14-170218,170218,11,0,4,285,7.142857142857142,1.1546891,1
2020-04-15-170218,170218,3,0,4,288,12.857142857142858,2.2955136,2
2020-04-16-170218,170218,4,1,2,292,7.0,1.1027079,3
2020-04-17-170218,170218,9,0,0,301,10.857142857142858,0.791849,4
2020-04-18-170218,170218,2,0,0,303,2.2857142857142856,0.11215629,5
2020-04-19-170218,170218,2,0,0,305,4.714285714285714,0.8254051,6
2020-04-20-170218,170218,10,0,2,315,5.857142857142858,1.8512921,0
2020-04-21-170218,170218,6,0,2,321,6.428571428571429,0.972383,1
2020-04-22-170218,170218,5,0,4,326,7.857142857142858,0.42663673,2
2020-04-23-170218,170218,4,0,2,330,1.8571428571428568,0.016234515,3
2020-04-24-170218,170218,8,0,6,338,4.0,0.86856675,4
2020-04-25-170218,170218,2,0,0,340,1.7142857142857142,0.22712007,5
2020-04-26-170218,170218,4,0,0,344,0.8571428571428571,0.18011993,6
2020-04-27-170218,170218,6,1,3,350,5.285714285714286,1.250376,0
2020-04-28-170218,170218,4,0,4,354,4.0,0.4239819,1
2020-04-29-170218,170218,4,0,9,358,5.0,1.1619446,2
2020-04-30-170218,170218,2,0,7,360,2.8571428571428568,0.4772964,3
2020-05-01-170218,170218,0,0,5,360,1.0,0.010831199,4
2020-05-02-170218,170218,0,0,2,360,1.7142857142857142,0.14290093,5
2020-05-03-170218,170218,0,0,0,360,0.5714285714285714,0.0067369067,6
2020-05-04-170218,170218,2,0,2,362,3.571428571428572,0.9988086,0
2020-05-05-170218,170218,2,0,8,364,3.0,0.8875127,1
2020-05-06-170218,170218,4,0,5,368,4.142857142857143,0.57066476,2
2020-05-07-170218,170218,2,0,8,370,2.571428571428572,0.5140302,3
2020-05-08-170218,170218,6,0,0,376,4.857142857142857,1.6110262,4
2020-05-09-170218,170218,0,0,0,376,0.2857142857142857,0.004836596,5
2020-05-10-170218,170218,0,1,0,376,0.7142857142857143,0.08915933,6
2020-05-11-170218,170218,3,0,4,379,6.428571428571429,0.5541387,0
2020-05-12-170218,170218,4,0,0,383,3.571428571428572,0.7172843,1
2020-05-13-170218,170218,9,0,4,392,6.7142857142857135,1.7651364,2
2020-05-14-170218,170218,7,0,1,399,6.7142857142857135,2.1951537,3
2020-05-15-170218,170218,5,0,2,404,6.2857142857142865,1.0944874,4
2020-05-16-170218,170218,2,0,0,406,1.5714285714285714,3.4052305e-06,5
2020-05-17-170218,170218,0,0,0,406,0.14285714285714285,0.008176697,6
2020-05-18-170218,170218,2,0,1,408,5.571428571428571,1.1221321,0
2020-05-19-170218,170218,8,0,2,416,3.571428571428572,1.0116156,1
2020-05-20-170218,170218,5,0,2,421,4.285714285714286,0.59821856,2
2020-05-21-170218,170218,8,0,2,429,3.0,0.6506139,3
2020-05-22-170218,170218,0,1,1,429,3.7142857142857135,0.42812428,4
2020-05-23-170218,170218,0,0,3,429,0.7142857142857143,0.0002872156,5
2020-05-24-170218,170218,0,0,0,429,0.0,0.0011957582,6
2020-05-25-170218,170218,4,0,0,433,5.428571428571429,1.034796,0
2020-05-26-170218,170218,0,0,1,433,4.142857142857143,0.6024359,1
2020-05-27-170218,170218,4,0,7,437,2.7142857142857144,0.62201047,2
2020-05-28-170218,170218,1,1,2,438,2.8571428571428568,1.2352655,3
2020-05-29-170218,170218,2,0,0,440,2.142857142857143,0.37822542,4
2020-05-30-170218,170218,0,0,0,440,0.0,0.0005680466,5
2020-05-31-170218,170218,0,0,0,440,0.0,0.0064464887,6
2020-06-01-170218,170218,1,0,2,441,2.7142857142857144,0.037308473,0
2020-06-02-170218,170218,2,0,0,443,1.4285714285714286,0.7464334,1
2020-06-03-170218,170218,2,0,3,445,1.7142857142857142,0.10184591,2
2020-06-04-170218,170218,2,0,0,447,2.142857142857143,0.26681733,3
2020-06-05-170218,170218,1,0,1,448,2.571428571428572,0.32209167,4
2020-06-06-170218,170218,3,0,0,451,0.42857142857142855,0.040769976,5
2020-06-07-170218,170218,0,0,0,451,0.2857142857142857,5.7341033e-05,6
2020-06-08-170218,170218,0,0,2,451,2.2857142857142856,0.54706717,0
2020-06-09-170218,170218,1,0,2,452,1.4285714285714286,0.2017525,1
2020-06-10-170218,170218,7,0,1,459,1.1428571428571428,0.081123225,2
2020-06-11-170218,170218,2,0,0,461,0.7142857142857143,0.6104213,3
2020-06-12-170218,170218,0,0,0,461,1.7142857142857142,0.5445472,4
2020-06-13-170218,170218,0,0,0,461,0.14285714285714285,0.028551305,5
2020-06-14-170218,170218,0,0,0,461,0.14285714285714285,0.0021251668,6
2020-06-15-170218,170218,2,0,0,463,1.2857142857142858,0.038689017,0
2020-06-16-170218,170218,0,0,0,463,1.2857142857142858,0.2832983,1
2020-06-17-170218,170218,3,0,2,466,1.4285714285714286,0.59872097,2
2020-06-18-170218,170218,0,0,0,466,0.8571428571428571,0.48433155,3
2020-06-19-170218,170218,1,0,0,467,0.0,0.017894309,4
2020-06-20-170218,170218,0,0,0,467,0.2857142857142857,0.026241295,5
2020-06-21-170218,170218,0,0,0,467,0.2857142857142857,0.040357564,6
2020-06-22-170218,170218,2,0,0,469,1.0,0.22275835,0
2020-06-23-170218,170218,2,0,0,471,1.0,0.8053607,1
2020-06-24-170218,170218,1,1,1,472,1.1428571428571428,0.77884275,2
2020-06-25-170218,170218,0,0,1,472,1.4285714285714286,0.22399427,3
2020-06-26-170218,170218,0,0,0,472,1.5714285714285714,0.6133861,4
2020-06-27-170218,170218,0,2,0,472,0.2857142857142857,0.33609128,5
2020-06-28-170218,170218,0,0,0,472,0.14285714285714285,0.0029253059,6
2020-06-29-170218,170218,0,0,1,472,0.14285714285714285,0.01623652,0
2020-06-30-170218,170218,0,0,1,472,0.8571428571428571,0.52833915,1
2020-07-01-170218,170218,2,0,3,474,0.7142857142857143,0.02996566,2
2020-07-02-170218,170218,0,0,0,474,0.14285714285714285,0.031835407,3
2020-07-03-170218,170218,0,0,2,474,0.7142857142857143,0.3885571,4
2020-07-04-170218,170218,0,0,0,474,0.14285714285714285,0.00081120594,5
2020-07-05-170218,170218,0,0,1,474,0.2857142857142857,0.004800722,6
2020-07-06-170218,170218,0,0,3,474,0.2857142857142857,0.066105016,0
2020-07-07-170218,170218,0,0,1,474,0.7142857142857143,0.44972593,1
2020-07-08-170218,170218,1,0,2,475,0.2857142857142857,0.045801103,2
2020-07-09-170218,170218,1,0,0,476,0.5714285714285714,0.0873182,3
2020-07-10-170218,170218,0,0,0,476,0.5714285714285714,0.02272604,4
2020-07-11-170218,170218,0,0,2,476,0.0,0.0019445022,5
2020-07-12-170218,170218,0,0,1,476,0.42857142857142855,0.2412451,6
2020-07-13-170218,170218,1,0,4,477,0.2857142857142857,0.015089572,0
2020-07-14-170218,170218,1,0,0,478,0.5714285714285714,0.26216096,1
2020-07-15-170218,170218,3,0,3,481,0.8571428571428571,0.3710257,2
2020-07-16-170218,170218,0,0,5,481,1.0,0.067500725,3
2020-07-17-170218,170218,2,0,2,483,1.4285714285714286,0.29119572,4
2020-07-18-170218,170218,0,0,1,483,1.0,0.1882162,5
2020-07-19-170218,170218,1,0,0,484,0.2857142857142857,0.06514983,6
2020-07-20-170218,170218,3,0,1,487,0.42857142857142855,0.22557573,0
2020-07-21-170218,170218,1,0,0,488,0.42857142857142855,0.020764912,1
2020-07-22-170218,170218,2,0,4,490,0.42857142857142855,0.027749702,2
2020-07-23-170218,170218,0,0,3,490,0.8571428571428571,0.38603777,3
2020-07-24-170218,170218,0,0,0,490,1.0,0.03858401,4
2020-07-25-170218,170218,2,0,0,492,0.0,0.009634221,5
2020-07-26-170218,170218,1,0,1,493,0.0,0.0093987305,6
2020-07-27-170218,170218,4,0,1,497,2.2857142857142856,0.9255015,0
2020-07-28-170218,170218,0,0,4,497,1.2857142857142858,0.2387079,1
2020-07-29-170218,170218,3,0,1,500,1.5714285714285714,0.89317095,2
2020-07-30-170218,170218,5,0,4,505,1.8571428571428568,1.7873288,3
2020-07-31-170218,170218,2,0,1,507,3.7142857142857135,1.3199162,4
2020-08-01-170218,170218,1,0,3,508,1.0,0.3210955,5
2020-08-02-170218,170218,0,0,0,508,0.42857142857142855,1.3870009,6
2020-08-03-170218,170218,1,0,1,509,3.1428571428571432,0.5972873,0
2020-08-04-170218,170218,0,0,7,509,3.4285714285714284,2.9400978,1
2020-08-05-170218,170218,4,0,3,513,3.2857142857142856,3.0415475,2
2020-08-06-170218,170218,3,0,1,516,2.2857142857142856,0.8794959,3
2020-08-07-170218,170218,0,0,2,516,2.571428571428572,1.1621423,4
2020-08-08-170218,170218,0,0,1,516,3.1428571428571432,1.2391577,5
2020-08-09-170218,170218,1,0,1,517,1.0,0.12795602,6
2020-08-10-170218,170218,1,0,4,518,3.1428571428571432,2.2835667,0
2020-08-11-170218,170218,4,0,5,522,3.2857142857142856,1.8298309,1
2020-08-12-170218,170218,1,0,5,523,6.0,2.764877,2
2020-08-13-170218,170218,4,0,3,527,4.571428571428571,2.0580268,3
2020-08-14-170218,170218,1,0,3,528,3.4285714285714284,1.2960297,4
2020-08-15-170218,170218,3,0,0,531,1.7142857142857142,0.47954094,5
2020-08-16-170218,170218,0,0,0,531,2.4285714285714284,1.6482172,6
2020-08-17-170218,170218,1,0,8,532,2.571428571428572,1.361833,0
2020-08-18-170218,170218,7,0,4,539,6.0,3.3381767,1
2020-08-19-170218,170218,3,0,3,542,3.571428571428572,1.6118392,2
2020-08-20-170218,170218,1,0,4,543,3.1428571428571432,1.8134921,3
2020-08-21-170218,170218,2,0,10,545,4.142857142857143,3.0454724,4
2020-08-22-170218,170218,1,0,5,546,3.0,1.3749295,5
2020-08-23-170218,170218,1,0,5,547,0.8571428571428571,0.6584585,6
2020-08-24-170218,170218,4,0,0,551,8.285714285714286,2.489069,0
2020-08-25-170218,170218,5,0,6,556,5.142857142857143,1.9087145,1
2020-08-26-170218,170218,5,0,5,561,3.7142857142857135,1.2804782,2
2020-08-27-170218,170218,3,0,8,564,5.571428571428571,1.2032766,3
2020-08-28-170218,170218,3,0,6,567,3.7142857142857135,2.2471821,4
2020-08-29-170218,170218,0,0,2,567,1.0,0.57962507,5
2020-08-30-170218,170218,0,0,2,567,2.2857142857142856,0.2697575,6
2020-08-31-170218,170218,8,0,3,575,3.8571428571428568,0.6797325,0
2020-09-01-170218,170218,4,0,9,579,6.0,6.4198985,1
2020-09-02-170218,170218,3,0,5,582,5.0,2.0196912,2
2020-09-03-170218,170218,4,0,9,586,6.571428571428571,1.0168912,3
2020-09-04-170218,170218,10,0,13,596,4.285714285714286,1.4468082,4
2020-09-05-170218,170218,5,0,1,601,2.7142857142857144,0.2834039,5
2020-09-06-170218,170218,5,0,1,606,0.7142857142857143,0.32319328,6
2020-09-07-170218,170218,0,0,5,606,6.0,1.2479324,0
2020-09-08-170218,170218,6,0,10,612,5.571428571428571,3.9762144,1
2020-09-09-170218,170218,5,0,13,617,4.285714285714286,1.2922652,2
2020-09-10-170218,170218,8,0,9,625,6.142857142857142,1.2579921,3
2020-09-11-170218,170218,6,0,12,631,5.0,2.3992724,4
2020-09-12-170218,170218,2,0,0,633,2.7142857142857144,1.2544905,5
2020-09-13-170218,170218,2,0,0,635,3.2857142857142856,0.7978645,6
2020-09-14-170218,170218,3,0,8,638,7.571428571428571,1.4082011,0
2020-09-15-170218,170218,9,0,3,647,10.0,5.1793046,1
2020-09-16-170218,170218,5,0,4,652,7.7142857142857135,1.9300065,2
2020-09-17-170218,170218,9,0,2,661,10.571428571428571,1.5974737,3
2020-09-18-170218,170218,13,0,1,674,8.571428571428571,2.749123,4
2020-09-19-170218,170218,1,0,1,675,1.7142857142857142,0.024943871,5
2020-09-20-170218,170218,1,0,1,676,2.571428571428572,0.6224101,6
2020-09-21-170218,170218,5,1,3,681,11.285714285714285,1.8559473,0
2020-09-22-170218,170218,10,2,9,691,10.0,1.6900309,1
2020-09-23-170218,170218,13,0,4,704,11.0,2.4550562,2
2020-09-24-170218,170218,9,0,5,713,6.7142857142857135,0.9796194,3
2020-09-25-170218,170218,12,1,29,725,9.285714285714286,2.6306472,4
2020-09-26-170218,170218,0,0,2,725,0.5714285714285714,0.83536947,5
2020-09-27-170218,170218,0,0,8,725,1.7142857142857142,0.37665826,6
2020-09-28-170218,170218,8,0,9,733,5.428571428571429,2.0829685,0
2020-09-29-170218,170218,3,1,14,736,4.285714285714286,2.6958861,1
2020-09-30-170218,170218,4,0,5,740,7.0,1.8330863,2
2020-10-01-170218,170218,2,0,5,742,5.857142857142858,1.5823547,3
2020-10-02-170218,170218,1,0,22,743,7.428571428571429,1.2464927,4
2020-10-03-170218,170218,1,0,2,744,3.0,0.81922674,5
2020-10-04-170218,170218,1,0,1,745,4.142857142857143,1.0040219,6
2020-10-05-170218,170218,3,1,14,748,5.428571428571429,4.620101,0
2020-10-06-170218,170218,9,0,17,757,4.857142857142857,3.866474,1
2020-10-07-170218,170218,4,0,22,761,9.571428571428571,6.430572,2
2020-10-08-170218,170218,5,0,13,766,8.428571428571429,2.0903285,3
2020-10-09-170218,170218,29,1,15,795,11.285714285714285,4.0431757,4
2020-10-10-170218,170218,2,0,4,797,2.142857142857143,0.62528527,5
2020-10-11-170218,170218,8,0,4,805,3.8571428571428568,0.7328141,6
2020-10-12-170218,170218,9,0,35,814,5.428571428571429,1.2351645,0
2020-10-13-170218,170218,14,0,14,828,11.571428571428573,2.366938,1
2020-10-14-170218,170218,5,0,24,833,10.0,4.2602997,2
2020-10-15-170218,170218,5,0,17,838,15.285714285714285,7.383347,3
2020-10-16-170218,170218,22,0,22,860,12.428571428571427,10.312769,4
2020-10-17-170218,170218,2,0,8,862,4.857142857142857,1.7303798,5
2020-10-18-170218,170218,1,1,17,863,2.8571428571428568,0.8540142,6
2020-10-19-170218,170218,14,0,3,877,18.142857142857142,6.6828294,0
2020-10-20-170218,170218,17,0,22,894,14.857142857142858,4.974335,1
2020-10-21-170218,170218,22,0,12,916,14.714285714285715,7.240412,2
2020-10-22-170218,170218,13,0,18,929,14.0,7.5979185,3
2020-10-23-170218,170218,15,0,21,944,25.285714285714285,5.5919003,4
2020-10-24-170218,170218,4,0,13,948,5.285714285714286,1.7330213,5
2020-10-25-170218,170218,4,0,15,952,8.714285714285714,1.7956122,6
2020-10-26-170218,170218,35,0,23,987,23.57142857142857,8.53649,0
2020-10-27-170218,170218,14,1,19,1001,21.142857142857142,7.688511,1
2020-10-28-170218,170218,24,1,18,1025,18.142857142857142,8.343154,2
2020-10-29-170218,170218,17,0,18,1042,20.0,5.0819216,3
2020-10-30-170218,170218,22,1,20,1064,17.428571428571427,7.4700756,4
2020-10-31-170218,170218,8,0,0,1072,6.857142857142858,2.5051296,5
2020-11-01-170218,170218,17,0,0,1089,13.857142857142858,1.6810303,6
2020-11-02-170218,170218,3,1,0,1092,12.428571428571427,2.5724096,0
2020-11-03-170218,170218,22,0,0,1114,20.714285714285715,5.8859763,1
2020-11-04-170218,170218,12,0,0,1126,21.714285714285715,6.513995,2
2020-11-05-170218,170218,18,0,0,1144,18.714285714285715,5.195054,3
2020-11-06-170218,170218,21,0,0,1165,31.57142857142857,5.8107853,4
2020-11-07-170218,170218,13,0,0,1178,10.0,2.418573,5
2020-11-08-170218,170218,15,0,0,1193,14.857142857142858,3.8743887,6
2020-11-09-170218,170218,23,0,0,1216,25.714285714285715,9.861469,0
2020-11-10-170218,170218,19,0,0,1235,15.571428571428573,6.4191704,1
2020-11-11-170218,170218,18,1,0,1253,13.714285714285715,4.0583014,2
2020-11-12-170218,170218,18,0,0,1271,23.714285714285715,9.723485,3
2020-11-13-170218,170218,20,2,0,1291,24.285714285714285,7.6417837,4
2020-03-01-170219,170219,0,0,1,0,0.0,7.444719e-06,6
2020-03-02-170219,170219,0,0,2,0,0.0,0.0015449163,0
2020-03-03-170219,170219,0,0,1,0,0.0,0.0024202552,1
2020-03-04-170219,170219,0,0,3,0,0.0,0.0065058405,2
2020-03-05-170219,170219,0,1,3,0,0.0,1.4849174e-08,3
2020-03-06-170219,170219,0,0,5,0,0.0,0.01100394,4
2020-03-07-170219,170219,0,0,1,0,0.0,0.021747498,5
2020-03-08-170219,170219,0,0,9,0,0.0,0.0028069832,6
2020-03-09-170219,170219,0,1,3,0,0.4,0.09854614,0
2020-03-10-170219,170219,0,0,2,0,0.0,0.04436607,1
2020-03-11-170219,170219,0,0,6,0,0.2,0.05439759,2
2020-03-12-170219,170219,0,0,4,0,0.2,0.040638514,3
2020-03-13-170219,170219,0,0,1,0,0.6,0.13636771,4
2020-03-14-170219,170219,0,0,0,0,0.4,0.071742006,5
2020-03-15-170219,170219,1,0,0,1,0.2,0.035282183,6
2020-03-16-170219,170219,2,0,2,3,0.0,0.055909395,0
2020-03-17-170219,170219,1,0,2,4,0.8,0.11843006,1
2020-03-18-170219,170219,3,1,5,7,1.2,0.18839888,2
2020-03-19-170219,170219,3,3,1,10,2.0,0.38768396,3
2020-03-20-170219,170219,5,0,4,15,2.6,0.39533645,4
2020-03-21-170219,170219,1,0,1,16,1.6,0.15527152,5
2020-03-22-170219,170219,9,0,0,25,0.6,0.08802496,6
2020-03-23-170219,170219,3,0,3,28,4.4,0.71268576,0
2020-03-24-170219,170219,2,0,1,30,4.4,0.6951614,1
2020-03-25-170219,170219,6,0,0,36,3.2,0.57435626,2
2020-03-26-170219,170219,4,0,1,40,2.8,0.3856675,3
2020-03-27-170219,170219,1,0,2,41,2.0,0.36030328,4
2020-03-28-170219,170219,0,0,0,41,1.2,0.1667145,5
2020-03-29-170219,170219,0,0,1,41,0.2,0.025321856,6
2020-03-30-170219,170219,2,0,2,43,3.0,0.3899357,0
2020-03-31-170219,170219,2,0,0,45,2.0,0.2982766,1
2020-04-01-170219,170219,5,0,1,50,3.6,0.30953103,2
2020-04-02-170219,170219,1,0,0,51,3.0,0.38065597,3
2020-04-03-170219,170219,4,0,0,55,3.2,0.44919884,4
2020-04-04-170219,170219,1,0,0,56,0.8,0.06228699,5
2020-04-05-170219,170219,0,0,0,56,0.2,0.030660119,6
2020-04-06-170219,170219,3,0,3,59,2.0,0.3455029,0
2020-04-07-170219,170219,1,0,1,60,1.8,0.26065677,1
2020-04-08-170219,170219,0,1,1,60,1.0,0.121283524,2
2020-04-09-170219,170219,1,0,1,61,2.4,0.3116624,3
2020-04-10-170219,170219,2,0,0,63,0.8,0.09108205,4
2020-04-11-170219,170219,0,0,0,63,0.6,0.033300817,5
2020-04-12-170219,170219,1,0,1,64,0.0,0.0059186616,6
2020-04-13-170219,170219,2,0,0,66,1.8,0.2683795,0
2020-04-14-170219,170219,0,0,3,66,1.0,0.1431645,1
2020-04-15-170219,170219,1,0,1,67,0.8,0.16736354,2
2020-04-16-170219,170219,0,0,0,67,1.2,0.18135947,3
2020-04-17-170219,170219,0,0,2,67,0.4,0.08032829,4
2020-04-18-170219,170219,0,0,1,67,0.2,0.027512632,5
2020-04-19-170219,170219,0,0,0,67,0.4,0.03783082,6
2020-04-20-170219,170219,3,0,1,70,1.2,0.17432235,0
2020-04-21-170219,170219,1,0,0,71,0.6,0.10229939,1
2020-04-22-170219,170219,1,0,1,72,1.0,0.1460649,2
2020-04-23-170219,170219,1,0,1,73,0.0,0.009590169,3
2020-04-24-170219,170219,0,0,2,73,0.4,0.08715463,4
2020-04-25-170219,170219,0,0,1,73,0.2,0.010429131,5
2020-04-26-170219,170219,1,0,0,74,0.6,0.04479114,6
2020-04-27-170219,170219,0,1,1,74,0.4,0.058898482,0
2020-04-28-170219,170219,3,0,0,77,0.6,0.09285104,1
2020-04-29-170219,170219,1,0,3,78,0.4,0.062971264,2
2020-04-30-170219,170219,0,0,4,78,0.0,0.0188647,3
2020-05-01-170219,170219,2,0,0,80,0.2,0.028219355,4
2020-05-02-170219,170219,1,0,0,81,0.0,0.012014419,5
2020-05-03-170219,170219,0,0,0,81,0.0,0.0016191242,6
2020-05-04-170219,170219,1,0,2,82,0.4,0.107911535,0
2020-05-05-170219,170219,0,0,0,82,0.6,0.12339346,1
2020-05-06-170219,170219,1,0,1,83,0.4,0.106976144,2
2020-05-07-170219,170219,1,0,1,84,0.2,0.06557089,3
2020-05-08-170219,170219,2,0,1,86,0.2,0.073273025,4
2020-05-09-170219,170219,1,0,1,87,0.0,0.006664584,5
2020-05-10-170219,170219,0,0,0,87,0.4,0.04324216,6
2020-05-11-170219,170219,1,0,0,88,0.2,0.06844971,0
2020-05-12-170219,170219,0,0,3,88,0.6,0.08951799,1
2020-05-13-170219,170219,3,0,1,91,0.8,0.15590389,2
2020-05-14-170219,170219,4,0,3,95,0.6,0.15006477,3
2020-05-15-170219,170219,0,0,1,95,1.0,0.10581825,4
2020-05-16-170219,170219,0,0,0,95,0.0,2.9639426e-07,5
2020-05-17-170219,170219,0,0,1,95,0.0,0.00020209493,6
2020-05-18-170219,170219,2,0,2,97,0.4,0.11951141,0
2020-05-19-170219,170219,0,0,2,97,0.4,0.028502202,1
2020-05-20-170219,170219,1,0,1,98,0.4,0.0888493,2
2020-05-21-170219,170219,1,0,1,99,0.4,0.07559736,3
2020-05-22-170219,170219,1,0,1,100,0.4,0.06871446,4
2020-05-23-170219,170219,1,0,2,101,0.0,0.0075915153,5
2020-05-24-170219,170219,0,0,1,101,0.0,1.3076498e-05,6
2020-05-25-170219,170219,0,0,1,101,0.4,0.13232045,0
2020-05-26-170219,170219,3,0,0,104,0.0,0.0666668,1
2020-05-27-170219,170219,1,0,0,105,0.2,0.0392851,2
2020-05-28-170219,170219,3,1,0,108,0.0,0.048153512,3
2020-05-29-170219,170219,1,0,0,109,0.6,0.09595637,4
2020-05-30-170219,170219,0,0,0,109,0.0,1.4402039e-05,5
2020-05-31-170219,170219,1,0,1,110,0.0,0.0070734844,6
2020-06-01-170219,170219,2,1,0,112,0.4,0.11968331,0
2020-06-02-170219,170219,2,0,2,114,0.0,0.03820303,1
2020-06-03-170219,170219,1,0,1,115,0.4,0.07716615,2
2020-06-04-170219,170219,1,0,0,116,0.8,0.12813888,3
2020-06-05-170219,170219,1,0,1,117,0.2,0.06612216,4
2020-06-06-170219,170219,2,3,0,119,0.0,0.017803652,5
2020-06-07-170219,170219,1,0,1,120,0.0,0.0067335446,6
2020-06-08-170219,170219,1,0,0,121,0.6,0.07179734,0
2020-06-09-170219,170219,0,0,1,121,0.2,0.00995589,1
2020-06-10-170219,170219,0,0,0,121,0.8,0.12819463,2
2020-06-11-170219,170219,0,0,0,121,0.6,0.06461128,3
2020-06-12-170219,170219,0,0,0,121,0.6,0.1461387,4
2020-06-13-170219,170219,0,0,0,121,0.0,0.00013778552,5
2020-06-14-170219,170219,1,0,0,122,0.2,0.021160059,6
2020-06-15-170219,170219,0,0,0,122,0.4,0.034199685,0
2020-06-16-170219,170219,2,0,0,124,0.4,0.07161636,1
2020-06-17-170219,170219,1,0,0,125,0.0,0.013802116,2
2020-06-18-170219,170219,0,0,1,125,0.2,0.050941147,3
2020-06-19-170219,170219,1,0,0,126,0.2,0.036705706,4
2020-06-20-170219,170219,0,0,1,126,0.0,0.0004249178,5
2020-06-21-170219,170219,1,0,2,127,0.0,0.011792051,6
2020-06-22-170219,170219,0,0,0,127,0.0,0.0016934029,0
2020-06-23-170219,170219,1,0,1,128,0.0,0.020968147,1
2020-06-24-170219,170219,0,0,0,128,0.2,0.027825046,2
2020-06-25-170219,170219,0,0,1,128,0.0,0.0019872985,3
2020-06-26-170219,170219,0,0,0,128,0.0,0.017345492,4
2020-06-27-170219,170219,0,2,0,128,0.0,0.009051757,5
2020-06-28-170219,170219,0,0,0,128,0.0,0.002025328,6
2020-06-29-170219,170219,0,0,0,128,0.0,0.0049502375,0
2020-06-30-170219,170219,0,0,0,128,0.4,0.09520204,1
2020-07-01-170219,170219,0,0,0,128,0.4,0.11691283,2
2020-07-02-170219,170219,1,0,1,129,0.0,0.011503342,3
2020-07-03-170219,170219,0,0,0,129,0.8,0.2785397,4
2020-07-04-170219,170219,1,0,0,130,0.0,0.00019470765,5
2020-07-05-170219,170219,2,0,0,132,0.0,0.0263959,6
2020-07-06-170219,170219,0,0,1,132,0.8,0.039085817,0
2020-07-07-170219,170219,1,0,0,133,0.2,0.049452614,1
2020-07-08-170219,170219,0,0,0,133,1.0,0.16415077,2
2020-07-09-170219,170219,1,0,0,134,0.4,0.14571352,3
2020-07-10-170219,170219,0,0,0,134,0.4,0.099204466,4
2020-07-11-170219,170219,0,0,1,134,0.0,0.0046490883,5
2020-07-12-170219,170219,0,0,0,134,0.0,0.00091320596,6
2020-07-13-170219,170219,0,0,0,134,0.0,0.0004092992,0
2020-07-14-170219,170219,0,0,2,134,0.6,0.108786836,1
2020-07-15-170219,170219,0,0,1,134,0.6,0.020829914,2
2020-07-16-170219,170219,1,0,0,135,0.0,0.080756396,3
2020-07-17-170219,170219,0,0,2,135,0.0,0.003407969,4
2020-07-18-170219,170219,0,0,1,135,0.2,0.10057787,5
2020-07-19-170219,170219,0,0,2,135,0.0,0.040834174,6
2020-07-20-170219,170219,1,0,5,136,0.4,0.030775478,0
2020-07-21-170219,170219,0,0,3,136,0.0,0.030647997,1
2020-07-22-170219,170219,0,0,4,136,0.4,0.041905575,2
2020-07-23-170219,170219,0,0,7,136,0.0,0.016798388,3
2020-07-24-170219,170219,0,0,2,136,0.2,0.018358372,4
2020-07-25-170219,170219,1,0,0,137,0.0,0.031999473,5
2020-07-26-170219,170219,0,0,4,137,0.0,0.021312436,6
2020-07-27-170219,170219,0,0,3,137,0.2,0.018747315,0
2020-07-28-170219,170219,2,0,6,139,0.6,0.11826826,1
2020-07-29-170219,170219,1,0,6,140,0.2,0.12578021,2
2020-07-30-170219,170219,0,0,10,140,0.6,0.040890098,3
2020-07-31-170219,170219,2,0,3,142,0.2,0.04015432,4
2020-08-01-170219,170219,1,0,3,143,0.4,0.07825943,5
2020-08-02-170219,170219,2,0,1,145,0.4,0.09369968,6
2020-08-03-170219,170219,5,0,1,150,0.6,0.22772098,0
2020-08-04-170219,170219,3,0,5,153,0.8,0.28442052,1
2020-08-05-170219,170219,4,0,3,157,2.2,0.5043184,2
2020-08-06-170219,170219,7,0,6,164,1.6,0.42043385,3
2020-08-07-170219,170219,2,0,7,166,3.0,0.44940734,4
2020-08-08-170219,170219,0,0,1,166,1.0,0.17399432,5
2020-08-09-170219,170219,4,1,1,170,0.8,0.17095557,6
2020-08-10-170219,170219,3,0,1,173,1.2,0.32503563,0
2020-08-11-170219,170219,6,0,1,179,2.8,0.39370683,1
2020-08-12-170219,170219,6,0,8,185,2.8,0.5055402,2
2020-08-13-170219,170219,10,0,4,195,0.8,0.56619096,3
2020-08-14-170219,170219,3,0,5,198,0.2,0.11233836,4
2020-08-15-170219,170219,3,0,2,201,0.4,0.17667009,5
2020-08-16-170219,170219,1,0,1,202,0.0,0.058776584,6
2020-08-17-170219,170219,1,0,3,203,0.6,0.2690438,0
2020-08-18-170219,170219,5,0,4,208,1.4,0.6417497,1
2020-08-19-170219,170219,3,0,3,211,2.2,0.73057646,2
2020-08-20-170219,170219,6,0,1,217,2.4,0.33876354,3
2020-08-21-170219,170219,7,0,2,224,4.4,1.066539,4
2020-08-22-170219,170219,1,0,3,225,1.0,0.2317094,5
2020-08-23-170219,170219,1,0,0,226,1.4,0.05704161,6
2020-08-24-170219,170219,1,0,4,227,1.0,0.49602035,0
2020-08-25-170219,170219,1,0,1,228,1.0,0.22544517,1
2020-08-26-170219,170219,8,0,4,236,1.2,0.19526616,2
2020-08-27-170219,170219,4,0,3,240,0.8,0.29650798,3
2020-08-28-170219,170219,5,0,4,245,3.4,0.41165358,4
2020-08-29-170219,170219,2,0,3,247,0.6,0.16400816,5
2020-08-30-170219,170219,1,0,3,248,1.2,0.11188695,6
2020-08-31-170219,170219,3,0,4,251,1.6,0.35855275,0
2020-09-01-170219,170219,4,0,11,255,0.2,0.11629461,1
2020-09-02-170219,170219,3,0,6,258,1.8,0.30404937,2
2020-09-03-170219,170219,1,0,9,259,0.6,0.19317916,3
2020-09-04-170219,170219,2,0,3,261,0.2,0.19479789,4
2020-09-05-170219,170219,3,0,0,264,1.0,0.6077196,5
2020-09-06-170219,170219,0,0,7,264,0.4,0.13330866,6
2020-09-07-170219,170219,4,0,3,268,0.2,0.15291035,0
2020-09-08-170219,170219,1,0,5,269,1.0,0.37465847,1
2020-09-09-170219,170219,4,0,3,273,2.2,0.45420933,2
2020-09-10-170219,170219,3,0,6,276,0.4,0.17875151,3
2020-09-11-170219,170219,4,0,3,280,1.0,0.24435048,4
2020-09-12-170219,170219,3,0,0,283,0.2,0.3040401,5
2020-09-13-170219,170219,3,0,0,286,0.6,0.122232355,6
2020-09-14-170219,170219,4,0,1,290,1.6,0.20386198,0
2020-09-15-170219,170219,11,0,3,301,3.0,0.5053373,1
2020-09-16-170219,170219,6,0,1,307,1.2,0.2057367,2
2020-09-17-170219,170219,9,0,5,316,0.8,0.32038948,3
2020-09-18-170219,170219,3,0,3,319,2.0,0.4831278,4
2020-09-19-170219,170219,0,0,0,319,1.0,0.10936823,5
2020-09-20-170219,170219,7,1,1,326,0.4,0.06590168,6
2020-09-21-170219,170219,3,0,1,329,1.4,0.30524182,0
2020-09-22-170219,170219,5,0,5,334,1.2,0.2848464,1
2020-09-23-170219,170219,3,1,3,337,1.2,0.21157575,2
2020-09-24-170219,170219,6,0,1,343,0.8,0.25125983,3
2020-09-25-170219,170219,3,0,1,346,1.4,0.27614126,4
2020-09-26-170219,170219,0,0,0,346,1.4,0.34955144,5
2020-09-27-170219,170219,0,0,0,346,0.2,0.08235204,6
2020-09-28-170219,170219,1,0,1,347,0.8,0.28363758,0
2020-09-29-170219,170219,3,0,3,350,0.0,0.17698756,1
2020-09-30-170219,170219,1,0,0,351,1.4,0.33072177,2
2020-10-01-170219,170219,5,0,1,356,0.4,0.30988285,3
2020-10-02-170219,170219,3,0,2,359,1.2,0.26457956,4
2020-10-03-170219,170219,0,0,1,359,0.0,0.04517055,5
2020-10-04-170219,170219,1,1,2,360,0.2,0.11133183,6
2020-10-05-170219,170219,1,0,0,361,1.0,0.20042759,0
2020-10-06-170219,170219,5,0,5,366,2.4,0.3992615,1
2020-10-07-170219,170219,3,3,5,369,0.8,0.33076546,2
2020-10-08-170219,170219,1,0,10,370,0.4,0.2806094,3
2020-10-09-170219,170219,1,0,4,371,0.2,0.11853548,4
2020-10-10-170219,170219,0,0,0,371,0.2,0.06371995,5
2020-10-11-170219,170219,0,0,2,371,0.2,0.023269314,6
2020-10-12-170219,170219,1,0,2,372,0.0,0.048258048,0
2020-10-13-170219,170219,3,0,3,375,1.0,0.32492453,1
2020-10-14-170219,170219,0,0,4,375,1.6,0.39738032,2
2020-10-15-170219,170219,1,0,5,376,1.0,0.3590653,3
2020-10-16-170219,170219,2,0,5,378,1.2,0.44740227,4
2020-10-17-170219,170219,1,0,3,379,0.2,0.06460174,5
2020-10-18-170219,170219,2,0,3,381,1.0,0.15745069,6
2020-10-19-170219,170219,0,0,1,381,0.4,0.2805636,0
2020-10-20-170219,170219,5,0,4,386,0.6,0.22730555,1
2020-10-21-170219,170219,5,0,4,391,1.8,0.4488146,2
2020-10-22-170219,170219,10,0,2,401,1.6,0.49405125,3
2020-10-23-170219,170219,4,0,3,405,0.8,0.2512279,4
2020-10-24-170219,170219,0,0,0,405,0.6,0.10919204,5
2020-10-25-170219,170219,2,1,0,407,0.2,0.1278231,6
2020-10-26-170219,170219,2,1,4,409,0.2,0.22377016,0
2020-10-27-170219,170219,3,0,3,412,1.2,0.3766088,1
2020-10-28-170219,170219,4,1,4,416,3.8,0.85571015,2
2020-10-29-170219,170219,5,0,3,421,2.0,0.39746284,3
2020-10-30-170219,170219,5,1,9,426,1.4,0.51383233,4
2020-10-31-170219,170219,3,0,0,429,2.0,0.44301346,5
2020-11-01-170219,170219,3,0,0,432,1.6,0.39062378,6
2020-11-02-170219,170219,1,1,0,433,0.8,0.13111179,0
2020-11-03-170219,170219,4,0,0,437,2.4,0.5086865,1
2020-11-04-170219,170219,4,0,0,441,2.4,0.49640566,2
2020-11-05-170219,170219,2,0,0,443,1.6,0.4254458,3
2020-11-06-170219,170219,3,0,0,446,2.2,0.37284234,4
2020-11-07-170219,170219,0,0,0,446,1.2,0.27993065,5
2020-11-08-170219,170219,0,0,0,446,2.2,0.16203022,6
2020-11-09-170219,170219,4,0,0,450,3.2,0.49417722,0
2020-11-10-170219,170219,3,0,0,453,3.2,0.44202283,1
2020-11-11-170219,170219,4,0,0,457,4.0,0.48483595,2
2020-11-12-170219,170219,3,1,0,460,1.8,0.3305811,3
2020-11-13-170219,170219,9,0,0,469,3.0,0.48203868,4
2020-03-01-170220,170220,0,0,1,0,0.0,4.7792023e-06,6
2020-03-02-170220,170220,0,0,2,0,0.0,0.00026754348,0
2020-03-03-170220,170220,0,0,1,0,0.0,0.009670309,1
2020-03-04-170220,170220,0,1,0,0,0.0,0.023927545,2
2020-03-05-170220,170220,0,0,1,0,0.0,1.7099538e-07,3
2020-03-06-170220,170220,0,0,1,0,0.0,0.021389827,4
2020-03-07-170220,170220,0,0,0,0,0.0,0.00037026033,5
2020-03-08-170220,170220,0,0,0,0,0.16666666666666666,0.0063250065,6
2020-03-09-170220,170220,0,0,1,0,0.0,0.121073104,0
2020-03-10-170220,170220,0,0,0,0,0.0,0.014247896,1
2020-03-11-170220,170220,0,0,0,0,0.0,0.048873935,2
2020-03-12-170220,170220,0,0,1,0,0.6666666666666666,0.10114821,3
2020-03-13-170220,170220,1,0,2,1,0.3333333333333333,0.34345418,4
2020-03-14-170220,170220,0,0,1,1,0.8333333333333334,0.26788324,5
2020-03-15-170220,170220,1,0,0,2,0.3333333333333333,0.19593665,6
2020-03-16-170220,170220,2,0,2,4,1.0,0.24996093,0
2020-03-17-170220,170220,1,0,0,5,0.6666666666666666,0.56627977,1
2020-03-18-170220,170220,0,0,0,5,0.5,0.3270996,2
2020-03-19-170220,170220,1,0,0,6,1.5,0.75454944,3
2020-03-20-170220,170220,1,1,0,7,1.5,0.8321564,4
2020-03-21-170220,170220,0,0,0,7,0.6666666666666666,0.30960476,5
2020-03-22-170220,170220,0,0,0,7,0.6666666666666666,0.30549785,6
2020-03-23-170220,170220,1,0,0,8,1.5,0.96209276,0
2020-03-24-170220,170220,0,0,2,8,1.3333333333333333,0.9025444,1
2020-03-25-170220,170220,0,0,0,8,1.0,0.69733936,2
2020-03-26-170220,170220,1,0,1,9,1.6666666666666667,0.60249805,3
2020-03-27-170220,170220,2,0,1,11,3.1666666666666665,1.0725191,4
2020-03-28-170220,170220,1,0,0,12,0.3333333333333333,0.14507897,5
2020-03-29-170220,170220,0,0,0,12,1.6666666666666667,0.29719228,6
2020-03-30-170220,170220,2,0,0,14,1.0,0.963827,0
2020-03-31-170220,170220,0,0,3,14,0.8333333333333334,0.40757614,1
2020-04-01-170220,170220,0,0,3,14,0.8333333333333334,0.34756804,2
2020-04-02-170220,170220,0,0,0,14,1.1666666666666667,0.38799995,3
2020-04-03-170220,170220,0,0,2,14,0.0,0.4123757,4
2020-04-04-170220,170220,0,0,0,14,0.6666666666666666,0.14501429,5
2020-04-05-170220,170220,0,0,0,14,1.0,0.117447935,6
2020-04-06-170220,170220,0,0,0,14,1.3333333333333333,0.3199777,0
2020-04-07-170220,170220,2,0,0,16,0.6666666666666666,0.42025065,1
2020-04-08-170220,170220,0,1,0,16,2.6666666666666665,0.6087692,2
2020-04-09-170220,170220,1,0,1,17,1.6666666666666667,1.1117878,3
2020-04-10-170220,170220,1,0,0,18,2.0,0.43464985,4
2020-04-11-170220,170220,0,0,0,18,0.6666666666666666,0.26157674,5
2020-04-12-170220,170220,0,0,0,18,0.0,0.13723955,6
2020-04-13-170220,170220,0,1,0,18,1.1666666666666667,0.53179014,0
2020-04-14-170220,170220,3,0,0,21,0.8333333333333334,0.29702586,1
2020-04-15-170220,170220,3,0,0,24,0.8333333333333334,0.47236806,2
2020-04-16-170220,170220,0,0,0,24,0.6666666666666666,0.29363808,3
2020-04-17-170220,170220,2,0,0,26,0.5,0.3634359,4
2020-04-18-170220,170220,0,0,0,26,0.0,0.013070103,5
2020-04-19-170220,170220,0,0,0,26,0.3333333333333333,0.24960579,6
2020-04-20-170220,170220,0,0,0,26,1.0,0.6221407,0
2020-04-21-170220,170220,0,0,0,26,0.6666666666666666,0.3293432,1
2020-04-22-170220,170220,0,0,0,26,0.6666666666666666,0.21106838,2
2020-04-23-170220,170220,1,0,0,27,0.0,0.03604311,3
2020-04-24-170220,170220,0,0,0,27,0.3333333333333333,0.17558314,4
2020-04-25-170220,170220,0,0,0,27,0.16666666666666666,0.024523765,5
2020-04-26-170220,170220,0,0,0,27,0.0,0.030231798,6
2020-04-27-170220,170220,0,0,0,27,0.5,0.17394373,0
2020-04-28-170220,170220,0,0,0,27,0.5,0.12261776,1
2020-04-29-170220,170220,0,0,0,27,0.16666666666666666,0.22403212,2
2020-04-30-170220,170220,0,0,0,27,0.6666666666666666,0.102915786,3
2020-05-01-170220,170220,0,0,0,27,0.6666666666666666,0.02148074,4
2020-05-02-170220,170220,0,0,0,27,0.16666666666666666,0.06306911,5
2020-05-03-170220,170220,0,0,0,27,0.16666666666666666,0.01752736,6
2020-05-04-170220,170220,0,0,0,27,0.8333333333333334,0.21917045,0
2020-05-05-170220,170220,0,0,0,27,0.5,0.27331364,1
2020-05-06-170220,170220,0,0,1,27,0.6666666666666666,0.21456797,2
2020-05-07-170220,170220,0,0,0,27,0.3333333333333333,0.11143741,3
2020-05-08-170220,170220,0,0,0,27,0.3333333333333333,0.1944601,4
2020-05-09-170220,170220,0,0,0,27,0.16666666666666666,0.046604432,5
2020-05-10-170220,170220,0,0,0,27,0.16666666666666666,0.028612373,6
2020-05-11-170220,170220,0,2,0,27,0.5,0.16398501,0
2020-05-12-170220,170220,0,1,0,27,0.5,0.14699243,1
2020-05-13-170220,170220,0,0,0,27,0.3333333333333333,0.23422205,2
2020-05-14-170220,170220,0,1,1,27,0.16666666666666666,0.3389315,3
2020-05-15-170220,170220,0,0,0,27,0.5,0.24774866,4
2020-05-16-170220,170220,0,0,0,27,0.0,0.00017127862,5
2020-05-17-170220,170220,0,0,0,27,0.3333333333333333,0.06606255,6
2020-05-18-170220,170220,0,0,0,27,0.3333333333333333,0.23421796,0
2020-05-19-170220,170220,0,0,0,27,0.16666666666666666,0.21771057,1
2020-05-20-170220,170220,1,0,1,28,0.5,0.28646138,2
2020-05-21-170220,170220,0,0,0,28,0.8333333333333334,0.14702779,3
2020-05-22-170220,170220,0,0,0,28,1.5,0.16040863,4
2020-05-23-170220,170220,0,0,0,28,0.16666666666666666,0.00593659,5
2020-05-24-170220,170220,0,0,0,28,0.0,1.1975285e-05,6
2020-05-25-170220,170220,0,0,0,28,0.16666666666666666,0.14174694,0
2020-05-26-170220,170220,0,0,0,28,0.5,0.1639259,1
2020-05-27-170220,170220,0,0,0,28,0.3333333333333333,0.09349226,2
2020-05-28-170220,170220,1,0,0,29,0.5,0.26078624,3
2020-05-29-170220,170220,0,0,0,29,1.3333333333333333,0.30331683,4
2020-05-30-170220,170220,0,0,0,29,0.0,0.0032244334,5
2020-05-31-170220,170220,0,0,0,29,0.5,0.026958477,6
2020-06-01-170220,170220,0,0,0,29,0.16666666666666666,0.041124746,0
2020-06-02-170220,170220,0,0,1,29,0.6666666666666666,0.36423323,1
2020-06-03-170220,170220,1,0,0,30,0.3333333333333333,0.12886532,2
2020-06-04-170220,170220,0,0,0,30,0.3333333333333333,0.110740356,3
2020-06-05-170220,170220,0,0,0,30,0.5,0.119757764,4
2020-06-06-170220,170220,0,2,0,30,0.3333333333333333,0.06034695,5
2020-06-07-170220,170220,0,0,0,30,0.0,4.498483e-05,6
2020-06-08-170220,170220,0,0,0,30,0.0,0.06975937,0
2020-06-09-170220,170220,0,0,0,30,0.3333333333333333,0.049359884,1
2020-06-10-170220,170220,0,0,0,30,0.3333333333333333,0.12569365,2
2020-06-11-170220,170220,0,0,0,30,0.8333333333333334,0.18034795,3
2020-06-12-170220,170220,0,0,0,30,0.5,0.10557946,4
2020-06-13-170220,170220,0,0,0,30,0.3333333333333333,0.08961759,5
2020-06-14-170220,170220,0,0,0,30,0.0,0.002117966,6
2020-06-15-170220,170220,0,0,0,30,0.3333333333333333,0.1351526,0
2020-06-16-170220,170220,1,0,0,31,0.3333333333333333,0.13613492,1
2020-06-17-170220,170220,0,0,0,31,0.0,0.079095826,2
2020-06-18-170220,170220,0,0,0,31,0.8333333333333334,0.17885396,3
2020-06-19-170220,170220,0,0,0,31,0.0,0.0144950235,4
2020-06-20-170220,170220,0,0,0,31,0.0,0.020933215,5
2020-06-21-170220,170220,0,0,0,31,0.3333333333333333,0.0765493,6
2020-06-22-170220,170220,0,0,0,31,0.0,0.03270227,0
2020-06-23-170220,170220,0,0,0,31,0.0,0.10171094,1
2020-06-24-170220,170220,0,0,0,31,0.16666666666666666,0.17877206,2
2020-06-25-170220,170220,0,1,0,31,0.3333333333333333,0.05817359,3
2020-06-26-170220,170220,0,0,0,31,0.0,0.10420235,4
2020-06-27-170220,170220,0,0,0,31,0.16666666666666666,0.08042363,5
2020-06-28-170220,170220,0,0,0,31,0.0,0.000766874,6
2020-06-29-170220,170220,0,0,0,31,0.0,0.0093025165,0
2020-06-30-170220,170220,0,0,0,31,0.0,0.06059558,1
2020-07-01-170220,170220,0,0,0,31,0.0,0.015563394,2
2020-07-02-170220,170220,0,0,0,31,0.16666666666666666,0.031295057,3
2020-07-03-170220,170220,0,0,0,31,0.0,0.05943567,4
2020-07-04-170220,170220,0,0,0,31,0.0,0.0060458765,5
2020-07-05-170220,170220,0,0,0,31,0.16666666666666666,0.015202343,6
2020-07-06-170220,170220,0,0,0,31,0.0,0.03027462,0
2020-07-07-170220,170220,0,0,0,31,0.16666666666666666,0.092647955,1
2020-07-08-170220,170220,0,0,0,31,0.0,0.03176877,2
2020-07-09-170220,170220,0,0,0,31,0.3333333333333333,0.19890559,3
2020-07-10-170220,170220,0,0,0,31,0.0,0.020707903,4
2020-07-11-170220,170220,0,0,0,31,0.0,0.0010899673,5
2020-07-12-170220,170220,0,0,0,31,0.3333333333333333,0.26800314,6
2020-07-13-170220,170220,0,0,0,31,0.0,0.0019863239,0
2020-07-14-170220,170220,0,0,0,31,0.0,0.06153104,1
2020-07-15-170220,170220,0,1,0,31,0.0,0.07062654,2
2020-07-16-170220,170220,0,0,0,31,0.0,0.062400978,3
2020-07-17-170220,170220,0,0,0,31,0.0,0.0718444,4
2020-07-18-170220,170220,0,0,0,31,0.0,0.031231577,5
2020-07-19-170220,170220,0,0,0,31,0.16666666666666666,0.044457927,6
2020-07-20-170220,170220,0,0,0,31,0.0,0.039399825,0
2020-07-21-170220,170220,0,0,2,31,0.16666666666666666,0.017348763,1
2020-07-22-170220,170220,0,0,1,31,0.16666666666666666,0.012834816,2
2020-07-23-170220,170220,0,0,0,31,0.5,0.15397142,3
2020-07-24-170220,170220,0,0,1,31,0.3333333333333333,0.11509933,4
2020-07-25-170220,170220,0,0,4,31,0.0,0.018667312,5
2020-07-26-170220,170220,0,0,0,31,0.0,0.0037919704,6
2020-07-27-170220,170220,0,0,1,31,0.16666666666666666,0.23469418,0
2020-07-28-170220,170220,0,0,0,31,0.16666666666666666,0.07657778,1
2020-07-29-170220,170220,0,0,1,31,0.0,0.19112593,2
2020-07-30-170220,170220,0,0,1,31,0.0,0.26101947,3
2020-07-31-170220,170220,0,0,2,31,0.16666666666666666,0.32747048,4
2020-08-01-170220,170220,0,0,1,31,0.0,0.104377285,5
2020-08-02-170220,170220,0,0,3,31,0.16666666666666666,0.5227397,6
2020-08-03-170220,170220,0,0,1,31,0.0,0.15399884,0
2020-08-04-170220,170220,2,0,2,33,0.0,0.831551,1
2020-08-05-170220,170220,1,0,0,34,0.3333333333333333,0.76998794,2
2020-08-06-170220,170220,0,0,1,34,0.3333333333333333,0.2613533,3
2020-08-07-170220,170220,1,0,2,35,0.0,0.21965362,4
2020-08-08-170220,170220,4,0,0,39,0.0,0.5536024,5
2020-08-09-170220,170220,0,0,0,39,0.0,0.019657467,6
2020-08-10-170220,170220,1,0,4,40,0.3333333333333333,0.39417043,0
2020-08-11-170220,170220,0,0,0,40,0.8333333333333334,0.49055848,1
2020-08-12-170220,170220,1,0,0,41,0.3333333333333333,0.8612932,2
2020-08-13-170220,170220,1,0,3,42,1.1666666666666667,0.7643037,3
2020-08-14-170220,170220,2,0,1,44,0.6666666666666666,0.631272,4
2020-08-15-170220,170220,1,0,2,45,0.3333333333333333,0.46805006,5
2020-08-16-170220,170220,3,0,1,48,0.8333333333333334,0.65285635,6
2020-08-17-170220,170220,1,0,0,49,0.8333333333333334,0.36093372,0
2020-08-18-170220,170220,2,0,3,51,0.3333333333333333,0.7953231,1
2020-08-19-170220,170220,0,0,2,51,0.16666666666666666,0.33334443,2
2020-08-20-170220,170220,1,0,2,52,1.0,0.4010643,3
2020-08-21-170220,170220,2,0,2,54,2.1666666666666665,1.1692926,4
2020-08-22-170220,170220,0,0,1,54,1.5,0.62214756,5
2020-08-23-170220,170220,0,0,1,54,0.6666666666666666,0.34402195,6
2020-08-24-170220,170220,4,0,1,58,0.16666666666666666,0.76735157,0
2020-08-25-170220,170220,0,0,1,58,0.6666666666666666,0.8126585,1
2020-08-26-170220,170220,0,0,4,58,0.3333333333333333,0.24424525,2
2020-08-27-170220,170220,3,0,6,61,1.3333333333333333,0.7770964,3
2020-08-28-170220,170220,1,0,3,62,0.16666666666666666,0.72496456,4
2020-08-29-170220,170220,2,0,1,64,0.0,0.27702513,5
2020-08-30-170220,170220,1,0,0,65,1.3333333333333333,0.15735365,6
2020-08-31-170220,170220,0,0,3,65,0.3333333333333333,0.177237,0
2020-09-01-170220,170220,3,0,4,68,0.3333333333333333,0.8348557,1
2020-09-02-170220,170220,2,0,3,70,0.3333333333333333,0.537149,2
2020-09-03-170220,170220,2,0,0,72,1.1666666666666667,0.32472616,3
2020-09-04-170220,170220,2,0,2,74,1.3333333333333333,0.34240282,4
2020-09-05-170220,170220,1,0,0,75,0.3333333333333333,0.16267753,5
2020-09-06-170220,170220,1,0,0,76,1.0,0.14443487,6
2020-09-07-170220,170220,1,0,0,77,0.16666666666666666,0.29984275,0
2020-09-08-170220,170220,1,0,2,78,2.333333333333333,0.7250637,1
2020-09-09-170220,170220,4,0,4,82,1.5,0.65237665,2
2020-09-10-170220,170220,6,0,0,88,1.6666666666666667,0.7499346,3
2020-09-11-170220,170220,3,0,1,91,2.1666666666666665,0.7117129,4
2020-09-12-170220,170220,1,0,0,92,0.8333333333333334,0.55048203,5
2020-09-13-170220,170220,0,0,0,92,0.8333333333333334,0.21647222,6
2020-09-14-170220,170220,3,0,0,95,0.8333333333333334,0.40394664,0
2020-09-15-170220,170220,4,0,1,99,0.8333333333333334,1.3013223,1
2020-09-16-170220,170220,3,0,2,102,1.6666666666666667,0.7340868,2
2020-09-17-170220,170220,0,0,0,102,0.8333333333333334,0.39112148,3
2020-09-18-170220,170220,2,0,0,104,0.5,0.50500506,4
2020-09-19-170220,170220,0,0,2,104,0.0,0.02895782,5
2020-09-20-170220,170220,0,0,1,104,0.6666666666666666,0.25892475,6
2020-09-21-170220,170220,0,0,0,104,0.5,0.26034814,0
2020-09-22-170220,170220,2,1,1,106,0.0,0.28129262,1
2020-09-23-170220,170220,4,0,1,110,1.0,0.58976233,2
2020-09-24-170220,170220,0,1,2,110,1.0,0.24897237,3
2020-09-25-170220,170220,1,1,1,111,0.3333333333333333,0.4275706,4
2020-09-26-170220,170220,0,0,0,111,0.6666666666666666,0.22465913,5
2020-09-27-170220,170220,0,0,0,111,0.3333333333333333,0.14449653,6
2020-09-28-170220,170220,0,0,2,111,1.1666666666666667,0.34193635,0
2020-09-29-170220,170220,1,0,5,112,0.3333333333333333,0.35855252,1
2020-09-30-170220,170220,2,0,3,114,1.0,0.46624085,2
2020-10-01-170220,170220,0,0,1,114,1.1666666666666667,0.27489355,3
2020-10-02-170220,170220,0,0,5,114,2.0,0.37092578,4
2020-10-03-170220,170220,2,0,7,116,1.6666666666666667,0.36529085,5
2020-10-04-170220,170220,1,0,0,117,1.1666666666666667,0.26191866,6
2020-10-05-170220,170220,0,0,5,117,1.0,0.69510615,0
2020-10-06-170220,170220,1,0,10,118,2.0,0.820351,1
2020-10-07-170220,170220,1,0,4,119,0.5,0.80918056,2
2020-10-08-170220,170220,2,0,6,121,0.5,0.520892,3
2020-10-09-170220,170220,1,0,6,122,1.0,0.6218034,4
2020-10-10-170220,170220,0,0,3,122,1.3333333333333333,0.26947138,5
2020-10-11-170220,170220,0,0,3,122,1.0,0.4884532,6
2020-10-12-170220,170220,2,0,6,124,0.5,0.3615541,0
2020-10-13-170220,170220,5,0,2,129,0.5,0.7950107,1
2020-10-14-170220,170220,3,0,1,132,1.5,1.0448128,2
2020-10-15-170220,170220,1,0,3,133,1.0,1.0487908,3
2020-10-16-170220,170220,5,0,6,138,0.6666666666666666,1.4440029,4
2020-10-17-170220,170220,7,0,0,145,0.3333333333333333,0.6423641,5
2020-10-18-170220,170220,0,0,2,145,0.5,0.4459091,6
2020-10-19-170220,170220,5,0,2,150,1.1666666666666667,1.1429037,0
2020-10-20-170220,170220,10,0,6,160,1.0,1.0972652,1
2020-10-21-170220,170220,4,0,3,164,0.16666666666666666,1.1066478,2
2020-10-22-170220,170220,6,0,2,170,1.6666666666666667,1.3429549,3
2020-10-23-170220,170220,6,0,1,176,2.1666666666666665,0.99398834,4
2020-10-24-170220,170220,3,0,5,179,0.8333333333333334,0.64821464,5
2020-10-25-170220,170220,3,0,2,182,1.5,0.57926697,6
2020-10-26-170220,170220,6,0,2,188,0.5,1.3612119,0
2020-10-27-170220,170220,2,1,3,190,2.333333333333333,1.1996517,1
2020-10-28-170220,170220,1,0,0,191,1.3333333333333333,1.3297712,2
2020-10-29-170220,170220,3,1,2,194,2.1666666666666665,1.2520405,3
2020-10-30-170220,170220,6,1,4,200,3.333333333333333,1.6963407,4
2020-10-31-170220,170220,0,0,0,200,1.8333333333333333,0.82238674,5
2020-11-01-170220,170220,2,1,0,202,1.5,1.0092525,6
2020-11-02-170220,170220,2,0,0,204,0.8333333333333334,0.6161204,0
2020-11-03-170220,170220,6,0,0,210,1.6666666666666667,1.2518971,1
2020-11-04-170220,170220,3,0,0,213,0.6666666666666666,1.1160727,2
2020-11-05-170220,170220,2,0,0,215,2.5,1.1106452,3
2020-11-06-170220,170220,1,0,0,216,0.16666666666666666,1.0102025,4
2020-11-07-170220,170220,5,0,0,221,0.8333333333333334,0.5869437,5
2020-11-08-170220,170220,2,0,0,223,1.8333333333333333,1.0253363,6
2020-11-09-170220,170220,2,0,0,225,1.3333333333333333,1.4744965,0
2020-11-10-170220,170220,3,0,0,228,2.0,1.1284664,1
2020-11-11-170220,170220,0,0,0,228,0.3333333333333333,0.5477842,2
2020-11-12-170220,170220,2,0,0,230,1.5,1.5869184,3
2020-11-13-170220,170220,4,0,0,234,4.833333333333333,2.5356355,4
2020-03-01-170221,170221,0,0,2,0,0.0,4.7647565e-05,6
2020-03-02-170221,170221,0,0,14,0,0.25,0.022642685,0
2020-03-03-170221,170221,0,0,9,0,0.5,0.017673962,1
2020-03-04-170221,170221,0,0,10,0,0.0,0.021401888,2
2020-03-05-170221,170221,0,0,14,0,0.75,3.6996582e-05,3
2020-03-06-170221,170221,1,1,14,1,0.0,0.74270606,4
2020-03-07-170221,170221,7,0,6,8,0.5,4.833586,5
2020-03-08-170221,170221,1,0,8,9,1.75,0.6409047,6
2020-03-09-170221,170221,1,0,17,10,1.0,1.1827991,0
2020-03-10-170221,170221,14,0,21,24,3.0,10.397142,1
2020-03-11-170221,170221,1,0,17,25,0.75,0.9608204,2
2020-03-12-170221,170221,3,0,13,28,3.5,1.9790516,3
2020-03-13-170221,170221,5,0,12,33,2.25,2.9557133,4
2020-03-14-170221,170221,3,0,2,36,2.5,1.746493,5
2020-03-15-170221,170221,2,0,3,38,1.25,0.9416519,6
2020-03-16-170221,170221,14,0,18,52,3.75,5.908274,0
2020-03-17-170221,170221,9,0,14,61,4.75,4.7019887,1
2020-03-18-170221,170221,10,0,5,71,6.5,4.902804,2
2020-03-19-170221,170221,14,0,11,85,7.75,7.5190425,3
2020-03-20-170221,170221,14,1,11,99,10.0,7.7153425,4
2020-03-21-170221,170221,6,0,5,105,3.5,3.0999236,5
2020-03-22-170221,170221,8,0,1,113,2.0,3.027709,6
2020-03-23-170221,170221,17,0,11,130,14.25,10.47247,0
2020-03-24-170221,170221,21,0,10,151,12.75,12.175159,1
2020-03-25-170221,170221,17,0,8,168,9.25,9.450388,2
2020-03-26-170221,170221,13,0,10,181,8.75,6.688307,3
2020-03-27-170221,170221,12,0,5,193,9.25,6.684979,4
2020-03-28-170221,170221,2,0,2,195,4.75,1.5558577,5
2020-03-29-170221,170221,3,0,0,198,0.75,1.1533557,6
2020-03-30-170221,170221,18,0,5,216,10.0,9.047053,0
2020-03-31-170221,170221,14,0,6,230,6.5,6.7199855,1
2020-04-01-170221,170221,5,0,11,235,5.75,3.0175822,2
2020-04-02-170221,170221,11,0,13,246,6.75,6.431892,3
2020-04-03-170221,170221,11,0,9,257,5.25,6.783932,4
2020-04-04-170221,170221,5,0,2,262,0.75,2.0819626,5
2020-04-05-170221,170221,1,0,0,263,3.0,0.49387458,6
2020-04-06-170221,170221,11,0,5,274,4.75,5.118014,0
2020-04-07-170221,170221,10,0,8,284,4.5,4.9283385,1
2020-04-08-170221,170221,8,0,3,292,4.5,3.6533306,2
2020-04-09-170221,170221,10,0,2,302,4.75,5.0496306,3
2020-04-10-170221,170221,5,0,2,307,3.75,2.128044,4
2020-04-11-170221,170221,2,0,1,309,1.25,0.9210479,5
2020-04-12-170221,170221,0,0,1,309,0.25,0.002680962,6
2020-04-13-170221,170221,5,0,1,314,7.25,2.313925,0
2020-04-14-170221,170221,6,0,9,320,4.25,3.6540935,1
2020-04-15-170221,170221,11,0,4,331,4.5,5.5705204,2
2020-04-16-170221,170221,13,0,4,344,6.5,7.074135,3
2020-04-17-170221,170221,9,0,1,353,11.75,3.143665,4
2020-04-18-170221,170221,2,0,3,355,0.5,0.51980025,5
2020-04-19-170221,170221,0,0,1,355,0.75,0.1643876,6
2020-04-20-170221,170221,5,0,5,360,3.5,2.8710597,0
2020-04-21-170221,170221,8,0,7,368,3.25,3.895351,1
2020-04-22-170221,170221,3,0,7,371,4.0,1.9767239,2
2020-04-23-170221,170221,2,0,13,373,1.0,0.8078683,3
2020-04-24-170221,170221,2,0,1,375,3.25,1.2857877,4
2020-04-25-170221,170221,1,0,0,376,2.5,0.4255194,5
2020-04-26-170221,170221,1,0,0,377,0.75,0.5576617,6
2020-04-27-170221,170221,1,0,9,378,3.75,0.68278545,0
2020-04-28-170221,170221,9,0,6,387,3.0,4.5807714,1
2020-04-29-170221,170221,4,0,9,391,2.25,2.16815,2
2020-04-30-170221,170221,4,0,4,395,1.5,2.0142722,3
2020-05-01-170221,170221,1,0,4,396,0.5,0.49232224,4
2020-05-02-170221,170221,3,0,0,399,0.5,1.5193701,5
2020-05-03-170221,170221,1,0,0,400,0.0,0.48305395,6
2020-05-04-170221,170221,5,0,6,405,2.75,3.1309159,0
2020-05-05-170221,170221,7,0,2,412,1.5,4.954466,1
2020-05-06-170221,170221,7,0,3,419,1.5,3.7215962,2
2020-05-07-170221,170221,13,0,4,432,3.0,7.0736737,3
2020-05-08-170221,170221,1,0,3,433,2.5,0.7834941,4
2020-05-09-170221,170221,0,0,0,433,0.75,0.0029236511,5
2020-05-10-170221,170221,0,0,0,433,0.75,0.20359111,6
2020-05-11-170221,170221,9,0,4,442,2.0,4.538741,0
2020-05-12-170221,170221,6,0,5,448,2.0,2.8604872,1
2020-05-13-170221,170221,9,1,5,457,3.5,5.3299747,2
2020-05-14-170221,170221,4,0,1,461,3.25,2.6106987,3
2020-05-15-170221,170221,4,0,1,465,2.5,2.1485064,4
2020-05-16-170221,170221,0,0,0,465,0.5,0.0015106502,5
2020-05-17-170221,170221,0,0,0,465,0.25,0.00071325235,6
2020-05-18-170221,170221,6,0,6,471,4.75,3.806899,0
2020-05-19-170221,170221,2,0,2,473,1.5,1.7721729,1
2020-05-20-170221,170221,3,0,1,476,2.0,2.0146346,2
2020-05-21-170221,170221,4,0,5,480,1.0,2.6063435,3
2020-05-22-170221,170221,3,0,1,483,1.25,1.3948674,4
2020-05-23-170221,170221,0,0,0,483,0.0,0.0024854278,5
2020-05-24-170221,170221,0,0,0,483,0.25,6.3402666e-05,6
2020-05-25-170221,170221,4,0,1,487,2.25,3.6290238,0
2020-05-26-170221,170221,5,0,0,492,0.5,3.203995,1
2020-05-27-170221,170221,5,0,1,497,0.75,3.2364595,2
2020-05-28-170221,170221,1,3,1,498,0.5,0.71895176,3
2020-05-29-170221,170221,1,1,0,499,1.5,1.0653379,4
2020-05-30-170221,170221,0,1,0,499,0.25,0.00030662425,5
2020-05-31-170221,170221,0,0,0,499,0.0,0.0032197468,6
2020-06-01-170221,170221,6,0,0,505,1.75,4.1734905,0
2020-06-02-170221,170221,2,1,0,507,0.75,1.305667,1
2020-06-03-170221,170221,1,0,0,508,1.75,0.8981485,2
2020-06-04-170221,170221,5,0,0,513,0.5,3.3450966,3
2020-06-05-170221,170221,1,0,0,514,0.25,0.9319287,4
2020-06-06-170221,170221,0,0,0,514,0.25,0.016708422,5
2020-06-07-170221,170221,0,0,0,514,0.0,0.0026531045,6
2020-06-08-170221,170221,1,0,0,515,0.75,0.8792762,0
2020-06-09-170221,170221,0,0,0,515,0.0,0.0125518255,1
2020-06-10-170221,170221,1,0,0,516,1.0,1.3056808,2
2020-06-11-170221,170221,1,0,1,517,0.25,0.8355023,3
2020-06-12-170221,170221,0,0,2,517,1.25,0.5900407,4
2020-06-13-170221,170221,0,0,0,517,0.0,0.0014231269,5
2020-06-14-170221,170221,0,0,0,517,0.25,0.09016596,6
2020-06-15-170221,170221,0,0,0,517,0.0,0.0049559753,0
2020-06-16-170221,170221,0,0,1,517,1.0,0.29097673,1
2020-06-17-170221,170221,0,0,1,517,0.25,0.028548732,2
2020-06-18-170221,170221,0,0,0,517,0.5,0.22684082,3
2020-06-19-170221,170221,0,0,0,517,0.0,0.015260013,4
2020-06-20-170221,170221,0,0,0,517,0.0,0.002845507,5
2020-06-21-170221,170221,0,0,0,517,0.5,0.013752895,6
2020-06-22-170221,170221,0,0,1,517,0.0,0.011259228,0
2020-06-23-170221,170221,0,0,0,517,0.25,0.043989964,1
2020-06-24-170221,170221,0,0,1,517,0.25,0.13466963,2
2020-06-25-170221,170221,1,0,1,518,0.0,0.011580967,3
2020-06-26-170221,170221,2,1,0,520,0.0,1.3930254,4
2020-06-27-170221,170221,0,0,1,520,0.0,0.020192957,5
2020-06-28-170221,170221,0,0,0,520,0.0,0.00031875452,6
2020-06-29-170221,170221,0,0,0,520,0.0,0.6753651,0
2020-06-30-170221,170221,1,0,0,521,0.25,0.9484705,1
2020-07-01-170221,170221,1,0,0,522,0.5,1.1683186,2
2020-07-02-170221,170221,0,0,1,522,0.25,0.010801866,3
2020-07-03-170221,170221,0,0,0,522,1.25,0.93023443,4
2020-07-04-170221,170221,0,0,0,522,0.0,0.00039005646,5
2020-07-05-170221,170221,0,0,0,522,0.0,0.010254041,6
2020-07-06-170221,170221,1,0,0,523,0.25,0.70676726,0
2020-07-07-170221,170221,0,0,0,523,0.0,0.020707238,1
2020-07-08-170221,170221,1,1,0,524,0.75,0.5238718,2
2020-07-09-170221,170221,1,0,3,525,0.5,1.1551794,3
2020-07-10-170221,170221,0,0,3,525,0.5,0.23463912,4
2020-07-11-170221,170221,1,0,2,526,0.25,0.60684687,5
2020-07-12-170221,170221,0,0,4,526,0.0,0.013269336,6
2020-07-13-170221,170221,0,0,0,526,0.75,0.0032603687,0
2020-07-14-170221,170221,0,0,1,526,0.25,0.27796653,1
2020-07-15-170221,170221,0,0,2,526,0.25,0.033742607,2
2020-07-16-170221,170221,1,0,2,527,0.75,0.9031273,3
2020-07-17-170221,170221,0,0,3,527,0.25,0.016891537,4
2020-07-18-170221,170221,0,0,2,527,0.5,0.3138298,5
2020-07-19-170221,170221,0,0,1,527,0.25,0.036196806,6
2020-07-20-170221,170221,0,0,0,527,0.5,0.016222743,0
2020-07-21-170221,170221,0,0,2,527,0.0,0.028042154,1
2020-07-22-170221,170221,0,0,1,527,0.0,0.0044496367,2
2020-07-23-170221,170221,3,0,1,530,0.25,1.3277991,3
2020-07-24-170221,170221,3,0,0,533,0.5,1.3305355,4
2020-07-25-170221,170221,2,0,4,535,0.0,1.2007856,5
2020-07-26-170221,170221,4,0,0,539,0.0,2.1922045,6
2020-07-27-170221,170221,0,1,4,539,0.0,0.033273906,0
2020-07-28-170221,170221,1,0,5,540,0.25,0.9349878,1
2020-07-29-170221,170221,2,0,4,542,0.5,2.2038214,2
2020-07-30-170221,170221,2,0,5,544,0.5,0.7267143,3
2020-07-31-170221,170221,3,0,4,547,0.75,0.71099794,4
2020-08-01-170221,170221,2,0,3,549,0.75,1.2552494,5
2020-08-02-170221,170221,1,0,3,550,0.0,0.60069215,6
2020-08-03-170221,170221,0,0,13,550,1.0,0.95409423,0
2020-08-04-170221,170221,2,0,2,552,1.0,2.0647075,1
2020-08-05-170221,170221,1,0,8,553,3.25,1.6419133,2
2020-08-06-170221,170221,1,0,11,554,1.5,1.6652607,3
2020-08-07-170221,170221,0,1,5,554,2.5,0.13337727,4
2020-08-08-170221,170221,4,0,1,558,0.75,3.0368207,5
2020-08-09-170221,170221,0,0,2,558,0.5,0.2290531,6
2020-08-10-170221,170221,4,0,10,562,2.25,2.487893,0
2020-08-11-170221,170221,5,0,9,567,1.25,2.8405492,1
2020-08-12-170221,170221,4,0,8,571,4.75,2.5687304,2
2020-08-13-170221,170221,5,0,9,576,1.75,4.165934,3
2020-08-14-170221,170221,4,0,9,580,0.5,2.5717282,4
2020-08-15-170221,170221,3,0,0,583,0.5,1.9288985,5
2020-08-16-170221,170221,3,0,12,586,0.75,1.1345145,6
2020-08-17-170221,170221,13,0,0,599,4.75,8.192456,0
2020-08-18-170221,170221,2,0,7,601,4.75,1.7030208,1
2020-08-19-170221,170221,8,0,13,609,4.75,4.2704787,2
2020-08-20-170221,170221,11,0,7,620,1.25,4.4355702,3
2020-08-21-170221,170221,5,0,10,625,4.5,5.9728093,4
2020-08-22-170221,170221,1,0,5,626,1.0,0.13799857,5
2020-08-23-170221,170221,2,0,2,628,1.75,1.5969682,6
2020-08-24-170221,170221,10,0,22,638,5.0,6.162665,0
2020-08-25-170221,170221,9,0,4,647,1.75,6.2275057,1
2020-08-26-170221,170221,8,0,12,655,2.5,3.711357,2
2020-08-27-170221,170221,9,0,13,664,3.5,2.5959592,3
2020-08-28-170221,170221,9,0,19,673,1.75,6.9324303,4
2020-08-29-170221,170221,0,0,18,673,2.0,0.31466413,5
2020-08-30-170221,170221,12,0,12,685,2.0,5.4266987,6
2020-08-31-170221,170221,0,0,21,685,1.25,0.9378646,0
2020-09-01-170221,170221,7,0,34,692,3.25,3.4774125,1
2020-09-02-170221,170221,13,0,29,705,3.0,7.920197,2
2020-09-03-170221,170221,7,0,32,712,1.0,5.771084,3
2020-09-04-170221,170221,10,0,35,722,1.25,9.321093,4
2020-09-05-170221,170221,5,0,12,727,1.5,4.8904424,5
2020-09-06-170221,170221,2,0,11,729,0.75,1.5048338,6
2020-09-07-170221,170221,22,0,59,751,3.25,13.185599,0
2020-09-08-170221,170221,4,0,38,755,3.75,5.095121,1
2020-09-09-170221,170221,12,0,38,767,3.75,7.678743,2
2020-09-10-170221,170221,13,0,43,780,4.0,8.67401,3
2020-09-11-170221,170221,19,0,82,799,2.75,7.320894,4
2020-09-12-170221,170221,18,0,8,817,2.25,10.129897,5
2020-09-13-170221,170221,12,0,9,829,3.0,6.3498235,6
2020-09-14-170221,170221,21,0,44,850,4.75,9.375468,0
2020-09-15-170221,170221,34,0,25,884,9.5,17.34206,1
2020-09-16-170221,170221,29,0,27,913,11.75,14.007414,2
2020-09-17-170221,170221,32,0,56,945,12.0,9.918812,3
2020-09-18-170221,170221,35,0,34,980,10.25,22.336487,4
2020-09-19-170221,170221,12,0,10,992,2.25,4.454655,5
2020-09-20-170221,170221,11,0,15,1003,4.75,3.6649327,6
2020-09-21-170221,170221,59,1,19,1062,17.25,32.448452,0
2020-09-22-170221,170221,38,0,20,1100,13.0,18.659782,1
2020-09-23-170221,170221,38,1,20,1138,13.25,21.34165,2
2020-09-24-170221,170221,43,0,23,1181,10.0,20.36799,3
2020-09-25-170221,170221,82,3,11,1263,10.0,28.012754,4
2020-09-26-170221,170221,8,0,3,1271,3.5,6.065151,5
2020-09-27-170221,170221,9,0,2,1280,2.5,3.939655,6
2020-09-28-170221,170221,44,0,8,1324,9.25,26.92372,0
2020-09-29-170221,170221,25,0,28,1349,6.75,16.394161,1
2020-09-30-170221,170221,27,0,11,1376,7.25,12.590827,2
2020-10-01-170221,170221,56,0,9,1432,9.5,35.2523,3
2020-10-02-170221,170221,34,2,14,1466,8.25,15.610049,4
2020-10-03-170221,170221,10,0,3,1476,1.5,5.6869006,5
2020-10-04-170221,170221,15,1,1,1491,2.25,6.7809005,6
2020-10-05-170221,170221,19,0,15,1510,8.75,11.969902,0
2020-10-06-170221,170221,20,1,7,1530,9.0,12.803604,1
2020-10-07-170221,170221,20,0,13,1550,6.0,12.268999,2
2020-10-08-170221,170221,23,2,11,1573,8.25,12.676448,3
2020-10-09-170221,170221,11,0,20,1584,7.0,5.968442,4
2020-10-10-170221,170221,3,0,3,1587,2.25,1.9084471,5
2020-10-11-170221,170221,2,0,16,1589,0.25,1.0578843,6
2020-10-12-170221,170221,8,0,13,1597,2.0,3.694302,0
2020-10-13-170221,170221,28,0,12,1625,4.75,18.25313,1
2020-10-14-170221,170221,11,0,12,1636,8.5,7.500467,2
2020-10-15-170221,170221,9,0,10,1645,8.25,8.2936945,3
2020-10-16-170221,170221,14,0,10,1659,9.5,10.659654,4
2020-10-17-170221,170221,3,0,3,1662,2.0,1.9043751,5
2020-10-18-170221,170221,1,0,2,1663,2.0,0.23657016,6
2020-10-19-170221,170221,15,1,8,1678,8.5,10.495756,0
2020-10-20-170221,170221,7,0,16,1685,7.25,4.911962,1
2020-10-21-170221,170221,13,0,8,1698,7.5,9.167447,2
2020-10-22-170221,170221,11,0,5,1709,8.0,8.524922,3
2020-10-23-170221,170221,20,0,9,1729,4.5,8.725907,4
2020-10-24-170221,170221,3,0,5,1732,3.25,1.9148142,5
2020-10-25-170221,170221,16,0,1,1748,4.5,6.990909,6
2020-10-26-170221,170221,13,0,15,1761,5.0,8.385973,0
2020-10-27-170221,170221,12,1,15,1773,3.75,9.397464,1
2020-10-28-170221,170221,12,2,7,1785,7.25,9.960549,2
2020-10-29-170221,170221,10,0,10,1795,5.0,5.264851,3
2020-10-30-170221,170221,10,0,7,1805,4.25,8.997319,4
2020-10-31-170221,170221,3,0,0,1808,1.75,3.2002902,5
2020-11-01-170221,170221,2,0,0,1810,2.0,1.356638,6
2020-11-02-170221,170221,8,1,0,1818,1.75,4.2488756,0
2020-11-03-170221,170221,16,0,0,1834,4.75,10.945639,1
2020-11-04-170221,170221,8,0,0,1842,4.25,8.306796,2
2020-11-05-170221,170221,5,0,0,1847,2.75,2.6812086,3
2020-11-06-170221,170221,9,1,0,1856,5.0,5.9535427,4
2020-11-07-170221,170221,5,0,0,1861,2.25,3.3535507,5
2020-11-08-170221,170221,1,0,0,1862,0.75,0.8646973,6
2020-11-09-170221,170221,15,0,0,1877,2.5,10.469933,0
2020-11-10-170221,170221,15,0,0,1892,7.5,10.248213,1
2020-11-11-170221,170221,7,2,0,1899,3.25,6.113225,2
2020-11-12-170221,170221,10,0,0,1909,2.25,5.045182,3
2020-11-13-170221,170221,7,1,0,1916,5.0,4.405647,4
2020-03-01-170222,170222,0,0,3,0,0.0,1.7729002e-06,6
2020-03-02-170222,170222,0,0,9,0,0.0,0.0006485084,0
2020-03-03-170222,170222,0,0,9,0,0.0,0.00032613703,1
2020-03-04-170222,170222,0,0,12,0,0.0,0.00055874523,2
2020-03-05-170222,170222,3,0,12,3,0.0,1.3763595e-06,3
2020-03-06-170222,170222,0,0,26,3,1.0,0.02708488,4
2020-03-07-170222,170222,2,0,4,5,7.0,0.17786637,5
2020-03-08-170222,170222,7,0,6,12,1.0,0.02361036,6
2020-03-09-170222,170222,1,0,21,13,1.0,0.0393404,0
2020-03-10-170222,170222,12,0,27,25,14.0,0.38309532,1
2020-03-11-170222,170222,2,0,15,27,1.0,0.033136275,2
2020-03-12-170222,170222,12,0,18,39,3.0,0.07239158,3
2020-03-13-170222,170222,5,0,20,44,5.0,0.10290824,4
2020-03-14-170222,170222,3,0,6,47,3.0,0.06052001,5
2020-03-15-170222,170222,3,0,1,50,2.0,0.03267367,6
2020-03-16-170222,170222,9,0,18,59,14.0,0.21625735,0
2020-03-17-170222,170222,9,0,14,68,9.0,0.16666014,1
2020-03-18-170222,170222,12,1,12,80,10.0,0.17102547,2
2020-03-19-170222,170222,12,0,12,92,14.0,0.25566006,3
2020-03-20-170222,170222,26,2,5,118,14.0,0.26713753,4
2020-03-21-170222,170222,4,0,2,122,6.0,0.10386987,5
2020-03-22-170222,170222,6,0,6,128,8.0,0.10926341,6
2020-03-23-170222,170222,21,0,8,149,17.0,0.34684736,0
2020-03-24-170222,170222,27,0,8,176,21.0,0.40634984,1
2020-03-25-170222,170222,15,0,11,191,17.0,0.3125105,2
2020-03-26-170222,170222,18,0,6,209,13.0,0.22859181,3
2020-03-27-170222,170222,20,0,11,229,12.0,0.22570105,4
2020-03-28-170222,170222,6,0,3,235,2.0,0.04466057,5
2020-03-29-170222,170222,1,1,1,236,3.0,0.040703982,6
2020-03-30-170222,170222,18,0,22,254,18.0,0.30794132,0
2020-03-31-170222,170222,14,0,12,268,14.0,0.23058793,1
2020-04-01-170222,170222,12,0,14,280,5.0,0.09822832,2
2020-04-02-170222,170222,12,0,20,292,11.0,0.21368568,3
2020-04-03-170222,170222,5,0,43,297,11.0,0.22409575,4
2020-04-04-170222,170222,2,0,1,299,5.0,0.074841954,5
2020-04-05-170222,170222,6,0,1,305,1.0,0.01563443,6
2020-04-06-170222,170222,8,1,10,313,11.0,0.17036109,0
2020-04-07-170222,170222,8,0,9,321,10.0,0.16583517,1
2020-04-08-170222,170222,11,1,12,332,8.0,0.12813237,2
2020-04-09-170222,170222,6,0,4,338,10.0,0.16529141,3
2020-04-10-170222,170222,11,0,10,349,5.0,0.07405619,4
2020-04-11-170222,170222,3,0,8,352,2.0,0.032315683,5
2020-04-12-170222,170222,1,0,0,353,0.0,4.352963e-05,6
2020-04-13-170222,170222,22,0,13,375,5.0,0.072207876,0
2020-04-14-170222,170222,12,0,7,387,6.0,0.12820601,1
2020-04-15-170222,170222,14,0,5,401,11.0,0.19666144,2
2020-04-16-170222,170222,20,0,6,421,13.0,0.2504247,3
2020-04-17-170222,170222,43,0,0,464,9.0,0.11113396,4
2020-04-18-170222,170222,1,0,2,465,2.0,0.017374901,5
2020-04-19-170222,170222,1,0,0,466,0.0,0.0031891377,6
2020-04-20-170222,170222,10,0,9,476,5.0,0.09755924,0
2020-04-21-170222,170222,9,0,3,485,8.0,0.13893984,1
2020-04-22-170222,170222,12,0,4,497,3.0,0.065783724,2
2020-04-23-170222,170222,4,0,9,501,2.0,0.029662771,3
2020-04-24-170222,170222,10,0,8,511,2.0,0.04254038,4
2020-04-25-170222,170222,8,0,3,519,1.0,0.015486557,5
2020-04-26-170222,170222,0,0,1,519,1.0,0.018088946,6
2020-04-27-170222,170222,13,0,6,532,1.0,0.022559546,0
2020-04-28-170222,170222,7,0,5,539,9.0,0.16560523,1
2020-04-29-170222,170222,5,0,8,544,4.0,0.07621843,2
2020-04-30-170222,170222,6,0,8,550,4.0,0.07364071,3
2020-05-01-170222,170222,0,0,4,550,1.0,0.01676132,4
2020-05-02-170222,170222,2,0,2,552,3.0,0.05588501,5
2020-05-03-170222,170222,0,0,1,552,1.0,0.01780437,6
2020-05-04-170222,170222,9,0,16,561,5.0,0.10967919,0
2020-05-05-170222,170222,3,0,6,564,7.0,0.17576586,1
2020-05-06-170222,170222,4,0,7,568,7.0,0.13178957,2
2020-05-07-170222,170222,9,0,1,577,13.0,0.25876015,3
2020-05-08-170222,170222,8,0,2,585,1.0,0.025886081,4
2020-05-09-170222,170222,3,0,0,588,0.0,5.8207985e-05,5
2020-05-10-170222,170222,1,0,1,589,0.0,0.004089423,6
2020-05-11-170222,170222,6,1,4,595,9.0,0.16428627,0
2020-05-12-170222,170222,5,0,2,600,6.0,0.10233576,1
2020-05-13-170222,170222,8,0,3,608,9.0,0.19017014,2
2020-05-14-170222,170222,8,0,2,616,4.0,0.08995885,3
2020-05-15-170222,170222,4,0,1,620,4.0,0.07340743,4
2020-05-16-170222,170222,2,0,1,622,0.0,5.6211633e-05,5
2020-05-17-170222,170222,1,0,0,623,0.0,5.0728652e-09,6
2020-05-18-170222,170222,16,0,4,639,6.0,0.13420227,0
2020-05-19-170222,170222,6,0,3,645,2.0,0.064633936,1
2020-05-20-170222,170222,7,1,3,652,3.0,0.07138663,2
2020-05-21-170222,170222,1,0,1,653,4.0,0.09256061,3
2020-05-22-170222,170222,2,0,0,655,3.0,0.04816907,4
2020-05-23-170222,170222,0,0,1,655,0.0,4.9963564e-05,5
2020-05-24-170222,170222,1,0,0,656,0.0,6.88523e-07,6
2020-05-25-170222,170222,4,0,2,660,4.0,0.12763925,0
2020-05-26-170222,170222,2,0,0,662,5.0,0.117202125,1
2020-05-27-170222,170222,3,0,0,665,5.0,0.118313335,2
2020-05-28-170222,170222,2,0,0,667,1.0,0.025326952,3
2020-05-29-170222,170222,1,0,0,668,1.0,0.034720264,4
2020-05-30-170222,170222,1,0,0,669,0.0,1.04449e-05,5
2020-05-31-170222,170222,0,0,0,669,0.0,7.440349e-05,6
2020-06-01-170222,170222,4,0,0,673,6.0,0.14857952,0
2020-06-02-170222,170222,3,0,2,676,2.0,0.047396716,1
2020-06-03-170222,170222,3,0,1,679,1.0,0.029669981,2
2020-06-04-170222,170222,1,0,1,680,5.0,0.120159164,3
2020-06-05-170222,170222,0,0,0,680,1.0,0.031472832,4
2020-06-06-170222,170222,1,0,0,681,0.0,0.00045366972,5
2020-06-07-170222,170222,0,0,1,681,0.0,6.260244e-05,6
2020-06-08-170222,170222,2,0,0,683,1.0,0.02974666,0
2020-06-09-170222,170222,0,0,1,683,0.0,0.00037258424,1
2020-06-10-170222,170222,0,0,0,683,1.0,0.04173727,2
2020-06-11-170222,170222,0,0,0,683,1.0,0.028304018,3
2020-06-12-170222,170222,0,0,0,683,0.0,0.014686561,4
2020-06-13-170222,170222,0,0,0,683,0.0,3.4215027e-05,5
2020-06-14-170222,170222,0,0,0,683,0.0,0.002625419,6
2020-06-15-170222,170222,0,0,0,683,0.0,0.00010374287,0
2020-06-16-170222,170222,2,0,0,685,0.0,0.0077731516,1
2020-06-17-170222,170222,1,0,0,686,0.0,0.0007296605,2
2020-06-18-170222,170222,1,0,1,687,0.0,0.0058604507,3
2020-06-19-170222,170222,0,0,1,687,0.0,0.0004379899,4
2020-06-20-170222,170222,0,0,0,687,0.0,5.462267e-05,5
2020-06-21-170222,170222,1,0,0,688,0.0,0.00018462347,6
2020-06-22-170222,170222,0,0,0,688,0.0,0.0003090282,0
2020-06-23-170222,170222,1,0,0,689,0.0,0.0011646874,1
2020-06-24-170222,170222,0,0,1,689,0.0,0.0039252406,2
2020-06-25-170222,170222,0,0,0,689,1.0,0.00036187394,3
2020-06-26-170222,170222,0,0,1,689,2.0,0.050749276,4
2020-06-27-170222,170222,0,0,1,689,0.0,0.00039920336,5
2020-06-28-170222,170222,0,0,0,689,0.0,1.1860716e-05,6
2020-06-29-170222,170222,0,0,3,689,0.0,0.024759276,0
2020-06-30-170222,170222,0,0,0,689,1.0,0.03156393,1
2020-07-01-170222,170222,0,0,1,689,1.0,0.03658462,2
2020-07-02-170222,170222,1,0,3,690,0.0,0.00024295245,3
2020-07-03-170222,170222,1,0,0,691,0.0,0.021441469,4
2020-07-04-170222,170222,0,0,1,691,0.0,1.4339832e-05,5
2020-07-05-170222,170222,0,0,1,691,0.0,0.00021347243,6
2020-07-06-170222,170222,0,0,1,691,1.0,0.024961667,0
2020-07-07-170222,170222,0,0,0,691,0.0,0.00048547133,1
2020-07-08-170222,170222,1,0,0,692,1.0,0.012467788,2
2020-07-09-170222,170222,0,0,1,692,1.0,0.0358092,3
2020-07-10-170222,170222,1,0,2,693,0.0,0.005284807,4
2020-07-11-170222,170222,1,0,0,694,1.0,0.022192255,5
2020-07-12-170222,170222,0,2,0,694,0.0,0.00037936892,6
2020-07-13-170222,170222,3,0,0,697,0.0,6.747794e-05,0
2020-07-14-170222,170222,0,0,0,697,0.0,0.0068334052,1
2020-07-15-170222,170222,1,0,1,698,0.0,0.00064825907,2
2020-07-16-170222,170222,3,0,1,701,1.0,0.029316692,3
2020-07-17-170222,170222,0,0,2,701,0.0,0.00047175807,4
2020-07-18-170222,170222,1,0,3,702,0.0,0.0062937276,5
2020-07-19-170222,170222,1,0,0,703,0.0,0.00041890593,6
2020-07-20-170222,170222,1,0,0,704,0.0,0.0003530905,0
2020-07-21-170222,170222,0,0,3,704,0.0,0.00027691742,1
2020-07-22-170222,170222,0,0,1,704,0.0,8.3472645e-05,2
2020-07-23-170222,170222,1,0,0,705,3.0,0.04824264,3
2020-07-24-170222,170222,2,0,0,707,3.0,0.048658017,4
2020-07-25-170222,170222,0,0,1,707,2.0,0.04366702,5
2020-07-26-170222,170222,0,1,0,707,4.0,0.07994855,6
2020-07-27-170222,170222,0,0,7,707,0.0,0.0007393245,0
2020-07-28-170222,170222,0,0,0,707,1.0,0.029585961,1
2020-07-29-170222,170222,1,0,14,708,2.0,0.07582579,2
2020-07-30-170222,170222,1,0,3,709,2.0,0.025423849,3
2020-07-31-170222,170222,2,0,2,711,3.0,0.025293468,4
2020-08-01-170222,170222,3,0,0,714,2.0,0.045496985,5
2020-08-02-170222,170222,0,0,2,714,1.0,0.02008944,6
2020-08-03-170222,170222,0,0,13,714,0.0,0.029481225,0
2020-08-04-170222,170222,3,0,5,717,2.0,0.07091083,1
2020-08-05-170222,170222,1,0,12,718,1.0,0.044877723,2
2020-08-06-170222,170222,0,0,5,718,1.0,0.045315083,3
2020-08-07-170222,170222,0,0,9,718,0.0,0.0025672796,4
2020-08-08-170222,170222,1,0,2,719,4.0,0.104325525,5
2020-08-09-170222,170222,0,0,4,719,0.0,0.004229919,6
2020-08-10-170222,170222,7,0,16,726,4.0,0.08001026,0
2020-08-11-170222,170222,0,0,4,726,5.0,0.095913924,1
2020-08-12-170222,170222,14,0,10,740,4.0,0.08994261,2
2020-08-13-170222,170222,3,0,12,743,5.0,0.1435848,3
2020-08-14-170222,170222,2,0,5,745,4.0,0.09263943,4
2020-08-15-170222,170222,0,0,7,745,3.0,0.06402552,5
2020-08-16-170222,170222,2,0,8,747,3.0,0.03894909,6
2020-08-17-170222,170222,13,0,1,760,13.0,0.29336867,0
2020-08-18-170222,170222,5,0,12,765,2.0,0.03558592,1
2020-08-19-170222,170222,12,0,7,777,8.0,0.13647258,2
2020-08-20-170222,170222,5,0,3,782,11.0,0.15818144,3
2020-08-21-170222,170222,9,0,4,791,5.0,0.19253014,4
2020-08-22-170222,170222,2,0,1,793,1.0,0.002019777,5
2020-08-23-170222,170222,4,0,1,797,2.0,0.05722541,6
2020-08-24-170222,170222,16,0,10,813,10.0,0.20641728,0
2020-08-25-170222,170222,4,0,10,817,9.0,0.22125834,1
2020-08-26-170222,170222,10,0,10,827,8.0,0.13419974,2
2020-08-27-170222,170222,12,0,14,839,9.0,0.08377,3
2020-08-28-170222,170222,5,0,9,844,9.0,0.24450393,4
2020-08-29-170222,170222,7,0,8,851,0.0,0.0062159733,5
2020-08-30-170222,170222,8,0,12,859,12.0,0.19799387,6
2020-08-31-170222,170222,1,1,19,860,0.0,0.020966046,0
2020-09-01-170222,170222,12,0,29,872,7.0,0.124022625,1
2020-09-02-170222,170222,7,0,46,879,13.0,0.28260788,2
2020-09-03-170222,170222,3,0,44,882,7.0,0.20447814,3
2020-09-04-170222,170222,4,1,36,886,10.0,0.33778772,4
2020-09-05-170222,170222,1,0,9,887,5.0,0.15748051,5
2020-09-06-170222,170222,1,0,17,888,2.0,0.0486969,6
2020-09-07-170222,170222,10,0,62,898,22.0,0.4837407,0
2020-09-08-170222,170222,10,0,46,908,4.0,0.17306623,1
2020-09-09-170222,170222,10,0,47,918,12.0,0.27393427,2
2020-09-10-170222,170222,14,0,36,932,13.0,0.31307125,3
2020-09-11-170222,170222,9,0,33,941,19.0,0.26264724,4
2020-09-12-170222,170222,8,0,9,949,18.0,0.36353377,5
2020-09-13-170222,170222,12,1,10,961,12.0,0.232088,6
2020-09-14-170222,170222,19,0,35,980,21.0,0.3432706,0
2020-09-15-170222,170222,29,0,24,1009,34.0,0.62930053,1
2020-09-16-170222,170222,46,0,23,1055,29.0,0.5101115,2
2020-09-17-170222,170222,44,1,36,1099,32.0,0.35768604,3
2020-09-18-170222,170222,36,1,28,1135,35.0,0.808238,4
2020-09-19-170222,170222,9,1,6,1144,12.0,0.16335708,5
2020-09-20-170222,170222,17,0,8,1161,11.0,0.1313557,6
2020-09-21-170222,170222,62,0,31,1223,59.0,1.1878555,0
2020-09-22-170222,170222,46,0,31,1269,38.0,0.6774945,1
2020-09-23-170222,170222,47,0,19,1316,38.0,0.7810994,2
2020-09-24-170222,170222,36,0,30,1352,43.0,0.74505955,3
2020-09-25-170222,170222,33,3,26,1385,82.0,1.0267938,4
2020-09-26-170222,170222,9,0,8,1394,8.0,0.20760237,5
2020-09-27-170222,170222,10,0,1,1404,9.0,0.14195569,6
2020-09-28-170222,170222,35,0,4,1439,44.0,0.9862762,0
2020-09-29-170222,170222,24,0,14,1463,25.0,0.5987827,1
2020-09-30-170222,170222,23,1,23,1486,27.0,0.4541945,2
2020-10-01-170222,170222,36,1,18,1522,56.0,1.2909662,3
2020-10-02-170222,170222,28,0,22,1550,34.0,0.5671802,4
2020-10-03-170222,170222,6,1,5,1556,10.0,0.2091176,5
2020-10-04-170222,170222,8,4,4,1564,15.0,0.24703535,6
2020-10-05-170222,170222,31,1,20,1595,19.0,0.43330383,0
2020-10-06-170222,170222,31,0,18,1626,20.0,0.45972112,1
2020-10-07-170222,170222,19,4,15,1645,20.0,0.43726864,2
2020-10-08-170222,170222,30,0,18,1675,23.0,0.4558477,3
2020-10-09-170222,170222,26,0,11,1701,11.0,0.21673353,4
2020-10-10-170222,170222,8,0,1,1709,3.0,0.06879137,5
2020-10-11-170222,170222,1,0,6,1710,2.0,0.038327344,6
2020-10-12-170222,170222,4,0,17,1714,8.0,0.13501383,0
2020-10-13-170222,170222,14,0,5,1728,28.0,0.6652381,1
2020-10-14-170222,170222,23,0,19,1751,11.0,0.2614756,2
2020-10-15-170222,170222,18,0,12,1769,9.0,0.2845839,3
2020-10-16-170222,170222,22,0,10,1791,14.0,0.3817338,4
2020-10-17-170222,170222,5,0,0,1796,3.0,0.06793195,5
2020-10-18-170222,170222,4,2,5,1800,1.0,0.0045938175,6
2020-10-19-170222,170222,20,0,7,1820,15.0,0.37772375,0
2020-10-20-170222,170222,18,1,15,1838,7.0,0.17240451,1
2020-10-21-170222,170222,15,2,11,1853,13.0,0.3225295,2
2020-10-22-170222,170222,18,0,10,1871,11.0,0.29492834,3
2020-10-23-170222,170222,11,2,15,1882,20.0,0.3149073,4
2020-10-24-170222,170222,1,1,6,1883,3.0,0.0681975,5
2020-10-25-170222,170222,6,1,1,1889,16.0,0.25165686,6
2020-10-26-170222,170222,17,0,7,1906,13.0,0.30377585,0
2020-10-27-170222,170222,5,0,25,1911,12.0,0.3307329,1
2020-10-28-170222,170222,19,2,7,1930,12.0,0.34156203,2
2020-10-29-170222,170222,12,2,7,1942,10.0,0.17632768,3
2020-10-30-170222,170222,10,0,15,1952,10.0,0.3144177,4
2020-10-31-170222,170222,0,1,0,1952,3.0,0.102642946,5
2020-11-01-170222,170222,5,4,0,1957,2.0,0.045955222,6
2020-11-02-170222,170222,7,2,0,1964,8.0,0.15416126,0
2020-11-03-170222,170222,15,1,0,1979,16.0,0.3931423,1
2020-11-04-170222,170222,11,2,0,1990,8.0,0.29256582,2
2020-11-05-170222,170222,10,1,0,2000,5.0,0.09088075,3
2020-11-06-170222,170222,15,3,0,2015,9.0,0.20998621,4
2020-11-07-170222,170222,6,3,0,2021,5.0,0.11673378,5
2020-11-08-170222,170222,1,1,0,2022,1.0,0.026933102,6
2020-11-09-170222,170222,7,0,0,2029,15.0,0.38065702,0
2020-11-10-170222,170222,25,4,0,2054,15.0,0.36389783,1
2020-11-11-170222,170222,7,2,0,2061,7.0,0.21140777,2
2020-11-12-170222,170222,7,1,0,2068,10.0,0.17830588,3
2020-11-13-170222,170222,15,0,0,2083,7.0,0.14834142,4
2020-03-01-170223,170223,0,0,0,0,0.0,0.00013959178,6
2020-03-02-170223,170223,0,0,0,0,0.0,0.0011682622,0
2020-03-03-170223,170223,0,0,2,0,0.0,0.0072059855,1
2020-03-04-170223,170223,0,0,0,0,0.0,0.01665134,2
2020-03-05-170223,170223,0,0,1,0,0.0,9.00004e-07,3
2020-03-06-170223,170223,0,0,0,0,0.0,0.016571328,4
2020-03-07-170223,170223,0,0,1,0,0.0,0.0004133966,5
2020-03-08-170223,170223,0,0,1,0,0.0,0.004599109,6
2020-03-09-170223,170223,0,0,0,0,0.4,0.17280899,0
2020-03-10-170223,170223,0,0,2,0,0.4,0.120558396,1
2020-03-11-170223,170223,0,0,1,0,0.2,0.08508936,2
2020-03-12-170223,170223,0,0,2,0,0.2,0.08046066,3
2020-03-13-170223,170223,1,0,1,1,1.2,0.52796453,4
2020-03-14-170223,170223,0,0,0,1,1.4,0.3287393,5
2020-03-15-170223,170223,0,0,0,1,1.0,0.21196024,6
2020-03-16-170223,170223,0,0,0,1,1.8,0.5734762,0
2020-03-17-170223,170223,2,0,1,3,2.8,1.0910294,1
2020-03-18-170223,170223,0,0,0,3,2.0,0.21123032,2
2020-03-19-170223,170223,1,0,0,4,4.6,1.4076262,3
2020-03-20-170223,170223,0,0,0,4,3.8,1.1939272,4
2020-03-21-170223,170223,1,0,1,5,2.4,0.90863425,5
2020-03-22-170223,170223,1,0,1,6,2.4,0.70999455,6
2020-03-23-170223,170223,0,0,0,6,6.2,2.1741133,0
2020-03-24-170223,170223,2,0,1,8,4.2,1.8985467,1
2020-03-25-170223,170223,1,0,0,9,3.0,1.4788198,2
2020-03-26-170223,170223,2,0,1,11,2.2,1.1187552,3
2020-03-27-170223,170223,1,0,0,12,5.0,1.4657437,4
2020-03-28-170223,170223,0,0,0,12,1.0,0.3094406,5
2020-03-29-170223,170223,0,0,0,12,2.0,0.34051943,6
2020-03-30-170223,170223,0,0,1,12,5.2,1.3446215,0
2020-03-31-170223,170223,1,0,1,13,2.8,0.82281435,1
2020-04-01-170223,170223,0,0,0,13,3.0,0.8313096,2
2020-04-02-170223,170223,0,0,2,13,3.6,0.91177815,3
2020-04-03-170223,170223,0,0,1,13,3.0,0.9275177,4
2020-04-04-170223,170223,1,0,0,14,0.4,0.21306887,5
2020-04-05-170223,170223,1,0,0,15,1.6,0.21600403,6
2020-04-06-170223,170223,0,0,2,15,2.0,0.67408377,0
2020-04-07-170223,170223,1,0,1,16,1.8,0.6169706,1
2020-04-08-170223,170223,0,0,0,16,3.2,0.92372483,2
2020-04-09-170223,170223,1,0,0,17,7.2,1.525973,3
2020-04-10-170223,170223,0,0,0,17,3.2,0.6641806,4
2020-04-11-170223,170223,0,0,0,17,1.6,0.35449085,5
2020-04-12-170223,170223,0,0,0,17,2.0,0.591889,6
2020-04-13-170223,170223,1,0,0,18,2.8,0.3165757,0
2020-04-14-170223,170223,1,0,0,19,2.0,0.17222986,1
2020-04-15-170223,170223,0,0,0,19,5.0,1.292721,2
2020-04-16-170223,170223,2,0,0,21,2.2,0.7186137,3
2020-04-17-170223,170223,1,0,0,22,2.0,0.89244574,4
2020-04-18-170223,170223,0,0,0,22,0.0,0.013878099,5
2020-04-19-170223,170223,0,0,1,22,1.8,0.329521,6
2020-04-20-170223,170223,2,0,0,24,1.8,0.8403532,0
2020-04-21-170223,170223,1,1,0,25,1.8,0.65104693,1
2020-04-22-170223,170223,0,0,0,25,0.8,0.21870576,2
2020-04-23-170223,170223,0,0,0,25,0.6,0.15701135,3
2020-04-24-170223,170223,0,0,0,25,0.6,0.23300877,4
2020-04-25-170223,170223,0,0,0,25,0.0,0.014332961,5
2020-04-26-170223,170223,0,0,0,25,0.2,0.04172841,6
2020-04-27-170223,170223,0,0,0,25,1.2,0.21723196,0
2020-04-28-170223,170223,0,0,0,25,1.0,0.31383443,1
2020-04-29-170223,170223,0,0,1,25,1.4,0.41779706,2
2020-04-30-170223,170223,0,0,0,25,0.6,0.3404848,3
2020-05-01-170223,170223,0,0,0,25,0.0,0.0142722735,4
2020-05-02-170223,170223,0,0,0,25,0.4,0.10372599,5
2020-05-03-170223,170223,1,0,0,26,0.4,0.15599543,6
2020-05-04-170223,170223,0,0,1,26,0.6,0.21427943,0
2020-05-05-170223,170223,0,0,0,26,1.4,0.42437673,1
2020-05-06-170223,170223,0,0,1,26,0.8,0.32120892,2
2020-05-07-170223,170223,0,0,0,26,0.8,0.38348928,3
2020-05-08-170223,170223,0,0,0,26,1.2,0.10812616,4
2020-05-09-170223,170223,0,0,0,26,0.2,0.02525018,5
2020-05-10-170223,170223,0,0,0,26,0.2,0.043361563,6
2020-05-11-170223,170223,0,0,0,26,0.8,0.35059172,0
2020-05-12-170223,170223,0,0,0,26,0.6,0.18310297,1
2020-05-13-170223,170223,1,0,0,27,1.2,0.4714292,2
2020-05-14-170223,170223,0,0,1,27,1.6,0.60265726,3
2020-05-15-170223,170223,0,0,2,27,0.8,0.2644056,4
2020-05-16-170223,170223,0,0,0,27,0.0,0.00056508754,5
2020-05-17-170223,170223,0,0,0,27,0.4,0.09323394,6
2020-05-18-170223,170223,1,0,0,28,1.6,0.14344768,0
2020-05-19-170223,170223,0,0,1,28,1.2,0.11911803,1
2020-05-20-170223,170223,1,0,0,29,0.8,0.538794,2
2020-05-21-170223,170223,0,0,0,29,0.8,0.17634712,3
2020-05-22-170223,170223,0,0,0,29,1.2,0.14833732,4
2020-05-23-170223,170223,0,0,0,29,0.0,0.0027499858,5
2020-05-24-170223,170223,0,0,0,29,0.0,1.8811957e-06,6
2020-05-25-170223,170223,0,0,0,29,0.6,0.078629225,0
2020-05-26-170223,170223,0,0,0,29,0.8,0.07864182,1
2020-05-27-170223,170223,0,0,1,29,0.6,0.28737527,2
2020-05-28-170223,170223,1,0,1,30,0.4,0.27905437,3
2020-05-29-170223,170223,2,0,0,32,0.6,0.37427726,4
2020-05-30-170223,170223,0,0,1,32,0.0,0.001431674,5
2020-05-31-170223,170223,0,0,0,32,0.0,0.0113523,6
2020-06-01-170223,170223,0,0,0,32,0.0,0.022911716,0
2020-06-02-170223,170223,1,0,2,33,1.2,0.20165241,1
2020-06-03-170223,170223,0,0,0,33,0.6,0.23217148,2
2020-06-04-170223,170223,0,0,1,33,0.8,0.32577816,3
2020-06-05-170223,170223,0,0,0,33,0.6,0.21225706,4
2020-06-06-170223,170223,0,0,0,33,0.4,0.19864422,5
2020-06-07-170223,170223,0,0,0,33,0.0,6.819538e-05,6
2020-06-08-170223,170223,0,0,0,33,0.2,0.03715771,0
2020-06-09-170223,170223,0,0,0,33,0.4,0.029972384,1
2020-06-10-170223,170223,1,1,0,34,0.0,0.12910207,2
2020-06-11-170223,170223,1,0,0,35,0.4,0.12983711,3
2020-06-12-170223,170223,0,0,0,35,0.6,0.15163028,4
2020-06-13-170223,170223,1,0,0,36,0.0,0.1324255,5
2020-06-14-170223,170223,0,0,0,36,0.2,0.0007030446,6
2020-06-15-170223,170223,0,0,0,36,0.2,0.053414613,0
2020-06-16-170223,170223,2,0,0,38,0.6,0.078643456,1
2020-06-17-170223,170223,0,0,0,38,0.2,0.09059401,2
2020-06-18-170223,170223,1,0,0,39,1.6,0.24679166,3
2020-06-19-170223,170223,0,0,0,39,0.0,0.043402337,4
2020-06-20-170223,170223,0,0,0,39,0.2,0.13273107,5
2020-06-21-170223,170223,0,0,0,39,0.2,0.037301622,6
2020-06-22-170223,170223,0,0,0,39,0.2,0.020861788,0
2020-06-23-170223,170223,0,0,0,39,0.2,0.060595423,1
2020-06-24-170223,170223,0,0,0,39,1.0,0.34750652,2
2020-06-25-170223,170223,0,0,1,39,0.2,0.06960242,3
2020-06-26-170223,170223,0,2,0,39,0.6,0.22784701,4
2020-06-27-170223,170223,0,1,0,39,0.2,0.03903591,5
2020-06-28-170223,170223,0,0,0,39,0.0,0.00060987653,6
2020-06-29-170223,170223,0,0,0,39,0.0,0.003939887,0
2020-06-30-170223,170223,0,0,0,39,0.2,0.031426273,1
2020-07-01-170223,170223,0,0,0,39,0.2,0.023024717,2
2020-07-02-170223,170223,0,0,0,39,0.2,0.11822814,3
2020-07-03-170223,170223,0,0,0,39,0.0,0.03744618,4
2020-07-04-170223,170223,0,0,0,39,0.0,0.0012748723,5
2020-07-05-170223,170223,0,0,0,39,0.0,0.0038209765,6
2020-07-06-170223,170223,0,0,0,39,0.2,0.012005322,0
2020-07-07-170223,170223,0,0,0,39,0.6,0.056508247,1
2020-07-08-170223,170223,0,0,0,39,0.0,0.028740438,2
2020-07-09-170223,170223,1,0,1,40,0.2,0.20031707,3
2020-07-10-170223,170223,0,0,0,40,0.0,0.036231812,4
2020-07-11-170223,170223,0,0,0,40,0.0,0.00040394554,5
2020-07-12-170223,170223,0,0,0,40,0.8,0.26219958,6
2020-07-13-170223,170223,0,0,0,40,0.2,0.00055379316,0
2020-07-14-170223,170223,0,0,0,40,0.6,0.036748905,1
2020-07-15-170223,170223,0,0,0,40,0.2,0.15944852,2
2020-07-16-170223,170223,0,0,0,40,0.2,0.16755353,3
2020-07-17-170223,170223,0,0,0,40,0.2,0.09099876,4
2020-07-18-170223,170223,0,0,0,40,0.0,0.023211474,5
2020-07-19-170223,170223,0,0,1,40,0.2,0.14210485,6
2020-07-20-170223,170223,0,0,0,40,0.0,0.025636347,0
2020-07-21-170223,170223,0,0,0,40,0.2,0.012185022,1
2020-07-22-170223,170223,0,0,0,40,0.0,0.021584934,2
2020-07-23-170223,170223,1,0,0,41,0.0,0.19082366,3
2020-07-24-170223,170223,0,0,0,41,0.2,0.0680786,4
2020-07-25-170223,170223,0,0,0,41,0.0,0.012910397,5
2020-07-26-170223,170223,0,0,0,41,0.0,0.0028217735,6
2020-07-27-170223,170223,0,0,0,41,0.6,0.14586292,0
2020-07-28-170223,170223,0,0,0,41,0.4,0.046094522,1
2020-07-29-170223,170223,0,0,0,41,1.0,0.33870766,2
2020-07-30-170223,170223,0,0,1,41,0.6,0.3433687,3
2020-07-31-170223,170223,0,0,0,41,1.2,0.40758315,4
2020-08-01-170223,170223,0,0,0,41,0.6,0.1765938,5
2020-08-02-170223,170223,1,0,0,42,0.6,0.88011324,6
2020-08-03-170223,170223,0,0,0,42,0.6,0.09816983,0
2020-08-04-170223,170223,0,0,1,42,3.2,0.5331112,1
2020-08-05-170223,170223,0,0,0,42,2.2,1.2110196,2
2020-08-06-170223,170223,0,0,2,42,1.0,0.66524327,3
2020-08-07-170223,170223,0,0,1,42,0.6,0.273884,4
2020-08-08-170223,170223,0,0,0,42,1.8,0.68249077,5
2020-08-09-170223,170223,0,0,1,42,0.0,0.076023385,6
2020-08-10-170223,170223,0,0,0,42,0.8,0.18697552,0
2020-08-11-170223,170223,0,0,0,42,1.6,0.29892963,1
2020-08-12-170223,170223,0,0,0,42,3.0,1.612919,2
2020-08-13-170223,170223,1,0,2,43,2.6,1.279392,3
2020-08-14-170223,170223,0,0,0,43,2.2,1.1334171,4
2020-08-15-170223,170223,0,0,0,43,2.0,1.2021583,5
2020-08-16-170223,170223,0,0,0,43,2.6,1.223389,6
2020-08-17-170223,170223,0,0,0,43,2.2,0.2140869,0
2020-08-18-170223,170223,1,0,0,44,3.6,0.4696542,1
2020-08-19-170223,170223,0,0,2,44,1.4,0.9088557,2
2020-08-20-170223,170223,2,0,4,46,1.2,1.0758406,3
2020-08-21-170223,170223,1,0,0,47,3.8,2.2261043,4
2020-08-22-170223,170223,0,0,0,47,1.4,0.9007589,5
2020-08-23-170223,170223,1,0,0,48,2.2,1.1757196,6
2020-08-24-170223,170223,0,0,1,48,4.8,0.43271622,0
2020-08-25-170223,170223,0,0,0,48,2.4,0.38104683,1
2020-08-26-170223,170223,0,0,1,48,1.6,0.41934118,2
2020-08-27-170223,170223,2,0,0,50,2.0,0.7045857,3
2020-08-28-170223,170223,0,0,4,50,1.8,1.0230325,4
2020-08-29-170223,170223,0,0,0,50,1.0,0.4308744,5
2020-08-30-170223,170223,0,0,0,50,1.4,0.20499808,6
2020-08-31-170223,170223,0,0,0,50,1.0,0.113687,0
2020-09-01-170223,170223,0,0,1,50,2.4,0.47417358,1
2020-09-02-170223,170223,2,0,2,52,2.0,0.98253447,2
2020-09-03-170223,170223,4,0,1,56,1.4,0.6088145,3
2020-09-04-170223,170223,0,0,1,56,2.2,0.56412476,4
2020-09-05-170223,170223,0,0,0,56,0.8,0.30001542,5
2020-09-06-170223,170223,0,0,1,56,0.6,0.27413097,6
2020-09-07-170223,170223,1,0,0,57,2.0,0.196827,0
2020-09-08-170223,170223,0,0,0,57,6.0,0.48070568,1
2020-09-09-170223,170223,1,0,0,58,2.4,1.1302636,2
2020-09-10-170223,170223,0,0,0,58,6.2,1.671072,3
2020-09-11-170223,170223,4,0,0,62,3.0,1.6311722,4
2020-09-12-170223,170223,0,0,0,62,3.4,1.3917223,5
2020-09-13-170223,170223,0,0,0,62,1.4,0.5002323,6
2020-09-14-170223,170223,0,0,2,62,2.4,0.21220699,0
2020-09-15-170223,170223,1,0,0,63,6.8,0.84117293,1
2020-09-16-170223,170223,2,0,0,65,3.4,1.1897664,2
2020-09-17-170223,170223,1,0,0,66,2.6,0.6943145,3
2020-09-18-170223,170223,1,0,0,67,1.6,0.78286713,4
2020-09-19-170223,170223,0,0,0,67,0.8,0.010690498,5
2020-09-20-170223,170223,1,0,0,68,2.0,0.5489658,6
2020-09-21-170223,170223,0,0,1,68,3.4,0.16822147,0
2020-09-22-170223,170223,0,0,4,68,2.2,0.16687217,1
2020-09-23-170223,170223,0,0,0,68,4.4,1.1107183,2
2020-09-24-170223,170223,0,0,0,68,2.6,0.3965354,3
2020-09-25-170223,170223,0,0,0,68,2.0,0.6954727,4
2020-09-26-170223,170223,0,0,0,68,0.4,0.3639455,5
2020-09-27-170223,170223,0,0,0,68,0.6,0.2591627,6
2020-09-28-170223,170223,2,0,1,70,1.2,0.19698906,0
2020-09-29-170223,170223,0,0,1,70,1.2,0.19840275,1
2020-09-30-170223,170223,0,1,2,70,2.4,0.48284858,2
2020-10-01-170223,170223,0,0,3,70,3.0,0.5345004,3
2020-10-02-170223,170223,0,0,1,70,2.4,0.74450135,4
2020-10-03-170223,170223,0,0,0,70,1.6,0.4000003,5
2020-10-04-170223,170223,0,0,0,70,2.2,0.3712816,6
2020-10-05-170223,170223,1,0,1,71,2.6,0.41445583,0
2020-10-06-170223,170223,4,0,1,75,3.8,0.5022886,1
2020-10-07-170223,170223,0,0,0,75,3.6,1.2881209,2
2020-10-08-170223,170223,0,0,1,75,2.2,0.6321414,3
2020-10-09-170223,170223,0,0,1,75,3.6,0.89560133,4
2020-10-10-170223,170223,0,0,0,75,1.2,0.5307361,5
2020-10-11-170223,170223,0,0,1,75,1.6,0.5194402,6
2020-10-12-170223,170223,1,0,0,76,1.4,0.19021125,0
2020-10-13-170223,170223,1,0,3,77,2.2,0.45714015,1
2020-10-14-170223,170223,2,0,0,79,3.8,1.8471127,2
2020-10-15-170223,170223,3,0,4,82,2.6,1.2762423,3
2020-10-16-170223,170223,1,0,6,83,3.8,0.7795693,4
2020-10-17-170223,170223,0,0,2,83,2.0,0.5799726,5
2020-10-18-170223,170223,0,0,1,83,0.8,0.42638886,6
2020-10-19-170223,170223,1,0,1,84,5.8,0.6637531,0
2020-10-20-170223,170223,1,0,1,85,4.0,0.58172804,1
2020-10-21-170223,170223,0,0,1,85,4.0,1.623714,2
2020-10-22-170223,170223,1,0,3,86,5.2,1.7378519,3
2020-10-23-170223,170223,1,0,0,87,5.0,1.570823,4
2020-10-24-170223,170223,0,0,2,87,2.8,0.72275335,5
2020-10-25-170223,170223,1,0,1,88,1.8,0.58578867,6
2020-10-26-170223,170223,0,0,1,88,6.2,0.8193017,0
2020-10-27-170223,170223,3,0,3,91,5.0,0.6907133,1
2020-10-28-170223,170223,0,0,0,91,6.0,2.7024465,2
2020-10-29-170223,170223,4,0,1,95,3.6,2.0393026,3
2020-10-30-170223,170223,6,0,25,101,7.4,3.0207672,4
2020-10-31-170223,170223,2,0,0,103,3.6,1.423341,5
2020-11-01-170223,170223,1,0,0,104,4.8,1.6828527,6
2020-11-02-170223,170223,1,0,0,105,2.0,0.32358086,0
2020-11-03-170223,170223,1,1,0,106,6.0,0.7297358,1
2020-11-04-170223,170223,1,0,0,107,5.6,2.3373966,2
2020-11-05-170223,170223,3,0,0,110,3.6,1.9775256,3
2020-11-06-170223,170223,0,1,0,110,6.8,2.6296716,4
2020-11-07-170223,170223,2,0,0,112,1.6,0.7518327,5
2020-11-08-170223,170223,1,0,0,113,4.8,1.3828052,6
2020-11-09-170223,170223,1,0,0,114,5.8,0.83241844,0
2020-11-10-170223,170223,3,1,0,117,4.4,0.64835036,1
2020-11-11-170223,170223,0,0,0,117,2.0,1.1631216,2
2020-11-12-170223,170223,1,0,0,118,7.0,2.05757,3
2020-11-13-170223,170223,25,0,0,143,5.8,4.1553917,4
2020-03-01-170224,170224,0,0,0,0,0.0,2.3715495e-08,6
2020-03-02-170224,170224,0,0,0,0,0.0,4.270268e-06,0
2020-03-03-170224,170224,0,0,0,0,0.0,0.0032186294,1
2020-03-04-170224,170224,0,0,2,0,0.0,0.0018318673,2
2020-03-05-170224,170224,0,1,0,0,0.25,0.0055031753,3
2020-03-06-170224,170224,0,0,3,0,0.0,0.0026879665,4
2020-03-07-170224,170224,0,0,2,0,0.25,0.014674941,5
2020-03-08-170224,170224,0,0,0,0,0.0,0.0012798071,6
2020-03-09-170224,170224,0,0,4,0,0.75,0.054278985,0
2020-03-10-170224,170224,0,0,1,0,0.25,0.010012028,1
2020-03-11-170224,170224,0,0,3,0,1.0,0.029461112,2
2020-03-12-170224,170224,0,0,3,0,1.0,0.5343702,3
2020-03-13-170224,170224,0,0,1,0,0.5,0.36739382,4
2020-03-14-170224,170224,0,0,1,0,0.0,0.03709383,5
2020-03-15-170224,170224,0,0,0,0,0.75,0.043178037,6
2020-03-16-170224,170224,0,0,4,0,6.0,0.20085962,0
2020-03-17-170224,170224,0,0,1,0,3.5,0.23841062,1
2020-03-18-170224,170224,2,0,2,2,8.25,0.5744396,2
2020-03-19-170224,170224,0,1,1,2,3.25,0.42473266,3
2020-03-20-170224,170224,3,0,3,5,3.5,0.26462564,4
2020-03-21-170224,170224,2,0,1,7,1.75,0.2312091,5
2020-03-22-170224,170224,0,0,2,7,2.25,0.2008916,6
2020-03-23-170224,170224,4,0,1,11,6.0,0.78484476,0
2020-03-24-170224,170224,1,0,2,12,5.75,0.4477141,1
2020-03-25-170224,170224,3,0,0,15,5.5,0.5140699,2
2020-03-26-170224,170224,3,0,1,18,7.0,0.25810716,3
2020-03-27-170224,170224,1,0,5,19,5.0,0.34436792,4
2020-03-28-170224,170224,1,2,1,20,1.75,0.0591461,5
2020-03-29-170224,170224,0,0,1,20,1.25,0.035217516,6
2020-03-30-170224,170224,4,0,1,24,4.5,0.40520653,0
2020-03-31-170224,170224,1,0,0,25,5.75,0.4451706,1
2020-04-01-170224,170224,2,0,2,27,8.75,0.421511,2
2020-04-02-170224,170224,1,0,2,28,2.75,0.28877556,3
2020-04-03-170224,170224,3,0,1,31,0.75,0.17943513,4
2020-04-04-170224,170224,1,0,0,32,1.0,0.083139874,5
2020-04-05-170224,170224,2,0,0,34,0.75,0.043750484,6
2020-04-06-170224,170224,1,0,1,35,3.25,0.12403161,0
2020-04-07-170224,170224,2,0,0,37,4.5,0.16771413,1
2020-04-08-170224,170224,0,1,0,37,4.75,0.2514006,2
2020-04-09-170224,170224,1,0,0,38,6.25,0.08696962,3
2020-04-10-170224,170224,5,0,0,43,2.25,0.31797367,4
2020-04-11-170224,170224,1,0,1,44,1.25,0.027490694,5
2020-04-12-170224,170224,1,0,0,45,0.75,0.04999169,6
2020-04-13-170224,170224,1,0,0,46,4.75,0.20788196,0
2020-04-14-170224,170224,0,0,0,46,5.0,0.30260158,1
2020-04-15-170224,170224,2,0,0,48,2.25,0.29096106,2
2020-04-16-170224,170224,2,0,0,50,7.25,0.6766281,3
2020-04-17-170224,170224,1,0,0,51,1.0,0.19656402,4
2020-04-18-170224,170224,0,0,0,51,6.0,0.09161847,5
2020-04-19-170224,170224,0,0,0,51,1.0,0.038277626,6
2020-04-20-170224,170224,1,0,1,52,14.75,0.45546752,0
2020-04-21-170224,170224,0,0,1,52,1.25,0.22046566,1
2020-04-22-170224,170224,0,0,1,52,2.0,0.19301458,2
2020-04-23-170224,170224,0,0,1,52,0.5,0.051396057,3
2020-04-24-170224,170224,0,0,0,52,2.5,0.09854516,4
2020-04-25-170224,170224,1,0,0,53,1.5,0.08763581,5
2020-04-26-170224,170224,0,0,0,53,0.0,0.005052692,6
2020-04-27-170224,170224,0,0,0,53,2.0,0.08499324,0
2020-04-28-170224,170224,0,0,0,53,1.5,0.19615258,1
2020-04-29-170224,170224,0,0,0,53,1.25,0.20362689,2
2020-04-30-170224,170224,0,0,0,53,1.5,0.39827,3
2020-05-01-170224,170224,0,0,0,53,0.75,0.10296318,4
2020-05-02-170224,170224,0,0,0,53,1.0,0.010194204,5
2020-05-03-170224,170224,0,0,0,53,0.25,0.056951664,6
2020-05-04-170224,170224,1,0,0,54,2.75,0.20129381,0
2020-05-05-170224,170224,1,0,0,55,3.25,0.08859839,1
2020-05-06-170224,170224,1,0,1,56,3.0,0.28446007,2
2020-05-07-170224,170224,1,0,0,57,1.75,0.096543886,3
2020-05-08-170224,170224,0,0,0,57,1.75,0.05194532,4
2020-05-09-170224,170224,0,0,0,57,0.25,0.0021615431,5
2020-05-10-170224,170224,0,0,0,57,0.0,0.0024947282,6
2020-05-11-170224,170224,0,0,0,57,1.75,0.05476204,0
2020-05-12-170224,170224,0,1,0,57,2.5,0.12996008,1
2020-05-13-170224,170224,0,0,0,57,3.75,0.11682426,2
2020-05-14-170224,170224,0,0,0,57,0.75,0.14971945,3
2020-05-15-170224,170224,0,0,0,57,2.5,0.24498433,4
2020-05-16-170224,170224,0,0,0,57,0.25,0.0060889972,5
2020-05-17-170224,170224,0,0,0,57,0.0,0.0017564105,6
2020-05-18-170224,170224,0,0,0,57,1.5,0.10054899,0
2020-05-19-170224,170224,0,1,0,57,2.0,0.123184234,1
2020-05-20-170224,170224,1,0,0,58,1.0,0.04887917,2
2020-05-21-170224,170224,0,0,0,58,0.25,0.022612112,3
2020-05-22-170224,170224,0,0,0,58,0.5,0.085067675,4
2020-05-23-170224,170224,0,0,0,58,0.0,0.00037100163,5
2020-05-24-170224,170224,0,1,0,58,1.0,0.009598887,6
2020-05-25-170224,170224,0,0,0,58,1.75,0.07400688,0
2020-05-26-170224,170224,0,0,0,58,2.25,0.43839067,1
2020-05-27-170224,170224,0,0,0,58,1.25,0.14440136,2
2020-05-28-170224,170224,0,0,0,58,1.25,0.047210813,3
2020-05-29-170224,170224,0,1,0,58,1.0,0.06049396,4
2020-05-30-170224,170224,0,0,0,58,0.75,0.020462688,5
2020-05-31-170224,170224,0,0,0,58,0.0,0.0011032376,6
2020-06-01-170224,170224,0,0,0,58,0.75,0.024695884,0
2020-06-02-170224,170224,0,0,0,58,1.25,0.13526799,1
2020-06-03-170224,170224,0,0,0,58,0.75,0.042068392,2
2020-06-04-170224,170224,0,0,0,58,1.25,0.1650451,3
2020-06-05-170224,170224,0,1,1,58,1.0,0.048328128,4
2020-06-06-170224,170224,0,1,0,58,0.5,0.021295333,5
2020-06-07-170224,170224,0,0,0,58,0.25,0.008781283,6
2020-06-08-170224,170224,0,0,0,58,0.75,0.026351377,0
2020-06-09-170224,170224,0,0,0,58,1.25,0.120204,1
2020-06-10-170224,170224,0,0,0,58,1.25,0.024298018,2
2020-06-11-170224,170224,0,0,1,58,0.0,0.016521795,3
2020-06-12-170224,170224,0,0,0,58,0.75,0.20528133,4
2020-06-13-170224,170224,0,0,0,58,0.25,0.008413831,5
2020-06-14-170224,170224,0,0,0,58,0.25,0.013550542,6
2020-06-15-170224,170224,0,0,0,58,0.0,0.0003327577,0
2020-06-16-170224,170224,0,1,0,58,1.5,0.29774454,1
2020-06-17-170224,170224,0,0,1,58,1.5,0.061993394,2
2020-06-18-170224,170224,0,0,1,58,0.75,0.069132686,3
2020-06-19-170224,170224,1,0,0,59,1.0,0.09669292,4
2020-06-20-170224,170224,0,0,0,59,0.25,0.013178808,5
2020-06-21-170224,170224,0,0,0,59,0.0,0.0012137996,6
2020-06-22-170224,170224,0,0,0,59,0.75,0.029658979,0
2020-06-23-170224,170224,0,0,0,59,0.0,0.03326478,1
2020-06-24-170224,170224,0,1,0,59,0.0,0.052406847,2
2020-06-25-170224,170224,1,0,1,60,0.5,0.120304145,3
2020-06-26-170224,170224,0,0,0,60,0.5,0.047113217,4
2020-06-27-170224,170224,0,0,0,60,0.25,0.04008542,5
2020-06-28-170224,170224,0,0,0,60,0.5,0.046480943,6
2020-06-29-170224,170224,0,0,1,60,0.0,0.002131746,0
2020-06-30-170224,170224,0,0,0,60,0.0,0.018652625,1
2020-07-01-170224,170224,1,0,0,61,0.25,0.02139758,2
2020-07-02-170224,170224,1,0,0,62,0.0,0.064379886,3
2020-07-03-170224,170224,0,0,1,62,0.0,0.017701354,4
2020-07-04-170224,170224,0,0,0,62,0.0,0.0011968651,5
2020-07-05-170224,170224,0,0,0,62,0.0,3.580881e-09,6
2020-07-06-170224,170224,0,0,0,62,0.75,0.35500774,0
2020-07-07-170224,170224,0,0,1,62,0.75,0.100660324,1
2020-07-08-170224,170224,0,0,0,62,0.5,0.24410407,2
2020-07-09-170224,170224,1,0,0,63,0.0,0.048801374,3
2020-07-10-170224,170224,0,0,1,63,0.25,0.0026011413,4
2020-07-11-170224,170224,0,0,0,63,0.0,5.3536798e-05,5
2020-07-12-170224,170224,0,0,2,63,0.5,0.011569474,6
2020-07-13-170224,170224,1,0,1,64,1.25,0.091170006,0
2020-07-14-170224,170224,0,0,1,64,0.25,0.047772065,1
2020-07-15-170224,170224,0,0,1,64,1.0,0.051706627,2
2020-07-16-170224,170224,0,0,0,64,1.5,0.3102699,3
2020-07-17-170224,170224,1,0,0,65,0.0,0.07563575,4
2020-07-18-170224,170224,0,0,0,65,0.0,0.010317599,5
2020-07-19-170224,170224,0,0,0,65,0.0,0.010035645,6
2020-07-20-170224,170224,0,0,0,65,0.25,0.017254997,0
2020-07-21-170224,170224,1,0,4,66,0.25,0.10223475,1
2020-07-22-170224,170224,0,0,2,66,0.25,0.21851115,2
2020-07-23-170224,170224,0,0,1,66,0.5,0.08741348,3
2020-07-24-170224,170224,1,0,0,67,0.75,0.18109328,4
2020-07-25-170224,170224,0,0,0,67,0.0,0.021257697,5
2020-07-26-170224,170224,2,0,0,69,0.5,0.1661918,6
2020-07-27-170224,170224,1,0,2,70,0.0,0.10858954,0
2020-07-28-170224,170224,1,0,1,71,0.0,0.020540634,1
2020-07-29-170224,170224,1,0,0,72,0.5,0.1639289,2
2020-07-30-170224,170224,0,0,1,72,0.75,0.18852039,3
2020-07-31-170224,170224,0,0,1,72,0.5,0.16478938,4
2020-08-01-170224,170224,0,0,1,72,1.25,0.3987951,5
2020-08-02-170224,170224,0,0,0,72,0.0,0.06107934,6
2020-08-03-170224,170224,0,0,2,72,0.0,0.060791694,0
2020-08-04-170224,170224,4,0,2,76,1.5,0.5877801,1
2020-08-05-170224,170224,2,0,4,78,3.5,0.5683284,2
2020-08-06-170224,170224,1,0,0,79,3.0,0.47749162,3
2020-08-07-170224,170224,0,0,3,79,0.5,0.13037477,4
2020-08-08-170224,170224,0,0,4,79,1.25,0.41135627,5
2020-08-09-170224,170224,0,0,1,79,1.5,0.30525708,6
2020-08-10-170224,170224,2,1,6,81,1.5,0.9668937,0
2020-08-11-170224,170224,1,0,1,82,1.75,0.7159348,1
2020-08-12-170224,170224,0,0,2,82,2.25,0.7427565,2
2020-08-13-170224,170224,1,0,2,83,1.5,2.2992964,3
2020-08-14-170224,170224,1,0,0,84,3.75,2.0748398,4
2020-08-15-170224,170224,1,0,0,85,0.25,0.22068183,5
2020-08-16-170224,170224,0,0,1,85,1.75,0.8028732,6
2020-08-17-170224,170224,2,0,0,87,0.5,0.5767494,0
2020-08-18-170224,170224,2,0,2,89,2.25,0.86901283,1
2020-08-19-170224,170224,4,0,1,93,1.75,0.73061424,2
2020-08-20-170224,170224,0,0,1,93,2.5,0.882031,3
2020-08-21-170224,170224,3,0,0,96,1.0,1.2481798,4
2020-08-22-170224,170224,4,0,2,100,2.5,1.6304361,5
2020-08-23-170224,170224,1,0,0,101,0.25,0.11258625,6
2020-08-24-170224,170224,6,0,1,107,1.25,0.37353432,0
2020-08-25-170224,170224,1,0,0,108,2.25,1.1578691,1
2020-08-26-170224,170224,2,0,0,110,1.75,0.18904118,2
2020-08-27-170224,170224,2,0,0,112,1.25,0.27092093,3
2020-08-28-170224,170224,0,0,0,112,1.0,0.13949232,4
2020-08-29-170224,170224,0,0,1,112,0.5,0.5281986,5
2020-08-30-170224,170224,1,0,1,113,0.25,0.09178193,6
2020-08-31-170224,170224,0,0,3,113,0.5,0.26311588,0
2020-09-01-170224,170224,2,0,0,115,1.75,0.35306242,1
2020-09-02-170224,170224,1,0,5,116,1.5,0.75679034,2
2020-09-03-170224,170224,1,0,1,117,2.25,1.93372,3
2020-09-04-170224,170224,0,0,0,117,1.5,0.4463463,4
2020-09-05-170224,170224,2,0,0,119,0.5,0.025606392,5
2020-09-06-170224,170224,0,1,0,119,0.25,0.111693,6
2020-09-07-170224,170224,1,0,0,120,2.0,0.9704845,0
2020-09-08-170224,170224,0,0,2,120,1.75,0.60599184,1
2020-09-09-170224,170224,0,0,1,120,0.75,0.40253934,2
2020-09-10-170224,170224,0,0,3,120,1.25,0.63703996,3
2020-09-11-170224,170224,0,0,1,120,1.0,0.68060917,4
2020-09-12-170224,170224,1,0,1,121,1.25,0.37685516,5
2020-09-13-170224,170224,1,0,0,122,1.0,0.40454364,6
2020-09-14-170224,170224,3,0,2,125,1.5,0.33974218,0
2020-09-15-170224,170224,0,0,0,125,0.75,0.64723164,1
2020-09-16-170224,170224,5,0,0,130,1.25,0.61624086,2
2020-09-17-170224,170224,1,0,0,131,1.0,0.50841874,3
2020-09-18-170224,170224,0,0,1,131,1.75,0.334947,4
2020-09-19-170224,170224,0,0,0,131,0.25,0.013376848,5
2020-09-20-170224,170224,0,0,0,131,1.25,0.123335384,6
2020-09-21-170224,170224,0,0,0,131,0.5,0.2460406,0
2020-09-22-170224,170224,2,1,0,133,0.5,0.14533241,1
2020-09-23-170224,170224,1,0,1,134,1.25,0.30853856,2
2020-09-24-170224,170224,3,0,2,137,2.0,0.4531018,3
2020-09-25-170224,170224,1,0,1,138,0.5,0.2417041,4
2020-09-26-170224,170224,1,0,1,139,2.5,0.30987614,5
2020-09-27-170224,170224,0,0,0,139,0.0,0.11747129,6
2020-09-28-170224,170224,2,0,2,141,1.75,0.25704604,0
2020-09-29-170224,170224,0,0,2,141,1.0,0.2593684,1
2020-09-30-170224,170224,0,0,4,141,1.0,0.4279516,2
2020-10-01-170224,170224,0,0,4,141,0.25,0.10220821,3
2020-10-02-170224,170224,1,0,4,142,0.0,0.06951423,4
2020-10-03-170224,170224,0,0,0,142,0.0,0.032661077,5
2020-10-04-170224,170224,0,1,4,142,0.25,0.045872144,6
2020-10-05-170224,170224,0,0,1,142,0.5,0.13859321,0
2020-10-06-170224,170224,0,0,8,142,0.5,0.11968864,1
2020-10-07-170224,170224,1,0,6,143,1.75,0.99108934,2
2020-10-08-170224,170224,2,0,3,145,0.75,0.43597516,3
2020-10-09-170224,170224,1,0,1,146,1.0,0.5147507,4
2020-10-10-170224,170224,1,0,0,147,1.25,0.31906304,5
2020-10-11-170224,170224,0,0,4,147,1.0,0.19708292,6
2020-10-12-170224,170224,2,0,9,149,0.75,0.22175875,0
2020-10-13-170224,170224,2,0,0,151,2.0,0.82056755,1
2020-10-14-170224,170224,4,0,3,155,2.0,1.4465004,2
2020-10-15-170224,170224,4,0,10,159,1.5,0.8087932,3
2020-10-16-170224,170224,4,0,8,163,5.75,1.6481541,4
2020-10-17-170224,170224,0,0,5,163,9.75,1.1637903,5
2020-10-18-170224,170224,4,0,0,167,0.25,0.30380803,6
2020-10-19-170224,170224,1,0,1,168,0.25,0.354915,0
2020-10-20-170224,170224,8,0,2,176,1.25,1.1744546,1
2020-10-21-170224,170224,6,0,5,182,3.75,1.3913128,2
2020-10-22-170224,170224,3,0,6,185,3.0,1.0555235,3
2020-10-23-170224,170224,1,0,5,186,3.0,0.828557,4
2020-10-24-170224,170224,0,0,2,186,2.0,0.6998785,5
2020-10-25-170224,170224,4,0,12,190,2.75,0.51842755,6
2020-10-26-170224,170224,9,0,10,199,4.5,2.2264342,0
2020-10-27-170224,170224,0,0,10,199,1.75,0.8161156,1
2020-10-28-170224,170224,3,0,6,202,10.0,4.263424,2
2020-10-29-170224,170224,10,0,11,212,5.0,2.6041281,3
2020-10-30-170224,170224,8,0,16,220,6.0,1.7359041,4
2020-10-31-170224,170224,5,0,0,225,5.5,2.0326993,5
2020-11-01-170224,170224,0,0,0,225,2.75,1.0809186,6
2020-11-02-170224,170224,1,0,0,226,2.0,0.55336356,0
2020-11-03-170224,170224,2,0,0,228,2.5,0.9279327,1
2020-11-04-170224,170224,5,0,0,233,3.0,1.0711274,2
2020-11-05-170224,170224,6,0,0,239,3.0,0.8653823,3
2020-11-06-170224,170224,5,0,0,244,6.0,2.1074471,4
2020-11-07-170224,170224,2,0,0,246,2.25,0.46121997,5
2020-11-08-170224,170224,12,0,0,258,10.5,2.1643422,6
2020-11-09-170224,170224,10,0,0,268,1.75,1.1939093,0
2020-11-10-170224,170224,10,0,0,278,5.25,3.0644102,1
2020-11-11-170224,170224,6,1,0,284,2.75,0.771844,2
2020-11-12-170224,170224,11,0,0,295,4.25,1.680927,3
2020-11-13-170224,170224,16,0,0,311,2.25,1.5772314,4
2020-03-01-170225,170225,0,0,2,0,0.0,0.0006503008,6
2020-03-02-170225,170225,0,0,5,0,0.0,0.0047451,0
2020-03-03-170225,170225,0,0,0,0,0.0,0.006764048,1
2020-03-04-170225,170225,0,0,1,0,0.0,0.0062659723,2
2020-03-05-170225,170225,0,0,3,0,0.0,0.002706682,3
2020-03-06-170225,170225,0,0,3,0,0.0,0.0074962857,4
2020-03-07-170225,170225,0,0,1,0,0.0,0.0025060344,5
2020-03-08-170225,170225,0,0,3,0,0.0,0.00078923104,6
2020-03-09-170225,170225,1,0,1,1,0.125,0.2529059,0
2020-03-10-170225,170225,0,0,2,1,0.25,0.2296782,1
2020-03-11-170225,170225,0,0,2,1,0.125,0.3005571,2
2020-03-12-170225,170225,0,0,3,1,0.125,0.3225914,3
2020-03-13-170225,170225,0,0,2,1,0.375,0.3353296,4
2020-03-14-170225,170225,0,0,2,1,1.0,1.1411912,5
2020-03-15-170225,170225,2,0,1,3,0.0,0.3013115,6
2020-03-16-170225,170225,5,0,2,8,1.75,2.2469904,0
2020-03-17-170225,170225,0,0,1,8,2.0,2.4478586,1
2020-03-18-170225,170225,1,0,1,9,2.125,2.0600417,2
2020-03-19-170225,170225,3,0,1,12,3.375,3.4287848,3
2020-03-20-170225,170225,3,1,0,15,2.25,2.460991,4
2020-03-21-170225,170225,1,1,0,16,1.625,1.2959043,5
2020-03-22-170225,170225,3,0,0,19,2.25,1.275265,6
2020-03-23-170225,170225,1,0,0,20,7.25,7.4334364,0
2020-03-24-170225,170225,2,0,2,22,5.0,4.526897,1
2020-03-25-170225,170225,2,0,0,24,4.125,4.8068604,2
2020-03-26-170225,170225,3,0,1,27,4.0,3.8737478,3
2020-03-27-170225,170225,2,0,0,29,4.125,3.5400093,4
2020-03-28-170225,170225,2,0,0,31,2.25,1.2970499,5
2020-03-29-170225,170225,1,0,1,32,1.25,0.8433438,6
2020-03-30-170225,170225,2,0,0,34,3.375,3.2588208,0
2020-03-31-170225,170225,1,0,0,35,2.875,2.91962,1
2020-04-01-170225,170225,1,0,0,36,4.0,3.0581405,2
2020-04-02-170225,170225,1,0,0,37,2.25,1.6280719,3
2020-04-03-170225,170225,0,0,0,37,2.0,2.0811052,4
2020-04-04-170225,170225,0,0,1,37,1.125,0.5112146,5
2020-04-05-170225,170225,0,0,0,37,1.875,0.3069873,6
2020-04-06-170225,170225,0,0,1,37,2.125,1.4253651,0
2020-04-07-170225,170225,2,3,0,39,2.375,1.4754355,1
2020-04-08-170225,170225,0,0,1,39,1.75,1.4731327,2
2020-04-09-170225,170225,1,2,0,40,1.375,0.7290974,3
2020-04-10-170225,170225,0,0,1,40,0.875,0.55463684,4
2020-04-11-170225,170225,0,0,0,40,0.875,0.4493121,5
2020-04-12-170225,170225,1,0,0,41,1.25,1.3241448,6
2020-04-13-170225,170225,0,0,0,41,2.0,1.2582333,0
2020-04-14-170225,170225,0,0,0,41,1.5,2.0672104,1
2020-04-15-170225,170225,0,0,0,41,2.25,1.5808151,2
2020-04-16-170225,170225,0,0,1,41,1.25,1.053216,3
2020-04-17-170225,170225,0,0,1,41,3.25,5.294339,4
2020-04-18-170225,170225,1,0,0,42,0.375,0.18298808,5
2020-04-19-170225,170225,0,0,0,42,0.375,0.36811185,6
2020-04-20-170225,170225,1,0,1,43,1.0,1.6021345,0
2020-04-21-170225,170225,0,0,0,43,2.375,0.90144944,1
2020-04-22-170225,170225,1,0,0,44,1.0,0.2483247,2
2020-04-23-170225,170225,0,0,1,44,0.5,0.3126814,3
2020-04-24-170225,170225,1,0,1,45,1.25,0.718832,4
2020-04-25-170225,170225,0,0,0,45,0.0,0.006777467,5
2020-04-26-170225,170225,0,0,1,45,2.375,0.3164829,6
2020-04-27-170225,170225,0,0,0,45,0.75,0.74572414,0
2020-04-28-170225,170225,0,0,0,45,0.875,0.6364415,1
2020-04-29-170225,170225,0,0,0,45,1.0,1.0903114,2
2020-04-30-170225,170225,1,0,0,46,0.375,0.8244589,3
2020-05-01-170225,170225,1,0,0,47,0.0,0.1966751,4
2020-05-02-170225,170225,0,0,0,47,0.125,0.17356277,5
2020-05-03-170225,170225,0,0,0,47,0.25,0.29629144,6
2020-05-04-170225,170225,1,0,1,48,1.0,1.3402339,0
2020-05-05-170225,170225,0,0,0,48,0.625,0.47486746,1
2020-05-06-170225,170225,0,0,0,48,0.625,0.9430262,2
2020-05-07-170225,170225,1,0,2,49,0.625,0.86561644,3
2020-05-08-170225,170225,1,0,0,50,0.625,0.71600187,4
2020-05-09-170225,170225,0,0,0,50,0.125,0.22320808,5
2020-05-10-170225,170225,1,0,0,51,0.0,0.32044575,6
2020-05-11-170225,170225,0,0,1,51,1.0,0.9305524,0
2020-05-12-170225,170225,0,0,0,51,0.375,0.050756756,1
2020-05-13-170225,170225,0,0,2,51,1.0,1.5177667,2
2020-05-14-170225,170225,0,0,3,51,0.875,0.9415487,3
2020-05-15-170225,170225,0,1,0,51,0.25,0.31829077,4
2020-05-16-170225,170225,0,0,0,51,0.125,0.0027171285,5
2020-05-17-170225,170225,0,0,0,51,0.25,0.16728833,6
2020-05-18-170225,170225,1,0,0,52,1.0,1.8783872,0
2020-05-19-170225,170225,0,0,0,52,0.875,0.8372874,1
2020-05-20-170225,170225,0,0,1,52,1.0,1.5763621,2
2020-05-21-170225,170225,2,0,0,54,0.5,0.861302,3
2020-05-22-170225,170225,0,1,0,54,0.5,0.056413185,4
2020-05-23-170225,170225,0,0,0,54,0.25,0.016174376,5
2020-05-24-170225,170225,0,0,0,54,0.25,0.0041463,6
2020-05-25-170225,170225,1,0,0,55,0.75,1.3708712,0
2020-05-26-170225,170225,0,0,0,55,0.75,0.59896976,1
2020-05-27-170225,170225,2,0,0,57,0.75,0.9298853,2
2020-05-28-170225,170225,3,1,0,60,0.125,0.7906532,3
2020-05-29-170225,170225,0,1,0,60,0.375,0.68904775,4
2020-05-30-170225,170225,0,0,0,60,0.0,0.0007106993,5
2020-05-31-170225,170225,0,0,0,60,0.0,0.002044262,6
2020-06-01-170225,170225,0,0,0,60,0.125,0.2987194,0
2020-06-02-170225,170225,0,0,0,60,0.5,0.27350664,1
2020-06-03-170225,170225,1,0,0,61,0.375,1.044703,2
2020-06-04-170225,170225,0,0,0,61,0.625,0.47860554,3
2020-06-05-170225,170225,0,0,3,61,0.25,0.24013339,4
2020-06-06-170225,170225,0,0,1,61,0.375,0.37921587,5
2020-06-07-170225,170225,0,0,0,61,0.0,0.000118036674,6
2020-06-08-170225,170225,0,0,1,61,0.375,0.23565385,0
2020-06-09-170225,170225,0,0,0,61,0.125,0.22324577,1
2020-06-10-170225,170225,0,0,1,61,0.0,0.03186919,2
2020-06-11-170225,170225,0,0,0,61,0.125,0.033588625,3
2020-06-12-170225,170225,0,0,1,61,0.125,0.053148236,4
2020-06-13-170225,170225,0,0,0,61,0.0,0.016689384,5
2020-06-14-170225,170225,0,0,0,61,0.0,0.0011322467,6
2020-06-15-170225,170225,0,0,0,61,0.0,0.0056743454,0
2020-06-16-170225,170225,0,0,1,61,0.375,0.20568717,1
2020-06-17-170225,170225,0,1,0,61,0.125,0.026162893,2
2020-06-18-170225,170225,0,0,0,61,1.125,0.0672074,3
2020-06-19-170225,170225,3,0,0,64,0.25,0.770733,4
2020-06-20-170225,170225,1,0,0,65,0.125,0.39314562,5
2020-06-21-170225,170225,0,0,0,65,0.0,0.0024448372,6
2020-06-22-170225,170225,1,0,0,66,0.125,0.5732096,0
2020-06-23-170225,170225,0,0,0,66,0.25,0.32875487,1
2020-06-24-170225,170225,1,1,0,67,0.5,0.28334627,2
2020-06-25-170225,170225,0,0,1,67,0.0,0.025629511,3
2020-06-26-170225,170225,1,0,1,68,0.375,0.53733295,4
2020-06-27-170225,170225,0,0,1,68,0.0,0.012961313,5
2020-06-28-170225,170225,0,0,0,68,0.0,0.0018615387,6
2020-06-29-170225,170225,0,0,0,68,0.25,0.32094866,0
2020-06-30-170225,170225,1,0,0,69,0.25,0.25732392,1
2020-07-01-170225,170225,0,0,0,69,0.375,0.29781464,2
2020-07-02-170225,170225,0,1,0,69,0.25,0.22097996,3
2020-07-03-170225,170225,0,0,0,69,0.375,0.053376585,4
2020-07-04-170225,170225,0,0,0,69,0.0,0.011183268,5
2020-07-05-170225,170225,0,0,0,69,0.0,0.0004684669,6
2020-07-06-170225,170225,0,0,0,69,0.25,0.028412705,0
2020-07-07-170225,170225,0,0,1,69,0.125,0.2571129,1
2020-07-08-170225,170225,0,0,0,69,0.125,0.02999398,2
2020-07-09-170225,170225,1,0,0,70,0.0,0.2693389,3
2020-07-10-170225,170225,1,0,0,71,0.375,0.59198815,4
2020-07-11-170225,170225,1,0,0,72,0.0,0.00053079217,5
2020-07-12-170225,170225,0,0,0,72,0.25,0.2216308,6
2020-07-13-170225,170225,0,0,0,72,0.125,0.22023667,0
2020-07-14-170225,170225,0,0,0,72,0.75,0.49514088,1
2020-07-15-170225,170225,0,1,0,72,0.625,0.26330337,2
2020-07-16-170225,170225,0,0,0,72,0.625,0.24503787,3
2020-07-17-170225,170225,0,0,0,72,0.0,0.021732423,4
2020-07-18-170225,170225,0,0,1,72,0.0,0.011621505,5
2020-07-19-170225,170225,0,0,0,72,0.125,0.20653313,6
2020-07-20-170225,170225,0,0,1,72,0.125,0.32376233,0
2020-07-21-170225,170225,1,0,2,73,0.125,0.5835995,1
2020-07-22-170225,170225,0,0,1,73,0.125,0.025856728,2
2020-07-23-170225,170225,0,0,2,73,0.125,0.038635533,3
2020-07-24-170225,170225,0,0,1,73,0.125,0.33930156,4
2020-07-25-170225,170225,0,0,1,73,0.25,0.33506754,5
2020-07-26-170225,170225,0,0,0,73,0.0,0.0024467423,6
2020-07-27-170225,170225,0,0,0,73,0.125,0.04081638,0
2020-07-28-170225,170225,0,0,2,73,0.25,0.63057506,1
2020-07-29-170225,170225,0,0,5,73,0.375,0.31657797,2
2020-07-30-170225,170225,0,0,2,73,0.125,0.40212825,3
2020-07-31-170225,170225,0,0,1,73,0.625,0.45118704,4
2020-08-01-170225,170225,1,0,4,74,0.375,0.6917668,5
2020-08-02-170225,170225,0,1,0,74,0.125,0.30583486,6
2020-08-03-170225,170225,1,0,1,75,0.75,2.1144252,0
2020-08-04-170225,170225,2,0,4,77,0.625,2.8261218,1
2020-08-05-170225,170225,1,0,1,78,1.625,6.0664797,2
2020-08-06-170225,170225,2,0,6,80,2.125,6.763189,3
2020-08-07-170225,170225,1,0,2,81,1.375,3.7820902,4
2020-08-08-170225,170225,1,0,0,82,1.375,2.9986286,5
2020-08-09-170225,170225,0,1,1,82,2.125,2.9306505,6
2020-08-10-170225,170225,0,0,2,82,3.75,6.185482,0
2020-08-11-170225,170225,2,1,2,84,3.25,6.8285236,1
2020-08-12-170225,170225,5,0,1,89,2.5,5.138467,2
2020-08-13-170225,170225,2,0,2,91,3.5,2.008342,3
2020-08-14-170225,170225,1,0,4,92,2.375,3.7885516,4
2020-08-15-170225,170225,4,0,3,96,2.75,4.6907907,5
2020-08-16-170225,170225,0,0,2,96,1.5,1.2054349,6
2020-08-17-170225,170225,1,0,2,97,5.375,10.035845,0
2020-08-18-170225,170225,4,0,1,101,2.875,3.7776258,1
2020-08-19-170225,170225,1,0,1,102,3.625,4.127345,2
2020-08-20-170225,170225,6,0,15,108,2.75,5.330479,3
2020-08-21-170225,170225,2,0,3,110,2.875,3.6793709,4
2020-08-22-170225,170225,0,0,0,110,0.375,0.792361,5
2020-08-23-170225,170225,1,0,16,111,1.75,2.7671354,6
2020-08-24-170225,170225,2,0,0,113,2.5,3.1012793,0
2020-08-25-170225,170225,2,0,1,115,1.875,1.1579869,1
2020-08-26-170225,170225,1,0,3,116,2.625,2.6379004,2
2020-08-27-170225,170225,2,0,1,118,2.25,1.5023161,3
2020-08-28-170225,170225,4,0,5,122,2.25,2.8469353,4
2020-08-29-170225,170225,3,0,3,125,1.25,1.0108367,5
2020-08-30-170225,170225,2,0,0,127,1.875,0.92124355,6
2020-08-31-170225,170225,2,0,1,129,1.875,0.73215103,0
2020-09-01-170225,170225,1,0,6,130,1.0,0.5922087,1
2020-09-02-170225,170225,1,0,10,131,0.75,1.0595604,2
2020-09-03-170225,170225,15,0,3,146,1.625,5.0951715,3
2020-09-04-170225,170225,3,0,5,149,2.875,1.9907079,4
2020-09-05-170225,170225,0,0,2,149,1.125,0.99985105,5
2020-09-06-170225,170225,16,0,4,165,1.0,3.0336347,6
2020-09-07-170225,170225,0,0,3,165,1.5,1.0159276,0
2020-09-08-170225,170225,1,0,2,166,4.125,1.3592228,1
2020-09-09-170225,170225,3,1,1,169,3.625,2.4731686,2
2020-09-10-170225,170225,1,0,0,170,5.375,7.641664,3
2020-09-11-170225,170225,5,0,8,175,6.125,6.369435,4
2020-09-12-170225,170225,3,0,2,178,2.75,2.9146218,5
2020-09-13-170225,170225,0,1,3,178,1.875,2.157545,6
2020-09-14-170225,170225,1,1,3,179,2.125,0.72303134,0
2020-09-15-170225,170225,6,0,15,185,5.125,4.53076,1
2020-09-16-170225,170225,10,1,3,195,2.5,4.066381,2
2020-09-17-170225,170225,3,1,2,198,3.125,2.72219,3
2020-09-18-170225,170225,5,0,4,203,2.75,2.1492956,4
2020-09-19-170225,170225,2,1,0,205,1.625,0.950029,5
2020-09-20-170225,170225,4,0,0,209,2.125,2.423133,6
2020-09-21-170225,170225,3,1,0,212,3.25,2.9405103,0
2020-09-22-170225,170225,2,0,2,214,3.0,0.9035057,1
2020-09-23-170225,170225,1,0,2,215,3.0,1.4546937,2
2020-09-24-170225,170225,0,1,5,215,2.375,0.9139977,3
2020-09-25-170225,170225,8,0,2,223,2.875,2.8164144,4
2020-09-26-170225,170225,2,0,2,225,1.125,1.3946388,5
2020-09-27-170225,170225,3,0,0,228,0.875,0.8469334,6
2020-09-28-170225,170225,3,0,3,231,1.625,1.849599,0
2020-09-29-170225,170225,15,0,0,246,1.25,3.966732,1
2020-09-30-170225,170225,3,0,8,249,1.375,0.99283475,2
2020-10-01-170225,170225,2,0,3,251,2.375,1.6955074,3
2020-10-02-170225,170225,4,0,4,255,1.25,2.2723203,4
2020-10-03-170225,170225,0,1,3,255,1.0,0.5858663,5
2020-10-04-170225,170225,0,1,1,255,1.375,0.8501058,6
2020-10-05-170225,170225,0,0,4,255,1.5,0.3931706,0
2020-10-06-170225,170225,2,0,3,257,1.625,1.6009954,1
2020-10-07-170225,170225,2,0,10,259,1.75,2.0147476,2
2020-10-08-170225,170225,5,0,4,264,1.375,1.7499238,3
2020-10-09-170225,170225,2,0,5,266,1.625,1.229414,4
2020-10-10-170225,170225,2,0,8,268,1.375,1.6101903,5
2020-10-11-170225,170225,0,0,3,268,1.25,1.2052256,6
2020-10-12-170225,170225,3,0,4,271,1.0,2.2850897,0
2020-10-13-170225,170225,0,0,3,271,1.5,1.6700493,1
2020-10-14-170225,170225,8,0,11,279,2.0,3.517262,2
2020-10-15-170225,170225,3,0,3,282,1.5,2.0309207,3
2020-10-16-170225,170225,4,0,9,286,2.0,1.841246,4
2020-10-17-170225,170225,3,0,4,289,0.75,0.75926155,5
2020-10-18-170225,170225,1,0,6,290,1.375,1.4581976,6
2020-10-19-170225,170225,4,0,2,294,3.0,4.251868,0
2020-10-20-170225,170225,3,0,14,297,2.0,1.6492896,1
2020-10-21-170225,170225,10,0,4,307,2.875,4.198903,2
2020-10-22-170225,170225,4,0,22,311,2.375,2.5922751,3
2020-10-23-170225,170225,5,0,10,316,3.625,2.0196397,4
2020-10-24-170225,170225,8,0,9,324,0.875,1.8490629,5
2020-10-25-170225,170225,3,0,8,327,0.75,1.0251178,6
2020-10-26-170225,170225,4,1,2,331,2.75,3.3226044,0
2020-10-27-170225,170225,3,1,10,334,2.75,2.8011315,1
2020-10-28-170225,170225,11,0,8,345,5.375,6.8666205,2
2020-10-29-170225,170225,3,0,6,348,4.125,5.2974296,3
2020-10-30-170225,170225,9,0,11,357,5.875,6.009904,4
2020-10-31-170225,170225,4,0,0,361,2.125,2.707038,5
2020-11-01-170225,170225,6,0,0,367,2.0,3.2201884,6
2020-11-02-170225,170225,2,0,0,369,1.25,2.1552844,0
2020-11-03-170225,170225,14,0,0,383,3.75,7.899135,1
2020-11-04-170225,170225,4,1,0,387,4.0,4.136581,2
2020-11-05-170225,170225,22,0,0,409,3.375,7.818543,3
2020-11-06-170225,170225,10,0,0,419,7.625,8.215321,4
2020-11-07-170225,170225,9,2,0,428,2.0,2.3910346,5
2020-11-08-170225,170225,8,0,0,436,1.375,2.4605474,6
2020-11-09-170225,170225,2,0,0,438,2.375,3.2461736,0
2020-11-10-170225,170225,10,1,0,448,2.25,3.4387226,1
2020-11-11-170225,170225,8,1,0,456,3.5,5.301089,2
2020-11-12-170225,170225,6,1,0,462,3.75,5.6179514,3
2020-11-13-170225,170225,11,0,0,473,4.125,4.0069714,4
2020-03-01-170226,170226,0,0,0,0,0.0,4.6412612e-08,6
2020-03-02-170226,170226,0,0,1,0,0.125,0.00081127847,0
2020-03-03-170226,170226,0,0,1,0,0.25,0.006720761,1
2020-03-04-170226,170226,0,0,2,0,0.125,0.010270646,2
2020-03-05-170226,170226,0,0,1,0,0.0,0.0027272212,3
2020-03-06-170226,170226,0,0,0,0,0.125,0.013384782,4
2020-03-07-170226,170226,0,0,1,0,0.0,0.0044695195,5
2020-03-08-170226,170226,0,0,2,0,0.0,0.0007323466,6
2020-03-09-170226,170226,0,0,3,0,0.5,0.15660289,0
2020-03-10-170226,170226,0,0,1,0,0.25,0.04148568,1
2020-03-11-170226,170226,0,0,1,0,0.25,0.07967935,2
2020-03-12-170226,170226,2,0,1,2,0.5,1.2783062,3
2020-03-13-170226,170226,2,0,1,4,0.875,1.2297983,4
2020-03-14-170226,170226,0,0,0,4,2.25,0.21536155,5
2020-03-15-170226,170226,0,0,0,4,0.625,0.076845735,6
2020-03-16-170226,170226,1,0,1,5,2.5,0.3244319,0
2020-03-17-170226,170226,1,0,4,6,4.125,0.84049064,1
2020-03-18-170226,170226,2,0,2,8,4.125,1.2796892,2
2020-03-19-170226,170226,1,0,2,9,6.25,1.3233473,3
2020-03-20-170226,170226,0,0,0,9,5.125,0.7086094,4
2020-03-21-170226,170226,1,0,1,10,2.5,0.7054946,5
2020-03-22-170226,170226,2,0,0,12,2.0,0.84633815,6
2020-03-23-170226,170226,3,0,0,15,10.25,2.375335,0
2020-03-24-170226,170226,1,0,0,16,6.375,1.3117458,1
2020-03-25-170226,170226,1,0,1,17,7.0,1.0993173,2
2020-03-26-170226,170226,1,0,0,18,5.25,0.5891953,3
2020-03-27-170226,170226,1,0,1,19,5.25,1.6106315,4
2020-03-28-170226,170226,0,0,0,19,2.375,0.08342842,5
2020-03-29-170226,170226,0,0,1,19,1.375,0.1332538,6
2020-03-30-170226,170226,1,0,0,20,6.5,1.0419087,0
2020-03-31-170226,170226,4,0,1,24,3.625,1.3194381,1
2020-04-01-170226,170226,2,1,1,26,4.875,1.005604,2
2020-04-02-170226,170226,2,0,7,28,3.125,0.716702,3
2020-04-03-170226,170226,0,0,1,28,3.625,0.41448534,4
2020-04-04-170226,170226,1,0,0,29,0.5,0.2420903,5
2020-04-05-170226,170226,0,0,0,29,1.5,0.05913144,6
2020-04-06-170226,170226,0,0,0,29,2.75,0.26152325,0
2020-04-07-170226,170226,0,0,1,29,3.0,0.22212201,1
2020-04-08-170226,170226,1,1,1,30,3.375,0.94664663,2
2020-04-09-170226,170226,0,0,2,30,5.125,0.30624533,3
2020-04-10-170226,170226,1,0,0,31,3.0,0.3901851,4
2020-04-11-170226,170226,0,0,1,31,1.125,0.069153816,5
2020-04-12-170226,170226,1,0,0,32,1.5,0.14224988,6
2020-04-13-170226,170226,0,0,0,32,2.5,0.29792565,0
2020-04-14-170226,170226,1,0,1,33,2.125,0.579741,1
2020-04-15-170226,170226,1,0,1,34,3.5,0.74936,2
2020-04-16-170226,170226,7,0,3,41,2.0,1.6446568,3
2020-04-17-170226,170226,1,0,1,42,3.75,0.6701133,4
2020-04-18-170226,170226,0,0,0,42,0.125,0.01723301,5
2020-04-19-170226,170226,0,0,1,42,1.5,0.09605667,6
2020-04-20-170226,170226,0,0,1,42,2.125,0.4732858,0
2020-04-21-170226,170226,1,2,0,43,1.75,0.5582827,1
2020-04-22-170226,170226,1,0,1,44,0.625,0.35391352,2
2020-04-23-170226,170226,2,1,0,46,0.25,0.007402572,3
2020-04-24-170226,170226,0,0,0,46,1.25,0.22948885,4
2020-04-25-170226,170226,1,0,0,47,0.75,0.35457435,5
2020-04-26-170226,170226,0,0,0,47,0.625,0.015556148,6
2020-04-27-170226,170226,0,0,0,47,1.75,0.18176806,0
2020-04-28-170226,170226,1,0,0,48,1.25,0.7441914,1
2020-04-29-170226,170226,1,0,0,49,2.0,0.6919836,2
2020-04-30-170226,170226,3,0,0,52,0.625,1.1625407,3
2020-05-01-170226,170226,1,0,1,53,0.25,0.22142364,4
2020-05-02-170226,170226,0,0,0,53,0.125,0.028097266,5
2020-05-03-170226,170226,1,0,0,54,0.25,0.2889859,6
2020-05-04-170226,170226,1,0,1,55,1.25,0.48115495,0
2020-05-05-170226,170226,0,0,0,55,0.875,0.22747667,1
2020-05-06-170226,170226,1,0,0,56,0.875,0.49282825,2
2020-05-07-170226,170226,0,0,0,56,1.125,0.14190976,3
2020-05-08-170226,170226,0,0,0,56,1.375,0.1398285,4
2020-05-09-170226,170226,0,0,0,56,0.0,0.0012715533,5
2020-05-10-170226,170226,0,0,0,56,0.125,0.0103633795,6
2020-05-11-170226,170226,0,1,0,56,0.875,0.12696633,0
2020-05-12-170226,170226,0,0,3,56,0.875,0.12992792,1
2020-05-13-170226,170226,0,0,0,56,2.375,0.30483592,2
2020-05-14-170226,170226,0,0,0,56,2.25,0.3172397,3
2020-05-15-170226,170226,1,0,0,57,1.125,0.57335395,4
2020-05-16-170226,170226,0,0,0,57,0.0,0.00089764793,5
2020-05-17-170226,170226,0,0,0,57,0.125,0.01949201,6
2020-05-18-170226,170226,1,0,0,58,2.0,0.23120047,0
2020-05-19-170226,170226,0,0,0,58,1.0,0.18982033,1
2020-05-20-170226,170226,0,0,0,58,1.25,0.16099569,2
2020-05-21-170226,170226,0,0,1,58,0.875,0.090740584,3
2020-05-22-170226,170226,0,0,0,58,0.875,0.09875592,4
2020-05-23-170226,170226,0,0,0,58,0.0,5.425673e-05,5
2020-05-24-170226,170226,0,0,0,58,0.0,0.0013920198,6
2020-05-25-170226,170226,0,0,0,58,1.375,0.2313065,0
2020-05-26-170226,170226,3,0,0,61,0.875,2.008239,1
2020-05-27-170226,170226,0,0,0,61,1.125,0.24315436,2
2020-05-28-170226,170226,0,2,0,61,0.625,0.10808924,3
2020-05-29-170226,170226,0,0,1,61,0.625,0.113003984,4
2020-05-30-170226,170226,0,0,0,61,0.0,0.003057645,5
2020-05-31-170226,170226,0,0,0,61,0.0,0.00050344056,6
2020-06-01-170226,170226,0,0,0,61,0.25,0.017709214,0
2020-06-02-170226,170226,0,1,1,61,0.75,0.16494115,1
2020-06-03-170226,170226,0,0,0,61,0.75,0.08545611,2
2020-06-04-170226,170226,1,0,0,62,0.625,0.55100715,3
2020-06-05-170226,170226,0,0,0,62,0.25,0.112976246,4
2020-06-06-170226,170226,0,0,0,62,0.25,0.10517046,5
2020-06-07-170226,170226,0,0,0,62,0.0,0.0013990925,6
2020-06-08-170226,170226,0,0,0,62,0.25,0.09328424,0
2020-06-09-170226,170226,0,0,0,62,0.5,0.13376573,1
2020-06-10-170226,170226,0,0,0,62,0.0,0.030438652,2
2020-06-11-170226,170226,0,0,0,62,0.25,0.053812213,3
2020-06-12-170226,170226,1,0,0,63,0.5,0.5270996,4
2020-06-13-170226,170226,0,0,0,63,0.0,0.017063206,5
2020-06-14-170226,170226,0,0,0,63,0.125,0.0019497705,6
2020-06-15-170226,170226,0,0,0,63,0.0,0.00044948974,0
2020-06-16-170226,170226,1,0,0,64,0.375,0.5929191,1
2020-06-17-170226,170226,0,0,0,64,0.25,0.089704715,2
2020-06-18-170226,170226,0,0,0,64,0.625,0.1259012,3
2020-06-19-170226,170226,0,0,0,64,0.25,0.07784532,4
2020-06-20-170226,170226,0,0,0,64,0.125,0.08319526,5
2020-06-21-170226,170226,0,0,0,64,0.125,0.0046098814,6
2020-06-22-170226,170226,0,0,2,64,0.25,0.064460345,0
2020-06-23-170226,170226,0,0,0,64,0.375,0.10163262,1
2020-06-24-170226,170226,0,0,1,64,0.625,0.23385374,2
2020-06-25-170226,170226,0,0,0,64,0.375,0.09662484,3
2020-06-26-170226,170226,0,0,0,64,0.5,0.16492997,4
2020-06-27-170226,170226,0,0,0,64,0.25,0.07461269,5
2020-06-28-170226,170226,0,0,0,64,0.0,0.016867356,6
2020-06-29-170226,170226,0,0,0,64,0.125,0.0197545,0
2020-06-30-170226,170226,0,0,0,64,0.25,0.08688724,1
2020-07-01-170226,170226,0,0,0,64,0.5,0.022607094,2
2020-07-02-170226,170226,0,0,1,64,0.125,0.08635081,3
2020-07-03-170226,170226,0,0,0,64,0.125,0.04579322,4
2020-07-04-170226,170226,0,0,0,64,0.0,0.001660411,5
2020-07-05-170226,170226,0,0,0,64,0.0,0.0002924606,6
2020-07-06-170226,170226,2,0,0,66,0.25,1.1979064,0
2020-07-07-170226,170226,0,0,0,66,0.625,0.18290529,1
2020-07-08-170226,170226,1,0,1,67,0.0,0.5933424,2
2020-07-09-170226,170226,0,0,0,67,0.25,0.053805906,3
2020-07-10-170226,170226,0,0,0,67,0.125,0.025692262,4
2020-07-11-170226,170226,0,0,0,67,0.0,0.0007346208,5
2020-07-12-170226,170226,0,0,1,67,0.25,0.10034985,6
2020-07-13-170226,170226,0,0,0,67,0.25,0.086692534,0
2020-07-14-170226,170226,0,0,0,67,0.5,0.18031338,1
2020-07-15-170226,170226,0,0,0,67,0.375,0.064897,2
2020-07-16-170226,170226,1,0,1,68,0.375,0.6034521,3
2020-07-17-170226,170226,0,0,0,68,0.375,0.085293226,4
2020-07-18-170226,170226,0,0,0,68,0.125,0.028924108,5
2020-07-19-170226,170226,0,0,0,68,0.125,0.09308407,6
2020-07-20-170226,170226,0,0,0,68,0.25,0.05976577,0
2020-07-21-170226,170226,0,0,0,68,0.125,0.062487002,1
2020-07-22-170226,170226,1,0,0,69,0.0,0.5838186,2
2020-07-23-170226,170226,0,0,0,69,0.125,0.06913612,3
2020-07-24-170226,170226,0,0,0,69,0.375,0.09218892,4
2020-07-25-170226,170226,0,0,2,69,0.125,0.032031596,5
2020-07-26-170226,170226,1,0,0,70,0.25,0.06760758,6
2020-07-27-170226,170226,0,0,3,70,0.625,0.19366147,0
2020-07-28-170226,170226,0,0,1,70,0.375,0.07163638,1
2020-07-29-170226,170226,0,0,3,70,0.875,0.2993495,2
2020-07-30-170226,170226,1,0,4,71,1.0,0.38050756,3
2020-07-31-170226,170226,0,0,6,71,1.0,0.33906534,4
2020-08-01-170226,170226,0,0,0,71,0.75,0.28169757,5
2020-08-02-170226,170226,0,0,5,71,0.5,0.64711267,6
2020-08-03-170226,170226,0,0,1,71,1.375,0.2431643,0
2020-08-04-170226,170226,0,0,2,71,3.5,1.011255,1
2020-08-05-170226,170226,0,0,3,71,4.5,1.303642,2
2020-08-06-170226,170226,0,0,4,71,3.25,0.7397341,3
2020-08-07-170226,170226,0,0,4,71,3.125,0.38616687,4
2020-08-08-170226,170226,2,0,7,73,2.0,2.030232,5
2020-08-09-170226,170226,0,0,0,73,2.75,0.43239173,6
2020-08-10-170226,170226,3,0,1,76,5.0,3.1630695,0
2020-08-11-170226,170226,1,0,4,77,3.875,2.162489,1
2020-08-12-170226,170226,3,0,1,80,4.25,2.258372,2
2020-08-13-170226,170226,4,0,0,84,3.5,9.01723,3
2020-08-14-170226,170226,6,0,0,90,2.875,6.26406,4
2020-08-15-170226,170226,0,0,2,90,2.5,0.9985469,5
2020-08-16-170226,170226,5,0,0,95,1.75,4.587858,6
2020-08-17-170226,170226,1,0,1,96,6.5,1.8303422,0
2020-08-18-170226,170226,2,0,0,98,5.0,2.202885,1
2020-08-19-170226,170226,3,0,3,101,3.5,1.8435667,2
2020-08-20-170226,170226,4,0,7,105,2.125,3.5054913,3
2020-08-21-170226,170226,4,0,2,109,4.125,5.684164,4
2020-08-22-170226,170226,7,0,2,116,2.0,7.1184144,5
2020-08-23-170226,170226,0,0,0,116,1.875,0.84245104,6
2020-08-24-170226,170226,1,0,3,117,4.75,0.85745084,0
2020-08-25-170226,170226,4,0,3,121,2.5,3.7410283,1
2020-08-26-170226,170226,1,0,1,122,2.5,0.43982646,2
2020-08-27-170226,170226,0,0,2,122,2.75,0.32537138,3
2020-08-28-170226,170226,0,0,1,122,2.0,0.6458969,4
2020-08-29-170226,170226,2,0,0,124,0.5,2.3709304,5
2020-08-30-170226,170226,0,0,1,124,0.5,0.16394687,6
2020-08-31-170226,170226,1,0,1,125,0.5,0.78138703,0
2020-09-01-170226,170226,0,0,2,125,3.0,0.86504537,1
2020-09-02-170226,170226,3,0,2,128,1.875,2.7274835,2
2020-09-03-170226,170226,7,0,1,135,1.125,5.412927,3
2020-09-04-170226,170226,2,0,1,137,1.25,1.0345412,4
2020-09-05-170226,170226,2,0,0,139,1.0,0.22397281,5
2020-09-06-170226,170226,0,0,0,139,0.25,0.19455014,6
2020-09-07-170226,170226,3,0,1,142,2.375,2.0848265,0
2020-09-08-170226,170226,3,0,0,145,3.0,1.8257837,1
2020-09-09-170226,170226,1,0,0,146,1.875,1.065646,2
2020-09-10-170226,170226,2,0,1,148,5.25,2.202329,3
2020-09-11-170226,170226,1,0,0,149,4.125,1.4723595,4
2020-09-12-170226,170226,0,0,0,149,2.875,1.2001547,5
2020-09-13-170226,170226,1,0,0,150,2.125,1.3031071,6
2020-09-14-170226,170226,1,0,2,151,2.25,0.7999515,0
2020-09-15-170226,170226,2,0,1,153,6.375,2.669018,1
2020-09-16-170226,170226,2,0,1,155,3.375,1.2909358,2
2020-09-17-170226,170226,1,0,0,156,4.25,0.996319,3
2020-09-18-170226,170226,1,0,0,157,2.75,0.5212908,4
2020-09-19-170226,170226,0,0,0,157,1.375,0.101440065,5
2020-09-20-170226,170226,0,0,0,157,2.5,0.37105978,6
2020-09-21-170226,170226,1,0,0,158,3.875,0.87343514,0
2020-09-22-170226,170226,0,0,0,158,3.0,0.26627588,1
2020-09-23-170226,170226,0,0,3,158,3.5,0.80725527,2
2020-09-24-170226,170226,1,0,1,159,2.75,0.7762841,3
2020-09-25-170226,170226,0,0,1,159,2.625,0.62249535,4
2020-09-26-170226,170226,0,0,1,159,1.5,0.3591662,5
2020-09-27-170226,170226,0,0,0,159,0.625,0.6685241,6
2020-09-28-170226,170226,2,0,0,161,1.5,0.640829,0
2020-09-29-170226,170226,1,0,2,162,2.125,0.6600856,1
2020-09-30-170226,170226,1,0,6,163,2.25,0.7563638,2
2020-10-01-170226,170226,0,0,0,163,2.0,0.36982456,3
2020-10-02-170226,170226,0,0,5,163,2.25,0.42926162,4
2020-10-03-170226,170226,0,0,2,163,0.875,0.21233028,5
2020-10-04-170226,170226,0,0,0,163,1.375,0.21642715,6
2020-10-05-170226,170226,0,0,0,163,2.125,0.36100334,0
2020-10-06-170226,170226,0,0,2,163,3.0,0.5276231,1
2020-10-07-170226,170226,3,0,3,166,3.75,2.4891026,2
2020-10-08-170226,170226,1,0,4,167,2.375,1.003008,3
2020-10-09-170226,170226,1,0,1,168,2.875,1.464687,4
2020-10-10-170226,170226,1,0,2,169,1.375,0.4932907,5
2020-10-11-170226,170226,0,0,3,169,1.375,0.5040407,6
2020-10-12-170226,170226,0,0,7,169,2.625,0.40366828,0
2020-10-13-170226,170226,2,0,2,171,2.5,1.8408757,1
2020-10-14-170226,170226,6,0,26,177,4.0,3.2627647,2
2020-10-15-170226,170226,0,0,14,177,5.5,1.0209761,3
2020-10-16-170226,170226,5,0,13,182,5.5,3.0904887,4
2020-10-17-170226,170226,2,0,13,184,1.625,1.6606789,5
2020-10-18-170226,170226,0,0,7,184,2.25,0.47203714,6
2020-10-19-170226,170226,0,0,2,184,6.5,1.0170406,0
2020-10-20-170226,170226,2,0,4,186,4.75,1.6395807,1
2020-10-21-170226,170226,3,0,5,189,6.875,2.7133563,2
2020-10-22-170226,170226,4,0,3,193,7.0,2.5018363,3
2020-10-23-170226,170226,1,0,6,194,5.75,2.2979972,4
2020-10-24-170226,170226,2,0,2,196,3.125,2.0627863,5
2020-10-25-170226,170226,3,0,17,199,4.125,1.691598,6
2020-10-26-170226,170226,7,0,3,206,7.5,4.72357,0
2020-10-27-170226,170226,2,0,10,208,6.125,2.1710606,1
2020-10-28-170226,170226,26,0,0,234,7.5,13.408504,2
2020-10-29-170226,170226,14,1,9,248,6.125,5.100677,3
2020-10-30-170226,170226,13,1,5,261,7.875,5.678491,4
2020-10-31-170226,170226,13,0,0,274,4.0,7.735923,5
2020-11-01-170226,170226,7,0,0,281,3.875,3.4014184,6
2020-11-02-170226,170226,2,0,0,283,4.375,1.4871358,0
2020-11-03-170226,170226,4,1,0,287,6.625,3.151742,1
2020-11-04-170226,170226,5,2,0,292,5.125,3.5348034,2
2020-11-05-170226,170226,3,0,0,295,5.125,1.769408,3
2020-11-06-170226,170226,6,2,0,301,8.625,5.1533837,4
2020-11-07-170226,170226,2,0,0,303,3.125,1.069885,5
2020-11-08-170226,170226,17,0,0,320,6.5,6.2303133,6
2020-11-09-170226,170226,3,0,0,323,8.125,2.4810905,0
2020-11-10-170226,170226,10,1,0,333,6.0,7.216512,1
2020-11-11-170226,170226,0,0,0,333,5.0,1.0972476,2
2020-11-12-170226,170226,9,1,0,342,9.25,3.6625857,3
2020-11-13-170226,170226,5,1,0,347,7.75,3.5660162,4
2020-03-01-170227,170227,0,0,4,0,0.0,0.0007939381,6
2020-03-02-170227,170227,0,0,8,0,0.0,0.00796711,0
2020-03-03-170227,170227,1,0,10,1,0.0,0.009917416,1
2020-03-04-170227,170227,1,0,23,2,0.0,0.2545654,2
2020-03-05-170227,170227,0,0,27,2,0.2,0.0017776147,3
2020-03-06-170227,170227,0,0,27,2,0.4,0.26690665,4
2020-03-07-170227,170227,0,0,11,2,0.2,0.0032959701,5
2020-03-08-170227,170227,0,0,11,2,0.0,0.0030117002,6
2020-03-09-170227,170227,0,0,43,2,0.6,0.7732934,0
2020-03-10-170227,170227,3,0,29,5,0.6,0.03264238,1
2020-03-11-170227,170227,0,0,28,5,1.8,0.27904505,2
2020-03-12-170227,170227,1,0,21,6,1.4,0.09510484,3
2020-03-13-170227,170227,8,0,16,14,2.2,0.8867689,4
2020-03-14-170227,170227,2,0,6,16,1.8,0.960196,5
2020-03-15-170227,170227,4,0,5,20,2.6,0.38779157,6
2020-03-16-170227,170227,8,0,25,28,7.4,0.7268652,0
2020-03-17-170227,170227,10,0,6,38,8.2,1.5696075,1
2020-03-18-170227,170227,23,0,15,61,15.0,1.314681,2
2020-03-19-170227,170227,27,0,15,88,11.6,1.9881629,3
2020-03-20-170227,170227,27,0,15,115,16.6,2.8897161,4
2020-03-21-170227,170227,11,0,6,126,5.2,0.45570126,5
2020-03-22-170227,170227,11,2,3,137,8.6,0.5342415,6
2020-03-23-170227,170227,43,0,17,180,19.2,2.8432071,0
2020-03-24-170227,170227,29,0,12,209,13.6,1.9410526,1
2020-03-25-170227,170227,28,0,11,237,13.2,2.1269922,2
2020-03-26-170227,170227,21,0,6,258,13.4,1.5815089,3
2020-03-27-170227,170227,16,0,10,274,19.2,2.0752463,4
2020-03-28-170227,170227,6,0,3,280,6.0,0.23039076,5
2020-03-29-170227,170227,5,0,3,285,5.2,0.42594892,6
2020-03-30-170227,170227,25,0,11,310,16.0,2.1231718,0
2020-03-31-170227,170227,6,0,13,316,12.4,1.01908,1
2020-04-01-170227,170227,15,0,14,331,9.2,1.0418502,2
2020-04-02-170227,170227,15,0,7,346,9.8,1.2698877,3
2020-04-03-170227,170227,15,0,6,361,11.2,1.3987648,4
2020-04-04-170227,170227,6,0,0,367,4.6,0.015995072,5
2020-04-05-170227,170227,3,0,1,370,2.0,0.17979938,6
2020-04-06-170227,170227,17,0,10,387,4.6,1.0185131,0
2020-04-07-170227,170227,12,0,8,399,7.0,1.120781,1
2020-04-08-170227,170227,11,0,9,410,6.4,1.2730678,2
2020-04-09-170227,170227,6,0,4,416,9.6,2.0413916,3
2020-04-10-170227,170227,10,1,3,426,8.0,0.70597607,4
2020-04-11-170227,170227,3,0,4,429,9.2,0.3338448,5
2020-04-12-170227,170227,3,0,2,432,3.2,0.19579458,6
2020-04-13-170227,170227,11,0,4,443,9.0,1.2652316,0
2020-04-14-170227,170227,13,0,6,456,7.8,0.9101094,1
2020-04-15-170227,170227,14,0,7,470,13.0,1.8611305,2
2020-04-16-170227,170227,7,1,4,477,8.0,1.0147332,3
2020-04-17-170227,170227,6,0,3,483,14.6,0.61844426,4
2020-04-18-170227,170227,0,0,6,483,2.8,0.07005026,5
2020-04-19-170227,170227,1,0,2,484,6.4,0.61573964,6
2020-04-20-170227,170227,10,0,5,494,7.4,1.5615616,0
2020-04-21-170227,170227,8,1,6,502,7.6,0.8139749,1
2020-04-22-170227,170227,9,0,5,511,9.6,0.37321958,2
2020-04-23-170227,170227,4,0,4,515,2.6,0.012687876,3
2020-04-24-170227,170227,3,0,6,518,5.4,0.6855539,4
2020-04-25-170227,170227,4,0,0,522,1.6,0.14387126,5
2020-04-26-170227,170227,2,0,1,524,1.2,0.13047996,6
2020-04-27-170227,170227,4,0,10,528,6.6,0.7704926,0
2020-04-28-170227,170227,6,0,6,534,4.8,0.35539973,1
2020-04-29-170227,170227,7,0,11,541,5.8,0.96490663,2
2020-04-30-170227,170227,4,0,9,545,3.0,0.31719872,3
2020-05-01-170227,170227,3,0,6,548,0.8,0.004543578,4
2020-05-02-170227,170227,6,0,2,554,0.8,0.09493617,5
2020-05-03-170227,170227,2,0,0,556,0.4,0.00948131,6
2020-05-04-170227,170227,5,0,10,561,3.2,0.63684607,0
2020-05-05-170227,170227,6,0,5,567,2.4,0.59853876,1
2020-05-06-170227,170227,5,0,7,572,4.6,0.3440323,2
2020-05-07-170227,170227,4,0,3,576,2.0,0.3231218,3
2020-05-08-170227,170227,6,0,4,582,5.0,1.0526882,4
2020-05-09-170227,170227,0,0,1,582,0.0,0.0031607288,5
2020-05-10-170227,170227,1,0,0,583,0.6,0.0920351,6
2020-05-11-170227,170227,10,0,1,593,5.0,0.35360262,0
2020-05-12-170227,170227,6,0,9,599,3.6,0.5472266,1
2020-05-13-170227,170227,11,0,4,610,6.4,1.2513071,2
2020-05-14-170227,170227,9,0,3,619,7.4,1.3779472,3
2020-05-15-170227,170227,6,0,3,625,6.4,0.82234114,4
2020-05-16-170227,170227,2,0,0,627,1.4,0.0011438476,5
2020-05-17-170227,170227,0,0,0,627,0.2,0.0066788457,6
2020-05-18-170227,170227,10,0,6,637,5.2,0.9059841,0
2020-05-19-170227,170227,5,0,1,642,5.0,0.7709277,1
2020-05-20-170227,170227,7,0,5,649,5.0,0.4287693,2
2020-05-21-170227,170227,3,0,1,652,4.2,0.5172287,3
2020-05-22-170227,170227,4,0,3,656,3.8,0.4373475,4
2020-05-23-170227,170227,1,0,1,657,0.6,0.00025832935,5
2020-05-24-170227,170227,0,0,0,657,0.0,0.00021529557,6
2020-05-25-170227,170227,1,0,3,658,6.4,0.7591498,0
2020-05-26-170227,170227,9,0,3,667,3.6,0.4515832,1
2020-05-27-170227,170227,4,0,3,671,3.2,0.50049305,2
2020-05-28-170227,170227,3,3,0,674,2.4,0.7890564,3
2020-05-29-170227,170227,3,0,1,677,2.4,0.35080478,4
2020-05-30-170227,170227,0,0,0,677,0.0,0.0029198576,5
2020-05-31-170227,170227,0,0,0,677,0.0,0.006203427,6
2020-06-01-170227,170227,6,0,3,683,2.2,0.029775478,0
2020-06-02-170227,170227,1,0,2,684,2.2,0.61778635,1
2020-06-03-170227,170227,5,0,1,689,1.0,0.07957604,2
2020-06-04-170227,170227,1,0,0,690,2.8,0.25727987,3
2020-06-05-170227,170227,3,0,0,693,2.8,0.2864625,4
2020-06-06-170227,170227,1,0,1,694,0.8,0.060615443,5
2020-06-07-170227,170227,0,0,1,694,0.4,0.00026552624,6
2020-06-08-170227,170227,3,1,0,697,1.8,0.396497,0
2020-06-09-170227,170227,3,0,1,700,1.6,0.19326189,1
2020-06-10-170227,170227,3,0,1,703,2.2,0.07044768,2
2020-06-11-170227,170227,0,0,0,703,1.0,0.4073191,3
2020-06-12-170227,170227,1,0,2,704,1.4,0.50299114,4
2020-06-13-170227,170227,0,0,0,704,0.2,0.03385237,5
2020-06-14-170227,170227,0,0,0,704,0.2,0.0035116298,6
2020-06-15-170227,170227,3,0,1,707,1.2,0.018465599,0
2020-06-16-170227,170227,2,1,0,709,1.0,0.25599307,1
2020-06-17-170227,170227,1,0,0,710,1.2,0.45413312,2
2020-06-18-170227,170227,0,0,0,710,1.0,0.43134552,3
2020-06-19-170227,170227,0,0,1,710,0.2,0.022167806,4
2020-06-20-170227,170227,1,0,0,711,0.2,0.034356527,5
2020-06-21-170227,170227,1,0,0,712,0.0,0.033619627,6
2020-06-22-170227,170227,0,0,0,712,1.2,0.19339448,0
2020-06-23-170227,170227,1,0,0,713,1.0,0.6118297,1
2020-06-24-170227,170227,1,0,0,714,1.0,0.79735804,2
2020-06-25-170227,170227,0,0,0,714,0.8,0.18848981,3
2020-06-26-170227,170227,2,0,0,716,0.8,0.5063657,4
2020-06-27-170227,170227,0,0,0,716,0.2,0.31133062,5
2020-06-28-170227,170227,0,0,1,716,0.0,0.0023685112,6
2020-06-29-170227,170227,1,0,1,717,0.0,0.015585885,0
2020-06-30-170227,170227,0,0,1,717,0.6,0.4298564,1
2020-07-01-170227,170227,0,0,2,717,1.0,0.030523138,2
2020-07-02-170227,170227,0,0,2,717,0.0,0.031729866,3
2020-07-03-170227,170227,1,0,5,718,0.6,0.26176926,4
2020-07-04-170227,170227,0,0,2,718,0.2,0.0016542663,5
2020-07-05-170227,170227,0,0,0,718,0.4,0.0039152186,6
2020-07-06-170227,170227,0,0,2,718,0.2,0.07004298,0
2020-07-07-170227,170227,0,0,1,718,0.8,0.38931012,1
2020-07-08-170227,170227,0,0,2,718,0.4,0.05867184,2
2020-07-09-170227,170227,0,0,1,718,0.8,0.07784972,3
2020-07-10-170227,170227,0,0,1,718,0.8,0.025567431,4
2020-07-11-170227,170227,0,0,0,718,0.0,0.001453632,5
2020-07-12-170227,170227,1,1,0,719,0.4,0.22979268,6
2020-07-13-170227,170227,1,0,4,720,0.4,0.022765731,0
2020-07-14-170227,170227,1,0,2,721,0.8,0.21759962,1
2020-07-15-170227,170227,2,0,3,723,1.0,0.25512263,2
2020-07-16-170227,170227,2,0,2,725,0.6,0.0869573,3
2020-07-17-170227,170227,5,0,4,730,1.4,0.28183907,4
2020-07-18-170227,170227,2,0,2,732,0.8,0.15178838,5
2020-07-19-170227,170227,0,0,0,732,0.6,0.066127524,6
2020-07-20-170227,170227,2,0,4,734,0.8,0.17972952,0
2020-07-21-170227,170227,1,0,0,735,0.2,0.025664574,1
2020-07-22-170227,170227,2,0,4,737,0.6,0.03924937,2
2020-07-23-170227,170227,1,0,5,738,0.6,0.25856274,3
2020-07-24-170227,170227,1,0,2,739,1.0,0.031182844,4
2020-07-25-170227,170227,0,0,2,739,0.4,0.0099424515,5
2020-07-26-170227,170227,0,0,2,739,0.2,0.010769388,6
2020-07-27-170227,170227,4,0,4,743,2.2,0.74142694,0
2020-07-28-170227,170227,2,0,5,745,1.2,0.21440375,1
2020-07-29-170227,170227,3,0,7,748,1.4,0.7738723,2
2020-07-30-170227,170227,2,0,8,750,2.2,1.3537439,3
2020-07-31-170227,170227,4,0,9,754,3.6,1.1193172,4
2020-08-01-170227,170227,2,0,2,756,1.0,0.31717336,5
2020-08-02-170227,170227,0,0,2,756,0.4,1.5167333,6
2020-08-03-170227,170227,4,0,6,760,3.6,0.570539,0
2020-08-04-170227,170227,0,0,12,760,4.0,2.6135714,1
2020-08-05-170227,170227,4,0,7,764,4.0,2.5029817,2
2020-08-06-170227,170227,5,0,7,769,2.4,0.7749602,3
2020-08-07-170227,170227,2,0,7,771,1.4,0.92311376,4
2020-08-08-170227,170227,2,0,9,773,3.2,1.0883036,5
2020-08-09-170227,170227,2,0,0,775,0.8,0.14632192,6
2020-08-10-170227,170227,4,0,16,779,2.0,1.7850055,0
2020-08-11-170227,170227,5,0,8,784,3.0,1.4544756,1
2020-08-12-170227,170227,7,0,6,791,5.2,2.8313074,2
2020-08-13-170227,170227,8,0,9,799,3.4,2.0593636,3
2020-08-14-170227,170227,9,0,4,808,2.4,1.3930098,4
2020-08-15-170227,170227,2,0,1,810,2.2,0.57854646,5
2020-08-16-170227,170227,2,0,4,812,2.4,1.4414847,6
2020-08-17-170227,170227,6,0,5,818,2.2,1.2066791,0
2020-08-18-170227,170227,12,0,8,830,6.4,3.0364811,1
2020-08-19-170227,170227,7,0,8,837,3.2,1.327249,2
2020-08-20-170227,170227,7,0,6,844,2.0,1.5098784,3
2020-08-21-170227,170227,7,0,6,851,4.0,2.7920017,4
2020-08-22-170227,170227,9,0,5,860,1.8,1.4206543,5
2020-08-23-170227,170227,0,0,0,860,1.0,0.71327466,6
2020-08-24-170227,170227,16,0,9,876,7.2,1.9725698,0
2020-08-25-170227,170227,8,0,9,884,5.4,1.6230842,1
2020-08-26-170227,170227,6,0,12,890,3.4,0.99269974,2
2020-08-27-170227,170227,9,0,10,899,3.8,0.8514999,3
2020-08-28-170227,170227,4,0,9,903,3.2,1.7956316,4
2020-08-29-170227,170227,1,0,2,904,1.0,0.62543434,5
2020-08-30-170227,170227,4,0,10,908,2.2,0.26994097,6
2020-08-31-170227,170227,5,0,15,913,5.8,0.6352076,0
2020-09-01-170227,170227,8,0,17,921,5.4,4.5960107,1
2020-09-02-170227,170227,8,0,11,929,5.4,1.7437111,2
2020-09-03-170227,170227,6,0,21,935,8.0,0.75854415,3
2020-09-04-170227,170227,6,0,16,941,6.4,1.2838554,4
2020-09-05-170227,170227,5,0,0,946,3.2,0.29325983,5
2020-09-06-170227,170227,0,0,2,946,1.8,0.2909013,6
2020-09-07-170227,170227,9,0,17,955,5.2,1.0939137,0
2020-09-08-170227,170227,9,1,16,964,6.8,3.4335527,1
2020-09-09-170227,170227,12,0,21,976,3.8,1.1203333,2
2020-09-10-170227,170227,10,0,11,986,5.2,1.031205,3
2020-09-11-170227,170227,9,0,18,995,4.2,2.1249065,4
2020-09-12-170227,170227,2,0,0,997,3.0,1.3030466,5
2020-09-13-170227,170227,10,0,3,1007,2.8,0.8815063,6
2020-09-14-170227,170227,15,0,16,1022,5.8,1.1674261,0
2020-09-15-170227,170227,17,0,8,1039,9.0,4.2340016,1
2020-09-16-170227,170227,11,0,24,1050,5.6,1.8557738,2
2020-09-17-170227,170227,21,0,11,1071,8.2,1.1864069,3
2020-09-18-170227,170227,16,0,14,1087,7.6,2.0536425,4
2020-09-19-170227,170227,0,0,8,1087,2.2,0.044976924,5
2020-09-20-170227,170227,2,0,11,1089,2.8,0.68503606,6
2020-09-21-170227,170227,17,1,8,1106,8.4,1.4450953,0
2020-09-22-170227,170227,16,1,3,1122,8.4,1.3872529,1
2020-09-23-170227,170227,21,0,7,1143,10.4,2.1310105,2
2020-09-24-170227,170227,11,1,8,1154,6.4,0.7627344,3
2020-09-25-170227,170227,18,0,9,1172,7.8,2.5548239,4
2020-09-26-170227,170227,0,0,3,1172,0.2,0.7056537,5
2020-09-27-170227,170227,3,0,4,1175,1.6,0.4631762,6
2020-09-28-170227,170227,16,0,9,1191,4.8,1.466164,0
2020-09-29-170227,170227,8,0,25,1199,3.2,1.8883821,1
2020-09-30-170227,170227,24,0,15,1223,4.4,1.3619221,2
2020-10-01-170227,170227,11,0,24,1234,3.8,1.3433892,3
2020-10-02-170227,170227,14,0,19,1248,5.0,1.2290621,4
2020-10-03-170227,170227,8,0,8,1256,2.4,0.73225635,5
2020-10-04-170227,170227,11,1,8,1267,3.0,0.9152986,6
2020-10-05-170227,170227,8,1,30,1275,4.8,3.3721294,0
2020-10-06-170227,170227,3,0,30,1278,6.0,3.0666282,1
2020-10-07-170227,170227,7,0,17,1285,8.6,5.508775,2
2020-10-08-170227,170227,8,0,26,1293,8.4,1.6078125,3
2020-10-09-170227,170227,9,2,27,1302,16.6,3.4181013,4
2020-10-10-170227,170227,3,0,10,1305,2.2,0.60447234,5
2020-10-11-170227,170227,4,0,9,1309,5.0,0.7340865,6
2020-10-12-170227,170227,9,0,45,1318,6.0,1.1153473,0
2020-10-13-170227,170227,25,0,30,1343,10.8,1.7122506,1
2020-10-14-170227,170227,15,0,25,1358,8.0,3.9179475,2
2020-10-15-170227,170227,24,0,31,1382,13.2,5.577817,3
2020-10-16-170227,170227,19,0,30,1401,13.6,7.812706,4
2020-10-17-170227,170227,8,0,10,1409,2.8,1.4477153,5
2020-10-18-170227,170227,8,0,38,1417,2.0,0.85030776,6
2020-10-19-170227,170227,30,0,17,1447,15.4,5.1820474,0
2020-10-20-170227,170227,30,0,36,1477,14.2,3.5633955,1
2020-10-21-170227,170227,17,0,43,1494,15.6,5.0676713,2
2020-10-22-170227,170227,26,0,25,1520,12.0,5.997253,3
2020-10-23-170227,170227,27,1,74,1547,27.6,4.0902553,4
2020-10-24-170227,170227,10,0,16,1557,4.4,1.7753582,5
2020-10-25-170227,170227,9,0,23,1566,8.2,1.7205302,6
2020-10-26-170227,170227,45,0,37,1611,26.2,6.677192,0
2020-10-27-170227,170227,30,0,23,1641,20.4,5.47659,1
2020-10-28-170227,170227,25,1,16,1666,20.6,6.743767,2
2020-10-29-170227,170227,31,0,29,1697,20.4,4.3915796,3
2020-10-30-170227,170227,30,1,29,1727,17.4,6.7492557,4
2020-10-31-170227,170227,10,0,0,1737,7.8,2.4150503,5
2020-11-01-170227,170227,38,0,0,1775,13.6,1.8198264,6
2020-11-02-170227,170227,17,0,0,1792,8.6,2.5996168,0
2020-11-03-170227,170227,36,0,0,1828,20.4,4.9630303,1
2020-11-04-170227,170227,43,0,0,1871,17.8,5.0075154,2
2020-11-05-170227,170227,25,0,0,1896,18.4,3.9984322,3
2020-11-06-170227,170227,74,1,0,1970,26.2,5.276788,4
2020-11-07-170227,170227,16,2,0,1986,8.6,1.9375607,5
2020-11-08-170227,170227,23,0,0,2009,16.2,4.03707,6
2020-11-09-170227,170227,37,1,0,2046,23.6,6.7172046,0
2020-11-10-170227,170227,23,0,0,2069,15.6,4.162938,1
2020-11-11-170227,170227,16,2,0,2085,15.8,2.9590611,2
2020-11-12-170227,170227,29,1,0,2114,22.8,5.907583,3
2020-11-13-170227,170227,29,0,0,2143,25.0,4.4641323,4
2020-03-01-170228,170228,0,0,2,0,0.16666666666666666,7.2781666e-05,6
2020-03-02-170228,170228,0,0,6,0,0.0,0.0056829057,0
2020-03-03-170228,170228,0,0,10,0,0.16666666666666666,0.01480933,1
2020-03-04-170228,170228,0,0,26,0,0.16666666666666666,0.2625905,2
2020-03-05-170228,170228,1,0,8,1,0.3333333333333333,0.0011536445,3
2020-03-06-170228,170228,1,0,18,2,0.16666666666666666,0.27917543,4
2020-03-07-170228,170228,0,0,5,2,0.16666666666666666,0.0052896203,5
2020-03-08-170228,170228,0,0,7,2,0.16666666666666666,0.004201801,6
2020-03-09-170228,170228,0,0,26,2,0.6666666666666666,0.7027662,0
2020-03-10-170228,170228,0,0,13,2,2.333333333333333,0.032709677,1
2020-03-11-170228,170228,1,0,19,3,1.8333333333333333,0.21637064,2
2020-03-12-170228,170228,0,0,18,3,1.3333333333333333,0.08096783,3
2020-03-13-170228,170228,3,0,19,6,3.6666666666666665,0.6665726,4
2020-03-14-170228,170228,0,0,12,6,2.0,0.9630886,5
2020-03-15-170228,170228,2,0,7,8,3.0,0.27595982,6
2020-03-16-170228,170228,6,0,19,14,9.0,0.5766736,0
2020-03-17-170228,170228,10,0,8,24,9.0,1.1813276,1
2020-03-18-170228,170228,26,0,11,50,16.5,1.2506393,2
2020-03-19-170228,170228,8,0,7,58,17.666666666666668,1.6355966,3
2020-03-20-170228,170228,18,0,13,76,21.5,2.5971048,4
2020-03-21-170228,170228,5,0,8,81,8.833333333333334,0.42212096,5
2020-03-22-170228,170228,7,0,4,88,9.333333333333334,0.44851705,6
2020-03-23-170228,170228,26,0,4,114,23.5,2.642157,0
2020-03-24-170228,170228,13,0,6,127,19.33333333333333,1.9880205,1
2020-03-25-170228,170228,19,0,5,146,16.5,1.876891,2
2020-03-26-170228,170228,18,0,5,164,13.833333333333336,1.4936798,3
2020-03-27-170228,170228,19,1,5,183,19.166666666666668,2.2867036,4
2020-03-28-170228,170228,12,0,21,195,5.333333333333333,0.21626854,5
2020-03-29-170228,170228,7,1,12,202,5.166666666666667,0.5003645,6
2020-03-30-170228,170228,19,0,10,221,16.333333333333332,1.6735859,0
2020-03-31-170228,170228,8,0,8,229,11.0,0.8838113,1
2020-04-01-170228,170228,11,0,34,240,10.166666666666666,0.86455405,2
2020-04-02-170228,170228,7,0,8,247,10.666666666666666,1.1646559,3
2020-04-03-170228,170228,13,0,58,260,11.833333333333336,1.1319448,4
2020-04-04-170228,170228,8,0,8,268,3.6666666666666665,0.016523398,5
2020-04-05-170228,170228,4,0,19,272,3.1666666666666665,0.18628387,6
2020-04-06-170228,170228,4,0,14,276,9.0,1.086691,0
2020-04-07-170228,170228,6,0,8,282,7.666666666666668,1.1852176,1
2020-04-08-170228,170228,5,5,31,287,8.0,1.2040963,2
2020-04-09-170228,170228,5,0,5,292,10.166666666666666,1.9691938,3
2020-04-10-170228,170228,5,1,9,297,7.833333333333332,0.73334664,4
2020-04-11-170228,170228,21,0,3,318,2.6666666666666665,0.341797,5
2020-04-12-170228,170228,12,0,0,330,1.5,0.16699825,6
2020-04-13-170228,170228,10,0,11,340,8.333333333333334,1.2257321,0
2020-04-14-170228,170228,8,0,7,348,8.0,0.7083642,1
2020-04-15-170228,170228,34,0,7,382,10.0,1.6593128,2
2020-04-16-170228,170228,8,0,5,390,7.333333333333332,0.842113,3
2020-04-17-170228,170228,58,0,2,448,5.833333333333332,0.514287,4
2020-04-18-170228,170228,8,0,0,456,1.6666666666666667,0.08861291,5
2020-04-19-170228,170228,19,0,2,475,3.333333333333333,0.6149628,6
2020-04-20-170228,170228,14,0,6,489,7.833333333333332,1.3157618,0
2020-04-21-170228,170228,8,1,5,497,6.166666666666668,0.5497849,1
2020-04-22-170228,170228,31,0,5,528,5.166666666666667,0.27106813,2
2020-04-23-170228,170228,5,0,2,533,2.6666666666666665,0.0048898733,3
2020-04-24-170228,170228,9,0,4,542,4.333333333333333,0.5940799,4
2020-04-25-170228,170228,3,0,0,545,1.5,0.17859444,5
2020-04-26-170228,170228,0,0,1,545,1.3333333333333333,0.15055928,6
2020-04-27-170228,170228,11,1,3,556,6.0,0.8222142,0
2020-04-28-170228,170228,7,0,2,563,5.0,0.309566,1
2020-04-29-170228,170228,7,0,6,570,5.0,0.77328426,2
2020-04-30-170228,170228,5,0,12,575,2.833333333333333,0.31933483,3
2020-05-01-170228,170228,2,0,7,577,1.1666666666666667,0.004391701,4
2020-05-02-170228,170228,0,0,0,577,1.5,0.11622049,5
2020-05-03-170228,170228,2,0,0,579,0.6666666666666666,0.0041435296,6
2020-05-04-170228,170228,6,0,5,585,3.0,0.63056445,0
2020-05-05-170228,170228,5,0,5,590,4.333333333333333,0.4799334,1
2020-05-06-170228,170228,5,0,4,595,4.166666666666667,0.36806917,2
2020-05-07-170228,170228,2,0,2,597,3.5,0.32324767,3
2020-05-08-170228,170228,4,0,6,601,4.5,1.0262307,4
2020-05-09-170228,170228,0,0,2,601,0.0,0.0020711718,5
2020-05-10-170228,170228,1,0,0,602,0.5,0.07437875,6
2020-05-11-170228,170228,3,0,12,605,4.666666666666667,0.37275153,0
2020-05-12-170228,170228,2,0,6,607,4.333333333333333,0.45036748,1
2020-05-13-170228,170228,6,1,4,613,7.333333333333332,1.102815,2
2020-05-14-170228,170228,12,0,2,625,7.5,1.3365356,3
2020-05-15-170228,170228,7,1,6,632,6.166666666666668,0.79675907,4
2020-05-16-170228,170228,0,0,0,632,1.6666666666666667,0.00010485929,5
2020-05-17-170228,170228,0,0,0,632,0.0,0.0025228213,6
2020-05-18-170228,170228,5,0,5,637,7.333333333333332,0.7583418,0
2020-05-19-170228,170228,5,0,3,642,5.166666666666667,0.6261359,1
2020-05-20-170228,170228,4,0,0,646,4.333333333333333,0.41322523,2
2020-05-21-170228,170228,2,0,3,648,3.8333333333333335,0.45158163,3
2020-05-22-170228,170228,6,0,3,654,4.0,0.3093836,4
2020-05-23-170228,170228,2,0,1,656,0.3333333333333333,8.0297854e-05,5
2020-05-24-170228,170228,0,0,2,656,0.0,4.991203e-05,6
2020-05-25-170228,170228,12,0,2,668,4.833333333333333,0.72029305,0
2020-05-26-170228,170228,6,0,1,674,3.1666666666666665,0.45177487,1
2020-05-27-170228,170228,4,0,2,678,3.6666666666666665,0.45179364,2
2020-05-28-170228,170228,2,0,0,680,2.333333333333333,0.82659453,3
2020-05-29-170228,170228,6,0,1,686,1.6666666666666667,0.28045696,4
2020-05-30-170228,170228,0,0,0,686,0.0,0.00048677667,5
2020-05-31-170228,170228,0,0,0,686,0.0,0.0031996614,6
2020-06-01-170228,170228,5,0,2,691,1.6666666666666667,0.024216248,0
2020-06-02-170228,170228,3,0,3,694,2.0,0.4499144,1
2020-06-03-170228,170228,0,0,1,694,1.8333333333333333,0.06641336,2
2020-06-04-170228,170228,3,0,3,697,2.5,0.23291619,3
2020-06-05-170228,170228,3,0,0,700,2.333333333333333,0.24181809,4
2020-06-06-170228,170228,1,0,0,701,1.0,0.04811173,5
2020-06-07-170228,170228,2,1,0,703,0.0,0.00010265291,6
2020-06-08-170228,170228,2,0,1,705,2.0,0.35874417,0
2020-06-09-170228,170228,1,0,1,706,1.5,0.17049348,1
2020-06-10-170228,170228,2,0,1,708,2.0,0.05562071,2
2020-06-11-170228,170228,0,2,3,708,1.3333333333333333,0.39619327,3
2020-06-12-170228,170228,1,0,0,709,1.3333333333333333,0.42651322,4
2020-06-13-170228,170228,0,0,0,709,0.0,0.025583412,5
2020-06-14-170228,170228,0,0,0,709,0.16666666666666666,0.0022988892,6
2020-06-15-170228,170228,2,0,0,711,1.3333333333333333,0.015409939,0
2020-06-16-170228,170228,3,0,1,714,0.6666666666666666,0.20815559,1
2020-06-17-170228,170228,1,0,1,715,1.0,0.4287206,2
2020-06-18-170228,170228,3,0,0,718,0.8333333333333334,0.35494897,3
2020-06-19-170228,170228,0,0,2,718,0.3333333333333333,0.0107034035,4
2020-06-20-170228,170228,0,0,0,718,0.3333333333333333,0.030100102,5
2020-06-21-170228,170228,0,0,0,718,0.16666666666666666,0.0271996,6
2020-06-22-170228,170228,1,0,0,719,0.8333333333333334,0.18216795,0
2020-06-23-170228,170228,1,0,1,720,0.6666666666666666,0.573426,1
2020-06-24-170228,170228,1,0,0,721,1.1666666666666667,0.6376466,2
2020-06-25-170228,170228,3,0,0,724,0.5,0.16358513,3
2020-06-26-170228,170228,0,0,1,724,1.1666666666666667,0.47737533,4
2020-06-27-170228,170228,0,0,0,724,0.16666666666666666,0.30776972,5
2020-06-28-170228,170228,0,0,0,724,0.0,0.0019655132,6
2020-06-29-170228,170228,0,0,0,724,0.16666666666666666,0.008432627,0
2020-06-30-170228,170228,1,0,0,725,0.3333333333333333,0.41148686,1
2020-07-01-170228,170228,1,0,1,726,0.6666666666666666,0.029687475,2
2020-07-02-170228,170228,0,0,0,726,0.0,0.030486923,3
2020-07-03-170228,170228,2,0,1,728,0.3333333333333333,0.26167625,4
2020-07-04-170228,170228,0,1,0,728,0.0,0.0008440587,5
2020-07-05-170228,170228,0,0,1,728,0.3333333333333333,0.0031345687,6
2020-07-06-170228,170228,0,0,0,728,0.0,0.060228135,0
2020-07-07-170228,170228,1,0,0,729,0.6666666666666666,0.33948776,1
2020-07-08-170228,170228,0,0,0,729,0.16666666666666666,0.0515197,2
2020-07-09-170228,170228,0,0,2,729,0.3333333333333333,0.07907356,3
2020-07-10-170228,170228,1,0,0,730,0.5,0.021835882,4
2020-07-11-170228,170228,0,0,0,730,0.16666666666666666,0.00065721764,5
2020-07-12-170228,170228,0,0,0,730,0.5,0.18712707,6
2020-07-13-170228,170228,0,0,3,730,0.6666666666666666,0.012773527,0
2020-07-14-170228,170228,0,0,2,730,0.8333333333333334,0.19433466,1
2020-07-15-170228,170228,1,0,1,731,2.833333333333333,0.25357428,2
2020-07-16-170228,170228,0,0,2,731,0.5,0.06177544,3
2020-07-17-170228,170228,1,0,4,732,2.1666666666666665,0.18502632,4
2020-07-18-170228,170228,0,0,0,732,1.3333333333333333,0.15149488,5
2020-07-19-170228,170228,1,0,0,733,0.3333333333333333,0.049713533,6
2020-07-20-170228,170228,0,0,6,733,1.1666666666666667,0.15984598,0
2020-07-21-170228,170228,0,0,0,733,0.5,0.023603452,1
2020-07-22-170228,170228,0,0,4,733,0.8333333333333334,0.040271968,2
2020-07-23-170228,170228,2,0,2,735,0.6666666666666666,0.25755906,3
2020-07-24-170228,170228,0,0,0,735,1.3333333333333333,0.019609962,4
2020-07-25-170228,170228,0,0,5,735,0.3333333333333333,0.0037800896,5
2020-07-26-170228,170228,0,0,3,735,0.5,0.0072709494,6
2020-07-27-170228,170228,3,0,4,738,2.6666666666666665,0.6760967,0
2020-07-28-170228,170228,2,0,1,740,1.5,0.19770433,1
2020-07-29-170228,170228,1,0,5,741,2.0,0.7049921,2
2020-07-30-170228,170228,2,0,2,743,3.333333333333333,1.3313909,3
2020-07-31-170228,170228,4,0,1,747,3.333333333333333,1.0758345,4
2020-08-01-170228,170228,0,0,2,747,1.0,0.3088681,5
2020-08-02-170228,170228,0,0,0,747,0.3333333333333333,1.0020746,6
2020-08-03-170228,170228,6,0,3,753,2.5,0.44679588,0
2020-08-04-170228,170228,0,0,4,753,4.0,2.0750058,1
2020-08-05-170228,170228,4,1,5,757,3.6666666666666665,1.9834496,2
2020-08-06-170228,170228,2,0,0,759,3.333333333333333,0.6245364,3
2020-08-07-170228,170228,0,0,3,759,1.8333333333333333,0.88576967,4
2020-08-08-170228,170228,5,0,2,764,2.1666666666666665,0.9789892,5
2020-08-09-170228,170228,3,0,3,767,1.0,0.10140457,6
2020-08-10-170228,170228,4,0,9,771,2.333333333333333,1.6746019,0
2020-08-11-170228,170228,1,0,6,772,4.166666666666667,1.2889781,1
2020-08-12-170228,170228,5,0,3,777,4.833333333333333,2.2681751,2
2020-08-13-170228,170228,2,0,5,779,4.0,1.7480426,3
2020-08-14-170228,170228,1,0,3,780,3.1666666666666665,1.3997934,4
2020-08-15-170228,170228,2,0,1,782,2.5,0.51210886,5
2020-08-16-170228,170228,0,0,4,782,2.1666666666666665,1.2885089,6
2020-08-17-170228,170228,3,0,8,785,2.6666666666666665,0.99296516,0
2020-08-18-170228,170228,4,0,7,789,7.166666666666668,2.596452,1
2020-08-19-170228,170228,5,0,10,794,2.833333333333333,1.1758783,2
2020-08-20-170228,170228,0,0,9,794,2.5,1.356466,3
2020-08-21-170228,170228,3,0,7,797,4.5,2.4745734,4
2020-08-22-170228,170228,2,0,2,799,2.5,1.1459886,5
2020-08-23-170228,170228,3,0,1,802,0.8333333333333334,0.50548404,6
2020-08-24-170228,170228,9,0,7,811,8.333333333333334,1.7758218,0
2020-08-25-170228,170228,6,0,8,817,6.166666666666668,1.3313236,1
2020-08-26-170228,170228,3,0,7,820,5.0,0.94549084,2
2020-08-27-170228,170228,5,0,7,825,4.5,0.8802219,3
2020-08-28-170228,170228,3,0,3,828,4.333333333333333,1.6089896,4
2020-08-29-170228,170228,1,0,6,829,1.0,0.5083203,5
2020-08-30-170228,170228,4,0,0,833,2.1666666666666665,0.2239597,6
2020-08-31-170228,170228,8,0,11,841,5.5,0.51881427,0
2020-09-01-170228,170228,7,0,10,848,5.5,4.2763586,1
2020-09-02-170228,170228,10,0,6,858,5.666666666666668,1.3798505,2
2020-09-03-170228,170228,9,0,13,867,6.0,0.71739364,3
2020-09-04-170228,170228,7,0,14,874,6.333333333333332,1.0968375,4
2020-09-05-170228,170228,2,0,5,876,3.6666666666666665,0.25275263,5
2020-09-06-170228,170228,1,0,1,877,2.0,0.18452378,6
2020-09-07-170228,170228,7,1,13,884,4.333333333333333,0.8596013,0
2020-09-08-170228,170228,8,0,7,892,8.5,2.3339403,1
2020-09-09-170228,170228,7,0,13,899,5.833333333333332,0.96372586,2
2020-09-10-170228,170228,7,0,8,906,10.0,0.89230543,3
2020-09-11-170228,170228,3,1,9,909,8.0,1.7894125,4
2020-09-12-170228,170228,6,0,0,915,2.1666666666666665,1.0777171,5
2020-09-13-170228,170228,0,0,2,915,3.8333333333333335,0.6374182,6
2020-09-14-170228,170228,11,0,4,926,6.666666666666668,1.1008284,0
2020-09-15-170228,170228,10,0,3,936,15.166666666666664,3.720269,1
2020-09-16-170228,170228,6,0,9,942,9.0,1.5439488,2
2020-09-17-170228,170228,13,0,4,955,12.333333333333336,1.0944132,3
2020-09-18-170228,170228,14,0,8,969,11.166666666666664,1.8801081,4
2020-09-19-170228,170228,5,0,2,974,2.1666666666666665,0.028873391,5
2020-09-20-170228,170228,1,0,7,975,2.0,0.49335614,6
2020-09-21-170228,170228,13,0,5,988,13.0,1.1980361,0
2020-09-22-170228,170228,7,0,8,995,12.833333333333336,1.2835656,1
2020-09-23-170228,170228,13,2,12,1008,14.0,1.8096138,2
2020-09-24-170228,170228,8,0,18,1016,8.333333333333334,0.65276164,3
2020-09-25-170228,170228,9,0,21,1025,11.333333333333336,2.2797701,4
2020-09-26-170228,170228,0,0,1,1025,0.16666666666666666,0.6724033,5
2020-09-27-170228,170228,2,0,8,1027,1.3333333333333333,0.3493994,6
2020-09-28-170228,170228,4,0,5,1031,8.833333333333334,1.2986083,0
2020-09-29-170228,170228,3,0,16,1034,4.166666666666667,1.780212,1
2020-09-30-170228,170228,9,0,11,1043,8.166666666666666,1.219559,2
2020-10-01-170228,170228,4,0,17,1047,7.666666666666668,1.0970466,3
2020-10-02-170228,170228,8,0,19,1055,11.666666666666664,1.1069674,4
2020-10-03-170228,170228,2,0,2,1057,3.333333333333333,0.700095,5
2020-10-04-170228,170228,7,0,4,1064,4.666666666666667,0.82503814,6
2020-10-05-170228,170228,5,2,22,1069,6.666666666666668,3.2565792,0
2020-10-06-170228,170228,8,0,15,1077,6.333333333333332,2.8971448,1
2020-10-07-170228,170228,12,2,13,1089,9.5,5.2002964,2
2020-10-08-170228,170228,18,0,11,1107,7.5,1.471683,3
2020-10-09-170228,170228,21,0,15,1128,17.833333333333332,3.0768218,4
2020-10-10-170228,170228,1,0,2,1129,3.0,0.5001737,5
2020-10-11-170228,170228,8,0,9,1137,5.166666666666667,0.69500375,6
2020-10-12-170228,170228,5,0,27,1142,7.0,0.912271,0
2020-10-13-170228,170228,16,0,15,1158,11.833333333333336,1.5755349,1
2020-10-14-170228,170228,11,0,17,1169,9.666666666666666,3.4284818,2
2020-10-15-170228,170228,17,0,22,1186,16.5,5.377427,3
2020-10-16-170228,170228,19,0,19,1205,14.5,7.7738495,4
2020-10-17-170228,170228,2,0,8,1207,3.6666666666666665,1.3301783,5
2020-10-18-170228,170228,4,0,9,1211,3.1666666666666665,0.6994254,6
2020-10-19-170228,170228,22,2,15,1233,18.33333333333333,4.9262357,0
2020-10-20-170228,170228,15,1,21,1248,14.5,3.479455,1
2020-10-21-170228,170228,13,0,33,1261,18.5,4.701508,2
2020-10-22-170228,170228,11,0,28,1272,17.666666666666668,5.40696,3
2020-10-23-170228,170228,15,0,38,1287,17.166666666666668,4.183569,4
2020-10-24-170228,170228,2,1,9,1289,7.166666666666668,1.7684276,5
2020-10-25-170228,170228,9,2,17,1298,8.0,1.4541086,6
2020-10-26-170228,170228,27,1,29,1325,29.33333333333333,6.3484144,0
2020-10-27-170228,170228,15,0,19,1340,20.33333333333333,5.0457325,1
2020-10-28-170228,170228,17,0,19,1357,21.166666666666668,5.6654644,2
2020-10-29-170228,170228,22,1,30,1379,15.833333333333336,3.6923525,3
2020-10-30-170228,170228,19,2,33,1398,22.0,5.8496037,4
2020-10-31-170228,170228,8,0,0,1406,10.333333333333334,2.1145983,5
2020-11-01-170228,170228,9,3,0,1415,22.5,1.6133423,6
2020-11-02-170228,170228,15,0,0,1430,11.166666666666664,2.3774734,0
2020-11-03-170228,170228,21,0,0,1451,24.0,4.4099355,1
2020-11-04-170228,170228,33,1,0,1484,21.66666666666667,4.806351,2
2020-11-05-170228,170228,28,0,0,1512,22.0,3.6810129,3
2020-11-06-170228,170228,38,1,0,1550,32.666666666666664,4.189896,4
2020-11-07-170228,170228,9,2,0,1559,11.5,1.9838265,5
2020-11-08-170228,170228,17,1,0,1576,17.666666666666668,3.1584823,6
2020-11-09-170228,170228,29,0,0,1605,26.83333333333333,6.3231854,0
2020-11-10-170228,170228,19,0,0,1624,21.0,3.9924219,1
2020-11-11-170228,170228,19,2,0,1643,16.5,2.5589185,2
2020-11-12-170228,170228,30,0,0,1673,22.16666666666667,5.197008,3
2020-11-13-170228,170228,33,2,0,1706,25.0,4.5384617,4
2020-03-01-170229,170229,0,0,0,0,0.0,9.925728e-10,6
2020-03-02-170229,170229,0,0,0,0,0.0,0.004436578,0
2020-03-03-170229,170229,0,0,0,0,0.0,0.008204632,1
2020-03-04-170229,170229,0,0,0,0,0.16666666666666666,0.019326322,2
2020-03-05-170229,170229,0,0,0,0,0.0,6.7421404e-08,3
2020-03-06-170229,170229,0,1,0,0,0.16666666666666666,0.01814616,4
2020-03-07-170229,170229,0,0,0,0,0.0,0.0072109057,5
2020-03-08-170229,170229,0,0,0,0,0.0,0.0007788239,6
2020-03-09-170229,170229,0,0,0,0,0.5,0.1258212,0
2020-03-10-170229,170229,0,0,0,0,0.0,0.014727016,1
2020-03-11-170229,170229,0,0,0,0,0.16666666666666666,0.06320476,2
2020-03-12-170229,170229,0,0,0,0,0.16666666666666666,0.027606117,3
2020-03-13-170229,170229,0,0,0,0,0.5,0.14390032,4
2020-03-14-170229,170229,0,0,0,0,0.6666666666666666,0.105554834,5
2020-03-15-170229,170229,0,0,0,0,0.5,0.047470875,6
2020-03-16-170229,170229,0,0,0,0,0.16666666666666666,0.06185111,0
2020-03-17-170229,170229,0,0,0,0,1.6666666666666667,0.17843363,1
2020-03-18-170229,170229,0,0,0,0,1.6666666666666667,0.36598405,2
2020-03-19-170229,170229,0,0,0,0,3.0,0.59194434,3
2020-03-20-170229,170229,0,0,0,0,4.166666666666667,0.5661004,4
2020-03-21-170229,170229,0,0,0,0,1.8333333333333333,0.22747162,5
2020-03-22-170229,170229,0,0,0,0,0.3333333333333333,0.05088098,6
2020-03-23-170229,170229,0,1,0,0,5.0,1.0070353,0
2020-03-24-170229,170229,0,0,0,0,5.166666666666667,1.0103652,1
2020-03-25-170229,170229,0,0,0,0,3.5,0.70523816,2
2020-03-26-170229,170229,0,0,0,0,4.5,0.53523815,3
2020-03-27-170229,170229,0,0,0,0,3.1666666666666665,0.51739305,4
2020-03-28-170229,170229,0,0,0,0,1.5,0.20767005,5
2020-03-29-170229,170229,0,0,0,0,0.8333333333333334,0.054088432,6
2020-03-30-170229,170229,0,0,0,0,3.5,0.57182294,0
2020-03-31-170229,170229,0,0,0,0,2.1666666666666665,0.4063554,1
2020-04-01-170229,170229,0,0,0,0,3.0,0.35696778,2
2020-04-02-170229,170229,0,0,0,0,3.0,0.66864514,3
2020-04-03-170229,170229,0,0,0,0,3.1666666666666665,0.71562064,4
2020-04-04-170229,170229,0,0,0,0,0.8333333333333334,0.053411853,5
2020-04-05-170229,170229,0,0,0,0,0.6666666666666666,0.05544419,6
2020-04-06-170229,170229,0,2,0,0,3.1666666666666665,0.45790005,0
2020-04-07-170229,170229,0,0,0,0,2.6666666666666665,0.4309482,1
2020-04-08-170229,170229,0,0,0,0,2.1666666666666665,0.18411835,2
2020-04-09-170229,170229,0,3,0,0,2.5,0.5163783,3
2020-04-10-170229,170229,0,0,0,0,1.3333333333333333,0.14484234,4
2020-04-11-170229,170229,0,0,0,0,1.3333333333333333,0.050706714,5
2020-04-12-170229,170229,0,0,0,0,0.16666666666666666,0.0037795121,6
2020-04-13-170229,170229,0,0,0,0,2.1666666666666665,0.44163814,0
2020-04-14-170229,170229,0,1,0,0,1.0,0.1929444,1
2020-04-15-170229,170229,0,0,0,0,1.0,0.24268092,2
2020-04-16-170229,170229,0,0,0,0,1.0,0.23445156,3
2020-04-17-170229,170229,0,0,0,0,1.0,0.1350571,4
2020-04-18-170229,170229,0,0,0,0,0.5,0.044798248,5
2020-04-19-170229,170229,0,0,0,0,0.6666666666666666,0.095084526,6
2020-04-20-170229,170229,0,0,0,0,1.6666666666666667,0.24653447,0
2020-04-21-170229,170229,0,0,0,0,0.8333333333333334,0.14922708,1
2020-04-22-170229,170229,0,0,0,0,0.8333333333333334,0.19301593,2
2020-04-23-170229,170229,0,0,0,0,0.0,0.0028825453,3
2020-04-24-170229,170229,0,0,0,0,0.6666666666666666,0.14189826,4
2020-04-25-170229,170229,0,0,0,0,0.6666666666666666,0.029726362,5
2020-04-26-170229,170229,0,0,0,0,0.6666666666666666,0.06840813,6
2020-04-27-170229,170229,0,0,0,0,1.0,0.1368475,0
2020-04-28-170229,170229,0,0,0,0,0.5,0.08699203,1
2020-04-29-170229,170229,0,0,0,0,0.5,0.11090119,2
2020-04-30-170229,170229,0,0,0,0,0.3333333333333333,0.03387187,3
2020-05-01-170229,170229,0,0,0,0,0.16666666666666666,0.041521873,4
2020-05-02-170229,170229,0,0,0,0,0.16666666666666666,0.011714348,5
2020-05-03-170229,170229,0,0,0,0,0.0,0.0008829203,6
2020-05-04-170229,170229,0,0,0,0,1.3333333333333333,0.18325506,0
2020-05-05-170229,170229,0,0,0,0,1.1666666666666667,0.20890668,1
2020-05-06-170229,170229,0,0,0,0,1.1666666666666667,0.16239566,2
2020-05-07-170229,170229,0,0,0,0,0.3333333333333333,0.046953704,3
2020-05-08-170229,170229,0,0,0,0,1.1666666666666667,0.13721651,4
2020-05-09-170229,170229,0,0,0,0,0.3333333333333333,0.0055468553,5
2020-05-10-170229,170229,0,0,0,0,0.3333333333333333,0.071949944,6
2020-05-11-170229,170229,0,0,0,0,1.1666666666666667,0.08465223,0
2020-05-12-170229,170229,0,0,0,0,0.6666666666666666,0.09647588,1
2020-05-13-170229,170229,0,0,0,0,1.8333333333333333,0.22698776,2
2020-05-14-170229,170229,0,0,0,0,1.5,0.21223316,3
2020-05-15-170229,170229,0,0,0,0,1.1666666666666667,0.16368467,4
2020-05-16-170229,170229,0,0,0,0,0.0,7.5751316e-08,5
2020-05-17-170229,170229,0,0,0,0,0.16666666666666666,0.002911128,6
2020-05-18-170229,170229,0,0,0,0,0.6666666666666666,0.18057445,0
2020-05-19-170229,170229,0,1,0,0,0.8333333333333334,0.04721714,1
2020-05-20-170229,170229,0,0,0,0,0.6666666666666666,0.11723402,2
2020-05-21-170229,170229,0,0,0,0,0.5,0.120338276,3
2020-05-22-170229,170229,0,0,0,0,1.0,0.10601717,4
2020-05-23-170229,170229,0,0,0,0,0.0,0.00068530766,5
2020-05-24-170229,170229,0,0,0,0,0.0,2.0392125e-07,6
2020-05-25-170229,170229,0,0,0,0,0.8333333333333334,0.21444742,0
2020-05-26-170229,170229,0,0,0,0,0.8333333333333334,0.051420785,1
2020-05-27-170229,170229,0,0,0,0,0.5,0.043899737,2
2020-05-28-170229,170229,0,2,0,0,0.8333333333333334,0.097649194,3
2020-05-29-170229,170229,0,0,0,0,0.5,0.10906885,4
2020-05-30-170229,170229,0,0,0,0,0.16666666666666666,0.00039002413,5
2020-05-31-170229,170229,0,0,0,0,0.5,0.0014232881,6
2020-06-01-170229,170229,0,0,0,0,0.3333333333333333,0.13124427,0
2020-06-02-170229,170229,0,0,0,0,1.3333333333333333,0.06905131,1
2020-06-03-170229,170229,0,0,0,0,0.5,0.090752214,2
2020-06-04-170229,170229,0,0,0,0,0.8333333333333334,0.09797636,3
2020-06-05-170229,170229,0,0,0,0,0.6666666666666666,0.08728334,4
2020-06-06-170229,170229,0,0,0,0,0.16666666666666666,0.0045771264,5
2020-06-07-170229,170229,0,0,0,0,0.0,0.0006397339,6
2020-06-08-170229,170229,0,1,0,0,0.6666666666666666,0.095202096,0
2020-06-09-170229,170229,0,0,0,0,0.16666666666666666,0.008586705,1
2020-06-10-170229,170229,0,0,0,0,0.3333333333333333,0.16372325,2
2020-06-11-170229,170229,0,0,0,0,0.8333333333333334,0.099854164,3
2020-06-12-170229,170229,0,0,0,0,0.6666666666666666,0.20202404,4
2020-06-13-170229,170229,0,0,0,0,0.0,0.0068984265,5
2020-06-14-170229,170229,0,0,0,0,0.16666666666666666,0.009419576,6
2020-06-15-170229,170229,0,0,0,0,1.8333333333333333,0.016482554,0
2020-06-16-170229,170229,0,0,0,0,0.5,0.0901701,1
2020-06-17-170229,170229,0,1,0,0,0.3333333333333333,0.032248475,2
2020-06-18-170229,170229,0,0,0,0,0.16666666666666666,0.078412764,3
2020-06-19-170229,170229,0,0,0,0,0.16666666666666666,0.010810576,4
2020-06-20-170229,170229,0,0,0,0,0.0,0.0016710969,5
2020-06-21-170229,170229,0,0,0,0,0.3333333333333333,0.011254415,6
2020-06-22-170229,170229,0,0,0,0,0.0,0.008411044,0
2020-06-23-170229,170229,0,0,0,0,0.16666666666666666,0.04493233,1
2020-06-24-170229,170229,0,1,0,0,0.0,0.03300709,2
2020-06-25-170229,170229,0,0,0,0,0.0,0.00990485,3
2020-06-26-170229,170229,0,0,0,0,0.3333333333333333,0.04117858,4
2020-06-27-170229,170229,0,0,0,0,0.16666666666666666,0.039312854,5
2020-06-28-170229,170229,0,1,0,0,0.0,2.241543e-05,6
2020-06-29-170229,170229,0,0,0,0,0.0,0.0018449255,0
2020-06-30-170229,170229,0,0,0,0,0.3333333333333333,0.12566173,1
2020-07-01-170229,170229,0,0,0,0,0.3333333333333333,0.16486323,2
2020-07-02-170229,170229,0,0,0,0,0.0,0.0041365987,3
2020-07-03-170229,170229,0,0,0,0,0.8333333333333334,0.35894436,4
2020-07-04-170229,170229,0,0,0,0,0.16666666666666666,0.0009035906,5
2020-07-05-170229,170229,0,0,1,0,0.3333333333333333,0.0036114398,6
2020-07-06-170229,170229,0,0,0,0,1.0,0.018019091,0
2020-07-07-170229,170229,0,0,1,0,0.3333333333333333,0.033788797,1
2020-07-08-170229,170229,0,0,0,0,0.6666666666666666,0.17432608,2
2020-07-09-170229,170229,0,0,0,0,0.6666666666666666,0.1887024,3
2020-07-10-170229,170229,0,0,0,0,0.3333333333333333,0.09075718,4
2020-07-11-170229,170229,0,1,0,0,0.0,0.0015062125,5
2020-07-12-170229,170229,0,0,0,0,0.5,0.028304122,6
2020-07-13-170229,170229,0,0,0,0,0.0,0.00084401004,0
2020-07-14-170229,170229,0,0,0,0,0.3333333333333333,0.100369535,1
2020-07-15-170229,170229,0,0,0,0,0.8333333333333334,0.057744898,2
2020-07-16-170229,170229,0,0,0,0,0.0,0.08952146,3
2020-07-17-170229,170229,0,0,1,0,0.0,0.013995754,4
2020-07-18-170229,170229,0,0,0,0,0.3333333333333333,0.14628269,5
2020-07-19-170229,170229,1,0,1,1,0.0,0.118486695,6
2020-07-20-170229,170229,0,0,1,1,0.3333333333333333,0.021819536,0
2020-07-21-170229,170229,1,0,3,2,0.0,0.08423178,1
2020-07-22-170229,170229,0,0,1,2,0.16666666666666666,0.015162197,2
2020-07-23-170229,170229,0,0,0,2,0.16666666666666666,0.04481182,3
2020-07-24-170229,170229,0,0,1,2,0.3333333333333333,0.016114619,4
2020-07-25-170229,170229,0,0,0,2,0.6666666666666666,0.0089066615,5
2020-07-26-170229,170229,0,0,0,2,0.16666666666666666,0.006428439,6
2020-07-27-170229,170229,0,0,0,2,0.3333333333333333,0.064272396,0
2020-07-28-170229,170229,0,0,0,2,1.0,0.120305754,1
2020-07-29-170229,170229,0,0,0,2,1.0,0.15849315,2
2020-07-30-170229,170229,0,0,0,2,1.1666666666666667,0.15778776,3
2020-07-31-170229,170229,1,0,0,3,0.5,0.090390004,4
2020-08-01-170229,170229,0,0,0,3,0.16666666666666666,0.048801757,5
2020-08-02-170229,170229,1,0,0,4,0.8333333333333334,0.239608,6
2020-08-03-170229,170229,1,0,0,5,0.8333333333333334,0.25520363,0
2020-08-04-170229,170229,3,0,0,8,1.3333333333333333,0.6063666,1
2020-08-05-170229,170229,1,0,0,9,2.1666666666666665,0.83968043,2
2020-08-06-170229,170229,0,0,0,9,1.6666666666666667,0.44998708,3
2020-08-07-170229,170229,1,0,0,10,1.6666666666666667,0.39736748,4
2020-08-08-170229,170229,0,0,0,10,1.3333333333333333,0.31865135,5
2020-08-09-170229,170229,0,0,0,10,0.16666666666666666,0.120520145,6
2020-08-10-170229,170229,0,0,0,10,2.5,0.45751476,0
2020-08-11-170229,170229,0,0,0,10,2.833333333333333,0.35133618,1
2020-08-12-170229,170229,0,0,0,10,2.833333333333333,0.32905528,2
2020-08-13-170229,170229,0,0,0,10,2.1666666666666665,0.57326937,3
2020-08-14-170229,170229,0,0,0,10,1.5,0.15645751,4
2020-08-15-170229,170229,0,0,0,10,0.5,0.20536186,5
2020-08-16-170229,170229,0,0,0,10,1.0,0.2323997,6
2020-08-17-170229,170229,0,0,0,10,0.8333333333333334,0.24231265,0
2020-08-18-170229,170229,0,0,0,10,4.0,0.86537427,1
2020-08-19-170229,170229,0,0,0,10,2.333333333333333,0.58478177,2
2020-08-20-170229,170229,0,0,0,10,2.5,0.30402595,3
2020-08-21-170229,170229,0,0,0,10,2.1666666666666665,0.99921,4
2020-08-22-170229,170229,0,0,0,10,0.8333333333333334,0.27273902,5
2020-08-23-170229,170229,0,0,0,10,1.5,0.09097167,6
2020-08-24-170229,170229,0,0,0,10,2.833333333333333,0.60114807,0
2020-08-25-170229,170229,0,0,0,10,1.6666666666666667,0.34407562,1
2020-08-26-170229,170229,0,0,0,10,2.1666666666666665,0.19148906,2
2020-08-27-170229,170229,0,0,0,10,3.0,0.48175216,3
2020-08-28-170229,170229,0,0,2,10,3.8333333333333335,0.43620726,4
2020-08-29-170229,170229,0,0,2,10,0.6666666666666666,0.19750908,5
2020-08-30-170229,170229,0,0,0,10,1.3333333333333333,0.07300503,6
2020-08-31-170229,170229,0,0,0,10,2.1666666666666665,0.41009656,0
2020-09-01-170229,170229,0,0,0,10,2.833333333333333,0.41191286,1
2020-09-02-170229,170229,0,0,0,10,2.833333333333333,0.34714633,2
2020-09-03-170229,170229,0,0,1,10,1.3333333333333333,0.24305302,3
2020-09-04-170229,170229,0,0,0,10,1.0,0.20074935,4
2020-09-05-170229,170229,0,0,0,10,1.8333333333333333,0.62081593,5
2020-09-06-170229,170229,0,0,0,10,0.3333333333333333,0.16941339,6
2020-09-07-170229,170229,0,0,0,10,0.16666666666666666,0.07267503,0
2020-09-08-170229,170229,0,0,0,10,1.5,0.58541137,1
2020-09-09-170229,170229,0,0,0,10,0.8333333333333334,0.3373113,2
2020-09-10-170229,170229,0,0,0,10,1.5,0.18420663,3
2020-09-11-170229,170229,2,0,0,12,1.0,0.38452289,4
2020-09-12-170229,170229,2,0,0,14,0.6666666666666666,0.50243753,5
2020-09-13-170229,170229,0,0,0,14,0.8333333333333334,0.07356003,6
2020-09-14-170229,170229,0,0,0,14,3.333333333333333,0.1406504,0
2020-09-15-170229,170229,0,0,0,14,4.166666666666667,0.5286192,1
2020-09-16-170229,170229,0,0,0,14,3.0,0.21535085,2
2020-09-17-170229,170229,1,0,0,15,3.5,0.33751547,3
2020-09-18-170229,170229,0,0,0,15,3.8333333333333335,0.45783237,4
2020-09-19-170229,170229,0,0,0,15,2.0,0.043927822,5
2020-09-20-170229,170229,0,0,0,15,1.3333333333333333,0.041246872,6
2020-09-21-170229,170229,0,0,0,15,2.833333333333333,0.23045368,0
2020-09-22-170229,170229,0,0,0,15,2.833333333333333,0.29533514,1
2020-09-23-170229,170229,0,0,0,15,2.1666666666666665,0.17830357,2
2020-09-24-170229,170229,0,0,0,15,1.8333333333333333,0.116955325,3
2020-09-25-170229,170229,0,0,0,15,2.0,0.15879478,4
2020-09-26-170229,170229,0,0,0,15,1.6666666666666667,0.4956635,5
2020-09-27-170229,170229,0,0,0,15,1.0,0.09842091,6
2020-09-28-170229,170229,0,0,0,15,0.8333333333333334,0.22817615,0
2020-09-29-170229,170229,0,0,0,15,1.6666666666666667,0.20246364,1
2020-09-30-170229,170229,0,0,0,15,2.1666666666666665,0.31077275,2
2020-10-01-170229,170229,0,0,0,15,1.6666666666666667,0.23612379,3
2020-10-02-170229,170229,0,0,0,15,1.8333333333333333,0.20093922,4
2020-10-03-170229,170229,0,0,0,15,1.1666666666666667,0.08470609,5
2020-10-04-170229,170229,0,0,0,15,0.6666666666666666,0.1266566,6
2020-10-05-170229,170229,0,0,0,15,2.5,0.39977974,0
2020-10-06-170229,170229,0,0,0,15,3.5,0.4617366,1
2020-10-07-170229,170229,0,0,0,15,2.333333333333333,0.5513722,2
2020-10-08-170229,170229,0,0,0,15,1.8333333333333333,0.37267527,3
2020-10-09-170229,170229,0,0,0,15,2.333333333333333,0.25780535,4
2020-10-10-170229,170229,0,0,0,15,1.1666666666666667,0.102786355,5
2020-10-11-170229,170229,0,0,0,15,1.5,0.09659257,6
2020-10-12-170229,170229,0,0,1,15,1.0,0.12567174,0
2020-10-13-170229,170229,0,0,0,15,2.5,0.27037382,1
2020-10-14-170229,170229,0,0,0,15,3.8333333333333335,0.6192511,2
2020-10-15-170229,170229,0,0,0,15,3.0,0.78546816,3
2020-10-16-170229,170229,0,0,1,15,5.166666666666667,0.8367429,4
2020-10-17-170229,170229,0,0,0,15,3.1666666666666665,0.22628905,5
2020-10-18-170229,170229,0,0,0,15,3.8333333333333335,0.20395905,6
2020-10-19-170229,170229,0,0,0,15,2.833333333333333,0.5388099,0
2020-10-20-170229,170229,0,0,0,15,4.833333333333333,0.4798167,1
2020-10-21-170229,170229,0,0,0,15,5.5,0.737888,2
2020-10-22-170229,170229,0,0,0,15,9.833333333333334,0.7864762,3
2020-10-23-170229,170229,0,0,0,15,4.5,0.3976097,4
2020-10-24-170229,170229,0,0,2,15,4.0,0.31880507,5
2020-10-25-170229,170229,0,0,0,15,4.333333333333333,0.22237287,6
2020-10-26-170229,170229,1,0,0,16,4.833333333333333,0.5203047,0
2020-10-27-170229,170229,0,0,0,16,6.166666666666668,0.62812275,1
2020-10-28-170229,170229,0,0,0,16,5.666666666666668,0.87671965,2
2020-10-29-170229,170229,0,0,0,16,7.833333333333332,0.5881958,3
2020-10-30-170229,170229,1,0,0,17,4.5,0.7559195,4
2020-10-31-170229,170229,0,0,0,17,2.5,0.6105875,5
2020-11-01-170229,170229,0,0,0,17,2.833333333333333,0.2468584,6
2020-11-02-170229,170229,0,0,0,17,4.333333333333333,0.30150625,0
2020-11-03-170229,170229,0,0,0,17,3.8333333333333335,0.4461788,1
2020-11-04-170229,170229,0,0,0,17,4.5,0.54260373,2
2020-11-05-170229,170229,0,0,0,17,3.1666666666666665,0.47221,3
2020-11-06-170229,170229,0,0,0,17,4.0,0.4986424,4
2020-11-07-170229,170229,2,0,0,19,4.0,0.46249777,5
2020-11-08-170229,170229,0,0,0,19,4.166666666666667,0.39657834,6
2020-11-09-170229,170229,0,0,0,19,5.833333333333332,0.5450159,0
2020-11-10-170229,170229,0,0,0,19,4.166666666666667,0.569363,1
2020-11-11-170229,170229,0,0,0,19,3.333333333333333,0.5595282,2
2020-11-12-170229,170229,0,0,0,19,5.0,0.5875827,3
2020-11-13-170229,170229,0,0,0,19,6.166666666666668,0.7735772,4
2020-03-01-170230,170230,0,0,0,0,0.0,6.8527474e-06,6
2020-03-02-170230,170230,0,0,0,0,0.0,0.000119841214,0
2020-03-03-170230,170230,0,0,0,0,0.0,3.1981815e-06,1
2020-03-04-170230,170230,0,0,0,0,0.0,0.0043898844,2
2020-03-05-170230,170230,0,0,0,0,0.0,7.7481e-10,3
2020-03-06-170230,170230,0,0,0,0,0.0,0.0064255134,4
2020-03-07-170230,170230,0,0,0,0,0.0,0.0066376207,5
2020-03-08-170230,170230,0,0,0,0,0.0,0.0009864129,6
2020-03-09-170230,170230,0,0,0,0,0.25,0.05934302,0
2020-03-10-170230,170230,0,0,0,0,0.0,0.015419288,1
2020-03-11-170230,170230,0,0,0,0,0.0,0.032509245,2
2020-03-12-170230,170230,0,0,0,0,0.25,0.028993193,3
2020-03-13-170230,170230,0,0,0,0,0.25,0.07803385,4
2020-03-14-170230,170230,0,0,0,0,0.0,0.03604618,5
2020-03-15-170230,170230,0,0,0,0,0.5,0.016597336,6
2020-03-16-170230,170230,0,0,0,0,0.5,0.027347762,0
2020-03-17-170230,170230,0,0,0,0,0.5,0.05326682,1
2020-03-18-170230,170230,0,1,0,0,1.5,0.09680518,2
2020-03-19-170230,170230,0,0,0,0,1.5,0.19489788,3
2020-03-20-170230,170230,0,0,0,0,2.75,0.22986849,4
2020-03-21-170230,170230,0,0,0,0,0.25,0.065866165,5
2020-03-22-170230,170230,0,0,0,0,2.75,0.05818445,6
2020-03-23-170230,170230,0,0,1,0,1.5,0.36841404,0
2020-03-24-170230,170230,0,0,0,0,1.25,0.3264359,1
2020-03-25-170230,170230,0,0,0,0,2.25,0.26594648,2
2020-03-26-170230,170230,0,0,0,0,2.25,0.21877284,3
2020-03-27-170230,170230,0,0,0,0,1.75,0.17691576,4
2020-03-28-170230,170230,0,0,0,0,0.0,0.064650215,5
2020-03-29-170230,170230,0,0,0,0,0.25,0.00845527,6
2020-03-30-170230,170230,0,0,0,0,1.0,0.16627236,0
2020-03-31-170230,170230,0,0,0,0,1.25,0.14390469,1
2020-04-01-170230,170230,0,0,0,0,3.0,0.19042599,2
2020-04-02-170230,170230,0,0,0,0,0.5,0.17819166,3
2020-04-03-170230,170230,0,0,0,0,1.75,0.22321437,4
2020-04-04-170230,170230,0,0,0,0,1.0,0.039643887,5
2020-04-05-170230,170230,0,0,0,0,0.25,0.009813089,6
2020-04-06-170230,170230,1,0,0,1,1.25,0.18320175,0
2020-04-07-170230,170230,0,0,0,1,0.5,0.12210455,1
2020-04-08-170230,170230,0,4,0,1,1.75,0.05918637,2
2020-04-09-170230,170230,0,0,0,1,0.5,0.13514166,3
2020-04-10-170230,170230,0,0,0,1,1.25,0.04938972,4
2020-04-11-170230,170230,0,0,0,1,0.0,0.01750906,5
2020-04-12-170230,170230,0,0,0,1,0.25,0.005069148,6
2020-04-13-170230,170230,0,0,0,1,1.25,0.15372418,0
2020-04-14-170230,170230,0,0,0,1,0.75,0.07960895,1
2020-04-15-170230,170230,0,0,0,1,0.5,0.0827367,2
2020-04-16-170230,170230,0,0,0,1,0.5,0.08097541,3
2020-04-17-170230,170230,0,0,0,1,0.0,0.03471843,4
2020-04-18-170230,170230,0,0,0,1,0.0,0.012120264,5
2020-04-19-170230,170230,0,0,0,1,0.0,0.015167126,6
2020-04-20-170230,170230,0,0,0,1,0.75,0.09816602,0
2020-04-21-170230,170230,0,0,0,1,0.5,0.05381162,1
2020-04-22-170230,170230,0,0,0,1,0.75,0.082247175,2
2020-04-23-170230,170230,0,0,0,1,0.25,0.0061500035,3
2020-04-24-170230,170230,0,0,0,1,0.25,0.0446096,4
2020-04-25-170230,170230,0,0,0,1,0.25,0.007261077,5
2020-04-26-170230,170230,0,0,0,1,0.25,0.023357645,6
2020-04-27-170230,170230,0,0,0,1,0.0,0.035083182,0
2020-04-28-170230,170230,0,0,0,1,1.0,0.0529223,1
2020-04-29-170230,170230,0,0,0,1,0.25,0.028017653,2
2020-04-30-170230,170230,0,0,0,1,0.0,0.008561424,3
2020-05-01-170230,170230,0,0,0,1,0.5,0.015514866,4
2020-05-02-170230,170230,0,0,0,1,0.25,0.0066841985,5
2020-05-03-170230,170230,0,0,0,1,0.0,0.0003472867,6
2020-05-04-170230,170230,0,0,0,1,0.25,0.053526934,0
2020-05-05-170230,170230,0,0,0,1,0.0,0.055903524,1
2020-05-06-170230,170230,0,0,0,1,0.25,0.053537603,2
2020-05-07-170230,170230,0,0,0,1,0.25,0.030454846,3
2020-05-08-170230,170230,0,0,0,1,0.5,0.045496162,4
2020-05-09-170230,170230,0,0,0,1,0.25,0.005791777,5
2020-05-10-170230,170230,0,0,0,1,0.0,0.016404651,6
2020-05-11-170230,170230,0,0,0,1,0.5,0.032107767,0
2020-05-12-170230,170230,0,0,0,1,0.5,0.054828588,1
2020-05-13-170230,170230,0,0,0,1,1.0,0.08870266,2
2020-05-14-170230,170230,0,0,0,1,1.25,0.08986734,3
2020-05-15-170230,170230,0,1,0,1,0.75,0.053504996,4
2020-05-16-170230,170230,0,0,0,1,0.0,1.7935138e-08,5
2020-05-17-170230,170230,0,0,0,1,0.0,5.9061435e-06,6
2020-05-18-170230,170230,0,0,0,1,0.5,0.059958473,0
2020-05-19-170230,170230,0,0,0,1,0.0,0.017429506,1
2020-05-20-170230,170230,0,0,0,1,0.5,0.057737216,2
2020-05-21-170230,170230,0,0,0,1,0.25,0.039891753,3
2020-05-22-170230,170230,0,0,0,1,0.25,0.038171288,4
2020-05-23-170230,170230,0,0,0,1,0.25,0.006700215,5
2020-05-24-170230,170230,0,0,0,1,0.0,5.5860724e-08,6
2020-05-25-170230,170230,0,0,0,1,0.0,0.07213238,0
2020-05-26-170230,170230,0,0,0,1,1.25,0.04778823,1
2020-05-27-170230,170230,0,0,0,1,0.25,0.021939546,2
2020-05-28-170230,170230,0,0,0,1,0.75,0.03473981,3
2020-05-29-170230,170230,0,0,0,1,0.75,0.055291962,4
2020-05-30-170230,170230,0,0,0,1,0.0,6.693786e-06,5
2020-05-31-170230,170230,0,0,0,1,0.25,0.006204453,6
2020-06-01-170230,170230,0,0,0,1,0.75,0.06506265,0
2020-06-02-170230,170230,0,0,0,1,0.5,0.027179925,1
2020-06-03-170230,170230,0,0,0,1,0.5,0.04585205,2
2020-06-04-170230,170230,0,0,0,1,0.75,0.08894106,3
2020-06-05-170230,170230,0,0,0,1,0.25,0.03934941,4
2020-06-06-170230,170230,0,0,0,1,0.5,0.015254499,5
2020-06-07-170230,170230,0,0,0,1,0.25,0.005953654,6
2020-06-08-170230,170230,0,0,0,1,0.5,0.046130624,0
2020-06-09-170230,170230,0,1,0,1,0.0,0.00852355,1
2020-06-10-170230,170230,0,0,0,1,0.5,0.0720371,2
2020-06-11-170230,170230,0,0,0,1,0.0,0.040760268,3
2020-06-12-170230,170230,0,0,0,1,0.0,0.08572305,4
2020-06-13-170230,170230,0,0,0,1,0.0,5.7078555e-08,5
2020-06-14-170230,170230,0,0,0,1,0.5,0.014579951,6
2020-06-15-170230,170230,0,0,0,1,0.25,0.030907221,0
2020-06-16-170230,170230,0,0,0,1,0.75,0.04541394,1
2020-06-17-170230,170230,0,0,0,1,0.25,0.010464505,2
2020-06-18-170230,170230,0,0,0,1,0.0,0.0295688,3
2020-06-19-170230,170230,0,1,0,1,0.5,0.032879606,4
2020-06-20-170230,170230,0,0,0,1,0.0,4.5942747e-05,5
2020-06-21-170230,170230,0,0,0,1,0.25,0.008656194,6
2020-06-22-170230,170230,0,0,0,1,0.0,0.00081867905,0
2020-06-23-170230,170230,0,0,0,1,0.25,0.016123557,1
2020-06-24-170230,170230,0,0,0,1,0.25,0.018323837,2
2020-06-25-170230,170230,0,0,0,1,0.0,0.0013626092,3
2020-06-26-170230,170230,0,0,0,1,0.0,0.008671906,4
2020-06-27-170230,170230,0,0,0,1,0.0,0.005962729,5
2020-06-28-170230,170230,0,0,0,1,0.0,0.0018643679,6
2020-06-29-170230,170230,0,0,0,1,0.0,0.0020643082,0
2020-06-30-170230,170230,0,0,0,1,0.25,0.06256703,1
2020-07-01-170230,170230,0,0,0,1,0.0,0.061375707,2
2020-07-02-170230,170230,0,0,0,1,0.25,0.009516969,3
2020-07-03-170230,170230,0,0,0,1,0.0,0.16796568,4
2020-07-04-170230,170230,0,0,0,1,0.25,0.00017772085,5
2020-07-05-170230,170230,0,0,0,1,0.5,0.023164514,6
2020-07-06-170230,170230,0,0,0,1,0.5,0.026991252,0
2020-07-07-170230,170230,0,0,0,1,0.5,0.043572392,1
2020-07-08-170230,170230,0,1,0,1,0.25,0.10389368,2
2020-07-09-170230,170230,0,2,0,1,0.25,0.085950024,3
2020-07-10-170230,170230,0,0,0,1,0.25,0.068151034,4
2020-07-11-170230,170230,0,0,0,1,0.0,0.0016699317,5
2020-07-12-170230,170230,0,0,0,1,0.0,7.111414e-05,6
2020-07-13-170230,170230,0,0,0,1,0.0,1.4445502e-05,0
2020-07-14-170230,170230,0,1,0,1,0.25,0.07653832,1
2020-07-15-170230,170230,0,0,0,1,0.0,0.015085541,2
2020-07-16-170230,170230,0,0,0,1,0.25,0.04554337,3
2020-07-17-170230,170230,0,0,0,1,0.0,0.0020818315,4
2020-07-18-170230,170230,0,0,0,1,0.0,0.05643881,5
2020-07-19-170230,170230,0,0,0,1,0.0,0.03134197,6
2020-07-20-170230,170230,0,0,0,1,0.25,0.026630115,0
2020-07-21-170230,170230,0,0,0,1,0.0,0.023043646,1
2020-07-22-170230,170230,0,0,0,1,0.25,0.0379865,2
2020-07-23-170230,170230,0,0,0,1,0.0,0.007636696,3
2020-07-24-170230,170230,0,0,0,1,0.0,0.011175372,4
2020-07-25-170230,170230,0,0,0,1,0.25,0.022641761,5
2020-07-26-170230,170230,0,0,0,1,0.0,0.0087174475,6
2020-07-27-170230,170230,0,0,0,1,0.0,0.013894226,0
2020-07-28-170230,170230,0,0,0,1,0.5,0.07391077,1
2020-07-29-170230,170230,0,0,0,1,0.25,0.07429649,2
2020-07-30-170230,170230,0,0,0,1,0.0,0.026756253,3
2020-07-31-170230,170230,0,0,0,1,0.75,0.029144084,4
2020-08-01-170230,170230,0,0,0,1,0.5,0.06386713,5
2020-08-02-170230,170230,0,0,0,1,0.5,0.071013406,6
2020-08-03-170230,170230,0,0,0,1,1.25,0.16915289,0
2020-08-04-170230,170230,0,0,0,1,1.25,0.22192892,1
2020-08-05-170230,170230,0,0,2,1,2.75,0.355142,2
2020-08-06-170230,170230,0,0,0,1,1.75,0.27518693,3
2020-08-07-170230,170230,0,0,0,1,2.75,0.3972025,4
2020-08-08-170230,170230,0,0,0,1,0.25,0.10188663,5
2020-08-09-170230,170230,0,0,0,1,1.75,0.12847066,6
2020-08-10-170230,170230,0,0,1,1,1.0,0.21475439,0
2020-08-11-170230,170230,0,0,0,1,4.25,0.296557,1
2020-08-12-170230,170230,0,0,0,1,3.5,0.42722067,2
2020-08-13-170230,170230,0,0,0,1,3.0,0.4441337,3
2020-08-14-170230,170230,0,0,0,1,1.0,0.082867965,4
2020-08-15-170230,170230,0,0,0,1,0.75,0.110589474,5
2020-08-16-170230,170230,0,0,0,1,0.25,0.032162014,6
2020-08-17-170230,170230,0,0,0,1,1.0,0.17058913,0
2020-08-18-170230,170230,0,0,0,1,1.75,0.4041568,1
2020-08-19-170230,170230,2,0,0,3,3.25,0.5217675,2
2020-08-20-170230,170230,0,0,0,3,2.25,0.26552394,3
2020-08-21-170230,170230,0,0,0,3,5.0,0.7818527,4
2020-08-22-170230,170230,0,0,0,3,1.5,0.19220315,5
2020-08-23-170230,170230,0,0,0,3,1.25,0.037725013,6
2020-08-24-170230,170230,1,0,0,4,0.25,0.3028481,0
2020-08-25-170230,170230,0,0,0,4,0.75,0.13719141,1
2020-08-26-170230,170230,0,0,0,4,3.0,0.15341868,2
2020-08-27-170230,170230,0,0,0,4,1.75,0.18675013,3
2020-08-28-170230,170230,0,0,0,4,1.25,0.28847206,4
2020-08-29-170230,170230,0,0,0,4,0.75,0.114050165,5
2020-08-30-170230,170230,0,0,0,4,0.5,0.07651926,6
2020-08-31-170230,170230,0,0,0,4,1.5,0.23645678,0
2020-09-01-170230,170230,0,0,0,4,1.75,0.07092688,1
2020-09-02-170230,170230,0,0,0,4,1.25,0.19852519,2
2020-09-03-170230,170230,0,0,0,4,1.0,0.10889118,3
2020-09-04-170230,170230,0,0,0,4,0.75,0.118501686,4
2020-09-05-170230,170230,0,0,0,4,1.25,0.39493927,5
2020-09-06-170230,170230,0,0,0,4,0.25,0.0737205,6
2020-09-07-170230,170230,0,0,0,4,1.5,0.09439102,0
2020-09-08-170230,170230,0,0,0,4,0.5,0.23391697,1
2020-09-09-170230,170230,0,0,0,4,3.5,0.33866936,2
2020-09-10-170230,170230,0,0,0,4,1.25,0.09944799,3
2020-09-11-170230,170230,0,0,1,4,2.25,0.15926209,4
2020-09-12-170230,170230,0,0,0,4,1.0,0.18984903,5
2020-09-13-170230,170230,0,0,0,4,1.0,0.08433918,6
2020-09-14-170230,170230,0,0,0,4,2.0,0.14999646,0
2020-09-15-170230,170230,0,0,0,4,5.25,0.35748687,1
2020-09-16-170230,170230,0,0,0,4,1.75,0.11476317,2
2020-09-17-170230,170230,0,0,0,4,3.25,0.21829443,3
2020-09-18-170230,170230,0,0,0,4,1.75,0.2908375,4
2020-09-19-170230,170230,0,0,0,4,0.5,0.08447628,5
2020-09-20-170230,170230,0,0,0,4,1.75,0.026979128,6
2020-09-21-170230,170230,0,0,0,4,1.25,0.14957735,0
2020-09-22-170230,170230,0,0,0,4,1.75,0.1490799,1
2020-09-23-170230,170230,0,0,0,4,2.0,0.107215874,2
2020-09-24-170230,170230,0,0,0,4,3.0,0.14502744,3
2020-09-25-170230,170230,1,0,0,5,1.75,0.1496325,4
2020-09-26-170230,170230,0,0,0,5,0.0,0.2003629,5
2020-09-27-170230,170230,0,0,0,5,0.0,0.04465152,6
2020-09-28-170230,170230,0,0,0,5,1.0,0.15652655,0
2020-09-29-170230,170230,0,0,2,5,0.75,0.087377824,1
2020-09-30-170230,170230,0,0,0,5,1.0,0.20825452,2
2020-10-01-170230,170230,0,0,1,5,1.5,0.14568372,3
2020-10-02-170230,170230,0,0,0,5,1.0,0.15172553,4
2020-10-03-170230,170230,0,0,0,5,0.0,0.024828916,5
2020-10-04-170230,170230,0,0,0,5,0.25,0.066998444,6
2020-10-05-170230,170230,0,0,0,5,0.25,0.10320953,0
2020-10-06-170230,170230,0,0,0,5,2.5,0.25525627,1
2020-10-07-170230,170230,0,0,0,5,0.75,0.17509553,2
2020-10-08-170230,170230,0,0,0,5,0.5,0.15189487,3
2020-10-09-170230,170230,0,0,0,5,0.5,0.0731185,4
2020-10-10-170230,170230,0,0,0,5,0.25,0.043698333,5
2020-10-11-170230,170230,0,0,0,5,0.0,0.014440342,6
2020-10-12-170230,170230,0,0,0,5,0.25,0.027939152,0
2020-10-13-170230,170230,2,0,0,7,0.75,0.2052574,1
2020-10-14-170230,170230,0,0,0,7,0.5,0.2474266,2
2020-10-15-170230,170230,1,0,0,8,0.5,0.16915938,3
2020-10-16-170230,170230,0,0,0,8,1.5,0.31156054,4
2020-10-17-170230,170230,0,0,0,8,0.25,0.039768912,5
2020-10-18-170230,170230,0,0,3,8,1.5,0.11660203,6
2020-10-19-170230,170230,0,0,1,8,0.0,0.17207806,0
2020-10-20-170230,170230,0,0,0,8,1.75,0.1395687,1
2020-10-21-170230,170230,0,0,0,8,2.0,0.28816077,2
2020-10-22-170230,170230,0,0,1,8,3.5,0.30509338,3
2020-10-23-170230,170230,0,0,0,8,1.0,0.16546027,4
2020-10-24-170230,170230,0,0,0,8,1.0,0.079944514,5
2020-10-25-170230,170230,0,0,0,8,0.5,0.060747497,6
2020-10-26-170230,170230,0,0,0,8,1.25,0.15038037,0
2020-10-27-170230,170230,0,0,0,8,1.25,0.21941127,1
2020-10-28-170230,170230,0,0,0,8,4.25,0.5922182,2
2020-10-29-170230,170230,0,0,0,8,2.0,0.23435187,3
2020-10-30-170230,170230,0,0,0,8,2.25,0.33602223,4
2020-10-31-170230,170230,0,0,0,8,2.0,0.29729062,5
2020-11-01-170230,170230,3,0,0,11,2.25,0.32903692,6
2020-11-02-170230,170230,1,0,0,12,1.0,0.09415959,0
2020-11-03-170230,170230,0,0,0,12,3.0,0.37302405,1
2020-11-04-170230,170230,0,0,0,12,2.75,0.34577987,2
2020-11-05-170230,170230,1,0,0,13,2.75,0.33176282,3
2020-11-06-170230,170230,0,0,0,13,2.0,0.26553112,4
2020-11-07-170230,170230,0,0,0,13,0.75,0.20346123,5
2020-11-08-170230,170230,0,0,0,13,1.25,0.11383806,6
2020-11-09-170230,170230,0,0,0,13,4.0,0.39460418,0
2020-11-10-170230,170230,0,0,0,13,2.75,0.2896524,1
2020-11-11-170230,170230,0,0,0,13,3.0,0.33822265,2
2020-11-12-170230,170230,0,0,0,13,4.0,0.24089132,3
2020-11-13-170230,170230,0,0,0,13,4.0,0.33887208,4
2020-03-01-170231,170231,0,0,0,0,0.0,4.177187e-09,6
2020-03-02-170231,170231,0,0,0,0,0.0,0.0071182866,0
2020-03-03-170231,170231,0,0,0,0,0.0,0.012161756,1
2020-03-04-170231,170231,0,0,0,0,0.0,0.0087178955,2
2020-03-05-170231,170231,0,0,1,0,0.0,1.1220704e-08,3
2020-03-06-170231,170231,0,1,0,0,0.25,0.020238163,4
2020-03-07-170231,170231,0,0,0,0,1.75,0.07316142,5
2020-03-08-170231,170231,0,0,0,0,0.25,0.008734401,6
2020-03-09-170231,170231,0,0,0,0,0.75,0.17140666,0
2020-03-10-170231,170231,0,0,0,0,3.5,0.13898674,1
2020-03-11-170231,170231,0,0,1,0,0.5,0.09598624,2
2020-03-12-170231,170231,0,0,0,0,0.75,0.045864094,3
2020-03-13-170231,170231,0,0,0,0,1.75,0.25957626,4
2020-03-14-170231,170231,0,0,0,0,1.0,0.16391306,5
2020-03-15-170231,170231,0,0,0,0,1.0,0.08678903,6
2020-03-16-170231,170231,0,0,2,0,4.0,0.13181546,0
2020-03-17-170231,170231,0,0,0,0,3.0,0.30462298,1
2020-03-18-170231,170231,0,0,0,0,4.25,0.41861266,2
2020-03-19-170231,170231,1,0,0,1,6.25,0.88514996,3
2020-03-20-170231,170231,0,0,1,1,6.75,0.7320684,4
2020-03-21-170231,170231,0,0,0,1,3.25,0.42115366,5
2020-03-22-170231,170231,0,0,0,1,4.5,0.124714516,6
2020-03-23-170231,170231,0,0,0,1,9.5,1.5715942,0
2020-03-24-170231,170231,0,0,0,1,10.25,1.7130272,1
2020-03-25-170231,170231,1,1,0,2,8.75,1.4360186,2
2020-03-26-170231,170231,0,0,0,2,6.25,0.74414,3
2020-03-27-170231,170231,0,0,0,2,5.5,0.84563965,4
2020-03-28-170231,170231,0,0,0,2,2.0,0.48548532,5
2020-03-29-170231,170231,0,0,0,2,1.0,0.08118708,6
2020-03-30-170231,170231,2,0,0,4,7.75,1.0530528,0
2020-03-31-170231,170231,0,0,0,4,6.0,0.71414894,1
2020-04-01-170231,170231,0,0,0,4,4.5,0.5157228,2
2020-04-02-170231,170231,0,0,1,4,6.25,0.9409391,3
2020-04-03-170231,170231,1,0,0,5,6.5,1.0396087,4
2020-04-04-170231,170231,0,0,0,5,1.75,0.09645254,5
2020-04-05-170231,170231,0,0,0,5,0.5,0.10062495,6
2020-04-06-170231,170231,0,1,0,5,5.75,0.736769,0
2020-04-07-170231,170231,0,0,0,5,4.5,0.6438766,1
2020-04-08-170231,170231,0,0,0,5,2.75,0.28652358,2
2020-04-09-170231,170231,0,1,0,5,5.5,0.8293962,3
2020-04-10-170231,170231,0,0,0,5,2.5,0.18818392,4
2020-04-11-170231,170231,0,0,0,5,0.75,0.071796276,5
2020-04-12-170231,170231,0,0,0,5,0.25,0.0020633168,6
2020-04-13-170231,170231,0,0,0,5,3.5,0.5097366,0
2020-04-14-170231,170231,0,0,1,5,2.25,0.2848654,1
2020-04-15-170231,170231,0,0,0,5,3.75,0.3896362,2
2020-04-16-170231,170231,1,0,0,6,4.25,0.46987104,3
2020-04-17-170231,170231,0,0,0,6,2.75,0.21437816,4
2020-04-18-170231,170231,0,0,0,6,0.75,0.07216663,5
2020-04-19-170231,170231,0,0,0,6,0.5,0.1074077,6
2020-04-20-170231,170231,0,0,0,6,2.75,0.34024704,0
2020-04-21-170231,170231,0,0,0,6,2.75,0.22042608,1
2020-04-22-170231,170231,0,0,0,6,2.0,0.2850979,2
2020-04-23-170231,170231,0,0,0,6,0.75,0.014619572,3
2020-04-24-170231,170231,0,1,0,6,1.0,0.19460043,4
2020-04-25-170231,170231,0,0,0,6,0.25,0.0127406465,5
2020-04-26-170231,170231,0,0,0,6,1.0,0.09765619,6
2020-04-27-170231,170231,0,0,0,6,0.5,0.10445633,0
2020-04-28-170231,170231,1,0,1,7,3.25,0.17785485,1
2020-04-29-170231,170231,0,0,0,7,1.5,0.16360569,2
2020-04-30-170231,170231,0,0,1,7,1.0,0.048116412,3
2020-05-01-170231,170231,0,0,3,7,1.0,0.05716687,4
2020-05-02-170231,170231,0,0,0,7,1.0,0.023907023,5
2020-05-03-170231,170231,0,0,0,7,0.25,0.0062498264,6
2020-05-04-170231,170231,0,0,0,7,2.0,0.25034574,0
2020-05-05-170231,170231,0,0,0,7,2.5,0.31523153,1
2020-05-06-170231,170231,0,0,0,7,2.5,0.24554679,2
2020-05-07-170231,170231,0,0,0,7,3.5,0.16345017,3
2020-05-08-170231,170231,0,0,0,7,1.0,0.119897805,4
2020-05-09-170231,170231,0,0,0,7,0.25,0.001856206,5
2020-05-10-170231,170231,0,1,0,7,0.5,0.12789625,6
2020-05-11-170231,170231,0,1,0,7,2.75,0.16886401,0
2020-05-12-170231,170231,1,0,0,8,1.75,0.15058535,1
2020-05-13-170231,170231,0,0,0,8,3.5,0.2994081,2
2020-05-14-170231,170231,1,0,0,9,2.5,0.26365533,3
2020-05-15-170231,170231,3,1,2,12,1.5,0.2399161,4
2020-05-16-170231,170231,0,0,0,12,0.0,2.1498407e-08,5
2020-05-17-170231,170231,0,1,0,12,0.0,0.00097344484,6
2020-05-18-170231,170231,0,0,0,12,2.5,0.27348202,0
2020-05-19-170231,170231,0,0,0,12,0.5,0.048047412,1
2020-05-20-170231,170231,0,0,1,12,1.25,0.13130589,2
2020-05-21-170231,170231,0,0,0,12,1.5,0.16226059,3
2020-05-22-170231,170231,0,0,0,12,1.25,0.13701361,4
2020-05-23-170231,170231,0,0,0,12,0.25,0.001560542,5
2020-05-24-170231,170231,0,0,0,12,0.0,6.1290055e-05,6
2020-05-25-170231,170231,0,0,0,12,1.5,0.2714338,0
2020-05-26-170231,170231,0,0,0,12,2.0,0.07412496,1
2020-05-27-170231,170231,0,0,2,12,1.5,0.07767339,2
2020-05-28-170231,170231,0,1,0,12,1.0,0.052303992,3
2020-05-29-170231,170231,2,0,0,14,0.75,0.18055303,4
2020-05-30-170231,170231,0,0,0,14,0.0,3.5393063e-05,5
2020-05-31-170231,170231,0,0,1,14,0.25,0.0016663092,6
2020-06-01-170231,170231,0,0,0,14,2.5,0.24647745,0
2020-06-02-170231,170231,0,0,1,14,1.0,0.043581538,1
2020-06-03-170231,170231,1,0,0,15,0.75,0.13759662,2
2020-06-04-170231,170231,0,0,0,15,1.75,0.15826365,3
2020-06-05-170231,170231,0,0,0,15,0.75,0.11757116,4
2020-06-06-170231,170231,0,0,0,15,0.5,0.0061668097,5
2020-06-07-170231,170231,0,0,0,15,0.25,0.0013257018,6
2020-06-08-170231,170231,0,0,0,15,0.75,0.109022014,0
2020-06-09-170231,170231,0,0,0,15,0.0,0.00346672,1
2020-06-10-170231,170231,2,3,1,17,0.75,0.2512197,2
2020-06-11-170231,170231,0,0,0,17,0.5,0.10219056,3
2020-06-12-170231,170231,0,0,0,17,0.75,0.26667723,4
2020-06-13-170231,170231,0,0,0,17,0.0,0.0006874844,5
2020-06-14-170231,170231,1,0,0,18,0.25,0.026770677,6
2020-06-15-170231,170231,0,0,0,18,0.0,0.0029625841,0
2020-06-16-170231,170231,1,0,0,19,0.75,0.112049535,1
2020-06-17-170231,170231,0,0,0,19,0.25,0.012204407,2
2020-06-18-170231,170231,0,0,0,19,0.25,0.09466533,3
2020-06-19-170231,170231,0,0,0,19,0.25,0.004766664,4
2020-06-20-170231,170231,0,0,0,19,0.0,0.0018804729,5
2020-06-21-170231,170231,0,0,0,19,0.25,0.012001535,6
2020-06-22-170231,170231,0,0,1,19,0.0,0.0040329923,0
2020-06-23-170231,170231,0,0,0,19,0.25,0.01732436,1
2020-06-24-170231,170231,1,0,0,20,0.0,0.03983766,2
2020-06-25-170231,170231,0,0,0,20,0.25,0.0025336118,3
2020-06-26-170231,170231,0,1,0,20,0.5,0.039841987,4
2020-06-27-170231,170231,0,0,0,20,0.0,0.012920527,5
2020-06-28-170231,170231,0,0,0,20,0.0,2.030486e-07,6
2020-06-29-170231,170231,0,0,0,20,0.0,0.013627592,0
2020-06-30-170231,170231,0,0,0,20,0.5,0.13681202,1
2020-07-01-170231,170231,0,0,0,20,0.75,0.2527355,2
2020-07-02-170231,170231,0,0,0,20,0.25,0.0058335187,3
2020-07-03-170231,170231,0,0,0,20,1.0,0.48326823,4
2020-07-04-170231,170231,0,0,0,20,0.25,6.416306e-06,5
2020-07-05-170231,170231,0,0,0,20,0.5,0.006168568,6
2020-07-06-170231,170231,1,0,0,21,0.25,0.049071282,0
2020-07-07-170231,170231,0,0,0,21,0.25,0.010461691,1
2020-07-08-170231,170231,0,0,0,21,0.75,0.25774953,2
2020-07-09-170231,170231,0,0,0,21,1.0,0.26324773,3
2020-07-10-170231,170231,0,0,0,21,0.25,0.12643164,4
2020-07-11-170231,170231,0,0,0,21,0.25,0.0142663885,5
2020-07-12-170231,170231,0,0,0,21,0.0,0.0041964035,6
2020-07-13-170231,170231,0,0,0,21,0.0,0.0019751883,0
2020-07-14-170231,170231,0,0,0,21,0.25,0.12876713,1
2020-07-15-170231,170231,0,0,0,21,0.0,0.022280997,2
2020-07-16-170231,170231,0,0,0,21,0.5,0.15735324,3
2020-07-17-170231,170231,0,0,1,21,0.0,0.005751865,4
2020-07-18-170231,170231,0,0,0,21,0.25,0.19751845,5
2020-07-19-170231,170231,0,0,0,21,0.0,0.03404652,6
2020-07-20-170231,170231,0,0,0,21,0.25,0.009194707,0
2020-07-21-170231,170231,0,0,0,21,0.0,0.028122898,1
2020-07-22-170231,170231,0,0,0,21,0.0,0.0030157333,2
2020-07-23-170231,170231,0,0,0,21,0.75,0.04275971,3
2020-07-24-170231,170231,0,1,0,21,0.75,0.03125706,4
2020-07-25-170231,170231,0,0,0,21,0.75,0.037235368,5
2020-07-26-170231,170231,0,0,1,21,1.0,0.059602767,6
2020-07-27-170231,170231,0,0,0,21,0.0,0.018300362,0
2020-07-28-170231,170231,0,0,2,21,1.0,0.19096963,1
2020-07-29-170231,170231,0,0,1,21,1.0,0.226709,2
2020-07-30-170231,170231,0,0,0,21,0.75,0.05934504,3
2020-07-31-170231,170231,1,0,0,22,1.25,0.042674445,4
2020-08-01-170231,170231,0,0,0,22,0.75,0.04445401,5
2020-08-02-170231,170231,0,0,0,22,0.75,0.08301283,6
2020-08-03-170231,170231,0,0,1,22,1.75,0.22090285,0
2020-08-04-170231,170231,0,0,0,22,1.25,0.21712966,1
2020-08-05-170231,170231,0,0,2,22,1.75,0.59501964,2
2020-08-06-170231,170231,0,1,0,22,2.75,0.6108377,3
2020-08-07-170231,170231,0,0,2,22,0.5,0.087928586,4
2020-08-08-170231,170231,0,0,0,22,1.25,0.31830162,5
2020-08-09-170231,170231,1,0,3,23,1.0,0.15751073,6
2020-08-10-170231,170231,0,0,0,23,2.25,0.46099174,0
2020-08-11-170231,170231,2,0,0,25,3.0,0.35897624,1
2020-08-12-170231,170231,1,0,0,26,2.5,0.20699704,2
2020-08-13-170231,170231,0,0,0,26,3.75,0.4194319,3
2020-08-14-170231,170231,0,0,0,26,1.75,0.11212152,4
2020-08-15-170231,170231,0,0,0,26,1.75,0.28431672,5
2020-08-16-170231,170231,0,0,0,26,1.0,0.119847536,6
2020-08-17-170231,170231,1,0,0,27,3.75,0.42107287,0
2020-08-18-170231,170231,0,0,0,27,3.25,1.0193063,1
2020-08-19-170231,170231,2,0,0,29,4.0,0.8230542,2
2020-08-20-170231,170231,0,0,0,29,4.25,0.2520076,3
2020-08-21-170231,170231,2,0,0,31,4.25,1.0904115,4
2020-08-22-170231,170231,0,0,0,31,0.5,0.114300825,5
2020-08-23-170231,170231,3,0,0,34,0.75,0.080664255,6
2020-08-24-170231,170231,0,0,0,34,3.75,0.84007835,0
2020-08-25-170231,170231,0,0,0,34,3.0,0.3841364,1
2020-08-26-170231,170231,0,0,0,34,4.0,0.14316387,2
2020-08-27-170231,170231,0,0,1,34,3.5,0.47058073,3
2020-08-28-170231,170231,0,0,1,34,4.0,0.49365905,4
2020-08-29-170231,170231,0,0,0,34,0.75,0.20151561,5
2020-08-30-170231,170231,0,0,0,34,3.25,0.14443061,6
2020-08-31-170231,170231,0,0,0,34,1.75,0.5111313,0
2020-09-01-170231,170231,0,0,2,34,2.75,0.19715154,1
2020-09-02-170231,170231,0,0,0,34,4.75,0.44417605,2
2020-09-03-170231,170231,0,0,0,34,2.25,0.37666786,3
2020-09-04-170231,170231,0,0,2,34,3.25,0.33222342,4
2020-09-05-170231,170231,0,0,0,34,3.0,0.8986595,5
2020-09-06-170231,170231,0,0,0,34,1.0,0.26776376,6
2020-09-07-170231,170231,0,0,1,34,6.5,0.25326264,0
2020-09-08-170231,170231,0,0,1,34,2.25,0.6062862,1
2020-09-09-170231,170231,0,0,2,34,4.5,0.43277994,2
2020-09-10-170231,170231,1,0,2,35,4.0,0.3556321,3
2020-09-11-170231,170231,1,0,3,36,6.0,0.3583387,4
2020-09-12-170231,170231,0,1,0,36,5.5,0.4918109,5
2020-09-13-170231,170231,0,0,0,36,3.75,0.15381967,6
2020-09-14-170231,170231,0,0,1,36,6.25,0.20531085,0
2020-09-15-170231,170231,2,0,0,38,12.25,0.58729744,1
2020-09-16-170231,170231,0,0,0,38,9.0,0.40768266,2
2020-09-17-170231,170231,0,0,0,38,10.5,0.4181919,3
2020-09-18-170231,170231,2,0,1,40,10.25,0.84070015,4
2020-09-19-170231,170231,0,0,0,40,3.0,0.088175625,5
2020-09-20-170231,170231,0,1,0,40,4.75,0.18411185,6
2020-09-21-170231,170231,1,0,0,41,16.0,0.71798474,0
2020-09-22-170231,170231,1,0,1,42,11.25,0.6180544,1
2020-09-23-170231,170231,2,0,0,44,10.25,0.47824466,2
2020-09-24-170231,170231,2,0,0,46,12.25,0.47125736,3
2020-09-25-170231,170231,3,0,0,49,22.0,0.5714731,4
2020-09-26-170231,170231,0,0,0,49,3.25,0.6634851,5
2020-09-27-170231,170231,0,0,0,49,2.25,0.1702666,6
2020-09-28-170231,170231,1,0,0,50,11.25,0.5712601,0
2020-09-29-170231,170231,0,0,0,50,7.0,0.4128538,1
2020-09-30-170231,170231,0,0,0,50,7.75,0.5252683,2
2020-10-01-170231,170231,0,0,0,50,15.5,0.7628068,3
2020-10-02-170231,170231,1,0,2,51,10.0,0.5018351,4
2020-10-03-170231,170231,0,0,0,51,2.5,0.09154705,5
2020-10-04-170231,170231,0,0,0,51,4.25,0.19392525,6
2020-10-05-170231,170231,0,0,0,51,5.5,0.44402513,0
2020-10-06-170231,170231,1,0,0,52,7.0,0.61298037,1
2020-10-07-170231,170231,0,0,0,52,6.5,0.70686835,2
2020-10-08-170231,170231,0,0,0,52,6.25,0.5814888,3
2020-10-09-170231,170231,0,0,0,52,3.0,0.1964834,4
2020-10-10-170231,170231,0,0,1,52,0.75,0.08155867,5
2020-10-11-170231,170231,0,0,0,52,0.5,0.038050268,6
2020-10-12-170231,170231,0,0,0,52,2.25,0.090004556,0
2020-10-13-170231,170231,0,0,1,52,8.5,0.512591,1
2020-10-14-170231,170231,0,0,1,52,4.0,0.64645517,2
2020-10-15-170231,170231,0,0,0,52,3.0,0.8815303,3
2020-10-16-170231,170231,2,0,0,54,4.5,0.5473063,4
2020-10-17-170231,170231,0,0,0,54,1.0,0.10752666,5
2020-10-18-170231,170231,0,0,1,54,1.0,0.1544213,6
2020-10-19-170231,170231,0,0,0,54,4.25,0.4706723,0
2020-10-20-170231,170231,0,0,0,54,3.5,0.38052836,1
2020-10-21-170231,170231,0,0,0,54,5.5,0.6822448,2
2020-10-22-170231,170231,0,0,0,54,6.5,0.8177024,3
2020-10-23-170231,170231,0,0,0,54,6.25,0.35912538,4
2020-10-24-170231,170231,1,0,0,55,0.75,0.11203927,5
2020-10-25-170231,170231,0,0,1,55,4.75,0.31105876,6
2020-10-26-170231,170231,0,0,0,55,3.75,0.3034431,0
2020-10-27-170231,170231,1,0,0,56,4.75,0.69528764,1
2020-10-28-170231,170231,1,0,1,57,5.25,1.066704,2
2020-10-29-170231,170231,0,0,0,57,4.75,0.71833074,3
2020-10-30-170231,170231,0,0,0,57,4.75,0.74759805,4
2020-10-31-170231,170231,0,0,0,57,2.75,0.6031901,5
2020-11-01-170231,170231,1,0,0,58,2.0,0.16607223,6
2020-11-02-170231,170231,0,0,0,58,2.5,0.1446186,0
2020-11-03-170231,170231,0,0,0,58,5.75,0.51918596,1
2020-11-04-170231,170231,0,0,0,58,3.75,0.60661453,2
2020-11-05-170231,170231,0,0,0,58,2.25,0.32610995,3
2020-11-06-170231,170231,0,0,0,58,3.75,0.4236905,4
2020-11-07-170231,170231,0,0,0,58,1.75,0.29547313,5
2020-11-08-170231,170231,1,0,0,59,0.5,0.19234225,6
2020-11-09-170231,170231,0,1,0,59,4.75,0.3278428,0
2020-11-10-170231,170231,0,0,0,59,5.5,0.6399688,1
2020-11-11-170231,170231,1,0,0,60,3.75,0.5895214,2
2020-11-12-170231,170231,0,0,0,60,3.5,0.34590194,3
2020-11-13-170231,170231,0,0,0,60,5.0,0.5721444,4
2020-03-01-170232,170232,0,0,0,0,0.0,2.3134533e-08,6
2020-03-02-170232,170232,0,0,0,0,0.0,0.0032411981,0
2020-03-03-170232,170232,0,0,0,0,0.0,0.0059940815,1
2020-03-04-170232,170232,0,2,0,0,0.0,0.014113394,2
2020-03-05-170232,170232,0,0,0,0,0.0,2.0603895e-07,3
2020-03-06-170232,170232,0,0,1,0,0.0,0.0132517675,4
2020-03-07-170232,170232,0,0,0,0,0.0,0.0052685966,5
2020-03-08-170232,170232,0,0,0,0,0.0,0.0005698836,6
2020-03-09-170232,170232,0,0,1,0,0.0,0.09192491,0
2020-03-10-170232,170232,0,0,1,0,0.0,0.010759691,1
2020-03-11-170232,170232,0,0,0,0,0.0,0.046175048,2
2020-03-12-170232,170232,0,0,0,0,0.25,0.020239161,3
2020-03-13-170232,170232,0,0,0,0,0.25,0.10516024,4
2020-03-14-170232,170232,0,0,0,0,0.25,0.07715385,5
2020-03-15-170232,170232,0,0,0,0,0.25,0.03469711,6
2020-03-16-170232,170232,0,0,1,0,0.0,0.04521421,0
2020-03-17-170232,170232,0,0,0,0,0.75,0.13038747,1
2020-03-18-170232,170232,0,0,0,0,0.75,0.2673964,2
2020-03-19-170232,170232,0,0,0,0,0.5,0.4325282,3
2020-03-20-170232,170232,1,0,0,1,1.5,0.4136963,4
2020-03-21-170232,170232,0,0,0,1,0.75,0.16624694,5
2020-03-22-170232,170232,0,0,0,1,0.5,0.037181392,6
2020-03-23-170232,170232,1,0,0,2,1.5,0.73587126,0
2020-03-24-170232,170232,1,0,0,3,1.5,0.7382071,1
2020-03-25-170232,170232,0,0,0,3,0.75,0.5152985,2
2020-03-26-170232,170232,0,0,0,3,3.0,0.3911194,3
2020-03-27-170232,170232,0,1,1,3,0.75,0.37814498,4
2020-03-28-170232,170232,0,0,0,3,0.25,0.15174164,5
2020-03-29-170232,170232,0,0,0,3,0.25,0.039529774,6
2020-03-30-170232,170232,1,0,0,4,1.5,0.41782704,0
2020-03-31-170232,170232,0,0,0,4,0.75,0.29690513,1
2020-04-01-170232,170232,0,0,1,4,3.5,0.26090065,2
2020-04-02-170232,170232,0,0,0,4,0.75,0.4885736,3
2020-04-03-170232,170232,0,0,0,4,1.75,0.52290493,4
2020-04-04-170232,170232,0,0,0,4,1.25,0.039051622,5
2020-04-05-170232,170232,0,0,0,4,0.25,0.040517963,6
2020-04-06-170232,170232,0,0,0,4,0.75,0.33457717,0
2020-04-07-170232,170232,0,0,0,4,1.25,0.31490755,1
2020-04-08-170232,170232,0,0,0,4,0.5,0.13458538,2
2020-04-09-170232,170232,0,0,0,4,0.5,0.37725985,3
2020-04-10-170232,170232,1,1,0,5,0.75,0.10584609,4
2020-04-11-170232,170232,0,0,1,5,0.75,0.037054345,5
2020-04-12-170232,170232,0,0,0,5,0.25,0.0027652285,6
2020-04-13-170232,170232,0,1,1,5,1.0,0.32271802,0
2020-04-14-170232,170232,0,0,0,5,0.75,0.14105219,1
2020-04-15-170232,170232,1,0,0,6,0.25,0.17731453,2
2020-04-16-170232,170232,0,0,0,6,0.5,0.17131463,3
2020-04-17-170232,170232,0,0,0,6,0.5,0.09873035,4
2020-04-18-170232,170232,0,0,0,6,0.25,0.032748073,5
2020-04-19-170232,170232,0,0,0,6,0.0,0.06946978,6
2020-04-20-170232,170232,0,0,0,6,1.25,0.18025587,0
2020-04-21-170232,170232,0,0,0,6,1.0,0.10904667,1
2020-04-22-170232,170232,0,0,0,6,0.25,0.14107059,2
2020-04-23-170232,170232,0,0,0,6,0.0,0.0021137688,3
2020-04-24-170232,170232,0,0,0,6,0.0,0.10368337,4
2020-04-25-170232,170232,1,0,0,7,0.25,0.021728339,5
2020-04-26-170232,170232,0,0,0,7,0.25,0.04997909,6
2020-04-27-170232,170232,1,0,0,8,0.25,0.099969156,0
2020-04-28-170232,170232,0,0,0,8,0.5,0.06360874,1
2020-04-29-170232,170232,0,0,0,8,0.5,0.08106339,2
2020-04-30-170232,170232,0,0,0,8,0.0,0.024792982,3
2020-05-01-170232,170232,0,0,0,8,0.0,0.030371374,4
2020-05-02-170232,170232,0,0,0,8,0.0,0.008560961,5
2020-05-03-170232,170232,0,0,0,8,0.0,0.00064481393,6
2020-05-04-170232,170232,0,0,0,8,0.25,0.13400221,0
2020-05-05-170232,170232,0,0,0,8,0.25,0.15264384,1
2020-05-06-170232,170232,0,0,0,8,0.5,0.11869078,2
2020-05-07-170232,170232,0,0,0,8,0.25,0.03432926,3
2020-05-08-170232,170232,0,0,1,8,0.5,0.10029163,4
2020-05-09-170232,170232,0,0,0,8,0.25,0.0040597846,5
2020-05-10-170232,170232,0,1,0,8,0.0,0.052575093,6
2020-05-11-170232,170232,0,3,0,8,0.75,0.061915785,0
2020-05-12-170232,170232,0,0,0,8,0.75,0.07053126,1
2020-05-13-170232,170232,0,0,0,8,1.25,0.16585276,2
2020-05-14-170232,170232,0,0,0,8,0.5,0.1550567,3
2020-05-15-170232,170232,0,0,0,8,0.5,0.119637385,4
2020-05-16-170232,170232,0,0,0,8,0.0,1.3200504e-07,5
2020-05-17-170232,170232,0,0,0,8,0.0,0.0021408286,6
2020-05-18-170232,170232,0,0,0,8,0.25,0.13194385,0
2020-05-19-170232,170232,0,0,1,8,0.75,0.03451128,1
2020-05-20-170232,170232,0,0,0,8,0.5,0.08571842,2
2020-05-21-170232,170232,0,0,0,8,0.25,0.0879675,3
2020-05-22-170232,170232,1,0,0,9,1.0,0.07757227,4
2020-05-23-170232,170232,0,0,0,9,0.0,0.0005054335,5
2020-05-24-170232,170232,0,0,0,9,0.0,2.1759226e-07,6
2020-05-25-170232,170232,0,0,0,9,0.25,0.1566895,0
2020-05-26-170232,170232,0,0,0,9,0.75,0.037640657,1
2020-05-27-170232,170232,0,0,0,9,0.25,0.032096345,2
2020-05-28-170232,170232,0,1,0,9,0.5,0.071348876,3
2020-05-29-170232,170232,0,0,0,9,0.25,0.079720676,4
2020-05-30-170232,170232,0,0,0,9,0.25,0.00029568057,5
2020-05-31-170232,170232,0,0,0,9,0.75,0.0010711141,6
2020-06-01-170232,170232,0,1,0,9,0.0,0.09592866,0
2020-06-02-170232,170232,1,0,0,10,1.25,0.05055201,1
2020-06-03-170232,170232,0,0,0,10,0.0,0.066376485,2
2020-06-04-170232,170232,0,0,0,10,1.5,0.071622044,3
2020-06-05-170232,170232,0,0,0,10,0.75,0.063891955,4
2020-06-06-170232,170232,0,1,0,10,0.25,0.003385122,5
2020-06-07-170232,170232,0,0,0,10,0.0,0.00046795222,6
2020-06-08-170232,170232,0,0,0,10,0.75,0.06961102,0
2020-06-09-170232,170232,0,0,0,10,0.25,0.006307222,1
2020-06-10-170232,170232,0,0,0,10,0.0,0.119729325,2
2020-06-11-170232,170232,0,0,0,10,0.5,0.07301306,3
2020-06-12-170232,170232,0,0,0,10,0.25,0.14763203,4
2020-06-13-170232,170232,0,0,0,10,0.0,0.005056445,5
2020-06-14-170232,170232,0,0,0,10,0.25,0.0068896324,6
2020-06-15-170232,170232,0,0,0,10,2.75,0.012183625,0
2020-06-16-170232,170232,0,0,0,10,0.5,0.06592016,1
2020-06-17-170232,170232,0,0,0,10,0.25,0.023565602,2
2020-06-18-170232,170232,0,0,0,10,0.0,0.05729869,3
2020-06-19-170232,170232,0,0,0,10,0.5,0.00794593,4
2020-06-20-170232,170232,0,0,0,10,0.0,0.0012769165,5
2020-06-21-170232,170232,0,0,0,10,0.25,0.0082432525,6
2020-06-22-170232,170232,0,0,0,10,0.0,0.0061444133,0
2020-06-23-170232,170232,0,0,0,10,0.0,0.032849863,1
2020-06-24-170232,170232,0,1,0,10,0.0,0.02414146,2
2020-06-25-170232,170232,0,0,0,10,0.0,0.007245261,3
2020-06-26-170232,170232,0,0,0,10,0.25,0.030089244,4
2020-06-27-170232,170232,0,0,0,10,0.0,0.028766721,5
2020-06-28-170232,170232,0,0,0,10,0.0,1.6894594e-05,6
2020-06-29-170232,170232,0,0,0,10,0.0,0.0013705372,0
2020-06-30-170232,170232,0,0,0,10,0.25,0.09192353,1
2020-07-01-170232,170232,0,0,1,10,0.0,0.12048838,2
2020-07-02-170232,170232,0,0,0,10,0.0,0.003104035,3
2020-07-03-170232,170232,0,0,0,10,0.0,0.26228917,4
2020-07-04-170232,170232,0,0,0,10,0.25,0.0007007903,5
2020-07-05-170232,170232,0,0,0,10,0.5,0.002669712,6
2020-07-06-170232,170232,0,0,0,10,1.75,0.013268855,0
2020-07-07-170232,170232,0,0,0,10,0.75,0.024743129,1
2020-07-08-170232,170232,0,0,0,10,0.75,0.12744407,2
2020-07-09-170232,170232,0,1,0,10,0.0,0.13788024,3
2020-07-10-170232,170232,0,0,0,10,0.5,0.06636511,4
2020-07-11-170232,170232,0,0,0,10,0.0,0.001103178,5
2020-07-12-170232,170232,0,0,0,10,0.25,0.02069469,6
2020-07-13-170232,170232,0,0,0,10,0.0,0.00063876295,0
2020-07-14-170232,170232,0,0,0,10,0.5,0.07335434,1
2020-07-15-170232,170232,1,0,0,11,0.75,0.042200785,2
2020-07-16-170232,170232,0,0,0,11,0.0,0.06554211,3
2020-07-17-170232,170232,0,0,0,11,0.0,0.010284762,4
2020-07-18-170232,170232,0,0,0,11,0.0,0.10687487,5
2020-07-19-170232,170232,0,0,0,11,0.25,0.08657922,6
2020-07-20-170232,170232,0,0,0,11,0.5,0.015943103,0
2020-07-21-170232,170232,0,0,0,11,0.25,0.06160049,1
2020-07-22-170232,170232,0,0,0,11,0.5,0.0110876905,2
2020-07-23-170232,170232,0,0,0,11,0.0,0.032748204,3
2020-07-24-170232,170232,0,0,0,11,0.25,0.011800687,4
2020-07-25-170232,170232,0,0,1,11,1.0,0.006580756,5
2020-07-26-170232,170232,0,0,0,11,0.25,0.0047074626,6
2020-07-27-170232,170232,0,0,1,11,0.25,0.046998147,0
2020-07-28-170232,170232,0,0,4,11,1.25,0.08794665,1
2020-07-29-170232,170232,0,0,1,11,1.0,0.11596707,2
2020-07-30-170232,170232,0,0,2,11,0.75,0.11526777,3
2020-07-31-170232,170232,0,0,1,11,0.5,0.066031724,4
2020-08-01-170232,170232,0,0,0,11,0.5,0.035693537,5
2020-08-02-170232,170232,0,1,0,11,1.25,0.17507039,6
2020-08-03-170232,170232,0,0,0,11,1.0,0.18651105,0
2020-08-04-170232,170232,0,0,0,11,2.5,0.44312236,1
2020-08-05-170232,170232,0,0,0,11,3.5,0.6136547,2
2020-08-06-170232,170232,0,0,1,11,1.75,0.32883143,3
2020-08-07-170232,170232,0,0,0,11,4.25,0.29043233,4
2020-08-08-170232,170232,1,1,0,12,1.0,0.23283496,5
2020-08-09-170232,170232,0,0,0,12,0.75,0.088073656,6
2020-08-10-170232,170232,1,0,0,13,1.25,0.33441922,0
2020-08-11-170232,170232,4,0,0,17,3.25,0.25691456,1
2020-08-12-170232,170232,1,0,0,18,3.5,0.2408856,2
2020-08-13-170232,170232,2,0,4,20,1.75,0.41914147,3
2020-08-14-170232,170232,1,0,1,21,1.5,0.11454359,4
2020-08-15-170232,170232,0,0,0,21,0.25,0.15012516,5
2020-08-16-170232,170232,0,0,0,21,1.0,0.16985503,6
2020-08-17-170232,170232,0,0,3,21,1.0,0.1771873,0
2020-08-18-170232,170232,0,0,0,21,4.0,0.63246304,1
2020-08-19-170232,170232,0,0,1,21,2.0,0.42737657,2
2020-08-20-170232,170232,1,0,0,22,3.25,0.22223578,3
2020-08-21-170232,170232,0,0,0,22,4.0,0.7303294,4
2020-08-22-170232,170232,0,0,5,22,1.75,0.19936973,5
2020-08-23-170232,170232,0,0,0,22,1.5,0.06668853,6
2020-08-24-170232,170232,0,0,0,22,1.75,0.43951064,0
2020-08-25-170232,170232,0,0,0,22,0.75,0.2519633,1
2020-08-26-170232,170232,0,0,0,22,2.75,0.14067103,2
2020-08-27-170232,170232,4,0,1,26,1.25,0.35224843,3
2020-08-28-170232,170232,1,0,0,27,3.75,0.31874627,4
2020-08-29-170232,170232,0,0,0,27,0.75,0.14432377,5
2020-08-30-170232,170232,0,0,0,27,2.0,0.053427827,6
2020-08-31-170232,170232,3,0,0,30,2.0,0.29977825,0
2020-09-01-170232,170232,0,0,1,30,1.5,0.30094165,1
2020-09-02-170232,170232,1,0,0,31,3.5,0.25372785,2
2020-09-03-170232,170232,0,0,0,31,1.75,0.17774454,3
2020-09-04-170232,170232,0,0,1,31,0.5,0.14671454,4
2020-09-05-170232,170232,5,0,0,36,0.5,0.45365825,5
2020-09-06-170232,170232,0,0,0,36,0.0,0.12381349,6
2020-09-07-170232,170232,0,0,0,36,0.5,0.05311695,0
2020-09-08-170232,170232,0,0,1,36,0.75,0.42777514,1
2020-09-09-170232,170232,0,0,1,36,2.5,0.24654123,2
2020-09-10-170232,170232,1,0,3,37,0.75,0.13471232,3
2020-09-11-170232,170232,0,0,0,37,1.75,0.2810587,4
2020-09-12-170232,170232,0,0,0,37,0.75,0.36717102,5
2020-09-13-170232,170232,0,0,0,37,1.5,0.053841468,6
2020-09-14-170232,170232,0,0,0,37,5.0,0.1029392,0
2020-09-15-170232,170232,1,0,0,38,3.75,0.38636222,1
2020-09-16-170232,170232,0,0,0,38,1.75,0.15743929,2
2020-09-17-170232,170232,0,0,0,38,2.5,0.24673617,3
2020-09-18-170232,170232,1,0,0,39,3.5,0.3346517,4
2020-09-19-170232,170232,0,0,0,39,3.25,0.03222186,5
2020-09-20-170232,170232,0,0,1,39,1.5,0.030215375,6
2020-09-21-170232,170232,0,0,1,39,2.5,0.16844949,0
2020-09-22-170232,170232,1,0,0,40,2.0,0.21584964,1
2020-09-23-170232,170232,1,0,0,41,2.0,0.13043009,2
2020-09-24-170232,170232,3,0,0,44,1.25,0.08559991,3
2020-09-25-170232,170232,0,0,1,44,1.5,0.116089,4
2020-09-26-170232,170232,0,0,0,44,0.5,0.36224154,5
2020-09-27-170232,170232,0,0,0,44,1.5,0.0720131,6
2020-09-28-170232,170232,0,0,0,44,1.0,0.1667707,0
2020-09-29-170232,170232,0,0,0,44,0.75,0.14809427,1
2020-09-30-170232,170232,0,0,0,44,2.0,0.22714238,2
2020-10-01-170232,170232,0,0,0,44,1.75,0.17266014,3
2020-10-02-170232,170232,0,0,0,44,0.75,0.14701158,4
2020-10-03-170232,170232,0,0,0,44,1.25,0.062005673,5
2020-10-04-170232,170232,1,0,0,45,0.0,0.09254717,6
2020-10-05-170232,170232,1,1,0,46,1.75,0.2921554,0
2020-10-06-170232,170232,0,0,1,46,3.5,0.33749783,1
2020-10-07-170232,170232,0,0,2,46,0.5,0.40282166,2
2020-10-08-170232,170232,0,0,0,46,1.75,0.27236313,3
2020-10-09-170232,170232,1,0,0,47,1.75,0.18845902,4
2020-10-10-170232,170232,0,0,1,47,1.5,0.075282276,5
2020-10-11-170232,170232,0,0,0,47,1.25,0.07069247,6
2020-10-12-170232,170232,0,0,1,47,0.75,0.09203596,0
2020-10-13-170232,170232,0,0,1,47,2.75,0.1977479,1
2020-10-14-170232,170232,0,0,0,47,4.0,0.4528893,2
2020-10-15-170232,170232,0,0,1,47,2.0,0.5739619,3
2020-10-16-170232,170232,0,0,2,47,5.0,0.61149687,4
2020-10-17-170232,170232,0,0,2,47,3.5,0.16574177,5
2020-10-18-170232,170232,0,0,1,47,6.0,0.14934069,6
2020-10-19-170232,170232,0,0,1,47,1.25,0.3938115,0
2020-10-20-170232,170232,1,0,0,48,4.5,0.35140023,1
2020-10-21-170232,170232,2,0,2,50,4.5,0.5393192,2
2020-10-22-170232,170232,0,0,1,50,10.25,0.575089,3
2020-10-23-170232,170232,0,0,1,50,4.0,0.29103997,4
2020-10-24-170232,170232,1,0,0,51,5.25,0.23320794,5
2020-10-25-170232,170232,0,0,0,51,5.25,0.16267,6
2020-10-26-170232,170232,1,0,0,52,5.0,0.38028678,0
2020-10-27-170232,170232,1,0,0,53,5.25,0.4592119,1
2020-10-28-170232,170232,0,0,0,53,7.0,0.6410607,2
2020-10-29-170232,170232,1,0,1,54,9.25,0.4305822,3
2020-10-30-170232,170232,2,0,0,56,3.75,0.5526722,4
2020-10-31-170232,170232,2,0,0,58,2.25,0.44627336,5
2020-11-01-170232,170232,1,0,0,59,3.5,0.18058936,6
2020-11-02-170232,170232,1,0,0,60,4.25,0.22043157,0
2020-11-03-170232,170232,0,0,0,60,5.5,0.32638466,1
2020-11-04-170232,170232,2,1,0,62,5.5,0.39664403,2
2020-11-05-170232,170232,1,0,0,63,3.75,0.34537914,3
2020-11-06-170232,170232,1,0,0,64,4.0,0.36446446,4
2020-11-07-170232,170232,0,0,0,64,4.25,0.3381225,5
2020-11-08-170232,170232,0,0,0,64,5.25,0.28987476,6
2020-11-09-170232,170232,0,0,0,64,6.25,0.39835313,0
2020-11-10-170232,170232,0,0,0,64,3.5,0.41610426,1
2020-11-11-170232,170232,0,0,0,64,4.25,0.40886435,2
2020-11-12-170232,170232,1,0,0,65,5.0,0.4295098,3
2020-11-13-170232,170232,0,0,0,65,6.0,0.56545115,4
2020-03-01-170233,170233,0,0,1,0,0.0,1.826927e-05,6
2020-03-02-170233,170233,0,0,0,0,0.0,0.0005582595,0
2020-03-03-170233,170233,0,0,2,0,0.0,0.014082164,1
2020-03-04-170233,170233,0,1,0,0,0.14285714285714285,0.04997216,2
2020-03-05-170233,170233,0,0,2,0,0.0,1.5883928e-05,3
2020-03-06-170233,170233,0,1,2,0,0.14285714285714285,0.03673518,4
2020-03-07-170233,170233,0,0,1,0,0.0,0.00038151973,5
2020-03-08-170233,170233,0,0,0,0,0.0,0.00914113,6
2020-03-09-170233,170233,0,0,1,0,0.42857142857142855,0.117106475,0
2020-03-10-170233,170233,0,0,1,0,0.14285714285714285,0.0066073877,1
2020-03-11-170233,170233,0,0,0,0,0.14285714285714285,0.043547697,2
2020-03-12-170233,170233,1,0,1,1,0.2857142857142857,0.20489159,3
2020-03-13-170233,170233,0,0,3,1,1.0,0.32977194,4
2020-03-14-170233,170233,0,0,0,1,1.4285714285714286,0.28219384,5
2020-03-15-170233,170233,1,0,3,2,0.8571428571428571,0.2449184,6
2020-03-16-170233,170233,0,0,1,2,1.0,0.29783866,0
2020-03-17-170233,170233,2,0,1,4,2.0,0.51135916,1
2020-03-18-170233,170233,0,0,0,4,1.4285714285714286,0.34695622,2
2020-03-19-170233,170233,2,0,1,6,3.4285714285714284,0.83693355,3
2020-03-20-170233,170233,2,0,0,8,4.0,1.0553135,4
2020-03-21-170233,170233,1,0,1,9,1.2857142857142858,0.32596895,5
2020-03-22-170233,170233,0,0,1,9,1.2857142857142858,0.20060438,6
2020-03-23-170233,170233,1,0,1,10,4.428571428571429,1.0443882,0
2020-03-24-170233,170233,1,0,0,11,3.4285714285714284,0.91432524,1
2020-03-25-170233,170233,0,0,3,11,3.2857142857142856,0.677426,2
2020-03-26-170233,170233,1,0,1,12,3.4285714285714284,0.745748,3
2020-03-27-170233,170233,3,0,1,15,4.428571428571429,1.2298381,4
2020-03-28-170233,170233,0,0,3,15,1.0,0.16925526,5
2020-03-29-170233,170233,3,0,0,18,0.8571428571428571,0.398809,6
2020-03-30-170233,170233,1,0,3,19,3.8571428571428568,0.9241462,0
2020-03-31-170233,170233,1,0,0,20,1.7142857142857142,0.37549016,1
2020-04-01-170233,170233,0,0,0,20,2.571428571428572,0.31055272,2
2020-04-02-170233,170233,1,0,0,21,2.2857142857142856,0.37730917,3
2020-04-03-170233,170233,0,0,1,21,2.142857142857143,0.3550835,4
2020-04-04-170233,170233,1,0,0,22,0.42857142857142855,0.2031483,5
2020-04-05-170233,170233,1,0,1,23,0.7142857142857143,0.11381741,6
2020-04-06-170233,170233,1,0,1,24,1.7142857142857142,0.4063049,0
2020-04-07-170233,170233,0,0,0,24,2.7142857142857144,0.41374555,1
2020-04-08-170233,170233,3,0,1,27,2.4285714285714284,0.7969926,2
2020-04-09-170233,170233,1,0,0,28,5.142857142857143,0.90388536,3
2020-04-10-170233,170233,1,1,0,29,2.142857142857143,0.40573266,4
2020-04-11-170233,170233,3,0,0,32,0.7142857142857143,0.31612882,5
2020-04-12-170233,170233,0,0,0,32,0.42857142857142855,0.07073663,6
2020-04-13-170233,170233,3,1,0,35,2.0,0.6437396,0
2020-04-14-170233,170233,0,0,0,35,2.0,0.38503015,1
2020-04-15-170233,170233,0,0,0,35,3.0,0.43620875,2
2020-04-16-170233,170233,0,0,0,35,1.7142857142857142,0.2841067,3
2020-04-17-170233,170233,1,0,0,36,1.2857142857142858,0.47099382,4
2020-04-18-170233,170233,0,0,1,36,0.2857142857142857,0.029089293,5
2020-04-19-170233,170233,1,0,0,37,1.4285714285714286,0.22518976,6
2020-04-20-170233,170233,1,2,2,38,2.0,0.6763517,0
2020-04-21-170233,170233,0,0,2,38,1.4285714285714286,0.28425014,1
2020-04-22-170233,170233,1,0,2,39,0.5714285714285714,0.28596547,2
2020-04-23-170233,170233,0,0,0,39,0.14285714285714285,0.03624127,3
2020-04-24-170233,170233,0,0,0,39,0.7142857142857143,0.1841213,4
2020-04-25-170233,170233,0,0,1,39,0.2857142857142857,0.053308304,5
2020-04-26-170233,170233,0,0,0,39,0.2857142857142857,0.03284427,6
2020-04-27-170233,170233,0,0,1,39,1.2857142857142858,0.23525195,0
2020-04-28-170233,170233,0,1,0,39,0.8571428571428571,0.1399669,1
2020-04-29-170233,170233,0,0,0,39,1.0,0.20994855,2
2020-04-30-170233,170233,0,0,0,39,0.7142857142857143,0.13966183,3
2020-05-01-170233,170233,0,0,1,39,0.5714285714285714,0.04395897,4
2020-05-02-170233,170233,1,0,0,40,0.0,0.106117174,5
2020-05-03-170233,170233,0,0,1,40,0.14285714285714285,0.0066439426,6
2020-05-04-170233,170233,2,0,0,42,1.1428571428571428,0.4216241,0
2020-05-05-170233,170233,2,0,1,44,0.8571428571428571,0.38934347,1
2020-05-06-170233,170233,2,0,0,46,0.5714285714285714,0.4020969,2
2020-05-07-170233,170233,0,0,0,46,0.42857142857142855,0.13472764,3
2020-05-08-170233,170233,0,0,0,46,1.8571428571428568,0.28957576,4
2020-05-09-170233,170233,1,0,0,47,0.14285714285714285,0.09569833,5
2020-05-10-170233,170233,0,0,0,47,0.14285714285714285,0.026452415,6
2020-05-11-170233,170233,1,1,0,48,0.8571428571428571,0.22402221,0
2020-05-12-170233,170233,0,0,1,48,1.0,0.16296077,1
2020-05-13-170233,170233,0,0,0,48,1.7142857142857142,0.30112314,2
2020-05-14-170233,170233,0,0,0,48,1.7142857142857142,0.36229688,3
2020-05-15-170233,170233,1,0,1,49,1.1428571428571428,0.29796547,4
2020-05-16-170233,170233,0,0,0,49,0.0,9.4201765e-05,5
2020-05-17-170233,170233,1,0,0,50,0.0,0.11816811,6
2020-05-18-170233,170233,0,0,0,50,1.2857142857142858,0.27646923,0
2020-05-19-170233,170233,1,0,2,51,0.8571428571428571,0.32770297,1
2020-05-20-170233,170233,0,0,1,51,1.1428571428571428,0.3778341,2
2020-05-21-170233,170233,0,0,0,51,0.5714285714285714,0.20587707,3
2020-05-22-170233,170233,0,0,0,51,1.5714285714285714,0.28996176,4
2020-05-23-170233,170233,0,0,0,51,0.0,0.01264002,5
2020-05-24-170233,170233,0,0,0,51,0.0,0.0001365184,6
2020-05-25-170233,170233,0,0,0,51,0.8571428571428571,0.21039581,0
2020-05-26-170233,170233,1,0,0,52,1.0,0.2877285,1
2020-05-27-170233,170233,0,0,0,52,0.5714285714285714,0.14218889,2
2020-05-28-170233,170233,0,2,1,52,1.1428571428571428,0.37705958,3
2020-05-29-170233,170233,1,0,0,53,0.5714285714285714,0.4054875,4
2020-05-30-170233,170233,0,0,0,53,0.14285714285714285,0.007609731,5
2020-05-31-170233,170233,0,0,0,53,0.42857142857142855,0.05713948,6
2020-06-01-170233,170233,0,0,1,53,0.0,0.05936089,0
2020-06-02-170233,170233,2,0,0,55,1.4285714285714286,0.4972968,1
2020-06-03-170233,170233,1,1,0,56,0.2857142857142857,0.1853157,2
2020-06-04-170233,170233,0,0,0,56,0.7142857142857143,0.09973313,3
2020-06-05-170233,170233,0,0,0,56,0.8571428571428571,0.18098366,4
2020-06-06-170233,170233,0,0,0,56,0.2857142857142857,0.07012699,5
2020-06-07-170233,170233,0,0,1,56,0.0,7.4606054e-05,6
2020-06-08-170233,170233,0,0,0,56,0.2857142857142857,0.1101195,0
2020-06-09-170233,170233,0,0,0,56,0.14285714285714285,0.058526523,1
2020-06-10-170233,170233,0,0,0,56,0.2857142857142857,0.17721067,2
2020-06-11-170233,170233,1,0,0,57,0.5714285714285714,0.2924792,3
2020-06-12-170233,170233,0,0,0,57,0.42857142857142855,0.118648194,4
2020-06-13-170233,170233,0,0,0,57,0.14285714285714285,0.07230647,5
2020-06-14-170233,170233,0,0,0,57,0.2857142857142857,0.0051931813,6
2020-06-15-170233,170233,1,0,0,58,1.4285714285714286,0.27901477,0
2020-06-16-170233,170233,0,0,0,58,0.8571428571428571,0.17488831,1
2020-06-17-170233,170233,0,0,0,58,0.42857142857142855,0.10374342,2
2020-06-18-170233,170233,0,0,0,58,0.42857142857142855,0.17802879,3
2020-06-19-170233,170233,0,0,0,58,0.14285714285714285,0.027173424,4
2020-06-20-170233,170233,0,1,0,58,0.0,0.027273592,5
2020-06-21-170233,170233,1,1,0,59,0.14285714285714285,0.14406326,6
2020-06-22-170233,170233,0,0,0,59,0.14285714285714285,0.03521242,0
2020-06-23-170233,170233,0,0,0,59,0.2857142857142857,0.12757526,1
2020-06-24-170233,170233,0,0,0,59,0.42857142857142855,0.15459247,2
2020-06-25-170233,170233,0,1,1,59,0.2857142857142857,0.058831833,3
2020-06-26-170233,170233,0,2,0,59,0.42857142857142855,0.1321347,4
2020-06-27-170233,170233,0,0,0,59,0.42857142857142855,0.14072622,5
2020-06-28-170233,170233,0,0,2,59,0.0,0.00033539665,6
2020-06-29-170233,170233,0,0,0,59,0.0,0.01951268,0
2020-06-30-170233,170233,0,0,0,59,0.2857142857142857,0.09997201,1
2020-07-01-170233,170233,0,0,0,59,0.14285714285714285,0.029271979,2
2020-07-02-170233,170233,0,0,0,59,0.0,0.041353446,3
2020-07-03-170233,170233,0,0,0,59,0.14285714285714285,0.11340027,4
2020-07-04-170233,170233,0,0,0,59,0.14285714285714285,0.01851292,5
2020-07-05-170233,170233,0,0,0,59,0.42857142857142855,0.041468225,6
2020-07-06-170233,170233,0,0,0,59,0.5714285714285714,0.07405967,0
2020-07-07-170233,170233,0,0,0,59,0.7142857142857143,0.10926808,1
2020-07-08-170233,170233,0,0,0,59,0.0,0.050171822,2
2020-07-09-170233,170233,1,0,0,60,0.2857142857142857,0.25316012,3
2020-07-10-170233,170233,0,0,1,60,0.14285714285714285,0.038345434,4
2020-07-11-170233,170233,0,0,0,60,0.0,0.0024983466,5
2020-07-12-170233,170233,2,0,0,62,0.2857142857142857,0.44043255,6
2020-07-13-170233,170233,0,0,0,62,0.0,0.00589352,0
2020-07-14-170233,170233,0,0,0,62,0.14285714285714285,0.07583276,1
2020-07-15-170233,170233,0,0,0,62,0.14285714285714285,0.104302615,2
2020-07-16-170233,170233,0,0,0,62,0.0,0.089503825,3
2020-07-17-170233,170233,0,0,1,62,0.14285714285714285,0.099025175,4
2020-07-18-170233,170233,0,0,0,62,0.14285714285714285,0.060284097,5
2020-07-19-170233,170233,0,0,0,62,0.14285714285714285,0.039826047,6
2020-07-20-170233,170233,0,0,0,62,0.0,0.038651563,0
2020-07-21-170233,170233,0,0,0,62,0.14285714285714285,0.019717803,1
2020-07-22-170233,170233,0,0,0,62,0.0,0.013283432,2
2020-07-23-170233,170233,0,0,0,62,0.2857142857142857,0.18780376,3
2020-07-24-170233,170233,1,0,0,63,0.0,0.21886507,4
2020-07-25-170233,170233,0,0,0,63,0.5714285714285714,0.051662385,5
2020-07-26-170233,170233,0,0,0,63,0.14285714285714285,0.010368788,6
2020-07-27-170233,170233,0,0,1,63,0.5714285714285714,0.27244958,0
2020-07-28-170233,170233,0,0,1,63,0.5714285714285714,0.09652599,1
2020-07-29-170233,170233,0,0,2,63,1.1428571428571428,0.23894821,2
2020-07-30-170233,170233,0,0,4,63,1.0,0.2988825,3
2020-07-31-170233,170233,1,0,2,64,1.1428571428571428,0.4185817,4
2020-08-01-170233,170233,0,0,1,64,0.42857142857142855,0.101401545,5
2020-08-02-170233,170233,0,0,0,64,1.0,0.4106155,6
2020-08-03-170233,170233,0,0,0,64,0.8571428571428571,0.16425036,0
2020-08-04-170233,170233,0,0,0,64,3.4285714285714284,0.8396345,1
2020-08-05-170233,170233,0,0,1,64,2.7142857142857144,0.8969251,2
2020-08-06-170233,170233,0,0,0,64,0.7142857142857143,0.26784503,3
2020-08-07-170233,170233,0,0,0,64,1.0,0.33722463,4
2020-08-08-170233,170233,0,0,1,64,1.5714285714285714,0.6243787,5
2020-08-09-170233,170233,0,0,2,64,0.0,0.028639816,6
2020-08-10-170233,170233,1,0,1,65,1.5714285714285714,0.7154178,0
2020-08-11-170233,170233,1,1,3,66,1.8571428571428568,0.5664714,1
2020-08-12-170233,170233,2,0,1,68,2.4285714285714284,1.0582641,2
2020-08-13-170233,170233,4,0,3,72,1.5714285714285714,0.92321354,3
2020-08-14-170233,170233,2,0,0,74,1.7142857142857142,0.8532576,4
2020-08-15-170233,170233,1,0,0,75,0.5714285714285714,0.50819653,5
2020-08-16-170233,170233,0,0,0,75,2.4285714285714284,0.7695331,6
2020-08-17-170233,170233,0,0,0,75,1.4285714285714286,0.474683,0
2020-08-18-170233,170233,0,0,0,75,4.857142857142857,1.0063413,1
2020-08-19-170233,170233,1,0,0,76,1.4285714285714286,0.39127412,2
2020-08-20-170233,170233,0,0,0,76,1.4285714285714286,0.4947739,3
2020-08-21-170233,170233,0,0,2,76,2.4285714285714284,1.1659526,4
2020-08-22-170233,170233,1,0,0,77,1.2857142857142858,0.8495276,5
2020-08-23-170233,170233,2,0,0,79,0.7142857142857143,0.29803255,6
2020-08-24-170233,170233,1,0,0,80,3.7142857142857135,1.0417455,0
2020-08-25-170233,170233,3,0,1,83,1.4285714285714286,1.433163,1
2020-08-26-170233,170233,1,0,1,84,2.0,0.46926743,2
2020-08-27-170233,170233,3,0,4,87,2.571428571428572,1.1455925,3
2020-08-28-170233,170233,0,0,0,87,1.2857142857142858,0.8615555,4
2020-08-29-170233,170233,0,0,0,87,0.8571428571428571,0.35318333,5
2020-08-30-170233,170233,0,0,0,87,1.0,0.24239966,6
2020-08-31-170233,170233,0,0,0,87,1.0,0.18933377,0
2020-09-01-170233,170233,0,0,2,87,3.8571428571428568,1.178805,1
2020-09-02-170233,170233,0,0,2,87,2.7142857142857144,0.55154574,2
2020-09-03-170233,170233,0,0,2,87,2.142857142857143,0.44066584,3
2020-09-04-170233,170233,2,0,0,89,1.2857142857142858,0.41477883,4
2020-09-05-170233,170233,0,0,0,89,0.7142857142857143,0.19066094,5
2020-09-06-170233,170233,0,0,0,89,0.2857142857142857,0.16172229,6
2020-09-07-170233,170233,0,0,1,89,1.1428571428571428,0.29658216,0
2020-09-08-170233,170233,1,0,0,90,2.8571428571428568,0.71166676,1
2020-09-09-170233,170233,1,0,1,91,1.2857142857142858,0.795548,2
2020-09-10-170233,170233,4,0,2,95,2.571428571428572,0.8724026,3
2020-09-11-170233,170233,0,0,0,95,2.4285714285714284,0.7907321,4
2020-09-12-170233,170233,0,0,0,95,1.7142857142857142,0.55742854,5
2020-09-13-170233,170233,0,0,0,95,1.1428571428571428,0.2398492,6
2020-09-14-170233,170233,0,0,0,95,3.1428571428571432,0.6392286,0
2020-09-15-170233,170233,2,0,0,97,6.142857142857142,1.3483847,1
2020-09-16-170233,170233,2,0,0,99,3.7142857142857135,0.8606764,2
2020-09-17-170233,170233,2,0,0,101,3.7142857142857135,0.54021204,3
2020-09-18-170233,170233,0,0,1,101,3.2857142857142856,0.6057715,4
2020-09-19-170233,170233,0,0,0,101,1.7142857142857142,0.06699269,5
2020-09-20-170233,170233,0,0,0,101,1.8571428571428568,0.23766908,6
2020-09-21-170233,170233,1,1,0,102,2.8571428571428568,0.29295105,0
2020-09-22-170233,170233,0,0,1,102,2.8571428571428568,0.35542595,1
2020-09-23-170233,170233,1,0,0,103,4.285714285714286,0.7122642,2
2020-09-24-170233,170233,2,0,0,105,1.7142857142857142,0.35578167,3
2020-09-25-170233,170233,0,0,2,105,2.8571428571428568,0.46728235,4
2020-09-26-170233,170233,0,0,1,105,0.8571428571428571,0.36977717,5
2020-09-27-170233,170233,0,0,3,105,1.2857142857142858,0.17793347,6
2020-09-28-170233,170233,0,0,0,105,1.2857142857142858,0.4790581,0
2020-09-29-170233,170233,0,0,1,105,2.2857142857142856,0.5203131,1
2020-09-30-170233,170233,0,0,0,105,2.0,0.7104671,2
2020-10-01-170233,170233,0,0,0,105,2.142857142857143,0.34926724,3
2020-10-02-170233,170233,1,0,1,106,2.2857142857142856,0.54270625,4
2020-10-03-170233,170233,0,0,0,106,2.2857142857142856,0.5367805,5
2020-10-04-170233,170233,0,0,0,106,1.0,0.32448816,6
2020-10-05-170233,170233,0,0,1,106,2.8571428571428568,0.87908226,0
2020-10-06-170233,170233,1,1,0,107,3.8571428571428568,0.9681209,1
2020-10-07-170233,170233,0,0,1,107,3.571428571428572,1.0041981,2
2020-10-08-170233,170233,0,1,0,107,2.7142857142857144,0.66544753,3
2020-10-09-170233,170233,2,0,0,109,3.571428571428572,0.78963464,4
2020-10-10-170233,170233,1,0,1,110,1.2857142857142858,0.40555286,5
2020-10-11-170233,170233,3,0,0,113,1.1428571428571428,0.8341108,6
2020-10-12-170233,170233,0,0,0,113,2.0,0.5506408,0
2020-10-13-170233,170233,1,0,1,114,3.0,1.0359848,1
2020-10-14-170233,170233,0,0,2,114,4.285714285714286,1.2105352,2
2020-10-15-170233,170233,0,0,1,114,4.142857142857143,1.4324547,3
2020-10-16-170233,170233,1,0,2,115,6.0,2.1954496,4
2020-10-17-170233,170233,0,0,2,115,4.0,1.0460922,5
2020-10-18-170233,170233,0,0,4,115,3.571428571428572,0.6943429,6
2020-10-19-170233,170233,1,0,0,116,5.142857142857143,1.517031,0
2020-10-20-170233,170233,0,0,0,116,6.7142857142857135,1.6864878,1
2020-10-21-170233,170233,1,0,1,117,5.7142857142857135,1.4610008,2
2020-10-22-170233,170233,0,0,0,117,11.428571428571427,1.8484178,3
2020-10-23-170233,170233,0,0,1,117,7.2857142857142865,1.3264036,4
2020-10-24-170233,170233,1,0,0,118,5.142857142857143,0.864284,5
2020-10-25-170233,170233,0,1,2,118,5.7142857142857135,0.7189386,6
2020-10-26-170233,170233,0,0,4,118,8.428571428571429,1.7121568,0
2020-10-27-170233,170233,1,0,3,119,8.571428571428571,1.627946,1
2020-10-28-170233,170233,2,0,0,121,6.571428571428571,1.5529183,2
2020-10-29-170233,170233,1,0,2,122,7.857142857142858,1.6489434,3
2020-10-30-170233,170233,2,0,0,124,7.2857142857142865,2.2310636,4
2020-10-31-170233,170233,2,0,0,126,2.8571428571428568,1.0303967,5
2020-11-01-170233,170233,4,0,0,130,3.7142857142857135,1.2268432,6
2020-11-02-170233,170233,0,0,0,130,5.142857142857143,0.9699674,0
2020-11-03-170233,170233,0,1,0,130,7.0,1.6349255,1
2020-11-04-170233,170233,1,0,0,131,4.857142857142857,1.2907552,2
2020-11-05-170233,170233,0,0,0,131,5.285714285714286,1.4229087,3
2020-11-06-170233,170233,1,0,0,132,4.714285714285714,1.0693774,4
2020-11-07-170233,170233,0,0,0,132,4.857142857142857,0.8530068,5
2020-11-08-170233,170233,2,0,0,134,6.2857142857142865,1.1575662,6
2020-11-09-170233,170233,4,0,0,138,7.0,2.08049,0
2020-11-10-170233,170233,3,0,0,141,4.571428571428571,1.5369172,1
2020-11-11-170233,170233,0,0,0,141,2.0,0.6295259,2
2020-11-12-170233,170233,2,1,0,143,8.285714285714286,1.9427836,3
2020-11-13-170233,170233,0,0,0,143,10.857142857142858,2.5607095,4
2020-03-01-170234,170234,0,0,1,0,0.0,7.85397e-10,6
2020-03-02-170234,170234,0,0,0,0,0.0,2.0828332e-07,0
2020-03-03-170234,170234,0,0,1,0,0.0,2.4529618e-07,1
2020-03-04-170234,170234,0,0,3,0,0.0,0.00030199793,2
2020-03-05-170234,170234,0,0,2,0,0.0,4.273573e-09,3
2020-03-06-170234,170234,0,1,3,0,0.0,0.00062679936,4
2020-03-07-170234,170234,0,0,0,0,0.0,0.00029414363,5
2020-03-08-170234,170234,0,0,1,0,0.0,2.4532137e-05,6
2020-03-09-170234,170234,1,0,1,1,0.0,0.008631515,0
2020-03-10-170234,170234,0,0,1,1,0.0,0.00025006075,1
2020-03-11-170234,170234,0,0,1,1,0.0,0.003430845,2
2020-03-12-170234,170234,0,0,2,1,0.5,0.004656592,3
2020-03-13-170234,170234,1,0,5,2,0.0,0.010231992,4
2020-03-14-170234,170234,0,0,0,2,0.0,0.0029342694,5
2020-03-15-170234,170234,1,0,1,3,0.0,0.0025442564,6
2020-03-16-170234,170234,0,0,0,3,0.0,0.0046394016,0
2020-03-17-170234,170234,1,0,3,4,0.0,0.011843106,1
2020-03-18-170234,170234,3,0,0,7,0.0,0.019387448,2
2020-03-19-170234,170234,2,0,0,9,0.0,0.010876963,3
2020-03-20-170234,170234,3,2,0,12,1.5,0.03239288,4
2020-03-21-170234,170234,0,0,1,12,0.0,0.003669508,5
2020-03-22-170234,170234,1,0,1,13,0.5,0.003749469,6
2020-03-23-170234,170234,1,0,2,14,1.0,0.04394914,0
2020-03-24-170234,170234,1,0,1,15,1.0,0.065412246,1
2020-03-25-170234,170234,1,0,6,16,0.5,0.025090946,2
2020-03-26-170234,170234,2,0,1,18,1.5,0.0136096645,3
2020-03-27-170234,170234,5,0,2,23,0.5,0.026571987,4
2020-03-28-170234,170234,0,0,0,23,0.0,0.006249958,5
2020-03-29-170234,170234,1,0,0,24,0.0,0.00055212004,6
2020-03-30-170234,170234,0,0,1,24,0.0,0.022511112,0
2020-03-31-170234,170234,3,0,1,27,0.0,0.0077816383,1
2020-04-01-170234,170234,0,0,0,27,3.5,0.01852173,2
2020-04-02-170234,170234,0,0,1,27,0.5,0.014949955,3
2020-04-03-170234,170234,0,0,0,27,1.0,0.02028468,4
2020-04-04-170234,170234,1,0,0,28,1.0,0.005228103,5
2020-04-05-170234,170234,1,0,0,29,0.0,0.0005003805,6
2020-04-06-170234,170234,2,0,0,31,0.5,0.016092619,0
2020-04-07-170234,170234,1,0,0,32,0.0,0.007551941,1
2020-04-08-170234,170234,6,0,1,38,0.5,0.004859461,2
2020-04-09-170234,170234,1,4,0,39,0.0,0.0082546165,3
2020-04-10-170234,170234,2,0,1,41,0.5,0.004754959,4
2020-04-11-170234,170234,0,0,1,41,0.0,0.00086419017,5
2020-04-12-170234,170234,0,0,0,41,0.0,0.00051350304,6
2020-04-13-170234,170234,1,0,0,42,1.0,0.015175931,0
2020-04-14-170234,170234,1,0,0,43,1.0,0.011057649,1
2020-04-15-170234,170234,0,0,0,43,0.5,0.01214614,2
2020-04-16-170234,170234,1,0,0,44,0.0,0.008460128,3
2020-04-17-170234,170234,0,0,0,44,0.0,0.007032703,4
2020-04-18-170234,170234,0,0,0,44,0.0,0.00019663053,5
2020-04-19-170234,170234,0,0,0,44,0.0,0.0018516158,6
2020-04-20-170234,170234,0,0,0,44,0.0,0.022779688,0
2020-04-21-170234,170234,0,0,0,44,0.5,0.0044141393,1
2020-04-22-170234,170234,1,0,0,45,0.5,0.00500573,2
2020-04-23-170234,170234,0,0,0,45,0.0,0.00062535686,3
2020-04-24-170234,170234,1,0,0,46,0.0,0.0014618515,4
2020-04-25-170234,170234,1,0,0,47,0.0,0.0017412626,5
2020-04-26-170234,170234,0,0,0,47,0.0,0.0014192435,6
2020-04-27-170234,170234,0,1,1,47,0.0,0.002768784,0
2020-04-28-170234,170234,0,0,0,47,0.0,0.0043647443,1
2020-04-29-170234,170234,0,0,1,47,0.0,0.0028990218,2
2020-04-30-170234,170234,0,0,0,47,0.0,0.0020618227,3
2020-05-01-170234,170234,0,0,0,47,0.0,0.0023321726,4
2020-05-02-170234,170234,0,0,0,47,0.0,0.000772583,5
2020-05-03-170234,170234,0,0,0,47,0.0,8.512734e-08,6
2020-05-04-170234,170234,0,0,0,47,0.0,0.0023461776,0
2020-05-05-170234,170234,0,0,0,47,0.0,0.0050883745,1
2020-05-06-170234,170234,0,0,0,47,0.0,0.0041540167,2
2020-05-07-170234,170234,0,0,0,47,0.0,0.002665461,3
2020-05-08-170234,170234,0,0,0,47,0.0,0.0038915062,4
2020-05-09-170234,170234,0,0,0,47,0.0,0.0007444883,5
2020-05-10-170234,170234,0,0,0,47,0.0,0.00039702133,6
2020-05-11-170234,170234,1,2,0,48,0.0,0.0024529968,0
2020-05-12-170234,170234,0,3,2,48,0.5,0.01080683,1
2020-05-13-170234,170234,1,0,0,49,0.0,0.027250292,2
2020-05-14-170234,170234,0,0,0,49,0.0,0.00585123,3
2020-05-15-170234,170234,0,1,0,49,0.0,0.0016735485,4
2020-05-16-170234,170234,0,1,0,49,0.0,9.893838e-08,5
2020-05-17-170234,170234,0,0,0,49,0.0,8.573958e-07,6
2020-05-18-170234,170234,0,0,1,49,0.0,0.0051858663,0
2020-05-19-170234,170234,0,0,0,49,0.0,0.0024544788,1
2020-05-20-170234,170234,0,0,0,49,0.5,0.010632512,2
2020-05-21-170234,170234,0,0,0,49,0.0,0.0046187383,3
2020-05-22-170234,170234,0,0,0,49,0.0,0.004955203,4
2020-05-23-170234,170234,0,0,0,49,0.0,0.0017195438,5
2020-05-24-170234,170234,0,0,0,49,0.0,3.043958e-07,6
2020-05-25-170234,170234,0,0,0,49,0.0,0.0074346485,0
2020-05-26-170234,170234,2,0,0,51,0.0,0.0046328357,1
2020-05-27-170234,170234,0,0,0,51,0.0,0.0025842006,2
2020-05-28-170234,170234,0,0,0,51,0.0,0.010005467,3
2020-05-29-170234,170234,0,0,0,51,0.0,0.0038034378,4
2020-05-30-170234,170234,0,0,0,51,0.0,4.266529e-08,5
2020-05-31-170234,170234,0,0,0,51,0.0,0.00073694583,6
2020-06-01-170234,170234,1,0,0,52,0.0,0.005074665,0
2020-06-02-170234,170234,0,0,0,52,0.0,0.0049403585,1
2020-06-03-170234,170234,0,0,0,52,0.0,0.0013682559,2
2020-06-04-170234,170234,0,0,0,52,1.0,0.010627395,3
2020-06-05-170234,170234,0,0,0,52,0.0,0.003799164,4
2020-06-06-170234,170234,0,0,0,52,0.0,0.0030246829,5
2020-06-07-170234,170234,0,0,0,52,0.0,0.0009729586,6
2020-06-08-170234,170234,0,0,0,52,0.5,0.005038942,0
2020-06-09-170234,170234,0,0,0,52,0.0,0.00083011034,1
2020-06-10-170234,170234,0,0,0,52,0.0,0.0049654716,2
2020-06-11-170234,170234,0,0,0,52,0.0,0.008530524,3
2020-06-12-170234,170234,0,0,0,52,0.0,0.013755321,4
2020-06-13-170234,170234,0,0,0,52,0.0,2.7268308e-07,5
2020-06-14-170234,170234,0,0,0,52,0.0,0.0013777219,6
2020-06-15-170234,170234,0,0,0,52,0.5,0.006906976,0
2020-06-16-170234,170234,0,0,0,52,0.0,0.0057685776,1
2020-06-17-170234,170234,0,0,0,52,0.0,0.0018050643,2
2020-06-18-170234,170234,0,0,0,52,0.0,0.0005517354,3
2020-06-19-170234,170234,0,0,0,52,0.5,0.00678135,4
2020-06-20-170234,170234,0,0,0,52,0.0,4.805271e-07,5
2020-06-21-170234,170234,0,0,0,52,0.0,0.0012328508,6
2020-06-22-170234,170234,0,0,0,52,0.0,0.001987932,0
2020-06-23-170234,170234,0,0,0,52,0.0,0.0026059966,1
2020-06-24-170234,170234,0,0,0,52,0.0,0.0012429458,2
2020-06-25-170234,170234,0,1,0,52,0.0,5.183095e-06,3
2020-06-26-170234,170234,0,1,0,52,0.0,0.0016899215,4
2020-06-27-170234,170234,0,0,0,52,0.0,0.0008083718,5
2020-06-28-170234,170234,0,0,0,52,0.0,2.4708484e-07,6
2020-06-29-170234,170234,0,0,0,52,0.0,0.0005256771,0
2020-06-30-170234,170234,0,0,0,52,0.5,0.011960663,1
2020-07-01-170234,170234,0,0,0,52,0.0,0.0030119945,2
2020-07-02-170234,170234,0,0,0,52,0.0,0.0015849373,3
2020-07-03-170234,170234,0,0,0,52,0.0,0.0121031515,4
2020-07-04-170234,170234,0,0,0,52,0.0,0.00017081869,5
2020-07-05-170234,170234,0,0,0,52,0.0,0.0063591516,6
2020-07-06-170234,170234,0,0,0,52,0.5,0.0082453955,0
2020-07-07-170234,170234,0,0,0,52,0.5,0.009447973,1
2020-07-08-170234,170234,0,0,0,52,0.5,0.0119748395,2
2020-07-09-170234,170234,0,0,0,52,0.0,0.0149077885,3
2020-07-10-170234,170234,0,0,0,52,0.5,0.009218234,4
2020-07-11-170234,170234,0,0,0,52,0.0,6.608428e-05,5
2020-07-12-170234,170234,0,0,0,52,0.0,0.00030491574,6
2020-07-13-170234,170234,0,0,0,52,0.0,4.129532e-07,0
2020-07-14-170234,170234,0,0,0,52,0.5,0.011433143,1
2020-07-15-170234,170234,0,0,0,52,0.0,0.002858566,2
2020-07-16-170234,170234,0,0,0,52,0.0,0.0024289468,3
2020-07-17-170234,170234,0,0,0,52,0.0,4.0832245e-05,4
2020-07-18-170234,170234,0,0,0,52,0.0,0.004144488,5
2020-07-19-170234,170234,0,0,0,52,0.0,0.024681551,6
2020-07-20-170234,170234,0,0,0,52,0.0,0.0042282194,0
2020-07-21-170234,170234,0,0,1,52,0.0,0.0019318146,1
2020-07-22-170234,170234,0,0,3,52,0.5,0.007502164,2
2020-07-23-170234,170234,0,0,0,52,0.0,0.0018413719,3
2020-07-24-170234,170234,0,0,0,52,0.0,0.0016572748,4
2020-07-25-170234,170234,0,0,1,52,0.0,0.0027034357,5
2020-07-26-170234,170234,0,0,0,52,0.0,0.0006532782,6
2020-07-27-170234,170234,0,0,0,52,0.0,0.0027895814,0
2020-07-28-170234,170234,0,0,6,52,0.0,0.0076199616,1
2020-07-29-170234,170234,0,0,2,52,0.0,0.0046958565,2
2020-07-30-170234,170234,0,0,0,52,0.0,0.008745645,3
2020-07-31-170234,170234,0,0,1,52,0.0,0.004476781,4
2020-08-01-170234,170234,0,0,0,52,0.5,0.010431718,5
2020-08-02-170234,170234,0,0,0,52,0.0,0.011712935,6
2020-08-03-170234,170234,0,0,1,52,0.0,0.018648617,0
2020-08-04-170234,170234,1,0,1,53,0.5,0.07596876,1
2020-08-05-170234,170234,3,0,6,56,2.0,0.050053548,2
2020-08-06-170234,170234,0,0,1,56,0.0,0.03757963,3
2020-08-07-170234,170234,0,0,0,56,4.5,0.08580728,4
2020-08-08-170234,170234,1,0,0,57,0.0,0.018516798,5
2020-08-09-170234,170234,0,0,1,57,1.0,0.025942642,6
2020-08-10-170234,170234,0,0,0,57,0.5,0.034217343,0
2020-08-11-170234,170234,6,0,1,63,1.5,0.041851327,1
2020-08-12-170234,170234,2,0,1,65,2.5,0.077021405,2
2020-08-13-170234,170234,0,0,2,65,1.0,0.08303004,3
2020-08-14-170234,170234,1,0,0,66,0.0,0.010333666,4
2020-08-15-170234,170234,0,0,0,66,0.0,0.012297907,5
2020-08-16-170234,170234,0,0,0,66,0.0,0.03348057,6
2020-08-17-170234,170234,1,0,1,67,0.5,0.024754094,0
2020-08-18-170234,170234,1,0,3,68,0.5,0.047860194,1
2020-08-19-170234,170234,6,0,0,74,2.0,0.067874536,2
2020-08-20-170234,170234,1,0,3,75,1.0,0.040337883,3
2020-08-21-170234,170234,0,0,1,75,5.5,0.114997454,4
2020-08-22-170234,170234,0,0,1,75,2.5,0.039987035,5
2020-08-23-170234,170234,1,0,1,76,0.0,0.028055,6
2020-08-24-170234,170234,0,0,1,76,0.5,0.03335213,0
2020-08-25-170234,170234,1,0,1,77,0.5,0.018409599,1
2020-08-26-170234,170234,1,0,1,78,1.5,0.02844629,2
2020-08-27-170234,170234,2,0,1,80,0.5,0.04142163,3
2020-08-28-170234,170234,0,0,3,80,0.0,0.04369693,4
2020-08-29-170234,170234,0,0,1,80,0.5,0.016602028,5
2020-08-30-170234,170234,0,0,0,80,0.5,0.027586784,6
2020-08-31-170234,170234,1,0,1,81,1.0,0.049178585,0
2020-09-01-170234,170234,3,0,1,84,0.0,0.026674239,1
2020-09-02-170234,170234,0,0,0,84,1.0,0.035932485,2
2020-09-03-170234,170234,3,0,1,87,0.0,0.012160785,3
2020-09-04-170234,170234,1,0,0,88,0.0,0.014310094,4
2020-09-05-170234,170234,1,0,0,89,0.5,0.03353826,5
2020-09-06-170234,170234,1,0,0,90,0.0,0.018426692,6
2020-09-07-170234,170234,1,0,0,91,0.5,0.011618155,0
2020-09-08-170234,170234,1,0,0,92,0.0,0.03392586,1
2020-09-09-170234,170234,1,0,1,93,4.5,0.073296994,2
2020-09-10-170234,170234,1,0,2,94,0.0,0.0077851606,3
2020-09-11-170234,170234,3,0,0,97,0.5,0.013359646,4
2020-09-12-170234,170234,1,0,0,98,0.0,0.019753167,5
2020-09-13-170234,170234,0,0,0,98,0.5,0.02761308,6
2020-09-14-170234,170234,1,0,0,99,1.5,0.028741704,0
2020-09-15-170234,170234,1,0,0,100,3.5,0.062046193,1
2020-09-16-170234,170234,0,0,0,100,0.5,0.018243156,2
2020-09-17-170234,170234,1,0,0,101,1.5,0.037667144,3
2020-09-18-170234,170234,0,0,0,101,1.0,0.024620768,4
2020-09-19-170234,170234,0,0,0,101,1.0,0.012014288,5
2020-09-20-170234,170234,0,1,0,101,0.0,0.0044539073,6
2020-09-21-170234,170234,0,0,0,101,0.5,0.011121741,0
2020-09-22-170234,170234,0,0,1,101,0.5,0.015757766,1
2020-09-23-170234,170234,1,0,0,102,1.0,0.017205082,2
2020-09-24-170234,170234,2,0,0,104,1.0,0.01521201,3
2020-09-25-170234,170234,0,0,0,104,1.0,0.009991066,4
2020-09-26-170234,170234,0,0,0,104,0.0,0.013624584,5
2020-09-27-170234,170234,0,0,0,104,0.0,0.0065458445,6
2020-09-28-170234,170234,0,0,0,104,1.0,0.026682036,0
2020-09-29-170234,170234,0,0,0,104,0.0,0.015556526,1
2020-09-30-170234,170234,0,0,0,104,1.5,0.047072466,2
2020-10-01-170234,170234,0,0,0,104,0.5,0.015643535,3
2020-10-02-170234,170234,0,0,1,104,0.0,0.014641992,4
2020-10-03-170234,170234,0,0,0,104,0.0,0.0028427439,5
2020-10-04-170234,170234,0,0,1,104,0.0,0.010884794,6
2020-10-05-170234,170234,0,0,0,104,0.0,0.020067662,0
2020-10-06-170234,170234,1,0,2,105,1.5,0.038547225,1
2020-10-07-170234,170234,0,2,0,105,0.0,0.017563686,2
2020-10-08-170234,170234,0,0,3,105,0.5,0.016973501,3
2020-10-09-170234,170234,0,0,0,105,0.5,0.020305172,4
2020-10-10-170234,170234,0,0,1,105,0.5,0.00803292,5
2020-10-11-170234,170234,0,0,0,105,0.0,0.0029560379,6
2020-10-12-170234,170234,0,0,2,105,0.0,0.009752696,0
2020-10-13-170234,170234,0,0,1,105,1.0,0.025188213,1
2020-10-14-170234,170234,0,0,0,105,1.0,0.020511596,2
2020-10-15-170234,170234,0,0,0,105,1.0,0.024733191,3
2020-10-16-170234,170234,1,0,1,106,0.5,0.051067956,4
2020-10-17-170234,170234,0,0,0,106,0.0,0.0096145235,5
2020-10-18-170234,170234,1,0,1,107,1.5,0.0317972,6
2020-10-19-170234,170234,0,0,2,107,0.0,0.028893476,0
2020-10-20-170234,170234,2,0,0,109,0.0,0.012989016,1
2020-10-21-170234,170234,0,0,1,109,1.5,0.049249828,2
2020-10-22-170234,170234,3,0,3,112,0.5,0.040991493,3
2020-10-23-170234,170234,0,0,1,112,0.0,0.026893046,4
2020-10-24-170234,170234,1,2,0,113,1.0,0.024635764,5
2020-10-25-170234,170234,0,0,0,113,0.0,0.008363316,6
2020-10-26-170234,170234,2,0,0,115,0.5,0.030941702,0
2020-10-27-170234,170234,1,1,2,116,0.0,0.02671116,1
2020-10-28-170234,170234,0,0,0,116,6.0,0.07744526,2
2020-10-29-170234,170234,0,0,8,116,1.5,0.0321899,3
2020-10-30-170234,170234,1,0,2,117,1.5,0.047558554,4
2020-10-31-170234,170234,0,0,0,117,2.5,0.036136817,5
2020-11-01-170234,170234,1,1,0,118,3.5,0.06732677,6
2020-11-02-170234,170234,2,0,0,120,1.0,0.022959396,0
2020-11-03-170234,170234,0,0,0,120,4.0,0.07279872,1
2020-11-04-170234,170234,1,0,0,121,3.0,0.055224963,2
2020-11-05-170234,170234,3,1,0,124,3.5,0.051771965,3
2020-11-06-170234,170234,1,1,0,125,2.0,0.033146113,4
2020-11-07-170234,170234,0,0,0,125,1.5,0.034020416,5
2020-11-08-170234,170234,0,0,0,125,2.0,0.018935245,6
2020-11-09-170234,170234,0,0,0,125,6.0,0.06413019,0
2020-11-10-170234,170234,2,0,0,127,3.0,0.043727588,1
2020-11-11-170234,170234,0,0,0,127,3.5,0.050248377,2
2020-11-12-170234,170234,8,0,0,135,2.5,0.02924586,3
2020-11-13-170234,170234,2,0,0,137,2.5,0.045924332,4
2020-03-01-170235,170235,0,0,0,0,0.0,1.882184e-09,6
2020-03-02-170235,170235,0,0,0,0,0.0,0.0019993568,0
2020-03-03-170235,170235,0,1,2,0,0.0,0.0032183316,1
2020-03-04-170235,170235,0,0,2,0,0.0,0.012495893,2
2020-03-05-170235,170235,0,0,1,0,0.0,1.4159154e-05,3
2020-03-06-170235,170235,0,0,2,0,0.0,0.009858296,4
2020-03-07-170235,170235,0,0,2,0,0.0,0.004422124,5
2020-03-08-170235,170235,0,0,1,0,0.0,0.00042612109,6
2020-03-09-170235,170235,0,0,2,0,0.4,0.07747064,0
2020-03-10-170235,170235,0,0,2,0,0.0,0.008369998,1
2020-03-11-170235,170235,0,0,2,0,0.2,0.037402987,2
2020-03-12-170235,170235,0,0,3,0,0.2,0.048570555,3
2020-03-13-170235,170235,1,0,0,1,0.4,0.08486212,4
2020-03-14-170235,170235,1,0,0,2,0.2,0.058921248,5
2020-03-15-170235,170235,0,0,0,2,0.4,0.027822448,6
2020-03-16-170235,170235,0,0,2,2,0.4,0.03732711,0
2020-03-17-170235,170235,2,0,2,4,0.6,0.11557393,1
2020-03-18-170235,170235,2,1,3,6,1.4,0.2103195,2
2020-03-19-170235,170235,1,0,1,7,2.2,0.32775182,3
2020-03-20-170235,170235,2,5,2,9,3.4,0.4203565,4
2020-03-21-170235,170235,2,0,1,11,1.4,0.13276184,5
2020-03-22-170235,170235,1,0,0,12,2.2,0.069151,6
2020-03-23-170235,170235,2,0,1,14,4.8,0.63215846,0
2020-03-24-170235,170235,2,0,2,16,4.6,0.60936713,1
2020-03-25-170235,170235,2,0,1,18,3.8,0.42671764,2
2020-03-26-170235,170235,3,0,1,21,3.0,0.3880482,3
2020-03-27-170235,170235,0,0,0,21,2.2,0.31116325,4
2020-03-28-170235,170235,0,0,2,21,1.2,0.10619933,5
2020-03-29-170235,170235,0,0,0,21,0.2,0.025892539,6
2020-03-30-170235,170235,2,0,0,23,2.8,0.30995464,0
2020-03-31-170235,170235,2,0,0,25,2.0,0.21833733,1
2020-04-01-170235,170235,3,0,0,28,4.0,0.37729537,2
2020-04-02-170235,170235,1,0,1,29,3.0,0.39566633,3
2020-04-03-170235,170235,2,0,0,31,3.4,0.45147634,4
2020-04-04-170235,170235,1,0,0,32,0.8,0.09080323,5
2020-04-05-170235,170235,0,0,0,32,0.2,0.028032362,6
2020-04-06-170235,170235,1,1,3,33,2.2,0.29138866,0
2020-04-07-170235,170235,2,1,0,35,1.6,0.25313157,1
2020-04-08-170235,170235,1,0,0,36,0.8,0.13863397,2
2020-04-09-170235,170235,1,0,0,37,2.4,0.26273197,3
2020-04-10-170235,170235,0,0,0,37,1.4,0.09996646,4
2020-04-11-170235,170235,2,0,1,39,0.2,0.036802016,5
2020-04-12-170235,170235,0,0,1,39,0.2,0.0040982338,6
2020-04-13-170235,170235,0,0,1,39,2.2,0.29007694,0
2020-04-14-170235,170235,0,0,1,39,1.0,0.17452674,1
2020-04-15-170235,170235,0,0,1,39,1.2,0.17357683,2
2020-04-16-170235,170235,1,0,0,40,0.8,0.13177392,3
2020-04-17-170235,170235,0,0,0,40,0.4,0.072086215,4
2020-04-18-170235,170235,0,0,0,40,0.2,0.024997832,5
2020-04-19-170235,170235,0,0,0,40,0.4,0.049685594,6
2020-04-20-170235,170235,3,1,0,43,1.2,0.19093297,0
2020-04-21-170235,170235,0,2,0,43,0.8,0.111064985,1
2020-04-22-170235,170235,0,0,0,43,1.2,0.15897734,2
2020-04-23-170235,170235,0,0,1,43,0.2,0.007157305,3
2020-04-24-170235,170235,0,0,0,43,0.4,0.086390056,4
2020-04-25-170235,170235,1,0,0,44,0.2,0.022423131,5
2020-04-26-170235,170235,1,0,0,45,0.6,0.041885298,6
2020-04-27-170235,170235,1,0,0,46,0.4,0.08720167,0
2020-04-28-170235,170235,1,0,0,47,0.8,0.061998934,1
2020-04-29-170235,170235,1,0,2,48,0.4,0.074317366,2
2020-04-30-170235,170235,0,0,0,48,0.0,0.017405905,3
2020-05-01-170235,170235,0,0,0,48,0.6,0.023831787,4
2020-05-02-170235,170235,0,0,0,48,0.2,0.008515845,5
2020-05-03-170235,170235,0,0,0,48,0.0,0.00049056264,6
2020-05-04-170235,170235,0,0,0,48,0.6,0.0937437,0
2020-05-05-170235,170235,0,0,2,48,0.6,0.113340676,1
2020-05-06-170235,170235,0,0,0,48,0.6,0.09532843,2
2020-05-07-170235,170235,1,0,1,49,0.2,0.033580896,3
2020-05-08-170235,170235,0,0,1,49,0.6,0.08209458,4
2020-05-09-170235,170235,0,0,0,49,0.2,0.0072532166,5
2020-05-10-170235,170235,0,1,0,49,0.4,0.037653115,6
2020-05-11-170235,170235,0,0,0,49,0.4,0.054790035,0
2020-05-12-170235,170235,0,0,0,49,0.4,0.083666734,1
2020-05-13-170235,170235,2,0,1,51,1.0,0.15598975,2
2020-05-14-170235,170235,0,0,0,51,1.2,0.1443298,3
2020-05-15-170235,170235,0,0,0,51,0.4,0.090539776,4
2020-05-16-170235,170235,0,0,0,51,0.0,0.00032753008,5
2020-05-17-170235,170235,0,0,0,51,0.0,0.003660957,6
2020-05-18-170235,170235,0,0,0,51,0.8,0.11389819,0
2020-05-19-170235,170235,2,0,0,53,0.0,0.043543704,1
2020-05-20-170235,170235,0,0,0,53,0.6,0.09286813,2
2020-05-21-170235,170235,1,0,1,54,0.4,0.07170967,3
2020-05-22-170235,170235,1,0,0,55,0.6,0.06966191,4
2020-05-23-170235,170235,0,0,0,55,0.2,0.0046087024,5
2020-05-24-170235,170235,0,0,0,55,0.0,0.0010076882,6
2020-05-25-170235,170235,0,0,1,55,0.4,0.115574636,0
2020-05-26-170235,170235,0,0,1,55,0.6,0.052655056,1
2020-05-27-170235,170235,1,0,0,56,0.2,0.03983642,2
2020-05-28-170235,170235,0,0,2,56,0.6,0.06411442,3
2020-05-29-170235,170235,0,1,0,56,0.4,0.06310383,4
2020-05-30-170235,170235,0,0,0,56,0.0,0.00024301746,5
2020-05-31-170235,170235,0,0,0,56,0.2,0.003960907,6
2020-06-01-170235,170235,0,0,1,56,0.8,0.08931116,0
2020-06-02-170235,170235,0,0,0,56,0.6,0.04705852,1
2020-06-03-170235,170235,0,0,0,56,0.4,0.054844692,2
2020-06-04-170235,170235,1,0,0,57,0.8,0.13250722,3
2020-06-05-170235,170235,0,0,0,57,0.4,0.052249398,4
2020-06-06-170235,170235,0,1,0,57,0.4,0.011924635,5
2020-06-07-170235,170235,0,1,0,57,0.2,0.003973699,6
2020-06-08-170235,170235,1,1,0,58,0.6,0.064137235,0
2020-06-09-170235,170235,1,0,0,59,0.0,0.01293396,1
2020-06-10-170235,170235,0,0,0,59,0.4,0.091263235,2
2020-06-11-170235,170235,2,0,0,61,0.2,0.07233576,3
2020-06-12-170235,170235,0,0,0,61,0.6,0.11359056,4
2020-06-13-170235,170235,0,0,0,61,0.0,0.0035604264,5
2020-06-14-170235,170235,0,1,0,61,0.2,0.0077460487,6
2020-06-15-170235,170235,1,2,0,62,0.2,0.052393228,0
2020-06-16-170235,170235,0,0,0,62,0.6,0.057955936,1
2020-06-17-170235,170235,0,0,0,62,0.2,0.022951877,2
2020-06-18-170235,170235,0,0,0,62,0.2,0.04157118,3
2020-06-19-170235,170235,0,0,0,62,0.4,0.056638706,4
2020-06-20-170235,170235,0,0,0,62,0.0,0.0022166749,5
2020-06-21-170235,170235,0,0,0,62,0.2,0.0095592225,6
2020-06-22-170235,170235,0,0,2,62,0.0,0.006613746,0
2020-06-23-170235,170235,0,0,0,62,0.2,0.02911039,1
2020-06-24-170235,170235,0,0,2,62,0.0,0.01763275,2
2020-06-25-170235,170235,0,0,0,62,0.0,0.007685807,3
2020-06-26-170235,170235,0,1,0,62,0.0,0.025312614,4
2020-06-27-170235,170235,0,0,0,62,0.0,0.021905683,5
2020-06-28-170235,170235,0,0,0,62,0.0,0.00011969403,6
2020-06-29-170235,170235,0,0,0,62,0.0,0.0011473529,0
2020-06-30-170235,170235,0,0,1,62,0.4,0.11074559,1
2020-07-01-170235,170235,0,0,3,62,0.4,0.08887876,2
2020-07-02-170235,170235,0,0,0,62,0.2,0.009445762,3
2020-07-03-170235,170235,0,0,0,62,0.8,0.2014928,4
2020-07-04-170235,170235,0,0,0,62,0.2,0.00079117337,5
2020-07-05-170235,170235,0,0,0,62,0.4,0.011958445,6
2020-07-06-170235,170235,2,0,2,64,0.2,0.02815505,0
2020-07-07-170235,170235,0,0,0,64,0.4,0.06496639,1
2020-07-08-170235,170235,2,0,1,66,0.6,0.16161492,2
2020-07-09-170235,170235,0,0,0,66,0.6,0.121277556,3
2020-07-10-170235,170235,0,0,1,66,0.4,0.09777645,4
2020-07-11-170235,170235,0,0,0,66,0.0,0.0013147164,5
2020-07-12-170235,170235,0,0,0,66,0.0,0.011760757,6
2020-07-13-170235,170235,0,0,1,66,0.0,0.0016866786,0
2020-07-14-170235,170235,1,0,2,67,0.4,0.11051988,1
2020-07-15-170235,170235,3,1,0,70,0.2,0.038728885,2
2020-07-16-170235,170235,0,0,2,70,0.2,0.055157047,3
2020-07-17-170235,170235,0,0,0,70,0.0,0.00900851,4
2020-07-18-170235,170235,0,0,1,70,0.2,0.0811398,5
2020-07-19-170235,170235,0,0,2,70,0.2,0.07346988,6
2020-07-20-170235,170235,2,0,1,72,0.2,0.033769082,0
2020-07-21-170235,170235,0,0,3,72,0.2,0.062332146,1
2020-07-22-170235,170235,1,0,5,73,0.2,0.05858676,2
2020-07-23-170235,170235,0,0,5,73,0.0,0.023769606,3
2020-07-24-170235,170235,1,0,6,74,0.0,0.016237684,4
2020-07-25-170235,170235,0,0,4,74,0.2,0.011611887,5
2020-07-26-170235,170235,0,0,1,74,0.0,0.0036844767,6
2020-07-27-170235,170235,1,0,3,75,0.0,0.043602873,0
2020-07-28-170235,170235,2,0,8,77,0.6,0.088613,1
2020-07-29-170235,170235,0,0,8,77,0.4,0.090752676,2
2020-07-30-170235,170235,2,0,2,79,0.2,0.09486445,3
2020-07-31-170235,170235,0,0,1,79,0.6,0.051221363,4
2020-08-01-170235,170235,1,0,1,80,0.4,0.07944091,5
2020-08-02-170235,170235,2,0,0,82,0.6,0.16062406,6
2020-08-03-170235,170235,1,0,0,83,1.6,0.19175781,0
2020-08-04-170235,170235,3,0,0,86,1.4,0.46381006,1
2020-08-05-170235,170235,5,0,2,91,2.2,0.66908604,2
2020-08-06-170235,170235,5,0,10,96,2.0,0.33136648,3
2020-08-07-170235,170235,6,0,4,102,2.4,0.7158116,4
2020-08-08-170235,170235,4,1,0,106,0.4,0.20129502,5
2020-08-09-170235,170235,1,0,4,107,1.2,0.17583615,6
2020-08-10-170235,170235,3,0,1,110,1.4,0.355132,0
2020-08-11-170235,170235,8,0,2,118,2.8,0.41988105,1
2020-08-12-170235,170235,8,0,3,126,2.4,0.534297,2
2020-08-13-170235,170235,2,0,2,128,2.8,0.7007641,3
2020-08-14-170235,170235,1,0,15,129,0.8,0.1076443,4
2020-08-15-170235,170235,1,0,1,130,0.8,0.13262084,5
2020-08-16-170235,170235,0,0,5,130,0.2,0.117884815,6
2020-08-17-170235,170235,0,0,2,130,0.6,0.18113153,0
2020-08-18-170235,170235,0,0,1,130,2.4,0.5468817,1
2020-08-19-170235,170235,2,0,4,132,1.6,0.53672874,2
2020-08-20-170235,170235,10,0,2,142,1.8,0.42740625,3
2020-08-21-170235,170235,4,0,0,146,4.6,1.0701401,4
2020-08-22-170235,170235,0,0,0,146,1.2,0.35841766,5
2020-08-23-170235,170235,4,0,0,150,0.2,0.079824045,6
2020-08-24-170235,170235,1,0,0,151,0.8,0.3712407,0
2020-08-25-170235,170235,2,0,1,153,0.8,0.23414741,1
2020-08-26-170235,170235,3,0,0,156,2.2,0.27222976,2
2020-08-27-170235,170235,2,0,1,158,2.0,0.3495245,3
2020-08-28-170235,170235,15,0,2,173,1.6,0.41212037,4
2020-08-29-170235,170235,1,0,0,174,0.8,0.16692773,5
2020-08-30-170235,170235,5,0,2,179,0.4,0.1167711,6
2020-08-31-170235,170235,2,0,5,181,2.4,0.32129493,0
2020-09-01-170235,170235,1,0,2,182,0.8,0.23394407,1
2020-09-02-170235,170235,4,0,4,186,1.8,0.30111858,2
2020-09-03-170235,170235,2,0,0,188,0.4,0.15146908,3
2020-09-04-170235,170235,0,0,3,188,0.6,0.14977446,4
2020-09-05-170235,170235,0,0,3,188,2.6,0.4078767,5
2020-09-06-170235,170235,0,0,1,188,0.4,0.09488269,6
2020-09-07-170235,170235,0,0,3,188,1.0,0.09722484,0
2020-09-08-170235,170235,1,0,2,189,1.0,0.3242139,1
2020-09-09-170235,170235,0,0,2,189,3.0,0.5370299,2
2020-09-10-170235,170235,1,0,0,190,0.8,0.14297816,3
2020-09-11-170235,170235,2,0,0,192,1.6,0.3131468,4
2020-09-12-170235,170235,0,0,2,192,1.2,0.2877245,5
2020-09-13-170235,170235,2,0,1,194,0.8,0.09950135,6
2020-09-14-170235,170235,5,0,1,199,1.4,0.21528085,0
2020-09-15-170235,170235,2,0,0,201,4.6,0.58048236,1
2020-09-16-170235,170235,4,0,1,205,1.6,0.16476284,2
2020-09-17-170235,170235,0,0,0,205,2.8,0.33215156,3
2020-09-18-170235,170235,3,0,2,208,1.8,0.35992688,4
2020-09-19-170235,170235,3,0,0,211,0.4,0.120711185,5
2020-09-20-170235,170235,1,0,0,212,1.6,0.033793688,6
2020-09-21-170235,170235,3,1,3,215,1.2,0.21269418,0
2020-09-22-170235,170235,2,0,5,217,1.8,0.2332999,1
2020-09-23-170235,170235,2,0,1,219,1.2,0.17459452,2
2020-09-24-170235,170235,0,0,0,219,2.2,0.15333405,3
2020-09-25-170235,170235,0,0,0,219,1.2,0.1273286,4
2020-09-26-170235,170235,2,0,0,221,1.0,0.26309556,5
2020-09-27-170235,170235,1,0,1,222,0.0,0.057688136,6
2020-09-28-170235,170235,1,0,0,223,0.6,0.21383159,0
2020-09-29-170235,170235,0,0,2,223,0.6,0.12520795,1
2020-09-30-170235,170235,1,0,1,224,1.4,0.2834707,2
2020-10-01-170235,170235,0,0,2,224,1.4,0.17401715,3
2020-10-02-170235,170235,2,0,1,226,1.2,0.14234862,4
2020-10-03-170235,170235,0,0,1,226,0.0,0.041421372,5
2020-10-04-170235,170235,0,0,1,226,0.6,0.07345357,6
2020-10-05-170235,170235,3,0,0,229,0.8,0.24884327,0
2020-10-06-170235,170235,5,0,1,234,2.2,0.39772454,1
2020-10-07-170235,170235,1,1,2,235,1.2,0.3319771,2
2020-10-08-170235,170235,0,1,2,235,0.6,0.22216362,3
2020-10-09-170235,170235,0,0,3,235,0.6,0.17468326,4
2020-10-10-170235,170235,0,0,0,235,0.2,0.092694886,5
2020-10-11-170235,170235,1,0,0,236,0.0,0.0598215,6
2020-10-12-170235,170235,0,0,0,236,0.2,0.074847504,0
2020-10-13-170235,170235,2,0,1,238,0.8,0.23735999,1
2020-10-14-170235,170235,1,0,1,239,1.4,0.41079503,2
2020-10-15-170235,170235,2,0,3,241,0.6,0.46428818,3
2020-10-16-170235,170235,1,0,0,242,1.0,0.5535511,4
2020-10-17-170235,170235,1,0,0,243,0.2,0.121509485,5
2020-10-18-170235,170235,1,0,0,244,1.2,0.20562084,6
2020-10-19-170235,170235,0,0,2,244,0.4,0.33449823,0
2020-10-20-170235,170235,1,0,1,245,1.6,0.2697068,1
2020-10-21-170235,170235,2,0,3,247,2.8,0.54719937,2
2020-10-22-170235,170235,2,0,0,249,3.2,0.47731483,3
2020-10-23-170235,170235,3,0,4,252,1.0,0.30684978,4
2020-10-24-170235,170235,0,0,1,252,0.6,0.21798038,5
2020-10-25-170235,170235,0,0,5,252,0.6,0.11470767,6
2020-10-26-170235,170235,0,0,4,252,1.0,0.32996625,0
2020-10-27-170235,170235,1,0,6,253,1.6,0.36549905,1
2020-10-28-170235,170235,1,0,8,254,4.2,0.8694489,2
2020-10-29-170235,170235,3,0,3,257,2.6,0.41007227,3
2020-10-30-170235,170235,0,0,6,257,3.0,0.60458934,4
2020-10-31-170235,170235,0,0,0,257,3.0,0.48851097,5
2020-11-01-170235,170235,0,0,0,257,1.6,0.34669825,6
2020-11-02-170235,170235,2,0,0,259,0.6,0.2188123,0
2020-11-03-170235,170235,1,1,0,260,3.0,0.5618674,1
2020-11-04-170235,170235,3,0,0,263,3.0,0.5198924,2
2020-11-05-170235,170235,0,0,0,263,2.0,0.49237317,3
2020-11-06-170235,170235,4,0,0,267,2.2,0.4410675,4
2020-11-07-170235,170235,1,0,0,268,1.4,0.41365448,5
2020-11-08-170235,170235,5,0,0,273,1.0,0.3210059,6
2020-11-09-170235,170235,4,0,0,277,3.2,0.66877586,0
2020-11-10-170235,170235,6,0,0,283,2.6,0.4766271,1
2020-11-11-170235,170235,8,0,0,291,3.0,0.5663983,2
2020-11-12-170235,170235,3,0,0,294,2.0,0.41893747,3
2020-11-13-170235,170235,6,0,0,300,3.6,0.57311255,4
2020-03-01-170236,170236,0,0,9,0,0.5,7.8502955e-05,6
2020-03-02-170236,170236,3,0,16,3,0.0,0.019715922,0
2020-03-03-170236,170236,2,0,18,5,0.0,0.029700814,1
2020-03-04-170236,170236,1,0,28,6,0.5,0.64044166,2
2020-03-05-170236,170236,0,0,41,6,0.75,0.0006369374,3
2020-03-06-170236,170236,0,0,28,6,0.25,0.63749564,4
2020-03-07-170236,170236,0,1,12,6,0.0,0.006961269,5
2020-03-08-170236,170236,1,0,15,7,0.25,0.0036249284,6
2020-03-09-170236,170236,1,0,39,8,0.75,1.3767161,0
2020-03-10-170236,170236,2,0,38,10,1.5,0.06507437,1
2020-03-11-170236,170236,1,0,26,11,1.75,0.3772304,2
2020-03-12-170236,170236,6,0,20,17,1.25,0.18187566,3
2020-03-13-170236,170236,4,0,28,21,3.0,1.0682288,4
2020-03-14-170236,170236,5,0,10,26,2.75,1.3758538,5
2020-03-15-170236,170236,9,0,6,35,3.25,0.3959897,6
2020-03-16-170236,170236,16,0,24,51,10.25,1.107294,0
2020-03-17-170236,170236,18,0,14,69,10.5,2.2207024,1
2020-03-18-170236,170236,28,0,12,97,12.5,2.656444,2
2020-03-19-170236,170236,41,0,12,138,15.25,3.5218349,3
2020-03-20-170236,170236,28,3,16,166,17.5,5.5233364,4
2020-03-21-170236,170236,12,0,5,178,6.25,0.62764716,5
2020-03-22-170236,170236,15,0,6,193,8.0,0.42046124,6
2020-03-23-170236,170236,39,0,19,232,18.75,4.4592495,0
2020-03-24-170236,170236,38,0,6,270,15.5,3.853528,1
2020-03-25-170236,170236,26,0,10,296,13.75,3.6904993,2
2020-03-26-170236,170236,20,0,9,316,14.25,3.685064,3
2020-03-27-170236,170236,28,0,19,344,13.5,3.5639076,4
2020-03-28-170236,170236,10,0,3,354,5.25,0.3704489,5
2020-03-29-170236,170236,6,0,3,360,4.5,0.46658126,6
2020-03-30-170236,170236,24,0,22,384,10.5,2.6979287,0
2020-03-31-170236,170236,14,0,15,398,8.0,1.2181541,1
2020-04-01-170236,170236,12,0,18,410,6.75,1.2721651,2
2020-04-02-170236,170236,12,0,16,422,7.75,1.787166,3
2020-04-03-170236,170236,16,0,14,438,7.75,2.2563612,4
2020-04-04-170236,170236,5,0,1,443,1.25,0.025570368,5
2020-04-05-170236,170236,6,0,1,449,4.25,0.29433754,6
2020-04-06-170236,170236,19,0,9,468,10.25,2.5894105,0
2020-04-07-170236,170236,6,0,11,474,5.5,2.0567598,1
2020-04-08-170236,170236,10,0,15,484,6.0,2.2189114,2
2020-04-09-170236,170236,9,0,2,493,3.25,1.8722904,3
2020-04-10-170236,170236,19,0,6,512,4.5,0.78369725,4
2020-04-11-170236,170236,3,0,4,515,2.75,0.48832864,5
2020-04-12-170236,170236,3,0,3,518,1.5,0.15847528,6
2020-04-13-170236,170236,22,0,13,540,5.5,1.5303478,0
2020-04-14-170236,170236,15,0,10,555,5.0,1.3596804,1
2020-04-15-170236,170236,18,0,7,573,15.5,2.7769644,2
2020-04-16-170236,170236,16,0,12,589,5.5,1.2429044,3
2020-04-17-170236,170236,14,0,1,603,4.0,1.1321447,4
2020-04-18-170236,170236,1,0,2,604,2.25,0.29457524,5
2020-04-19-170236,170236,1,0,3,605,1.75,0.79406375,6
2020-04-20-170236,170236,9,0,5,614,4.75,2.2237773,0
2020-04-21-170236,170236,11,1,3,625,2.25,0.99250114,1
2020-04-22-170236,170236,15,0,6,640,2.75,0.45499697,2
2020-04-23-170236,170236,2,0,6,642,1.25,0.008364367,3
2020-04-24-170236,170236,6,0,10,648,2.5,1.2563425,4
2020-04-25-170236,170236,4,0,0,652,1.0,0.5881402,5
2020-04-26-170236,170236,3,0,0,655,0.75,0.29875734,6
2020-04-27-170236,170236,13,0,7,668,3.5,1.6626819,0
2020-04-28-170236,170236,10,0,6,678,3.25,0.48708838,1
2020-04-29-170236,170236,7,0,10,685,2.25,1.1889652,2
2020-04-30-170236,170236,12,1,14,697,2.5,0.85952693,3
2020-05-01-170236,170236,1,0,16,698,0.5,0.014018288,4
2020-05-02-170236,170236,2,0,1,700,0.0,0.3559998,5
2020-05-03-170236,170236,3,0,0,703,0.75,0.016291851,6
2020-05-04-170236,170236,5,0,19,708,3.0,1.6401225,0
2020-05-05-170236,170236,3,0,7,711,3.25,1.0317868,1
2020-05-06-170236,170236,6,0,8,717,3.0,0.99911255,2
2020-05-07-170236,170236,6,0,13,723,1.75,0.70160997,3
2020-05-08-170236,170236,10,0,8,733,2.25,2.350822,4
2020-05-09-170236,170236,0,0,0,733,0.0,0.008340003,5
2020-05-10-170236,170236,0,0,1,733,0.25,0.06616994,6
2020-05-11-170236,170236,7,0,6,740,4.0,1.070688,0
2020-05-12-170236,170236,6,1,3,746,3.25,0.9176204,1
2020-05-13-170236,170236,10,0,2,756,5.5,2.567552,2
2020-05-14-170236,170236,14,0,3,770,6.75,3.1567664,3
2020-05-15-170236,170236,16,0,6,786,3.75,1.5136622,4
2020-05-16-170236,170236,1,0,0,787,1.0,0.0002222886,5
2020-05-17-170236,170236,0,0,0,787,0.0,0.011726086,6
2020-05-18-170236,170236,19,0,0,806,4.5,1.4502535,0
2020-05-19-170236,170236,7,0,1,813,3.25,1.21142,1
2020-05-20-170236,170236,8,0,3,821,3.25,0.86517924,2
2020-05-21-170236,170236,13,0,2,834,2.75,0.93062127,3
2020-05-22-170236,170236,8,0,6,842,4.5,0.5044739,4
2020-05-23-170236,170236,0,0,1,842,0.0,0.00038744832,5
2020-05-24-170236,170236,1,0,0,843,0.0,0.0034372911,6
2020-05-25-170236,170236,6,0,4,849,4.5,1.6984584,0
2020-05-26-170236,170236,3,0,3,852,3.0,0.9103167,1
2020-05-27-170236,170236,2,0,1,854,2.5,0.9909048,2
2020-05-28-170236,170236,3,0,5,857,3.0,1.9932709,3
2020-05-29-170236,170236,6,0,0,863,1.25,0.49778253,4
2020-05-30-170236,170236,0,0,0,863,0.0,0.0026622918,5
2020-05-31-170236,170236,0,0,2,863,0.0,0.0059670475,6
2020-06-01-170236,170236,0,0,4,863,2.0,0.06745523,0
2020-06-02-170236,170236,1,0,1,864,0.5,0.7440444,1
2020-06-03-170236,170236,3,0,1,867,1.0,0.1651414,2
2020-06-04-170236,170236,2,0,3,869,0.5,0.38373634,3
2020-06-05-170236,170236,6,0,0,875,1.5,0.40933225,4
2020-06-06-170236,170236,1,0,0,876,0.5,0.09629862,5
2020-06-07-170236,170236,0,2,0,876,0.0,0.0002035152,6
2020-06-08-170236,170236,4,0,1,880,1.25,0.87559783,0
2020-06-09-170236,170236,3,0,0,883,1.75,0.25841385,1
2020-06-10-170236,170236,1,0,2,884,1.25,0.12933432,2
2020-06-11-170236,170236,5,0,1,889,2.0,0.9245952,3
2020-06-12-170236,170236,0,0,0,889,0.25,0.83438647,4
2020-06-13-170236,170236,0,0,1,889,0.0,0.043446857,5
2020-06-14-170236,170236,2,0,0,891,0.0,0.006466314,6
2020-06-15-170236,170236,4,0,0,895,0.75,0.043395225,0
2020-06-16-170236,170236,1,0,0,896,0.75,0.3703023,1
2020-06-17-170236,170236,1,0,0,897,0.75,0.989392,2
2020-06-18-170236,170236,3,0,0,900,0.5,0.5816408,3
2020-06-19-170236,170236,0,0,0,900,0.5,0.02990752,4
2020-06-20-170236,170236,0,0,0,900,0.0,0.051163573,5
2020-06-21-170236,170236,0,0,0,900,0.0,0.061277095,6
2020-06-22-170236,170236,1,0,0,901,1.0,0.29502445,0
2020-06-23-170236,170236,0,0,0,901,0.25,1.1630714,1
2020-06-24-170236,170236,2,0,0,903,0.5,1.170812,2
2020-06-25-170236,170236,1,1,3,904,0.5,0.27348894,3
2020-06-26-170236,170236,0,1,1,904,1.25,1.018882,4
2020-06-27-170236,170236,1,0,0,905,0.25,0.64074874,5
2020-06-28-170236,170236,0,0,0,905,0.25,0.0057888995,6
2020-06-29-170236,170236,0,0,1,905,0.0,0.021408778,0
2020-06-30-170236,170236,0,0,1,905,0.75,0.9201663,1
2020-07-01-170236,170236,0,0,2,905,0.5,0.09089388,2
2020-07-02-170236,170236,0,1,1,905,0.0,0.053660322,3
2020-07-03-170236,170236,0,0,0,905,0.75,0.72323644,4
2020-07-04-170236,170236,0,0,3,905,0.0,0.0024140691,5
2020-07-05-170236,170236,0,0,0,905,0.0,0.0074124313,6
2020-07-06-170236,170236,0,0,2,905,0.0,0.13156766,0
2020-07-07-170236,170236,0,1,4,905,0.75,0.5695128,1
2020-07-08-170236,170236,0,0,2,905,0.25,0.11798824,2
2020-07-09-170236,170236,3,0,0,908,0.5,0.17881684,3
2020-07-10-170236,170236,1,0,1,909,0.25,0.05383617,4
2020-07-11-170236,170236,0,0,2,909,0.0,0.0022938144,5
2020-07-12-170236,170236,0,0,0,909,0.0,0.32347235,6
2020-07-13-170236,170236,1,0,0,910,1.75,0.029010944,0
2020-07-14-170236,170236,1,0,2,911,0.25,0.33393347,1
2020-07-15-170236,170236,2,0,1,913,4.0,0.65405536,2
2020-07-16-170236,170236,1,0,2,914,0.25,0.14387493,3
2020-07-17-170236,170236,0,0,0,914,1.25,0.35422167,4
2020-07-18-170236,170236,3,0,0,917,1.0,0.4354639,5
2020-07-19-170236,170236,0,0,1,917,0.5,0.11050036,6
2020-07-20-170236,170236,2,0,1,919,1.0,0.26966783,0
2020-07-21-170236,170236,4,0,0,923,0.75,0.04400015,1
2020-07-22-170236,170236,2,0,6,925,1.0,0.05580892,2
2020-07-23-170236,170236,0,0,4,925,1.5,0.6638161,3
2020-07-24-170236,170236,1,0,1,926,0.25,0.05528469,4
2020-07-25-170236,170236,2,0,4,928,0.25,0.012260462,5
2020-07-26-170236,170236,0,0,0,928,0.0,0.020329336,6
2020-07-27-170236,170236,0,0,2,928,1.5,1.3797553,0
2020-07-28-170236,170236,2,1,7,930,1.25,0.32352787,1
2020-07-29-170236,170236,1,0,9,931,2.25,1.3996781,2
2020-07-30-170236,170236,2,0,4,933,4.0,2.8128567,3
2020-07-31-170236,170236,0,0,4,933,3.0,1.9831765,4
2020-08-01-170236,170236,0,0,1,933,0.0,0.4153862,5
2020-08-02-170236,170236,1,0,4,934,0.25,1.7723227,6
2020-08-03-170236,170236,1,0,7,935,1.0,0.8415001,0
2020-08-04-170236,170236,0,0,6,935,3.0,3.995519,1
2020-08-05-170236,170236,6,0,5,941,2.5,4.1913233,2
2020-08-06-170236,170236,4,0,7,945,1.75,1.2356656,3
2020-08-07-170236,170236,1,0,3,946,2.25,2.088756,4
2020-08-08-170236,170236,4,0,8,950,1.25,1.9256766,5
2020-08-09-170236,170236,0,0,2,950,1.25,0.23060857,6
2020-08-10-170236,170236,2,0,9,952,4.75,4.0421176,0
2020-08-11-170236,170236,7,0,5,959,2.25,2.2584417,1
2020-08-12-170236,170236,9,0,6,968,4.75,4.319402,2
2020-08-13-170236,170236,4,0,5,972,2.75,3.4768589,3
2020-08-14-170236,170236,4,0,2,976,0.75,2.2202132,4
2020-08-15-170236,170236,1,0,3,977,1.0,0.71872663,5
2020-08-16-170236,170236,4,0,5,981,1.0,2.4547567,6
2020-08-17-170236,170236,7,0,12,988,2.5,2.0279202,0
2020-08-18-170236,170236,6,0,11,994,3.0,4.995587,1
2020-08-19-170236,170236,5,0,18,999,2.75,2.7823331,2
2020-08-20-170236,170236,7,0,7,1006,1.75,3.159281,3
2020-08-21-170236,170236,3,0,14,1009,3.25,5.037062,4
2020-08-22-170236,170236,8,1,4,1017,2.25,2.193858,5
2020-08-23-170236,170236,2,0,2,1019,1.5,1.0803782,6
2020-08-24-170236,170236,9,0,11,1028,6.75,3.5766094,0
2020-08-25-170236,170236,5,0,8,1033,4.25,3.2310846,1
2020-08-26-170236,170236,6,0,12,1039,5.75,2.2041497,2
2020-08-27-170236,170236,5,0,6,1044,6.5,2.024637,3
2020-08-28-170236,170236,2,0,13,1046,5.0,3.8222306,4
2020-08-29-170236,170236,3,0,3,1049,2.75,0.98020804,5
2020-08-30-170236,170236,5,0,6,1054,4.25,0.5354099,6
2020-08-31-170236,170236,12,0,9,1066,5.0,0.98351943,0
2020-09-01-170236,170236,11,0,9,1077,6.5,9.730329,1
2020-09-02-170236,170236,18,0,9,1095,4.75,2.835337,2
2020-09-03-170236,170236,7,0,15,1102,5.25,1.5312483,3
2020-09-04-170236,170236,14,0,7,1116,5.5,2.2306306,4
2020-09-05-170236,170236,4,1,2,1120,2.0,0.45896932,5
2020-09-06-170236,170236,2,0,0,1122,1.5,0.41596606,6
2020-09-07-170236,170236,11,0,4,1133,4.25,1.5350386,0
2020-09-08-170236,170236,8,0,11,1141,5.0,4.877888,1
2020-09-09-170236,170236,12,0,11,1153,5.0,1.9899285,2
2020-09-10-170236,170236,6,1,7,1159,10.75,1.6946019,3
2020-09-11-170236,170236,13,0,7,1172,6.5,3.6432376,4
2020-09-12-170236,170236,3,0,1,1175,3.5,2.1939344,5
2020-09-13-170236,170236,6,0,2,1181,4.0,1.0642058,6
2020-09-14-170236,170236,9,0,7,1190,10.5,2.270773,0
2020-09-15-170236,170236,9,0,4,1199,18.0,6.6588564,1
2020-09-16-170236,170236,9,0,5,1208,12.5,2.7744977,2
2020-09-17-170236,170236,15,0,12,1223,16.25,2.6888335,3
2020-09-18-170236,170236,7,0,9,1230,13.0,4.4074154,4
2020-09-19-170236,170236,2,1,4,1232,2.0,0.058089864,5
2020-09-20-170236,170236,0,0,2,1232,2.0,0.785747,6
2020-09-21-170236,170236,4,1,6,1236,18.25,2.5233748,0
2020-09-22-170236,170236,11,1,3,1247,13.0,2.5576127,1
2020-09-23-170236,170236,11,0,4,1258,10.0,3.607175,2
2020-09-24-170236,170236,7,0,15,1265,6.75,1.4091648,3
2020-09-25-170236,170236,7,0,15,1272,10.25,4.051716,4
2020-09-26-170236,170236,1,0,3,1273,1.25,1.6606246,5
2020-09-27-170236,170236,2,0,3,1275,0.5,0.52423394,6
2020-09-28-170236,170236,7,0,10,1282,7.0,3.3529074,0
2020-09-29-170236,170236,4,0,22,1286,6.0,4.277893,1
2020-09-30-170236,170236,5,0,3,1291,6.5,2.929823,2
2020-10-01-170236,170236,12,0,17,1303,7.5,2.3428254,3
2020-10-02-170236,170236,9,1,14,1312,14.0,2.0797932,4
2020-10-03-170236,170236,4,0,2,1316,3.25,1.546226,5
2020-10-04-170236,170236,2,1,3,1318,3.5,1.4839137,6
2020-10-05-170236,170236,6,0,24,1324,6.75,6.786545,0
2020-10-06-170236,170236,3,1,27,1327,9.0,6.01606,1
2020-10-07-170236,170236,4,2,41,1331,9.0,10.409475,2
2020-10-08-170236,170236,15,1,41,1346,7.25,3.174404,3
2020-10-09-170236,170236,15,0,20,1361,12.75,6.199447,4
2020-10-10-170236,170236,3,0,9,1364,3.0,1.076825,5
2020-10-11-170236,170236,3,0,12,1367,2.0,1.0659872,6
2020-10-12-170236,170236,10,0,30,1377,6.5,1.9770657,0
2020-10-13-170236,170236,22,0,31,1399,13.5,3.4235625,1
2020-10-14-170236,170236,3,0,37,1402,6.5,6.9262295,2
2020-10-15-170236,170236,17,0,35,1419,19.75,12.393247,3
2020-10-16-170236,170236,14,0,35,1433,13.5,18.133709,4
2020-10-17-170236,170236,2,0,22,1435,2.75,3.184867,5
2020-10-18-170236,170236,3,0,34,1438,3.5,1.2386874,6
2020-10-19-170236,170236,24,0,39,1462,17.5,10.943525,0
2020-10-20-170236,170236,27,0,40,1489,10.75,7.5815024,1
2020-10-21-170236,170236,41,0,26,1530,19.75,10.547924,2
2020-10-22-170236,170236,41,0,38,1571,17.5,11.655993,3
2020-10-23-170236,170236,20,0,62,1591,13.5,8.7972355,4
2020-10-24-170236,170236,9,1,26,1600,4.5,3.0646749,5
2020-10-25-170236,170236,12,2,15,1612,9.5,2.9702868,6
2020-10-26-170236,170236,30,1,47,1642,18.75,12.746438,0
2020-10-27-170236,170236,31,1,33,1673,16.25,10.593831,1
2020-10-28-170236,170236,37,2,52,1710,19.75,13.585137,2
2020-10-29-170236,170236,35,3,45,1745,20.5,8.14429,3
2020-10-30-170236,170236,35,0,86,1780,20.0,12.124857,4
2020-10-31-170236,170236,22,0,0,1802,6.5,3.8013394,5
2020-11-01-170236,170236,34,0,0,1836,16.25,2.7345269,6
2020-11-02-170236,170236,39,1,0,1875,9.0,5.3014374,0
2020-11-03-170236,170236,40,0,0,1915,19.0,9.394048,1
2020-11-04-170236,170236,26,0,0,1941,18.0,9.582547,2
2020-11-05-170236,170236,38,0,0,1979,20.25,8.198843,3
2020-11-06-170236,170236,62,1,0,2041,22.25,8.869314,4
2020-11-07-170236,170236,26,3,0,2067,12.75,5.0632806,5
2020-11-08-170236,170236,15,0,0,2082,12.0,6.1223726,6
2020-11-09-170236,170236,47,0,0,2129,22.25,15.128216,0
2020-11-10-170236,170236,33,1,0,2162,17.75,9.532895,1
2020-11-11-170236,170236,52,1,0,2214,16.25,6.79007,2
2020-11-12-170236,170236,45,0,0,2259,18.25,13.095213,3
2020-11-13-170236,170236,86,2,0,2345,21.75,10.726383,4
2020-03-01-170237,170237,0,0,4,0,0.0,7.74619e-05,6
2020-03-02-170237,170237,0,0,4,0,0.0,0.0037209531,0
2020-03-03-170237,170237,0,0,8,0,0.3333333333333333,0.008719399,1
2020-03-04-170237,170237,0,0,10,0,0.3333333333333333,0.18320991,2
2020-03-05-170237,170237,0,0,6,0,0.0,0.00040376466,3
2020-03-06-170237,170237,0,0,10,0,0.0,0.16759405,4
2020-03-07-170237,170237,0,0,4,0,0.3333333333333333,0.0021745234,5
2020-03-08-170237,170237,0,0,7,0,0.0,0.0019249365,6
2020-03-09-170237,170237,1,0,15,1,0.6666666666666666,0.59255034,0
2020-03-10-170237,170237,0,0,11,1,2.0,0.024625324,1
2020-03-11-170237,170237,5,0,6,6,0.6666666666666666,0.23046798,2
2020-03-12-170237,170237,3,0,14,9,1.0,0.074289106,3
2020-03-13-170237,170237,0,0,19,9,5.0,0.6855355,4
2020-03-14-170237,170237,2,0,3,11,2.333333333333333,0.66184187,5
2020-03-15-170237,170237,4,0,7,15,3.333333333333333,0.2966059,6
2020-03-16-170237,170237,4,0,12,19,8.333333333333334,0.55923826,0
2020-03-17-170237,170237,8,3,12,27,9.666666666666666,1.2072278,1
2020-03-18-170237,170237,10,2,5,37,14.333333333333336,0.96126336,2
2020-03-19-170237,170237,6,0,9,43,17.666666666666668,1.5773038,3
2020-03-20-170237,170237,10,0,7,53,15.666666666666664,2.1897147,4
2020-03-21-170237,170237,4,0,6,57,7.0,0.3216445,5
2020-03-22-170237,170237,7,0,3,64,10.0,0.34184405,6
2020-03-23-170237,170237,15,2,5,79,25.33333333333333,2.1467712,0
2020-03-24-170237,170237,11,0,7,90,19.33333333333333,1.5961388,1
2020-03-25-170237,170237,6,0,4,96,16.0,1.6037258,2
2020-03-26-170237,170237,14,0,2,110,14.0,1.1992918,3
2020-03-27-170237,170237,19,0,9,129,14.333333333333336,1.6288192,4
2020-03-28-170237,170237,3,0,18,132,4.666666666666667,0.1729341,5
2020-03-29-170237,170237,7,0,1,139,4.333333333333333,0.3401845,6
2020-03-30-170237,170237,12,0,11,151,17.0,1.6616578,0
2020-03-31-170237,170237,12,0,8,163,9.0,0.72767985,1
2020-04-01-170237,170237,5,0,4,168,10.666666666666666,0.68783516,2
2020-04-02-170237,170237,9,0,5,177,12.333333333333336,1.0342063,3
2020-04-03-170237,170237,7,0,1,184,13.0,1.0281414,4
2020-04-04-170237,170237,6,0,0,190,4.666666666666667,0.015796777,5
2020-04-05-170237,170237,3,1,0,193,1.6666666666666667,0.13758695,6
2020-04-06-170237,170237,5,0,2,198,7.666666666666668,0.7143959,0
2020-04-07-170237,170237,7,3,10,205,7.666666666666668,0.8314113,1
2020-04-08-170237,170237,4,4,5,209,8.333333333333334,0.9902748,2
2020-04-09-170237,170237,2,0,1,211,14.333333333333336,1.5056161,3
2020-04-10-170237,170237,9,1,1,220,9.333333333333334,0.46472454,4
2020-04-11-170237,170237,18,0,1,238,2.6666666666666665,0.23543708,5
2020-04-12-170237,170237,1,0,1,239,2.0,0.13368107,6
2020-04-13-170237,170237,11,0,2,250,9.333333333333334,1.0454644,0
2020-04-14-170237,170237,8,0,4,258,9.333333333333334,0.65209913,1
2020-04-15-170237,170237,4,0,7,262,10.666666666666666,1.548169,2
2020-04-16-170237,170237,5,0,5,267,6.333333333333332,0.81765646,3
2020-04-17-170237,170237,1,0,0,268,6.0,0.49708667,4
2020-04-18-170237,170237,0,0,2,268,0.6666666666666666,0.046128675,5
2020-04-19-170237,170237,0,0,0,268,3.6666666666666665,0.44378734,6
2020-04-20-170237,170237,2,0,5,270,9.333333333333334,1.2449255,0
2020-04-21-170237,170237,10,0,1,280,6.666666666666668,0.60492307,1
2020-04-22-170237,170237,5,1,9,285,5.666666666666668,0.27857715,2
2020-04-23-170237,170237,1,1,2,286,2.6666666666666665,0.013240576,3
2020-04-24-170237,170237,1,0,4,287,4.666666666666667,0.48089463,4
2020-04-25-170237,170237,1,0,0,288,2.0,0.09870386,5
2020-04-26-170237,170237,1,0,0,289,2.333333333333333,0.08855248,6
2020-04-27-170237,170237,2,0,14,291,5.333333333333333,0.5794122,0
2020-04-28-170237,170237,4,0,6,295,4.333333333333333,0.26681072,1
2020-04-29-170237,170237,7,0,6,302,5.666666666666668,0.7200303,2
2020-04-30-170237,170237,5,0,7,307,2.0,0.20903683,3
2020-05-01-170237,170237,0,0,6,307,1.0,0.004403071,4
2020-05-02-170237,170237,2,0,0,309,2.0,0.061716266,5
2020-05-03-170237,170237,0,0,1,309,0.6666666666666666,0.008181511,6
2020-05-04-170237,170237,5,0,5,314,2.6666666666666665,0.45004892,0
2020-05-05-170237,170237,1,0,4,315,3.6666666666666665,0.47511318,1
2020-05-06-170237,170237,9,0,10,324,3.0,0.24350864,2
2020-05-07-170237,170237,2,0,5,326,2.333333333333333,0.25924152,3
2020-05-08-170237,170237,4,0,4,330,5.666666666666668,0.79968286,4
2020-05-09-170237,170237,0,0,0,330,0.0,0.002647151,5
2020-05-10-170237,170237,0,0,0,330,0.6666666666666666,0.059765756,6
2020-05-11-170237,170237,14,0,3,344,4.333333333333333,0.25387463,0
2020-05-12-170237,170237,6,0,5,350,4.333333333333333,0.38707936,1
2020-05-13-170237,170237,6,2,2,356,8.0,0.9034718,2
2020-05-14-170237,170237,7,0,5,363,7.0,1.0423688,3
2020-05-15-170237,170237,6,0,3,369,4.666666666666667,0.61434984,4
2020-05-16-170237,170237,0,0,0,369,1.3333333333333333,0.00014081453,5
2020-05-17-170237,170237,1,0,0,370,0.0,0.007187204,6
2020-05-18-170237,170237,5,0,5,375,5.666666666666668,0.695285,0
2020-05-19-170237,170237,4,0,1,379,5.666666666666668,0.57574755,1
2020-05-20-170237,170237,10,0,2,389,4.333333333333333,0.3194905,2
2020-05-21-170237,170237,5,0,0,394,4.333333333333333,0.3883002,3
2020-05-22-170237,170237,4,1,2,398,2.333333333333333,0.33896738,4
2020-05-23-170237,170237,0,0,0,398,0.3333333333333333,0.0003450687,5
2020-05-24-170237,170237,0,0,0,398,0.0,0.00010711738,6
2020-05-25-170237,170237,3,0,2,401,2.333333333333333,0.5649726,0
2020-05-26-170237,170237,5,0,3,406,3.333333333333333,0.34338474,1
2020-05-27-170237,170237,2,1,1,408,3.0,0.37044847,2
2020-05-28-170237,170237,5,0,0,413,1.6666666666666667,0.556682,3
2020-05-29-170237,170237,3,0,0,416,2.0,0.25702706,4
2020-05-30-170237,170237,0,0,1,416,0.0,0.00031552647,5
2020-05-31-170237,170237,0,0,0,416,0.0,0.0046611815,6
2020-06-01-170237,170237,5,0,1,421,2.333333333333333,0.029384986,0
2020-06-02-170237,170237,1,0,1,422,2.0,0.4569792,1
2020-06-03-170237,170237,2,1,1,424,2.333333333333333,0.0633958,2
2020-06-04-170237,170237,0,0,0,424,1.6666666666666667,0.2041089,3
2020-06-05-170237,170237,2,0,0,426,1.6666666666666667,0.21310532,4
2020-06-06-170237,170237,0,0,0,426,1.3333333333333333,0.048018925,5
2020-06-07-170237,170237,0,0,0,426,0.0,0.00022603918,6
2020-06-08-170237,170237,2,0,1,428,1.0,0.28827578,0
2020-06-09-170237,170237,3,0,1,431,1.6666666666666667,0.14828497,1
2020-06-10-170237,170237,1,0,0,432,3.333333333333333,0.059581637,2
2020-06-11-170237,170237,0,0,0,432,1.0,0.30340642,3
2020-06-12-170237,170237,0,0,1,432,1.0,0.36457944,4
2020-06-13-170237,170237,1,0,0,433,0.0,0.027098661,5
2020-06-14-170237,170237,0,0,0,433,0.3333333333333333,0.0030858265,6
2020-06-15-170237,170237,1,0,0,434,1.6666666666666667,0.014990893,0
2020-06-16-170237,170237,1,0,1,435,1.0,0.19149168,1
2020-06-17-170237,170237,1,0,1,436,1.6666666666666667,0.34097153,2
2020-06-18-170237,170237,0,0,0,436,0.6666666666666666,0.3097795,3
2020-06-19-170237,170237,0,0,1,436,0.3333333333333333,0.0135756,4
2020-06-20-170237,170237,0,0,1,436,0.3333333333333333,0.022656836,5
2020-06-21-170237,170237,0,0,0,436,0.3333333333333333,0.025205426,6
2020-06-22-170237,170237,1,0,1,437,1.0,0.14783943,0
2020-06-23-170237,170237,1,0,1,438,1.3333333333333333,0.43388236,1
2020-06-24-170237,170237,0,0,1,438,1.6666666666666667,0.63616604,2
2020-06-25-170237,170237,0,0,2,438,0.3333333333333333,0.13899988,3
2020-06-26-170237,170237,1,0,1,439,1.0,0.35458416,4
2020-06-27-170237,170237,0,0,0,439,0.3333333333333333,0.22247003,5
2020-06-28-170237,170237,0,0,0,439,0.0,0.0023447792,6
2020-06-29-170237,170237,0,0,1,439,0.3333333333333333,0.012221346,0
2020-06-30-170237,170237,1,0,2,440,0.3333333333333333,0.30427957,1
2020-07-01-170237,170237,1,0,0,441,1.0,0.027649308,2
2020-07-02-170237,170237,0,0,3,441,0.0,0.0227874,3
2020-07-03-170237,170237,1,0,0,442,0.3333333333333333,0.1751163,4
2020-07-04-170237,170237,1,0,0,443,0.0,0.0009614449,5
2020-07-05-170237,170237,0,0,1,443,0.0,0.0030607586,6
2020-07-06-170237,170237,1,0,1,444,0.0,0.044466924,0
2020-07-07-170237,170237,1,0,0,445,0.6666666666666666,0.30470967,1
2020-07-08-170237,170237,1,0,0,446,0.3333333333333333,0.04038738,2
2020-07-09-170237,170237,2,0,0,448,0.3333333333333333,0.06400263,3
2020-07-10-170237,170237,1,0,1,449,0.0,0.022286752,4
2020-07-11-170237,170237,0,0,0,449,0.0,0.00050399586,5
2020-07-12-170237,170237,0,0,0,449,0.6666666666666666,0.16538577,6
2020-07-13-170237,170237,1,0,0,450,0.6666666666666666,0.015327754,0
2020-07-14-170237,170237,2,0,0,452,1.0,0.16162376,1
2020-07-15-170237,170237,0,0,0,452,1.6666666666666667,0.18180461,2
2020-07-16-170237,170237,3,0,1,455,0.6666666666666666,0.06386518,3
2020-07-17-170237,170237,0,0,3,455,2.6666666666666665,0.19320552,4
2020-07-18-170237,170237,0,0,1,455,0.6666666666666666,0.099942826,5
2020-07-19-170237,170237,1,0,0,456,0.3333333333333333,0.04791837,6
2020-07-20-170237,170237,1,0,5,457,1.6666666666666667,0.13694271,0
2020-07-21-170237,170237,0,0,2,457,0.6666666666666666,0.018550323,1
2020-07-22-170237,170237,0,0,0,457,1.3333333333333333,0.025147166,2
2020-07-23-170237,170237,0,0,1,457,0.3333333333333333,0.18661004,3
2020-07-24-170237,170237,1,0,4,458,0.3333333333333333,0.023820236,4
2020-07-25-170237,170237,0,0,2,458,0.6666666666666666,0.0079745995,5
2020-07-26-170237,170237,0,0,0,458,0.3333333333333333,0.005044228,6
2020-07-27-170237,170237,0,0,2,458,3.6666666666666665,0.5700917,0
2020-07-28-170237,170237,0,0,3,458,1.0,0.155407,1
2020-07-29-170237,170237,0,0,5,458,3.0,0.51976305,2
2020-07-30-170237,170237,1,0,4,459,3.333333333333333,0.97464156,3
2020-07-31-170237,170237,3,0,3,462,3.6666666666666665,0.8659285,4
2020-08-01-170237,170237,1,0,0,463,2.0,0.24671748,5
2020-08-02-170237,170237,0,0,3,463,0.6666666666666666,1.0921725,6
2020-08-03-170237,170237,5,0,0,468,2.6666666666666665,0.4313422,0
2020-08-04-170237,170237,2,0,4,470,4.666666666666667,1.9271139,1
2020-08-05-170237,170237,0,1,3,470,5.666666666666668,1.7739271,2
2020-08-06-170237,170237,1,0,4,471,3.6666666666666665,0.56939065,3
2020-08-07-170237,170237,4,0,0,475,1.0,0.63938063,4
2020-08-08-170237,170237,2,0,1,477,2.333333333333333,0.79501957,5
2020-08-09-170237,170237,0,0,0,477,1.0,0.0941813,6
2020-08-10-170237,170237,2,1,3,479,2.333333333333333,1.1935725,0
2020-08-11-170237,170237,3,6,4,482,5.0,1.0879494,1
2020-08-12-170237,170237,5,0,3,487,6.0,1.9984572,2
2020-08-13-170237,170237,4,0,5,491,5.333333333333333,1.384218,3
2020-08-14-170237,170237,3,0,2,494,5.0,1.0416458,4
2020-08-15-170237,170237,0,0,0,494,2.6666666666666665,0.38086277,5
2020-08-16-170237,170237,3,0,6,497,3.0,1.0586168,6
2020-08-17-170237,170237,0,0,2,497,4.0,0.8490517,0
2020-08-18-170237,170237,4,0,3,501,10.666666666666666,2.1042402,1
2020-08-19-170237,170237,3,0,2,504,4.0,0.9632246,2
2020-08-20-170237,170237,4,0,19,508,3.6666666666666665,1.0808038,3
2020-08-21-170237,170237,0,0,9,508,6.333333333333332,2.0360296,4
2020-08-22-170237,170237,1,0,5,509,5.0,0.9477578,5
2020-08-23-170237,170237,0,0,0,509,0.6666666666666666,0.4883914,6
2020-08-24-170237,170237,3,1,11,512,10.0,1.510142,0
2020-08-25-170237,170237,4,0,2,516,6.333333333333332,1.0827612,1
2020-08-26-170237,170237,3,0,2,519,5.333333333333333,0.6950174,2
2020-08-27-170237,170237,5,0,0,524,5.333333333333333,0.5917904,3
2020-08-28-170237,170237,2,0,0,526,3.333333333333333,1.2182903,4
2020-08-29-170237,170237,0,0,0,526,1.0,0.42985007,5
2020-08-30-170237,170237,6,0,4,532,1.3333333333333333,0.186214,6
2020-08-31-170237,170237,2,0,5,534,5.333333333333333,0.4805899,0
2020-09-01-170237,170237,3,0,1,537,6.666666666666668,3.509035,1
2020-09-02-170237,170237,2,0,5,539,5.666666666666668,1.242694,2
2020-09-03-170237,170237,19,0,5,558,4.666666666666667,0.5101435,3
2020-09-04-170237,170237,9,1,8,567,6.666666666666668,0.9173023,4
2020-09-05-170237,170237,5,1,1,572,4.0,0.2218069,5
2020-09-06-170237,170237,0,0,4,572,2.0,0.20300277,6
2020-09-07-170237,170237,11,0,12,583,4.666666666666667,0.8190891,0
2020-09-08-170237,170237,2,0,9,585,10.0,2.4127038,1
2020-09-09-170237,170237,2,0,8,587,6.333333333333332,0.8414156,2
2020-09-10-170237,170237,0,2,4,587,9.0,0.73780704,3
2020-09-11-170237,170237,0,0,8,587,6.333333333333332,1.5600743,4
2020-09-12-170237,170237,0,0,1,587,3.0,0.93902487,5
2020-09-13-170237,170237,4,1,3,591,5.0,0.60263944,6
2020-09-14-170237,170237,5,0,3,596,7.333333333333332,0.8231176,0
2020-09-15-170237,170237,1,0,5,597,15.666666666666664,3.2750232,1
2020-09-16-170237,170237,5,1,4,602,8.333333333333334,1.3721113,2
2020-09-17-170237,170237,5,0,2,607,12.0,0.8647953,3
2020-09-18-170237,170237,8,0,6,615,10.666666666666666,1.4894933,4
2020-09-19-170237,170237,1,0,4,616,1.3333333333333333,0.025042592,5
2020-09-20-170237,170237,4,0,1,620,3.0,0.4984032,6
2020-09-21-170237,170237,12,1,3,632,10.333333333333334,1.0625904,0
2020-09-22-170237,170237,9,0,1,641,10.666666666666666,0.98256075,1
2020-09-23-170237,170237,8,1,9,649,15.666666666666664,1.5863669,2
2020-09-24-170237,170237,4,1,7,653,8.0,0.5823623,3
2020-09-25-170237,170237,8,1,3,661,13.0,2.01323,4
2020-09-26-170237,170237,1,0,2,662,0.0,0.45897833,5
2020-09-27-170237,170237,3,0,3,665,1.6666666666666667,0.28860018,6
2020-09-28-170237,170237,3,1,5,668,8.666666666666666,1.0746869,0
2020-09-29-170237,170237,5,0,7,673,4.666666666666667,1.35563,1
2020-09-30-170237,170237,4,0,3,677,10.0,0.90109134,2
2020-10-01-170237,170237,2,0,18,679,6.333333333333332,0.9544124,3
2020-10-02-170237,170237,6,0,8,685,7.0,0.9038746,4
2020-10-03-170237,170237,4,0,3,689,3.6666666666666665,0.5037636,5
2020-10-04-170237,170237,1,0,1,690,5.333333333333333,0.61538845,6
2020-10-05-170237,170237,3,1,13,693,6.666666666666668,2.5008767,0
2020-10-06-170237,170237,1,0,15,694,7.0,2.2588534,1
2020-10-07-170237,170237,9,0,12,703,8.0,3.7645965,2
2020-10-08-170237,170237,7,0,10,710,6.666666666666668,1.2562456,3
2020-10-09-170237,170237,3,0,86,713,17.0,2.5349295,4
2020-10-10-170237,170237,2,0,5,715,2.333333333333333,0.39439014,5
2020-10-11-170237,170237,3,0,17,718,5.0,0.5242074,6
2020-10-12-170237,170237,5,0,25,723,7.333333333333332,0.77447677,0
2020-10-13-170237,170237,7,0,30,730,14.333333333333336,1.3032289,1
2020-10-14-170237,170237,3,0,27,733,9.0,2.790492,2
2020-10-15-170237,170237,18,0,50,751,13.0,3.970897,3
2020-10-16-170237,170237,8,0,21,759,16.666666666666668,5.313894,4
2020-10-17-170237,170237,3,0,5,762,4.0,0.97439796,5
2020-10-18-170237,170237,1,0,5,763,4.0,0.5607345,6
2020-10-19-170237,170237,13,0,1,776,19.666666666666668,3.740624,0
2020-10-20-170237,170237,15,0,17,791,18.33333333333333,2.7199295,1
2020-10-21-170237,170237,12,0,14,803,17.0,3.6888943,2
2020-10-22-170237,170237,10,0,17,813,18.33333333333333,4.207924,3
2020-10-23-170237,170237,86,0,23,899,18.33333333333333,2.9268575,4
2020-10-24-170237,170237,5,0,9,904,7.666666666666668,1.2577993,5
2020-10-25-170237,170237,17,0,10,921,6.333333333333332,1.0511798,6
2020-10-26-170237,170237,25,0,19,946,33.666666666666664,4.8294106,0
2020-10-27-170237,170237,30,1,12,976,20.666666666666668,4.1996517,1
2020-10-28-170237,170237,27,0,18,1003,20.666666666666668,4.818612,2
2020-10-29-170237,170237,50,1,21,1053,17.333333333333332,3.061699,3
2020-10-30-170237,170237,21,0,19,1074,21.66666666666667,4.8314424,4
2020-10-31-170237,170237,5,0,0,1079,9.333333333333334,1.7523702,5
2020-11-01-170237,170237,5,0,0,1084,21.66666666666667,1.2825948,6
2020-11-02-170237,170237,1,0,0,1085,9.333333333333334,1.6510074,0
2020-11-03-170237,170237,17,3,0,1102,24.66666666666667,3.805782,1
2020-11-04-170237,170237,14,0,0,1116,22.33333333333333,3.6501217,2
2020-11-05-170237,170237,17,2,0,1133,17.333333333333332,2.891219,3
2020-11-06-170237,170237,23,1,0,1156,37.333333333333336,3.9126928,4
2020-11-07-170237,170237,9,1,0,1165,10.333333333333334,1.3182685,5
2020-11-08-170237,170237,10,2,0,1175,18.666666666666668,2.646177,6
2020-11-09-170237,170237,19,0,0,1194,26.33333333333333,5.021133,0
2020-11-10-170237,170237,12,0,0,1206,17.666666666666668,3.293261,1
2020-11-11-170237,170237,18,1,0,1224,13.0,2.188985,2
2020-11-12-170237,170237,21,0,0,1245,25.33333333333333,4.704848,3
2020-11-13-170237,170237,19,4,0,1264,22.33333333333333,3.8757706,4
2020-03-01-170301,170301,0,0,0,0,0.14285714285714285,7.500978e-05,6
2020-03-02-170301,170301,0,0,10,0,0.0,0.0007815664,0
2020-03-03-170301,170301,0,0,6,0,0.0,0.0015931264,1
2020-03-04-170301,170301,0,0,14,0,0.0,0.0020550478,2
2020-03-05-170301,170301,0,0,12,0,0.0,0.00045916578,3
2020-03-06-170301,170301,0,0,15,0,0.0,0.00038941755,4
2020-03-07-170301,170301,0,0,3,0,0.0,0.0010654952,5
2020-03-08-170301,170301,0,0,0,0,0.0,0.0010024101,6
2020-03-09-170301,170301,0,0,15,0,0.14285714285714285,0.0660334,0
2020-03-10-170301,170301,0,0,12,0,0.0,0.004412518,1
2020-03-11-170301,170301,0,0,18,0,0.14285714285714285,0.009612717,2
2020-03-12-170301,170301,1,0,6,1,0.14285714285714285,0.08812675,3
2020-03-13-170301,170301,0,0,20,1,0.0,0.03192888,4
2020-03-14-170301,170301,0,0,4,1,1.1428571428571428,0.13473344,5
2020-03-15-170301,170301,0,0,10,1,1.1428571428571428,0.14346448,6
2020-03-16-170301,170301,10,0,7,11,9.571428571428571,2.0293016,0
2020-03-17-170301,170301,6,0,11,17,12.142857142857142,1.7110941,1
2020-03-18-170301,170301,14,0,6,31,12.428571428571427,2.2574573,2
2020-03-19-170301,170301,12,0,10,43,13.428571428571427,2.6500118,3
2020-03-20-170301,170301,15,0,7,58,12.142857142857142,2.4585774,4
2020-03-21-170301,170301,3,0,3,61,2.7142857142857144,0.52390057,5
2020-03-22-170301,170301,0,0,2,61,4.0,0.3464942,6
2020-03-23-170301,170301,15,0,5,76,18.714285714285715,3.541864,0
2020-03-24-170301,170301,12,0,5,88,13.857142857142858,2.4091918,1
2020-03-25-170301,170301,18,0,3,106,13.142857142857142,2.8973284,2
2020-03-26-170301,170301,6,0,3,112,12.571428571428573,1.7475585,3
2020-03-27-170301,170301,20,0,35,132,13.714285714285715,2.9812274,4
2020-03-28-170301,170301,4,0,5,136,3.571428571428572,0.5898545,5
2020-03-29-170301,170301,10,0,6,146,0.8571428571428571,0.58988726,6
2020-03-30-170301,170301,7,0,23,153,13.0,1.9475619,0
2020-03-31-170301,170301,11,0,15,164,11.714285714285715,1.8077105,1
2020-04-01-170301,170301,6,0,22,170,8.714285714285714,1.5124544,2
2020-04-02-170301,170301,10,0,14,180,6.0,1.3548737,3
2020-04-03-170301,170301,7,0,3,187,7.142857142857142,1.2606902,4
2020-04-04-170301,170301,3,0,0,190,1.7142857142857142,0.35157102,5
2020-04-05-170301,170301,2,0,1,192,1.1428571428571428,0.22240412,6
2020-04-06-170301,170301,5,0,3,197,11.571428571428573,1.7372997,0
2020-04-07-170301,170301,5,1,5,202,6.0,1.2438207,1
2020-04-08-170301,170301,3,0,2,205,10.571428571428571,1.5180434,2
2020-04-09-170301,170301,3,1,1,208,5.285714285714286,0.6295006,3
2020-04-10-170301,170301,35,0,6,243,5.571428571428571,2.2168815,4
2020-04-11-170301,170301,5,0,1,248,1.0,0.4001513,5
2020-04-12-170301,170301,6,0,1,254,1.2857142857142858,0.53266543,6
2020-04-13-170301,170301,23,0,0,277,5.428571428571429,2.7545075,0
2020-04-14-170301,170301,15,0,5,292,7.428571428571429,2.92873,1
2020-04-15-170301,170301,22,0,1,314,6.0,2.6822355,2
2020-04-16-170301,170301,14,0,6,328,6.2857142857142865,2.3411684,3
2020-04-17-170301,170301,3,0,1,331,4.428571428571429,0.9674488,4
2020-04-18-170301,170301,0,0,0,331,0.2857142857142857,0.057394676,5
2020-04-19-170301,170301,1,0,0,332,0.7142857142857143,0.08672042,6
2020-04-20-170301,170301,3,0,3,335,10.571428571428571,1.5837702,0
2020-04-21-170301,170301,5,0,1,340,8.285714285714286,1.3403077,1
2020-04-22-170301,170301,2,0,6,342,3.1428571428571432,0.74037904,2
2020-04-23-170301,170301,1,0,0,343,1.5714285714285714,0.22468263,3
2020-04-24-170301,170301,6,0,5,349,5.428571428571429,1.5253834,4
2020-04-25-170301,170301,1,0,1,350,1.4285714285714286,0.2967255,5
2020-04-26-170301,170301,1,0,0,351,0.42857142857142855,0.13191362,6
2020-04-27-170301,170301,0,0,2,351,3.4285714285714284,0.5886119,0
2020-04-28-170301,170301,5,0,1,356,2.571428571428572,0.78691435,1
2020-04-29-170301,170301,1,1,1,357,2.8571428571428568,0.39734498,2
2020-04-30-170301,170301,6,0,5,363,3.571428571428572,0.6091511,3
2020-05-01-170301,170301,1,0,3,364,0.2857142857142857,0.043793317,4
2020-05-02-170301,170301,0,0,0,364,1.1428571428571428,0.12581345,5
2020-05-03-170301,170301,0,0,0,364,1.4285714285714286,0.14921032,6
2020-05-04-170301,170301,3,0,2,367,4.0,0.63158643,0
2020-05-05-170301,170301,1,0,1,368,3.0,0.7348375,1
2020-05-06-170301,170301,6,0,0,374,2.8571428571428568,0.84304357,2
2020-05-07-170301,170301,0,0,5,374,2.4285714285714284,0.53507555,3
2020-05-08-170301,170301,5,0,0,379,3.1428571428571432,0.8325955,4
2020-05-09-170301,170301,1,0,0,380,1.0,0.21464232,5
2020-05-10-170301,170301,0,0,2,380,0.2857142857142857,0.04496927,6
2020-05-11-170301,170301,2,1,3,382,3.0,0.5694083,0
2020-05-12-170301,170301,1,0,1,383,1.7142857142857142,0.2835116,1
2020-05-13-170301,170301,1,0,1,384,3.8571428571428568,0.38163924,2
2020-05-14-170301,170301,5,1,2,389,3.571428571428572,1.0976847,3
2020-05-15-170301,170301,3,0,1,392,2.2857142857142856,0.54295236,4
2020-05-16-170301,170301,0,0,0,392,0.14285714285714285,0.075440936,5
2020-05-17-170301,170301,0,0,0,392,0.14285714285714285,0.04258015,6
2020-05-18-170301,170301,2,0,2,394,2.7142857142857144,0.5171127,0
2020-05-19-170301,170301,1,0,5,395,3.4285714285714284,0.6743357,1
2020-05-20-170301,170301,0,1,0,395,2.4285714285714284,0.43819028,2
2020-05-21-170301,170301,5,0,0,400,3.0,0.83254415,3
2020-05-22-170301,170301,0,0,2,400,3.0,0.5822709,4
2020-05-23-170301,170301,0,0,0,400,0.2857142857142857,0.04118573,5
2020-05-24-170301,170301,2,0,0,402,0.0,0.1208988,6
2020-05-25-170301,170301,3,0,1,405,1.7142857142857142,0.39139557,0
2020-05-26-170301,170301,1,0,0,406,2.0,0.5101911,1
2020-05-27-170301,170301,1,0,5,407,1.2857142857142858,0.58384556,2
2020-05-28-170301,170301,2,2,0,409,2.0,0.68685246,3
2020-05-29-170301,170301,1,0,0,410,1.4285714285714286,0.47121158,4
2020-05-30-170301,170301,0,1,0,410,1.0,0.14322463,5
2020-05-31-170301,170301,0,0,0,410,0.2857142857142857,0.021080209,6
2020-06-01-170301,170301,2,0,0,412,2.2857142857142856,0.63159937,0
2020-06-02-170301,170301,5,0,1,417,2.2857142857142856,0.906564,1
2020-06-03-170301,170301,0,0,4,417,3.1428571428571432,0.5114118,2
2020-06-04-170301,170301,0,0,1,417,2.0,0.35549524,3
2020-06-05-170301,170301,2,1,0,419,1.8571428571428568,0.579279,4
2020-06-06-170301,170301,0,0,0,419,0.2857142857142857,0.03341986,5
2020-06-07-170301,170301,0,0,0,419,0.42857142857142855,0.034703027,6
2020-06-08-170301,170301,1,0,0,420,2.142857142857143,0.57197756,0
2020-06-09-170301,170301,0,0,1,420,2.571428571428572,0.5715189,1
2020-06-10-170301,170301,5,0,0,425,2.7142857142857144,1.0537767,2
2020-06-11-170301,170301,0,1,1,425,2.7142857142857144,0.5199842,3
2020-06-12-170301,170301,0,0,0,425,1.7142857142857142,0.44976425,4
2020-06-13-170301,170301,0,0,0,425,0.42857142857142855,0.024076585,5
2020-06-14-170301,170301,0,0,0,425,0.0,0.018534062,6
2020-06-15-170301,170301,0,0,0,425,1.2857142857142858,0.3428959,0
2020-06-16-170301,170301,1,0,0,426,1.2857142857142858,0.29264337,1
2020-06-17-170301,170301,4,0,0,430,0.5714285714285714,0.40370417,2
2020-06-18-170301,170301,1,0,0,431,1.2857142857142858,0.22561404,3
2020-06-19-170301,170301,0,0,0,431,0.14285714285714285,0.1246393,4
2020-06-20-170301,170301,0,0,0,431,0.0,0.001369254,5
2020-06-21-170301,170301,0,0,0,431,0.0,0.0020997007,6
2020-06-22-170301,170301,0,0,0,431,0.8571428571428571,0.1474712,0
2020-06-23-170301,170301,1,0,0,432,0.7142857142857143,0.38984245,1
2020-06-24-170301,170301,0,3,0,432,0.7142857142857143,0.20486484,2
2020-06-25-170301,170301,1,0,0,433,1.8571428571428568,0.44457,3
2020-06-26-170301,170301,0,0,0,433,0.5714285714285714,0.11146224,4
2020-06-27-170301,170301,0,0,0,433,0.14285714285714285,0.024763716,5
2020-06-28-170301,170301,0,0,0,433,0.0,0.001627768,6
2020-06-29-170301,170301,0,0,0,433,0.0,0.08036554,0
2020-06-30-170301,170301,0,0,0,433,0.8571428571428571,0.17081966,1
2020-07-01-170301,170301,0,0,0,433,0.14285714285714285,0.03208328,2
2020-07-02-170301,170301,0,0,1,433,0.2857142857142857,0.06529948,3
2020-07-03-170301,170301,0,0,1,433,0.5714285714285714,0.09017771,4
2020-07-04-170301,170301,0,0,0,433,0.0,0.00074678526,5
2020-07-05-170301,170301,0,0,0,433,0.14285714285714285,0.010814807,6
2020-07-06-170301,170301,0,0,1,433,1.1428571428571428,0.20996198,0
2020-07-07-170301,170301,0,0,0,433,0.8571428571428571,0.15077202,1
2020-07-08-170301,170301,0,0,0,433,0.7142857142857143,0.13719672,2
2020-07-09-170301,170301,0,0,0,433,0.7142857142857143,0.2039428,3
2020-07-10-170301,170301,0,0,0,433,0.5714285714285714,0.08953102,4
2020-07-11-170301,170301,0,0,0,433,0.2857142857142857,0.015320139,5
2020-07-12-170301,170301,0,0,0,433,0.2857142857142857,0.03890988,6
2020-07-13-170301,170301,0,0,0,433,0.5714285714285714,0.12082174,0
2020-07-14-170301,170301,0,0,1,433,0.42857142857142855,0.071495146,1
2020-07-15-170301,170301,0,0,0,433,0.8571428571428571,0.063291766,2
2020-07-16-170301,170301,1,0,0,434,0.5714285714285714,0.12767686,3
2020-07-17-170301,170301,1,0,1,435,0.14285714285714285,0.1740394,4
2020-07-18-170301,170301,0,0,0,435,0.14285714285714285,0.06833617,5
2020-07-19-170301,170301,0,0,0,435,0.14285714285714285,0.056966376,6
2020-07-20-170301,170301,1,0,0,436,0.8571428571428571,0.21096367,0
2020-07-21-170301,170301,0,0,1,436,0.42857142857142855,0.13631895,1
2020-07-22-170301,170301,0,0,1,436,1.1428571428571428,0.17967819,2
2020-07-23-170301,170301,0,1,0,436,0.5714285714285714,0.18569684,3
2020-07-24-170301,170301,0,2,0,436,1.2857142857142858,0.24268305,4
2020-07-25-170301,170301,0,0,0,436,0.0,0.0020495737,5
2020-07-26-170301,170301,0,0,0,436,0.2857142857142857,0.032646902,6
2020-07-27-170301,170301,0,0,1,436,0.42857142857142855,0.10631275,0
2020-07-28-170301,170301,1,0,1,437,0.5714285714285714,0.2083292,1
2020-07-29-170301,170301,0,0,1,437,0.7142857142857143,0.020152327,2
2020-07-30-170301,170301,0,0,0,437,0.7142857142857143,0.19365121,3
2020-07-31-170301,170301,1,0,0,438,0.8571428571428571,0.24354206,4
2020-08-01-170301,170301,0,0,0,438,0.14285714285714285,0.019302774,5
2020-08-02-170301,170301,0,0,0,438,0.14285714285714285,0.09258451,6
2020-08-03-170301,170301,0,0,0,438,0.42857142857142855,0.12357512,0
2020-08-04-170301,170301,1,0,0,439,1.0,0.3304094,1
2020-08-05-170301,170301,1,0,1,440,0.2857142857142857,0.29217583,2
2020-08-06-170301,170301,0,0,0,440,1.1428571428571428,0.40366405,3
2020-08-07-170301,170301,0,0,0,440,0.7142857142857143,0.14544731,4
2020-08-08-170301,170301,0,0,0,440,0.2857142857142857,0.09539898,5
2020-08-09-170301,170301,0,0,0,440,0.14285714285714285,0.1463278,6
2020-08-10-170301,170301,1,0,1,441,1.2857142857142858,0.3511322,0
2020-08-11-170301,170301,1,0,3,442,1.1428571428571428,0.33768192,1
2020-08-12-170301,170301,1,0,0,443,1.1428571428571428,0.25687647,2
2020-08-13-170301,170301,0,0,4,443,0.8571428571428571,0.23296237,3
2020-08-14-170301,170301,0,0,4,443,1.1428571428571428,0.18622108,4
2020-08-15-170301,170301,0,0,1,443,0.0,0.14088896,5
2020-08-16-170301,170301,0,1,0,443,0.42857142857142855,0.07489299,6
2020-08-17-170301,170301,0,0,5,443,0.2857142857142857,0.19167307,0
2020-08-18-170301,170301,0,0,3,443,0.8571428571428571,0.2920137,1
2020-08-19-170301,170301,1,0,1,444,1.5714285714285714,0.40305302,2
2020-08-20-170301,170301,0,0,2,444,2.2857142857142856,0.46574095,3
2020-08-21-170301,170301,0,1,4,444,2.7142857142857144,0.7311435,4
2020-08-22-170301,170301,0,0,0,444,0.14285714285714285,0.24773121,5
2020-08-23-170301,170301,0,0,7,444,0.8571428571428571,0.19609621,6
2020-08-24-170301,170301,1,0,6,445,1.2857142857142858,0.8929151,0
2020-08-25-170301,170301,3,0,4,448,5.285714285714286,1.3687507,1
2020-08-26-170301,170301,0,0,10,448,1.8571428571428568,0.82556325,2
2020-08-27-170301,170301,4,0,11,452,3.4285714285714284,1.0785584,3
2020-08-28-170301,170301,4,0,7,456,2.142857142857143,0.6283605,4
2020-08-29-170301,170301,1,0,6,457,1.8571428571428568,0.51041704,5
2020-08-30-170301,170301,0,0,1,457,1.7142857142857142,0.4871868,6
2020-08-31-170301,170301,5,0,5,462,4.142857142857143,1.1403992,0
2020-09-01-170301,170301,3,0,4,465,2.2857142857142856,0.735625,1
2020-09-02-170301,170301,1,0,3,466,2.571428571428572,0.76659596,2
2020-09-03-170301,170301,2,0,5,468,3.0,0.8281548,3
2020-09-04-170301,170301,4,0,3,472,4.142857142857143,0.92902,4
2020-09-05-170301,170301,0,0,6,472,1.8571428571428568,0.17660722,5
2020-09-06-170301,170301,7,1,3,479,2.4285714285714284,0.63714385,6
2020-09-07-170301,170301,6,0,1,485,5.428571428571429,1.2996212,0
2020-09-08-170301,170301,4,0,5,489,4.285714285714286,0.88984686,1
2020-09-09-170301,170301,10,0,6,499,7.0,2.2192564,2
2020-09-10-170301,170301,11,0,11,510,5.857142857142858,1.9944917,3
2020-09-11-170301,170301,7,0,10,517,4.857142857142857,2.0800579,4
2020-09-12-170301,170301,6,0,1,523,2.2857142857142856,0.7268986,5
2020-09-13-170301,170301,1,0,4,524,5.0,0.51685864,6
2020-09-14-170301,170301,5,0,6,529,4.0,1.1845154,0
2020-09-15-170301,170301,4,0,4,533,5.142857142857143,1.2307805,1
2020-09-16-170301,170301,3,0,25,536,7.571428571428571,1.7312464,2
2020-09-17-170301,170301,5,0,34,541,8.0,2.0367513,3
2020-09-18-170301,170301,3,0,20,544,6.2857142857142865,1.2802107,4
2020-09-19-170301,170301,6,0,2,550,2.7142857142857144,0.5869921,5
2020-09-20-170301,170301,3,0,2,553,2.0,0.3492431,6
2020-09-21-170301,170301,1,0,2,554,10.428571428571429,1.6679567,0
2020-09-22-170301,170301,5,1,32,559,6.2857142857142865,1.8143582,1
2020-09-23-170301,170301,6,0,6,565,9.142857142857142,2.0240195,2
2020-09-24-170301,170301,11,0,20,576,15.857142857142858,4.4268265,3
2020-09-25-170301,170301,10,0,10,586,9.285714285714286,2.4121904,4
2020-09-26-170301,170301,1,0,6,587,2.8571428571428568,0.5536943,5
2020-09-27-170301,170301,4,1,5,591,1.1428571428571428,0.35481903,6
2020-09-28-170301,170301,6,0,6,597,8.857142857142858,1.9033602,0
2020-09-29-170301,170301,4,1,26,601,7.571428571428571,1.5329019,1
2020-09-30-170301,170301,25,0,15,626,7.571428571428571,2.8539906,2
2020-10-01-170301,170301,34,0,25,660,13.285714285714285,4.9681387,3
2020-10-02-170301,170301,20,1,21,680,12.571428571428573,3.1475136,4
2020-10-03-170301,170301,2,1,4,682,5.285714285714286,0.8224111,5
2020-10-04-170301,170301,2,0,1,684,2.2857142857142856,0.40706992,6
2020-10-05-170301,170301,2,0,15,686,5.7142857142857135,1.353155,0
2020-10-06-170301,170301,32,2,9,718,6.428571428571429,3.667189,1
2020-10-07-170301,170301,6,2,20,724,9.142857142857142,1.6685985,2
2020-10-08-170301,170301,20,2,6,744,10.142857142857142,3.425981,3
2020-10-09-170301,170301,10,5,10,754,21.0,4.5316963,4
2020-10-10-170301,170301,6,0,3,760,2.571428571428572,0.7404954,5
2020-10-11-170301,170301,5,0,0,765,2.8571428571428568,0.6145959,6
2020-10-12-170301,170301,6,0,14,771,3.2857142857142856,0.66138583,0
2020-10-13-170301,170301,26,0,13,797,17.285714285714285,4.6240673,1
2020-10-14-170301,170301,15,0,7,812,14.0,3.354461,2
2020-10-15-170301,170301,25,0,23,837,15.857142857142858,4.8717484,3
2020-10-16-170301,170301,21,0,13,858,15.714285714285715,3.9296846,4
2020-10-17-170301,170301,4,1,4,862,4.0,0.9599743,5
2020-10-18-170301,170301,1,0,0,863,4.857142857142857,0.73188335,6
2020-10-19-170301,170301,15,0,4,878,17.714285714285715,3.911899,0
2020-10-20-170301,170301,9,1,18,887,10.857142857142858,2.6294518,1
2020-10-21-170301,170301,20,1,8,907,9.571428571428571,2.6254046,2
2020-10-22-170301,170301,6,0,10,913,12.142857142857142,3.0601704,3
2020-10-23-170301,170301,10,0,19,923,14.428571428571427,4.1505194,4
2020-10-24-170301,170301,3,1,2,926,5.0,0.7496076,5
2020-10-25-170301,170301,0,2,4,926,3.1428571428571432,0.5001077,6
2020-10-26-170301,170301,14,0,20,940,15.571428571428573,3.7369225,0
2020-10-27-170301,170301,13,0,6,953,7.2857142857142865,2.24699,1
2020-10-28-170301,170301,7,0,10,960,11.571428571428573,2.6935413,2
2020-10-29-170301,170301,23,0,14,983,15.142857142857142,3.854961,3
2020-10-30-170301,170301,13,1,6,996,14.714285714285715,4.143267,4
2020-10-31-170301,170301,4,0,0,1000,3.571428571428572,0.79665923,5
2020-11-01-170301,170301,0,2,0,1000,5.142857142857143,0.4621673,6
2020-11-02-170301,170301,4,2,0,1004,1.8571428571428568,0.5978069,0
2020-11-03-170301,170301,18,1,0,1022,14.857142857142858,4.624837,1
2020-11-04-170301,170301,8,1,0,1030,6.0,2.2469385,2
2020-11-05-170301,170301,10,0,0,1040,13.428571428571427,3.337921,3
2020-11-06-170301,170301,19,5,0,1059,15.714285714285715,4.159272,4
2020-11-07-170301,170301,2,1,0,1061,4.142857142857143,0.9009651,5
2020-11-08-170301,170301,4,0,0,1065,8.0,0.6103289,6
2020-11-09-170301,170301,20,1,0,1085,24.57142857142857,5.252037,0
2020-11-10-170301,170301,6,0,0,1091,12.571428571428573,3.186914,1
2020-11-11-170301,170301,10,0,0,1101,9.142857142857142,3.324479,2
2020-11-12-170301,170301,14,1,0,1115,11.0,2.4151475,3
2020-11-13-170301,170301,6,3,0,1121,13.142857142857142,3.4658284,4
2020-03-01-170302,170302,0,0,2,0,0.0,0.00043170078,6
2020-03-02-170302,170302,0,0,11,0,0.0,0.00023963705,0
2020-03-03-170302,170302,0,0,25,0,0.0,0.00011554695,1
2020-03-04-170302,170302,0,0,25,0,0.0,2.0527516e-05,2
2020-03-05-170302,170302,0,0,25,0,0.0,4.043955e-08,3
2020-03-06-170302,170302,0,0,17,0,0.0,0.0008562665,4
2020-03-07-170302,170302,0,0,16,0,0.0,0.001114175,5
2020-03-08-170302,170302,1,0,12,1,0.0,0.04040078,6
2020-03-09-170302,170302,1,0,28,2,0.0,0.090036206,0
2020-03-10-170302,170302,2,1,33,4,0.0,0.10429567,1
2020-03-11-170302,170302,0,0,25,4,0.0,0.0057136235,2
2020-03-12-170302,170302,1,0,20,5,0.0,0.09818848,3
2020-03-13-170302,170302,4,0,26,9,0.0,0.21456073,4
2020-03-14-170302,170302,4,0,9,13,2.5,0.6708955,5
2020-03-15-170302,170302,2,0,0,15,1.5,0.4905827,6
2020-03-16-170302,170302,11,0,27,26,5.5,1.1836107,0
2020-03-17-170302,170302,25,0,20,51,10.0,4.830725,1
2020-03-18-170302,170302,25,0,18,76,7.5,3.3910534,2
2020-03-19-170302,170302,25,1,11,101,8.0,4.8364162,3
2020-03-20-170302,170302,17,0,24,118,8.5,3.124727,4
2020-03-21-170302,170302,16,0,5,134,3.5,0.62412345,5
2020-03-22-170302,170302,12,0,0,146,5.5,0.8222125,6
2020-03-23-170302,170302,28,0,18,174,18.0,5.1101055,0
2020-03-24-170302,170302,33,0,9,207,12.5,5.7618475,1
2020-03-25-170302,170302,25,0,8,232,13.5,6.6940928,2
2020-03-26-170302,170302,20,0,9,252,9.0,4.1013055,3
2020-03-27-170302,170302,26,0,17,278,15.0,2.5640175,4
2020-03-28-170302,170302,9,0,4,287,5.5,1.1051764,5
2020-03-29-170302,170302,0,0,3,287,2.0,0.75755864,6
2020-03-30-170302,170302,27,0,16,314,13.0,2.984394,0
2020-03-31-170302,170302,20,0,6,334,10.0,3.32737,1
2020-04-01-170302,170302,18,0,8,352,8.5,2.1763353,2
2020-04-02-170302,170302,11,0,11,363,7.0,1.9806975,3
2020-04-03-170302,170302,24,0,16,387,7.0,1.8297557,4
2020-04-04-170302,170302,5,0,4,392,3.5,0.57503825,5
2020-04-05-170302,170302,0,0,18,392,0.5,0.0600641,6
2020-04-06-170302,170302,18,0,11,410,5.5,1.9477608,0
2020-04-07-170302,170302,9,1,25,419,7.5,2.9950778,1
2020-04-08-170302,170302,8,2,3,427,23.5,1.5934691,2
2020-04-09-170302,170302,9,0,2,436,5.0,1.0588428,3
2020-04-10-170302,170302,17,1,26,453,5.0,0.7092857,4
2020-04-11-170302,170302,4,0,0,457,1.5,0.6088386,5
2020-04-12-170302,170302,3,0,1,460,2.5,0.49968463,6
2020-04-13-170302,170302,16,0,3,476,3.5,2.342369,0
2020-04-14-170302,170302,6,0,1,482,3.5,0.60941976,1
2020-04-15-170302,170302,8,0,3,490,2.5,0.3514295,2
2020-04-16-170302,170302,11,0,4,501,5.0,0.5655,3
2020-04-17-170302,170302,16,0,1,517,3.0,1.4461807,4
2020-04-18-170302,170302,4,0,1,521,0.0,0.11998759,5
2020-04-19-170302,170302,18,0,0,539,1.0,0.5085474,6
2020-04-20-170302,170302,11,1,4,550,10.0,0.5240974,0
2020-04-21-170302,170302,25,0,3,575,19.0,1.2965591,1
2020-04-22-170302,170302,3,0,4,578,2.5,1.3916001,2
2020-04-23-170302,170302,2,0,7,580,0.0,0.064603455,3
2020-04-24-170302,170302,26,0,1,606,2.0,2.1877384,4
2020-04-25-170302,170302,0,0,0,606,0.5,0.051314313,5
2020-04-26-170302,170302,1,0,0,607,0.0,0.052755393,6
2020-04-27-170302,170302,3,0,4,610,2.0,0.29385793,0
2020-04-28-170302,170302,1,1,4,611,4.0,1.4758489,1
2020-04-29-170302,170302,3,0,4,614,0.5,0.1554763,2
2020-04-30-170302,170302,4,0,2,618,0.0,0.23083292,3
2020-05-01-170302,170302,1,0,5,619,0.0,0.048530005,4
2020-05-02-170302,170302,1,0,2,620,1.0,0.09964125,5
2020-05-03-170302,170302,0,0,2,620,0.0,0.017244391,6
2020-05-04-170302,170302,4,0,4,624,1.0,0.30375898,0
2020-05-05-170302,170302,3,0,2,627,1.5,1.3197305,1
2020-05-06-170302,170302,4,0,6,631,1.5,0.32915875,2
2020-05-07-170302,170302,7,0,2,638,0.0,0.37694007,3
2020-05-08-170302,170302,1,0,1,639,4.5,0.6379809,4
2020-05-09-170302,170302,0,0,2,639,0.5,0.029839035,5
2020-05-10-170302,170302,0,0,0,639,0.0,0.0155074345,6
2020-05-11-170302,170302,4,0,3,643,0.5,0.7393698,0
2020-05-12-170302,170302,4,0,3,647,0.5,0.7979183,1
2020-05-13-170302,170302,4,0,3,651,0.5,0.39964798,2
2020-05-14-170302,170302,2,0,3,653,1.0,0.27333313,3
2020-05-15-170302,170302,5,0,7,658,1.5,0.32926792,4
2020-05-16-170302,170302,2,0,1,660,0.0,0.09590739,5
2020-05-17-170302,170302,2,0,0,662,0.0,0.07119392,6
2020-05-18-170302,170302,4,0,1,666,1.0,0.32000628,0
2020-05-19-170302,170302,2,0,3,668,3.5,0.3466684,1
2020-05-20-170302,170302,6,0,3,674,1.0,0.36938214,2
2020-05-21-170302,170302,2,0,4,676,0.5,0.2455225,3
2020-05-22-170302,170302,1,0,3,677,2.0,0.19291943,4
2020-05-23-170302,170302,2,0,1,679,0.0,0.07560262,5
2020-05-24-170302,170302,0,0,0,679,0.0,0.004589554,6
2020-05-25-170302,170302,3,0,1,682,0.5,0.728645,0
2020-05-26-170302,170302,3,0,2,685,2.0,0.7647118,1
2020-05-27-170302,170302,3,0,1,688,0.5,0.7856845,2
2020-05-28-170302,170302,3,2,1,691,1.5,1.418259,3
2020-05-29-170302,170302,7,0,3,698,1.0,1.0215286,4
2020-05-30-170302,170302,1,0,0,699,0.0,0.04726028,5
2020-05-31-170302,170302,0,0,0,699,0.0,0.00045566628,6
2020-06-01-170302,170302,1,0,2,700,2.0,2.144362,0
2020-06-02-170302,170302,3,0,2,703,0.0,0.33999377,1
2020-06-03-170302,170302,3,0,0,706,0.5,0.29420945,2
2020-06-04-170302,170302,4,0,1,710,0.0,0.43710753,3
2020-06-05-170302,170302,3,0,2,713,1.0,0.7646602,4
2020-06-06-170302,170302,1,1,0,714,0.0,0.05097864,5
2020-06-07-170302,170302,0,0,0,714,0.0,0.015865637,6
2020-06-08-170302,170302,1,0,1,715,0.0,0.11540536,0
2020-06-09-170302,170302,2,0,1,717,2.0,0.2567771,1
2020-06-10-170302,170302,1,0,1,718,0.5,0.8162137,2
2020-06-11-170302,170302,1,0,1,719,1.5,0.15934786,3
2020-06-12-170302,170302,3,0,1,722,1.0,0.7363121,4
2020-06-13-170302,170302,0,0,0,722,0.5,0.014105884,5
2020-06-14-170302,170302,0,0,0,722,0.0,0.0010603579,6
2020-06-15-170302,170302,2,0,0,724,0.0,0.25061497,0
2020-06-16-170302,170302,2,0,1,726,0.5,0.17308694,1
2020-06-17-170302,170302,0,0,0,726,0.0,0.08242689,2
2020-06-18-170302,170302,1,0,0,727,0.5,0.10238374,3
2020-06-19-170302,170302,2,0,1,729,0.0,0.1282531,4
2020-06-20-170302,170302,0,0,0,729,0.0,0.006713626,5
2020-06-21-170302,170302,0,0,0,729,0.0,0.0020511742,6
2020-06-22-170302,170302,1,0,1,730,0.0,0.15240629,0
2020-06-23-170302,170302,1,0,0,731,0.0,0.15562117,1
2020-06-24-170302,170302,1,0,0,732,0.0,0.14130552,2
2020-06-25-170302,170302,1,0,0,733,1.5,0.21265747,3
2020-06-26-170302,170302,1,0,0,734,0.0,0.07448551,4
2020-06-27-170302,170302,0,0,0,734,0.5,0.019632654,5
2020-06-28-170302,170302,0,0,0,734,0.0,8.146424e-06,6
2020-06-29-170302,170302,0,0,0,734,0.0,0.11357404,0
2020-06-30-170302,170302,1,0,1,735,1.0,0.1700104,1
2020-07-01-170302,170302,0,0,0,735,0.0,0.014330964,2
2020-07-02-170302,170302,0,0,0,735,0.5,0.13392876,3
2020-07-03-170302,170302,1,0,0,736,0.0,0.10570004,4
2020-07-04-170302,170302,0,0,0,736,0.0,0.0047060517,5
2020-07-05-170302,170302,0,0,0,736,0.0,0.0015544517,6
2020-07-06-170302,170302,1,0,0,737,0.0,0.08776588,0
2020-07-07-170302,170302,0,0,0,737,0.5,0.030433299,1
2020-07-08-170302,170302,0,0,1,737,0.5,0.0734291,2
2020-07-09-170302,170302,0,0,0,737,0.0,0.105591804,3
2020-07-10-170302,170302,0,0,0,737,0.0,0.022854693,4
2020-07-11-170302,170302,0,2,0,737,0.0,0.0011980371,5
2020-07-12-170302,170302,0,0,0,737,0.5,0.016208788,6
2020-07-13-170302,170302,0,0,0,737,1.0,0.10446308,0
2020-07-14-170302,170302,1,0,1,738,0.0,0.0710516,1
2020-07-15-170302,170302,0,0,0,738,1.0,0.022047933,2
2020-07-16-170302,170302,0,0,0,738,0.5,0.070180446,3
2020-07-17-170302,170302,0,0,0,738,0.0,0.023457602,4
2020-07-18-170302,170302,0,0,0,738,0.5,0.07070726,5
2020-07-19-170302,170302,0,0,0,738,0.5,0.028966706,6
2020-07-20-170302,170302,0,0,3,738,1.0,0.073681846,0
2020-07-21-170302,170302,0,0,2,738,0.5,0.035752684,1
2020-07-22-170302,170302,1,0,1,739,1.0,0.111127935,2
2020-07-23-170302,170302,0,0,0,739,1.0,0.10678594,3
2020-07-24-170302,170302,0,0,5,739,1.5,0.1022914,4
2020-07-25-170302,170302,0,0,1,739,0.0,0.0159948,5
2020-07-26-170302,170302,0,0,0,739,0.5,0.014345487,6
2020-07-27-170302,170302,0,0,0,739,0.5,0.056414384,0
2020-07-28-170302,170302,1,0,0,740,1.0,0.11995111,1
2020-07-29-170302,170302,0,1,0,740,0.5,0.030898122,2
2020-07-30-170302,170302,0,0,0,740,2.0,0.11173343,3
2020-07-31-170302,170302,0,0,1,740,0.5,0.055660192,4
2020-08-01-170302,170302,0,0,0,740,0.0,0.043822598,5
2020-08-02-170302,170302,0,0,0,740,0.0,0.03903013,6
2020-08-03-170302,170302,3,0,1,743,0.0,0.18846306,0
2020-08-04-170302,170302,2,0,0,745,1.5,0.79037875,1
2020-08-05-170302,170302,1,0,3,746,1.0,0.7669889,2
2020-08-06-170302,170302,0,0,0,746,1.0,0.423236,3
2020-08-07-170302,170302,5,0,1,751,0.0,0.40804365,4
2020-08-08-170302,170302,1,0,1,752,0.0,0.07919177,5
2020-08-09-170302,170302,0,0,0,752,0.0,0.03671938,6
2020-08-10-170302,170302,0,0,0,752,0.5,0.6498414,0
2020-08-11-170302,170302,0,0,0,752,0.0,0.051184654,1
2020-08-12-170302,170302,0,1,1,752,0.5,0.1979687,2
2020-08-13-170302,170302,0,0,1,752,0.5,0.101797536,3
2020-08-14-170302,170302,1,1,5,753,0.5,0.10623543,4
2020-08-15-170302,170302,0,0,0,753,0.0,0.28199527,5
2020-08-16-170302,170302,0,0,0,753,1.0,0.05403559,6
2020-08-17-170302,170302,1,0,0,754,0.0,0.0802928,0
2020-08-18-170302,170302,0,0,2,754,1.0,0.21723978,1
2020-08-19-170302,170302,3,0,6,757,1.0,0.2577944,2
2020-08-20-170302,170302,0,0,2,757,3.0,0.20675059,3
2020-08-21-170302,170302,1,0,0,758,3.5,0.23806742,4
2020-08-22-170302,170302,1,0,0,759,0.0,0.10153916,5
2020-08-23-170302,170302,0,0,0,759,2.0,0.07356787,6
2020-08-24-170302,170302,0,0,0,759,1.5,0.14573397,0
2020-08-25-170302,170302,0,0,1,759,3.0,0.29780045,1
2020-08-26-170302,170302,1,0,25,760,4.0,4.4658146,2
2020-08-27-170302,170302,1,0,1,761,5.5,0.97721916,3
2020-08-28-170302,170302,5,1,2,766,3.0,1.6259242,4
2020-08-29-170302,170302,0,0,1,766,0.5,0.6150599,5
2020-08-30-170302,170302,0,0,1,766,2.0,0.7670122,6
2020-08-31-170302,170302,0,0,2,766,3.5,0.2680147,0
2020-09-01-170302,170302,2,0,4,768,2.0,2.2124538,1
2020-09-02-170302,170302,6,0,1,774,1.0,0.38850135,2
2020-09-03-170302,170302,2,0,2,776,6.0,2.550402,3
2020-09-04-170302,170302,0,0,3,776,3.0,0.79415363,4
2020-09-05-170302,170302,0,0,0,776,1.5,0.034881264,5
2020-09-06-170302,170302,0,0,2,776,1.0,0.12860367,6
2020-09-07-170302,170302,0,0,6,776,3.5,0.23385954,0
2020-09-08-170302,170302,1,0,5,777,1.0,0.27148524,1
2020-09-09-170302,170302,25,0,0,802,4.5,1.3366914,2
2020-09-10-170302,170302,1,0,0,803,0.5,0.17962347,3
2020-09-11-170302,170302,2,0,2,805,1.5,1.46944,4
2020-09-12-170302,170302,1,0,5,806,0.5,0.097666,5
2020-09-13-170302,170302,1,0,0,807,3.0,0.23177421,6
2020-09-14-170302,170302,2,0,3,809,1.0,0.33621058,0
2020-09-15-170302,170302,4,0,2,813,6.0,1.7787097,1
2020-09-16-170302,170302,1,0,3,814,5.0,0.29513618,2
2020-09-17-170302,170302,2,0,1,816,7.5,0.36241224,3
2020-09-18-170302,170302,3,0,2,819,3.5,0.40483567,4
2020-09-19-170302,170302,0,0,2,819,1.5,0.09249014,5
2020-09-20-170302,170302,2,0,3,821,1.0,0.62676626,6
2020-09-21-170302,170302,6,1,0,827,6.0,1.0344546,0
2020-09-22-170302,170302,5,0,1,832,3.0,0.6703785,1
2020-09-23-170302,170302,0,0,6,832,5.5,0.31558925,2
2020-09-24-170302,170302,0,0,11,832,1.5,0.5132126,3
2020-09-25-170302,170302,2,1,8,834,7.0,0.4946273,4
2020-09-26-170302,170302,5,0,1,839,1.0,0.35444653,5
2020-09-27-170302,170302,0,0,0,839,0.0,0.083257064,6
2020-09-28-170302,170302,3,0,0,842,4.5,1.0737062,0
2020-09-29-170302,170302,2,0,4,844,4.5,0.535324,1
2020-09-30-170302,170302,3,0,8,847,2.0,1.2520264,2
2020-10-01-170302,170302,1,0,14,848,15.0,1.2510012,3
2020-10-02-170302,170302,2,0,5,850,8.0,1.0694108,4
2020-10-03-170302,170302,2,2,8,852,1.5,1.0461794,5
2020-10-04-170302,170302,3,0,5,855,0.0,0.16302924,6
2020-10-05-170302,170302,0,1,3,855,3.5,0.8795778,0
2020-10-06-170302,170302,1,1,3,856,2.5,0.9216412,1
2020-10-07-170302,170302,6,0,10,862,1.5,0.51904935,2
2020-10-08-170302,170302,11,2,9,873,4.5,0.72541267,3
2020-10-09-170302,170302,8,2,7,881,4.5,2.6879315,4
2020-10-10-170302,170302,1,0,5,882,0.5,0.12035289,5
2020-10-11-170302,170302,0,0,1,882,1.0,0.63099736,6
2020-10-12-170302,170302,0,0,3,882,0.0,0.12512855,0
2020-10-13-170302,170302,4,0,2,886,7.0,1.3193779,1
2020-10-14-170302,170302,8,0,1,894,10.5,1.8768822,2
2020-10-15-170302,170302,14,0,21,908,7.5,1.6165498,3
2020-10-16-170302,170302,5,0,5,913,7.0,1.6310676,4
2020-10-17-170302,170302,8,0,8,921,1.0,0.9617708,5
2020-10-18-170302,170302,5,0,0,926,2.0,1.115769,6
2020-10-19-170302,170302,3,0,6,929,11.0,1.2344651,0
2020-10-20-170302,170302,3,1,3,932,6.5,1.9200672,1
2020-10-21-170302,170302,10,0,8,942,6.5,1.8212788,2
2020-10-22-170302,170302,9,1,3,951,6.0,1.4498185,3
2020-10-23-170302,170302,7,0,3,958,5.5,1.5332389,4
2020-10-24-170302,170302,5,0,7,963,4.5,0.8927535,5
2020-10-25-170302,170302,1,0,0,964,2.5,0.13875812,6
2020-10-26-170302,170302,3,1,10,967,5.0,2.0440965,0
2020-10-27-170302,170302,2,1,2,969,4.5,1.9904317,1
2020-10-28-170302,170302,1,2,5,970,5.5,1.2373656,2
2020-10-29-170302,170302,21,1,6,991,17.0,4.202984,3
2020-10-30-170302,170302,5,0,4,996,6.5,1.9821225,4
2020-10-31-170302,170302,8,0,0,1004,4.0,2.1109083,5
2020-11-01-170302,170302,0,0,0,1004,1.5,0.12759759,6
2020-11-02-170302,170302,6,0,0,1010,3.0,0.4341177,0
2020-11-03-170302,170302,3,2,0,1013,10.0,3.5598435,1
2020-11-04-170302,170302,8,0,0,1021,3.0,1.6859728,2
2020-11-05-170302,170302,3,2,0,1024,11.0,1.5299052,3
2020-11-06-170302,170302,3,2,0,1027,7.0,0.81086683,4
2020-11-07-170302,170302,7,0,0,1034,4.0,1.3370398,5
2020-11-08-170302,170302,0,0,0,1034,2.0,0.11683754,6
2020-11-09-170302,170302,10,2,0,1044,7.0,1.4760311,0
2020-11-10-170302,170302,2,0,0,1046,5.0,1.1064988,1
2020-11-11-170302,170302,5,0,0,1051,5.5,2.127548,2
2020-11-12-170302,170302,6,2,0,1057,6.5,1.7716459,3
2020-11-13-170302,170302,4,1,0,1061,14.5,1.2867955,4
2020-03-01-170303,170303,0,0,1,0,0.0,0.00030415476,6
2020-03-02-170303,170303,0,0,1,0,0.0,0.00035650237,0
2020-03-03-170303,170303,0,0,7,0,0.0,0.00043363197,1
2020-03-04-170303,170303,0,0,4,0,0.0,0.00092930795,2
2020-03-05-170303,170303,0,0,9,0,0.0,3.0726627e-05,3
2020-03-06-170303,170303,0,1,5,0,0.14285714285714285,0.0044264644,4
2020-03-07-170303,170303,0,0,0,0,0.0,0.0028118154,5
2020-03-08-170303,170303,0,0,1,0,0.14285714285714285,0.031187693,6
2020-03-09-170303,170303,0,0,7,0,0.2857142857142857,0.067451574,0
2020-03-10-170303,170303,0,0,9,0,0.2857142857142857,0.07485411,1
2020-03-11-170303,170303,0,0,15,0,0.0,0.00681416,2
2020-03-12-170303,170303,0,0,8,0,0.42857142857142855,0.087816015,3
2020-03-13-170303,170303,0,0,3,0,0.7142857142857143,0.20352204,4
2020-03-14-170303,170303,1,0,2,1,1.2857142857142858,0.5669311,5
2020-03-15-170303,170303,1,0,2,2,1.0,0.41648883,6
2020-03-16-170303,170303,1,0,4,3,5.142857142857143,1.2034074,0
2020-03-17-170303,170303,7,0,6,10,9.285714285714286,3.742637,1
2020-03-18-170303,170303,4,0,3,14,11.142857142857142,3.0763783,2
2020-03-19-170303,170303,9,0,3,23,9.142857142857142,4.0054846,3
2020-03-20-170303,170303,5,1,2,28,7.571428571428571,2.665458,4
2020-03-21-170303,170303,0,0,1,28,5.428571428571429,0.7716305,5
2020-03-22-170303,170303,1,0,0,29,6.571428571428571,1.0758184,6
2020-03-23-170303,170303,7,0,2,36,15.428571428571427,4.34584,0
2020-03-24-170303,170303,9,0,6,45,14.571428571428573,4.87691,1
2020-03-25-170303,170303,15,0,2,60,12.857142857142858,5.3203797,2
2020-03-26-170303,170303,8,0,2,68,10.428571428571429,3.29684,3
2020-03-27-170303,170303,3,0,0,71,13.285714285714285,2.7424252,4
2020-03-28-170303,170303,2,0,1,73,5.0,1.0890062,5
2020-03-29-170303,170303,2,0,0,75,3.4285714285714284,0.686705,6
2020-03-30-170303,170303,4,0,4,79,12.0,2.704407,0
2020-03-31-170303,170303,6,0,1,85,9.428571428571429,2.7284544,1
2020-04-01-170303,170303,3,0,0,88,8.428571428571429,1.927809,2
2020-04-02-170303,170303,3,0,0,91,7.0,1.8087687,3
2020-04-03-170303,170303,2,0,2,93,7.857142857142858,1.734242,4
2020-04-04-170303,170303,1,0,0,94,4.857142857142857,0.6949495,5
2020-04-05-170303,170303,0,0,0,94,1.4285714285714286,0.1683481,6
2020-04-06-170303,170303,2,0,0,96,9.571428571428571,2.0368416,0
2020-04-07-170303,170303,6,5,0,102,5.428571428571429,2.1929626,1
2020-04-08-170303,170303,2,0,3,104,11.0,1.9425992,2
2020-04-09-170303,170303,2,0,0,106,6.7142857142857135,1.0639182,3
2020-04-10-170303,170303,0,0,1,106,6.7142857142857135,1.0155172,4
2020-04-11-170303,170303,1,0,0,107,2.4285714285714284,0.5887872,5
2020-04-12-170303,170303,0,0,0,107,5.0,0.6058789,6
2020-04-13-170303,170303,4,0,0,111,5.428571428571429,1.9828743,0
2020-04-14-170303,170303,1,0,4,112,6.2857142857142865,0.90595174,1
2020-04-15-170303,170303,0,0,0,112,3.571428571428572,0.5356051,2
2020-04-16-170303,170303,0,0,0,112,5.285714285714286,0.75259745,3
2020-04-17-170303,170303,2,0,0,114,5.0,1.2119522,4
2020-04-18-170303,170303,0,0,0,114,1.0,0.1420886,5
2020-04-19-170303,170303,0,0,0,114,3.2857142857142856,0.4493256,6
2020-04-20-170303,170303,0,0,0,114,6.428571428571429,0.8857301,0
2020-04-21-170303,170303,0,0,2,114,11.285714285714285,1.4896858,1
2020-04-22-170303,170303,3,0,0,117,2.0,1.1002398,2
2020-04-23-170303,170303,0,0,0,117,1.0,0.12900627,3
2020-04-24-170303,170303,1,0,1,118,10.714285714285714,2.1052582,4
2020-04-25-170303,170303,0,0,0,118,1.0,0.16316953,5
2020-04-26-170303,170303,0,0,0,118,0.8571428571428571,0.089734055,6
2020-04-27-170303,170303,0,0,1,118,2.4285714285714284,0.40057054,0
2020-04-28-170303,170303,4,6,1,122,1.8571428571428568,1.1911277,1
2020-04-29-170303,170303,0,0,0,122,2.4285714285714284,0.27583873,2
2020-04-30-170303,170303,0,0,0,122,2.0,0.30033174,3
2020-05-01-170303,170303,0,0,0,122,1.2857142857142858,0.19109069,4
2020-05-02-170303,170303,0,0,0,122,1.1428571428571428,0.17635049,5
2020-05-03-170303,170303,0,0,0,122,0.7142857142857143,0.10507187,6
2020-05-04-170303,170303,0,0,0,122,3.571428571428572,0.5707685,0
2020-05-05-170303,170303,2,0,0,124,2.571428571428572,1.1736271,1
2020-05-06-170303,170303,0,0,0,124,2.8571428571428568,0.51501817,2
2020-05-07-170303,170303,0,0,0,124,1.7142857142857142,0.43429804,3
2020-05-08-170303,170303,1,0,0,125,2.7142857142857144,0.69420564,4
2020-05-09-170303,170303,0,0,0,125,1.4285714285714286,0.1724425,5
2020-05-10-170303,170303,0,0,0,125,0.8571428571428571,0.06995773,6
2020-05-11-170303,170303,1,0,1,126,2.0,0.6787915,0
2020-05-12-170303,170303,1,1,1,127,2.142857142857143,0.66906196,1
2020-05-13-170303,170303,0,0,1,127,2.571428571428572,0.48160332,2
2020-05-14-170303,170303,0,0,2,127,1.8571428571428568,0.3514776,3
2020-05-15-170303,170303,0,0,1,127,3.2857142857142856,0.51068,4
2020-05-16-170303,170303,0,0,0,127,0.42857142857142855,0.080641136,5
2020-05-17-170303,170303,0,0,0,127,0.5714285714285714,0.10410855,6
2020-05-18-170303,170303,0,0,4,127,2.4285714285714284,0.5272533,0
2020-05-19-170303,170303,0,0,0,127,2.571428571428572,0.49241903,1
2020-05-20-170303,170303,0,0,0,127,1.8571428571428568,0.41171262,2
2020-05-21-170303,170303,0,0,0,127,1.2857142857142858,0.32793835,3
2020-05-22-170303,170303,0,0,1,127,1.8571428571428568,0.40401188,4
2020-05-23-170303,170303,0,0,0,127,0.5714285714285714,0.07111233,5
2020-05-24-170303,170303,0,0,0,127,0.14285714285714285,0.029701995,6
2020-05-25-170303,170303,1,0,0,128,1.1428571428571428,0.63319296,0
2020-05-26-170303,170303,1,0,0,129,1.4285714285714286,0.6462938,1
2020-05-27-170303,170303,1,0,1,130,2.2857142857142856,0.9021349,2
2020-05-28-170303,170303,2,1,0,132,2.8571428571428568,1.1905994,3
2020-05-29-170303,170303,1,0,1,133,2.7142857142857144,0.91383064,4
2020-05-30-170303,170303,0,0,0,133,0.14285714285714285,0.053357378,5
2020-05-31-170303,170303,0,0,0,133,0.0,0.0018310153,6
2020-06-01-170303,170303,4,0,0,137,1.1428571428571428,1.5335547,0
2020-06-02-170303,170303,0,0,0,137,2.142857142857143,0.4876578,1
2020-06-03-170303,170303,0,0,0,137,2.142857142857143,0.469261,2
2020-06-04-170303,170303,0,0,0,137,2.0,0.53308177,3
2020-06-05-170303,170303,1,1,0,138,1.7142857142857142,0.6841062,4
2020-06-06-170303,170303,0,0,0,138,0.14285714285714285,0.05150307,5
2020-06-07-170303,170303,0,0,0,138,0.2857142857142857,0.07358673,6
2020-06-08-170303,170303,0,0,0,138,1.2857142857142858,0.32529655,0
2020-06-09-170303,170303,0,0,0,138,2.7142857142857144,0.41062856,1
2020-06-10-170303,170303,1,0,0,139,1.2857142857142858,0.73584956,2
2020-06-11-170303,170303,0,0,0,139,1.5714285714285714,0.33194652,3
2020-06-12-170303,170303,1,0,0,140,1.7142857142857142,0.6436753,4
2020-06-13-170303,170303,0,0,0,140,0.14285714285714285,0.025792321,5
2020-06-14-170303,170303,0,0,0,140,0.0,0.0027167117,6
2020-06-15-170303,170303,0,0,0,140,1.4285714285714286,0.3835725,0
2020-06-16-170303,170303,0,0,0,140,1.5714285714285714,0.2859394,1
2020-06-17-170303,170303,0,0,0,140,0.7142857142857143,0.16256765,2
2020-06-18-170303,170303,0,0,0,140,0.5714285714285714,0.10084906,3
2020-06-19-170303,170303,0,0,0,140,0.7142857142857143,0.19500987,4
2020-06-20-170303,170303,0,0,0,140,0.14285714285714285,0.039778575,5
2020-06-21-170303,170303,0,0,0,140,0.0,0.0055454085,6
2020-06-22-170303,170303,0,0,0,140,0.8571428571428571,0.21046278,0
2020-06-23-170303,170303,0,0,0,140,1.2857142857142858,0.31657216,1
2020-06-24-170303,170303,0,0,0,140,1.0,0.22166066,2
2020-06-25-170303,170303,0,0,0,140,1.4285714285714286,0.3525234,3
2020-06-26-170303,170303,0,0,0,140,0.5714285714285714,0.12688553,4
2020-06-27-170303,170303,0,0,0,140,0.14285714285714285,0.03340477,5
2020-06-28-170303,170303,0,0,0,140,0.14285714285714285,0.00012003384,6
2020-06-29-170303,170303,0,0,0,140,0.8571428571428571,0.2511638,0
2020-06-30-170303,170303,0,0,0,140,1.1428571428571428,0.2594278,1
2020-07-01-170303,170303,0,0,0,140,0.14285714285714285,0.047974758,2
2020-07-02-170303,170303,0,0,0,140,0.8571428571428571,0.17472453,3
2020-07-03-170303,170303,0,0,0,140,0.7142857142857143,0.17362878,4
2020-07-04-170303,170303,0,0,0,140,0.14285714285714285,0.033312578,5
2020-07-05-170303,170303,0,0,0,140,0.14285714285714285,0.0055577583,6
2020-07-06-170303,170303,0,0,0,140,0.14285714285714285,0.086467765,0
2020-07-07-170303,170303,0,0,0,140,0.42857142857142855,0.08545782,1
2020-07-08-170303,170303,0,0,0,140,0.5714285714285714,0.13189775,2
2020-07-09-170303,170303,0,0,0,140,0.5714285714285714,0.19811365,3
2020-07-10-170303,170303,0,0,0,140,0.2857142857142857,0.08127873,4
2020-07-11-170303,170303,0,0,0,140,0.0,0.0013989873,5
2020-07-12-170303,170303,0,0,0,140,0.14285714285714285,0.026529085,6
2020-07-13-170303,170303,0,0,0,140,0.8571428571428571,0.2514914,0
2020-07-14-170303,170303,0,0,0,140,0.2857142857142857,0.103316605,1
2020-07-15-170303,170303,0,0,0,140,0.8571428571428571,0.11103616,2
2020-07-16-170303,170303,0,0,0,140,0.7142857142857143,0.20853837,3
2020-07-17-170303,170303,0,1,0,140,0.2857142857142857,0.100877635,4
2020-07-18-170303,170303,0,0,0,140,0.42857142857142855,0.17028834,5
2020-07-19-170303,170303,0,0,0,140,0.2857142857142857,0.077708505,6
2020-07-20-170303,170303,0,0,0,140,0.8571428571428571,0.2429333,0
2020-07-21-170303,170303,0,0,1,140,0.2857142857142857,0.10601105,1
2020-07-22-170303,170303,0,0,1,140,1.0,0.21780336,2
2020-07-23-170303,170303,0,0,0,140,1.0,0.29641324,3
2020-07-24-170303,170303,0,0,0,140,0.8571428571428571,0.16597195,4
2020-07-25-170303,170303,0,0,0,140,0.42857142857142855,0.10501199,5
2020-07-26-170303,170303,0,0,0,140,0.14285714285714285,0.029979406,6
2020-07-27-170303,170303,0,0,0,140,0.2857142857142857,0.073540986,0
2020-07-28-170303,170303,0,0,0,140,1.0,0.24759048,1
2020-07-29-170303,170303,0,0,0,140,0.7142857142857143,0.16214384,2
2020-07-30-170303,170303,0,0,0,140,1.4285714285714286,0.31582555,3
2020-07-31-170303,170303,0,0,0,140,0.5714285714285714,0.1313982,4
2020-08-01-170303,170303,0,0,0,140,0.14285714285714285,0.085857004,5
2020-08-02-170303,170303,0,0,0,140,0.42857142857142855,0.17402643,6
2020-08-03-170303,170303,0,0,0,140,1.0,0.2999443,0
2020-08-04-170303,170303,1,0,0,141,1.4285714285714286,0.79850495,1
2020-08-05-170303,170303,1,0,0,142,1.7142857142857142,0.87368834,2
2020-08-06-170303,170303,0,0,0,142,2.142857142857143,0.54158777,3
2020-08-07-170303,170303,0,0,0,142,2.2857142857142856,0.5683994,4
2020-08-08-170303,170303,0,0,0,142,0.42857142857142855,0.18568517,5
2020-08-09-170303,170303,0,0,0,142,0.0,0.060860664,6
2020-08-10-170303,170303,0,0,0,142,1.0,0.6755846,0
2020-08-11-170303,170303,0,0,0,142,0.42857142857142855,0.07784784,1
2020-08-12-170303,170303,0,0,7,142,1.4285714285714286,0.34774673,2
2020-08-13-170303,170303,0,0,1,142,0.8571428571428571,0.22717834,3
2020-08-14-170303,170303,0,0,4,142,0.2857142857142857,0.16726519,4
2020-08-15-170303,170303,0,0,1,142,1.1428571428571428,0.39365143,5
2020-08-16-170303,170303,0,0,0,142,0.7142857142857143,0.12248647,6
2020-08-17-170303,170303,0,0,0,142,0.5714285714285714,0.118175015,0
2020-08-18-170303,170303,0,0,2,142,2.0,0.54912895,1
2020-08-19-170303,170303,0,0,0,142,1.5714285714285714,0.38028672,2
2020-08-20-170303,170303,0,0,4,142,2.2857142857142856,0.4104843,3
2020-08-21-170303,170303,0,0,2,142,1.4285714285714286,0.30465442,4
2020-08-22-170303,170303,0,0,0,142,1.0,0.22915654,5
2020-08-23-170303,170303,0,0,0,142,0.7142857142857143,0.13044967,6
2020-08-24-170303,170303,0,0,0,142,1.4285714285714286,0.35036248,0
2020-08-25-170303,170303,0,0,0,142,2.2857142857142856,0.62205446,1
2020-08-26-170303,170303,7,0,2,149,1.1428571428571428,3.405317,2
2020-08-27-170303,170303,1,0,0,150,3.1428571428571432,1.1250169,3
2020-08-28-170303,170303,4,0,2,154,1.7142857142857142,1.4247223,4
2020-08-29-170303,170303,1,0,0,155,1.0,0.63814825,5
2020-08-30-170303,170303,0,0,0,155,4.0,0.9171457,6
2020-08-31-170303,170303,0,0,0,155,2.571428571428572,0.5375415,0
2020-09-01-170303,170303,2,0,2,157,2.0,1.6659861,1
2020-09-02-170303,170303,0,0,0,157,1.7142857142857142,0.48614454,2
2020-09-03-170303,170303,4,0,0,161,2.571428571428572,1.9850508,3
2020-09-04-170303,170303,2,0,0,163,1.8571428571428568,0.92890096,4
2020-09-05-170303,170303,0,0,0,163,1.5714285714285714,0.15435387,5
2020-09-06-170303,170303,0,0,1,163,1.8571428571428568,0.43993482,6
2020-09-07-170303,170303,0,0,1,163,2.2857142857142856,0.42741045,0
2020-09-08-170303,170303,0,0,0,163,1.2857142857142858,0.29759476,1
2020-09-09-170303,170303,2,0,0,165,5.0,1.1804243,2
2020-09-10-170303,170303,0,0,0,165,1.4285714285714286,0.3752002,3
2020-09-11-170303,170303,2,0,0,167,1.7142857142857142,1.3299063,4
2020-09-12-170303,170303,0,0,0,167,0.5714285714285714,0.17076027,5
2020-09-13-170303,170303,0,0,0,167,2.4285714285714284,0.6049997,6
2020-09-14-170303,170303,0,0,1,167,1.4285714285714286,0.35707805,0
2020-09-15-170303,170303,2,0,0,169,4.142857142857143,1.4698353,1
2020-09-16-170303,170303,0,0,2,169,3.1428571428571432,0.40141824,2
2020-09-17-170303,170303,0,0,1,169,5.142857142857143,0.7099377,3
2020-09-18-170303,170303,0,0,1,169,3.0,0.5747729,4
2020-09-19-170303,170303,0,0,2,169,1.8571428571428568,0.2705934,5
2020-09-20-170303,170303,1,0,0,170,1.4285714285714286,0.5342765,6
2020-09-21-170303,170303,1,0,1,171,4.142857142857143,0.98290044,0
2020-09-22-170303,170303,0,0,1,171,4.428571428571429,0.92236185,1
2020-09-23-170303,170303,0,1,0,171,4.285714285714286,0.78011495,2
2020-09-24-170303,170303,0,0,0,171,1.2857142857142858,0.5607493,3
2020-09-25-170303,170303,0,1,3,171,4.0,0.7442394,4
2020-09-26-170303,170303,0,0,0,171,1.5714285714285714,0.41506422,5
2020-09-27-170303,170303,0,0,1,171,1.5714285714285714,0.2979777,6
2020-09-28-170303,170303,1,0,0,172,3.8571428571428568,1.2472214,0
2020-09-29-170303,170303,0,0,1,172,4.285714285714286,0.7974753,1
2020-09-30-170303,170303,2,0,1,174,2.7142857142857144,1.1893536,2
2020-10-01-170303,170303,1,0,3,175,8.142857142857142,1.6383005,3
2020-10-02-170303,170303,1,0,2,176,6.7142857142857135,1.3655747,4
2020-10-03-170303,170303,2,0,1,178,2.142857142857143,0.9325197,5
2020-10-04-170303,170303,0,0,2,178,1.2857142857142858,0.27876544,6
2020-10-05-170303,170303,1,1,1,179,5.285714285714286,1.0293316,0
2020-10-06-170303,170303,1,0,5,180,3.2857142857142856,0.90814805,1
2020-10-07-170303,170303,0,0,2,180,4.571428571428571,0.6742737,2
2020-10-08-170303,170303,0,0,3,180,6.428571428571429,1.0729947,3
2020-10-09-170303,170303,3,1,2,183,5.0,2.2649488,4
2020-10-10-170303,170303,0,0,1,183,2.142857142857143,0.43539023,5
2020-10-11-170303,170303,1,0,1,184,2.571428571428572,0.79367197,6
2020-10-12-170303,170303,0,0,1,184,1.7142857142857142,0.46156058,0
2020-10-13-170303,170303,1,0,2,185,5.571428571428571,1.4363773,1
2020-10-14-170303,170303,1,0,1,186,6.7142857142857135,1.8592852,2
2020-10-15-170303,170303,3,0,8,189,5.857142857142858,1.5567987,3
2020-10-16-170303,170303,2,0,3,191,5.285714285714286,1.5986576,4
2020-10-17-170303,170303,1,0,3,192,3.571428571428572,1.0237211,5
2020-10-18-170303,170303,2,0,0,194,2.571428571428572,0.981382,6
2020-10-19-170303,170303,1,0,0,195,5.142857142857143,1.3397409,0
2020-10-20-170303,170303,5,0,3,200,4.285714285714286,1.5774364,1
2020-10-21-170303,170303,2,0,1,202,6.7142857142857135,1.7873704,2
2020-10-22-170303,170303,3,0,0,205,6.857142857142858,1.5374671,3
2020-10-23-170303,170303,2,0,0,207,8.285714285714286,1.8352969,4
2020-10-24-170303,170303,1,0,2,208,4.714285714285714,0.9334296,5
2020-10-25-170303,170303,1,0,0,209,1.4285714285714286,0.257525,6
2020-10-26-170303,170303,1,0,1,210,6.2857142857142865,1.9551679,0
2020-10-27-170303,170303,2,1,1,212,6.428571428571429,1.8146006,1
2020-10-28-170303,170303,1,0,3,213,7.2857142857142865,2.0563064,2
2020-10-29-170303,170303,8,0,2,221,14.285714285714285,4.0261054,3
2020-10-30-170303,170303,3,0,1,224,8.857142857142858,2.088133,4
2020-10-31-170303,170303,3,0,0,227,5.428571428571429,2.0970273,5
2020-11-01-170303,170303,0,0,0,227,4.142857142857143,0.53470737,6
2020-11-02-170303,170303,0,0,0,227,5.428571428571429,0.7138859,0
2020-11-03-170303,170303,3,1,0,230,7.428571428571429,3.157821,1
2020-11-04-170303,170303,1,0,0,231,6.7142857142857135,1.8782635,2
2020-11-05-170303,170303,0,0,0,231,11.571428571428573,2.1709476,3
2020-11-06-170303,170303,0,0,0,231,9.285714285714286,1.4526869,4
2020-11-07-170303,170303,2,1,0,233,5.7142857142857135,1.659876,5
2020-11-08-170303,170303,0,0,0,233,3.2857142857142856,0.42062774,6
2020-11-09-170303,170303,1,0,0,234,6.571428571428571,1.7955787,0
2020-11-10-170303,170303,1,0,0,235,5.285714285714286,1.5070566,1
2020-11-11-170303,170303,3,1,0,238,8.142857142857142,2.5111902,2
2020-11-12-170303,170303,2,0,0,240,5.7142857142857135,1.7958494,3
2020-11-13-170303,170303,1,2,0,241,9.142857142857142,1.7491281,4
2020-03-01-170304,170304,0,0,0,0,0.0,1.1029741e-13,6
2020-03-02-170304,170304,0,0,0,0,0.0,2.3521101e-05,0
2020-03-03-170304,170304,0,0,5,0,0.0,2.5440513e-11,1
2020-03-04-170304,170304,0,0,1,0,0.0,0.000117264826,2
2020-03-05-170304,170304,0,0,1,0,0.0,2.896603e-05,3
2020-03-06-170304,170304,0,1,0,0,0.0,0.0008199479,4
2020-03-07-170304,170304,0,0,1,0,0.0,0.0002436772,5
2020-03-08-170304,170304,0,0,2,0,0.0,0.00011339158,6
2020-03-09-170304,170304,0,0,0,0,0.0,0.00095224986,0
2020-03-10-170304,170304,0,0,3,0,0.0,0.00087931025,1
2020-03-11-170304,170304,0,0,0,0,0.0,0.00019100662,2
2020-03-12-170304,170304,0,0,0,0,0.0,0.002085358,3
2020-03-13-170304,170304,0,0,1,0,0.3333333333333333,0.041706197,4
2020-03-14-170304,170304,1,0,0,1,0.3333333333333333,0.08848627,5
2020-03-15-170304,170304,0,0,2,1,0.6666666666666666,0.022048993,6
2020-03-16-170304,170304,0,0,1,1,2.6666666666666665,0.11230131,0
2020-03-17-170304,170304,5,2,1,6,2.0,0.27630118,1
2020-03-18-170304,170304,1,0,1,7,1.0,0.14747615,2
2020-03-19-170304,170304,1,0,0,8,4.333333333333333,0.2723354,3
2020-03-20-170304,170304,0,0,2,8,3.0,0.14932969,4
2020-03-21-170304,170304,1,0,0,9,1.0,0.05570337,5
2020-03-22-170304,170304,2,0,0,11,1.6666666666666667,0.13874091,6
2020-03-23-170304,170304,0,0,3,11,4.0,0.23010571,0
2020-03-24-170304,170304,3,0,1,14,3.333333333333333,0.310382,1
2020-03-25-170304,170304,0,0,1,14,3.6666666666666665,0.27838445,2
2020-03-26-170304,170304,0,0,0,14,4.0,0.30216655,3
2020-03-27-170304,170304,1,0,2,15,3.0,0.1942878,4
2020-03-28-170304,170304,0,0,1,15,2.0,0.081160635,5
2020-03-29-170304,170304,2,0,0,17,5.666666666666668,0.1015701,6
2020-03-30-170304,170304,1,0,1,18,4.333333333333333,0.21327552,0
2020-03-31-170304,170304,1,0,0,19,3.6666666666666665,0.16442561,1
2020-04-01-170304,170304,1,0,0,20,2.333333333333333,0.15533195,2
2020-04-02-170304,170304,0,0,0,20,3.6666666666666665,0.12717165,3
2020-04-03-170304,170304,2,0,1,22,1.0,0.11335111,4
2020-04-04-170304,170304,0,0,0,22,1.3333333333333333,0.0722551,5
2020-04-05-170304,170304,0,0,0,22,0.0,0.011056804,6
2020-04-06-170304,170304,3,5,1,25,1.0,0.13554548,0
2020-04-07-170304,170304,1,3,0,26,0.6666666666666666,0.13791685,1
2020-04-08-170304,170304,1,0,0,27,1.6666666666666667,0.21851812,2
2020-04-09-170304,170304,0,0,0,27,4.333333333333333,0.12714772,3
2020-04-10-170304,170304,2,0,0,29,1.0,0.04689152,4
2020-04-11-170304,170304,1,0,0,30,0.6666666666666666,0.05402349,5
2020-04-12-170304,170304,0,0,0,30,0.0,0.018065762,6
2020-04-13-170304,170304,1,0,0,31,0.6666666666666666,0.13379806,0
2020-04-14-170304,170304,0,0,0,31,0.6666666666666666,0.05687792,1
2020-04-15-170304,170304,0,0,0,31,0.6666666666666666,0.041794535,2
2020-04-16-170304,170304,0,0,0,31,0.6666666666666666,0.054681595,3
2020-04-17-170304,170304,1,0,1,32,1.3333333333333333,0.07280237,4
2020-04-18-170304,170304,0,0,0,32,0.0,0.0062121255,5
2020-04-19-170304,170304,0,0,0,32,0.3333333333333333,0.004928196,6
2020-04-20-170304,170304,1,1,0,33,1.0,0.119850144,0
2020-04-21-170304,170304,0,0,1,33,1.0,0.12645245,1
2020-04-22-170304,170304,0,0,1,33,1.6666666666666667,0.10992042,2
2020-04-23-170304,170304,0,0,0,33,0.0,0.011449872,3
2020-04-24-170304,170304,0,0,0,33,2.6666666666666665,0.13158377,4
2020-04-25-170304,170304,0,0,0,33,0.0,0.01409132,5
2020-04-26-170304,170304,0,0,0,33,0.0,0.003931241,6
2020-04-27-170304,170304,0,0,0,33,1.6666666666666667,0.032447897,0
2020-04-28-170304,170304,0,0,2,33,1.3333333333333333,0.069449835,1
2020-04-29-170304,170304,0,0,1,33,0.3333333333333333,0.019984642,2
2020-04-30-170304,170304,0,0,0,33,0.3333333333333333,0.017890753,3
2020-05-01-170304,170304,1,0,0,34,0.3333333333333333,0.0479947,4
2020-05-02-170304,170304,0,1,0,34,0.0,0.01436739,5
2020-05-03-170304,170304,0,0,0,34,0.3333333333333333,0.029128307,6
2020-05-04-170304,170304,0,0,0,34,2.333333333333333,0.1321457,0
2020-05-05-170304,170304,1,0,0,35,0.6666666666666666,0.09897559,1
2020-05-06-170304,170304,1,0,0,36,0.3333333333333333,0.08418693,2
2020-05-07-170304,170304,0,0,0,36,0.6666666666666666,0.027057579,3
2020-05-08-170304,170304,0,0,1,36,1.3333333333333333,0.095103174,4
2020-05-09-170304,170304,0,0,0,36,0.6666666666666666,0.021508476,5
2020-05-10-170304,170304,0,1,0,36,0.3333333333333333,0.0057304273,6
2020-05-11-170304,170304,0,0,1,36,0.6666666666666666,0.03649403,0
2020-05-12-170304,170304,2,0,0,38,0.6666666666666666,0.059332937,1
2020-05-13-170304,170304,1,0,1,39,0.3333333333333333,0.046759453,2
2020-05-14-170304,170304,0,16,0,39,1.6666666666666667,0.05468224,3
2020-05-15-170304,170304,0,0,1,39,0.6666666666666666,0.099798925,4
2020-05-16-170304,170304,0,0,0,39,0.3333333333333333,0.0022105807,5
2020-05-17-170304,170304,0,0,0,39,0.0,0.006138961,6
2020-05-18-170304,170304,0,0,0,39,2.0,0.048772328,0
2020-05-19-170304,170304,0,0,0,39,0.3333333333333333,0.04819304,1
2020-05-20-170304,170304,0,0,0,39,0.6666666666666666,0.02401566,2
2020-05-21-170304,170304,0,0,0,39,1.0,0.054043822,3
2020-05-22-170304,170304,1,0,0,40,2.0,0.06891754,4
2020-05-23-170304,170304,0,1,0,40,0.0,0.0009880183,5
2020-05-24-170304,170304,0,0,0,40,0.0,0.0035729322,6
2020-05-25-170304,170304,1,0,0,41,0.6666666666666666,0.055022385,0
2020-05-26-170304,170304,0,0,0,41,0.3333333333333333,0.042842094,1
2020-05-27-170304,170304,1,0,0,42,0.3333333333333333,0.087522045,2
2020-05-28-170304,170304,0,1,0,42,0.3333333333333333,0.08876617,3
2020-05-29-170304,170304,1,1,0,43,1.0,0.078397565,4
2020-05-30-170304,170304,0,1,0,43,0.3333333333333333,0.002044678,5
2020-05-31-170304,170304,0,0,0,43,0.0,0.00045117893,6
2020-06-01-170304,170304,0,0,1,43,0.6666666666666666,0.09054288,0
2020-06-02-170304,170304,0,0,0,43,1.0,0.038782615,1
2020-06-03-170304,170304,0,0,0,43,0.3333333333333333,0.040096927,2
2020-06-04-170304,170304,0,0,0,43,1.3333333333333333,0.096753925,3
2020-06-05-170304,170304,0,0,0,43,0.6666666666666666,0.047994103,4
2020-06-06-170304,170304,0,0,0,43,0.0,0.0008829543,5
2020-06-07-170304,170304,0,0,0,43,0.0,0.009055943,6
2020-06-08-170304,170304,0,0,0,43,1.0,0.04785432,0
2020-06-09-170304,170304,0,0,0,43,0.6666666666666666,0.050068002,1
2020-06-10-170304,170304,0,0,0,43,0.0,0.04922512,2
2020-06-11-170304,170304,0,0,0,43,0.3333333333333333,0.06401678,3
2020-06-12-170304,170304,0,0,0,43,0.0,0.0442073,4
2020-06-13-170304,170304,0,0,0,43,0.0,0.0049937777,5
2020-06-14-170304,170304,0,0,0,43,0.0,0.00088992645,6
2020-06-15-170304,170304,1,0,0,44,0.0,0.043083817,0
2020-06-16-170304,170304,0,1,0,44,1.6666666666666667,0.06518526,1
2020-06-17-170304,170304,0,0,0,44,0.6666666666666666,0.01783625,2
2020-06-18-170304,170304,0,0,0,44,0.0,0.006646473,3
2020-06-19-170304,170304,0,0,0,44,0.3333333333333333,0.023790937,4
2020-06-20-170304,170304,0,1,0,44,0.0,0.0058640772,5
2020-06-21-170304,170304,0,0,0,44,0.3333333333333333,0.00070424867,6
2020-06-22-170304,170304,0,0,0,44,0.0,0.014856505,0
2020-06-23-170304,170304,0,0,0,44,0.0,0.036536552,1
2020-06-24-170304,170304,0,0,0,44,0.0,0.015496966,2
2020-06-25-170304,170304,0,0,0,44,0.0,0.04255809,3
2020-06-26-170304,170304,0,0,0,44,0.0,0.013093591,4
2020-06-27-170304,170304,0,0,0,44,0.0,0.0060331924,5
2020-06-28-170304,170304,0,0,0,44,0.0,0.000112471054,6
2020-06-29-170304,170304,0,0,2,44,0.6666666666666666,0.066188134,0
2020-06-30-170304,170304,0,0,0,44,0.0,0.027509479,1
2020-07-01-170304,170304,0,0,0,44,0.0,0.0041963956,2
2020-07-02-170304,170304,0,0,0,44,0.0,0.012608749,3
2020-07-03-170304,170304,0,0,1,44,0.3333333333333333,0.023959806,4
2020-07-04-170304,170304,0,0,1,44,0.0,0.007104139,5
2020-07-05-170304,170304,0,0,0,44,0.0,0.0009272293,6
2020-07-06-170304,170304,0,0,1,44,0.0,0.005081571,0
2020-07-07-170304,170304,0,0,0,44,0.0,0.014563286,1
2020-07-08-170304,170304,0,0,1,44,0.3333333333333333,0.016257193,2
2020-07-09-170304,170304,0,0,0,44,0.3333333333333333,0.0607466,3
2020-07-10-170304,170304,0,0,0,44,0.0,0.01114505,4
2020-07-11-170304,170304,0,0,0,44,0.0,0.00047222013,5
2020-07-12-170304,170304,0,0,0,44,0.0,0.0063021556,6
2020-07-13-170304,170304,2,0,0,46,0.3333333333333333,0.12173456,0
2020-07-14-170304,170304,0,0,0,46,0.6666666666666666,0.0154318735,1
2020-07-15-170304,170304,0,0,1,46,0.3333333333333333,0.02085604,2
2020-07-16-170304,170304,0,0,2,46,0.0,0.027312486,3
2020-07-17-170304,170304,1,0,0,47,0.0,0.0388008,4
2020-07-18-170304,170304,1,0,2,48,0.3333333333333333,0.10249287,5
2020-07-19-170304,170304,0,0,1,48,0.0,0.008651386,6
2020-07-20-170304,170304,1,0,1,49,0.0,0.06592122,0
2020-07-21-170304,170304,0,0,0,49,0.0,0.014842345,1
2020-07-22-170304,170304,1,0,0,50,0.0,0.055887505,2
2020-07-23-170304,170304,0,0,0,50,0.3333333333333333,0.043659437,3
2020-07-24-170304,170304,0,0,0,50,0.6666666666666666,0.02331718,4
2020-07-25-170304,170304,0,0,1,50,0.0,0.016014159,5
2020-07-26-170304,170304,0,0,0,50,0.0,0.007955368,6
2020-07-27-170304,170304,0,0,0,50,0.0,0.008914674,0
2020-07-28-170304,170304,0,0,1,50,0.3333333333333333,0.038369372,1
2020-07-29-170304,170304,1,0,0,51,0.3333333333333333,0.052491855,2
2020-07-30-170304,170304,2,0,0,53,0.0,0.09118939,3
2020-07-31-170304,170304,0,0,1,53,0.0,0.024653187,4
2020-08-01-170304,170304,2,0,0,55,0.0,0.060931727,5
2020-08-02-170304,170304,1,0,2,56,0.3333333333333333,0.1131098,6
2020-08-03-170304,170304,1,0,0,57,0.0,0.05249131,0
2020-08-04-170304,170304,0,0,0,57,0.3333333333333333,0.124746665,1
2020-08-05-170304,170304,0,0,2,57,0.3333333333333333,0.09243982,2
2020-08-06-170304,170304,0,0,0,57,0.0,0.039620876,3
2020-08-07-170304,170304,0,0,0,57,0.3333333333333333,0.047402587,4
2020-08-08-170304,170304,1,0,0,58,0.3333333333333333,0.11597546,5
2020-08-09-170304,170304,0,0,0,58,0.0,0.004569907,6
2020-08-10-170304,170304,0,0,1,58,1.0,0.06818074,0
2020-08-11-170304,170304,1,0,0,59,0.6666666666666666,0.014193506,1
2020-08-12-170304,170304,0,0,0,59,1.0,0.037475448,2
2020-08-13-170304,170304,0,0,0,59,0.6666666666666666,0.07220593,3
2020-08-14-170304,170304,1,0,4,60,0.0,0.042385053,4
2020-08-15-170304,170304,0,0,0,60,0.3333333333333333,0.08131474,5
2020-08-16-170304,170304,2,0,0,62,0.6666666666666666,0.09273896,6
2020-08-17-170304,170304,0,0,0,62,0.3333333333333333,0.016668992,0
2020-08-18-170304,170304,0,0,1,62,1.3333333333333333,0.24255961,1
2020-08-19-170304,170304,2,0,0,64,0.0,0.0977648,2
2020-08-20-170304,170304,0,0,0,64,0.6666666666666666,0.10470501,3
2020-08-21-170304,170304,0,0,0,64,0.3333333333333333,0.044047613,4
2020-08-22-170304,170304,0,0,0,64,0.3333333333333333,0.032736544,5
2020-08-23-170304,170304,0,0,0,64,0.0,0.027926492,6
2020-08-24-170304,170304,1,0,0,65,0.3333333333333333,0.11535454,0
2020-08-25-170304,170304,0,0,1,65,1.3333333333333333,0.22446236,1
2020-08-26-170304,170304,0,0,0,65,2.6666666666666665,0.32841617,2
2020-08-27-170304,170304,0,0,0,65,3.333333333333333,0.19969128,3
2020-08-28-170304,170304,4,0,0,69,0.0,0.19813387,4
2020-08-29-170304,170304,0,0,0,69,0.6666666666666666,0.14251485,5
2020-08-30-170304,170304,0,0,1,69,1.6666666666666667,0.18387647,6
2020-08-31-170304,170304,0,0,2,69,0.6666666666666666,0.123102285,0
2020-09-01-170304,170304,1,0,1,70,0.6666666666666666,0.19842409,1
2020-09-02-170304,170304,0,0,0,70,1.3333333333333333,0.11182764,2
2020-09-03-170304,170304,0,0,0,70,0.3333333333333333,0.20349425,3
2020-09-04-170304,170304,0,0,1,70,1.0,0.21704115,4
2020-09-05-170304,170304,0,0,0,70,0.6666666666666666,0.024122305,5
2020-09-06-170304,170304,0,0,0,70,1.0,0.16133796,6
2020-09-07-170304,170304,0,0,0,70,1.0,0.21809481,0
2020-09-08-170304,170304,1,0,0,71,0.3333333333333333,0.041595533,1
2020-09-09-170304,170304,0,0,0,71,2.0,0.10556865,2
2020-09-10-170304,170304,0,0,0,71,0.6666666666666666,0.11827624,3
2020-09-11-170304,170304,0,0,2,71,0.6666666666666666,0.19480672,4
2020-09-12-170304,170304,0,0,0,71,0.0,0.021635562,5
2020-09-13-170304,170304,1,0,2,72,1.3333333333333333,0.2875481,6
2020-09-14-170304,170304,2,0,2,74,0.0,0.070287734,0
2020-09-15-170304,170304,1,0,0,75,2.0,0.16571562,1
2020-09-16-170304,170304,0,0,0,75,2.0,0.05994565,2
2020-09-17-170304,170304,0,0,0,75,1.3333333333333333,0.18311389,3
2020-09-18-170304,170304,1,0,1,76,0.3333333333333333,0.09524945,4
2020-09-19-170304,170304,0,0,1,76,0.0,0.04123772,5
2020-09-20-170304,170304,0,0,0,76,1.3333333333333333,0.037232418,6
2020-09-21-170304,170304,0,0,0,76,1.0,0.13414828,0
2020-09-22-170304,170304,0,0,0,76,2.6666666666666665,0.17827378,1
2020-09-23-170304,170304,0,0,0,76,1.3333333333333333,0.17328615,2
2020-09-24-170304,170304,0,0,1,76,4.666666666666667,0.088087656,3
2020-09-25-170304,170304,2,0,0,78,7.333333333333332,0.16253343,4
2020-09-26-170304,170304,0,0,0,78,1.3333333333333333,0.11202336,5
2020-09-27-170304,170304,2,0,0,80,3.333333333333333,0.09125781,6
2020-09-28-170304,170304,2,0,0,82,2.0,0.21990174,0
2020-09-29-170304,170304,0,0,0,82,1.0,0.0978667,1
2020-09-30-170304,170304,0,0,0,82,0.3333333333333333,0.11069012,2
2020-10-01-170304,170304,0,0,0,82,3.6666666666666665,0.2752864,3
2020-10-02-170304,170304,1,0,1,83,1.6666666666666667,0.19235514,4
2020-10-03-170304,170304,1,0,0,84,1.6666666666666667,0.10768567,5
2020-10-04-170304,170304,0,0,0,84,1.0,0.068014026,6
2020-10-05-170304,170304,0,0,0,84,0.3333333333333333,0.10844342,0
2020-10-06-170304,170304,0,0,0,84,1.3333333333333333,0.08321181,1
2020-10-07-170304,170304,0,0,0,84,0.6666666666666666,0.056357317,2
2020-10-08-170304,170304,1,0,0,85,1.6666666666666667,0.12383214,3
2020-10-09-170304,170304,0,0,1,85,3.333333333333333,0.21096717,4
2020-10-10-170304,170304,0,0,0,85,2.333333333333333,0.07314885,5
2020-10-11-170304,170304,0,0,0,85,1.0,0.105443284,6
2020-10-12-170304,170304,0,0,0,85,3.0,0.237848,0
2020-10-13-170304,170304,0,0,1,85,2.0,0.1699728,1
2020-10-14-170304,170304,0,0,0,85,2.0,0.24713524,2
2020-10-15-170304,170304,0,0,0,85,0.3333333333333333,0.16621694,3
2020-10-16-170304,170304,1,0,0,86,6.0,0.21528831,4
2020-10-17-170304,170304,0,0,0,86,4.333333333333333,0.13154565,5
2020-10-18-170304,170304,0,0,1,86,1.0,0.076667346,6
2020-10-19-170304,170304,0,0,0,86,6.666666666666668,0.27652794,0
2020-10-20-170304,170304,0,0,1,86,5.0,0.15144666,1
2020-10-21-170304,170304,0,0,2,86,5.666666666666668,0.1804363,2
2020-10-22-170304,170304,0,0,1,86,6.333333333333332,0.23838222,3
2020-10-23-170304,170304,1,0,1,87,2.333333333333333,0.23983221,4
2020-10-24-170304,170304,0,0,0,87,4.0,0.08192717,5
2020-10-25-170304,170304,0,0,0,87,2.0,0.039299212,6
2020-10-26-170304,170304,0,0,0,87,6.0,0.26194927,0
2020-10-27-170304,170304,1,0,0,88,4.0,0.22678587,1
2020-10-28-170304,170304,0,0,2,88,4.0,0.36432844,2
2020-10-29-170304,170304,0,0,0,88,5.333333333333333,0.5310039,3
2020-10-30-170304,170304,0,0,0,88,8.666666666666666,0.26363277,4
2020-10-31-170304,170304,0,0,0,88,1.3333333333333333,0.12949757,5
2020-11-01-170304,170304,1,0,0,89,2.6666666666666665,0.094839126,6
2020-11-02-170304,170304,0,0,0,89,0.3333333333333333,0.073897846,0
2020-11-03-170304,170304,1,0,0,90,7.333333333333332,0.41046003,1
2020-11-04-170304,170304,2,0,0,92,5.0,0.2133555,2
2020-11-05-170304,170304,1,0,0,93,7.666666666666668,0.3425026,3
2020-11-06-170304,170304,1,0,0,94,4.333333333333333,0.25583437,4
2020-11-07-170304,170304,0,0,0,94,3.333333333333333,0.3864048,5
2020-11-08-170304,170304,0,0,0,94,1.3333333333333333,0.055285584,6
2020-11-09-170304,170304,0,0,0,94,8.333333333333334,0.2154651,0
2020-11-10-170304,170304,0,0,0,94,4.333333333333333,0.2311116,1
2020-11-11-170304,170304,2,0,0,96,4.666666666666667,0.28087816,2
2020-11-12-170304,170304,0,0,0,96,4.666666666666667,0.17670113,3
2020-11-13-170304,170304,0,0,0,96,7.0,0.25139654,4
2020-03-01-170305,170305,0,0,1,0,0.0,3.0143816e-14,6
2020-03-02-170305,170305,0,0,4,0,0.0,0.00052812515,0
2020-03-03-170305,170305,0,0,1,0,0.0,0.0,1
2020-03-04-170305,170305,0,0,0,0,0.0,0.00044500383,2
2020-03-05-170305,170305,0,0,1,0,0.0,8.5759595e-09,3
2020-03-06-170305,170305,0,0,2,0,0.0,7.938545e-05,4
2020-03-07-170305,170305,0,0,1,0,0.0,0.00030449306,5
2020-03-08-170305,170305,0,0,1,0,0.0,0.0007939802,6
2020-03-09-170305,170305,0,0,3,0,0.0,0.0020237493,0
2020-03-10-170305,170305,0,0,3,0,0.0,6.792119e-05,1
2020-03-11-170305,170305,0,0,3,0,0.0,0.00057934294,2
2020-03-12-170305,170305,0,0,2,0,0.0,0.0025231994,3
2020-03-13-170305,170305,0,0,1,0,0.0,0.0030883641,4
2020-03-14-170305,170305,0,0,1,0,1.0,0.0053959438,5
2020-03-15-170305,170305,1,0,1,1,1.3333333333333333,0.05310389,6
2020-03-16-170305,170305,4,0,2,5,7.166666666666668,0.25370482,0
2020-03-17-170305,170305,1,0,1,6,7.5,0.15703021,1
2020-03-18-170305,170305,0,0,0,6,8.833333333333334,0.14026774,2
2020-03-19-170305,170305,1,0,2,7,10.0,0.31704625,3
2020-03-20-170305,170305,2,0,1,9,9.166666666666666,0.23110886,4
2020-03-21-170305,170305,1,0,0,10,1.3333333333333333,0.041707877,5
2020-03-22-170305,170305,1,0,1,11,2.0,0.056577183,6
2020-03-23-170305,170305,3,0,1,14,14.333333333333336,0.3849362,0
2020-03-24-170305,170305,3,0,1,17,9.833333333333334,0.22143094,1
2020-03-25-170305,170305,3,0,0,20,11.833333333333336,0.21826114,2
2020-03-26-170305,170305,2,0,1,22,12.0,0.17968176,3
2020-03-27-170305,170305,1,0,0,23,11.333333333333336,0.2511814,4
2020-03-28-170305,170305,1,0,1,24,0.8333333333333334,0.031875502,5
2020-03-29-170305,170305,1,0,2,25,0.3333333333333333,0.034922056,6
2020-03-30-170305,170305,2,0,2,27,13.666666666666664,0.09321365,0
2020-03-31-170305,170305,1,0,0,28,6.333333333333332,0.08286203,1
2020-04-01-170305,170305,0,0,3,28,6.833333333333332,0.11514182,2
2020-04-02-170305,170305,2,0,1,30,4.666666666666667,0.078667685,3
2020-04-03-170305,170305,1,0,0,31,6.666666666666668,0.05920095,4
2020-04-04-170305,170305,0,0,1,31,1.0,0.006780605,5
2020-04-05-170305,170305,1,0,1,32,1.3333333333333333,0.013752021,6
2020-04-06-170305,170305,1,1,0,33,10.833333333333336,0.06485213,0
2020-04-07-170305,170305,1,0,3,34,5.833333333333332,0.06475896,1
2020-04-08-170305,170305,0,0,0,34,4.666666666666667,0.14399886,2
2020-04-09-170305,170305,1,0,0,35,5.333333333333333,0.03347818,3
2020-04-10-170305,170305,0,0,3,35,4.333333333333333,0.059918553,4
2020-04-11-170305,170305,1,0,0,36,0.6666666666666666,0.03201596,5
2020-04-12-170305,170305,2,0,0,38,0.6666666666666666,0.031088656,6
2020-04-13-170305,170305,2,0,0,40,5.333333333333333,0.17540324,0
2020-04-14-170305,170305,0,0,1,40,5.666666666666668,0.117968306,1
2020-04-15-170305,170305,3,1,0,43,3.6666666666666665,0.10948459,2
2020-04-16-170305,170305,1,0,2,44,4.666666666666667,0.060250595,3
2020-04-17-170305,170305,0,0,0,44,5.166666666666667,0.07652193,4
2020-04-18-170305,170305,1,0,0,45,0.16666666666666666,0.017414983,5
2020-04-19-170305,170305,1,0,0,46,1.0,0.013169978,6
2020-04-20-170305,170305,0,0,0,46,8.5,0.09493644,0
2020-04-21-170305,170305,3,0,1,49,2.333333333333333,0.12340042,1
2020-04-22-170305,170305,0,0,0,49,8.0,0.04684035,2
2020-04-23-170305,170305,0,0,0,49,1.6666666666666667,0.004187683,3
2020-04-24-170305,170305,3,0,2,52,13.333333333333336,0.119140014,4
2020-04-25-170305,170305,0,0,0,52,0.3333333333333333,0.0056443517,5
2020-04-26-170305,170305,0,0,1,52,0.6666666666666666,0.016824069,6
2020-04-27-170305,170305,0,0,0,52,3.8333333333333335,0.026741844,0
2020-04-28-170305,170305,1,1,1,53,1.8333333333333333,0.08534937,1
2020-04-29-170305,170305,0,0,0,53,3.1666666666666665,0.032190796,2
2020-04-30-170305,170305,2,0,0,55,3.333333333333333,0.124269634,3
2020-05-01-170305,170305,0,0,0,55,0.3333333333333333,0.0118313255,4
2020-05-02-170305,170305,0,0,0,55,0.5,0.0018577373,5
2020-05-03-170305,170305,0,0,0,55,0.3333333333333333,0.0004753957,6
2020-05-04-170305,170305,0,0,0,55,3.0,0.06318901,0
2020-05-05-170305,170305,1,0,0,56,3.0,0.10051993,1
2020-05-06-170305,170305,0,0,0,56,2.6666666666666665,0.035612803,2
2020-05-07-170305,170305,0,0,0,56,2.5,0.12673952,3
2020-05-08-170305,170305,2,0,0,58,3.1666666666666665,0.11374879,4
2020-05-09-170305,170305,0,0,0,58,0.6666666666666666,0.014892832,5
2020-05-10-170305,170305,1,0,1,59,0.3333333333333333,0.018975165,6
2020-05-11-170305,170305,0,0,2,59,1.6666666666666667,0.018257998,0
2020-05-12-170305,170305,1,0,1,60,1.6666666666666667,0.048558038,1
2020-05-13-170305,170305,0,0,0,60,3.333333333333333,0.1462743,2
2020-05-14-170305,170305,0,0,0,60,4.166666666666667,0.096205525,3
2020-05-15-170305,170305,0,0,1,60,1.8333333333333333,0.016903667,4
2020-05-16-170305,170305,0,0,0,60,1.1666666666666667,0.015307278,5
2020-05-17-170305,170305,0,0,0,60,0.0,0.0001758292,6
2020-05-18-170305,170305,0,0,0,60,1.8333333333333333,0.050222874,0
2020-05-19-170305,170305,0,0,0,60,2.333333333333333,0.04245545,1
2020-05-20-170305,170305,0,0,0,60,2.0,0.018006423,2
2020-05-21-170305,170305,0,0,3,60,3.1666666666666665,0.04557481,3
2020-05-22-170305,170305,0,0,0,60,4.5,0.027303541,4
2020-05-23-170305,170305,0,0,0,60,0.6666666666666666,0.036462113,5
2020-05-24-170305,170305,1,0,0,61,0.16666666666666666,0.019567342,6
2020-05-25-170305,170305,2,0,0,63,2.333333333333333,0.14943019,0
2020-05-26-170305,170305,1,0,0,64,2.333333333333333,0.15966548,1
2020-05-27-170305,170305,0,0,0,64,1.3333333333333333,0.031509385,2
2020-05-28-170305,170305,0,0,1,64,2.833333333333333,0.028772017,3
2020-05-29-170305,170305,1,0,0,65,3.333333333333333,0.08491785,4
2020-05-30-170305,170305,0,0,0,65,0.5,0.010096811,5
2020-05-31-170305,170305,0,0,1,65,0.16666666666666666,0.018952327,6
2020-06-01-170305,170305,0,0,0,65,2.333333333333333,0.056218907,0
2020-06-02-170305,170305,0,0,0,65,1.8333333333333333,0.05675659,1
2020-06-03-170305,170305,0,0,0,65,3.5,0.021247828,2
2020-06-04-170305,170305,3,0,0,68,1.5,0.122723565,3
2020-06-05-170305,170305,0,0,0,68,3.5,0.0473289,4
2020-06-06-170305,170305,0,0,0,68,0.0,0.00038849545,5
2020-06-07-170305,170305,0,0,0,68,0.0,0.0012952077,6
2020-06-08-170305,170305,0,0,1,68,3.5,0.0315807,0
2020-06-09-170305,170305,0,0,0,68,3.1666666666666665,0.06429455,1
2020-06-10-170305,170305,0,0,0,68,2.0,0.040710907,2
2020-06-11-170305,170305,1,0,0,69,2.1666666666666665,0.08109131,3
2020-06-12-170305,170305,0,0,1,69,1.1666666666666667,0.01352161,4
2020-06-13-170305,170305,0,0,0,69,0.5,0.025202423,5
2020-06-14-170305,170305,1,0,0,70,0.16666666666666666,0.03238781,6
2020-06-15-170305,170305,0,0,0,70,1.1666666666666667,0.013044759,0
2020-06-16-170305,170305,0,0,0,70,0.8333333333333334,0.015258612,1
2020-06-17-170305,170305,0,1,0,70,0.5,0.009487543,2
2020-06-18-170305,170305,0,0,0,70,0.8333333333333334,0.011194754,3
2020-06-19-170305,170305,0,0,0,70,1.0,0.011483484,4
2020-06-20-170305,170305,0,0,0,70,0.0,0.0028515148,5
2020-06-21-170305,170305,0,0,0,70,0.0,0.006881953,6
2020-06-22-170305,170305,1,0,0,71,0.3333333333333333,0.06803916,0
2020-06-23-170305,170305,0,0,0,71,0.6666666666666666,0.06573924,1
2020-06-24-170305,170305,0,1,0,71,0.0,0.0071934187,2
2020-06-25-170305,170305,0,1,0,71,0.3333333333333333,0.009994255,3
2020-06-26-170305,170305,1,0,1,72,0.5,0.054442465,4
2020-06-27-170305,170305,0,0,0,72,0.0,0.002119854,5
2020-06-28-170305,170305,0,0,0,72,0.0,2.0641046e-06,6
2020-06-29-170305,170305,0,0,1,72,0.3333333333333333,0.014899512,0
2020-06-30-170305,170305,0,0,1,72,0.3333333333333333,0.011843613,1
2020-07-01-170305,170305,0,0,1,72,0.16666666666666666,0.004104477,2
2020-07-02-170305,170305,0,0,1,72,0.16666666666666666,0.0371068,3
2020-07-03-170305,170305,0,0,0,72,0.5,0.024935009,4
2020-07-04-170305,170305,0,0,1,72,0.0,0.0006147405,5
2020-07-05-170305,170305,0,0,1,72,0.16666666666666666,0.0025433342,6
2020-07-06-170305,170305,0,0,0,72,0.5,0.009835186,0
2020-07-07-170305,170305,0,0,2,72,1.1666666666666667,0.09259432,1
2020-07-08-170305,170305,0,0,0,72,0.3333333333333333,0.004530427,2
2020-07-09-170305,170305,0,0,4,72,0.5,0.013105441,3
2020-07-10-170305,170305,1,0,0,73,0.3333333333333333,0.014064583,4
2020-07-11-170305,170305,0,0,0,73,0.0,0.002900355,5
2020-07-12-170305,170305,0,0,0,73,0.16666666666666666,0.0022360499,6
2020-07-13-170305,170305,1,0,1,74,0.8333333333333334,0.059489634,0
2020-07-14-170305,170305,1,0,0,75,0.3333333333333333,0.0563197,1
2020-07-15-170305,170305,1,0,1,76,0.3333333333333333,0.0486656,2
2020-07-16-170305,170305,1,0,0,77,0.16666666666666666,0.06530261,3
2020-07-17-170305,170305,0,0,0,77,0.8333333333333334,0.045724705,4
2020-07-18-170305,170305,1,0,0,78,0.3333333333333333,0.059166037,5
2020-07-19-170305,170305,1,0,0,79,0.3333333333333333,0.051996212,6
2020-07-20-170305,170305,0,0,0,79,0.5,0.009419089,0
2020-07-21-170305,170305,2,0,0,81,0.5,0.117817715,1
2020-07-22-170305,170305,0,0,1,81,0.5,0.009166522,2
2020-07-23-170305,170305,4,0,0,85,0.16666666666666666,0.1568869,3
2020-07-24-170305,170305,0,0,0,85,1.1666666666666667,0.05691556,4
2020-07-25-170305,170305,0,1,0,85,0.0,0.00258633,5
2020-07-26-170305,170305,0,0,0,85,0.5,0.006855153,6
2020-07-27-170305,170305,1,0,1,86,0.6666666666666666,0.00884484,0
2020-07-28-170305,170305,0,0,1,86,0.3333333333333333,0.061196186,1
2020-07-29-170305,170305,1,0,0,87,0.0,0.057631336,2
2020-07-30-170305,170305,0,0,0,87,0.8333333333333334,0.025206877,3
2020-07-31-170305,170305,0,0,1,87,0.6666666666666666,0.011749249,4
2020-08-01-170305,170305,0,0,0,87,0.0,0.0044701938,5
2020-08-02-170305,170305,0,0,0,87,0.0,0.008855023,6
2020-08-03-170305,170305,0,0,1,87,1.5,0.04978228,0
2020-08-04-170305,170305,0,0,0,87,1.1666666666666667,0.07281247,1
2020-08-05-170305,170305,1,0,1,88,1.1666666666666667,0.05632561,2
2020-08-06-170305,170305,0,0,0,88,0.6666666666666666,0.054275844,3
2020-08-07-170305,170305,0,0,0,88,0.8333333333333334,0.07854414,4
2020-08-08-170305,170305,0,0,0,88,0.16666666666666666,0.010048656,5
2020-08-09-170305,170305,0,0,0,88,0.0,0.009915469,6
2020-08-10-170305,170305,1,0,0,89,0.8333333333333334,0.120575614,0
2020-08-11-170305,170305,1,0,1,90,1.0,0.07074105,1
2020-08-12-170305,170305,0,0,5,90,1.3333333333333333,0.02485665,2
2020-08-13-170305,170305,0,0,0,90,1.0,0.086888134,3
2020-08-14-170305,170305,1,0,0,91,1.0,0.05691458,4
2020-08-15-170305,170305,0,0,0,91,1.0,0.21928015,5
2020-08-16-170305,170305,0,0,0,91,0.3333333333333333,0.05562934,6
2020-08-17-170305,170305,1,0,3,92,1.8333333333333333,0.16482504,0
2020-08-18-170305,170305,0,0,0,92,0.8333333333333334,0.13841188,1
2020-08-19-170305,170305,1,0,0,93,4.0,0.42918357,2
2020-08-20-170305,170305,0,0,0,93,0.8333333333333334,0.14495325,3
2020-08-21-170305,170305,0,0,1,93,4.0,0.2660518,4
2020-08-22-170305,170305,0,0,1,93,1.1666666666666667,0.07012775,5
2020-08-23-170305,170305,0,0,0,93,1.5,0.09353626,6
2020-08-24-170305,170305,0,0,0,93,1.8333333333333333,0.17454582,0
2020-08-25-170305,170305,1,0,1,94,4.0,0.34153625,1
2020-08-26-170305,170305,5,0,2,99,1.3333333333333333,0.4421844,2
2020-08-27-170305,170305,0,0,0,99,3.0,0.22168727,3
2020-08-28-170305,170305,0,0,0,99,2.0,0.07219618,4
2020-08-29-170305,170305,0,0,0,99,2.833333333333333,0.0851861,5
2020-08-30-170305,170305,0,0,0,99,1.6666666666666667,0.09142609,6
2020-08-31-170305,170305,3,0,4,102,2.833333333333333,0.19933999,0
2020-09-01-170305,170305,0,0,3,102,2.1666666666666665,0.06700079,1
2020-09-02-170305,170305,0,0,0,102,1.5,0.071417056,2
2020-09-03-170305,170305,0,0,2,102,2.5,0.08446314,3
2020-09-04-170305,170305,1,0,2,103,3.8333333333333335,0.18755254,4
2020-09-05-170305,170305,1,0,0,104,3.0,0.12356472,5
2020-09-06-170305,170305,0,0,0,104,0.6666666666666666,0.05336957,6
2020-09-07-170305,170305,0,0,1,104,5.833333333333332,0.10496305,0
2020-09-08-170305,170305,1,0,0,105,5.666666666666668,0.16018695,1
2020-09-09-170305,170305,2,0,0,107,5.0,0.2591449,2
2020-09-10-170305,170305,0,0,0,107,5.666666666666668,0.24096368,3
2020-09-11-170305,170305,0,0,0,107,6.666666666666668,0.20535913,4
2020-09-12-170305,170305,0,0,0,107,2.333333333333333,0.05973294,5
2020-09-13-170305,170305,0,0,0,107,4.166666666666667,0.067060284,6
2020-09-14-170305,170305,4,0,0,111,8.666666666666666,0.6417307,0
2020-09-15-170305,170305,3,0,1,114,4.833333333333333,0.4269921,1
2020-09-16-170305,170305,0,0,0,114,8.833333333333334,0.18465242,2
2020-09-17-170305,170305,2,0,0,116,7.666666666666668,0.2348062,3
2020-09-18-170305,170305,2,0,1,118,8.0,0.21063855,4
2020-09-19-170305,170305,0,0,0,118,1.1666666666666667,0.06374052,5
2020-09-20-170305,170305,0,0,3,118,2.0,0.09868129,6
2020-09-21-170305,170305,1,0,0,119,11.666666666666664,0.20766725,0
2020-09-22-170305,170305,0,1,0,119,7.0,0.14451493,1
2020-09-23-170305,170305,0,0,3,119,7.333333333333332,0.1448101,2
2020-09-24-170305,170305,0,1,0,119,7.0,0.26212564,3
2020-09-25-170305,170305,0,0,4,119,6.0,0.22130798,4
2020-09-26-170305,170305,0,0,3,119,1.6666666666666667,0.03599411,5
2020-09-27-170305,170305,0,0,0,119,1.0,0.05769664,6
2020-09-28-170305,170305,0,0,0,119,9.666666666666666,0.17039992,0
2020-09-29-170305,170305,1,0,0,120,4.5,0.18329765,1
2020-09-30-170305,170305,0,0,2,120,7.0,0.16685554,2
2020-10-01-170305,170305,0,0,2,120,9.666666666666666,0.26480544,3
2020-10-02-170305,170305,1,0,3,121,12.333333333333336,0.23904097,4
2020-10-03-170305,170305,0,0,8,121,3.0,0.101145774,5
2020-10-04-170305,170305,3,1,0,124,2.6666666666666665,0.16861331,6
2020-10-05-170305,170305,0,1,1,124,3.0,0.19000399,0
2020-10-06-170305,170305,0,0,3,124,9.666666666666666,0.39029756,1
2020-10-07-170305,170305,3,0,0,127,8.666666666666666,0.2449109,2
2020-10-08-170305,170305,0,0,5,127,8.0,0.3070064,3
2020-10-09-170305,170305,4,0,2,131,17.5,0.49344292,4
2020-10-10-170305,170305,3,0,2,134,2.1666666666666665,0.25534382,5
2020-10-11-170305,170305,0,0,0,134,1.8333333333333333,0.058087382,6
2020-10-12-170305,170305,0,0,0,134,1.0,0.092023246,0
2020-10-13-170305,170305,0,0,1,134,14.666666666666664,0.27867332,1
2020-10-14-170305,170305,2,0,0,136,9.833333333333334,0.31261542,2
2020-10-15-170305,170305,2,0,2,138,11.166666666666664,0.24541828,3
2020-10-16-170305,170305,3,0,5,141,7.666666666666668,0.298387,4
2020-10-17-170305,170305,8,0,0,149,1.3333333333333333,0.34306076,5
2020-10-18-170305,170305,0,0,1,149,2.333333333333333,0.07215319,6
2020-10-19-170305,170305,1,0,0,150,17.0,0.23535685,0
2020-10-20-170305,170305,3,0,0,153,9.0,0.2604675,1
2020-10-21-170305,170305,0,0,1,153,11.166666666666664,0.13650385,2
2020-10-22-170305,170305,5,0,0,158,18.83333333333333,0.5317405,3
2020-10-23-170305,170305,2,0,2,160,11.166666666666664,0.32069874,4
2020-10-24-170305,170305,2,0,0,162,2.6666666666666665,0.17731,5
2020-10-25-170305,170305,0,0,15,162,2.333333333333333,0.05538492,6
2020-10-26-170305,170305,0,0,9,162,13.833333333333336,0.26917866,0
2020-10-27-170305,170305,1,0,4,163,4.833333333333333,0.24433467,1
2020-10-28-170305,170305,0,1,3,163,17.166666666666668,0.18544267,2
2020-10-29-170305,170305,2,0,2,165,13.833333333333336,0.29151234,3
2020-10-30-170305,170305,5,0,18,170,14.333333333333336,0.48715618,4
2020-10-31-170305,170305,0,0,0,170,2.0,0.12717403,5
2020-11-01-170305,170305,1,0,0,171,3.0,0.18307702,6
2020-11-02-170305,170305,0,0,0,171,0.8333333333333334,0.031370673,0
2020-11-03-170305,170305,0,0,0,171,15.166666666666664,0.29733878,1
2020-11-04-170305,170305,1,0,0,172,6.0,0.20584667,2
2020-11-05-170305,170305,0,0,0,172,12.333333333333336,0.38581747,3
2020-11-06-170305,170305,2,0,0,174,9.666666666666666,0.21789663,4
2020-11-07-170305,170305,0,1,0,174,0.6666666666666666,0.046833556,5
2020-11-08-170305,170305,15,0,0,189,1.3333333333333333,0.2893619,6
2020-11-09-170305,170305,9,0,0,198,17.5,0.6351759,0
2020-11-10-170305,170305,4,1,0,202,18.166666666666668,0.50589436,1
2020-11-11-170305,170305,3,1,0,205,10.833333333333336,0.31145576,2
2020-11-12-170305,170305,2,0,0,207,10.833333333333336,0.2984407,3
2020-11-13-170305,170305,18,0,0,225,10.666666666666666,0.77213836,4
2020-03-01-170306,170306,0,0,4,0,0.0,1.3393135e-08,6
2020-03-02-170306,170306,0,0,3,0,0.0,3.0874584e-05,0
2020-03-03-170306,170306,0,0,2,0,0.0,5.0696755e-08,1
2020-03-04-170306,170306,0,0,4,0,0.0,0.0003035448,2
2020-03-05-170306,170306,0,0,8,0,0.0,4.763323e-08,3
2020-03-06-170306,170306,0,0,7,0,0.0,0.00011627383,4
2020-03-07-170306,170306,0,0,2,0,0.0,0.00077687507,5
2020-03-08-170306,170306,0,0,3,0,0.0,0.0009678142,6
2020-03-09-170306,170306,0,0,10,0,0.2,0.015144339,0
2020-03-10-170306,170306,0,0,3,0,0.0,0.00020502394,1
2020-03-11-170306,170306,0,0,4,0,0.0,0.00497041,2
2020-03-12-170306,170306,0,0,4,0,0.2,0.008879716,3
2020-03-13-170306,170306,0,0,9,0,0.0,0.005090846,4
2020-03-14-170306,170306,0,0,1,0,0.2,0.008615535,5
2020-03-15-170306,170306,4,0,2,4,0.4,0.08414545,6
2020-03-16-170306,170306,3,0,1,7,1.6,0.39551482,0
2020-03-17-170306,170306,2,0,2,9,1.2,0.19140923,1
2020-03-18-170306,170306,4,0,5,13,1.2,0.20128393,2
2020-03-19-170306,170306,8,1,1,21,0.8,0.50422955,3
2020-03-20-170306,170306,7,0,0,28,1.6,0.41255268,4
2020-03-21-170306,170306,2,0,0,30,0.8,0.09240792,5
2020-03-22-170306,170306,3,0,1,33,0.4,0.07123067,6
2020-03-23-170306,170306,10,0,1,43,2.4,0.5758333,0
2020-03-24-170306,170306,3,0,1,46,1.6,0.29710415,1
2020-03-25-170306,170306,4,0,7,50,1.8,0.32833132,2
2020-03-26-170306,170306,4,0,0,54,1.0,0.25098017,3
2020-03-27-170306,170306,9,0,5,63,0.8,0.49275482,4
2020-03-28-170306,170306,1,0,2,64,0.2,0.0543415,5
2020-03-29-170306,170306,2,0,0,66,0.6,0.05317205,6
2020-03-30-170306,170306,1,0,3,67,0.8,0.13902533,0
2020-03-31-170306,170306,2,0,2,69,0.8,0.11973459,1
2020-04-01-170306,170306,5,0,2,74,0.6,0.2135374,2
2020-04-02-170306,170306,1,0,0,75,0.8,0.09111068,3
2020-04-03-170306,170306,0,0,0,75,1.2,0.11874122,4
2020-04-04-170306,170306,0,0,0,75,0.2,0.04293612,5
2020-04-05-170306,170306,1,0,0,76,0.2,0.022105837,6
2020-04-06-170306,170306,1,0,2,77,0.8,0.108983666,0
2020-04-07-170306,170306,1,0,1,78,0.8,0.12317477,1
2020-04-08-170306,170306,7,0,0,85,0.8,0.29294488,2
2020-04-09-170306,170306,0,0,0,85,0.2,0.043705907,3
2020-04-10-170306,170306,5,1,2,90,0.6,0.13716322,4
2020-04-11-170306,170306,2,0,0,92,0.8,0.057424713,5
2020-04-12-170306,170306,0,1,2,92,0.8,0.035137493,6
2020-04-13-170306,170306,3,0,1,95,0.8,0.24891283,0
2020-04-14-170306,170306,2,0,2,97,0.8,0.23137401,1
2020-04-15-170306,170306,2,0,0,99,1.2,0.17340235,2
2020-04-16-170306,170306,0,0,1,99,1.0,0.08198421,3
2020-04-17-170306,170306,0,0,1,99,0.2,0.13804714,4
2020-04-18-170306,170306,0,0,0,99,0.4,0.01955771,5
2020-04-19-170306,170306,0,0,0,99,0.2,0.014177044,6
2020-04-20-170306,170306,2,0,0,101,0.4,0.17155166,0
2020-04-21-170306,170306,1,0,1,102,1.0,0.17240132,1
2020-04-22-170306,170306,0,0,0,102,0.4,0.07423628,2
2020-04-23-170306,170306,0,0,4,102,0.2,0.0056748334,3
2020-04-24-170306,170306,2,0,0,104,1.4,0.14549482,4
2020-04-25-170306,170306,0,0,0,104,0.2,0.033845156,5
2020-04-26-170306,170306,2,0,1,106,0.2,0.046130855,6
2020-04-27-170306,170306,1,0,0,107,0.2,0.027768055,0
2020-04-28-170306,170306,2,0,0,109,1.6,0.15823889,1
2020-04-29-170306,170306,0,0,6,109,1.0,0.06460812,2
2020-04-30-170306,170306,1,0,5,110,0.8,0.18762258,3
2020-05-01-170306,170306,1,0,0,111,0.0,0.019871157,4
2020-05-02-170306,170306,0,0,1,111,0.2,0.008026583,5
2020-05-03-170306,170306,0,0,0,111,0.0,0.0017936141,6
2020-05-04-170306,170306,0,0,1,111,0.6,0.092367895,0
2020-05-05-170306,170306,1,0,1,112,0.2,0.11984365,1
2020-05-06-170306,170306,0,0,0,112,0.8,0.062143426,2
2020-05-07-170306,170306,4,0,1,116,1.0,0.29917452,3
2020-05-08-170306,170306,0,0,1,116,0.8,0.10992449,4
2020-05-09-170306,170306,0,0,2,116,0.2,0.024894807,5
2020-05-10-170306,170306,1,2,0,117,0.4,0.026219996,6
2020-05-11-170306,170306,0,0,2,117,0.0,0.022918714,0
2020-05-12-170306,170306,0,0,3,117,0.6,0.06989135,1
2020-05-13-170306,170306,6,0,0,123,0.8,0.3103865,2
2020-05-14-170306,170306,5,0,0,128,0.2,0.17617022,3
2020-05-15-170306,170306,0,0,1,128,0.0,0.023656677,4
2020-05-16-170306,170306,1,0,0,129,0.2,0.03159166,5
2020-05-17-170306,170306,0,0,1,129,0.0,0.0017559102,6
2020-05-18-170306,170306,1,0,0,130,0.4,0.0760137,0
2020-05-19-170306,170306,1,0,1,131,0.0,0.07355943,1
2020-05-20-170306,170306,0,0,0,131,0.6,0.029569402,2
2020-05-21-170306,170306,1,0,0,132,0.2,0.075019434,3
2020-05-22-170306,170306,1,0,0,133,0.2,0.02702418,4
2020-05-23-170306,170306,2,0,0,135,0.2,0.07996416,5
2020-05-24-170306,170306,0,0,0,135,0.2,0.016965296,6
2020-05-25-170306,170306,2,0,0,137,1.0,0.19436288,0
2020-05-26-170306,170306,3,0,1,140,0.6,0.2663539,1
2020-05-27-170306,170306,0,0,0,140,0.4,0.068423964,2
2020-05-28-170306,170306,0,0,1,140,0.2,0.033195585,3
2020-05-29-170306,170306,1,0,0,141,1.2,0.1103951,4
2020-05-30-170306,170306,0,0,1,141,0.0,0.0067808796,5
2020-05-31-170306,170306,1,0,0,142,0.0,0.04531094,6
2020-06-01-170306,170306,0,0,0,142,0.4,0.08216107,0
2020-06-02-170306,170306,1,1,0,143,0.0,0.09914987,1
2020-06-03-170306,170306,0,0,0,143,0.2,0.021616856,2
2020-06-04-170306,170306,0,0,0,143,0.8,0.13440341,3
2020-06-05-170306,170306,0,0,0,143,0.4,0.058229607,4
2020-06-06-170306,170306,0,0,0,143,0.0,0.001087181,5
2020-06-07-170306,170306,0,1,0,143,0.0,0.00056237035,6
2020-06-08-170306,170306,0,0,1,143,0.2,0.0457537,0
2020-06-09-170306,170306,1,0,1,144,0.2,0.113913104,1
2020-06-10-170306,170306,0,0,0,144,0.8,0.08928114,2
2020-06-11-170306,170306,1,0,0,145,0.2,0.103751086,3
2020-06-12-170306,170306,0,0,0,145,0.4,0.01654471,4
2020-06-13-170306,170306,1,0,0,146,0.0,0.047225494,5
2020-06-14-170306,170306,0,0,0,146,0.2,0.033333603,6
2020-06-15-170306,170306,0,0,0,146,0.4,0.02704562,0
2020-06-16-170306,170306,0,2,0,146,0.2,0.011992156,1
2020-06-17-170306,170306,0,0,0,146,0.4,0.014010467,2
2020-06-18-170306,170306,0,0,1,146,0.8,0.028919073,3
2020-06-19-170306,170306,0,1,0,146,0.0,0.009781644,4
2020-06-20-170306,170306,0,0,0,146,0.0,0.0038955675,5
2020-06-21-170306,170306,0,0,0,146,0.0,0.003046782,6
2020-06-22-170306,170306,1,0,0,147,0.4,0.09416937,0
2020-06-23-170306,170306,1,0,0,148,0.2,0.12512554,1
2020-06-24-170306,170306,0,0,0,148,0.0,0.017704384,2
2020-06-25-170306,170306,0,0,0,148,0.4,0.021315126,3
2020-06-26-170306,170306,0,0,0,148,0.2,0.056631908,4
2020-06-27-170306,170306,0,0,0,148,0.0,0.004816034,5
2020-06-28-170306,170306,0,0,0,148,0.0,0.00014801318,6
2020-06-29-170306,170306,0,0,1,148,0.0,0.010535703,0
2020-06-30-170306,170306,0,0,0,148,0.4,0.024541624,1
2020-07-01-170306,170306,0,0,0,148,0.0,0.009418821,2
2020-07-02-170306,170306,1,0,0,149,0.2,0.065499336,3
2020-07-03-170306,170306,0,0,1,149,0.2,0.059794933,4
2020-07-04-170306,170306,0,0,0,149,0.0,0.0008455328,5
2020-07-05-170306,170306,0,0,0,149,0.0,0.0009079658,6
2020-07-06-170306,170306,0,0,0,149,0.2,0.035163507,0
2020-07-07-170306,170306,0,0,0,149,0.0,0.17100832,1
2020-07-08-170306,170306,0,0,0,149,0.0,0.0082676,2
2020-07-09-170306,170306,0,0,0,149,0.0,0.016938407,3
2020-07-10-170306,170306,0,0,1,149,0.4,0.040716864,4
2020-07-11-170306,170306,0,0,0,149,0.0,0.015148299,5
2020-07-12-170306,170306,0,0,0,149,0.0,0.001275452,6
2020-07-13-170306,170306,1,0,0,150,0.2,0.05223627,0
2020-07-14-170306,170306,0,0,1,150,0.2,0.0651433,1
2020-07-15-170306,170306,0,0,0,150,0.2,0.05249626,2
2020-07-16-170306,170306,0,0,1,150,0.2,0.06815452,3
2020-07-17-170306,170306,1,0,0,151,0.0,0.08239947,4
2020-07-18-170306,170306,0,0,0,151,0.6,0.0548728,5
2020-07-19-170306,170306,0,0,0,151,0.2,0.046698004,6
2020-07-20-170306,170306,0,0,1,151,0.0,0.008592105,0
2020-07-21-170306,170306,0,0,1,151,0.6,0.14875343,1
2020-07-22-170306,170306,0,0,1,151,0.0,0.007338641,2
2020-07-23-170306,170306,0,0,1,151,0.8,0.14859809,3
2020-07-24-170306,170306,1,0,2,152,0.0,0.0677682,4
2020-07-25-170306,170306,0,0,0,152,0.4,0.005165353,5
2020-07-26-170306,170306,0,0,0,152,0.0,0.0020401923,6
2020-07-27-170306,170306,0,0,1,152,0.4,0.019329293,0
2020-07-28-170306,170306,1,0,1,153,0.4,0.12066045,1
2020-07-29-170306,170306,0,0,0,153,0.2,0.054253902,2
2020-07-30-170306,170306,1,0,2,154,0.0,0.015660757,3
2020-07-31-170306,170306,0,0,1,154,0.2,0.009337026,4
2020-08-01-170306,170306,0,0,6,154,0.0,0.00640681,5
2020-08-02-170306,170306,0,0,1,154,0.0,0.011954231,6
2020-08-03-170306,170306,1,0,3,155,0.2,0.08127721,0
2020-08-04-170306,170306,1,0,1,156,0.0,0.12990999,1
2020-08-05-170306,170306,1,1,12,157,0.2,0.091468275,2
2020-08-06-170306,170306,1,0,3,158,0.0,0.10361304,3
2020-08-07-170306,170306,2,0,3,160,0.0,0.12967853,4
2020-08-08-170306,170306,0,0,1,160,0.0,0.010235263,5
2020-08-09-170306,170306,0,0,2,160,0.0,0.018537018,6
2020-08-10-170306,170306,1,0,0,161,0.4,0.16556871,0
2020-08-11-170306,170306,1,0,3,162,0.2,0.15510078,1
2020-08-12-170306,170306,0,0,1,162,0.4,0.047604576,2
2020-08-13-170306,170306,2,0,1,164,0.0,0.16184038,3
2020-08-14-170306,170306,1,0,0,165,0.2,0.09188601,4
2020-08-15-170306,170306,6,0,0,171,0.0,0.3309985,5
2020-08-16-170306,170306,1,0,2,172,0.2,0.09604137,6
2020-08-17-170306,170306,3,0,0,175,0.6,0.24709882,0
2020-08-18-170306,170306,1,0,3,176,1.2,0.2538445,1
2020-08-19-170306,170306,12,0,0,188,1.4,0.74919736,2
2020-08-20-170306,170306,3,0,2,191,0.4,0.2628101,3
2020-08-21-170306,170306,3,0,1,194,5.0,0.57465076,4
2020-08-22-170306,170306,1,0,0,195,0.4,0.10370551,5
2020-08-23-170306,170306,2,0,1,197,1.0,0.16792317,6
2020-08-24-170306,170306,0,0,2,197,0.2,0.28086558,0
2020-08-25-170306,170306,3,0,0,200,1.6,0.67898744,1
2020-08-26-170306,170306,1,0,2,201,2.4,0.5412285,2
2020-08-27-170306,170306,1,0,3,202,1.8,0.27396005,3
2020-08-28-170306,170306,0,0,0,202,0.8,0.1297111,4
2020-08-29-170306,170306,0,0,1,202,1.4,0.17384984,5
2020-08-30-170306,170306,2,0,0,204,0.6,0.13069122,6
2020-08-31-170306,170306,0,0,19,204,1.4,0.27227724,0
2020-09-01-170306,170306,3,0,8,207,0.2,0.13355526,1
2020-09-02-170306,170306,0,0,2,207,0.6,0.10246246,2
2020-09-03-170306,170306,2,0,1,209,0.0,0.08487943,3
2020-09-04-170306,170306,1,0,0,210,1.2,0.3306877,4
2020-09-05-170306,170306,0,0,2,210,1.8,0.16303003,5
2020-09-06-170306,170306,1,0,5,211,0.8,0.07021785,6
2020-09-07-170306,170306,2,0,7,213,0.4,0.1354022,0
2020-09-08-170306,170306,0,0,0,213,1.2,0.20269048,1
2020-09-09-170306,170306,2,0,2,215,1.2,0.41268513,2
2020-09-10-170306,170306,3,0,3,218,2.2,0.45588544,3
2020-09-11-170306,170306,0,0,3,218,0.2,0.31709516,4
2020-09-12-170306,170306,1,0,0,219,0.6,0.093110055,5
2020-09-13-170306,170306,0,0,1,219,0.0,0.052048713,6
2020-09-14-170306,170306,19,0,3,238,2.2,1.0046751,0
2020-09-15-170306,170306,8,0,2,246,0.6,0.70961833,1
2020-09-16-170306,170306,2,0,4,248,1.6,0.27557236,2
2020-09-17-170306,170306,1,0,4,249,1.0,0.3141488,3
2020-09-18-170306,170306,0,0,4,249,1.2,0.28560135,4
2020-09-19-170306,170306,2,0,3,251,0.0,0.10790088,5
2020-09-20-170306,170306,5,1,1,256,0.4,0.16397443,6
2020-09-21-170306,170306,7,1,5,263,1.0,0.32364887,0
2020-09-22-170306,170306,0,2,3,263,1.4,0.22392634,1
2020-09-23-170306,170306,2,0,1,265,0.6,0.23945677,2
2020-09-24-170306,170306,3,0,5,268,0.0,0.450448,3
2020-09-25-170306,170306,3,0,9,271,0.2,0.56668746,4
2020-09-26-170306,170306,0,0,4,271,1.8,0.06690527,5
2020-09-27-170306,170306,1,0,0,272,0.0,0.07241987,6
2020-09-28-170306,170306,3,0,2,275,1.6,0.21765003,0
2020-09-29-170306,170306,2,0,3,277,1.8,0.31356564,1
2020-09-30-170306,170306,4,0,1,281,1.6,0.2888266,2
2020-10-01-170306,170306,4,0,1,285,1.8,0.39113262,3
2020-10-02-170306,170306,4,0,0,289,1.0,0.36557513,4
2020-10-03-170306,170306,3,0,1,292,0.8,0.18961044,5
2020-10-04-170306,170306,1,0,0,293,3.2,0.20337303,6
2020-10-05-170306,170306,5,0,0,298,1.6,0.3141949,0
2020-10-06-170306,170306,3,0,0,301,1.2,0.5813986,1
2020-10-07-170306,170306,1,1,0,302,1.6,0.34948203,2
2020-10-08-170306,170306,5,0,2,307,3.0,0.49321613,3
2020-10-09-170306,170306,9,0,3,316,1.4,0.6819533,4
2020-10-10-170306,170306,4,0,2,320,1.0,0.35828143,5
2020-10-11-170306,170306,0,0,0,320,0.4,0.041582827,6
2020-10-12-170306,170306,2,0,2,322,1.0,0.1674819,0
2020-10-13-170306,170306,3,0,1,325,1.2,0.43240902,1
2020-10-14-170306,170306,1,0,1,326,0.6,0.41781273,2
2020-10-15-170306,170306,1,0,2,327,1.8,0.44348407,3
2020-10-16-170306,170306,0,0,1,327,0.8,0.38913634,4
2020-10-17-170306,170306,1,0,1,328,2.2,0.42539215,5
2020-10-18-170306,170306,0,0,5,328,1.2,0.11175064,6
2020-10-19-170306,170306,0,0,0,328,2.8,0.32223427,0
2020-10-20-170306,170306,0,0,0,328,2.2,0.40209377,1
2020-10-21-170306,170306,0,0,1,328,0.6,0.17082877,2
2020-10-22-170306,170306,2,0,4,330,4.0,0.5749213,3
2020-10-23-170306,170306,3,0,0,333,1.4,0.52899826,4
2020-10-24-170306,170306,2,0,0,335,3.8,0.22281276,5
2020-10-25-170306,170306,0,0,0,335,0.6,0.06968982,6
2020-10-26-170306,170306,2,0,2,337,1.6,0.39153492,0
2020-10-27-170306,170306,1,0,5,338,1.4,0.42422768,1
2020-10-28-170306,170306,1,0,1,339,4.8,0.22825876,2
2020-10-29-170306,170306,2,0,3,341,2.8,0.41490477,3
2020-10-30-170306,170306,1,0,1,342,3.0,0.5838519,4
2020-10-31-170306,170306,1,1,0,343,0.6,0.16147459,5
2020-11-01-170306,170306,5,0,0,348,4.4,0.2978758,6
2020-11-02-170306,170306,0,1,0,348,1.2,0.08153378,0
2020-11-03-170306,170306,0,0,0,348,3.8,0.36995697,1
2020-11-04-170306,170306,1,0,0,349,2.6,0.33855537,2
2020-11-05-170306,170306,4,0,0,353,1.2,0.47811767,3
2020-11-06-170306,170306,0,1,0,353,2.4,0.30111045,4
2020-11-07-170306,170306,0,1,0,353,1.6,0.10221801,5
2020-11-08-170306,170306,0,1,0,353,3.2,0.21741216,6
2020-11-09-170306,170306,2,0,0,355,3.4,0.84386414,0
2020-11-10-170306,170306,5,0,0,360,2.6,0.8048,1
2020-11-11-170306,170306,1,0,0,361,3.0,0.56947976,2
2020-11-12-170306,170306,3,0,0,364,4.6,0.46357775,3
2020-11-13-170306,170306,1,0,0,365,3.8,0.9651314,4
2020-03-01-170307,170307,0,0,2,0,0.0,7.3939233e-09,6
2020-03-02-170307,170307,0,0,5,0,0.0,0.00087980763,0
2020-03-03-170307,170307,0,0,2,0,0.0,1.70282e-06,1
2020-03-04-170307,170307,0,1,3,0,0.0,0.0011860015,2
2020-03-05-170307,170307,0,0,10,0,0.0,5.519859e-09,3
2020-03-06-170307,170307,0,0,8,0,0.0,0.00020317014,4
2020-03-07-170307,170307,0,0,0,0,0.0,0.0014535014,5
2020-03-08-170307,170307,0,0,2,0,0.0,0.00040855177,6
2020-03-09-170307,170307,0,0,6,0,0.0,0.0024840925,0
2020-03-10-170307,170307,0,0,3,0,0.0,4.0296705e-05,1
2020-03-11-170307,170307,0,0,5,0,0.0,0.00033553172,2
2020-03-12-170307,170307,0,0,3,0,0.0,0.0027526058,3
2020-03-13-170307,170307,0,0,1,0,0.2,0.022461044,4
2020-03-14-170307,170307,0,0,2,0,1.0,0.031383425,5
2020-03-15-170307,170307,2,0,0,2,0.6,0.066651195,6
2020-03-16-170307,170307,5,0,4,7,4.6,0.36923262,0
2020-03-17-170307,170307,2,0,6,9,9.4,0.2520451,1
2020-03-18-170307,170307,3,1,3,12,8.4,0.25728583,2
2020-03-19-170307,170307,10,0,5,22,11.4,0.4512923,3
2020-03-20-170307,170307,8,0,1,30,7.6,0.37428167,4
2020-03-21-170307,170307,0,0,0,30,1.8,0.038356967,5
2020-03-22-170307,170307,2,0,0,32,2.4,0.09149811,6
2020-03-23-170307,170307,6,0,0,38,13.0,0.5063618,0
2020-03-24-170307,170307,3,0,1,41,10.2,0.33093834,1
2020-03-25-170307,170307,5,0,3,46,11.6,0.38162312,2
2020-03-26-170307,170307,3,0,2,49,13.2,0.2972654,3
2020-03-27-170307,170307,1,0,2,50,11.8,0.2308488,4
2020-03-28-170307,170307,2,0,1,52,0.8,0.058963526,5
2020-03-29-170307,170307,0,0,0,52,1.2,0.030178133,6
2020-03-30-170307,170307,4,0,1,56,13.8,0.23304065,0
2020-03-31-170307,170307,6,0,1,62,6.8,0.20623858,1
2020-04-01-170307,170307,3,0,1,65,7.6,0.15595338,2
2020-04-02-170307,170307,5,0,2,70,4.6,0.1693359,3
2020-04-03-170307,170307,1,0,1,71,6.4,0.09385512,4
2020-04-04-170307,170307,0,0,0,71,1.2,0.015781274,5
2020-04-05-170307,170307,0,0,1,71,1.4,0.013701917,6
2020-04-06-170307,170307,0,7,1,71,6.6,0.11706318,0
2020-04-07-170307,170307,1,3,3,72,6.8,0.107785836,1
2020-04-08-170307,170307,3,0,3,75,5.0,0.17202532,2
2020-04-09-170307,170307,2,0,0,77,7.0,0.10180774,3
2020-04-10-170307,170307,2,0,3,79,2.6,0.07050789,4
2020-04-11-170307,170307,1,0,0,80,0.8,0.04563932,5
2020-04-12-170307,170307,0,0,0,80,0.8,0.031520765,6
2020-04-13-170307,170307,1,0,3,81,8.2,0.21114078,0
2020-04-14-170307,170307,1,0,3,82,4.6,0.12521179,1
2020-04-15-170307,170307,1,0,1,83,3.8,0.12816572,2
2020-04-16-170307,170307,2,0,1,85,3.2,0.1198611,3
2020-04-17-170307,170307,1,0,0,86,5.0,0.107625395,4
2020-04-18-170307,170307,0,0,0,86,0.8,0.020120393,5
2020-04-19-170307,170307,1,0,0,87,0.8,0.029221142,6
2020-04-20-170307,170307,1,0,3,88,4.4,0.11260958,0
2020-04-21-170307,170307,3,0,1,91,2.6,0.1690234,1
2020-04-22-170307,170307,3,0,0,94,9.4,0.15112595,2
2020-04-23-170307,170307,0,0,0,94,0.4,0.0074263974,3
2020-04-24-170307,170307,3,0,2,97,13.0,0.27649993,4
2020-04-25-170307,170307,0,0,0,97,1.2,0.011903565,5
2020-04-26-170307,170307,0,0,0,97,0.6,0.003794455,6
2020-04-27-170307,170307,3,0,2,100,3.8,0.12455204,0
2020-04-28-170307,170307,3,0,0,103,2.0,0.15732896,1
2020-04-29-170307,170307,1,0,0,104,3.0,0.07553715,2
2020-04-30-170307,170307,1,0,2,105,3.0,0.09978573,3
2020-05-01-170307,170307,0,0,0,105,0.4,0.0064246324,4
2020-05-02-170307,170307,0,0,0,105,0.8,0.005441309,5
2020-05-03-170307,170307,0,0,0,105,0.4,0.0078062913,6
2020-05-04-170307,170307,3,0,5,108,3.4,0.16367693,0
2020-05-05-170307,170307,1,0,0,109,3.6,0.13530223,1
2020-05-06-170307,170307,0,0,1,109,2.8,0.061679468,2
2020-05-07-170307,170307,0,0,1,109,2.4,0.05090695,3
2020-05-08-170307,170307,2,0,1,111,3.2,0.18153295,4
2020-05-09-170307,170307,0,0,0,111,0.4,0.012272184,5
2020-05-10-170307,170307,0,0,0,111,0.2,0.015431321,6
2020-05-11-170307,170307,2,7,2,113,1.8,0.09259677,0
2020-05-12-170307,170307,0,0,1,113,3.0,0.06612699,1
2020-05-13-170307,170307,0,0,1,113,2.8,0.050244622,2
2020-05-14-170307,170307,2,0,0,115,4.0,0.1328172,3
2020-05-15-170307,170307,0,0,0,115,1.6,0.06705719,4
2020-05-16-170307,170307,0,0,1,115,1.0,0.011648568,5
2020-05-17-170307,170307,0,0,0,115,0.2,0.0014741233,6
2020-05-18-170307,170307,5,0,2,120,1.6,0.16449279,0
2020-05-19-170307,170307,0,0,1,120,2.2,0.040071726,1
2020-05-20-170307,170307,1,1,0,121,2.0,0.05738196,2
2020-05-21-170307,170307,1,0,0,122,2.0,0.08159616,3
2020-05-22-170307,170307,1,0,2,123,4.8,0.093949854,4
2020-05-23-170307,170307,0,0,0,123,0.4,0.00935761,5
2020-05-24-170307,170307,0,0,0,123,0.2,0.018477485,6
2020-05-25-170307,170307,2,0,0,125,2.6,0.21712975,0
2020-05-26-170307,170307,1,0,0,126,1.2,0.13000965,1
2020-05-27-170307,170307,1,0,0,127,1.8,0.074502975,2
2020-05-28-170307,170307,0,0,0,127,2.8,0.0640033,3
2020-05-29-170307,170307,0,1,0,127,3.4,0.1251782,4
2020-05-30-170307,170307,1,0,0,128,0.0,0.0383762,5
2020-05-31-170307,170307,0,0,0,128,0.4,0.006186462,6
2020-06-01-170307,170307,2,0,0,130,3.2,0.123646654,0
2020-06-02-170307,170307,1,0,1,131,2.0,0.08769287,1
2020-06-03-170307,170307,0,0,0,131,3.2,0.058461234,2
2020-06-04-170307,170307,0,0,0,131,2.8,0.17372404,3
2020-06-05-170307,170307,2,0,0,133,2.8,0.13232107,4
2020-06-06-170307,170307,0,0,0,133,0.0,0.0007760138,5
2020-06-07-170307,170307,0,0,1,133,0.0,0.0031956255,6
2020-06-08-170307,170307,0,0,0,133,3.6,0.07084764,0
2020-06-09-170307,170307,0,0,0,133,3.2,0.073894955,1
2020-06-10-170307,170307,0,0,0,133,2.8,0.06691835,2
2020-06-11-170307,170307,0,0,0,133,2.8,0.10602767,3
2020-06-12-170307,170307,0,0,0,133,1.8,0.0423749,4
2020-06-13-170307,170307,0,0,0,133,0.4,0.00909932,5
2020-06-14-170307,170307,0,0,0,133,0.4,0.039408598,6
2020-06-15-170307,170307,0,0,1,133,1.4,0.024849,0
2020-06-16-170307,170307,1,0,0,134,1.0,0.06408923,1
2020-06-17-170307,170307,0,0,0,134,0.4,0.02043669,2
2020-06-18-170307,170307,0,0,0,134,0.0,0.008391454,3
2020-06-19-170307,170307,0,0,0,134,1.8,0.035579067,4
2020-06-20-170307,170307,0,0,0,134,0.0,0.0012568613,5
2020-06-21-170307,170307,1,0,0,135,0.0,0.03524424,6
2020-06-22-170307,170307,0,0,0,135,0.2,0.048739385,0
2020-06-23-170307,170307,0,0,0,135,1.6,0.039761662,1
2020-06-24-170307,170307,0,1,0,135,0.2,0.013136717,2
2020-06-25-170307,170307,0,0,0,135,0.4,0.01856825,3
2020-06-26-170307,170307,0,0,0,135,0.6,0.060994655,4
2020-06-27-170307,170307,0,0,0,135,0.0,0.004369966,5
2020-06-28-170307,170307,0,0,0,135,0.0,2.9330226e-07,6
2020-06-29-170307,170307,1,0,0,136,0.8,0.062334836,0
2020-06-30-170307,170307,0,0,0,136,0.2,0.011275623,1
2020-07-01-170307,170307,0,0,0,136,0.4,0.007211723,2
2020-07-02-170307,170307,0,0,0,136,0.0,0.011136061,3
2020-07-03-170307,170307,0,0,0,136,0.8,0.0226365,4
2020-07-04-170307,170307,0,0,0,136,0.0,0.00029243625,5
2020-07-05-170307,170307,0,0,0,136,0.4,0.0052425195,6
2020-07-06-170307,170307,0,0,0,136,0.8,0.018717015,0
2020-07-07-170307,170307,0,0,0,136,1.2,0.03536854,1
2020-07-08-170307,170307,0,0,0,136,0.2,0.0089854635,2
2020-07-09-170307,170307,0,0,1,136,0.8,0.04264813,3
2020-07-10-170307,170307,0,0,2,136,0.6,0.023558544,4
2020-07-11-170307,170307,0,0,0,136,0.0,0.003116351,5
2020-07-12-170307,170307,0,0,0,136,0.0,0.0026991419,6
2020-07-13-170307,170307,0,0,0,136,1.6,0.08575107,0
2020-07-14-170307,170307,0,0,1,136,0.4,0.051586624,1
2020-07-15-170307,170307,0,0,1,136,0.6,0.060282335,2
2020-07-16-170307,170307,0,0,0,136,0.2,0.09799362,3
2020-07-17-170307,170307,0,0,0,136,1.4,0.038191687,4
2020-07-18-170307,170307,0,0,0,136,0.6,0.08198928,5
2020-07-19-170307,170307,0,0,0,136,0.4,0.06588523,6
2020-07-20-170307,170307,0,0,0,136,1.4,0.025644742,0
2020-07-21-170307,170307,0,0,0,136,0.6,0.10805326,1
2020-07-22-170307,170307,0,0,1,136,0.8,0.018493818,2
2020-07-23-170307,170307,1,0,0,137,0.2,0.1936459,3
2020-07-24-170307,170307,2,0,0,139,1.0,0.109381,4
2020-07-25-170307,170307,0,0,0,139,0.0,0.00157534,5
2020-07-26-170307,170307,0,0,0,139,0.6,0.011611402,6
2020-07-27-170307,170307,0,0,1,139,0.8,0.018345026,0
2020-07-28-170307,170307,1,0,0,140,0.6,0.058481313,1
2020-07-29-170307,170307,1,0,0,141,0.4,0.09782427,2
2020-07-30-170307,170307,0,0,0,141,1.4,0.056182913,3
2020-07-31-170307,170307,0,0,0,141,0.8,0.021063581,4
2020-08-01-170307,170307,0,0,0,141,0.4,0.011838514,5
2020-08-02-170307,170307,0,0,0,141,0.4,0.037016373,6
2020-08-03-170307,170307,0,0,1,141,2.0,0.04303249,0
2020-08-04-170307,170307,0,0,0,141,1.4,0.065062396,1
2020-08-05-170307,170307,1,0,0,142,1.6,0.087730855,2
2020-08-06-170307,170307,0,0,1,142,0.4,0.032351963,3
2020-08-07-170307,170307,0,0,1,142,1.4,0.041133944,4
2020-08-08-170307,170307,0,0,0,142,0.6,0.03403337,5
2020-08-09-170307,170307,0,0,0,142,0.0,0.008573676,6
2020-08-10-170307,170307,1,1,0,143,0.6,0.15034088,0
2020-08-11-170307,170307,0,0,0,143,0.8,0.02848546,1
2020-08-12-170307,170307,0,0,7,143,1.0,0.032855798,2
2020-08-13-170307,170307,0,0,8,143,1.0,0.06235388,3
2020-08-14-170307,170307,0,0,0,143,1.0,0.043437634,4
2020-08-15-170307,170307,0,0,0,143,0.2,0.081709616,5
2020-08-16-170307,170307,0,0,0,143,0.6,0.040311873,6
2020-08-17-170307,170307,1,0,1,144,1.8,0.14910752,0
2020-08-18-170307,170307,0,0,0,144,2.2,0.1293558,1
2020-08-19-170307,170307,0,0,2,144,2.4,0.16456199,2
2020-08-20-170307,170307,1,0,1,145,1.0,0.107783124,3
2020-08-21-170307,170307,1,0,1,146,2.2,0.19880825,4
2020-08-22-170307,170307,0,0,0,146,1.4,0.08686612,5
2020-08-23-170307,170307,0,0,1,146,2.0,0.051809803,6
2020-08-24-170307,170307,0,0,1,146,2.2,0.19978522,0
2020-08-25-170307,170307,0,0,1,146,3.6,0.2996251,1
2020-08-26-170307,170307,7,0,5,153,3.6,0.6562498,2
2020-08-27-170307,170307,8,0,0,161,3.6,0.5330274,3
2020-08-28-170307,170307,0,0,2,161,3.4,0.11424634,4
2020-08-29-170307,170307,0,0,0,161,4.2,0.10644285,5
2020-08-30-170307,170307,0,0,0,161,3.6,0.11433076,6
2020-08-31-170307,170307,1,0,0,162,2.8,0.26546237,0
2020-09-01-170307,170307,0,0,5,162,2.4,0.111802615,1
2020-09-02-170307,170307,2,0,3,164,2.6,0.17660432,2
2020-09-03-170307,170307,1,0,2,165,3.2,0.17464438,3
2020-09-04-170307,170307,1,0,0,166,3.2,0.23860213,4
2020-09-05-170307,170307,0,0,0,166,2.8,0.14568986,5
2020-09-06-170307,170307,1,0,3,167,2.4,0.079079464,6
2020-09-07-170307,170307,1,0,1,168,6.0,0.22955716,0
2020-09-08-170307,170307,1,0,1,169,5.6,0.26295215,1
2020-09-09-170307,170307,5,0,1,174,6.4,0.44779316,2
2020-09-10-170307,170307,0,0,8,174,5.4,0.22790112,3
2020-09-11-170307,170307,2,0,9,176,9.0,0.39499596,4
2020-09-12-170307,170307,0,0,0,176,1.8,0.055799026,5
2020-09-13-170307,170307,0,0,2,176,6.6,0.18306714,6
2020-09-14-170307,170307,0,0,1,176,8.0,0.42737746,0
2020-09-15-170307,170307,5,0,2,181,6.4,0.45885903,1
2020-09-16-170307,170307,3,0,0,184,8.4,0.29594016,2
2020-09-17-170307,170307,2,0,5,186,8.0,0.4091021,3
2020-09-18-170307,170307,0,0,1,186,8.6,0.29221696,4
2020-09-19-170307,170307,0,0,0,186,1.4,0.052955355,5
2020-09-20-170307,170307,3,1,0,189,1.8,0.122490935,6
2020-09-21-170307,170307,1,0,0,190,11.8,0.25563663,0
2020-09-22-170307,170307,1,0,4,191,8.2,0.27546987,1
2020-09-23-170307,170307,1,0,1,192,10.2,0.30168703,2
2020-09-24-170307,170307,8,0,5,200,9.6,0.59611464,3
2020-09-25-170307,170307,9,0,10,209,6.0,0.52582395,4
2020-09-26-170307,170307,0,0,5,209,2.6,0.08620481,5
2020-09-27-170307,170307,2,0,2,211,1.6,0.10572867,6
2020-09-28-170307,170307,1,0,1,212,12.0,0.3259837,0
2020-09-29-170307,170307,2,0,6,214,4.8,0.26080537,1
2020-09-30-170307,170307,0,0,4,214,8.2,0.20638053,2
2020-10-01-170307,170307,5,0,1,219,12.4,0.43906346,3
2020-10-02-170307,170307,1,0,9,220,12.8,0.33542812,4
2020-10-03-170307,170307,0,2,4,220,3.6,0.119977325,5
2020-10-04-170307,170307,0,0,2,220,4.8,0.20275824,6
2020-10-05-170307,170307,0,2,7,220,2.0,0.15480065,0
2020-10-06-170307,170307,4,0,7,224,11.8,0.44473034,1
2020-10-07-170307,170307,1,0,7,225,8.2,0.35498253,2
2020-10-08-170307,170307,5,1,15,230,7.4,0.55181944,3
2020-10-09-170307,170307,10,0,0,240,12.4,0.5646258,4
2020-10-10-170307,170307,5,0,12,245,2.2,0.36046532,5
2020-10-11-170307,170307,2,0,1,247,1.8,0.1614547,6
2020-10-12-170307,170307,1,0,11,248,2.4,0.15694813,0
2020-10-13-170307,170307,6,0,2,254,18.4,0.51536465,1
2020-10-14-170307,170307,4,0,7,258,11.2,0.54604584,2
2020-10-15-170307,170307,1,0,5,259,15.2,0.39975116,3
2020-10-16-170307,170307,9,0,12,268,9.8,0.6921511,4
2020-10-17-170307,170307,4,0,1,272,3.0,0.45201787,5
2020-10-18-170307,170307,2,0,8,274,2.6,0.18976729,6
2020-10-19-170307,170307,7,0,0,281,18.0,0.7671983,0
2020-10-20-170307,170307,7,0,16,288,11.2,0.60366267,1
2020-10-21-170307,170307,7,1,9,295,12.6,0.43395075,2
2020-10-22-170307,170307,15,0,19,310,21.2,1.2151482,3
2020-10-23-170307,170307,0,0,7,310,15.8,0.46724606,4
2020-10-24-170307,170307,12,0,1,322,2.4,0.3252247,5
2020-10-25-170307,170307,1,2,4,323,4.2,0.10649459,6
2020-10-26-170307,170307,11,0,21,334,12.8,0.6984809,0
2020-10-27-170307,170307,2,0,5,336,6.6,0.31751114,1
2020-10-28-170307,170307,7,1,8,343,18.2,0.62401813,2
2020-10-29-170307,170307,5,0,8,348,14.6,0.66434836,3
2020-10-30-170307,170307,12,1,12,360,12.0,1.0389315,4
2020-10-31-170307,170307,1,1,0,361,3.2,0.19399127,5
2020-11-01-170307,170307,8,1,0,369,4.2,0.37865254,6
2020-11-02-170307,170307,0,0,0,369,1.8,0.042465463,0
2020-11-03-170307,170307,16,0,0,385,19.2,0.96380454,1
2020-11-04-170307,170307,9,1,0,394,8.0,0.55127746,2
2020-11-05-170307,170307,19,0,0,413,12.8,0.9706026,3
2020-11-06-170307,170307,7,2,0,420,13.0,0.63688064,4
2020-11-07-170307,170307,1,0,0,421,2.8,0.15182479,5
2020-11-08-170307,170307,4,0,0,425,1.8,0.4089574,6
2020-11-09-170307,170307,21,0,0,446,17.8,1.1347475,0
2020-11-10-170307,170307,5,0,0,451,20.0,0.67784166,1
2020-11-11-170307,170307,8,0,0,459,12.8,0.66025096,2
2020-11-12-170307,170307,8,0,0,467,12.6,0.6068068,3
2020-11-13-170307,170307,12,0,0,479,13.4,1.3228291,4
2020-03-01-170308,170308,0,0,4,0,0.0,1.846706e-08,6
2020-03-02-170308,170308,0,0,27,0,0.0,0.0009462132,0
2020-03-03-170308,170308,0,3,28,0,0.0,1.9516083e-05,1
2020-03-04-170308,170308,0,0,29,0,0.0,0.00075568224,2
2020-03-05-170308,170308,0,0,27,0,0.0,0.0005384661,3
2020-03-06-170308,170308,0,0,33,0,0.0,0.00042311256,4
2020-03-07-170308,170308,0,0,24,0,0.0,0.009038124,5
2020-03-08-170308,170308,0,0,17,0,0.0,0.0023687822,6
2020-03-09-170308,170308,0,0,75,0,1.0,0.14818916,0
2020-03-10-170308,170308,0,0,53,0,0.0,0.008988961,1
2020-03-11-170308,170308,1,0,31,1,0.0,0.03869665,2
2020-03-12-170308,170308,1,0,29,2,1.0,0.17173669,3
2020-03-13-170308,170308,5,0,24,7,0.0,0.18161662,4
2020-03-14-170308,170308,3,0,6,10,0.0,0.24934812,5
2020-03-15-170308,170308,4,0,22,14,2.0,0.3218918,6
2020-03-16-170308,170308,27,0,62,41,8.0,1.6149709,0
2020-03-17-170308,170308,28,0,46,69,19.0,2.9111702,1
2020-03-18-170308,170308,29,5,11,98,23.0,3.4865668,2
2020-03-19-170308,170308,27,0,19,125,15.0,3.1229858,3
2020-03-20-170308,170308,33,1,15,158,13.0,2.7289557,4
2020-03-21-170308,170308,24,0,2,182,7.0,1.2033631,5
2020-03-22-170308,170308,17,0,4,199,4.0,0.91158295,6
2020-03-23-170308,170308,75,1,7,274,32.0,5.6520205,0
2020-03-24-170308,170308,53,0,13,327,29.0,4.352778,1
2020-03-25-170308,170308,31,0,10,358,19.0,3.6041155,2
2020-03-26-170308,170308,29,0,26,387,9.0,2.2891893,3
2020-03-27-170308,170308,24,0,74,411,11.0,2.5266168,4
2020-03-28-170308,170308,6,0,4,417,3.0,0.6391197,5
2020-03-29-170308,170308,22,0,4,439,5.0,0.66294503,6
2020-03-30-170308,170308,62,0,22,501,11.0,2.753788,0
2020-03-31-170308,170308,46,0,16,547,9.0,2.2658052,1
2020-04-01-170308,170308,11,0,10,558,8.0,1.5645993,2
2020-04-02-170308,170308,19,0,4,577,10.0,1.8867682,3
2020-04-03-170308,170308,15,0,20,592,5.0,1.3702625,4
2020-04-04-170308,170308,2,0,1,594,1.0,0.2996818,5
2020-04-05-170308,170308,4,0,5,598,2.0,0.27289432,6
2020-04-06-170308,170308,7,0,9,605,19.0,2.215957,0
2020-04-07-170308,170308,13,1,15,618,7.0,1.5706342,1
2020-04-08-170308,170308,10,2,1,628,8.0,2.413682,2
2020-04-09-170308,170308,26,0,2,654,2.0,0.79260826,3
2020-04-10-170308,170308,74,1,12,728,11.0,2.259762,4
2020-04-11-170308,170308,4,0,4,732,4.0,0.48352548,5
2020-04-12-170308,170308,4,0,1,736,25.0,1.6613294,6
2020-04-13-170308,170308,22,0,4,758,6.0,1.3941405,0
2020-04-14-170308,170308,16,0,5,774,12.0,1.5524547,1
2020-04-15-170308,170308,10,0,8,784,1.0,0.52746016,2
2020-04-16-170308,170308,4,0,8,788,4.0,0.7723184,3
2020-04-17-170308,170308,20,0,1,808,2.0,0.8949862,4
2020-04-18-170308,170308,1,0,2,809,0.0,0.027939714,5
2020-04-19-170308,170308,5,0,2,814,0.0,0.13131772,6
2020-04-20-170308,170308,9,0,3,823,2.0,1.0787833,0
2020-04-21-170308,170308,15,0,4,838,4.0,1.927553,1
2020-04-22-170308,170308,1,0,5,839,0.0,0.30840102,2
2020-04-23-170308,170308,2,0,11,841,0.0,0.044423815,3
2020-04-24-170308,170308,12,1,2,853,34.0,3.3519003,4
2020-04-25-170308,170308,4,0,0,857,1.0,0.2599972,5
2020-04-26-170308,170308,1,0,0,858,1.0,0.09355165,6
2020-04-27-170308,170308,4,0,11,862,4.0,0.74866027,0
2020-04-28-170308,170308,5,0,14,867,4.0,0.90501946,1
2020-04-29-170308,170308,8,0,14,875,0.0,0.22782584,2
2020-04-30-170308,170308,8,1,7,883,2.0,0.38997927,3
2020-05-01-170308,170308,1,0,2,884,0.0,0.04262383,4
2020-05-02-170308,170308,2,0,0,886,1.0,0.2515494,5
2020-05-03-170308,170308,2,0,4,888,0.0,0.14364116,6
2020-05-04-170308,170308,3,0,6,891,5.0,0.56375194,0
2020-05-05-170308,170308,4,0,7,895,9.0,1.323684,1
2020-05-06-170308,170308,5,0,10,900,4.0,0.64528483,2
2020-05-07-170308,170308,11,0,22,911,1.0,0.5627025,3
2020-05-08-170308,170308,2,0,6,913,1.0,0.73880595,4
2020-05-09-170308,170308,0,0,0,913,0.0,0.08487806,5
2020-05-10-170308,170308,0,0,1,913,0.0,0.04952502,6
2020-05-11-170308,170308,11,1,2,924,2.0,0.66661924,0
2020-05-12-170308,170308,14,0,9,938,4.0,0.863871,1
2020-05-13-170308,170308,14,1,10,952,6.0,1.084744,2
2020-05-14-170308,170308,7,0,8,959,4.0,0.6893458,3
2020-05-15-170308,170308,2,0,4,961,2.0,0.33688387,4
2020-05-16-170308,170308,0,0,0,961,1.0,0.091005914,5
2020-05-17-170308,170308,4,0,0,965,0.0,0.08180013,6
2020-05-18-170308,170308,6,0,7,971,2.0,0.6630302,0
2020-05-19-170308,170308,7,0,3,978,4.0,1.0531213,1
2020-05-20-170308,170308,10,1,3,988,1.0,0.6754786,2
2020-05-21-170308,170308,22,0,11,1010,3.0,0.9461737,3
2020-05-22-170308,170308,6,0,7,1016,2.0,0.52339095,4
2020-05-23-170308,170308,0,0,3,1016,0.0,0.03806548,5
2020-05-24-170308,170308,1,0,1,1017,0.0,0.02201973,6
2020-05-25-170308,170308,2,0,6,1019,2.0,0.2622591,0
2020-05-26-170308,170308,9,0,7,1028,0.0,0.60336566,1
2020-05-27-170308,170308,10,0,5,1038,1.0,0.5776326,2
2020-05-28-170308,170308,8,0,3,1046,3.0,1.0114304,3
2020-05-29-170308,170308,4,0,1,1050,4.0,0.77554595,4
2020-05-30-170308,170308,0,0,1,1050,0.0,0.045699127,5
2020-05-31-170308,170308,0,1,0,1050,0.0,0.00040635388,6
2020-06-01-170308,170308,7,0,0,1057,3.0,0.9296973,0
2020-06-02-170308,170308,3,0,3,1060,4.0,0.77111167,1
2020-06-03-170308,170308,3,0,4,1063,3.0,0.54862744,2
2020-06-04-170308,170308,11,0,0,1074,6.0,1.1980121,3
2020-06-05-170308,170308,7,0,4,1081,1.0,0.48922077,4
2020-06-06-170308,170308,3,0,0,1084,0.0,0.13798933,5
2020-06-07-170308,170308,1,0,1,1085,0.0,0.05787089,6
2020-06-08-170308,170308,6,0,4,1091,0.0,0.3060988,0
2020-06-09-170308,170308,7,0,2,1098,1.0,0.6171143,1
2020-06-10-170308,170308,5,0,2,1103,4.0,1.2378396,2
2020-06-11-170308,170308,3,0,2,1106,0.0,0.41687068,3
2020-06-12-170308,170308,1,0,0,1107,3.0,0.6356341,4
2020-06-13-170308,170308,1,0,1,1108,0.0,0.057508633,5
2020-06-14-170308,170308,0,1,0,1108,0.0,0.0015772108,6
2020-06-15-170308,170308,0,0,2,1108,3.0,0.55223066,0
2020-06-16-170308,170308,3,0,5,1111,0.0,0.22670913,1
2020-06-17-170308,170308,4,0,0,1115,1.0,0.34907663,2
2020-06-18-170308,170308,0,0,1,1115,1.0,0.16360995,3
2020-06-19-170308,170308,4,0,0,1119,0.0,0.13494584,4
2020-06-20-170308,170308,0,0,0,1119,0.0,0.0013428748,5
2020-06-21-170308,170308,1,0,0,1120,0.0,0.024625842,6
2020-06-22-170308,170308,4,0,1,1124,2.0,0.44454592,0
2020-06-23-170308,170308,2,0,0,1126,1.0,0.40910637,1
2020-06-24-170308,170308,2,1,0,1128,3.0,0.54363906,2
2020-06-25-170308,170308,2,0,1,1130,2.0,0.59344345,3
2020-06-26-170308,170308,0,0,1,1130,0.0,0.068599865,4
2020-06-27-170308,170308,1,0,0,1131,0.0,0.06600115,5
2020-06-28-170308,170308,0,0,0,1131,0.0,0.00014925264,6
2020-06-29-170308,170308,2,0,1,1133,2.0,0.35901326,0
2020-06-30-170308,170308,5,0,0,1138,1.0,0.46584165,1
2020-07-01-170308,170308,0,0,0,1138,0.0,0.0061961957,2
2020-07-02-170308,170308,1,0,0,1139,3.0,0.47012818,3
2020-07-03-170308,170308,0,0,0,1139,1.0,0.14442727,4
2020-07-04-170308,170308,0,0,0,1139,0.0,0.0013380216,5
2020-07-05-170308,170308,0,0,0,1139,0.0,0.0013001959,6
2020-07-06-170308,170308,1,0,0,1140,0.0,0.24294552,0
2020-07-07-170308,170308,0,0,0,1140,0.0,0.04433178,1
2020-07-08-170308,170308,0,0,0,1140,1.0,0.2265994,2
2020-07-09-170308,170308,1,0,1,1141,2.0,0.3248809,3
2020-07-10-170308,170308,1,0,0,1142,0.0,0.066331305,4
2020-07-11-170308,170308,0,0,0,1142,0.0,0.0010976314,5
2020-07-12-170308,170308,0,0,0,1142,0.0,0.03732401,6
2020-07-13-170308,170308,1,0,0,1143,1.0,0.26728743,0
2020-07-14-170308,170308,0,0,0,1143,0.0,0.062398978,1
2020-07-15-170308,170308,0,0,0,1143,0.0,0.006713323,2
2020-07-16-170308,170308,0,0,0,1143,0.0,0.14903215,3
2020-07-17-170308,170308,0,0,0,1143,0.0,0.016810246,4
2020-07-18-170308,170308,0,0,0,1143,1.0,0.19134106,5
2020-07-19-170308,170308,0,0,0,1143,0.0,0.04283824,6
2020-07-20-170308,170308,0,0,0,1143,0.0,0.090059236,0
2020-07-21-170308,170308,0,0,0,1143,0.0,0.047043785,1
2020-07-22-170308,170308,0,0,1,1143,0.0,0.08721719,2
2020-07-23-170308,170308,1,0,0,1144,1.0,0.2748627,3
2020-07-24-170308,170308,0,1,0,1144,1.0,0.36414766,4
2020-07-25-170308,170308,0,0,0,1144,0.0,0.0014669852,5
2020-07-26-170308,170308,0,0,1,1144,0.0,0.034873497,6
2020-07-27-170308,170308,0,0,3,1144,1.0,0.17867236,0
2020-07-28-170308,170308,0,1,1,1144,0.0,0.091196336,1
2020-07-29-170308,170308,0,0,0,1144,0.0,0.009249669,2
2020-07-30-170308,170308,0,0,0,1144,0.0,0.21960987,3
2020-07-31-170308,170308,0,0,2,1144,0.0,0.16059768,4
2020-08-01-170308,170308,0,0,1,1144,1.0,0.15264836,5
2020-08-02-170308,170308,0,0,0,1144,0.0,0.014592646,6
2020-08-03-170308,170308,0,0,0,1144,0.0,0.03314091,0
2020-08-04-170308,170308,0,0,1,1144,0.0,0.17948546,1
2020-08-05-170308,170308,1,0,1,1145,1.0,0.32929546,2
2020-08-06-170308,170308,0,0,2,1145,9.0,1.4234824,3
2020-08-07-170308,170308,0,0,0,1145,2.0,0.23500192,4
2020-08-08-170308,170308,0,0,0,1145,0.0,0.029363528,5
2020-08-09-170308,170308,1,0,0,1146,0.0,0.059611317,6
2020-08-10-170308,170308,3,0,0,1149,0.0,0.2305884,0
2020-08-11-170308,170308,1,0,1,1150,0.0,0.1357841,1
2020-08-12-170308,170308,0,0,10,1150,4.0,0.6003363,2
2020-08-13-170308,170308,0,0,14,1150,0.0,0.03837946,3
2020-08-14-170308,170308,2,0,17,1152,0.0,0.16633905,4
2020-08-15-170308,170308,1,0,0,1153,7.0,1.1040882,5
2020-08-16-170308,170308,0,0,3,1153,0.0,0.09669595,6
2020-08-17-170308,170308,0,0,3,1153,0.0,0.05697216,0
2020-08-18-170308,170308,1,0,0,1154,1.0,0.38315862,1
2020-08-19-170308,170308,1,0,2,1155,0.0,0.17956734,2
2020-08-20-170308,170308,2,0,6,1157,1.0,0.49581888,3
2020-08-21-170308,170308,0,1,1,1157,0.0,0.25758108,4
2020-08-22-170308,170308,0,0,1,1157,0.0,0.30665088,5
2020-08-23-170308,170308,0,0,1,1157,0.0,0.13829477,6
2020-08-24-170308,170308,0,0,2,1157,0.0,0.29694346,0
2020-08-25-170308,170308,1,1,1,1158,2.0,0.61677784,1
2020-08-26-170308,170308,10,1,7,1168,3.0,1.3637478,2
2020-08-27-170308,170308,14,0,2,1182,4.0,1.2164385,3
2020-08-28-170308,170308,17,1,2,1199,1.0,1.0606076,4
2020-08-29-170308,170308,0,0,2,1199,1.0,0.13782209,5
2020-08-30-170308,170308,3,0,0,1202,19.0,2.5140202,6
2020-08-31-170308,170308,3,0,10,1205,2.0,0.6836571,0
2020-09-01-170308,170308,0,1,7,1205,3.0,1.1422017,1
2020-09-02-170308,170308,2,0,4,1207,0.0,0.4968837,2
2020-09-03-170308,170308,6,3,3,1213,1.0,0.8134506,3
2020-09-04-170308,170308,1,0,8,1214,2.0,0.7083277,4
2020-09-05-170308,170308,1,0,1,1215,0.0,0.04636068,5
2020-09-06-170308,170308,1,0,2,1216,0.0,0.17134973,6
2020-09-07-170308,170308,2,0,1,1218,0.0,0.38788044,0
2020-09-08-170308,170308,1,1,10,1219,2.0,0.63184327,1
2020-09-09-170308,170308,7,0,0,1226,2.0,1.1484478,2
2020-09-10-170308,170308,2,0,3,1228,0.0,0.27191526,3
2020-09-11-170308,170308,2,0,3,1230,3.0,0.8944146,4
2020-09-12-170308,170308,2,0,1,1232,0.0,0.19101897,5
2020-09-13-170308,170308,0,0,0,1232,0.0,0.33319888,6
2020-09-14-170308,170308,10,0,1,1242,2.0,0.7512425,0
2020-09-15-170308,170308,7,0,2,1249,9.0,1.8782089,1
2020-09-16-170308,170308,4,0,3,1253,1.0,0.7300994,2
2020-09-17-170308,170308,3,0,1,1256,3.0,0.58691376,3
2020-09-18-170308,170308,8,0,3,1264,1.0,0.83349216,4
2020-09-19-170308,170308,1,0,4,1265,0.0,0.19001323,5
2020-09-20-170308,170308,2,0,0,1267,3.0,0.53438663,6
2020-09-21-170308,170308,1,2,1,1268,2.0,0.64528865,0
2020-09-22-170308,170308,10,0,9,1278,3.0,1.3288833,1
2020-09-23-170308,170308,0,0,0,1278,1.0,0.7289859,2
2020-09-24-170308,170308,3,0,3,1281,2.0,1.3684849,3
2020-09-25-170308,170308,3,1,0,1284,1.0,1.1522173,4
2020-09-26-170308,170308,1,0,4,1285,1.0,0.64737546,5
2020-09-27-170308,170308,0,0,7,1285,1.0,0.15253833,6
2020-09-28-170308,170308,1,0,1,1286,4.0,1.1233968,0
2020-09-29-170308,170308,2,0,1,1288,6.0,1.1945297,1
2020-09-30-170308,170308,3,1,1,1291,2.0,0.7708546,2
2020-10-01-170308,170308,1,0,4,1292,2.0,2.0320764,3
2020-10-02-170308,170308,3,0,5,1295,1.0,1.1865325,4
2020-10-03-170308,170308,4,0,4,1299,2.0,0.49878854,5
2020-10-04-170308,170308,0,1,0,1299,0.0,0.08071398,6
2020-10-05-170308,170308,1,0,4,1300,2.0,1.3688091,0
2020-10-06-170308,170308,9,1,0,1309,5.0,1.4100893,1
2020-10-07-170308,170308,0,2,1,1309,2.0,0.60744715,2
2020-10-08-170308,170308,3,0,5,1312,2.0,1.3508831,3
2020-10-09-170308,170308,0,3,2,1312,3.0,2.1044009,4
2020-10-10-170308,170308,4,0,2,1316,0.0,0.29313555,5
2020-10-11-170308,170308,7,0,4,1323,2.0,0.8869194,6
2020-10-12-170308,170308,1,0,3,1324,1.0,0.19722266,0
2020-10-13-170308,170308,1,0,1,1325,1.0,1.3690898,1
2020-10-14-170308,170308,1,0,3,1326,2.0,1.553475,2
2020-10-15-170308,170308,4,0,12,1330,3.0,1.7740549,3
2020-10-16-170308,170308,5,0,10,1335,1.0,1.9574039,4
2020-10-17-170308,170308,4,0,1,1339,3.0,0.9433754,5
2020-10-18-170308,170308,0,0,0,1339,0.0,0.30873504,6
2020-10-19-170308,170308,4,1,1,1343,0.0,1.3402153,0
2020-10-20-170308,170308,0,1,1,1343,1.0,1.2715595,1
2020-10-21-170308,170308,1,1,1,1344,3.0,1.1613617,2
2020-10-22-170308,170308,5,0,6,1349,4.0,1.8212798,3
2020-10-23-170308,170308,2,0,4,1351,2.0,1.519965,4
2020-10-24-170308,170308,2,1,2,1353,2.0,0.9054995,5
2020-10-25-170308,170308,4,0,0,1357,0.0,0.48128003,6
2020-10-26-170308,170308,3,0,1,1360,2.0,1.173192,0
2020-10-27-170308,170308,1,0,1,1361,1.0,1.3051045,1
2020-10-28-170308,170308,3,0,5,1364,3.0,1.3735,2
2020-10-29-170308,170308,12,1,1,1376,4.0,2.3829968,3
2020-10-30-170308,170308,10,0,5,1386,10.0,2.0425882,4
2020-10-31-170308,170308,1,0,0,1387,7.0,1.6542995,5
2020-11-01-170308,170308,0,0,0,1387,0.0,0.24598955,6
2020-11-02-170308,170308,1,0,0,1388,2.0,0.5476419,0
2020-11-03-170308,170308,1,1,0,1389,0.0,1.7492322,1
2020-11-04-170308,170308,1,0,0,1390,0.0,0.5778815,2
2020-11-05-170308,170308,6,0,0,1396,27.0,4.6088486,3
2020-11-06-170308,170308,4,1,0,1400,5.0,2.054002,4
2020-11-07-170308,170308,2,0,0,1402,1.0,0.71436894,5
2020-11-08-170308,170308,0,1,0,1402,1.0,0.26388177,6
2020-11-09-170308,170308,1,1,0,1403,5.0,1.5609293,0
2020-11-10-170308,170308,1,0,0,1404,3.0,1.335555,1
2020-11-11-170308,170308,5,0,0,1409,2.0,1.443091,2
2020-11-12-170308,170308,1,1,0,1410,5.0,1.4601909,3
2020-11-13-170308,170308,5,1,0,1415,2.0,1.8576254,4
2020-03-01-170309,170309,0,0,2,0,0.0,0.00016444884,6
2020-03-02-170309,170309,0,0,8,0,0.0,0.0009803408,0
2020-03-03-170309,170309,0,0,19,0,0.0,0.0001971716,1
2020-03-04-170309,170309,0,0,23,0,0.0,0.0025501964,2
2020-03-05-170309,170309,0,0,15,0,0.0,0.0006138547,3
2020-03-06-170309,170309,0,0,13,0,0.0,0.0005649509,4
2020-03-07-170309,170309,0,0,7,0,0.1,0.005091536,5
2020-03-08-170309,170309,0,1,4,0,0.0,0.005620525,6
2020-03-09-170309,170309,1,0,32,1,0.1,0.16655213,0
2020-03-10-170309,170309,0,0,29,1,0.0,0.013493629,1
2020-03-11-170309,170309,0,0,19,1,0.1,0.02863317,2
2020-03-12-170309,170309,1,0,9,2,0.1,0.17260613,3
2020-03-13-170309,170309,0,0,11,2,0.6,0.15943293,4
2020-03-14-170309,170309,0,0,3,2,0.9,0.28629568,5
2020-03-15-170309,170309,2,0,5,4,0.9,0.45215666,6
2020-03-16-170309,170309,8,0,11,12,4.3,1.8660272,0
2020-03-17-170309,170309,19,0,9,31,5.8,3.9761844,1
2020-03-18-170309,170309,23,0,8,54,6.9,4.7137003,2
2020-03-19-170309,170309,15,0,10,69,6.3,4.388452,3
2020-03-20-170309,170309,13,1,5,82,7.2,3.6951017,4
2020-03-21-170309,170309,7,0,1,89,4.1,1.4761767,5
2020-03-22-170309,170309,4,0,2,93,3.9,1.1609163,6
2020-03-23-170309,170309,32,0,19,125,13.6,7.229972,0
2020-03-24-170309,170309,29,0,7,154,9.8,5.807197,1
2020-03-25-170309,170309,19,0,8,173,8.5,5.438311,2
2020-03-26-170309,170309,9,0,2,182,6.3,3.2601728,3
2020-03-27-170309,170309,11,0,11,193,8.1,3.5599067,4
2020-03-28-170309,170309,3,0,4,196,2.3,0.983009,5
2020-03-29-170309,170309,5,1,25,201,3.1,0.9036218,6
2020-03-30-170309,170309,11,0,6,212,10.2,3.5928183,0
2020-03-31-170309,170309,9,0,12,221,8.2,3.1637745,1
2020-04-01-170309,170309,8,0,1,229,5.2,2.4411843,2
2020-04-02-170309,170309,10,0,4,239,4.9,2.6422124,3
2020-04-03-170309,170309,5,0,2,244,3.8,1.7200983,4
2020-04-04-170309,170309,1,0,0,245,1.1,0.37106526,5
2020-04-05-170309,170309,2,0,0,247,0.9,0.50179785,6
2020-04-06-170309,170309,19,0,2,266,3.0,2.8966722,0
2020-04-07-170309,170309,7,0,4,273,4.1,2.0635898,1
2020-04-08-170309,170309,8,0,0,281,7.0,3.03772,2
2020-04-09-170309,170309,2,0,0,283,5.7,1.0080606,3
2020-04-10-170309,170309,11,0,34,294,10.5,2.3352587,4
2020-04-11-170309,170309,4,0,1,298,1.2,0.7334099,5
2020-04-12-170309,170309,25,0,1,323,0.9,2.6565022,6
2020-04-13-170309,170309,6,0,4,329,3.8,1.83921,0
2020-04-14-170309,170309,12,0,4,341,3.8,2.106322,1
2020-04-15-170309,170309,1,0,0,342,1.9,0.68741333,2
2020-04-16-170309,170309,4,0,2,346,2.3,1.145765,3
2020-04-17-170309,170309,2,0,0,348,3.4,1.1164966,4
2020-04-18-170309,170309,0,0,1,348,0.5,0.049844027,5
2020-04-19-170309,170309,0,0,0,348,0.9,0.18875088,6
2020-04-20-170309,170309,2,0,5,350,3.5,1.2467837,0
2020-04-21-170309,170309,4,0,9,354,6.5,2.183049,1
2020-04-22-170309,170309,0,0,4,354,1.2,0.5387205,2
2020-04-23-170309,170309,0,0,1,354,0.4,0.04860041,3
2020-04-24-170309,170309,34,0,1,388,2.7,4.5709558,4
2020-04-25-170309,170309,1,0,0,389,1.3,0.4478217,5
2020-04-26-170309,170309,1,0,0,390,0.3,0.18081202,6
2020-04-27-170309,170309,4,0,2,394,2.0,1.1374702,0
2020-04-28-170309,170309,4,0,4,398,2.6,1.295729,1
2020-04-29-170309,170309,0,0,6,398,1.4,0.26648444,2
2020-04-30-170309,170309,2,0,4,400,1.6,0.49918687,3
2020-05-01-170309,170309,0,0,2,400,0.3,0.09106484,4
2020-05-02-170309,170309,1,0,1,401,0.6,0.34966683,5
2020-05-03-170309,170309,0,0,0,401,0.8,0.30772787,6
2020-05-04-170309,170309,5,0,2,406,1.4,0.88585895,0
2020-05-05-170309,170309,9,0,4,415,2.2,1.9797647,1
2020-05-06-170309,170309,4,0,1,419,2.0,0.9696764,2
2020-05-07-170309,170309,1,0,3,420,4.3,0.9990076,3
2020-05-08-170309,170309,1,0,2,421,1.9,0.98859626,4
2020-05-09-170309,170309,0,0,0,421,0.5,0.20217443,5
2020-05-10-170309,170309,0,2,0,421,0.5,0.13861625,6
2020-05-11-170309,170309,2,0,2,423,2.3,0.9067388,0
2020-05-12-170309,170309,4,0,0,427,2.0,1.023152,1
2020-05-13-170309,170309,6,0,1,433,3.2,1.3588428,2
2020-05-14-170309,170309,4,0,3,437,1.9,1.1557906,3
2020-05-15-170309,170309,2,0,4,439,1.2,0.4155481,4
2020-05-16-170309,170309,1,0,0,440,0.1,0.16310282,5
2020-05-17-170309,170309,0,0,0,440,0.5,0.07279618,6
2020-05-18-170309,170309,2,0,3,442,2.0,1.0244046,0
2020-05-19-170309,170309,4,0,4,446,2.3,1.4288018,1
2020-05-20-170309,170309,1,0,3,447,2.1,0.9359617,2
2020-05-21-170309,170309,3,0,6,450,2.8,0.97263104,3
2020-05-22-170309,170309,2,0,1,452,1.8,0.6358852,4
2020-05-23-170309,170309,0,0,0,452,0.1,0.087903135,5
2020-05-24-170309,170309,0,0,0,452,0.1,0.017804958,6
2020-05-25-170309,170309,2,0,0,454,0.5,0.34486073,0
2020-05-26-170309,170309,0,0,1,454,2.1,0.78829724,1
2020-05-27-170309,170309,1,1,4,455,1.4,0.775278,2
2020-05-28-170309,170309,3,0,0,458,2.0,1.3903835,3
2020-05-29-170309,170309,4,0,3,462,0.9,0.95424265,4
2020-05-30-170309,170309,0,0,0,462,0.2,0.12164187,5
2020-05-31-170309,170309,0,0,0,462,0.0,0.0009056227,6
2020-06-01-170309,170309,3,0,3,465,1.8,1.222989,0
2020-06-02-170309,170309,4,0,0,469,0.9,1.0640999,1
2020-06-03-170309,170309,3,1,1,472,0.6,0.72998154,2
2020-06-04-170309,170309,6,0,1,478,2.0,1.4418125,3
2020-06-05-170309,170309,1,0,0,479,1.4,0.5656726,4
2020-06-06-170309,170309,0,3,0,479,0.4,0.16517814,5
2020-06-07-170309,170309,0,1,0,479,0.3,0.09209923,6
2020-06-08-170309,170309,0,0,2,479,1.5,0.43823856,0
2020-06-09-170309,170309,1,0,1,480,1.5,0.7646928,1
2020-06-10-170309,170309,4,0,3,484,2.1,1.7551473,2
2020-06-11-170309,170309,0,0,2,484,1.7,0.6617898,3
2020-06-12-170309,170309,3,0,0,487,1.0,0.9189082,4
2020-06-13-170309,170309,0,0,0,487,0.2,0.05211633,5
2020-06-14-170309,170309,0,0,0,487,0.0,0.002060146,6
2020-06-15-170309,170309,3,0,2,490,0.8,0.81343204,0
2020-06-16-170309,170309,0,0,1,490,0.7,0.295967,1
2020-06-17-170309,170309,1,1,0,491,0.7,0.4383537,2
2020-06-18-170309,170309,1,0,3,492,0.2,0.20503661,3
2020-06-19-170309,170309,0,0,1,492,0.4,0.11771563,4
2020-06-20-170309,170309,0,0,0,492,0.0,0.003576295,5
2020-06-21-170309,170309,0,0,0,492,0.1,0.019212136,6
2020-06-22-170309,170309,2,0,0,494,0.5,0.47090563,0
2020-06-23-170309,170309,1,0,0,495,0.9,0.57648504,1
2020-06-24-170309,170309,3,0,1,498,0.7,0.69093853,2
2020-06-25-170309,170309,2,0,2,500,1.1,0.7989218,3
2020-06-26-170309,170309,0,1,0,500,0.4,0.14839803,4
2020-06-27-170309,170309,0,0,0,500,0.2,0.07272238,5
2020-06-28-170309,170309,0,0,0,500,0.0,7.217116e-05,6
2020-06-29-170309,170309,2,0,1,502,0.4,0.41151467,0
2020-06-30-170309,170309,1,0,0,503,1.0,0.5468321,1
2020-07-01-170309,170309,0,0,0,503,0.1,0.022061681,2
2020-07-02-170309,170309,3,0,0,506,0.2,0.5476917,3
2020-07-03-170309,170309,1,0,0,507,0.0,0.18128513,4
2020-07-04-170309,170309,0,0,1,507,0.0,0.0011699034,5
2020-07-05-170309,170309,0,0,0,507,0.0,0.002520034,6
2020-07-06-170309,170309,0,0,0,507,0.6,0.42123997,0
2020-07-07-170309,170309,0,0,0,507,0.1,0.052114382,1
2020-07-08-170309,170309,1,0,0,508,0.5,0.3525237,2
2020-07-09-170309,170309,2,0,1,510,0.3,0.43891016,3
2020-07-10-170309,170309,0,0,1,510,0.4,0.10291308,4
2020-07-11-170309,170309,0,0,0,510,0.1,0.0025999604,5
2020-07-12-170309,170309,0,0,0,510,0.1,0.03815319,6
2020-07-13-170309,170309,1,0,1,511,0.3,0.28095955,0
2020-07-14-170309,170309,0,0,0,511,0.1,0.112251535,1
2020-07-15-170309,170309,0,0,0,511,0.4,0.015117994,2
2020-07-16-170309,170309,0,0,0,511,0.1,0.17761034,3
2020-07-17-170309,170309,0,5,0,511,0.1,0.04063555,4
2020-07-18-170309,170309,1,0,1,512,0.1,0.21318255,5
2020-07-19-170309,170309,0,0,0,512,0.2,0.0593978,6
2020-07-20-170309,170309,0,0,0,512,0.2,0.12092803,0
2020-07-21-170309,170309,0,0,0,512,0.1,0.064459674,1
2020-07-22-170309,170309,0,0,1,512,0.2,0.10566532,2
2020-07-23-170309,170309,1,0,9,513,0.4,0.3280886,3
2020-07-24-170309,170309,1,0,2,514,0.5,0.49318242,4
2020-07-25-170309,170309,0,0,0,514,0.0,0.0027027815,5
2020-07-26-170309,170309,0,0,0,514,0.1,0.03976022,6
2020-07-27-170309,170309,1,0,0,515,0.1,0.20168088,0
2020-07-28-170309,170309,0,0,0,515,0.2,0.11838268,1
2020-07-29-170309,170309,0,0,4,515,0.2,0.035897482,2
2020-07-30-170309,170309,0,0,0,515,0.7,0.30589154,3
2020-07-31-170309,170309,0,1,0,515,0.7,0.27837768,4
2020-08-01-170309,170309,1,0,7,516,0.0,0.17666773,5
2020-08-02-170309,170309,0,0,0,516,0.2,0.063730635,6
2020-08-03-170309,170309,0,0,0,516,0.4,0.08459306,0
2020-08-04-170309,170309,0,0,1,516,0.4,0.28386006,1
2020-08-05-170309,170309,1,0,0,517,0.5,0.4614783,2
2020-08-06-170309,170309,9,0,1,526,0.4,1.8175557,3
2020-08-07-170309,170309,2,0,0,528,0.0,0.28421637,4
2020-08-08-170309,170309,0,0,0,528,0.1,0.08863666,5
2020-08-09-170309,170309,0,0,0,528,0.3,0.1590062,6
2020-08-10-170309,170309,0,0,0,528,0.7,0.44557548,0
2020-08-11-170309,170309,0,0,2,528,0.4,0.25986654,1
2020-08-12-170309,170309,4,0,3,532,0.3,0.8099144,2
2020-08-13-170309,170309,0,0,4,532,0.3,0.11715453,3
2020-08-14-170309,170309,0,0,1,532,0.4,0.24469377,4
2020-08-15-170309,170309,7,0,1,539,0.6,1.4113253,5
2020-08-16-170309,170309,0,0,19,539,0.5,0.14880514,6
2020-08-17-170309,170309,0,0,2,539,0.3,0.15601334,0
2020-08-18-170309,170309,1,0,3,540,0.8,0.57280755,1
2020-08-19-170309,170309,0,0,0,540,1.4,0.37766522,2
2020-08-20-170309,170309,1,0,1,541,1.7,0.7998294,3
2020-08-21-170309,170309,0,0,2,541,1.2,0.4219589,4
2020-08-22-170309,170309,0,0,0,541,0.5,0.43580702,5
2020-08-23-170309,170309,0,1,0,541,0.7,0.23757157,6
2020-08-24-170309,170309,0,1,0,541,0.8,0.54043984,0
2020-08-25-170309,170309,2,0,2,543,2.1,0.9505234,1
2020-08-26-170309,170309,3,0,2,546,2.5,1.8857962,2
2020-08-27-170309,170309,4,0,0,550,3.0,1.3611699,3
2020-08-28-170309,170309,1,0,3,551,3.0,1.1677549,4
2020-08-29-170309,170309,1,0,0,552,0.3,0.2764393,5
2020-08-30-170309,170309,19,0,0,571,0.8,3.3511527,6
2020-08-31-170309,170309,2,0,2,573,2.1,0.8848324,0
2020-09-01-170309,170309,3,1,9,576,1.1,1.5477204,1
2020-09-02-170309,170309,0,0,1,576,2.4,0.9057505,2
2020-09-03-170309,170309,1,0,3,577,2.6,1.0596068,3
2020-09-04-170309,170309,2,0,1,579,2.2,0.9677558,4
2020-09-05-170309,170309,0,1,0,579,0.7,0.084391005,5
2020-09-06-170309,170309,0,0,3,579,0.6,0.26640946,6
2020-09-07-170309,170309,0,0,2,579,1.1,0.47693792,0
2020-09-08-170309,170309,2,0,3,581,1.6,0.82377076,1
2020-09-09-170309,170309,2,0,1,583,4.1,1.622557,2
2020-09-10-170309,170309,0,0,2,583,1.8,0.55001473,3
2020-09-11-170309,170309,3,0,1,586,1.6,1.3750163,4
2020-09-12-170309,170309,0,0,1,586,0.8,0.30652794,5
2020-09-13-170309,170309,0,1,1,586,1.3,0.5643537,6
2020-09-14-170309,170309,2,0,4,588,1.8,0.91473347,0
2020-09-15-170309,170309,9,0,6,597,2.7,2.2394242,1
2020-09-16-170309,170309,1,0,2,598,2.8,1.0154952,2
2020-09-17-170309,170309,3,0,2,601,3.9,1.0456649,3
2020-09-18-170309,170309,1,1,1,602,3.0,1.0323818,4
2020-09-19-170309,170309,0,0,2,602,1.2,0.2909664,5
2020-09-20-170309,170309,3,0,0,605,0.9,0.7239361,6
2020-09-21-170309,170309,2,1,2,607,3.2,1.0231844,0
2020-09-22-170309,170309,3,1,5,610,4.9,1.7279687,1
2020-09-23-170309,170309,1,0,2,611,3.3,1.1924741,2
2020-09-24-170309,170309,2,0,2,613,8.6,2.9313006,3
2020-09-25-170309,170309,1,0,3,614,4.0,1.6163608,4
2020-09-26-170309,170309,1,0,0,615,1.4,1.0484483,5
2020-09-27-170309,170309,1,0,2,616,0.3,0.26757497,6
2020-09-28-170309,170309,4,0,1,620,2.4,1.5265185,0
2020-09-29-170309,170309,6,0,1,626,3.5,1.6761442,1
2020-09-30-170309,170309,2,0,2,628,3.2,1.5050827,2
2020-10-01-170309,170309,2,0,3,630,6.0,2.8869014,3
2020-10-02-170309,170309,1,0,1,631,4.8,1.7357423,4
2020-10-03-170309,170309,2,0,3,633,2.5,0.7831091,5
2020-10-04-170309,170309,0,1,0,633,0.2,0.16426705,6
2020-10-05-170309,170309,2,0,0,635,3.3,2.0606954,0
2020-10-06-170309,170309,5,0,1,640,2.9,1.7162783,1
2020-10-07-170309,170309,2,0,3,642,2.4,1.0901059,2
2020-10-08-170309,170309,2,0,4,644,2.8,1.9079491,3
2020-10-09-170309,170309,3,3,2,647,8.7,3.5323677,4
2020-10-10-170309,170309,0,0,2,647,1.0,0.39723015,5
2020-10-11-170309,170309,2,0,0,649,1.8,1.3185681,6
2020-10-12-170309,170309,1,0,2,650,0.6,0.31846642,0
2020-10-13-170309,170309,1,0,1,651,4.3,2.0514245,1
2020-10-14-170309,170309,2,0,3,653,6.0,2.424215,2
2020-10-15-170309,170309,3,0,4,656,8.0,3.432495,3
2020-10-16-170309,170309,1,0,10,657,6.6,3.0521617,4
2020-10-17-170309,170309,3,0,7,660,1.6,1.3508332,5
2020-10-18-170309,170309,0,0,0,660,1.6,0.7004577,6
2020-10-19-170309,170309,0,1,2,660,4.6,1.9603089,0
2020-10-20-170309,170309,1,0,0,661,4.7,2.0718806,1
2020-10-21-170309,170309,3,0,0,664,3.0,1.6566268,2
2020-10-22-170309,170309,4,0,27,668,4.7,2.6152298,3
2020-10-23-170309,170309,2,0,5,670,9.9,3.1442807,4
2020-10-24-170309,170309,2,0,1,672,2.0,1.2313408,5
2020-10-25-170309,170309,0,1,1,672,2.4,0.8318091,6
2020-10-26-170309,170309,2,0,5,674,4.3,1.8567448,0
2020-10-27-170309,170309,1,1,3,675,3.9,1.9637035,1
2020-10-28-170309,170309,3,1,2,678,5.3,2.0904944,2
2020-10-29-170309,170309,4,0,5,682,8.5,3.1070063,3
2020-10-30-170309,170309,10,1,2,692,7.6,3.2090523,4
2020-10-31-170309,170309,7,0,0,699,2.4,2.2212832,5
2020-11-01-170309,170309,0,1,0,699,2.9,0.60000473,6
2020-11-02-170309,170309,2,0,0,701,1.1,0.6736246,0
2020-11-03-170309,170309,0,0,0,701,5.3,2.7289119,1
2020-11-04-170309,170309,0,1,0,701,3.2,1.2979637,2
2020-11-05-170309,170309,27,0,0,728,6.6,5.2358565,3
2020-11-06-170309,170309,5,2,0,733,7.2,2.9916408,4
2020-11-07-170309,170309,1,1,0,734,3.8,1.131495,5
2020-11-08-170309,170309,1,1,0,735,1.2,0.4165761,6
2020-11-09-170309,170309,5,2,0,740,5.0,2.394792,0
2020-11-10-170309,170309,3,1,0,743,4.3,1.9695971,1
2020-11-11-170309,170309,2,5,0,745,7.7,2.3106277,2
2020-11-12-170309,170309,5,2,0,750,6.8,2.0859675,3
2020-11-13-170309,170309,2,2,0,752,9.7,2.7340937,4
2020-03-01-170310,170310,0,0,0,0,0.0,9.766738e-09,6
2020-03-02-170310,170310,0,0,0,0,0.0,5.430319e-07,0
2020-03-03-170310,170310,0,0,0,0,0.0,1.1060932e-08,1
2020-03-04-170310,170310,0,0,0,0,0.0,0.00060372433,2
2020-03-05-170310,170310,0,0,0,0,0.0,5.2062227e-08,3
2020-03-06-170310,170310,0,0,0,0,0.14285714285714285,0.0013107795,4
2020-03-07-170310,170310,0,0,1,0,0.14285714285714285,0.002075661,5
2020-03-08-170310,170310,0,0,0,0,0.0,0.0006413986,6
2020-03-09-170310,170310,0,0,0,0,0.2857142857142857,0.003498313,0
2020-03-10-170310,170310,0,0,0,0,0.14285714285714285,0.0032406352,1
2020-03-11-170310,170310,0,0,3,0,0.0,0.0005024547,2
2020-03-12-170310,170310,0,0,0,0,0.2857142857142857,0.010546256,3
2020-03-13-170310,170310,0,0,0,0,0.14285714285714285,0.009532766,4
2020-03-14-170310,170310,0,0,0,0,0.2857142857142857,0.020461777,5
2020-03-15-170310,170310,0,0,0,0,0.5714285714285714,0.03239804,6
2020-03-16-170310,170310,0,0,0,0,2.0,0.09240042,0
2020-03-17-170310,170310,0,0,0,0,5.285714285714286,0.25622627,1
2020-03-18-170310,170310,0,0,0,0,5.0,0.24400349,2
2020-03-19-170310,170310,0,0,1,0,4.571428571428571,0.26245254,3
2020-03-20-170310,170310,0,0,0,0,4.428571428571429,0.17932971,4
2020-03-21-170310,170310,1,0,0,1,1.8571428571428568,0.062181037,5
2020-03-22-170310,170310,0,0,0,1,1.2857142857142858,0.050591514,6
2020-03-23-170310,170310,0,0,0,1,8.428571428571429,0.29092097,0
2020-03-24-170310,170310,0,0,0,1,7.7142857142857135,0.25317088,1
2020-03-25-170310,170310,3,0,0,4,7.571428571428571,0.31255683,2
2020-03-26-170310,170310,0,0,0,4,5.285714285714286,0.19972415,3
2020-03-27-170310,170310,0,0,0,4,5.285714285714286,0.17435597,4
2020-03-28-170310,170310,0,0,0,4,2.0,0.06813082,5
2020-03-29-170310,170310,0,0,0,4,2.571428571428572,0.06341396,6
2020-03-30-170310,170310,0,0,2,4,4.0,0.15371172,0
2020-03-31-170310,170310,0,0,0,4,4.142857142857143,0.14289923,1
2020-04-01-170310,170310,0,0,0,4,4.0,0.10165141,2
2020-04-02-170310,170310,1,0,0,5,3.8571428571428568,0.1269069,3
2020-04-03-170310,170310,0,0,0,5,2.8571428571428568,0.137188,4
2020-04-04-170310,170310,0,0,0,5,1.5714285714285714,0.054302156,5
2020-04-05-170310,170310,0,0,0,5,0.5714285714285714,0.016240481,6
2020-04-06-170310,170310,0,0,0,5,4.285714285714286,0.12646198,0
2020-04-07-170310,170310,0,0,0,5,3.4285714285714284,0.13195728,1
2020-04-08-170310,170310,0,0,0,5,2.8571428571428568,0.089249134,2
2020-04-09-170310,170310,0,1,0,5,2.8571428571428568,0.061207797,3
2020-04-10-170310,170310,0,0,0,5,2.0,0.06853141,4
2020-04-11-170310,170310,0,0,0,5,1.0,0.039101027,5
2020-04-12-170310,170310,0,0,0,5,3.7142857142857135,0.025982715,6
2020-04-13-170310,170310,2,0,0,7,1.8571428571428568,0.106544085,0
2020-04-14-170310,170310,0,0,0,7,3.7142857142857135,0.09377621,1
2020-04-15-170310,170310,0,0,0,7,1.2857142857142858,0.042713284,2
2020-04-16-170310,170310,0,0,0,7,1.4285714285714286,0.04527359,3
2020-04-17-170310,170310,0,0,0,7,2.0,0.05760021,4
2020-04-18-170310,170310,0,0,0,7,0.14285714285714285,0.012977063,5
2020-04-19-170310,170310,0,0,0,7,0.42857142857142855,0.022792086,6
2020-04-20-170310,170310,0,0,0,7,1.7142857142857142,0.06910203,0
2020-04-21-170310,170310,0,0,0,7,1.2857142857142858,0.057406012,1
2020-04-22-170310,170310,0,0,0,7,1.8571428571428568,0.09642719,2
2020-04-23-170310,170310,0,0,0,7,0.5714285714285714,0.019446677,3
2020-04-24-170310,170310,0,0,0,7,6.2857142857142865,0.09367794,4
2020-04-25-170310,170310,0,0,0,7,0.5714285714285714,0.025759796,5
2020-04-26-170310,170310,0,0,2,7,0.42857142857142855,0.006330497,6
2020-04-27-170310,170310,0,0,0,7,1.5714285714285714,0.061846666,0
2020-04-28-170310,170310,0,0,0,7,2.142857142857143,0.07814297,1
2020-04-29-170310,170310,0,0,0,7,2.0,0.044544064,2
2020-04-30-170310,170310,0,0,0,7,1.4285714285714286,0.049079172,3
2020-05-01-170310,170310,0,0,0,7,0.2857142857142857,0.008631864,4
2020-05-02-170310,170310,0,0,0,7,0.2857142857142857,0.011492142,5
2020-05-03-170310,170310,0,0,0,7,0.14285714285714285,0.012036308,6
2020-05-04-170310,170310,0,0,0,7,2.0,0.063542016,0
2020-05-05-170310,170310,0,0,0,7,1.8571428571428568,0.065721385,1
2020-05-06-170310,170310,0,0,0,7,1.4285714285714286,0.03278126,2
2020-05-07-170310,170310,0,0,0,7,0.2857142857142857,0.022159053,3
2020-05-08-170310,170310,0,0,0,7,1.2857142857142858,0.06439093,4
2020-05-09-170310,170310,0,0,0,7,0.5714285714285714,0.026208008,5
2020-05-10-170310,170310,2,0,0,9,0.2857142857142857,0.023456315,6
2020-05-11-170310,170310,0,0,1,9,1.5714285714285714,0.06911617,0
2020-05-12-170310,170310,0,0,0,9,1.7142857142857142,0.055970427,1
2020-05-13-170310,170310,0,0,0,9,1.2857142857142858,0.026874289,2
2020-05-14-170310,170310,0,1,0,9,1.2857142857142858,0.027865551,3
2020-05-15-170310,170310,0,0,0,9,2.0,0.043502882,4
2020-05-16-170310,170310,0,2,0,9,0.14285714285714285,0.0022184602,5
2020-05-17-170310,170310,0,0,0,9,0.0,0.00436476,6
2020-05-18-170310,170310,0,0,0,9,0.8571428571428571,0.049078744,0
2020-05-19-170310,170310,0,0,0,9,1.1428571428571428,0.03003292,1
2020-05-20-170310,170310,0,0,0,9,0.42857142857142855,0.030186664,2
2020-05-21-170310,170310,0,0,0,9,0.8571428571428571,0.03239732,3
2020-05-22-170310,170310,0,0,0,9,0.2857142857142857,0.060725234,4
2020-05-23-170310,170310,0,0,0,9,0.2857142857142857,0.0043406817,5
2020-05-24-170310,170310,0,0,0,9,0.0,0.00049952115,6
2020-05-25-170310,170310,1,0,0,10,0.5714285714285714,0.079889655,0
2020-05-26-170310,170310,0,0,0,10,0.8571428571428571,0.056854486,1
2020-05-27-170310,170310,0,0,0,10,0.8571428571428571,0.054299857,2
2020-05-28-170310,170310,0,4,0,10,1.8571428571428568,0.0727659,3
2020-05-29-170310,170310,0,0,0,10,1.2857142857142858,0.054454766,4
2020-05-30-170310,170310,0,0,0,10,0.0,0.015584076,5
2020-05-31-170310,170310,0,0,0,10,0.14285714285714285,0.00027800378,6
2020-06-01-170310,170310,0,0,0,10,1.5714285714285714,0.106903404,0
2020-06-02-170310,170310,0,0,1,10,1.2857142857142858,0.034016393,1
2020-06-03-170310,170310,0,0,0,10,0.5714285714285714,0.02674757,2
2020-06-04-170310,170310,0,0,0,10,1.0,0.029921707,3
2020-06-05-170310,170310,0,0,0,10,0.7142857142857143,0.051170465,4
2020-06-06-170310,170310,0,0,0,10,0.0,0.004805246,5
2020-06-07-170310,170310,0,2,0,10,0.14285714285714285,0.00711205,6
2020-06-08-170310,170310,0,0,0,10,0.14285714285714285,0.010396279,0
2020-06-09-170310,170310,0,0,0,10,1.1428571428571428,0.028956844,1
2020-06-10-170310,170310,0,0,0,10,1.1428571428571428,0.052333545,2
2020-06-11-170310,170310,0,0,0,10,0.42857142857142855,0.0248692,3
2020-06-12-170310,170310,0,0,0,10,0.7142857142857143,0.042061463,4
2020-06-13-170310,170310,0,0,0,10,0.0,0.001961258,5
2020-06-14-170310,170310,0,0,0,10,0.0,0.0010361162,6
2020-06-15-170310,170310,0,0,0,10,0.5714285714285714,0.026465848,0
2020-06-16-170310,170310,1,0,0,11,0.42857142857142855,0.033959378,1
2020-06-17-170310,170310,0,0,0,11,0.5714285714285714,0.028201247,2
2020-06-18-170310,170310,0,0,0,11,0.2857142857142857,0.009398578,3
2020-06-19-170310,170310,0,1,0,11,0.0,0.006368872,4
2020-06-20-170310,170310,0,0,0,11,0.14285714285714285,0.0066690575,5
2020-06-21-170310,170310,0,0,0,11,0.0,0.001518797,6
2020-06-22-170310,170310,0,0,0,11,0.42857142857142855,0.01762656,0
2020-06-23-170310,170310,0,0,0,11,0.14285714285714285,0.016632115,1
2020-06-24-170310,170310,0,0,0,11,0.5714285714285714,0.030321013,2
2020-06-25-170310,170310,0,0,0,11,0.2857142857142857,0.021952262,3
2020-06-26-170310,170310,0,0,0,11,0.14285714285714285,0.006439318,4
2020-06-27-170310,170310,0,0,0,11,0.0,0.0023544307,5
2020-06-28-170310,170310,0,0,0,11,0.0,8.935696e-07,6
2020-06-29-170310,170310,0,0,0,11,0.2857142857142857,0.021447306,0
2020-06-30-170310,170310,0,0,0,11,0.2857142857142857,0.014583442,1
2020-07-01-170310,170310,0,0,0,11,0.5714285714285714,0.039417684,2
2020-07-02-170310,170310,0,0,0,11,0.5714285714285714,0.018455224,3
2020-07-03-170310,170310,0,0,0,11,0.14285714285714285,0.0066321446,4
2020-07-04-170310,170310,0,0,0,11,0.0,0.0022632717,5
2020-07-05-170310,170310,0,0,0,11,0.14285714285714285,0.001734197,6
2020-07-06-170310,170310,0,0,0,11,0.0,0.007246314,0
2020-07-07-170310,170310,0,0,0,11,0.14285714285714285,0.020434357,1
2020-07-08-170310,170310,0,0,0,11,0.5714285714285714,0.025828756,2
2020-07-09-170310,170310,0,0,0,11,0.42857142857142855,0.020042185,3
2020-07-10-170310,170310,0,0,0,11,0.0,0.027601177,4
2020-07-11-170310,170310,0,0,0,11,0.0,0.00024522678,5
2020-07-12-170310,170310,0,0,0,11,0.0,0.0005085955,6
2020-07-13-170310,170310,0,0,0,11,0.42857142857142855,0.02763015,0
2020-07-14-170310,170310,0,0,0,11,0.0,0.02027923,1
2020-07-15-170310,170310,0,0,0,11,0.0,0.00921773,2
2020-07-16-170310,170310,0,0,0,11,0.14285714285714285,0.033916034,3
2020-07-17-170310,170310,0,0,0,11,0.0,0.004231825,4
2020-07-18-170310,170310,0,0,0,11,0.14285714285714285,0.023656772,5
2020-07-19-170310,170310,0,0,0,11,0.0,0.057289857,6
2020-07-20-170310,170310,0,0,0,11,0.0,0.02609414,0
2020-07-21-170310,170310,0,0,0,11,0.0,0.047495447,1
2020-07-22-170310,170310,0,0,0,11,0.5714285714285714,0.0216332,2
2020-07-23-170310,170310,0,0,0,11,0.14285714285714285,0.04421124,3
2020-07-24-170310,170310,0,0,0,11,0.14285714285714285,0.01227205,4
2020-07-25-170310,170310,0,0,0,11,0.0,0.003984646,5
2020-07-26-170310,170310,0,0,0,11,0.0,0.002159672,6
2020-07-27-170310,170310,0,0,0,11,0.14285714285714285,0.009089702,0
2020-07-28-170310,170310,0,0,0,11,0.0,0.02894847,1
2020-07-29-170310,170310,0,0,0,11,0.0,0.010928155,2
2020-07-30-170310,170310,0,0,0,11,0.2857142857142857,0.015614825,3
2020-07-31-170310,170310,0,0,0,11,0.42857142857142855,0.011195244,4
2020-08-01-170310,170310,0,0,0,11,0.14285714285714285,0.006269798,5
2020-08-02-170310,170310,0,0,0,11,0.14285714285714285,0.004085118,6
2020-08-03-170310,170310,0,0,0,11,0.2857142857142857,0.030475715,0
2020-08-04-170310,170310,0,0,0,11,0.14285714285714285,0.050898008,1
2020-08-05-170310,170310,0,0,0,11,0.42857142857142855,0.058461245,2
2020-08-06-170310,170310,0,0,0,11,1.5714285714285714,0.076185554,3
2020-08-07-170310,170310,0,0,0,11,0.5714285714285714,0.07868775,4
2020-08-08-170310,170310,0,1,0,11,0.2857142857142857,0.007803475,5
2020-08-09-170310,170310,0,0,0,11,0.8571428571428571,0.038453456,6
2020-08-10-170310,170310,0,0,0,11,0.2857142857142857,0.06243461,0
2020-08-11-170310,170310,0,0,0,11,0.5714285714285714,0.038705207,1
2020-08-12-170310,170310,0,0,0,11,0.8571428571428571,0.056680325,2
2020-08-13-170310,170310,0,0,1,11,0.2857142857142857,0.017574782,3
2020-08-14-170310,170310,0,0,0,11,0.14285714285714285,0.050042216,4
2020-08-15-170310,170310,0,0,0,11,1.0,0.08343725,5
2020-08-16-170310,170310,0,0,0,11,0.8571428571428571,0.013261723,6
2020-08-17-170310,170310,0,0,0,11,0.2857142857142857,0.014977683,0
2020-08-18-170310,170310,0,0,0,11,0.7142857142857143,0.06261633,1
2020-08-19-170310,170310,0,0,0,11,0.42857142857142855,0.031863764,2
2020-08-20-170310,170310,0,0,2,11,0.8571428571428571,0.03321267,3
2020-08-21-170310,170310,0,0,0,11,0.2857142857142857,0.055578962,4
2020-08-22-170310,170310,0,0,0,11,0.8571428571428571,0.05333864,5
2020-08-23-170310,170310,0,0,0,11,0.2857142857142857,0.0069319885,6
2020-08-24-170310,170310,0,0,0,11,0.42857142857142855,0.034883186,0
2020-08-25-170310,170310,0,0,1,11,0.5714285714285714,0.047377918,1
2020-08-26-170310,170310,0,0,0,11,1.8571428571428568,0.26812264,2
2020-08-27-170310,170310,1,0,0,12,1.0,0.11487921,3
2020-08-28-170310,170310,0,0,0,12,1.2857142857142858,0.12888353,4
2020-08-29-170310,170310,0,0,0,12,0.5714285714285714,0.04449648,5
2020-08-30-170310,170310,0,0,0,12,3.0,0.098839894,6
2020-08-31-170310,170310,0,0,0,12,1.1428571428571428,0.023487894,0
2020-09-01-170310,170310,0,0,0,12,1.2857142857142858,0.115208425,1
2020-09-02-170310,170310,0,0,0,12,0.42857142857142855,0.024002692,2
2020-09-03-170310,170310,2,0,0,14,8.285714285714286,0.18268698,3
2020-09-04-170310,170310,0,0,0,14,2.8571428571428568,0.10851538,4
2020-09-05-170310,170310,0,0,0,14,0.7142857142857143,0.025909197,5
2020-09-06-170310,170310,0,0,0,14,2.571428571428572,0.041239716,6
2020-09-07-170310,170310,0,0,0,14,2.2857142857142856,0.024506394,0
2020-09-08-170310,170310,1,0,0,15,2.142857142857143,0.106042646,1
2020-09-09-170310,170310,0,0,0,15,1.4285714285714286,0.08159112,2
2020-09-10-170310,170310,0,0,0,15,3.4285714285714284,0.04930724,3
2020-09-11-170310,170310,0,0,0,15,1.8571428571428568,0.10381682,4
2020-09-12-170310,170310,0,0,0,15,0.7142857142857143,0.048622534,5
2020-09-13-170310,170310,0,0,0,15,0.2857142857142857,0.023841,6
2020-09-14-170310,170310,0,0,0,15,1.0,0.037331283,0
2020-09-15-170310,170310,0,0,0,15,2.7142857142857144,0.17859958,1
2020-09-16-170310,170310,0,0,0,15,1.5714285714285714,0.043144245,2
2020-09-17-170310,170310,0,0,1,15,6.857142857142858,0.118024364,3
2020-09-18-170310,170310,0,0,0,15,2.2857142857142856,0.08894237,4
2020-09-19-170310,170310,0,0,0,15,0.7142857142857143,0.024823647,5
2020-09-20-170310,170310,0,0,0,15,1.1428571428571428,0.028216803,6
2020-09-21-170310,170310,0,1,0,15,3.1428571428571432,0.13099238,0
2020-09-22-170310,170310,0,0,0,15,3.1428571428571432,0.13334215,1
2020-09-23-170310,170310,0,0,0,15,1.8571428571428568,0.08598507,2
2020-09-24-170310,170310,0,0,0,15,1.8571428571428568,0.11867387,3
2020-09-25-170310,170310,0,0,0,15,1.7142857142857142,0.11840727,4
2020-09-26-170310,170310,0,0,0,15,0.2857142857142857,0.02167815,5
2020-09-27-170310,170310,0,0,0,15,0.5714285714285714,0.041809294,6
2020-09-28-170310,170310,0,0,0,15,1.1428571428571428,0.10830545,0
2020-09-29-170310,170310,0,0,1,15,2.142857142857143,0.09529192,1
2020-09-30-170310,170310,0,0,0,15,1.5714285714285714,0.12094454,2
2020-10-01-170310,170310,1,0,0,16,2.2857142857142856,0.14083047,3
2020-10-02-170310,170310,0,0,0,16,2.7142857142857144,0.1149162,4
2020-10-03-170310,170310,0,0,0,16,1.2857142857142858,0.051583372,5
2020-10-04-170310,170310,0,0,0,16,0.2857142857142857,0.027621541,6
2020-10-05-170310,170310,0,0,1,16,3.8571428571428568,0.108617105,0
2020-10-06-170310,170310,0,0,2,16,2.8571428571428568,0.08813004,1
2020-10-07-170310,170310,0,0,0,16,2.8571428571428568,0.10682278,2
2020-10-08-170310,170310,0,0,0,16,2.8571428571428568,0.09624982,3
2020-10-09-170310,170310,0,0,0,16,3.1428571428571432,0.17547078,4
2020-10-10-170310,170310,0,0,0,16,1.2857142857142858,0.22389372,5
2020-10-11-170310,170310,0,0,0,16,2.0,0.15631457,6
2020-10-12-170310,170310,0,0,0,16,0.8571428571428571,0.09603882,0
2020-10-13-170310,170310,1,0,0,17,2.142857142857143,0.12890832,1
2020-10-14-170310,170310,0,0,0,17,2.0,0.15614781,2
2020-10-15-170310,170310,0,0,0,17,1.7142857142857142,0.11416616,3
2020-10-16-170310,170310,0,0,0,17,2.7142857142857144,0.1690894,4
2020-10-17-170310,170310,0,0,0,17,1.7142857142857142,0.107870765,5
2020-10-18-170310,170310,0,0,0,17,1.8571428571428568,0.09228269,6
2020-10-19-170310,170310,1,0,0,18,2.142857142857143,0.111397594,0
2020-10-20-170310,170310,2,0,0,20,3.571428571428572,0.19936705,1
2020-10-21-170310,170310,0,0,0,20,3.8571428571428568,0.18064108,2
2020-10-22-170310,170310,0,0,0,20,4.428571428571429,0.20916739,3
2020-10-23-170310,170310,0,0,0,20,7.571428571428571,0.19643539,4
2020-10-24-170310,170310,0,0,0,20,3.0,0.09718546,5
2020-10-25-170310,170310,0,0,0,20,1.2857142857142858,0.043511357,6
2020-10-26-170310,170310,0,0,0,20,4.428571428571429,0.14445154,0
2020-10-27-170310,170310,0,0,0,20,7.428571428571429,0.2260583,1
2020-10-28-170310,170310,0,0,0,20,3.4285714285714284,0.17446819,2
2020-10-29-170310,170310,0,0,0,20,5.428571428571429,0.2743535,3
2020-10-30-170310,170310,0,0,0,20,9.428571428571429,0.31699246,4
2020-10-31-170310,170310,0,0,0,20,3.8571428571428568,0.3762181,5
2020-11-01-170310,170310,0,0,0,20,3.1428571428571432,0.10762513,6
2020-11-02-170310,170310,0,0,0,20,3.571428571428572,0.10602852,0
2020-11-03-170310,170310,0,0,0,20,3.2857142857142856,0.31607154,1
2020-11-04-170310,170310,0,0,0,20,4.142857142857143,0.25190488,2
2020-11-05-170310,170310,0,0,0,20,7.428571428571429,0.3579756,3
2020-11-06-170310,170310,0,0,0,20,6.428571428571429,0.24777713,4
2020-11-07-170310,170310,0,0,0,20,1.8571428571428568,0.126704,5
2020-11-08-170310,170310,0,0,0,20,1.4285714285714286,0.07885499,6
2020-11-09-170310,170310,0,0,0,20,3.8571428571428568,0.33225104,0
2020-11-10-170310,170310,0,0,0,20,2.4285714285714284,0.18766414,1
2020-11-11-170310,170310,0,0,0,20,4.0,0.38953248,2
2020-11-12-170310,170310,0,0,0,20,2.4285714285714284,0.22021163,3
2020-11-13-170310,170310,0,0,0,20,3.0,0.19070548,4
2020-03-01-170311,170311,0,0,0,0,0.0,1.9702973e-07,6
2020-03-02-170311,170311,0,0,2,0,0.0,0.0001079227,0
2020-03-03-170311,170311,0,0,2,0,0.0,9.9085934e-11,1
2020-03-04-170311,170311,0,0,0,0,0.0,0.00053007674,2
2020-03-05-170311,170311,0,0,3,0,0.0,0.00013292285,3
2020-03-06-170311,170311,0,0,1,0,0.0,0.0005156733,4
2020-03-07-170311,170311,0,0,1,0,0.0,0.0002288175,5
2020-03-08-170311,170311,0,0,3,0,0.0,0.00032725112,6
2020-03-09-170311,170311,0,0,0,0,0.0,0.0036551817,0
2020-03-10-170311,170311,0,0,3,0,0.0,0.0014311068,1
2020-03-11-170311,170311,0,0,0,0,0.0,0.0007559712,2
2020-03-12-170311,170311,0,0,4,0,0.0,0.0056964355,3
2020-03-13-170311,170311,1,0,1,1,0.0,0.11093283,4
2020-03-14-170311,170311,1,0,1,2,0.75,0.23323864,5
2020-03-15-170311,170311,0,0,2,2,1.125,0.058919203,6
2020-03-16-170311,170311,2,0,2,4,4.25,0.34319606,0
2020-03-17-170311,170311,2,0,1,6,6.125,0.6968292,1
2020-03-18-170311,170311,0,0,1,6,6.0,0.34041205,2
2020-03-19-170311,170311,3,0,1,9,7.875,0.64917827,3
2020-03-20-170311,170311,1,0,0,10,5.125,0.44290143,4
2020-03-21-170311,170311,1,0,2,11,2.0,0.15633094,5
2020-03-22-170311,170311,3,0,0,14,4.125,0.3615025,6
2020-03-23-170311,170311,0,0,0,14,10.625,0.69459516,0
2020-03-24-170311,170311,3,0,0,17,8.0,0.74794406,1
2020-03-25-170311,170311,0,0,1,17,8.75,0.60921615,2
2020-03-26-170311,170311,4,0,8,21,7.0,0.745685,3
2020-03-27-170311,170311,1,0,0,22,8.625,0.552515,4
2020-03-28-170311,170311,1,0,1,23,2.875,0.2262337,5
2020-03-29-170311,170311,2,0,0,25,3.625,0.18798187,6
2020-03-30-170311,170311,2,0,1,27,8.125,0.5728357,0
2020-03-31-170311,170311,1,0,1,28,6.25,0.42199728,1
2020-04-01-170311,170311,1,0,0,29,5.125,0.44252616,2
2020-04-02-170311,170311,1,0,0,30,5.0,0.32474896,3
2020-04-03-170311,170311,0,0,2,30,4.125,0.2766719,4
2020-04-04-170311,170311,2,0,0,32,2.75,0.16531356,5
2020-04-05-170311,170311,0,0,0,32,1.0,0.017500091,6
2020-04-06-170311,170311,0,0,1,32,5.0,0.27546817,0
2020-04-07-170311,170311,0,0,0,32,4.625,0.319004,1
2020-04-08-170311,170311,1,1,2,33,8.25,0.77458453,2
2020-04-09-170311,170311,8,0,0,41,3.75,0.36331543,3
2020-04-10-170311,170311,0,0,3,41,2.75,0.13443473,4
2020-04-11-170311,170311,1,1,0,42,1.125,0.12731318,5
2020-04-12-170311,170311,0,0,0,42,1.125,0.067589976,6
2020-04-13-170311,170311,1,0,0,43,4.625,0.30276027,0
2020-04-14-170311,170311,1,0,0,44,3.75,0.13495632,1
2020-04-15-170311,170311,0,1,0,44,2.75,0.093197785,2
2020-04-16-170311,170311,0,0,0,44,3.25,0.1509093,3
2020-04-17-170311,170311,2,0,1,46,2.375,0.1682832,4
2020-04-18-170311,170311,0,0,0,46,0.625,0.0062832157,5
2020-04-19-170311,170311,0,0,1,46,0.5,0.014159785,6
2020-04-20-170311,170311,1,0,3,47,4.0,0.38788554,0
2020-04-21-170311,170311,0,1,0,47,6.875,0.46626377,1
2020-04-22-170311,170311,2,0,1,49,1.75,0.29777518,2
2020-04-23-170311,170311,0,0,0,49,0.625,0.010967615,3
2020-04-24-170311,170311,3,0,1,52,2.125,0.32806653,4
2020-04-25-170311,170311,0,0,0,52,1.375,0.024921034,5
2020-04-26-170311,170311,0,0,1,52,0.375,0.0037612948,6
2020-04-27-170311,170311,0,0,0,52,2.125,0.0895451,0
2020-04-28-170311,170311,0,0,0,52,2.375,0.16733655,1
2020-04-29-170311,170311,0,0,0,52,1.25,0.033227958,2
2020-04-30-170311,170311,0,0,1,52,0.875,0.024815306,3
2020-05-01-170311,170311,1,0,2,53,0.875,0.09671293,4
2020-05-02-170311,170311,0,0,0,53,1.0,0.03583384,5
2020-05-03-170311,170311,1,0,0,54,0.5,0.07942584,6
2020-05-04-170311,170311,3,0,0,57,1.625,0.3488601,0
2020-05-05-170311,170311,0,0,0,57,1.375,0.19357872,1
2020-05-06-170311,170311,1,0,0,58,1.625,0.19135837,2
2020-05-07-170311,170311,0,0,1,58,1.375,0.051929176,3
2020-05-08-170311,170311,1,0,0,59,2.125,0.2731543,4
2020-05-09-170311,170311,0,0,0,59,1.0,0.025830429,5
2020-05-10-170311,170311,1,0,0,60,0.25,0.0054458017,6
2020-05-11-170311,170311,0,0,0,60,1.25,0.058814403,0
2020-05-12-170311,170311,0,0,0,60,1.25,0.08998906,1
2020-05-13-170311,170311,0,0,0,60,0.875,0.07349671,2
2020-05-14-170311,170311,1,2,0,61,1.375,0.16022122,3
2020-05-15-170311,170311,2,0,0,63,1.625,0.23373847,4
2020-05-16-170311,170311,0,0,0,63,0.125,0.003350819,5
2020-05-17-170311,170311,0,1,0,63,0.375,0.0045270757,6
2020-05-18-170311,170311,0,0,0,63,2.125,0.073653,0
2020-05-19-170311,170311,0,0,0,63,1.75,0.14721215,1
2020-05-20-170311,170311,0,0,0,63,1.25,0.052905742,2
2020-05-21-170311,170311,1,0,2,64,0.625,0.14719392,3
2020-05-22-170311,170311,0,0,0,64,3.0,0.12435014,4
2020-05-23-170311,170311,0,0,0,64,0.0,0.0019365905,5
2020-05-24-170311,170311,0,0,0,64,0.125,0.0029411917,6
2020-05-25-170311,170311,0,0,0,64,1.125,0.09810527,0
2020-05-26-170311,170311,0,0,0,64,0.75,0.1138758,1
2020-05-27-170311,170311,0,0,0,64,2.0,0.13716792,2
2020-05-28-170311,170311,0,0,1,64,1.5,0.15991062,3
2020-05-29-170311,170311,0,0,0,64,1.625,0.13318664,4
2020-05-30-170311,170311,0,0,0,64,0.125,0.0049392795,5
2020-05-31-170311,170311,0,0,0,64,0.25,0.0015680967,6
2020-06-01-170311,170311,0,0,0,64,1.75,0.16013059,0
2020-06-02-170311,170311,0,0,1,64,1.625,0.052506693,1
2020-06-03-170311,170311,0,0,0,64,1.75,0.0619409,2
2020-06-04-170311,170311,2,0,0,66,0.875,0.25278917,3
2020-06-05-170311,170311,0,0,0,66,1.25,0.096648954,4
2020-06-06-170311,170311,0,0,0,66,0.0,0.0024567256,5
2020-06-07-170311,170311,0,0,0,66,0.25,0.008108936,6
2020-06-08-170311,170311,0,0,0,66,1.625,0.051250685,0
2020-06-09-170311,170311,0,0,0,66,1.75,0.113276236,1
2020-06-10-170311,170311,0,0,0,66,1.0,0.09613396,2
2020-06-11-170311,170311,1,0,0,67,1.375,0.16950272,3
2020-06-12-170311,170311,0,0,0,67,1.125,0.095128655,4
2020-06-13-170311,170311,0,0,0,67,0.125,0.020523326,5
2020-06-14-170311,170311,0,0,0,67,0.125,0.0023923016,6
2020-06-15-170311,170311,0,0,1,67,0.75,0.05406214,0
2020-06-16-170311,170311,1,0,0,68,1.125,0.14438798,1
2020-06-17-170311,170311,0,1,0,68,0.625,0.019991914,2
2020-06-18-170311,170311,0,0,0,68,0.125,0.025142273,3
2020-06-19-170311,170311,0,0,0,68,1.0,0.025755994,4
2020-06-20-170311,170311,0,0,0,68,0.125,0.0041354815,5
2020-06-21-170311,170311,0,0,0,68,0.125,0.0021643902,6
2020-06-22-170311,170311,0,0,0,68,0.375,0.01734366,0
2020-06-23-170311,170311,0,0,0,68,1.5,0.041677885,1
2020-06-24-170311,170311,0,0,0,68,0.375,0.020885842,2
2020-06-25-170311,170311,0,1,1,68,1.0,0.098316886,3
2020-06-26-170311,170311,0,0,0,68,0.25,0.015655797,4
2020-06-27-170311,170311,0,0,0,68,0.125,0.024653478,5
2020-06-28-170311,170311,0,0,0,68,0.125,0.00051610236,6
2020-06-29-170311,170311,1,0,1,69,0.625,0.16047159,0
2020-06-30-170311,170311,0,1,0,69,0.625,0.059608087,1
2020-07-01-170311,170311,0,0,1,69,0.125,0.0054430794,2
2020-07-02-170311,170311,0,0,0,69,0.25,0.031224683,3
2020-07-03-170311,170311,0,0,0,69,0.625,0.025182163,4
2020-07-04-170311,170311,0,0,1,69,0.125,0.005138159,5
2020-07-05-170311,170311,0,0,0,69,0.125,0.0025847969,6
2020-07-06-170311,170311,0,0,0,69,0.125,0.014761714,0
2020-07-07-170311,170311,0,0,0,69,0.5,0.036669273,1
2020-07-08-170311,170311,0,0,0,69,0.375,0.037073556,2
2020-07-09-170311,170311,1,0,0,70,0.25,0.17081165,3
2020-07-10-170311,170311,0,0,0,70,0.375,0.016038882,4
2020-07-11-170311,170311,0,0,0,70,0.0,0.0018854472,5
2020-07-12-170311,170311,0,0,0,70,0.125,0.026477134,6
2020-07-13-170311,170311,1,0,0,71,0.75,0.26613486,0
2020-07-14-170311,170311,0,0,0,71,0.375,0.017538821,1
2020-07-15-170311,170311,1,0,0,72,0.875,0.02092386,2
2020-07-16-170311,170311,0,0,0,72,0.5,0.029617002,3
2020-07-17-170311,170311,0,1,0,72,0.625,0.05157574,4
2020-07-18-170311,170311,1,0,0,73,0.25,0.2357054,5
2020-07-19-170311,170311,0,0,1,73,0.25,0.03253179,6
2020-07-20-170311,170311,0,0,0,73,1.5,0.11095869,0
2020-07-21-170311,170311,0,0,1,73,0.375,0.03553728,1
2020-07-22-170311,170311,0,0,0,73,1.125,0.096859425,2
2020-07-23-170311,170311,0,0,0,73,1.0,0.09543609,3
2020-07-24-170311,170311,0,0,1,73,1.0,0.074189395,4
2020-07-25-170311,170311,0,0,1,73,0.375,0.0129721,5
2020-07-26-170311,170311,0,0,0,73,0.125,0.031474844,6
2020-07-27-170311,170311,0,0,0,73,0.25,0.035497267,0
2020-07-28-170311,170311,0,0,0,73,1.125,0.07600306,1
2020-07-29-170311,170311,0,0,0,73,1.0,0.05851252,2
2020-07-30-170311,170311,0,0,1,73,1.5,0.19308087,3
2020-07-31-170311,170311,0,0,0,73,0.5,0.051144186,4
2020-08-01-170311,170311,0,0,1,73,0.25,0.08519745,5
2020-08-02-170311,170311,1,0,0,74,0.375,0.24044973,6
2020-08-03-170311,170311,0,0,0,74,0.875,0.063908,0
2020-08-04-170311,170311,1,0,4,75,1.125,0.27689737,1
2020-08-05-170311,170311,0,0,0,75,1.75,0.14340644,2
2020-08-06-170311,170311,0,0,1,75,0.75,0.09411459,3
2020-08-07-170311,170311,1,0,0,76,1.375,0.05195787,4
2020-08-08-170311,170311,1,0,0,77,0.125,0.3190753,5
2020-08-09-170311,170311,0,0,0,77,0.0,0.011601785,6
2020-08-10-170311,170311,0,0,1,77,1.125,0.10208278,0
2020-08-11-170311,170311,0,0,3,77,0.5,0.0285978,1
2020-08-12-170311,170311,0,0,1,77,1.125,0.042992182,2
2020-08-13-170311,170311,1,0,2,78,0.625,0.1712415,3
2020-08-14-170311,170311,0,0,0,78,0.25,0.083522074,4
2020-08-15-170311,170311,1,0,2,79,0.0,0.20958944,5
2020-08-16-170311,170311,0,0,5,79,0.875,0.15612964,6
2020-08-17-170311,170311,0,0,1,79,0.625,0.03363818,0
2020-08-18-170311,170311,4,0,2,83,1.25,0.64687955,1
2020-08-19-170311,170311,0,0,1,83,1.125,0.18301031,2
2020-08-20-170311,170311,1,0,0,84,1.875,0.26785874,3
2020-08-21-170311,170311,0,0,2,84,1.25,0.13921525,4
2020-08-22-170311,170311,0,0,2,84,0.75,0.04905727,5
2020-08-23-170311,170311,0,0,2,84,1.25,0.09777894,6
2020-08-24-170311,170311,1,0,2,85,1.375,0.23651327,0
2020-08-25-170311,170311,3,0,0,88,1.625,0.6350245,1
2020-08-26-170311,170311,1,0,1,89,3.25,0.84671766,2
2020-08-27-170311,170311,2,0,2,91,3.125,0.5664811,3
2020-08-28-170311,170311,0,0,0,91,2.125,0.3837762,4
2020-08-29-170311,170311,2,0,0,93,1.125,0.3656042,5
2020-08-30-170311,170311,5,0,4,98,1.25,0.57586235,6
2020-08-31-170311,170311,1,0,0,99,2.125,0.3292392,0
2020-09-01-170311,170311,2,0,1,101,1.5,0.40874824,1
2020-09-02-170311,170311,1,0,2,102,1.375,0.2879505,2
2020-09-03-170311,170311,0,0,1,102,3.0,0.5024266,3
2020-09-04-170311,170311,2,0,0,104,1.5,0.51719433,4
2020-09-05-170311,170311,2,0,0,106,1.25,0.032560285,5
2020-09-06-170311,170311,2,0,1,108,2.25,0.36917582,6
2020-09-07-170311,170311,2,0,1,110,1.625,0.64986795,0
2020-09-08-170311,170311,0,0,3,110,1.0,0.09597921,1
2020-09-09-170311,170311,1,0,2,111,3.5,0.3607494,2
2020-09-10-170311,170311,2,0,1,113,1.875,0.31473044,3
2020-09-11-170311,170311,0,0,0,113,3.0,0.5006381,4
2020-09-12-170311,170311,0,0,2,113,0.625,0.057200097,5
2020-09-13-170311,170311,4,0,1,117,2.375,0.7991363,6
2020-09-14-170311,170311,0,0,1,117,2.25,0.1495974,0
2020-09-15-170311,170311,1,0,0,118,4.25,0.42904702,1
2020-09-16-170311,170311,2,1,0,120,3.75,0.16558251,2
2020-09-17-170311,170311,1,0,1,121,3.5,0.48422915,3
2020-09-18-170311,170311,0,0,0,121,2.625,0.19728342,4
2020-09-19-170311,170311,0,0,0,121,1.75,0.07873458,5
2020-09-20-170311,170311,1,0,1,122,1.625,0.08663127,6
2020-09-21-170311,170311,1,0,0,123,3.875,0.36946794,0
2020-09-22-170311,170311,3,1,0,126,3.25,0.5001507,1
2020-09-23-170311,170311,2,0,0,128,4.875,0.4345421,2
2020-09-24-170311,170311,1,0,0,129,5.0,0.2792271,3
2020-09-25-170311,170311,0,0,0,129,6.75,0.41311565,4
2020-09-26-170311,170311,2,0,1,131,0.875,0.31053704,5
2020-09-27-170311,170311,1,0,1,132,2.625,0.10738263,6
2020-09-28-170311,170311,1,0,5,133,5.75,0.47648212,0
2020-09-29-170311,170311,0,0,0,133,3.625,0.23574893,1
2020-09-30-170311,170311,0,0,2,133,3.25,0.25292405,2
2020-10-01-170311,170311,1,0,0,134,9.875,0.8318646,3
2020-10-02-170311,170311,0,0,3,134,6.625,0.46313125,4
2020-10-03-170311,170311,0,1,1,134,2.75,0.1842119,5
2020-10-04-170311,170311,1,0,0,135,2.375,0.16626282,6
2020-10-05-170311,170311,0,0,3,135,2.375,0.2500666,0
2020-10-06-170311,170311,0,0,0,135,4.0,0.22486395,1
2020-10-07-170311,170311,0,0,0,135,2.375,0.123634756,2
2020-10-08-170311,170311,0,0,3,135,4.125,0.27943474,3
2020-10-09-170311,170311,0,0,1,135,6.875,0.5025741,4
2020-10-10-170311,170311,1,0,0,136,2.0,0.16298975,5
2020-10-11-170311,170311,1,0,0,137,1.125,0.22625688,6
2020-10-12-170311,170311,5,0,1,142,1.875,0.5506131,0
2020-10-13-170311,170311,0,0,3,142,9.125,0.51736933,1
2020-10-14-170311,170311,2,0,2,144,5.5,0.6852755,2
2020-10-15-170311,170311,0,0,5,144,5.875,0.48674697,3
2020-10-16-170311,170311,3,0,0,147,6.25,0.54880524,4
2020-10-17-170311,170311,1,0,0,148,3.5,0.25655827,5
2020-10-18-170311,170311,0,0,0,148,1.875,0.15327242,6
2020-10-19-170311,170311,3,0,0,151,8.375,0.8386909,0
2020-10-20-170311,170311,0,0,1,151,6.125,0.366472,1
2020-10-21-170311,170311,0,1,0,151,7.25,0.41327843,2
2020-10-22-170311,170311,3,0,2,154,5.625,0.62763757,3
2020-10-23-170311,170311,1,0,0,155,7.25,0.57493633,4
2020-10-24-170311,170311,0,0,7,155,3.5,0.23126982,5
2020-10-25-170311,170311,0,0,0,155,2.875,0.10673567,6
2020-10-26-170311,170311,1,0,1,156,6.0,0.6586812,0
2020-10-27-170311,170311,3,0,2,159,5.0,0.5117361,1
2020-10-28-170311,170311,2,0,2,161,8.625,0.75406533,2
2020-10-29-170311,170311,5,0,1,166,11.0,1.2510197,3
2020-10-30-170311,170311,0,0,0,166,8.625,0.5471564,4
2020-10-31-170311,170311,0,0,0,166,2.875,0.27148846,5
2020-11-01-170311,170311,0,0,0,166,5.25,0.14108576,6
2020-11-02-170311,170311,0,0,0,166,2.125,0.21582828,0
2020-11-03-170311,170311,1,0,0,167,12.375,0.9646863,1
2020-11-04-170311,170311,0,0,0,167,7.75,0.3397176,2
2020-11-05-170311,170311,2,0,0,169,9.125,0.938591,3
2020-11-06-170311,170311,0,0,0,169,8.375,0.64882135,4
2020-11-07-170311,170311,7,0,0,176,3.125,0.93099165,5
2020-11-08-170311,170311,0,0,0,176,2.75,0.09992927,6
2020-11-09-170311,170311,1,1,0,177,10.25,0.58596104,0
2020-11-10-170311,170311,2,0,0,179,7.375,0.55649287,1
2020-11-11-170311,170311,2,0,0,181,7.875,0.55428123,2
2020-11-12-170311,170311,1,0,0,182,5.875,0.43213537,3
2020-11-13-170311,170311,0,1,0,182,11.875,0.6737092,4
2020-03-01-170312,170312,0,0,0,0,0.1111111111111111,0.001001691,6
2020-03-02-170312,170312,0,0,5,0,0.0,0.0010122778,0
2020-03-03-170312,170312,0,0,17,0,0.0,5.306973e-06,1
2020-03-04-170312,170312,0,0,26,0,0.3333333333333333,0.0053201867,2
2020-03-05-170312,170312,0,1,25,0,0.0,0.0005727933,3
2020-03-06-170312,170312,0,0,23,0,0.0,0.0019561122,4
2020-03-07-170312,170312,0,0,4,0,0.0,0.006170731,5
2020-03-08-170312,170312,0,0,2,0,0.0,0.0028737623,6
2020-03-09-170312,170312,0,0,37,0,0.2222222222222222,0.045984197,0
2020-03-10-170312,170312,0,0,30,0,0.0,0.0034955773,1
2020-03-11-170312,170312,0,0,41,0,0.2222222222222222,0.007743833,2
2020-03-12-170312,170312,0,0,48,0,0.4444444444444444,0.055809274,3
2020-03-13-170312,170312,0,0,36,0,0.3333333333333333,0.057613455,4
2020-03-14-170312,170312,3,0,2,3,0.5555555555555556,0.31366554,5
2020-03-15-170312,170312,0,0,0,3,1.4444444444444444,0.18815255,6
2020-03-16-170312,170312,5,0,51,8,13.777777777777779,1.7527088,0
2020-03-17-170312,170312,17,0,23,25,12.666666666666664,2.51899,1
2020-03-18-170312,170312,26,0,24,51,15.444444444444445,3.0918698,2
2020-03-19-170312,170312,25,0,16,76,15.111111111111109,3.4758494,3
2020-03-20-170312,170312,23,0,24,99,14.222222222222221,2.8371983,4
2020-03-21-170312,170312,4,0,4,103,1.2222222222222223,0.47667962,5
2020-03-22-170312,170312,2,0,5,105,2.555555555555556,0.2921684,6
2020-03-23-170312,170312,37,0,21,142,22.0,4.564632,0
2020-03-24-170312,170312,30,0,21,172,14.666666666666664,3.296488,1
2020-03-25-170312,170312,41,0,14,213,13.111111111111109,4.2159443,2
2020-03-26-170312,170312,48,0,19,261,10.555555555555557,4.246139,3
2020-03-27-170312,170312,36,1,10,297,11.111111111111109,3.8557708,4
2020-03-28-170312,170312,2,0,2,299,1.5555555555555556,0.28887084,5
2020-03-29-170312,170312,0,0,2,299,0.5555555555555556,0.1483283,6
2020-03-30-170312,170312,51,0,19,350,15.222222222222221,4.2607565,0
2020-03-31-170312,170312,23,0,11,373,9.0,2.3154058,1
2020-04-01-170312,170312,24,0,10,397,7.111111111111112,2.4051368,2
2020-04-02-170312,170312,16,0,9,413,7.4444444444444455,1.6798834,3
2020-04-03-170312,170312,24,0,15,437,6.666666666666668,2.0076368,4
2020-04-04-170312,170312,4,0,1,441,0.4444444444444444,0.34661186,5
2020-04-05-170312,170312,5,0,4,446,0.5555555555555556,0.28933498,6
2020-04-06-170312,170312,21,0,15,467,12.111111111111109,2.300518,0
2020-04-07-170312,170312,21,0,6,488,8.0,2.0962834,1
2020-04-08-170312,170312,14,3,40,502,6.111111111111112,1.7723262,2
2020-04-09-170312,170312,19,0,0,521,5.222222222222221,1.6665366,3
2020-04-10-170312,170312,10,0,56,531,5.888888888888888,0.9842611,4
2020-04-11-170312,170312,2,0,0,533,0.5555555555555556,0.22398861,5
2020-04-12-170312,170312,2,0,2,535,1.4444444444444444,0.25610927,6
2020-04-13-170312,170312,19,0,13,554,7.888888888888888,2.973245,0
2020-04-14-170312,170312,11,0,6,565,7.222222222222222,2.025662,1
2020-04-15-170312,170312,10,0,11,575,6.777777777777778,1.806395,2
2020-04-16-170312,170312,9,1,12,584,7.5555555555555545,1.5890192,3
2020-04-17-170312,170312,15,0,0,599,5.111111111111111,1.7608263,4
2020-04-18-170312,170312,1,0,1,600,1.0,0.15468206,5
2020-04-19-170312,170312,4,0,0,604,0.5555555555555556,0.2738367,6
2020-04-20-170312,170312,15,0,12,619,8.444444444444445,1.9075811,0
2020-04-21-170312,170312,6,0,12,625,4.777777777777779,1.1617206,1
2020-04-22-170312,170312,40,0,7,665,3.0,3.2023046,2
2020-04-23-170312,170312,0,0,7,665,1.5555555555555556,0.12529883,3
2020-04-24-170312,170312,56,0,11,721,5.222222222222221,4.51661,4
2020-04-25-170312,170312,0,0,1,721,1.2222222222222223,0.28345418,5
2020-04-26-170312,170312,2,0,0,723,0.1111111111111111,0.13271777,6
2020-04-27-170312,170312,13,0,6,736,3.6666666666666665,1.4179454,0
2020-04-28-170312,170312,6,0,10,742,2.7777777777777777,0.77551156,1
2020-04-29-170312,170312,11,0,13,753,4.0,1.0559492,2
2020-04-30-170312,170312,12,0,15,765,2.2222222222222223,1.1897274,3
2020-05-01-170312,170312,0,0,2,765,0.1111111111111111,0.01786848,4
2020-05-02-170312,170312,1,0,5,766,0.8888888888888888,0.19051722,5
2020-05-03-170312,170312,0,0,0,766,0.7777777777777778,0.05434792,6
2020-05-04-170312,170312,12,0,6,778,3.4444444444444446,1.2762847,0
2020-05-05-170312,170312,12,0,8,790,2.2222222222222223,1.2782387,1
2020-05-06-170312,170312,7,0,7,797,3.0,0.973667,2
2020-05-07-170312,170312,7,0,8,804,3.4444444444444446,0.8842696,3
2020-05-08-170312,170312,11,0,16,815,2.555555555555556,1.2697296,4
2020-05-09-170312,170312,1,0,2,816,0.4444444444444444,0.12533478,5
2020-05-10-170312,170312,0,0,1,816,0.2222222222222222,0.015240812,6
2020-05-11-170312,170312,6,2,9,822,4.222222222222221,0.7581379,0
2020-05-12-170312,170312,10,0,6,832,2.333333333333333,0.947645,1
2020-05-13-170312,170312,13,0,5,845,1.8888888888888888,1.1728973,2
2020-05-14-170312,170312,15,0,12,860,2.333333333333333,1.6393116,3
2020-05-15-170312,170312,2,0,12,862,2.555555555555556,0.5683319,4
2020-05-16-170312,170312,5,0,0,867,0.3333333333333333,0.38060337,5
2020-05-17-170312,170312,0,0,0,867,0.2222222222222222,0.03228085,6
2020-05-18-170312,170312,6,0,9,873,3.0,0.7656678,0
2020-05-19-170312,170312,8,0,6,881,3.111111111111111,1.0336848,1
2020-05-20-170312,170312,7,0,11,888,2.555555555555556,0.8542086,2
2020-05-21-170312,170312,8,0,8,896,3.0,1.1008651,3
2020-05-22-170312,170312,16,0,12,912,4.5555555555555545,1.7567606,4
2020-05-23-170312,170312,2,0,0,914,0.2222222222222222,0.16385281,5
2020-05-24-170312,170312,1,0,0,915,0.2222222222222222,0.0952701,6
2020-05-25-170312,170312,9,0,15,924,2.7777777777777777,1.2350923,0
2020-05-26-170312,170312,6,0,14,930,1.5555555555555556,0.82099384,1
2020-05-27-170312,170312,5,0,10,935,2.1111111111111107,0.78872883,2
2020-05-28-170312,170312,12,2,8,947,2.333333333333333,1.3278621,3
2020-05-29-170312,170312,12,0,6,959,1.8888888888888888,1.369939,4
2020-05-30-170312,170312,0,0,2,959,0.7777777777777778,0.07901082,5
2020-05-31-170312,170312,0,0,1,959,0.3333333333333333,0.07133701,6
2020-06-01-170312,170312,9,0,6,968,3.111111111111111,1.3251234,0
2020-06-02-170312,170312,6,0,3,974,3.111111111111111,0.95074886,1
2020-06-03-170312,170312,11,1,2,985,3.4444444444444446,1.3213496,2
2020-06-04-170312,170312,8,0,0,993,1.7777777777777777,1.072635,3
2020-06-05-170312,170312,12,0,5,1005,3.7777777777777777,1.3843267,4
2020-06-06-170312,170312,0,0,0,1005,0.3333333333333333,0.011881251,5
2020-06-07-170312,170312,0,0,0,1005,0.0,0.077761,6
2020-06-08-170312,170312,15,0,0,1020,1.6666666666666667,1.5482907,0
2020-06-09-170312,170312,14,0,3,1034,2.333333333333333,1.5194087,1
2020-06-10-170312,170312,10,0,0,1044,2.7777777777777777,1.3452144,2
2020-06-11-170312,170312,8,0,1,1052,2.6666666666666665,1.0284494,3
2020-06-12-170312,170312,6,0,3,1058,1.7777777777777777,0.78416574,4
2020-06-13-170312,170312,2,0,0,1060,0.2222222222222222,0.09066803,5
2020-06-14-170312,170312,1,0,0,1061,0.2222222222222222,0.13846847,6
2020-06-15-170312,170312,6,0,2,1067,0.5555555555555556,0.5719825,0
2020-06-16-170312,170312,3,0,1,1070,1.5555555555555556,0.467807,1
2020-06-17-170312,170312,2,0,1,1072,0.8888888888888888,0.3373828,2
2020-06-18-170312,170312,0,0,0,1072,0.8888888888888888,0.1727645,3
2020-06-19-170312,170312,5,0,3,1077,0.7777777777777778,0.6170665,4
2020-06-20-170312,170312,0,0,0,1077,0.0,0.0031200957,5
2020-06-21-170312,170312,0,0,1,1077,0.1111111111111111,0.0152157,6
2020-06-22-170312,170312,0,0,3,1077,0.6666666666666666,0.15777588,0
2020-06-23-170312,170312,3,0,4,1080,1.1111111111111112,0.5758878,1
2020-06-24-170312,170312,0,2,1,1080,0.2222222222222222,0.11124848,2
2020-06-25-170312,170312,1,1,2,1081,0.8888888888888888,0.28908917,3
2020-06-26-170312,170312,3,0,2,1084,0.6666666666666666,0.24115318,4
2020-06-27-170312,170312,0,0,0,1084,0.0,0.02386756,5
2020-06-28-170312,170312,0,0,0,1084,0.0,0.0023647174,6
2020-06-29-170312,170312,2,0,4,1086,0.3333333333333333,0.28619322,0
2020-06-30-170312,170312,1,0,2,1087,0.2222222222222222,0.19501975,1
2020-07-01-170312,170312,1,0,1,1088,0.3333333333333333,0.13396175,2
2020-07-02-170312,170312,0,0,0,1088,0.3333333333333333,0.061469,3
2020-07-03-170312,170312,3,0,4,1091,0.5555555555555556,0.31486937,4
2020-07-04-170312,170312,0,0,1,1091,0.0,0.0011759796,5
2020-07-05-170312,170312,1,0,2,1092,0.1111111111111111,0.08954581,6
2020-07-06-170312,170312,3,0,1,1095,0.3333333333333333,0.34734568,0
2020-07-07-170312,170312,4,0,2,1099,0.8888888888888888,0.48599315,1
2020-07-08-170312,170312,1,0,0,1100,0.3333333333333333,0.1604513,2
2020-07-09-170312,170312,2,0,0,1102,0.4444444444444444,0.32751384,3
2020-07-10-170312,170312,2,0,4,1104,0.6666666666666666,0.32965997,4
2020-07-11-170312,170312,0,0,0,1104,0.2222222222222222,0.034225557,5
2020-07-12-170312,170312,0,0,3,1104,0.1111111111111111,0.03271433,6
2020-07-13-170312,170312,4,0,2,1108,0.6666666666666666,0.457237,0
2020-07-14-170312,170312,2,0,1,1110,0.3333333333333333,0.2118789,1
2020-07-15-170312,170312,1,0,0,1111,1.0,0.19918403,2
2020-07-16-170312,170312,0,0,4,1111,0.2222222222222222,0.2613635,3
2020-07-17-170312,170312,4,0,3,1115,0.8888888888888888,0.4815466,4
2020-07-18-170312,170312,1,0,0,1116,0.1111111111111111,0.18986624,5
2020-07-19-170312,170312,2,0,0,1118,0.1111111111111111,0.20730516,6
2020-07-20-170312,170312,1,0,7,1119,1.2222222222222223,0.38367856,0
2020-07-21-170312,170312,2,0,4,1121,0.7777777777777778,0.34717909,1
2020-07-22-170312,170312,0,0,6,1121,1.3333333333333333,0.26010072,2
2020-07-23-170312,170312,0,0,1,1121,0.8888888888888888,0.26718426,3
2020-07-24-170312,170312,4,0,1,1125,0.7777777777777778,0.5132893,4
2020-07-25-170312,170312,0,0,1,1125,0.1111111111111111,0.00478219,5
2020-07-26-170312,170312,3,0,0,1128,0.2222222222222222,0.19442613,6
2020-07-27-170312,170312,2,0,2,1130,0.6666666666666666,0.33817992,0
2020-07-28-170312,170312,1,0,2,1131,0.4444444444444444,0.29245368,1
2020-07-29-170312,170312,0,0,4,1131,0.6666666666666666,0.07272337,2
2020-07-30-170312,170312,4,0,3,1135,0.8888888888888888,0.4919616,3
2020-07-31-170312,170312,3,0,4,1138,0.3333333333333333,0.3033023,4
2020-08-01-170312,170312,0,0,0,1138,0.2222222222222222,0.028054524,5
2020-08-02-170312,170312,0,0,0,1138,0.0,0.13072853,6
2020-08-03-170312,170312,7,0,6,1145,0.5555555555555556,0.6840461,0
2020-08-04-170312,170312,4,0,3,1149,0.4444444444444444,0.57318455,1
2020-08-05-170312,170312,6,0,8,1155,0.6666666666666666,0.70925355,2
2020-08-06-170312,170312,1,0,0,1156,0.6666666666666666,0.34965315,3
2020-08-07-170312,170312,1,0,10,1157,0.8888888888888888,0.36556572,4
2020-08-08-170312,170312,1,0,6,1158,0.1111111111111111,0.13900743,5
2020-08-09-170312,170312,0,0,5,1158,0.1111111111111111,0.110087246,6
2020-08-10-170312,170312,2,0,6,1160,1.1111111111111112,0.44779179,0
2020-08-11-170312,170312,2,0,13,1162,1.0,0.39373302,1
2020-08-12-170312,170312,4,0,6,1166,1.2222222222222223,0.3923571,2
2020-08-13-170312,170312,3,0,12,1169,1.3333333333333333,0.264618,3
2020-08-14-170312,170312,4,0,6,1173,0.6666666666666666,0.41549063,4
2020-08-15-170312,170312,0,0,13,1173,0.3333333333333333,0.15524557,5
2020-08-16-170312,170312,0,0,7,1173,0.3333333333333333,0.1562835,6
2020-08-17-170312,170312,6,0,10,1179,1.1111111111111112,0.7657567,0
2020-08-18-170312,170312,3,0,5,1182,1.1111111111111112,0.6548458,1
2020-08-19-170312,170312,8,0,7,1190,1.3333333333333333,0.97721595,2
2020-08-20-170312,170312,0,0,9,1190,2.7777777777777777,0.5076245,3
2020-08-21-170312,170312,10,0,12,1200,2.4444444444444446,1.2768455,4
2020-08-22-170312,170312,6,0,9,1206,0.6666666666666666,0.5591698,5
2020-08-23-170312,170312,5,0,1,1211,0.5555555555555556,0.5285371,6
2020-08-24-170312,170312,6,0,23,1217,1.5555555555555556,1.2925326,0
2020-08-25-170312,170312,13,0,21,1230,3.888888888888889,2.2874627,1
2020-08-26-170312,170312,6,0,16,1236,3.888888888888889,1.6346515,2
2020-08-27-170312,170312,12,0,14,1248,3.333333333333333,1.8616977,3
2020-08-28-170312,170312,6,2,29,1254,4.111111111111111,1.20153,4
2020-08-29-170312,170312,13,0,6,1267,3.2222222222222223,1.334112,5
2020-08-30-170312,170312,7,0,21,1274,2.0,0.93931454,6
2020-08-31-170312,170312,10,0,24,1284,4.777777777777779,1.7657105,0
2020-09-01-170312,170312,5,0,15,1289,2.1111111111111107,1.089737,1
2020-09-02-170312,170312,7,1,29,1296,2.888888888888889,1.1835519,2
2020-09-03-170312,170312,9,0,33,1305,3.888888888888889,1.566895,3
2020-09-04-170312,170312,12,1,36,1317,4.0,1.6740931,4
2020-09-05-170312,170312,9,0,2,1326,1.7777777777777777,0.75561416,5
2020-09-06-170312,170312,1,2,3,1327,3.2222222222222223,0.7477257,6
2020-09-07-170312,170312,23,0,45,1350,4.888888888888889,3.07196,0
2020-09-08-170312,170312,21,0,28,1371,6.0,2.3939502,1
2020-09-09-170312,170312,16,1,30,1387,8.444444444444445,3.1054885,2
2020-09-10-170312,170312,14,0,26,1401,7.777777777777778,3.1398396,3
2020-09-11-170312,170312,29,0,18,1430,7.5555555555555545,4.2661014,4
2020-09-12-170312,170312,6,1,8,1436,2.333333333333333,0.7014597,5
2020-09-13-170312,170312,21,0,1,1457,3.6666666666666665,2.1855958,6
2020-09-14-170312,170312,24,1,40,1481,9.0,3.148157,0
2020-09-15-170312,170312,15,0,16,1496,4.888888888888889,2.4173212,1
2020-09-16-170312,170312,29,0,29,1525,8.333333333333334,3.582606,2
2020-09-17-170312,170312,33,0,32,1558,7.666666666666668,3.9388454,3
2020-09-18-170312,170312,36,0,49,1594,7.111111111111112,3.7859025,4
2020-09-19-170312,170312,2,2,12,1596,1.3333333333333333,0.6200949,5
2020-09-20-170312,170312,3,3,9,1599,1.8888888888888888,0.6550742,6
2020-09-21-170312,170312,45,0,4,1644,12.0,4.108633,0
2020-09-22-170312,170312,28,0,37,1672,6.777777777777778,3.7187476,1
2020-09-23-170312,170312,30,0,31,1702,7.111111111111112,3.9537616,2
2020-09-24-170312,170312,26,1,25,1728,9.666666666666666,4.7516565,3
2020-09-25-170312,170312,18,1,34,1746,8.666666666666666,2.890913,4
2020-09-26-170312,170312,8,1,6,1754,1.1111111111111112,0.8544336,5
2020-09-27-170312,170312,1,0,5,1755,1.6666666666666667,0.43797445,6
2020-09-28-170312,170312,40,0,1,1795,10.666666666666666,5.1549315,0
2020-09-29-170312,170312,16,0,49,1811,5.666666666666668,2.4501882,1
2020-09-30-170312,170312,29,1,43,1840,6.333333333333332,3.8437862,2
2020-10-01-170312,170312,32,0,52,1872,12.111111111111109,6.611213,3
2020-10-02-170312,170312,49,0,30,1921,12.333333333333336,5.3197837,4
2020-10-03-170312,170312,12,2,5,1933,3.0,1.316048,5
2020-10-04-170312,170312,9,1,7,1942,3.6666666666666665,1.2933873,6
2020-10-05-170312,170312,4,1,59,1946,1.6666666666666667,1.0784811,0
2020-10-06-170312,170312,37,0,40,1983,10.222222222222221,5.4945974,1
2020-10-07-170312,170312,31,0,44,2014,9.222222222222221,3.8983564,2
2020-10-08-170312,170312,25,1,83,2039,11.444444444444445,4.2117147,3
2020-10-09-170312,170312,34,2,48,2073,17.444444444444443,6.500846,4
2020-10-10-170312,170312,6,0,8,2079,2.4444444444444446,0.873009,5
2020-10-11-170312,170312,5,0,9,2084,2.2222222222222223,0.52509046,6
2020-10-12-170312,170312,1,0,49,2085,3.4444444444444446,0.7117654,0
2020-10-13-170312,170312,49,0,11,2134,20.11111111111111,8.307352,1
2020-10-14-170312,170312,43,0,75,2177,10.444444444444443,5.801872,2
2020-10-15-170312,170312,52,0,49,2229,13.444444444444445,6.230166,3
2020-10-16-170312,170312,30,0,41,2259,14.555555555555555,5.3493934,4
2020-10-17-170312,170312,5,0,10,2264,4.666666666666667,1.104203,5
2020-10-18-170312,170312,7,0,3,2271,2.1111111111111107,1.1066997,6
2020-10-19-170312,170312,59,1,5,2330,20.88888888888889,8.879463,0
2020-10-20-170312,170312,40,0,56,2370,10.444444444444443,5.490429,1
2020-10-21-170312,170312,44,2,20,2414,11.888888888888891,5.9167423,2
2020-10-22-170312,170312,83,0,43,2497,12.777777777777779,7.90602,3
2020-10-23-170312,170312,48,1,38,2545,15.0,6.2528396,4
2020-10-24-170312,170312,8,1,2,2553,4.5555555555555545,1.1134801,5
2020-10-25-170312,170312,9,1,5,2562,2.333333333333333,1.1976671,6
2020-10-26-170312,170312,49,2,52,2611,17.0,7.057591,0
2020-10-27-170312,170312,11,1,76,2622,9.888888888888891,2.7842565,1
2020-10-28-170312,170312,75,3,45,2697,13.0,8.562124,2
2020-10-29-170312,170312,49,1,47,2746,13.333333333333336,6.5681076,3
2020-10-30-170312,170312,41,3,41,2787,16.444444444444443,7.2037153,4
2020-10-31-170312,170312,10,0,0,2797,3.4444444444444446,1.4909092,5
2020-11-01-170312,170312,3,2,0,2800,3.7777777777777777,0.9590193,6
2020-11-02-170312,170312,5,4,0,2805,1.8888888888888888,0.89088106,0
2020-11-03-170312,170312,56,3,0,2861,22.11111111111111,9.79767,1
2020-11-04-170312,170312,20,4,0,2881,10.555555555555557,3.8326101,2
2020-11-05-170312,170312,43,1,0,2924,15.666666666666664,6.593305,3
2020-11-06-170312,170312,38,4,0,2962,13.555555555555555,6.4174232,4
2020-11-07-170312,170312,2,1,0,2964,2.4444444444444446,0.89648205,5
2020-11-08-170312,170312,5,1,0,2969,6.4444444444444455,1.0121135,6
2020-11-09-170312,170312,52,2,0,3021,25.33333333333333,9.124371,0
2020-11-10-170312,170312,76,2,0,3097,14.444444444444445,9.037916,1
2020-11-11-170312,170312,45,5,0,3142,12.666666666666664,6.542746,2
2020-11-12-170312,170312,47,5,0,3189,15.0,5.2397556,3
2020-11-13-170312,170312,41,3,0,3230,14.777777777777779,7.0948033,4
2020-03-01-170313,170313,0,0,2,0,0.0,3.4075358e-05,6
2020-03-02-170313,170313,0,0,15,0,0.0,0.00050052,0
2020-03-03-170313,170313,0,0,32,0,0.0,0.00024861904,1
2020-03-04-170313,170313,1,0,35,1,0.6666666666666666,0.00079360156,2
2020-03-05-170313,170313,0,0,22,1,0.0,1.4765439e-05,3
2020-03-06-170313,170313,0,0,36,1,0.0,0.0013587509,4
2020-03-07-170313,170313,0,0,1,1,0.0,0.0008891171,5
2020-03-08-170313,170313,0,0,4,1,0.0,0.0006425749,6
2020-03-09-170313,170313,1,0,50,2,0.3333333333333333,0.020021616,0
2020-03-10-170313,170313,0,0,29,2,0.0,0.0022048033,1
2020-03-11-170313,170313,0,0,23,2,0.6666666666666666,0.0036649627,2
2020-03-12-170313,170313,0,0,23,2,1.0,0.03117897,3
2020-03-13-170313,170313,0,0,19,2,1.0,0.024292422,4
2020-03-14-170313,170313,1,0,3,3,1.3333333333333333,0.113026954,5
2020-03-15-170313,170313,2,0,0,5,0.6666666666666666,0.045680895,6
2020-03-16-170313,170313,15,0,20,20,13.0,0.5731208,0
2020-03-17-170313,170313,32,0,15,52,14.333333333333336,0.7571036,1
2020-03-18-170313,170313,35,0,10,87,23.0,0.9474079,2
2020-03-19-170313,170313,22,0,16,109,20.666666666666668,1.0483859,3
2020-03-20-170313,170313,36,0,11,145,18.666666666666668,0.87551016,4
2020-03-21-170313,170313,1,0,0,146,2.0,0.12211082,5
2020-03-22-170313,170313,4,1,0,150,2.333333333333333,0.066196844,6
2020-03-23-170313,170313,50,0,23,200,31.0,1.4421043,0
2020-03-24-170313,170313,29,0,22,229,25.66666666666667,1.0829507,1
2020-03-25-170313,170313,23,0,19,252,25.33333333333333,1.3487384,2
2020-03-26-170313,170313,23,0,12,275,25.33333333333333,1.337695,3
2020-03-27-170313,170313,19,0,16,294,18.33333333333333,1.2280126,4
2020-03-28-170313,170313,3,0,1,297,2.0,0.090661496,5
2020-03-29-170313,170313,0,0,2,297,0.6666666666666666,0.042704795,6
2020-03-30-170313,170313,20,0,12,317,35.333333333333336,1.3227286,0
2020-03-31-170313,170313,15,0,11,332,16.0,0.6868903,1
2020-04-01-170313,170313,10,0,11,342,14.333333333333336,0.71775717,2
2020-04-02-170313,170313,16,0,17,358,12.333333333333336,0.5206023,3
2020-04-03-170313,170313,11,0,7,369,14.0,0.64731914,4
2020-04-04-170313,170313,0,0,1,369,2.0,0.11436777,5
2020-04-05-170313,170313,0,0,1,369,1.6666666666666667,0.08592336,6
2020-04-06-170313,170313,23,0,10,392,16.0,0.80336297,0
2020-04-07-170313,170313,22,0,8,414,13.666666666666664,0.636032,1
2020-04-08-170313,170313,19,1,4,433,9.333333333333334,0.52918935,2
2020-04-09-170313,170313,12,0,0,445,9.333333333333334,0.44986102,3
2020-04-10-170313,170313,16,0,4,461,9.333333333333334,0.3561814,4
2020-04-11-170313,170313,1,0,1,462,1.3333333333333333,0.0746943,5
2020-04-12-170313,170313,2,0,0,464,2.0,0.0871989,6
2020-04-13-170313,170313,12,0,7,476,11.666666666666664,0.9196728,0
2020-04-14-170313,170313,11,0,2,487,10.0,0.6911825,1
2020-04-15-170313,170313,11,0,7,498,10.333333333333334,0.62993854,2
2020-04-16-170313,170313,17,0,1,515,9.0,0.5527087,3
2020-04-17-170313,170313,7,0,0,522,10.0,0.54590654,4
2020-04-18-170313,170313,1,0,2,523,1.6666666666666667,0.0322428,5
2020-04-19-170313,170313,1,0,0,524,1.3333333333333333,0.08069781,6
2020-04-20-170313,170313,10,0,5,534,12.0,0.71552217,0
2020-04-21-170313,170313,8,1,3,542,5.333333333333333,0.35372996,1
2020-04-22-170313,170313,4,0,6,546,15.666666666666664,0.9745473,2
2020-04-23-170313,170313,0,0,6,546,0.3333333333333333,0.049622815,3
2020-04-24-170313,170313,4,0,4,550,21.33333333333333,1.4913907,4
2020-04-25-170313,170313,1,0,1,551,0.6666666666666666,0.064351715,5
2020-04-26-170313,170313,0,0,0,551,0.6666666666666666,0.041893274,6
2020-04-27-170313,170313,7,0,12,558,7.0,0.43229955,0
2020-04-28-170313,170313,2,1,4,560,6.0,0.23977986,1
2020-04-29-170313,170313,7,0,9,567,8.666666666666666,0.34286752,2
2020-04-30-170313,170313,1,0,2,568,5.333333333333333,0.393121,3
2020-05-01-170313,170313,0,0,3,568,0.0,0.004538911,4
2020-05-02-170313,170313,2,0,3,570,0.6666666666666666,0.044527195,5
2020-05-03-170313,170313,0,0,0,570,0.3333333333333333,0.012172674,6
2020-05-04-170313,170313,5,0,4,575,7.333333333333332,0.41780555,0
2020-05-05-170313,170313,3,0,7,578,6.666666666666668,0.397089,1
2020-05-06-170313,170313,6,0,4,584,4.333333333333333,0.32715467,2
2020-05-07-170313,170313,6,0,8,590,6.666666666666668,0.2822394,3
2020-05-08-170313,170313,4,0,9,594,5.0,0.4190627,4
2020-05-09-170313,170313,1,0,0,595,0.3333333333333333,0.04795084,5
2020-05-10-170313,170313,0,0,0,595,0.3333333333333333,0.005056341,6
2020-05-11-170313,170313,12,0,4,607,6.0,0.24988726,0
2020-05-12-170313,170313,4,0,5,611,6.666666666666668,0.30797127,1
2020-05-13-170313,170313,9,0,2,620,6.666666666666668,0.3829803,2
2020-05-14-170313,170313,2,0,9,622,7.333333333333332,0.5391894,3
2020-05-15-170313,170313,3,0,3,625,2.6666666666666665,0.19721095,4
2020-05-16-170313,170313,3,0,0,628,1.6666666666666667,0.12136025,5
2020-05-17-170313,170313,0,0,0,628,0.3333333333333333,0.004301972,6
2020-05-18-170313,170313,4,1,2,632,5.333333333333333,0.2495589,0
2020-05-19-170313,170313,7,0,9,639,6.666666666666668,0.35021144,1
2020-05-20-170313,170313,4,0,2,643,5.333333333333333,0.27732125,2
2020-05-21-170313,170313,8,0,2,651,4.333333333333333,0.39476493,3
2020-05-22-170313,170313,9,0,9,660,9.333333333333334,0.5835668,4
2020-05-23-170313,170313,0,0,0,660,1.3333333333333333,0.04835744,5
2020-05-24-170313,170313,0,0,0,660,0.6666666666666666,0.03036182,6
2020-05-25-170313,170313,4,0,1,664,6.333333333333332,0.40753284,0
2020-05-26-170313,170313,5,0,7,669,2.6666666666666665,0.29742414,1
2020-05-27-170313,170313,2,0,6,671,4.333333333333333,0.2714991,2
2020-05-28-170313,170313,9,1,5,680,5.666666666666668,0.48208606,3
2020-05-29-170313,170313,3,0,3,683,5.0,0.47646418,4
2020-05-30-170313,170313,0,0,1,683,0.6666666666666666,0.03785744,5
2020-05-31-170313,170313,0,0,0,683,0.0,0.013410811,6
2020-06-01-170313,170313,2,2,1,685,5.666666666666668,0.4396255,0
2020-06-02-170313,170313,9,0,2,694,4.666666666666667,0.36614543,1
2020-06-03-170313,170313,2,0,3,696,6.666666666666668,0.4851409,2
2020-06-04-170313,170313,2,0,3,698,4.0,0.3390427,3
2020-06-05-170313,170313,9,0,0,707,8.0,0.5336076,4
2020-06-06-170313,170313,0,0,0,707,1.0,0.0041118814,5
2020-06-07-170313,170313,0,0,0,707,0.0,0.024062708,6
2020-06-08-170313,170313,1,0,0,708,7.0,0.58889794,0
2020-06-09-170313,170313,7,0,1,715,7.0,0.5713947,1
2020-06-10-170313,170313,6,0,0,721,7.333333333333332,0.50860703,2
2020-06-11-170313,170313,5,0,2,726,5.0,0.36686596,3
2020-06-12-170313,170313,3,0,2,729,4.666666666666667,0.27953172,4
2020-06-13-170313,170313,1,0,0,730,1.0,0.030652305,5
2020-06-14-170313,170313,0,0,0,730,0.3333333333333333,0.037910067,6
2020-06-15-170313,170313,1,0,0,731,3.0,0.22242835,0
2020-06-16-170313,170313,2,0,0,733,3.6666666666666665,0.17680106,1
2020-06-17-170313,170313,3,0,0,736,2.0,0.13920745,2
2020-06-18-170313,170313,3,0,0,739,0.0,0.08996609,3
2020-06-19-170313,170313,0,0,2,739,2.333333333333333,0.20505688,4
2020-06-20-170313,170313,0,0,0,739,0.0,0.00060447893,5
2020-06-21-170313,170313,0,0,0,739,0.0,0.003808664,6
2020-06-22-170313,170313,0,0,0,739,0.6666666666666666,0.06308257,0
2020-06-23-170313,170313,1,0,0,740,2.333333333333333,0.21568422,1
2020-06-24-170313,170313,0,0,0,740,0.0,0.04933678,2
2020-06-25-170313,170313,2,0,0,742,1.0,0.13246177,3
2020-06-26-170313,170313,2,0,1,744,2.0,0.105042785,4
2020-06-27-170313,170313,0,0,0,744,0.0,0.010979383,5
2020-06-28-170313,170313,0,0,0,744,0.0,0.0015182694,6
2020-06-29-170313,170313,0,0,0,744,1.0,0.0996949,0
2020-06-30-170313,170313,0,0,0,744,0.3333333333333333,0.07782113,1
2020-07-01-170313,170313,0,0,1,744,1.0,0.045861885,2
2020-07-02-170313,170313,0,0,0,744,0.6666666666666666,0.019575544,3
2020-07-03-170313,170313,2,0,0,746,1.6666666666666667,0.12235433,4
2020-07-04-170313,170313,0,0,0,746,0.0,0.0009013359,5
2020-07-05-170313,170313,0,0,0,746,0.3333333333333333,0.02459023,6
2020-07-06-170313,170313,0,0,0,746,1.3333333333333333,0.12726414,0
2020-07-07-170313,170313,0,0,1,746,2.0,0.19079582,1
2020-07-08-170313,170313,0,0,2,746,1.0,0.07137824,2
2020-07-09-170313,170313,0,0,0,746,1.3333333333333333,0.14108665,3
2020-07-10-170313,170313,1,0,0,747,1.6666666666666667,0.119623855,4
2020-07-11-170313,170313,0,0,0,747,0.6666666666666666,0.009413767,5
2020-07-12-170313,170313,0,0,1,747,0.0,0.014020724,6
2020-07-13-170313,170313,0,0,1,747,2.6666666666666665,0.17299888,0
2020-07-14-170313,170313,0,1,0,747,1.3333333333333333,0.078261495,1
2020-07-15-170313,170313,1,0,0,748,1.6666666666666667,0.06932149,2
2020-07-16-170313,170313,0,0,0,748,0.0,0.10435815,3
2020-07-17-170313,170313,0,0,0,748,3.333333333333333,0.17155538,4
2020-07-18-170313,170313,0,0,1,748,0.3333333333333333,0.058713436,5
2020-07-19-170313,170313,0,0,0,748,0.6666666666666666,0.068878144,6
2020-07-20-170313,170313,0,0,0,748,1.0,0.12552948,0
2020-07-21-170313,170313,1,0,1,749,1.3333333333333333,0.12123091,1
2020-07-22-170313,170313,2,0,0,751,1.0,0.10790563,2
2020-07-23-170313,170313,0,0,1,751,0.3333333333333333,0.09845033,3
2020-07-24-170313,170313,0,0,0,751,1.3333333333333333,0.19345288,4
2020-07-25-170313,170313,0,0,0,751,0.3333333333333333,0.0012947823,5
2020-07-26-170313,170313,1,0,0,752,1.0,0.06119716,6
2020-07-27-170313,170313,1,0,0,753,1.0,0.12919128,0
2020-07-28-170313,170313,0,0,1,753,0.6666666666666666,0.10488102,1
2020-07-29-170313,170313,0,0,0,753,1.0,0.029021136,2
2020-07-30-170313,170313,0,0,3,753,3.6666666666666665,0.19250368,3
2020-07-31-170313,170313,0,0,0,753,1.0,0.12771349,4
2020-08-01-170313,170313,1,0,2,754,0.0,0.010916997,5
2020-08-02-170313,170313,0,0,1,754,0.0,0.05257562,6
2020-08-03-170313,170313,0,0,1,754,2.6666666666666665,0.23777829,0
2020-08-04-170313,170313,1,0,2,755,1.3333333333333333,0.21634857,1
2020-08-05-170313,170313,0,0,1,755,2.6666666666666665,0.2769865,2
2020-08-06-170313,170313,1,0,4,756,0.3333333333333333,0.15883197,3
2020-08-07-170313,170313,0,1,3,756,0.6666666666666666,0.11985404,4
2020-08-08-170313,170313,0,0,0,756,0.3333333333333333,0.05594904,5
2020-08-09-170313,170313,0,0,0,756,0.3333333333333333,0.045581575,6
2020-08-10-170313,170313,0,0,5,756,1.3333333333333333,0.18787447,0
2020-08-11-170313,170313,1,0,5,757,1.6666666666666667,0.17004648,1
2020-08-12-170313,170313,0,0,3,757,3.0,0.1706076,2
2020-08-13-170313,170313,3,0,8,760,3.6666666666666665,0.12531695,3
2020-08-14-170313,170313,0,0,6,760,2.333333333333333,0.17491518,4
2020-08-15-170313,170313,2,0,5,762,0.3333333333333333,0.05114169,5
2020-08-16-170313,170313,1,0,2,763,0.3333333333333333,0.06684162,6
2020-08-17-170313,170313,1,0,10,764,2.6666666666666665,0.2881327,0
2020-08-18-170313,170313,2,0,3,766,1.6666666666666667,0.24667063,1
2020-08-19-170313,170313,1,0,5,767,4.0,0.38257748,2
2020-08-20-170313,170313,4,0,8,771,4.0,0.19856918,3
2020-08-21-170313,170313,3,0,3,774,6.333333333333332,0.53162205,4
2020-08-22-170313,170313,0,0,0,774,3.6666666666666665,0.19928072,5
2020-08-23-170313,170313,0,0,0,774,1.6666666666666667,0.16871198,6
2020-08-24-170313,170313,5,0,10,779,2.6666666666666665,0.5372572,0
2020-08-25-170313,170313,5,0,7,784,9.0,0.93199754,1
2020-08-26-170313,170313,3,0,14,787,4.333333333333333,0.55893534,2
2020-08-27-170313,170313,8,0,13,795,6.666666666666668,0.7201701,3
2020-08-28-170313,170313,6,0,11,801,7.666666666666668,0.46032184,4
2020-08-29-170313,170313,5,0,4,806,8.333333333333334,0.4818241,5
2020-08-30-170313,170313,2,0,2,808,3.333333333333333,0.2910019,6
2020-08-31-170313,170313,10,0,21,818,7.333333333333332,0.71345776,0
2020-09-01-170313,170313,3,0,4,821,3.0,0.4462018,1
2020-09-02-170313,170313,5,0,12,826,5.0,0.45385602,2
2020-09-03-170313,170313,8,0,12,834,7.333333333333332,0.6354779,3
2020-09-04-170313,170313,3,0,18,837,9.666666666666666,0.66958195,4
2020-09-05-170313,170313,0,0,0,837,4.666666666666667,0.27462098,5
2020-09-06-170313,170313,0,0,1,837,3.333333333333333,0.2547556,6
2020-09-07-170313,170313,10,0,39,847,11.333333333333336,1.268702,0
2020-09-08-170313,170313,7,0,10,854,13.333333333333336,0.9463438,1
2020-09-09-170313,170313,14,0,12,868,13.666666666666664,1.2414207,2
2020-09-10-170313,170313,13,0,13,881,14.0,1.3339463,3
2020-09-11-170313,170313,11,0,17,892,18.33333333333333,1.6947489,4
2020-09-12-170313,170313,4,0,1,896,4.333333333333333,0.31156003,5
2020-09-13-170313,170313,2,0,1,898,10.0,0.7106397,6
2020-09-14-170313,170313,21,0,9,919,18.666666666666668,1.2982378,0
2020-09-15-170313,170313,4,0,8,923,7.666666666666668,0.9265222,1
2020-09-16-170313,170313,12,0,6,935,18.33333333333333,1.5258746,2
2020-09-17-170313,170313,12,0,13,947,20.666666666666668,1.6392459,3
2020-09-18-170313,170313,18,0,23,965,19.0,1.4999261,4
2020-09-19-170313,170313,0,0,1,965,1.3333333333333333,0.25554034,5
2020-09-20-170313,170313,1,0,3,966,2.0,0.25095093,6
2020-09-21-170313,170313,39,3,0,1005,25.33333333333333,1.7744775,0
2020-09-22-170313,170313,10,0,10,1015,16.333333333333332,1.5675629,1
2020-09-23-170313,170313,12,0,16,1027,13.333333333333336,1.6963806,2
2020-09-24-170313,170313,13,1,21,1040,16.333333333333332,2.0527623,3
2020-09-25-170313,170313,17,0,14,1057,13.0,1.2716938,4
2020-09-26-170313,170313,1,0,1,1058,4.333333333333333,0.3183649,5
2020-09-27-170313,170313,1,0,1,1059,1.6666666666666667,0.1747914,6
2020-09-28-170313,170313,9,0,8,1068,26.33333333333333,2.1925786,0
2020-09-29-170313,170313,8,1,15,1076,11.333333333333336,1.0543141,1
2020-09-30-170313,170313,6,0,15,1082,16.333333333333332,1.5575725,2
2020-10-01-170313,170313,13,0,26,1095,21.33333333333333,2.9100432,3
2020-10-02-170313,170313,23,0,35,1118,30.33333333333333,2.3069422,4
2020-10-03-170313,170313,1,0,9,1119,7.0,0.520031,5
2020-10-04-170313,170313,3,0,1,1122,4.666666666666667,0.36065733,6
2020-10-05-170313,170313,0,0,29,1122,2.0,0.4951519,0
2020-10-06-170313,170313,10,0,20,1132,25.0,2.425386,1
2020-10-07-170313,170313,16,1,18,1148,18.33333333333333,1.6189845,2
2020-10-08-170313,170313,21,1,21,1169,20.33333333333333,1.8475581,3
2020-10-09-170313,170313,14,3,29,1183,22.0,2.8091385,4
2020-10-10-170313,170313,1,0,5,1184,3.333333333333333,0.29217276,5
2020-10-11-170313,170313,1,0,2,1185,4.0,0.20174703,6
2020-10-12-170313,170313,8,0,22,1193,3.333333333333333,0.19293857,0
2020-10-13-170313,170313,15,0,25,1208,36.0,3.5075278,1
2020-10-14-170313,170313,15,0,23,1223,25.66666666666667,2.463974,2
2020-10-15-170313,170313,26,0,8,1249,30.33333333333333,2.5519252,3
2020-10-16-170313,170313,35,0,27,1284,22.66666666666667,2.2170422,4
2020-10-17-170313,170313,9,0,6,1293,3.333333333333333,0.31708413,5
2020-10-18-170313,170313,1,0,1,1294,4.333333333333333,0.3571284,6
2020-10-19-170313,170313,29,1,5,1323,37.66666666666666,3.7489567,0
2020-10-20-170313,170313,20,0,28,1343,23.0,2.2344782,1
2020-10-21-170313,170313,18,0,13,1361,26.0,2.5154645,2
2020-10-22-170313,170313,21,0,18,1382,37.0,3.4117107,3
2020-10-23-170313,170313,29,0,22,1411,34.0,2.4857821,4
2020-10-24-170313,170313,5,1,5,1416,6.0,0.38714138,5
2020-10-25-170313,170313,2,2,1,1418,4.333333333333333,0.3456838,6
2020-10-26-170313,170313,22,1,34,1440,38.0,3.0923462,0
2020-10-27-170313,170313,25,1,25,1465,11.666666666666664,1.1718327,1
2020-10-28-170313,170313,23,0,17,1488,37.333333333333336,3.5031464,2
2020-10-29-170313,170313,8,0,17,1496,31.0,2.7792435,3
2020-10-30-170313,170313,27,0,19,1523,24.0,3.0127332,4
2020-10-31-170313,170313,6,0,0,1529,7.666666666666668,0.5441519,5
2020-11-01-170313,170313,1,0,0,1530,2.6666666666666665,0.2599402,6
2020-11-02-170313,170313,5,3,0,1535,3.6666666666666665,0.31707802,0
2020-11-03-170313,170313,28,1,0,1563,42.0,4.092556,1
2020-11-04-170313,170313,13,0,0,1576,18.666666666666668,1.5381354,2
2020-11-05-170313,170313,18,0,0,1594,31.66666666666667,2.6622343,3
2020-11-06-170313,170313,22,4,0,1616,26.66666666666667,2.6500502,4
2020-11-07-170313,170313,5,0,0,1621,3.333333333333333,0.30187264,5
2020-11-08-170313,170313,1,0,0,1622,3.333333333333333,0.32518384,6
2020-11-09-170313,170313,34,0,0,1656,35.666666666666664,3.8107886,0
2020-11-10-170313,170313,25,0,0,1681,39.333333333333336,3.7242718,1
2020-11-11-170313,170313,17,0,0,1698,30.0,2.653769,2
2020-11-12-170313,170313,17,2,0,1715,36.0,2.2189233,3
2020-11-13-170313,170313,19,1,0,1734,24.66666666666667,2.7978947,4
2020-03-01-170314,170314,0,0,2,0,0.2,0.0004371455,6
2020-03-02-170314,170314,0,0,9,0,0.0,0.0003584555,0
2020-03-03-170314,170314,0,0,12,0,0.0,1.913883e-05,1
2020-03-04-170314,170314,0,0,22,0,0.6,0.00026832643,2
2020-03-05-170314,170314,0,1,21,0,0.0,1.2068707e-05,3
2020-03-06-170314,170314,0,0,20,0,0.0,0.00046472988,4
2020-03-07-170314,170314,0,0,2,0,0.0,0.0016155078,5
2020-03-08-170314,170314,0,0,0,0,0.0,0.0010236367,6
2020-03-09-170314,170314,0,0,22,0,0.4,0.023481766,0
2020-03-10-170314,170314,0,0,27,0,0.0,0.0011547243,1
2020-03-11-170314,170314,0,0,17,0,0.4,0.0024992994,2
2020-03-12-170314,170314,2,0,20,2,0.4,0.027713472,3
2020-03-13-170314,170314,1,0,10,3,0.4,0.013886894,4
2020-03-14-170314,170314,1,0,2,4,1.4,0.067353815,5
2020-03-15-170314,170314,2,0,1,6,1.0,0.046714783,6
2020-03-16-170314,170314,9,0,27,15,19.0,0.5982263,0
2020-03-17-170314,170314,12,0,9,27,18.6,0.56325066,1
2020-03-18-170314,170314,22,0,2,49,25.0,0.66365516,2
2020-03-19-170314,170314,21,1,10,70,20.2,0.7576918,3
2020-03-20-170314,170314,20,0,8,90,21.4,0.6360623,4
2020-03-21-170314,170314,2,0,0,92,1.8,0.093417056,5
2020-03-22-170314,170314,0,1,0,92,3.4,0.07084574,6
2020-03-23-170314,170314,22,0,10,114,35.2,1.013715,0
2020-03-24-170314,170314,27,2,7,141,22.8,0.6780023,1
2020-03-25-170314,170314,17,0,5,158,23.4,0.79940325,2
2020-03-26-170314,170314,20,0,3,178,20.8,0.6711389,3
2020-03-27-170314,170314,10,0,7,188,20.6,0.81060785,4
2020-03-28-170314,170314,2,0,0,190,2.0,0.06751914,5
2020-03-29-170314,170314,1,0,2,191,0.2,0.078343675,6
2020-03-30-170314,170314,27,0,9,218,28.0,0.78762054,0
2020-03-31-170314,170314,9,0,10,227,15.8,0.44804075,1
2020-04-01-170314,170314,2,0,10,229,14.2,0.41665632,2
2020-04-02-170314,170314,10,0,9,239,12.0,0.3468072,3
2020-04-03-170314,170314,8,0,5,247,13.6,0.38093492,4
2020-04-04-170314,170314,0,0,1,247,1.6,0.064342424,5
2020-04-05-170314,170314,0,0,0,247,1.4,0.047691125,6
2020-04-06-170314,170314,10,0,10,257,22.0,0.57928115,0
2020-04-07-170314,170314,7,0,6,264,14.4,0.3984709,1
2020-04-08-170314,170314,5,0,2,269,10.4,0.36666417,2
2020-04-09-170314,170314,3,2,1,272,10.4,0.23791614,3
2020-04-10-170314,170314,7,0,4,279,10.6,0.32427192,4
2020-04-11-170314,170314,0,0,0,279,1.0,0.054683253,5
2020-04-12-170314,170314,2,0,0,281,1.8,0.07424007,6
2020-04-13-170314,170314,9,0,6,290,11.6,0.7531148,0
2020-04-14-170314,170314,10,0,5,300,10.8,0.67689526,1
2020-04-15-170314,170314,10,0,8,310,9.6,0.5956072,2
2020-04-16-170314,170314,9,0,2,319,11.6,0.5496071,3
2020-04-17-170314,170314,5,0,0,324,9.6,0.34373087,4
2020-04-18-170314,170314,1,0,0,325,1.0,0.021765785,5
2020-04-19-170314,170314,0,0,0,325,1.4,0.036891848,6
2020-04-20-170314,170314,10,0,7,335,15.0,0.48190415,0
2020-04-21-170314,170314,6,1,6,341,6.0,0.2912965,1
2020-04-22-170314,170314,2,0,3,343,11.4,0.4412677,2
2020-04-23-170314,170314,1,0,9,344,2.2,0.072724916,3
2020-04-24-170314,170314,4,0,2,348,17.4,0.7598099,4
2020-04-25-170314,170314,0,0,0,348,1.0,0.064268894,5
2020-04-26-170314,170314,0,0,1,348,0.4,0.018119793,6
2020-04-27-170314,170314,6,0,8,354,6.2,0.2324279,0
2020-04-28-170314,170314,5,0,3,359,3.6,0.16617495,1
2020-04-29-170314,170314,8,0,5,367,6.8,0.18403482,2
2020-04-30-170314,170314,2,0,5,369,4.8,0.23554562,3
2020-05-01-170314,170314,0,0,4,369,0.2,0.0061143045,4
2020-05-02-170314,170314,0,0,0,369,1.2,0.03262151,5
2020-05-03-170314,170314,0,0,0,369,1.2,0.015422088,6
2020-05-04-170314,170314,7,0,6,376,6.2,0.23908846,0
2020-05-05-170314,170314,6,0,7,382,3.8,0.19882454,1
2020-05-06-170314,170314,3,0,2,385,5.2,0.2384688,2
2020-05-07-170314,170314,9,0,3,394,4.8,0.16762646,3
2020-05-08-170314,170314,2,0,4,396,4.8,0.25961113,4
2020-05-09-170314,170314,0,0,2,396,0.8,0.03632569,5
2020-05-10-170314,170314,1,0,0,397,0.0,0.0025640554,6
2020-05-11-170314,170314,8,0,6,405,6.2,0.16810438,0
2020-05-12-170314,170314,3,1,1,408,4.8,0.14721145,1
2020-05-13-170314,170314,5,0,3,413,5.0,0.16102527,2
2020-05-14-170314,170314,5,0,3,418,5.0,0.31761387,3
2020-05-15-170314,170314,4,0,2,422,3.4,0.18650989,4
2020-05-16-170314,170314,0,0,1,422,1.6,0.04216628,5
2020-05-17-170314,170314,0,0,0,422,0.2,0.0064698528,6
2020-05-18-170314,170314,6,0,6,428,4.0,0.16245888,0
2020-05-19-170314,170314,7,0,2,435,5.2,0.21320358,1
2020-05-20-170314,170314,2,0,6,437,4.8,0.18043429,2
2020-05-21-170314,170314,3,0,4,440,6.0,0.30049527,3
2020-05-22-170314,170314,4,0,7,444,9.0,0.36155403,4
2020-05-23-170314,170314,2,0,3,446,0.4,0.020024378,5
2020-05-24-170314,170314,0,0,0,446,0.4,0.023603788,6
2020-05-25-170314,170314,6,0,0,452,4.2,0.2402939,0
2020-05-26-170314,170314,1,0,4,453,3.4,0.19620152,1
2020-05-27-170314,170314,3,1,8,456,3.4,0.18731117,2
2020-05-28-170314,170314,3,0,5,459,5.6,0.28793955,3
2020-05-29-170314,170314,2,1,8,461,4.4,0.2923317,4
2020-05-30-170314,170314,1,0,0,462,1.0,0.037828013,5
2020-05-31-170314,170314,0,0,0,462,0.2,0.012266524,6
2020-06-01-170314,170314,6,0,3,468,4.4,0.31917262,0
2020-06-02-170314,170314,2,0,4,470,5.4,0.30084527,1
2020-06-03-170314,170314,6,0,3,476,6.2,0.32631823,2
2020-06-04-170314,170314,4,0,0,480,2.6,0.20368128,3
2020-06-05-170314,170314,7,0,1,487,7.0,0.33080336,4
2020-06-06-170314,170314,3,0,0,490,0.0,0.0043116584,5
2020-06-07-170314,170314,0,0,0,490,0.0,0.011540824,6
2020-06-08-170314,170314,0,0,2,490,5.4,0.3659896,0
2020-06-09-170314,170314,4,0,4,494,5.8,0.3385096,1
2020-06-10-170314,170314,8,0,0,502,4.6,0.38474622,2
2020-06-11-170314,170314,5,0,1,507,4.2,0.2609367,3
2020-06-12-170314,170314,8,0,2,515,2.2,0.19378279,4
2020-06-13-170314,170314,0,0,0,515,0.8,0.0149997,5
2020-06-14-170314,170314,0,5,0,515,0.2,0.01683126,6
2020-06-15-170314,170314,3,0,1,518,1.6,0.1265632,0
2020-06-16-170314,170314,4,0,0,522,2.2,0.14244427,1
2020-06-17-170314,170314,3,0,1,525,1.4,0.124839164,2
2020-06-18-170314,170314,0,0,2,525,1.6,0.089977376,3
2020-06-19-170314,170314,1,0,1,526,1.4,0.13608845,4
2020-06-20-170314,170314,0,0,0,526,0.0,0.001889228,5
2020-06-21-170314,170314,0,0,0,526,0.0,0.0022885161,6
2020-06-22-170314,170314,2,0,1,528,0.4,0.05574144,0
2020-06-23-170314,170314,4,0,0,532,0.8,0.16055954,1
2020-06-24-170314,170314,0,0,0,532,0.2,0.028303053,2
2020-06-25-170314,170314,1,0,2,533,1.4,0.11149641,3
2020-06-26-170314,170314,2,1,3,535,1.2,0.06500065,4
2020-06-27-170314,170314,0,0,2,535,0.0,0.008817803,5
2020-06-28-170314,170314,0,0,0,535,0.0,0.0003935415,6
2020-06-29-170314,170314,1,0,4,536,0.4,0.06832192,0
2020-06-30-170314,170314,0,0,2,536,0.6,0.06657795,1
2020-07-01-170314,170314,1,0,3,537,0.4,0.030681068,2
2020-07-02-170314,170314,2,0,0,539,0.2,0.021433352,3
2020-07-03-170314,170314,1,0,5,540,1.2,0.0727318,4
2020-07-04-170314,170314,0,0,0,540,0.0,0.0005164832,5
2020-07-05-170314,170314,0,0,0,540,0.2,0.014132184,6
2020-07-06-170314,170314,1,0,2,541,0.8,0.08429803,0
2020-07-07-170314,170314,0,0,1,541,2.0,0.12796561,1
2020-07-08-170314,170314,0,0,3,541,0.8,0.050597813,2
2020-07-09-170314,170314,2,3,1,543,0.6,0.10242001,3
2020-07-10-170314,170314,3,0,0,546,0.6,0.07399172,4
2020-07-11-170314,170314,2,0,0,548,0.0,0.009329812,5
2020-07-12-170314,170314,0,0,0,548,0.2,0.013547899,6
2020-07-13-170314,170314,4,0,0,552,0.8,0.101238884,0
2020-07-14-170314,170314,2,0,1,554,0.4,0.051092573,1
2020-07-15-170314,170314,3,0,1,557,1.0,0.052321058,2
2020-07-16-170314,170314,0,0,4,557,0.0,0.06628529,3
2020-07-17-170314,170314,5,0,0,562,1.0,0.12111058,4
2020-07-18-170314,170314,0,0,0,562,0.2,0.038012996,5
2020-07-19-170314,170314,0,0,0,562,0.4,0.035633285,6
2020-07-20-170314,170314,2,0,1,564,1.0,0.117998205,0
2020-07-21-170314,170314,1,0,0,565,1.0,0.084779754,1
2020-07-22-170314,170314,3,0,2,568,1.2,0.10693315,2
2020-07-23-170314,170314,1,0,0,569,0.2,0.073093414,3
2020-07-24-170314,170314,0,0,1,569,1.6,0.14089473,4
2020-07-25-170314,170314,0,0,0,569,0.2,0.00069882337,5
2020-07-26-170314,170314,0,0,0,569,1.0,0.026860341,6
2020-07-27-170314,170314,0,0,1,569,1.0,0.08116867,0
2020-07-28-170314,170314,1,0,2,570,0.2,0.09285435,1
2020-07-29-170314,170314,1,0,5,571,0.4,0.014058612,2
2020-07-30-170314,170314,4,0,4,575,1.4,0.12408191,3
2020-07-31-170314,170314,0,0,2,575,1.0,0.1025318,4
2020-08-01-170314,170314,0,0,1,575,0.4,0.008841156,5
2020-08-02-170314,170314,0,0,1,575,0.0,0.041577853,6
2020-08-03-170314,170314,1,0,0,576,1.8,0.14644049,0
2020-08-04-170314,170314,0,0,1,576,1.2,0.1682225,1
2020-08-05-170314,170314,2,0,4,578,1.2,0.17303835,2
2020-08-06-170314,170314,0,0,6,578,1.2,0.13255228,3
2020-08-07-170314,170314,1,0,6,579,0.6,0.10990432,4
2020-08-08-170314,170314,0,0,0,579,0.4,0.039447203,5
2020-08-09-170314,170314,0,0,0,579,0.2,0.029086998,6
2020-08-10-170314,170314,1,0,1,580,1.6,0.15626892,0
2020-08-11-170314,170314,2,0,7,582,1.4,0.1374187,1
2020-08-12-170314,170314,5,0,3,587,1.8,0.13395257,2
2020-08-13-170314,170314,4,0,3,591,2.0,0.108128406,3
2020-08-14-170314,170314,2,0,7,593,1.4,0.111785226,4
2020-08-15-170314,170314,1,0,6,594,0.4,0.04801224,5
2020-08-16-170314,170314,1,0,1,595,0.2,0.05285537,6
2020-08-17-170314,170314,0,0,6,595,2.2,0.18515153,0
2020-08-18-170314,170314,1,0,3,596,1.6,0.2134621,1
2020-08-19-170314,170314,4,0,4,600,2.6,0.26880932,2
2020-08-20-170314,170314,6,0,9,606,2.8,0.1876591,3
2020-08-21-170314,170314,6,0,12,612,4.8,0.4106466,4
2020-08-22-170314,170314,0,0,3,612,2.2,0.12656824,5
2020-08-23-170314,170314,0,0,9,612,1.0,0.10363934,6
2020-08-24-170314,170314,1,0,5,613,3.2,0.37985408,0
2020-08-25-170314,170314,7,0,8,620,7.6,0.6689676,1
2020-08-26-170314,170314,3,0,18,623,3.0,0.38432047,2
2020-08-27-170314,170314,3,0,22,626,5.4,0.5407911,3
2020-08-28-170314,170314,7,0,17,633,5.8,0.3661333,4
2020-08-29-170314,170314,6,0,3,639,6.0,0.29021055,5
2020-08-30-170314,170314,1,0,9,640,3.6,0.21483636,6
2020-08-31-170314,170314,6,0,17,646,8.0,0.54134494,0
2020-09-01-170314,170314,3,0,6,649,3.4,0.3620672,1
2020-09-02-170314,170314,4,0,18,653,4.4,0.3335477,2
2020-09-03-170314,170314,9,1,26,662,5.4,0.5070668,3
2020-09-04-170314,170314,12,0,16,674,6.4,0.54306036,4
2020-09-05-170314,170314,3,1,2,677,3.6,0.14910708,5
2020-09-06-170314,170314,9,0,0,686,2.2,0.25357175,6
2020-09-07-170314,170314,5,0,18,691,11.2,0.83060217,0
2020-09-08-170314,170314,8,0,16,699,11.8,0.66234034,1
2020-09-09-170314,170314,18,0,7,717,10.4,0.94598585,2
2020-09-10-170314,170314,22,0,10,739,10.2,0.9738988,3
2020-09-11-170314,170314,17,0,8,756,12.4,1.1688293,4
2020-09-12-170314,170314,3,0,1,759,4.2,0.25382575,5
2020-09-13-170314,170314,9,0,0,768,7.6,0.3905258,6
2020-09-14-170314,170314,17,0,26,785,14.0,0.7923543,0
2020-09-15-170314,170314,6,0,11,791,6.0,0.69279546,1
2020-09-16-170314,170314,18,0,17,809,14.4,1.0639402,2
2020-09-17-170314,170314,26,0,15,835,13.2,1.0361997,3
2020-09-18-170314,170314,16,0,21,851,15.2,0.9569884,4
2020-09-19-170314,170314,2,0,7,853,1.4,0.20921113,5
2020-09-20-170314,170314,0,0,3,853,2.4,0.1568617,6
2020-09-21-170314,170314,18,0,1,871,24.0,1.0782763,0
2020-09-22-170314,170314,16,2,17,887,12.4,1.0133947,1
2020-09-23-170314,170314,7,1,9,894,13.4,1.1134995,2
2020-09-24-170314,170314,10,0,18,904,14.8,1.5991385,3
2020-09-25-170314,170314,8,0,13,912,13.8,1.0558004,4
2020-09-26-170314,170314,1,0,1,913,2.8,0.2262552,5
2020-09-27-170314,170314,0,0,0,913,2.0,0.12591103,6
2020-09-28-170314,170314,26,0,5,939,18.4,1.3381097,0
2020-09-29-170314,170314,11,0,31,950,9.0,0.76656324,1
2020-09-30-170314,170314,17,0,21,967,11.4,1.1531935,2
2020-10-01-170314,170314,15,0,21,982,18.4,2.1152632,3
2020-10-02-170314,170314,21,0,20,1003,24.6,1.6870915,4
2020-10-03-170314,170314,7,0,4,1010,5.4,0.36190686,5
2020-10-04-170314,170314,3,1,4,1013,4.4,0.2461624,6
2020-10-05-170314,170314,1,0,22,1014,2.4,0.3184375,0
2020-10-06-170314,170314,17,0,20,1031,17.2,1.7821878,1
2020-10-07-170314,170314,9,2,13,1040,18.2,1.0612447,2
2020-10-08-170314,170314,18,0,23,1058,18.8,1.4066908,3
2020-10-09-170314,170314,13,5,26,1071,27.2,2.2880733,4
2020-10-10-170314,170314,1,0,7,1072,3.0,0.22891912,5
2020-10-11-170314,170314,0,0,2,1072,4.0,0.13290478,6
2020-10-12-170314,170314,5,0,36,1077,4.0,0.19716647,0
2020-10-13-170314,170314,31,0,18,1108,30.0,2.4991407,1
2020-10-14-170314,170314,21,0,19,1129,19.8,1.5980836,2
2020-10-15-170314,170314,21,0,23,1150,25.0,1.8986099,3
2020-10-16-170314,170314,20,0,17,1170,22.8,1.6227244,4
2020-10-17-170314,170314,4,0,5,1174,4.4,0.24587317,5
2020-10-18-170314,170314,4,0,0,1178,2.8,0.23217636,6
2020-10-19-170314,170314,22,1,1,1200,37.8,2.4736075,0
2020-10-20-170314,170314,20,1,36,1220,17.6,1.3649145,1
2020-10-21-170314,170314,13,0,17,1233,22.4,1.6114063,2
2020-10-22-170314,170314,23,1,23,1256,27.0,1.9206847,3
2020-10-23-170314,170314,26,1,19,1282,25.2,1.6961755,4
2020-10-24-170314,170314,7,0,0,1289,4.8,0.24326922,5
2020-10-25-170314,170314,2,0,2,1291,3.0,0.20639943,6
2020-10-26-170314,170314,36,0,33,1327,28.2,2.0101273,0
2020-10-27-170314,170314,18,1,17,1345,12.2,0.9782544,1
2020-10-28-170314,170314,19,1,26,1364,30.4,2.0848405,2
2020-10-29-170314,170314,23,2,27,1387,24.0,1.9751904,3
2020-10-30-170314,170314,17,1,17,1404,27.2,2.2533088,4
2020-10-31-170314,170314,5,0,0,1409,5.8,0.3473932,5
2020-11-01-170314,170314,0,1,0,1409,2.2,0.21382415,6
2020-11-02-170314,170314,1,2,0,1410,3.4,0.21222228,0
2020-11-03-170314,170314,36,1,0,1446,33.0,2.7925026,1
2020-11-04-170314,170314,17,2,0,1463,14.0,1.1662749,2
2020-11-05-170314,170314,23,1,0,1486,24.8,1.8489031,3
2020-11-06-170314,170314,19,5,0,1505,21.2,1.9883701,4
2020-11-07-170314,170314,0,0,0,1505,3.6,0.24374677,5
2020-11-08-170314,170314,2,0,0,1507,7.6,0.20231223,6
2020-11-09-170314,170314,33,0,0,1540,36.2,2.8090317,0
2020-11-10-170314,170314,17,1,0,1557,31.6,2.1682954,1
2020-11-11-170314,170314,26,1,0,1583,21.4,1.8181713,2
2020-11-12-170314,170314,27,2,0,1610,26.0,1.2941772,3
2020-11-13-170314,170314,17,2,0,1627,20.2,1.9252512,4
2020-03-01-170315,170315,1,0,0,1,0.0,6.216022e-05,6
2020-03-02-170315,170315,0,0,17,1,0.0,5.106328e-05,0
2020-03-03-170315,170315,0,2,11,1,0.0,3.801145e-06,1
2020-03-04-170315,170315,0,1,22,1,0.0,7.76051e-05,2
2020-03-05-170315,170315,0,0,15,1,0.0,5.6016734e-06,3
2020-03-06-170315,170315,0,0,14,1,0.0,7.777638e-05,4
2020-03-07-170315,170315,0,0,2,1,0.0,0.00024057538,5
2020-03-08-170315,170315,0,0,0,1,0.0,0.00014206795,6
2020-03-09-170315,170315,0,0,18,1,0.0,0.0032020856,0
2020-03-10-170315,170315,0,0,12,1,0.0,0.00017618436,1
2020-03-11-170315,170315,0,0,13,1,0.16666666666666666,0.00034961774,2
2020-03-12-170315,170315,1,0,5,2,0.5,0.004010988,3
2020-03-13-170315,170315,0,0,18,2,0.16666666666666666,0.002192237,4
2020-03-14-170315,170315,0,0,1,2,1.3333333333333333,0.010570031,5
2020-03-15-170315,170315,0,0,0,2,1.6666666666666667,0.0074220686,6
2020-03-16-170315,170315,17,0,11,19,12.333333333333336,0.090019405,0
2020-03-17-170315,170315,11,0,13,30,17.666666666666668,0.08919656,1
2020-03-18-170315,170315,22,0,9,52,19.33333333333333,0.105845705,2
2020-03-19-170315,170315,15,0,6,67,22.0,0.120735236,3
2020-03-20-170315,170315,14,1,10,81,18.5,0.1010168,4
2020-03-21-170315,170315,2,0,0,83,2.6666666666666665,0.015360244,5
2020-03-22-170315,170315,0,0,0,83,3.1666666666666665,0.01115684,6
2020-03-23-170315,170315,18,0,7,101,27.66666666666667,0.16068111,0
2020-03-24-170315,170315,12,0,4,113,23.0,0.10868674,1
2020-03-25-170315,170315,13,0,4,126,23.0,0.13092555,2
2020-03-26-170315,170315,5,0,2,131,25.0,0.11301212,3
2020-03-27-170315,170315,18,0,7,149,20.33333333333333,0.13096358,4
2020-03-28-170315,170315,1,0,0,150,2.833333333333333,0.010846794,5
2020-03-29-170315,170315,0,0,1,150,2.6666666666666665,0.011370251,6
2020-03-30-170315,170315,11,1,10,161,24.5,0.12780653,0
2020-03-31-170315,170315,13,0,2,174,15.833333333333336,0.072616994,1
2020-04-01-170315,170315,9,0,6,183,10.833333333333336,0.06874476,2
2020-04-02-170315,170315,6,0,4,189,10.0,0.05582329,3
2020-04-03-170315,170315,10,0,1,199,11.333333333333336,0.06183714,4
2020-04-04-170315,170315,0,0,0,199,1.8333333333333333,0.010659424,5
2020-04-05-170315,170315,0,0,0,199,2.0,0.007987834,6
2020-04-06-170315,170315,7,1,5,206,17.0,0.09039994,0
2020-04-07-170315,170315,4,0,5,210,10.666666666666666,0.064752094,1
2020-04-08-170315,170315,4,0,1,214,7.5,0.059178073,2
2020-04-09-170315,170315,2,0,1,216,9.5,0.041037187,3
2020-04-10-170315,170315,7,0,2,223,11.5,0.04924955,4
2020-04-11-170315,170315,0,1,0,223,1.5,0.008654415,5
2020-04-12-170315,170315,1,0,0,224,2.5,0.011404578,6
2020-04-13-170315,170315,10,0,1,234,14.833333333333336,0.116360076,0
2020-04-14-170315,170315,2,0,0,236,13.166666666666664,0.10163021,1
2020-04-15-170315,170315,6,0,3,242,12.666666666666664,0.08984521,2
2020-04-16-170315,170315,4,0,3,246,10.666666666666666,0.08278341,3
2020-04-17-170315,170315,1,0,0,247,9.0,0.056033347,4
2020-04-18-170315,170315,0,0,0,247,1.0,0.003824286,5
2020-04-19-170315,170315,0,0,3,247,1.1666666666666667,0.0064073703,6
2020-04-20-170315,170315,5,0,6,252,12.833333333333336,0.074637674,0
2020-04-21-170315,170315,5,0,0,257,5.833333333333332,0.04542942,1
2020-04-22-170315,170315,1,1,3,258,10.5,0.07564961,2
2020-04-23-170315,170315,1,0,3,259,2.333333333333333,0.010633351,3
2020-04-24-170315,170315,2,0,2,261,16.833333333333332,0.12401887,4
2020-04-25-170315,170315,0,0,0,261,1.6666666666666667,0.010425142,5
2020-04-26-170315,170315,0,0,0,261,0.8333333333333334,0.0031551875,6
2020-04-27-170315,170315,1,0,5,262,6.333333333333332,0.038485482,0
2020-04-28-170315,170315,0,0,3,262,4.666666666666667,0.026624843,1
2020-04-29-170315,170315,3,0,0,265,6.5,0.030296348,2
2020-04-30-170315,170315,3,0,2,268,7.333333333333332,0.0379073,3
2020-05-01-170315,170315,0,0,1,268,0.3333333333333333,0.0009439117,4
2020-05-02-170315,170315,0,0,0,268,1.3333333333333333,0.005575955,5
2020-05-03-170315,170315,3,0,0,271,0.5,0.002447459,6
2020-05-04-170315,170315,6,0,2,277,6.666666666666668,0.03851529,0
2020-05-05-170315,170315,0,0,1,277,4.833333333333333,0.033574987,1
2020-05-06-170315,170315,3,0,1,280,4.833333333333333,0.037116837,2
2020-05-07-170315,170315,3,0,2,283,4.666666666666667,0.027178237,3
2020-05-08-170315,170315,2,0,2,285,4.666666666666667,0.0413257,4
2020-05-09-170315,170315,0,0,0,285,0.8333333333333334,0.005555323,5
2020-05-10-170315,170315,0,0,0,285,0.16666666666666666,0.0004108517,6
2020-05-11-170315,170315,5,0,3,290,4.666666666666667,0.026579099,0
2020-05-12-170315,170315,3,0,0,293,4.0,0.024666218,1
2020-05-13-170315,170315,0,0,3,293,6.833333333333332,0.027644342,2
2020-05-14-170315,170315,2,1,0,295,6.333333333333332,0.051252775,3
2020-05-15-170315,170315,1,0,0,296,4.166666666666667,0.028115002,4
2020-05-16-170315,170315,0,1,1,296,0.8333333333333334,0.007570651,5
2020-05-17-170315,170315,0,0,1,296,0.16666666666666666,0.0010710914,6
2020-05-18-170315,170315,2,0,4,298,4.166666666666667,0.025559813,0
2020-05-19-170315,170315,1,0,2,299,4.666666666666667,0.033875816,1
2020-05-20-170315,170315,1,0,5,300,3.333333333333333,0.028678518,2
2020-05-21-170315,170315,2,0,2,302,5.333333333333333,0.045652412,3
2020-05-22-170315,170315,2,0,2,304,6.666666666666668,0.05733382,4
2020-05-23-170315,170315,0,0,0,304,0.8333333333333334,0.0035007787,5
2020-05-24-170315,170315,0,0,0,304,0.5,0.0036710817,6
2020-05-25-170315,170315,3,0,0,307,4.833333333333333,0.03817336,0
2020-05-26-170315,170315,0,0,1,307,2.5,0.029994274,1
2020-05-27-170315,170315,3,0,2,310,2.833333333333333,0.029091235,2
2020-05-28-170315,170315,0,0,2,310,4.333333333333333,0.045002975,3
2020-05-29-170315,170315,0,0,1,310,4.333333333333333,0.045557924,4
2020-05-30-170315,170315,1,0,0,311,0.8333333333333334,0.005390605,5
2020-05-31-170315,170315,1,0,0,312,0.5,0.0020664926,6
2020-06-01-170315,170315,4,0,0,316,5.5,0.04920521,0
2020-06-02-170315,170315,2,0,0,318,4.166666666666667,0.044757012,1
2020-06-03-170315,170315,5,0,1,323,6.0,0.05014436,2
2020-06-04-170315,170315,2,0,1,325,4.166666666666667,0.032437168,3
2020-06-05-170315,170315,2,0,0,327,5.333333333333333,0.05081953,4
2020-06-06-170315,170315,0,0,0,327,0.6666666666666666,0.0006257508,5
2020-06-07-170315,170315,0,0,0,327,0.16666666666666666,0.0019378217,6
2020-06-08-170315,170315,0,0,1,327,4.833333333333333,0.056126356,0
2020-06-09-170315,170315,1,0,0,328,4.5,0.0526134,1
2020-06-10-170315,170315,2,0,1,330,4.666666666666667,0.05758397,2
2020-06-11-170315,170315,2,0,2,332,4.166666666666667,0.03975373,3
2020-06-12-170315,170315,1,0,0,333,3.5,0.02968844,4
2020-06-13-170315,170315,0,0,0,333,0.6666666666666666,0.0024371438,5
2020-06-14-170315,170315,0,0,0,333,0.3333333333333333,0.0029543303,6
2020-06-15-170315,170315,0,1,0,333,2.0,0.019681389,0
2020-06-16-170315,170315,0,0,1,333,2.5,0.021086242,1
2020-06-17-170315,170315,1,0,0,334,1.6666666666666667,0.018278131,2
2020-06-18-170315,170315,1,1,1,335,1.3333333333333333,0.012830877,3
2020-06-19-170315,170315,0,0,0,335,1.8333333333333333,0.02109737,4
2020-06-20-170315,170315,0,0,0,335,0.0,0.00024419435,5
2020-06-21-170315,170315,0,0,0,335,0.0,0.0003493979,6
2020-06-22-170315,170315,1,0,1,336,1.0,0.008080543,0
2020-06-23-170315,170315,0,0,1,336,2.333333333333333,0.02412251,1
2020-06-24-170315,170315,1,0,0,337,0.3333333333333333,0.0044425805,2
2020-06-25-170315,170315,2,0,0,339,1.1666666666666667,0.016340112,3
2020-06-26-170315,170315,0,2,0,339,1.3333333333333333,0.009634534,4
2020-06-27-170315,170315,0,0,0,339,0.0,0.0012987384,5
2020-06-28-170315,170315,0,0,0,339,0.0,7.232363e-05,6
2020-06-29-170315,170315,0,0,0,339,0.6666666666666666,0.010424338,0
2020-06-30-170315,170315,1,0,0,340,0.3333333333333333,0.009766763,1
2020-07-01-170315,170315,0,0,1,340,0.6666666666666666,0.004735094,2
2020-07-02-170315,170315,1,0,0,341,0.3333333333333333,0.0030919185,3
2020-07-03-170315,170315,0,0,0,341,1.5,0.011116262,4
2020-07-04-170315,170315,0,0,0,341,0.0,7.58367e-05,5
2020-07-05-170315,170315,0,0,0,341,0.5,0.0023483466,6
2020-07-06-170315,170315,1,0,2,342,1.3333333333333333,0.012918075,0
2020-07-07-170315,170315,1,0,1,343,1.6666666666666667,0.019170731,1
2020-07-08-170315,170315,0,0,1,343,0.6666666666666666,0.0074757496,2
2020-07-09-170315,170315,0,1,0,343,1.1666666666666667,0.015032026,3
2020-07-10-170315,170315,0,0,2,343,1.6666666666666667,0.011332777,4
2020-07-11-170315,170315,0,0,0,343,0.6666666666666666,0.0014198249,5
2020-07-12-170315,170315,0,0,1,343,0.16666666666666666,0.0019670068,6
2020-07-13-170315,170315,0,0,0,343,1.8333333333333333,0.0155266365,0
2020-07-14-170315,170315,0,0,0,343,1.0,0.0075139594,1
2020-07-15-170315,170315,1,0,0,344,1.3333333333333333,0.00774511,2
2020-07-16-170315,170315,0,0,0,344,0.6666666666666666,0.009832472,3
2020-07-17-170315,170315,0,0,1,344,2.0,0.018177195,4
2020-07-18-170315,170315,0,0,1,344,0.16666666666666666,0.005872849,5
2020-07-19-170315,170315,0,0,0,344,0.3333333333333333,0.005584947,6
2020-07-20-170315,170315,2,0,2,346,1.8333333333333333,0.017705511,0
2020-07-21-170315,170315,1,0,0,347,0.6666666666666666,0.012672301,1
2020-07-22-170315,170315,1,0,0,348,1.8333333333333333,0.015394524,2
2020-07-23-170315,170315,0,0,2,348,0.5,0.01071916,3
2020-07-24-170315,170315,2,0,0,350,1.1666666666666667,0.020754686,4
2020-07-25-170315,170315,0,0,1,350,0.0,0.00013618547,5
2020-07-26-170315,170315,1,0,0,351,0.5,0.004481573,6
2020-07-27-170315,170315,0,0,3,351,0.8333333333333334,0.012383065,0
2020-07-28-170315,170315,0,0,0,351,1.1666666666666667,0.0137566365,1
2020-07-29-170315,170315,0,0,1,351,1.0,0.0020833397,2
2020-07-30-170315,170315,0,0,0,351,1.5,0.018758757,3
2020-07-31-170315,170315,1,0,1,352,1.1666666666666667,0.014864047,4
2020-08-01-170315,170315,1,0,0,353,0.0,0.0012739262,5
2020-08-02-170315,170315,0,0,0,353,0.0,0.005950931,6
2020-08-03-170315,170315,2,0,0,355,1.6666666666666667,0.022677174,0
2020-08-04-170315,170315,0,0,2,355,1.5,0.024801075,1
2020-08-05-170315,170315,0,0,1,355,1.8333333333333333,0.02608192,2
2020-08-06-170315,170315,2,0,2,357,0.6666666666666666,0.019160096,3
2020-08-07-170315,170315,0,0,2,357,2.0,0.016354827,4
2020-08-08-170315,170315,1,0,0,358,0.16666666666666666,0.0057315165,5
2020-08-09-170315,170315,0,0,0,358,0.0,0.0043700915,6
2020-08-10-170315,170315,3,0,1,361,1.3333333333333333,0.022362716,0
2020-08-11-170315,170315,0,0,5,361,1.8333333333333333,0.020203881,1
2020-08-12-170315,170315,1,0,2,362,2.833333333333333,0.019509485,2
2020-08-13-170315,170315,0,0,0,362,1.3333333333333333,0.015375446,3
2020-08-14-170315,170315,1,0,3,363,1.8333333333333333,0.016543431,4
2020-08-15-170315,170315,0,0,4,363,0.16666666666666666,0.006766393,5
2020-08-16-170315,170315,0,0,6,363,0.5,0.0075595076,6
2020-08-17-170315,170315,0,0,7,363,1.8333333333333333,0.028190454,0
2020-08-18-170315,170315,2,0,3,365,1.5,0.031012217,1
2020-08-19-170315,170315,1,0,4,366,3.8333333333333335,0.039893888,2
2020-08-20-170315,170315,2,0,2,368,2.333333333333333,0.027200436,3
2020-08-21-170315,170315,2,0,6,370,4.333333333333333,0.059945926,4
2020-08-22-170315,170315,0,0,6,370,1.1666666666666667,0.019089332,5
2020-08-23-170315,170315,0,0,8,370,2.0,0.016252087,6
2020-08-24-170315,170315,1,0,7,371,2.333333333333333,0.05634637,0
2020-08-25-170315,170315,5,0,9,376,7.0,0.099048026,1
2020-08-26-170315,170315,2,0,4,378,4.833333333333333,0.058856923,2
2020-08-27-170315,170315,0,0,9,378,5.333333333333333,0.07957869,3
2020-08-28-170315,170315,3,0,3,381,5.333333333333333,0.054452304,4
2020-08-29-170315,170315,4,0,3,385,5.333333333333333,0.04481866,5
2020-08-30-170315,170315,6,0,11,391,2.6666666666666665,0.033752564,6
2020-08-31-170315,170315,7,0,7,398,5.833333333333332,0.07955035,0
2020-09-01-170315,170315,3,0,5,401,3.5,0.05319554,1
2020-09-02-170315,170315,4,0,7,405,3.1666666666666665,0.05018581,2
2020-09-03-170315,170315,2,0,9,407,5.666666666666668,0.07425807,3
2020-09-04-170315,170315,6,0,9,413,6.833333333333332,0.078854986,4
2020-09-05-170315,170315,6,0,2,419,3.1666666666666665,0.023228716,5
2020-09-06-170315,170315,8,0,3,427,5.166666666666667,0.037146762,6
2020-09-07-170315,170315,7,0,8,434,9.666666666666666,0.12464979,0
2020-09-08-170315,170315,9,0,7,443,9.333333333333334,0.09880334,1
2020-09-09-170315,170315,4,0,14,447,13.5,0.14089641,2
2020-09-10-170315,170315,9,0,10,456,13.666666666666664,0.14433801,3
2020-09-11-170315,170315,3,0,6,459,15.333333333333336,0.17569798,4
2020-09-12-170315,170315,3,0,1,462,4.5,0.03683523,5
2020-09-13-170315,170315,11,0,0,473,8.5,0.06255922,6
2020-09-14-170315,170315,7,0,18,480,12.666666666666664,0.12074188,0
2020-09-15-170315,170315,5,0,7,485,9.0,0.10367531,1
2020-09-16-170315,170315,7,0,11,492,14.166666666666664,0.15775625,2
2020-09-17-170315,170315,9,0,12,501,14.833333333333336,0.15597434,3
2020-09-18-170315,170315,9,0,11,510,13.333333333333336,0.14431666,4
2020-09-19-170315,170315,2,0,10,512,4.666666666666667,0.031121688,5
2020-09-20-170315,170315,3,0,7,515,3.333333333333333,0.024507167,6
2020-09-21-170315,170315,8,1,1,523,18.666666666666668,0.16202387,0
2020-09-22-170315,170315,7,1,6,530,12.833333333333336,0.15251206,1
2020-09-23-170315,170315,14,0,10,544,13.166666666666664,0.16662116,2
2020-09-24-170315,170315,10,1,15,554,14.166666666666664,0.23500359,3
2020-09-25-170315,170315,6,1,8,560,11.666666666666664,0.1537898,4
2020-09-26-170315,170315,1,0,2,561,3.333333333333333,0.03393233,5
2020-09-27-170315,170315,0,0,3,561,2.333333333333333,0.01911302,6
2020-09-28-170315,170315,18,1,5,579,19.0,0.20198084,0
2020-09-29-170315,170315,7,0,22,586,9.166666666666666,0.113004915,1
2020-09-30-170315,170315,11,0,13,597,16.666666666666668,0.17105621,2
2020-10-01-170315,170315,12,0,15,609,23.0,0.314917,3
2020-10-02-170315,170315,11,0,15,620,23.0,0.248224,4
2020-10-03-170315,170315,10,0,6,630,5.5,0.05419872,5
2020-10-04-170315,170315,7,0,0,637,5.666666666666668,0.039536312,6
2020-10-05-170315,170315,1,0,30,638,3.1666666666666665,0.048547912,0
2020-10-06-170315,170315,6,0,6,644,21.33333333333333,0.2636659,1
2020-10-07-170315,170315,10,0,6,654,15.333333333333336,0.15912676,2
2020-10-08-170315,170315,15,1,6,669,17.666666666666668,0.2073429,3
2020-10-09-170315,170315,8,0,5,677,26.83333333333333,0.33340296,4
2020-10-10-170315,170315,2,0,6,679,4.333333333333333,0.03438409,5
2020-10-11-170315,170315,3,0,1,682,3.0,0.020079378,6
2020-10-12-170315,170315,5,0,13,687,5.5,0.029819565,0
2020-10-13-170315,170315,22,0,7,709,35.666666666666664,0.37235916,1
2020-10-14-170315,170315,13,0,11,722,20.666666666666668,0.23968428,2
2020-10-15-170315,170315,15,0,16,737,25.33333333333333,0.28158203,3
2020-10-16-170315,170315,15,0,12,752,23.16666666666667,0.24242258,4
2020-10-17-170315,170315,6,0,5,758,4.333333333333333,0.03742251,5
2020-10-18-170315,170315,0,0,1,758,6.166666666666668,0.03614709,6
2020-10-19-170315,170315,30,0,2,788,28.33333333333333,0.37211418,0
2020-10-20-170315,170315,6,0,12,794,20.166666666666668,0.20952454,1
2020-10-21-170315,170315,6,0,6,800,22.83333333333333,0.24452712,2
2020-10-22-170315,170315,6,0,7,806,27.33333333333333,0.29129112,3
2020-10-23-170315,170315,5,0,6,811,25.33333333333333,0.25665802,4
2020-10-24-170315,170315,6,1,2,817,5.666666666666668,0.037731353,5
2020-10-25-170315,170315,1,1,26,818,4.5,0.03416357,6
2020-10-26-170315,170315,13,1,26,831,28.83333333333333,0.30025345,0
2020-10-27-170315,170315,7,0,10,838,13.5,0.14412451,1
2020-10-28-170315,170315,11,1,8,849,27.5,0.31753823,2
2020-10-29-170315,170315,16,0,20,865,25.16666666666667,0.29387316,3
2020-10-30-170315,170315,12,1,3,877,24.0,0.3321141,4
2020-10-31-170315,170315,5,0,0,882,4.833333333333333,0.053808764,5
2020-11-01-170315,170315,1,1,0,883,7.833333333333332,0.033328783,6
2020-11-02-170315,170315,2,0,0,885,2.6666666666666665,0.033126086,0
2020-11-03-170315,170315,12,0,0,897,33.666666666666664,0.42038107,1
2020-11-04-170315,170315,6,0,0,903,14.166666666666664,0.17333579,2
2020-11-05-170315,170315,7,1,0,910,22.5,0.27764326,3
2020-11-06-170315,170315,6,6,0,916,24.33333333333333,0.293864,4
2020-11-07-170315,170315,2,1,0,918,2.833333333333333,0.037199933,5
2020-11-08-170315,170315,26,0,0,944,5.666666666666668,0.032182474,6
2020-11-09-170315,170315,26,0,0,970,37.5,0.4162343,0
2020-11-10-170315,170315,10,0,0,980,26.83333333333333,0.33309337,1
2020-11-11-170315,170315,8,1,0,988,20.666666666666668,0.2722051,2
2020-11-12-170315,170315,20,0,0,1008,20.83333333333333,0.19782604,3
2020-11-13-170315,170315,3,0,0,1011,21.0,0.2889176,4
2020-03-01-170316,170316,0,0,0,0,0.0,5.0219893e-07,6
2020-03-02-170316,170316,0,0,25,0,0.0,0.001086431,0
2020-03-03-170316,170316,0,0,14,0,0.0,0.00011863021,1
2020-03-04-170316,170316,2,0,21,2,0.25,0.00082441233,2
2020-03-05-170316,170316,0,0,16,2,0.0,7.262881e-09,3
2020-03-06-170316,170316,0,0,13,2,0.0,0.00074344594,4
2020-03-07-170316,170316,0,0,0,2,0.0,0.002430919,5
2020-03-08-170316,170316,0,0,5,2,0.0,0.0014020783,6
2020-03-09-170316,170316,1,0,34,3,0.25,0.022032568,0
2020-03-10-170316,170316,0,0,20,3,0.0,0.0018743346,1
2020-03-11-170316,170316,2,0,18,5,0.0,0.0035286685,2
2020-03-12-170316,170316,1,0,8,6,0.5,0.04008375,3
2020-03-13-170316,170316,2,0,9,8,0.25,0.014876177,4
2020-03-14-170316,170316,0,0,2,8,2.0,0.101075545,5
2020-03-15-170316,170316,0,0,1,8,1.75,0.06575015,6
2020-03-16-170316,170316,25,0,28,33,15.5,0.926545,0
2020-03-17-170316,170316,14,0,16,47,20.0,0.7908752,1
2020-03-18-170316,170316,21,0,17,68,26.0,0.971705,2
2020-03-19-170316,170316,16,0,11,84,22.75,1.1294999,3
2020-03-20-170316,170316,13,0,10,97,25.0,1.0284706,4
2020-03-21-170316,170316,0,0,2,97,2.25,0.14136858,5
2020-03-22-170316,170316,5,0,0,102,3.0,0.09934224,6
2020-03-23-170316,170316,34,0,17,136,36.5,1.4801922,0
2020-03-24-170316,170316,20,0,13,156,27.25,1.0396975,1
2020-03-25-170316,170316,18,0,9,174,25.75,1.2609786,2
2020-03-26-170316,170316,8,1,6,182,27.75,1.0518719,3
2020-03-27-170316,170316,9,0,11,191,21.5,1.2698488,4
2020-03-28-170316,170316,2,0,2,193,2.25,0.13820998,5
2020-03-29-170316,170316,1,0,2,194,0.25,0.1175837,6
2020-03-30-170316,170316,28,0,7,222,32.0,1.1416137,0
2020-03-31-170316,170316,16,0,9,238,14.75,0.67046094,1
2020-04-01-170316,170316,17,0,11,255,11.75,0.5957451,2
2020-04-02-170316,170316,11,0,9,266,13.25,0.53071386,3
2020-04-03-170316,170316,10,0,10,276,14.0,0.59597063,4
2020-04-04-170316,170316,2,0,3,278,1.5,0.1169479,5
2020-04-05-170316,170316,0,0,0,278,1.75,0.07676876,6
2020-04-06-170316,170316,17,0,11,295,24.0,0.96604663,0
2020-04-07-170316,170316,13,0,4,308,15.5,0.5719302,1
2020-04-08-170316,170316,9,1,5,317,11.0,0.46890816,2
2020-04-09-170316,170316,6,0,0,323,11.75,0.37521437,3
2020-04-10-170316,170316,11,0,4,334,10.5,0.61970437,4
2020-04-11-170316,170316,2,0,2,336,0.75,0.09889629,5
2020-04-12-170316,170316,2,0,0,338,2.0,0.12675495,6
2020-04-13-170316,170316,7,0,2,345,12.5,1.0803624,0
2020-04-14-170316,170316,9,0,7,354,13.25,1.0891525,1
2020-04-15-170316,170316,11,0,7,365,10.25,0.92689806,2
2020-04-16-170316,170316,9,0,2,374,13.5,0.89216894,3
2020-04-17-170316,170316,10,0,0,384,10.5,0.52424705,4
2020-04-18-170316,170316,3,0,1,387,0.75,0.01890534,5
2020-04-19-170316,170316,0,0,1,387,1.75,0.0682598,6
2020-04-20-170316,170316,11,0,3,398,17.25,0.8300251,0
2020-04-21-170316,170316,4,0,2,402,6.75,0.38539335,1
2020-04-22-170316,170316,5,1,3,407,13.25,0.6366816,2
2020-04-23-170316,170316,0,0,4,407,2.75,0.13723035,3
2020-04-24-170316,170316,4,0,2,411,21.25,1.1596411,4
2020-04-25-170316,170316,2,0,0,413,0.75,0.07998999,5
2020-04-26-170316,170316,0,0,0,413,0.5,0.03271661,6
2020-04-27-170316,170316,2,2,4,415,8.5,0.32311764,0
2020-04-28-170316,170316,7,0,7,422,4.0,0.2537629,1
2020-04-29-170316,170316,7,0,2,429,8.0,0.29169372,2
2020-04-30-170316,170316,2,1,2,431,5.25,0.36566186,3
2020-05-01-170316,170316,0,0,2,431,0.25,0.0140326405,4
2020-05-02-170316,170316,1,0,0,432,1.25,0.04332548,5
2020-05-03-170316,170316,1,0,1,433,0.5,0.022947473,6
2020-05-04-170316,170316,3,0,4,436,7.25,0.35479,0
2020-05-05-170316,170316,2,0,5,438,5.75,0.28274742,1
2020-05-06-170316,170316,3,0,7,441,5.75,0.38369676,2
2020-05-07-170316,170316,4,0,2,445,6.5,0.23216476,3
2020-05-08-170316,170316,2,0,8,447,5.5,0.39215994,4
2020-05-09-170316,170316,0,0,0,447,1.0,0.069120266,5
2020-05-10-170316,170316,0,0,1,447,0.25,0.005067415,6
2020-05-11-170316,170316,4,0,4,451,7.5,0.2563739,0
2020-05-12-170316,170316,7,0,1,458,4.25,0.19035688,1
2020-05-13-170316,170316,2,0,5,460,7.0,0.22687477,2
2020-05-14-170316,170316,2,1,2,462,6.5,0.45612288,3
2020-05-15-170316,170316,2,1,1,464,4.5,0.29650798,4
2020-05-16-170316,170316,0,0,1,464,2.0,0.060431838,5
2020-05-17-170316,170316,1,0,0,465,0.0,0.0045618345,6
2020-05-18-170316,170316,4,0,2,469,5.0,0.23370317,0
2020-05-19-170316,170316,5,0,6,474,6.75,0.31354308,1
2020-05-20-170316,170316,7,0,3,481,4.5,0.253571,2
2020-05-21-170316,170316,2,0,0,483,7.25,0.47814453,3
2020-05-22-170316,170316,8,0,5,491,9.75,0.49285877,4
2020-05-23-170316,170316,0,0,0,491,1.0,0.030193,5
2020-05-24-170316,170316,1,0,0,492,0.25,0.04143441,6
2020-05-25-170316,170316,4,0,6,496,5.0,0.3237109,0
2020-05-26-170316,170316,1,0,3,497,4.25,0.30580667,1
2020-05-27-170316,170316,5,0,4,502,3.0,0.2482697,2
2020-05-28-170316,170316,2,5,2,504,7.25,0.41502365,3
2020-05-29-170316,170316,1,1,0,505,5.75,0.4230456,4
2020-05-30-170316,170316,1,0,1,506,1.0,0.06974621,5
2020-05-31-170316,170316,0,0,0,506,0.0,0.013232023,6
2020-06-01-170316,170316,2,0,0,508,5.5,0.41377214,0
2020-06-02-170316,170316,6,0,4,514,5.25,0.42927647,1
2020-06-03-170316,170316,3,0,1,517,7.25,0.43739504,2
2020-06-04-170316,170316,0,0,0,517,3.75,0.24650185,3
2020-06-05-170316,170316,5,0,1,522,8.75,0.47431356,4
2020-06-06-170316,170316,0,0,0,522,0.75,0.0052140774,5
2020-06-07-170316,170316,0,0,0,522,0.0,0.016451139,6
2020-06-08-170316,170316,6,0,0,528,5.25,0.4770247,0
2020-06-09-170316,170316,3,0,0,531,7.25,0.4353159,1
2020-06-10-170316,170316,4,0,0,535,6.25,0.4699942,2
2020-06-11-170316,170316,2,0,1,537,5.5,0.30966204,3
2020-06-12-170316,170316,0,0,1,537,4.5,0.22090384,4
2020-06-13-170316,170316,1,0,0,538,0.75,0.022141412,5
2020-06-14-170316,170316,0,0,0,538,0.25,0.024224509,6
2020-06-15-170316,170316,0,0,0,538,2.75,0.1690264,0
2020-06-16-170316,170316,4,1,0,542,2.75,0.17993075,1
2020-06-17-170316,170316,1,0,1,543,2.0,0.17191535,2
2020-06-18-170316,170316,0,1,0,543,1.75,0.14545804,3
2020-06-19-170316,170316,1,0,1,544,1.75,0.146537,4
2020-06-20-170316,170316,0,0,0,544,0.0,0.0005509634,5
2020-06-21-170316,170316,0,0,0,544,0.0,0.0024333799,6
2020-06-22-170316,170316,0,0,0,544,0.75,0.07126813,0
2020-06-23-170316,170316,0,0,2,544,2.0,0.19089435,1
2020-06-24-170316,170316,0,0,2,544,0.0,0.038398705,2
2020-06-25-170316,170316,1,0,0,545,1.25,0.15674594,3
2020-06-26-170316,170316,1,0,0,546,1.75,0.086362444,4
2020-06-27-170316,170316,0,0,0,546,0.0,0.012453793,5
2020-06-28-170316,170316,0,0,0,546,0.0,0.001840237,6
2020-06-29-170316,170316,0,0,0,546,0.75,0.06428529,0
2020-06-30-170316,170316,0,0,0,546,0.5,0.07775245,1
2020-07-01-170316,170316,1,0,1,547,0.5,0.032905947,2
2020-07-02-170316,170316,0,0,0,547,0.5,0.02408462,3
2020-07-03-170316,170316,1,0,1,548,1.5,0.08016405,4
2020-07-04-170316,170316,0,0,0,548,0.0,0.0014845446,5
2020-07-05-170316,170316,0,0,0,548,0.25,0.015501014,6
2020-07-06-170316,170316,0,0,0,548,1.0,0.09260144,0
2020-07-07-170316,170316,2,0,1,550,1.75,0.1562997,1
2020-07-08-170316,170316,2,0,0,552,0.5,0.062563315,2
2020-07-09-170316,170316,0,0,0,552,1.25,0.12913148,3
2020-07-10-170316,170316,0,0,0,552,1.5,0.07675768,4
2020-07-11-170316,170316,0,0,1,552,0.5,0.009390841,5
2020-07-12-170316,170316,0,0,0,552,0.25,0.022492746,6
2020-07-13-170316,170316,0,0,1,552,2.0,0.11445449,0
2020-07-14-170316,170316,0,0,0,552,1.0,0.052073654,1
2020-07-15-170316,170316,1,0,2,553,1.5,0.05695979,2
2020-07-16-170316,170316,0,0,3,553,0.0,0.084826976,3
2020-07-17-170316,170316,1,0,0,554,2.25,0.13782743,4
2020-07-18-170316,170316,0,0,0,554,0.25,0.06012916,5
2020-07-19-170316,170316,0,0,0,554,0.5,0.0485862,6
2020-07-20-170316,170316,0,0,0,554,1.25,0.12007391,0
2020-07-21-170316,170316,1,0,0,555,1.0,0.09094172,1
2020-07-22-170316,170316,0,0,0,555,2.0,0.13219178,2
2020-07-23-170316,170316,0,0,0,555,0.5,0.081092924,3
2020-07-24-170316,170316,0,0,0,555,1.5,0.16419756,4
2020-07-25-170316,170316,1,0,0,556,0.0,0.002610953,5
2020-07-26-170316,170316,0,0,1,556,1.0,0.03642639,6
2020-07-27-170316,170316,1,0,1,557,1.0,0.09777069,0
2020-07-28-170316,170316,0,1,1,557,0.5,0.10475297,1
2020-07-29-170316,170316,2,0,0,559,0.25,0.015022712,2
2020-07-30-170316,170316,3,0,4,562,2.0,0.12710615,3
2020-07-31-170316,170316,0,0,1,562,1.0,0.12115552,4
2020-08-01-170316,170316,0,0,0,562,0.25,0.010204852,5
2020-08-02-170316,170316,0,0,0,562,0.0,0.039121006,6
2020-08-03-170316,170316,0,1,2,562,2.0,0.15235369,0
2020-08-04-170316,170316,0,0,1,562,1.5,0.18479398,1
2020-08-05-170316,170316,0,0,0,562,2.0,0.18785301,2
2020-08-06-170316,170316,0,0,6,562,1.0,0.15102686,3
2020-08-07-170316,170316,0,0,3,562,1.0,0.11768297,4
2020-08-08-170316,170316,0,0,5,562,0.25,0.049570095,5
2020-08-09-170316,170316,1,0,0,563,0.0,0.045042843,6
2020-08-10-170316,170316,1,0,1,564,1.25,0.18981616,0
2020-08-11-170316,170316,1,0,7,565,2.0,0.18569553,1
2020-08-12-170316,170316,0,0,4,565,3.25,0.18669006,2
2020-08-13-170316,170316,4,0,5,569,2.5,0.11410047,3
2020-08-14-170316,170316,1,0,10,570,1.75,0.12999216,4
2020-08-15-170316,170316,0,0,6,570,0.75,0.06820817,5
2020-08-16-170316,170316,0,0,2,570,0.5,0.05904086,6
2020-08-17-170316,170316,2,0,6,572,2.25,0.21958219,0
2020-08-18-170316,170316,1,0,1,573,1.5,0.20486249,1
2020-08-19-170316,170316,0,0,4,573,4.0,0.31824338,2
2020-08-20-170316,170316,6,0,4,579,3.0,0.20025301,3
2020-08-21-170316,170316,3,0,5,582,6.25,0.49067685,4
2020-08-22-170316,170316,5,0,2,587,1.5,0.15792243,5
2020-08-23-170316,170316,0,0,0,587,1.25,0.11849698,6
2020-08-24-170316,170316,1,0,6,588,3.75,0.462405,0
2020-08-25-170316,170316,7,0,11,595,8.25,0.8185896,1
2020-08-26-170316,170316,4,0,7,599,3.0,0.4291702,2
2020-08-27-170316,170316,5,0,6,604,6.25,0.6641097,3
2020-08-28-170316,170316,10,0,9,614,5.75,0.40658438,4
2020-08-29-170316,170316,6,0,4,620,6.5,0.41962495,5
2020-08-30-170316,170316,2,0,0,622,2.75,0.24932578,6
2020-08-31-170316,170316,6,0,15,628,8.25,0.690066,0
2020-09-01-170316,170316,1,0,2,629,4.0,0.38281965,1
2020-09-02-170316,170316,4,0,8,633,4.5,0.38840553,2
2020-09-03-170316,170316,4,0,3,637,7.5,0.5233852,3
2020-09-04-170316,170316,5,0,5,642,8.25,0.65140826,4
2020-09-05-170316,170316,2,0,0,644,3.25,0.22569121,5
2020-09-06-170316,170316,0,0,3,644,3.0,0.29061893,6
2020-09-07-170316,170316,6,0,13,650,12.0,1.0123422,0
2020-09-08-170316,170316,11,0,5,661,11.75,0.78121513,1
2020-09-09-170316,170316,7,0,3,668,14.75,1.2166067,2
2020-09-10-170316,170316,6,0,13,674,14.5,1.2209836,3
2020-09-11-170316,170316,9,1,13,683,16.75,1.3756838,4
2020-09-12-170316,170316,4,0,4,687,4.25,0.36528784,5
2020-09-13-170316,170316,0,0,4,687,9.0,0.4994677,6
2020-09-14-170316,170316,15,0,13,702,16.25,0.9584355,0
2020-09-15-170316,170316,2,0,7,704,7.25,0.76592404,1
2020-09-16-170316,170316,8,0,3,712,18.75,1.2521906,2
2020-09-17-170316,170316,3,0,17,715,20.0,1.3410943,3
2020-09-18-170316,170316,5,0,21,720,19.5,1.1091756,4
2020-09-19-170316,170316,0,1,2,720,1.75,0.31074676,5
2020-09-20-170316,170316,3,0,2,723,1.5,0.2184737,6
2020-09-21-170316,170316,13,1,1,736,29.25,1.2232955,0
2020-09-22-170316,170316,5,1,21,741,16.5,1.204968,1
2020-09-23-170316,170316,3,0,15,744,14.25,1.2308521,2
2020-09-24-170316,170316,13,2,18,757,15.25,1.9445357,3
2020-09-25-170316,170316,13,0,19,770,14.5,1.3559561,4
2020-09-26-170316,170316,4,0,3,774,2.5,0.28706336,5
2020-09-27-170316,170316,4,0,7,778,1.5,0.1848289,6
2020-09-28-170316,170316,13,0,4,791,21.75,1.5137353,0
2020-09-29-170316,170316,7,0,28,798,10.5,0.8676621,1
2020-09-30-170316,170316,3,0,13,801,15.0,1.323646,2
2020-10-01-170316,170316,17,0,18,818,19.5,2.6429641,3
2020-10-02-170316,170316,21,0,18,839,28.0,2.0587726,4
2020-10-03-170316,170316,2,0,1,841,5.5,0.45364773,5
2020-10-04-170316,170316,2,0,2,843,4.0,0.30908442,6
2020-10-05-170316,170316,1,1,32,844,2.75,0.45497078,0
2020-10-06-170316,170316,21,0,9,865,19.0,2.129033,1
2020-10-07-170316,170316,15,1,21,880,18.75,1.2227229,2
2020-10-08-170316,170316,18,0,5,898,19.75,1.7420803,3
2020-10-09-170316,170316,19,4,28,917,30.5,3.0173461,4
2020-10-10-170316,170316,3,0,3,920,2.75,0.32951888,5
2020-10-11-170316,170316,7,0,2,927,2.5,0.2108686,6
2020-10-12-170316,170316,4,0,29,931,4.0,0.2377044,0
2020-10-13-170316,170316,28,0,6,959,32.75,2.971817,1
2020-10-14-170316,170316,13,0,18,972,23.5,1.9389327,2
2020-10-15-170316,170316,18,0,21,990,28.25,2.1595838,3
2020-10-16-170316,170316,18,0,14,1008,25.25,2.023306,4
2020-10-17-170316,170316,1,0,8,1009,4.75,0.34431216,5
2020-10-18-170316,170316,2,1,5,1011,4.0,0.30351004,6
2020-10-19-170316,170316,32,1,5,1043,37.25,3.0167778,0
2020-10-20-170316,170316,9,0,34,1052,23.25,1.5883152,1
2020-10-21-170316,170316,21,0,19,1073,24.5,1.9302179,2
2020-10-22-170316,170316,5,1,29,1078,36.75,2.258599,3
2020-10-23-170316,170316,28,0,23,1106,29.75,2.0018084,4
2020-10-24-170316,170316,3,0,8,1109,5.5,0.3300723,5
2020-10-25-170316,170316,2,0,3,1111,3.5,0.24313514,6
2020-10-26-170316,170316,29,0,22,1140,33.75,2.4867,0
2020-10-27-170316,170316,6,1,25,1146,16.5,1.1114641,1
2020-10-28-170316,170316,18,1,19,1164,35.5,2.3988261,2
2020-10-29-170316,170316,21,0,34,1185,26.5,2.3639185,3
2020-10-30-170316,170316,14,1,16,1199,31.75,2.6942692,4
2020-10-31-170316,170316,8,0,0,1207,5.25,0.45736885,5
2020-11-01-170316,170316,5,1,0,1212,1.25,0.22857262,6
2020-11-02-170316,170316,5,0,0,1217,2.75,0.27451617,0
2020-11-03-170316,170316,34,1,0,1251,38.75,3.336081,1
2020-11-04-170316,170316,19,1,0,1270,15.5,1.3940531,2
2020-11-05-170316,170316,29,0,0,1299,27.75,2.2122777,3
2020-11-06-170316,170316,23,4,0,1322,24.0,2.32504,4
2020-11-07-170316,170316,8,2,0,1330,2.0,0.29093844,5
2020-11-08-170316,170316,3,0,0,1333,2.75,0.30387524,6
2020-11-09-170316,170316,22,1,0,1355,41.5,3.398129,0
2020-11-10-170316,170316,25,2,0,1380,35.0,2.526833,1
2020-11-11-170316,170316,19,2,0,1399,26.5,2.1142008,2
2020-11-12-170316,170316,34,2,0,1433,25.75,1.5562773,3
2020-11-13-170316,170316,16,1,0,1449,24.75,2.068269,4
2020-03-01-170317,170317,0,0,3,0,0.125,0.00029344388,6
2020-03-02-170317,170317,0,0,33,0,0.0,0.0011301844,0
2020-03-03-170317,170317,0,0,19,0,0.0,0.00020760443,1
2020-03-04-170317,170317,0,2,21,0,0.25,0.0018792516,2
2020-03-05-170317,170317,0,0,23,0,0.0,0.00029516878,3
2020-03-06-170317,170317,0,0,21,0,0.0,0.0008040721,4
2020-03-07-170317,170317,0,0,2,0,0.0,0.0020004504,5
2020-03-08-170317,170317,0,0,6,0,0.0,0.0010460567,6
2020-03-09-170317,170317,0,0,37,0,0.125,0.04111774,0
2020-03-10-170317,170317,0,1,23,0,0.0,0.0033906293,1
2020-03-11-170317,170317,0,0,22,0,0.25,0.0060420292,2
2020-03-12-170317,170317,0,0,20,0,0.625,0.081800394,3
2020-03-13-170317,170317,0,0,21,0,0.375,0.025247935,4
2020-03-14-170317,170317,3,0,2,3,0.5,0.13608766,5
2020-03-15-170317,170317,3,0,0,6,0.5,0.17345013,6
2020-03-16-170317,170317,33,0,30,39,9.0,2.0790415,0
2020-03-17-170317,170317,19,0,12,58,8.0,1.577498,1
2020-03-18-170317,170317,21,0,11,79,13.375,1.9201266,2
2020-03-19-170317,170317,23,0,11,102,12.375,2.4256718,3
2020-03-20-170317,170317,21,0,13,123,12.125,2.3757882,4
2020-03-21-170317,170317,2,0,2,125,1.5,0.31219745,5
2020-03-22-170317,170317,6,0,2,131,1.125,0.2666345,6
2020-03-23-170317,170317,37,0,42,168,16.375,3.0752397,0
2020-03-24-170317,170317,23,1,12,191,13.625,2.21033,1
2020-03-25-170317,170317,22,0,6,213,14.5,2.662646,2
2020-03-26-170317,170317,20,1,13,233,11.25,1.7304415,3
2020-03-27-170317,170317,21,0,9,254,12.125,2.5215092,4
2020-03-28-170317,170317,2,0,0,256,1.75,0.36208865,5
2020-03-29-170317,170317,0,0,2,256,1.625,0.41391623,6
2020-03-30-170317,170317,30,0,10,286,16.0,1.9471,0
2020-03-31-170317,170317,12,0,21,298,9.25,1.3671291,1
2020-04-01-170317,170317,11,0,10,309,7.625,1.2203556,2
2020-04-02-170317,170317,11,0,19,320,6.875,1.0705162,3
2020-04-03-170317,170317,13,0,15,333,8.0,1.2007716,4
2020-04-04-170317,170317,2,0,0,335,1.375,0.30130967,5
2020-04-05-170317,170317,2,0,2,337,1.0,0.15576504,6
2020-04-06-170317,170317,42,0,34,379,8.125,1.9801052,0
2020-04-07-170317,170317,12,0,7,391,7.0,1.1699094,1
2020-04-08-170317,170317,6,0,7,397,4.5,0.95861334,2
2020-04-09-170317,170317,13,2,10,410,4.625,0.6809612,3
2020-04-10-170317,170317,9,0,21,419,9.125,1.6884023,4
2020-04-11-170317,170317,0,0,2,419,1.25,0.25785843,5
2020-04-12-170317,170317,2,0,0,421,1.875,0.34332284,6
2020-04-13-170317,170317,10,0,8,431,9.125,2.442344,0
2020-04-14-170317,170317,21,0,3,452,6.25,2.5298128,1
2020-04-15-170317,170317,10,0,6,462,8.0,2.3030093,2
2020-04-16-170317,170317,19,0,6,481,5.875,2.122898,3
2020-04-17-170317,170317,15,0,1,496,4.25,0.9636613,4
2020-04-18-170317,170317,0,0,2,496,0.75,0.04150084,5
2020-04-19-170317,170317,2,0,2,498,0.75,0.10272483,6
2020-04-20-170317,170317,34,0,5,532,5.5,1.6066291,0
2020-04-21-170317,170317,7,1,2,539,3.75,0.88511693,1
2020-04-22-170317,170317,7,0,7,546,6.75,0.9356638,2
2020-04-23-170317,170317,10,0,4,556,0.375,0.3451984,3
2020-04-24-170317,170317,21,0,5,577,9.5,1.6866302,4
2020-04-25-170317,170317,2,0,2,579,0.375,0.20156673,5
2020-04-26-170317,170317,0,0,0,579,0.375,0.07386556,6
2020-04-27-170317,170317,8,0,4,587,2.875,0.541504,0
2020-04-28-170317,170317,3,0,0,590,3.25,0.6052599,1
2020-04-29-170317,170317,6,0,1,596,4.0,0.52871174,2
2020-04-30-170317,170317,6,0,4,602,3.375,0.67596096,3
2020-05-01-170317,170317,1,0,9,603,0.125,0.037987486,4
2020-05-02-170317,170317,2,0,0,605,0.25,0.086479306,5
2020-05-03-170317,170317,2,0,0,607,0.5,0.06838328,6
2020-05-04-170317,170317,5,1,4,612,4.0,0.6171403,0
2020-05-05-170317,170317,2,0,5,614,3.0,0.5459283,1
2020-05-06-170317,170317,7,0,5,621,2.875,0.7504495,2
2020-05-07-170317,170317,4,0,10,625,3.0,0.47110078,3
2020-05-08-170317,170317,5,0,10,630,3.125,0.7667313,4
2020-05-09-170317,170317,2,0,0,632,0.25,0.15713596,5
2020-05-10-170317,170317,0,2,0,632,0.375,0.049430717,6
2020-05-11-170317,170317,4,2,1,636,3.25,0.50792044,0
2020-05-12-170317,170317,0,0,5,636,3.125,0.26105022,1
2020-05-13-170317,170317,1,0,2,637,2.625,0.30759737,2
2020-05-14-170317,170317,4,0,5,641,4.0,0.944963,3
2020-05-15-170317,170317,9,1,6,650,1.5,0.57236266,4
2020-05-16-170317,170317,0,1,3,650,0.75,0.089814946,5
2020-05-17-170317,170317,0,0,0,650,0.125,0.021387998,6
2020-05-18-170317,170317,4,0,5,654,2.5,0.40291548,0
2020-05-19-170317,170317,5,0,4,659,2.875,0.57157004,1
2020-05-20-170317,170317,5,0,10,664,2.25,0.44975647,2
2020-05-21-170317,170317,10,0,1,674,2.625,0.91682386,3
2020-05-22-170317,170317,10,0,7,684,3.75,0.75257945,4
2020-05-23-170317,170317,0,0,0,684,0.5,0.03883979,5
2020-05-24-170317,170317,0,0,0,684,0.625,0.105121545,6
2020-05-25-170317,170317,1,0,5,685,3.75,0.547865,0
2020-05-26-170317,170317,5,0,4,690,1.25,0.5120537,1
2020-05-27-170317,170317,2,0,1,692,2.25,0.5372409,2
2020-05-28-170317,170317,5,0,4,697,2.375,0.6331984,3
2020-05-29-170317,170317,6,0,1,703,2.125,0.61966693,4
2020-05-30-170317,170317,3,0,0,706,0.375,0.1533169,5
2020-05-31-170317,170317,0,0,0,706,0.125,0.026508844,6
2020-06-01-170317,170317,5,0,1,711,2.875,0.679196,0
2020-06-02-170317,170317,4,0,2,715,2.75,0.84993505,1
2020-06-03-170317,170317,10,0,0,725,3.125,0.68550324,2
2020-06-04-170317,170317,1,0,4,726,2.125,0.34577915,3
2020-06-05-170317,170317,7,0,1,733,3.75,0.78344536,4
2020-06-06-170317,170317,0,0,0,733,0.375,0.012417409,5
2020-06-07-170317,170317,0,0,0,733,0.0,0.019037979,6
2020-06-08-170317,170317,5,0,1,738,2.875,0.73056006,0
2020-06-09-170317,170317,4,0,0,742,3.0,0.6867081,1
2020-06-10-170317,170317,1,0,0,743,4.0,0.90359795,2
2020-06-11-170317,170317,4,0,1,747,2.25,0.515034,3
2020-06-12-170317,170317,1,0,0,748,1.875,0.3796301,4
2020-06-13-170317,170317,0,0,0,748,0.375,0.025600605,5
2020-06-14-170317,170317,0,0,0,748,0.25,0.034339935,6
2020-06-15-170317,170317,1,0,0,749,1.25,0.27625865,0
2020-06-16-170317,170317,2,0,1,751,1.5,0.3067145,1
2020-06-17-170317,170317,0,0,0,751,1.5,0.35266116,2
2020-06-18-170317,170317,4,0,0,755,0.375,0.30987898,3
2020-06-19-170317,170317,1,0,0,756,0.875,0.18819365,4
2020-06-20-170317,170317,0,0,0,756,0.0,0.0019806721,5
2020-06-21-170317,170317,0,0,0,756,0.0,0.0036690854,6
2020-06-22-170317,170317,1,0,0,757,0.625,0.17039509,0
2020-06-23-170317,170317,0,0,3,757,1.0,0.33686188,1
2020-06-24-170317,170317,0,0,1,757,0.125,0.10392731,2
2020-06-25-170317,170317,1,1,1,758,0.75,0.30618694,3
2020-06-26-170317,170317,0,1,0,758,0.875,0.13316257,4
2020-06-27-170317,170317,0,0,0,758,0.0,0.013672251,5
2020-06-28-170317,170317,0,0,1,758,0.0,0.0018797801,6
2020-06-29-170317,170317,0,0,0,758,0.375,0.09008035,0
2020-06-30-170317,170317,1,0,0,759,0.25,0.13395363,1
2020-07-01-170317,170317,0,0,1,759,0.375,0.042995505,2
2020-07-02-170317,170317,0,0,0,759,0.375,0.050575018,3
2020-07-03-170317,170317,0,0,0,759,0.625,0.112892546,4
2020-07-04-170317,170317,0,0,0,759,0.0,0.0012169782,5
2020-07-05-170317,170317,0,0,0,759,0.125,0.01795699,6
2020-07-06-170317,170317,0,0,2,759,0.625,0.13206072,0
2020-07-07-170317,170317,3,0,0,762,0.875,0.24276297,1
2020-07-08-170317,170317,1,0,3,763,0.375,0.11477806,2
2020-07-09-170317,170317,1,1,1,764,0.625,0.23674594,3
2020-07-10-170317,170317,0,0,2,764,0.75,0.111574,4
2020-07-11-170317,170317,0,0,0,764,0.25,0.017602827,5
2020-07-12-170317,170317,1,0,0,765,0.0,0.04807567,6
2020-07-13-170317,170317,0,0,1,765,1.125,0.14501446,0
2020-07-14-170317,170317,0,0,0,765,0.625,0.07600588,1
2020-07-15-170317,170317,1,0,0,766,0.875,0.101910464,2
2020-07-16-170317,170317,0,0,0,766,0.25,0.1437546,3
2020-07-17-170317,170317,0,0,1,766,1.5,0.22740015,4
2020-07-18-170317,170317,0,0,0,766,0.375,0.12571818,5
2020-07-19-170317,170317,0,0,0,766,0.375,0.07114566,6
2020-07-20-170317,170317,2,0,0,768,0.75,0.2273192,0
2020-07-21-170317,170317,0,0,1,768,1.125,0.22370991,1
2020-07-22-170317,170317,3,1,0,771,0.5,0.2445641,2
2020-07-23-170317,170317,1,0,2,772,0.625,0.20158005,3
2020-07-24-170317,170317,2,0,2,774,0.75,0.25064707,4
2020-07-25-170317,170317,0,0,0,774,0.125,0.0032220767,5
2020-07-26-170317,170317,0,0,0,774,0.5,0.036187902,6
2020-07-27-170317,170317,1,0,2,775,0.5,0.13461384,0
2020-07-28-170317,170317,0,0,3,775,0.375,0.2199297,1
2020-07-29-170317,170317,0,0,4,775,0.5,0.035365183,2
2020-07-30-170317,170317,0,0,0,775,1.375,0.17490305,3
2020-07-31-170317,170317,1,0,1,776,0.625,0.20219505,4
2020-08-01-170317,170317,0,0,0,776,0.125,0.011800515,5
2020-08-02-170317,170317,0,0,0,776,0.0,0.062426385,6
2020-08-03-170317,170317,0,0,2,776,1.375,0.21950017,0
2020-08-04-170317,170317,1,0,0,777,0.75,0.3451772,1
2020-08-05-170317,170317,0,0,3,777,1.25,0.30302155,2
2020-08-06-170317,170317,2,0,2,779,0.375,0.28861794,3
2020-08-07-170317,170317,2,0,6,781,0.25,0.20726255,4
2020-08-08-170317,170317,0,0,0,781,0.25,0.07442496,5
2020-08-09-170317,170317,0,0,0,781,0.125,0.07271679,6
2020-08-10-170317,170317,2,0,3,783,1.125,0.3553134,0
2020-08-11-170317,170317,3,0,8,786,1.0,0.37365878,1
2020-08-12-170317,170317,4,0,0,790,1.375,0.30529085,2
2020-08-13-170317,170317,0,0,2,790,1.625,0.3000363,3
2020-08-14-170317,170317,1,0,4,791,1.125,0.20132259,4
2020-08-15-170317,170317,0,0,2,791,0.125,0.11039049,5
2020-08-16-170317,170317,0,0,1,791,0.25,0.12459069,6
2020-08-17-170317,170317,2,0,7,793,1.125,0.33570707,0
2020-08-18-170317,170317,0,0,5,793,0.875,0.3117263,1
2020-08-19-170317,170317,3,0,2,796,2.0,0.55440843,2
2020-08-20-170317,170317,2,0,4,798,1.75,0.40686193,3
2020-08-21-170317,170317,6,0,6,804,3.125,1.0996838,4
2020-08-22-170317,170317,0,0,1,804,1.375,0.23948598,5
2020-08-23-170317,170317,0,0,2,804,0.75,0.20686042,6
2020-08-24-170317,170317,3,0,10,807,1.375,1.0784062,0
2020-08-25-170317,170317,8,0,11,815,5.0,1.6238991,1
2020-08-26-170317,170317,0,0,11,815,2.625,0.88201034,2
2020-08-27-170317,170317,2,0,9,817,3.5,1.2380887,3
2020-08-28-170317,170317,4,0,10,821,3.875,0.7522756,4
2020-08-29-170317,170317,2,0,4,823,4.25,0.74945754,5
2020-08-30-170317,170317,1,0,4,824,2.0,0.40590826,6
2020-08-31-170317,170317,7,0,3,831,4.75,1.2695996,0
2020-09-01-170317,170317,5,0,4,836,1.875,0.69632435,1
2020-09-02-170317,170317,2,0,16,838,2.75,0.6953551,2
2020-09-03-170317,170317,4,0,9,842,3.5,0.8802943,3
2020-09-04-170317,170317,6,0,8,848,5.75,1.2171501,4
2020-09-05-170317,170317,1,0,3,849,3.5,0.4677122,5
2020-09-06-170317,170317,2,0,2,851,3.125,0.5693774,6
2020-09-07-170317,170317,10,0,15,861,6.25,1.5965902,0
2020-09-08-170317,170317,11,0,12,872,6.75,1.2313175,1
2020-09-09-170317,170317,11,0,8,883,7.375,2.1941257,2
2020-09-10-170317,170317,9,0,12,892,8.875,2.310108,3
2020-09-11-170317,170317,10,0,15,902,8.375,2.3534915,4
2020-09-12-170317,170317,4,0,0,906,3.125,0.7404742,5
2020-09-13-170317,170317,4,0,4,910,5.25,0.6072757,6
2020-09-14-170317,170317,3,0,12,913,9.875,1.672859,0
2020-09-15-170317,170317,4,0,7,917,4.625,1.3152443,1
2020-09-16-170317,170317,16,0,8,933,9.25,2.2468119,2
2020-09-17-170317,170317,9,0,18,942,10.375,2.181145,3
2020-09-18-170317,170317,8,0,19,950,9.625,1.5769078,4
2020-09-19-170317,170317,3,1,2,953,1.5,0.5798314,5
2020-09-20-170317,170317,2,0,1,955,1.75,0.37030372,6
2020-09-21-170317,170317,15,1,6,970,11.375,1.8471934,0
2020-09-22-170317,170317,12,0,12,982,8.0,1.9779505,1
2020-09-23-170317,170317,8,0,19,990,8.375,2.1128802,2
2020-09-24-170317,170317,12,1,15,1002,10.0,3.7019994,3
2020-09-25-170317,170317,15,0,61,1017,7.0,2.515906,4
2020-09-26-170317,170317,0,0,3,1017,2.125,0.4341342,5
2020-09-27-170317,170317,4,0,4,1021,1.125,0.33282197,6
2020-09-28-170317,170317,12,0,2,1033,13.375,2.2846181,0
2020-09-29-170317,170317,7,0,36,1040,6.0,1.5007128,1
2020-09-30-170317,170317,8,0,15,1048,10.625,2.7241743,2
2020-10-01-170317,170317,18,0,14,1066,14.0,4.665109,3
2020-10-02-170317,170317,19,0,16,1085,16.0,3.276209,4
2020-10-03-170317,170317,2,0,1,1087,4.5,0.7962467,5
2020-10-04-170317,170317,1,2,4,1088,3.5,0.5685714,6
2020-10-05-170317,170317,6,0,39,1094,1.25,0.94897497,0
2020-10-06-170317,170317,12,0,13,1106,14.375,3.8679717,1
2020-10-07-170317,170317,19,2,23,1125,9.5,2.0421808,2
2020-10-08-170317,170317,15,1,20,1140,12.75,3.3262155,3
2020-10-09-170317,170317,61,5,16,1201,11.625,5.4048657,4
2020-10-10-170317,170317,3,0,2,1204,3.125,0.80121493,5
2020-10-11-170317,170317,4,0,1,1208,2.5,0.41629434,6
2020-10-12-170317,170317,2,0,28,1210,2.875,0.605421,0
2020-10-13-170317,170317,36,0,12,1246,20.25,5.0117154,1
2020-10-14-170317,170317,15,0,25,1261,14.125,3.3828237,2
2020-10-15-170317,170317,14,0,26,1275,16.875,3.8855555,3
2020-10-16-170317,170317,16,0,42,1291,14.0,3.762371,4
2020-10-17-170317,170317,1,0,0,1292,4.375,0.9441098,5
2020-10-18-170317,170317,4,2,1,1296,2.375,0.6535148,6
2020-10-19-170317,170317,39,1,0,1335,21.5,4.887861,0
2020-10-20-170317,170317,13,1,35,1348,11.25,2.6692207,1
2020-10-21-170317,170317,23,2,12,1371,13.5,3.0974422,2
2020-10-22-170317,170317,20,2,27,1391,17.125,3.626742,3
2020-10-23-170317,170317,16,0,17,1407,15.0,3.6708257,4
2020-10-24-170317,170317,2,1,1,1409,4.125,0.7665939,5
2020-10-25-170317,170317,1,1,3,1410,2.25,0.48867187,6
2020-10-26-170317,170317,28,0,47,1438,19.0,4.2783866,0
2020-10-27-170317,170317,12,1,22,1450,7.5,2.2248306,1
2020-10-28-170317,170317,25,1,18,1475,16.375,3.2744389,2
2020-10-29-170317,170317,26,0,12,1501,17.75,4.0376086,3
2020-10-30-170317,170317,42,1,22,1543,13.625,4.9059715,4
2020-10-31-170317,170317,0,0,0,1543,4.25,0.7278293,5
2020-11-01-170317,170317,1,1,0,1544,1.625,0.5280879,6
2020-11-02-170317,170317,0,2,0,1544,2.5,0.58072793,0
2020-11-03-170317,170317,35,0,0,1579,20.375,5.5092936,1
2020-11-04-170317,170317,12,1,0,1591,9.375,2.698804,2
2020-11-05-170317,170317,27,1,0,1618,15.25,3.59393,3
2020-11-06-170317,170317,17,1,0,1635,16.25,4.091176,4
2020-11-07-170317,170317,1,0,0,1636,1.875,0.6430474,5
2020-11-08-170317,170317,3,1,0,1639,7.0,0.66667694,6
2020-11-09-170317,170317,47,0,0,1686,24.0,6.6780796,0
2020-11-10-170317,170317,22,0,0,1708,18.375,3.854426,1
2020-11-11-170317,170317,18,1,0,1726,14.0,3.524139,2
2020-11-12-170317,170317,12,1,0,1738,18.75,2.5723126,3
2020-11-13-170317,170317,22,3,0,1760,13.0,3.6122036,4
2020-03-01-170318,170318,0,0,0,0,0.0,4.097928e-08,6
2020-03-02-170318,170318,0,0,2,0,0.0,0.00039538855,0
2020-03-03-170318,170318,0,1,2,0,0.0,0.0010237277,1
2020-03-04-170318,170318,0,3,1,0,0.0,0.00058532954,2
2020-03-05-170318,170318,0,0,8,0,0.0,1.806863e-05,3
2020-03-06-170318,170318,0,0,8,0,0.0,0.00045908688,4
2020-03-07-170318,170318,0,0,0,0,0.0,0.0001491086,5
2020-03-08-170318,170318,0,0,0,0,0.0,0.00027073026,6
2020-03-09-170318,170318,0,0,1,0,0.16666666666666666,0.06473503,0
2020-03-10-170318,170318,0,0,4,0,0.0,0.0008078436,1
2020-03-11-170318,170318,0,0,4,0,0.0,0.010486248,2
2020-03-12-170318,170318,0,0,1,0,0.16666666666666666,0.014537361,3
2020-03-13-170318,170318,0,0,2,0,0.0,0.011339546,4
2020-03-14-170318,170318,0,0,2,0,0.5,0.015291356,5
2020-03-15-170318,170318,0,0,0,0,0.6666666666666666,0.061077278,6
2020-03-16-170318,170318,2,0,2,2,8.5,0.70372534,0
2020-03-17-170318,170318,2,0,0,4,5.166666666666667,0.578717,1
2020-03-18-170318,170318,1,0,3,5,7.333333333333332,0.79120606,2
2020-03-19-170318,170318,8,0,0,13,7.0,1.1794169,3
2020-03-20-170318,170318,8,0,1,21,7.0,1.0509,4
2020-03-21-170318,170318,0,0,2,21,1.5,0.23044167,5
2020-03-22-170318,170318,0,3,0,21,1.5,0.14973472,6
2020-03-23-170318,170318,1,0,4,22,11.333333333333336,1.1867971,0
2020-03-24-170318,170318,4,0,4,26,7.666666666666668,1.0148723,1
2020-03-25-170318,170318,4,0,1,30,9.0,1.2204021,2
2020-03-26-170318,170318,1,0,3,31,5.0,0.5431227,3
2020-03-27-170318,170318,2,0,2,33,8.166666666666666,0.78806907,4
2020-03-28-170318,170318,2,0,0,35,1.3333333333333333,0.28134143,5
2020-03-29-170318,170318,0,0,0,35,1.8333333333333333,0.09625237,6
2020-03-30-170318,170318,2,0,3,37,6.666666666666668,0.45756263,0
2020-03-31-170318,170318,0,0,3,37,5.333333333333333,0.5677226,1
2020-04-01-170318,170318,3,0,2,40,4.333333333333333,0.83665824,2
2020-04-02-170318,170318,0,0,1,40,3.5,0.18300027,3
2020-04-03-170318,170318,1,0,0,41,4.833333333333333,0.46306434,4
2020-04-04-170318,170318,2,0,0,43,1.0,0.23323198,5
2020-04-05-170318,170318,0,0,0,43,0.8333333333333334,0.045230906,6
2020-04-06-170318,170318,4,0,0,47,8.666666666666666,0.5951554,0
2020-04-07-170318,170318,4,1,1,51,3.6666666666666665,0.5706768,1
2020-04-08-170318,170318,1,1,3,52,2.6666666666666665,0.5569289,2
2020-04-09-170318,170318,3,0,0,55,2.6666666666666665,0.22336483,3
2020-04-10-170318,170318,2,0,0,57,8.166666666666666,0.43362963,4
2020-04-11-170318,170318,0,0,0,57,1.1666666666666667,0.12318718,5
2020-04-12-170318,170318,0,0,0,57,1.6666666666666667,0.08600143,6
2020-04-13-170318,170318,3,1,0,60,6.5,0.56977826,0
2020-04-14-170318,170318,3,0,2,63,8.333333333333334,1.0808138,1
2020-04-15-170318,170318,2,0,0,65,6.0,0.51149434,2
2020-04-16-170318,170318,1,0,0,66,6.0,0.3864301,3
2020-04-17-170318,170318,0,0,0,66,3.5,0.22769733,4
2020-04-18-170318,170318,0,0,0,66,0.16666666666666666,0.05230465,5
2020-04-19-170318,170318,0,0,0,66,0.5,0.013344656,6
2020-04-20-170318,170318,0,2,0,66,6.833333333333332,0.31832257,0
2020-04-21-170318,170318,1,0,2,67,2.333333333333333,0.3060263,1
2020-04-22-170318,170318,3,0,0,70,1.8333333333333333,0.3699467,2
2020-04-23-170318,170318,0,0,1,70,1.8333333333333333,0.022361701,3
2020-04-24-170318,170318,0,0,0,70,5.333333333333333,0.3877382,4
2020-04-25-170318,170318,0,0,0,70,1.0,0.21567422,5
2020-04-26-170318,170318,0,0,0,70,0.5,0.08894329,6
2020-04-27-170318,170318,0,0,1,70,1.8333333333333333,0.19935289,0
2020-04-28-170318,170318,2,0,0,72,1.5,0.33584595,1
2020-04-29-170318,170318,0,0,0,72,1.8333333333333333,0.21033974,2
2020-04-30-170318,170318,0,0,3,72,2.1666666666666665,0.11630399,3
2020-05-01-170318,170318,0,0,0,72,0.3333333333333333,0.01245425,4
2020-05-02-170318,170318,0,0,0,72,0.5,0.06083814,5
2020-05-03-170318,170318,0,0,0,72,0.5,0.076000795,6
2020-05-04-170318,170318,0,0,0,72,1.6666666666666667,0.16807911,0
2020-05-05-170318,170318,2,0,1,74,1.1666666666666667,0.43325293,1
2020-05-06-170318,170318,0,0,1,74,3.1666666666666665,0.3828654,2
2020-05-07-170318,170318,1,0,1,75,1.5,0.49043444,3
2020-05-08-170318,170318,0,0,0,75,2.1666666666666665,0.2281409,4
2020-05-09-170318,170318,0,0,0,75,0.8333333333333334,0.12282837,5
2020-05-10-170318,170318,0,0,0,75,0.16666666666666666,0.041123945,6
2020-05-11-170318,170318,1,1,1,76,1.3333333333333333,0.24875072,0
2020-05-12-170318,170318,0,0,0,76,0.3333333333333333,0.09402,1
2020-05-13-170318,170318,0,0,0,76,0.8333333333333334,0.21199864,2
2020-05-14-170318,170318,3,2,0,79,2.1666666666666665,0.49312043,3
2020-05-15-170318,170318,0,0,0,79,2.0,0.052333962,4
2020-05-16-170318,170318,0,0,0,79,0.3333333333333333,0.08215519,5
2020-05-17-170318,170318,0,0,0,79,0.16666666666666666,0.04896994,6
2020-05-18-170318,170318,0,0,0,79,1.0,0.14488295,0
2020-05-19-170318,170318,1,0,1,80,1.1666666666666667,0.2559334,1
2020-05-20-170318,170318,1,0,0,81,1.0,0.19069415,2
2020-05-21-170318,170318,1,0,0,82,2.6666666666666665,0.23326114,3
2020-05-22-170318,170318,0,0,0,82,2.1666666666666665,0.19690752,4
2020-05-23-170318,170318,0,0,0,82,0.16666666666666666,0.084311716,5
2020-05-24-170318,170318,0,0,0,82,0.3333333333333333,0.008439437,6
2020-05-25-170318,170318,1,0,0,83,1.0,0.19397916,0
2020-05-26-170318,170318,0,0,2,83,1.1666666666666667,0.15949567,1
2020-05-27-170318,170318,0,0,2,83,1.0,0.51070106,2
2020-05-28-170318,170318,0,1,0,83,1.3333333333333333,0.14161152,3
2020-05-29-170318,170318,0,0,0,83,1.3333333333333333,0.10171827,4
2020-05-30-170318,170318,0,0,0,83,0.6666666666666666,0.08742724,5
2020-05-31-170318,170318,0,0,0,83,0.16666666666666666,0.034594648,6
2020-06-01-170318,170318,0,0,1,83,1.5,0.22974327,0
2020-06-02-170318,170318,1,0,0,84,1.5,0.22938494,1
2020-06-03-170318,170318,0,1,0,84,1.6666666666666667,0.07286921,2
2020-06-04-170318,170318,0,0,0,84,0.16666666666666666,0.0656083,3
2020-06-05-170318,170318,0,0,0,84,2.0,0.1905041,4
2020-06-06-170318,170318,0,0,0,84,0.0,0.010984088,5
2020-06-07-170318,170318,0,0,0,84,0.0,0.008979774,6
2020-06-08-170318,170318,0,0,1,84,1.6666666666666667,0.30260444,0
2020-06-09-170318,170318,2,0,0,86,1.0,0.34044644,1
2020-06-10-170318,170318,2,0,0,88,1.3333333333333333,0.47415385,2
2020-06-11-170318,170318,0,0,0,88,0.8333333333333334,0.1803064,3
2020-06-12-170318,170318,0,0,0,88,0.5,0.17772159,4
2020-06-13-170318,170318,0,0,0,88,0.0,0.006933148,5
2020-06-14-170318,170318,0,0,0,88,0.0,0.01050929,6
2020-06-15-170318,170318,1,0,0,89,0.3333333333333333,0.20451644,0
2020-06-16-170318,170318,0,0,0,89,0.5,0.042465393,1
2020-06-17-170318,170318,0,0,0,89,0.8333333333333334,0.070787854,2
2020-06-18-170318,170318,0,0,0,89,1.0,0.050545204,3
2020-06-19-170318,170318,0,0,0,89,0.16666666666666666,0.013569705,4
2020-06-20-170318,170318,0,0,0,89,0.0,0.001382306,5
2020-06-21-170318,170318,0,0,0,89,0.0,0.00025053901,6
2020-06-22-170318,170318,1,0,0,90,0.16666666666666666,0.10856991,0
2020-06-23-170318,170318,0,0,0,90,0.6666666666666666,0.22863641,1
2020-06-24-170318,170318,0,0,0,90,0.3333333333333333,0.18630311,2
2020-06-25-170318,170318,0,3,1,90,0.6666666666666666,0.2065146,3
2020-06-26-170318,170318,0,1,0,90,0.0,0.03546467,4
2020-06-27-170318,170318,0,0,0,90,0.0,0.0035216182,5
2020-06-28-170318,170318,0,0,0,90,0.0,0.00018532682,6
2020-06-29-170318,170318,0,0,0,90,0.0,0.022040037,0
2020-06-30-170318,170318,0,0,0,90,0.16666666666666666,0.049955815,1
2020-07-01-170318,170318,0,0,0,90,0.0,0.014312808,2
2020-07-02-170318,170318,0,0,0,90,0.0,0.018759165,3
2020-07-03-170318,170318,0,0,1,90,0.16666666666666666,0.0946847,4
2020-07-04-170318,170318,0,0,0,90,0.0,0.0002693271,5
2020-07-05-170318,170318,0,0,0,90,0.0,0.0010552618,6
2020-07-06-170318,170318,0,0,0,90,0.16666666666666666,0.09591727,0
2020-07-07-170318,170318,0,0,1,90,0.5,0.030172456,1
2020-07-08-170318,170318,0,0,0,90,0.16666666666666666,0.04379694,2
2020-07-09-170318,170318,1,0,0,91,0.16666666666666666,0.11761972,3
2020-07-10-170318,170318,0,0,0,91,0.16666666666666666,0.10657267,4
2020-07-11-170318,170318,0,0,0,91,0.16666666666666666,0.029642254,5
2020-07-12-170318,170318,0,0,0,91,0.16666666666666666,0.003975999,6
2020-07-13-170318,170318,0,0,0,91,0.0,0.013910712,0
2020-07-14-170318,170318,0,0,0,91,0.0,0.024919149,1
2020-07-15-170318,170318,0,0,0,91,0.16666666666666666,0.021257853,2
2020-07-16-170318,170318,0,0,0,91,0.3333333333333333,0.053060822,3
2020-07-17-170318,170318,1,0,0,92,0.16666666666666666,0.14712128,4
2020-07-18-170318,170318,0,0,0,92,0.16666666666666666,0.044031747,5
2020-07-19-170318,170318,0,0,0,92,0.16666666666666666,0.04837455,6
2020-07-20-170318,170318,0,0,0,92,0.5,0.020340282,0
2020-07-21-170318,170318,1,0,1,93,0.3333333333333333,0.1849284,1
2020-07-22-170318,170318,0,0,0,93,0.6666666666666666,0.02018956,2
2020-07-23-170318,170318,0,0,0,93,0.3333333333333333,0.110867046,3
2020-07-24-170318,170318,0,0,0,93,0.3333333333333333,0.059899043,4
2020-07-25-170318,170318,0,0,0,93,0.0,0.00052508566,5
2020-07-26-170318,170318,0,0,0,93,0.0,0.003928592,6
2020-07-27-170318,170318,0,0,0,93,0.3333333333333333,0.017992048,0
2020-07-28-170318,170318,0,0,1,93,0.5,0.1439109,1
2020-07-29-170318,170318,0,0,0,93,0.0,0.010042483,2
2020-07-30-170318,170318,0,0,2,93,0.3333333333333333,0.030685931,3
2020-07-31-170318,170318,0,0,0,93,0.6666666666666666,0.04600196,4
2020-08-01-170318,170318,0,0,0,93,0.0,0.005704956,5
2020-08-02-170318,170318,0,0,0,93,0.16666666666666666,0.10227683,6
2020-08-03-170318,170318,0,0,0,93,0.3333333333333333,0.06321595,0
2020-08-04-170318,170318,1,0,0,94,0.5,0.22305068,1
2020-08-05-170318,170318,0,0,0,94,0.3333333333333333,0.12359535,2
2020-08-06-170318,170318,0,0,0,94,0.6666666666666666,0.20995827,3
2020-08-07-170318,170318,0,0,0,94,0.3333333333333333,0.04010902,4
2020-08-08-170318,170318,0,0,0,94,0.16666666666666666,0.10389949,5
2020-08-09-170318,170318,0,0,0,94,0.16666666666666666,0.1642472,6
2020-08-10-170318,170318,0,0,0,94,0.8333333333333334,0.25550318,0
2020-08-11-170318,170318,1,0,4,95,1.0,0.27952144,1
2020-08-12-170318,170318,0,0,0,95,1.0,0.08074268,2
2020-08-13-170318,170318,2,0,3,97,0.5,0.31991568,3
2020-08-14-170318,170318,0,0,0,97,0.3333333333333333,0.11846276,4
2020-08-15-170318,170318,0,0,2,97,0.0,0.07009079,5
2020-08-16-170318,170318,0,0,0,97,0.16666666666666666,0.06761388,6
2020-08-17-170318,170318,0,0,1,97,0.5,0.16060682,0
2020-08-18-170318,170318,0,0,0,97,0.0,0.0837885,1
2020-08-19-170318,170318,0,0,2,97,1.1666666666666667,0.3466286,2
2020-08-20-170318,170318,0,0,2,97,0.6666666666666666,0.32292947,3
2020-08-21-170318,170318,0,0,2,97,3.5,1.0222032,4
2020-08-22-170318,170318,0,0,0,97,0.5,0.28187734,5
2020-08-23-170318,170318,0,0,0,97,0.16666666666666666,0.14820942,6
2020-08-24-170318,170318,0,0,3,97,1.3333333333333333,0.7212969,0
2020-08-25-170318,170318,4,0,0,101,4.0,1.3707758,1
2020-08-26-170318,170318,0,0,2,101,1.5,0.9652503,2
2020-08-27-170318,170318,3,0,3,104,2.833333333333333,0.77822053,3
2020-08-28-170318,170318,0,0,1,104,2.5,0.43815267,4
2020-08-29-170318,170318,2,0,0,106,1.8333333333333333,0.84886765,5
2020-08-30-170318,170318,0,0,0,106,0.3333333333333333,0.17175715,6
2020-08-31-170318,170318,1,0,1,107,2.833333333333333,0.73924935,0
2020-09-01-170318,170318,0,0,2,107,1.5,0.2662488,1
2020-09-02-170318,170318,2,0,4,109,1.5,0.6099768,2
2020-09-03-170318,170318,2,0,4,111,1.6666666666666667,0.18094014,3
2020-09-04-170318,170318,2,0,3,113,3.6666666666666665,0.8084813,4
2020-09-05-170318,170318,0,0,0,113,1.3333333333333333,0.2483124,5
2020-09-06-170318,170318,0,0,0,113,1.8333333333333333,0.19855002,6
2020-09-07-170318,170318,3,0,4,116,3.8333333333333335,0.49235144,0
2020-09-08-170318,170318,0,0,3,116,2.833333333333333,0.23557375,1
2020-09-09-170318,170318,2,0,5,118,6.666666666666668,1.2771162,2
2020-09-10-170318,170318,3,0,10,121,5.333333333333333,1.1541504,3
2020-09-11-170318,170318,1,0,1,122,4.5,1.4905288,4
2020-09-12-170318,170318,0,0,1,122,2.5,0.2993461,5
2020-09-13-170318,170318,0,0,0,122,1.0,0.14984983,6
2020-09-14-170318,170318,1,0,1,123,2.5,0.5699397,0
2020-09-15-170318,170318,2,0,0,125,1.8333333333333333,0.46761346,1
2020-09-16-170318,170318,4,0,0,129,5.0,0.8913972,2
2020-09-17-170318,170318,4,0,1,133,3.5,1.2273974,3
2020-09-18-170318,170318,3,0,5,136,3.6666666666666665,0.6582836,4
2020-09-19-170318,170318,0,1,2,136,1.6666666666666667,0.15509933,5
2020-09-20-170318,170318,0,0,0,136,1.3333333333333333,0.089753225,6
2020-09-21-170318,170318,4,0,1,140,5.5,0.9501558,0
2020-09-22-170318,170318,3,1,2,143,5.0,1.0482683,1
2020-09-23-170318,170318,5,0,2,148,6.166666666666668,1.2241826,2
2020-09-24-170318,170318,10,0,4,158,14.666666666666664,4.030411,3
2020-09-25-170318,170318,1,0,5,159,14.333333333333336,2.1738913,4
2020-09-26-170318,170318,1,0,4,160,1.0,0.3359684,5
2020-09-27-170318,170318,0,0,0,160,1.8333333333333333,0.20151235,6
2020-09-28-170318,170318,1,0,1,161,4.833333333333333,0.743125,0
2020-09-29-170318,170318,0,0,6,161,5.166666666666667,0.80738443,1
2020-09-30-170318,170318,0,0,6,161,9.333333333333334,1.159831,2
2020-10-01-170318,170318,1,0,2,162,11.833333333333336,1.5178176,3
2020-10-02-170318,170318,5,0,5,167,9.833333333333334,1.3848503,4
2020-10-03-170318,170318,2,0,7,169,3.6666666666666665,0.7637274,5
2020-10-04-170318,170318,0,0,5,169,1.6666666666666667,0.3121879,6
2020-10-05-170318,170318,1,0,10,170,3.333333333333333,0.8729768,0
2020-10-06-170318,170318,2,1,3,172,8.333333333333334,0.81894016,1
2020-10-07-170318,170318,2,0,4,174,7.0,1.2303766,2
2020-10-08-170318,170318,4,0,8,178,7.833333333333332,1.0980245,3
2020-10-09-170318,170318,5,2,1,183,14.333333333333336,1.7039168,4
2020-10-10-170318,170318,4,0,0,187,2.0,0.5495355,5
2020-10-11-170318,170318,0,0,3,187,1.5,0.13433833,6
2020-10-12-170318,170318,1,0,9,188,2.333333333333333,0.45891377,0
2020-10-13-170318,170318,6,0,2,194,11.833333333333336,1.5075219,1
2020-10-14-170318,170318,6,0,1,200,7.333333333333332,1.6216195,2
2020-10-15-170318,170318,2,0,3,202,13.5,2.87497,3
2020-10-16-170318,170318,5,0,6,207,7.5,1.7431325,4
2020-10-17-170318,170318,7,0,1,214,1.5,0.94984907,5
2020-10-18-170318,170318,5,0,0,219,2.0,0.77241313,6
2020-10-19-170318,170318,10,1,3,229,11.833333333333336,1.7369564,0
2020-10-20-170318,170318,3,0,7,232,5.666666666666668,1.0895592,1
2020-10-21-170318,170318,4,0,2,236,7.666666666666668,0.5239954,2
2020-10-22-170318,170318,8,0,10,244,7.333333333333332,1.7575423,3
2020-10-23-170318,170318,1,0,23,245,11.833333333333336,2.526367,4
2020-10-24-170318,170318,0,1,0,245,2.1666666666666665,0.44885525,5
2020-10-25-170318,170318,3,2,1,248,0.8333333333333334,0.3999133,6
2020-10-26-170318,170318,9,0,30,257,9.666666666666666,1.7486742,0
2020-10-27-170318,170318,2,2,5,259,5.166666666666667,0.6876302,1
2020-10-28-170318,170318,1,1,1,260,6.333333333333332,0.683629,2
2020-10-29-170318,170318,3,0,5,263,13.5,1.4177517,3
2020-10-30-170318,170318,6,0,3,269,12.166666666666664,1.7821196,4
2020-10-31-170318,170318,1,0,0,270,1.1666666666666667,0.31858706,5
2020-11-01-170318,170318,0,0,0,270,1.3333333333333333,0.47068542,6
2020-11-02-170318,170318,3,1,0,273,0.8333333333333334,0.38034168,0
2020-11-03-170318,170318,7,0,0,280,9.666666666666666,1.6961907,1
2020-11-04-170318,170318,2,1,0,282,5.5,1.4177586,2
2020-11-05-170318,170318,10,0,0,292,8.5,1.6240107,3
2020-11-06-170318,170318,23,1,0,315,9.0,1.6234764,4
2020-11-07-170318,170318,0,0,0,315,2.333333333333333,0.6485974,5
2020-11-08-170318,170318,1,0,0,316,1.8333333333333333,0.30322218,6
2020-11-09-170318,170318,30,0,0,346,13.833333333333336,3.2181442,0
2020-11-10-170318,170318,5,1,0,351,8.833333333333334,1.5786246,1
2020-11-11-170318,170318,1,0,0,352,8.0,1.7063317,2
2020-11-12-170318,170318,5,1,0,357,7.666666666666668,1.4558355,3
2020-11-13-170318,170318,3,1,0,360,7.666666666666668,1.6949874,4
2020-03-01-170319,170319,0,0,0,0,0.0,1.4373084e-11,6
2020-03-02-170319,170319,0,0,2,0,0.0,0.0003262509,0
2020-03-03-170319,170319,0,1,4,0,0.0,1.8413632e-10,1
2020-03-04-170319,170319,0,1,0,0,0.0,0.00027494133,2
2020-03-05-170319,170319,0,0,3,0,0.0,0.0,3
2020-03-06-170319,170319,0,0,1,0,0.0,4.469758e-05,4
2020-03-07-170319,170319,0,0,0,0,0.0,6.51293e-05,5
2020-03-08-170319,170319,0,0,0,0,0.0,0.00046796154,6
2020-03-09-170319,170319,0,3,1,0,0.0,0.00041593632,0
2020-03-10-170319,170319,0,0,1,0,0.0,4.0879553e-05,1
2020-03-11-170319,170319,0,0,2,0,0.0,0.00033345996,2
2020-03-12-170319,170319,0,0,0,0,0.0,0.000403459,3
2020-03-13-170319,170319,0,0,1,0,0.0,0.001885971,4
2020-03-14-170319,170319,0,0,0,0,1.0,0.0025796073,5
2020-03-15-170319,170319,0,0,0,0,1.0,0.018445916,6
2020-03-16-170319,170319,2,0,0,2,4.666666666666667,0.08534742,0
2020-03-17-170319,170319,4,1,0,6,6.666666666666668,0.06700366,1
2020-03-18-170319,170319,0,0,1,6,9.666666666666666,0.056128938,2
2020-03-19-170319,170319,3,0,0,9,12.0,0.10665362,3
2020-03-20-170319,170319,1,0,0,10,11.0,0.077355206,4
2020-03-21-170319,170319,0,0,0,10,1.6666666666666667,0.012904075,5
2020-03-22-170319,170319,0,0,0,10,1.6666666666666667,0.022934306,6
2020-03-23-170319,170319,1,0,0,11,15.333333333333336,0.14478329,0
2020-03-24-170319,170319,1,0,0,12,12.0,0.09202131,1
2020-03-25-170319,170319,2,0,1,14,16.333333333333332,0.085493706,2
2020-03-26-170319,170319,0,0,0,14,17.666666666666668,0.07034446,3
2020-03-27-170319,170319,1,0,1,15,12.666666666666664,0.066392265,4
2020-03-28-170319,170319,0,0,0,15,1.6666666666666667,0.0123513285,5
2020-03-29-170319,170319,0,0,0,15,0.3333333333333333,0.012492351,6
2020-03-30-170319,170319,0,0,0,15,19.0,0.040659975,0
2020-03-31-170319,170319,0,0,0,15,10.0,0.034098174,1
2020-04-01-170319,170319,1,0,0,16,9.0,0.0393662,2
2020-04-02-170319,170319,0,0,0,16,7.666666666666668,0.03493156,3
2020-04-03-170319,170319,0,0,0,16,8.666666666666666,0.021249514,4
2020-04-04-170319,170319,0,0,0,16,1.3333333333333333,0.002117585,5
2020-04-05-170319,170319,0,0,0,16,2.0,0.005494005,6
2020-04-06-170319,170319,0,0,0,16,7.333333333333332,0.025052868,0
2020-04-07-170319,170319,0,0,0,16,7.666666666666668,0.023394039,1
2020-04-08-170319,170319,1,2,0,17,5.666666666666668,0.039910637,2
2020-04-09-170319,170319,0,0,0,17,7.333333333333332,0.015322197,3
2020-04-10-170319,170319,1,0,0,18,4.0,0.018745692,4
2020-04-11-170319,170319,0,1,0,18,1.3333333333333333,0.011044248,5
2020-04-12-170319,170319,0,0,0,18,1.3333333333333333,0.0129006915,6
2020-04-13-170319,170319,0,0,0,18,7.333333333333332,0.069016404,0
2020-04-14-170319,170319,0,0,0,18,4.0,0.038814433,1
2020-04-15-170319,170319,0,0,0,18,4.666666666666667,0.037968323,2
2020-04-16-170319,170319,0,0,0,18,4.0,0.026121518,3
2020-04-17-170319,170319,0,0,0,18,5.333333333333333,0.028013367,4
2020-04-18-170319,170319,0,0,0,18,0.6666666666666666,0.0078632,5
2020-04-19-170319,170319,0,0,0,18,2.0,0.005838224,6
2020-04-20-170319,170319,0,1,0,18,5.333333333333333,0.029219765,0
2020-04-21-170319,170319,0,0,3,18,4.0,0.045415714,1
2020-04-22-170319,170319,0,0,1,18,14.333333333333336,0.020162651,2
2020-04-23-170319,170319,0,0,0,18,0.0,0.0021551123,3
2020-04-24-170319,170319,0,0,2,18,20.666666666666668,0.05189941,4
2020-04-25-170319,170319,0,0,1,18,0.0,0.0013261164,5
2020-04-26-170319,170319,0,0,0,18,0.6666666666666666,0.0026258559,6
2020-04-27-170319,170319,0,1,0,18,5.333333333333333,0.013493992,0
2020-04-28-170319,170319,0,0,0,18,3.333333333333333,0.030167166,1
2020-04-29-170319,170319,0,0,0,18,4.0,0.011522646,2
2020-04-30-170319,170319,0,0,0,18,5.0,0.038642596,3
2020-05-01-170319,170319,0,0,0,18,0.0,0.0033822902,4
2020-05-02-170319,170319,0,0,0,18,0.3333333333333333,0.00082992663,5
2020-05-03-170319,170319,0,0,0,18,0.0,0.0002554351,6
2020-05-04-170319,170319,0,0,0,18,5.0,0.023388714,0
2020-05-05-170319,170319,3,0,0,21,4.666666666666667,0.0425303,1
2020-05-06-170319,170319,1,0,0,22,2.333333333333333,0.013871843,2
2020-05-07-170319,170319,0,0,0,22,2.333333333333333,0.026057743,3
2020-05-08-170319,170319,2,0,0,24,5.0,0.054248046,4
2020-05-09-170319,170319,1,0,0,25,0.3333333333333333,0.005967718,5
2020-05-10-170319,170319,0,1,0,25,0.3333333333333333,0.007279162,6
2020-05-11-170319,170319,0,1,0,25,2.6666666666666665,0.009693023,0
2020-05-12-170319,170319,0,0,0,25,3.6666666666666665,0.018181982,1
2020-05-13-170319,170319,0,0,0,25,4.333333333333333,0.031025011,2
2020-05-14-170319,170319,0,0,0,25,5.666666666666668,0.0311203,3
2020-05-15-170319,170319,0,0,1,25,0.6666666666666666,0.0083723795,4
2020-05-16-170319,170319,0,0,0,25,1.6666666666666667,0.0038100134,5
2020-05-17-170319,170319,0,0,0,25,0.0,8.8593646e-05,6
2020-05-18-170319,170319,0,1,0,25,3.6666666666666665,0.020951604,0
2020-05-19-170319,170319,0,0,0,25,2.6666666666666665,0.015051119,1
2020-05-20-170319,170319,0,0,0,25,2.6666666666666665,0.00893757,2
2020-05-21-170319,170319,0,0,0,25,3.0,0.017725043,3
2020-05-22-170319,170319,0,0,0,25,5.666666666666668,0.014141295,4
2020-05-23-170319,170319,0,0,0,25,0.6666666666666666,0.009008919,5
2020-05-24-170319,170319,0,0,0,25,0.6666666666666666,0.0087929815,6
2020-05-25-170319,170319,0,0,0,25,4.333333333333333,0.057189584,0
2020-05-26-170319,170319,0,0,0,25,2.6666666666666665,0.04849307,1
2020-05-27-170319,170319,0,0,0,25,2.0,0.011846079,2
2020-05-28-170319,170319,0,0,0,25,4.0,0.014255047,3
2020-05-29-170319,170319,1,1,0,26,4.333333333333333,0.03541452,4
2020-05-30-170319,170319,0,0,0,26,0.3333333333333333,0.0054805903,5
2020-05-31-170319,170319,0,0,0,26,0.0,0.004382993,6
2020-06-01-170319,170319,0,0,0,26,3.6666666666666665,0.024192357,0
2020-06-02-170319,170319,0,0,0,26,2.333333333333333,0.019921254,1
2020-06-03-170319,170319,0,0,0,26,3.6666666666666665,0.010309009,2
2020-06-04-170319,170319,0,0,0,26,3.6666666666666665,0.051653773,3
2020-06-05-170319,170319,0,0,0,26,4.666666666666667,0.02257472,4
2020-06-06-170319,170319,0,1,0,26,0.0,0.00018570291,5
2020-06-07-170319,170319,0,0,0,26,0.0,0.00070114515,6
2020-06-08-170319,170319,0,0,0,26,5.0,0.014285506,0
2020-06-09-170319,170319,0,0,0,26,4.666666666666667,0.021047931,1
2020-06-10-170319,170319,0,0,0,26,3.333333333333333,0.016414247,2
2020-06-11-170319,170319,0,0,0,26,3.0,0.033439357,3
2020-06-12-170319,170319,0,0,0,26,2.0,0.006428641,4
2020-06-13-170319,170319,0,0,0,26,0.6666666666666666,0.0071958187,5
2020-06-14-170319,170319,0,0,0,26,0.6666666666666666,0.014252033,6
2020-06-15-170319,170319,0,1,0,26,2.0,0.0058697285,0
2020-06-16-170319,170319,0,0,0,26,1.3333333333333333,0.0075217346,1
2020-06-17-170319,170319,0,0,0,26,0.6666666666666666,0.0041208817,2
2020-06-18-170319,170319,0,0,0,26,0.0,0.0033769936,3
2020-06-19-170319,170319,0,0,0,26,1.6666666666666667,0.0060622925,4
2020-06-20-170319,170319,0,0,0,26,0.0,0.0016415012,5
2020-06-21-170319,170319,0,0,0,26,0.3333333333333333,0.0037728713,6
2020-06-22-170319,170319,0,0,0,26,0.3333333333333333,0.025487637,0
2020-06-23-170319,170319,0,0,0,26,1.0,0.01889412,1
2020-06-24-170319,170319,0,2,0,26,0.0,0.0031603845,2
2020-06-25-170319,170319,0,0,0,26,0.3333333333333333,0.0038938418,3
2020-06-26-170319,170319,0,2,0,26,1.3333333333333333,0.02606009,4
2020-06-27-170319,170319,0,0,0,26,0.0,0.0010309144,5
2020-06-28-170319,170319,0,0,0,26,0.0,1.3577461e-07,6
2020-06-29-170319,170319,0,0,0,26,1.0,0.0084268525,0
2020-06-30-170319,170319,0,0,0,26,0.3333333333333333,0.0030734958,1
2020-07-01-170319,170319,0,0,0,26,0.3333333333333333,0.001956478,2
2020-07-02-170319,170319,0,0,1,26,0.0,0.011905747,3
2020-07-03-170319,170319,0,0,0,26,1.0,0.008094942,4
2020-07-04-170319,170319,0,0,0,26,0.0,0.00028341063,5
2020-07-05-170319,170319,0,0,0,26,0.3333333333333333,0.0014390044,6
2020-07-06-170319,170319,0,0,0,26,1.0,0.004513755,0
2020-07-07-170319,170319,0,0,0,26,1.3333333333333333,0.023370646,1
2020-07-08-170319,170319,0,0,0,26,0.3333333333333333,0.0021895485,2
2020-07-09-170319,170319,0,2,0,26,0.6666666666666666,0.006619065,3
2020-07-10-170319,170319,0,0,0,26,1.0,0.005134369,4
2020-07-11-170319,170319,0,0,0,26,0.0,0.0012944734,5
2020-07-12-170319,170319,0,0,0,26,0.0,0.0012151614,6
2020-07-13-170319,170319,0,0,1,26,1.6666666666666667,0.02686156,0
2020-07-14-170319,170319,0,0,0,26,1.0,0.023136657,1
2020-07-15-170319,170319,0,0,0,26,0.6666666666666666,0.02135536,2
2020-07-16-170319,170319,1,0,0,27,0.3333333333333333,0.030614529,3
2020-07-17-170319,170319,0,0,0,27,1.3333333333333333,0.015410092,4
2020-07-18-170319,170319,0,0,0,27,0.6666666666666666,0.026415896,5
2020-07-19-170319,170319,0,0,0,27,1.0,0.024771176,6
2020-07-20-170319,170319,0,0,0,27,0.3333333333333333,0.005195722,0
2020-07-21-170319,170319,0,0,1,27,1.3333333333333333,0.045857806,1
2020-07-22-170319,170319,0,0,0,27,0.0,0.0046932152,2
2020-07-23-170319,170319,0,0,0,27,1.6666666666666667,0.06966693,3
2020-07-24-170319,170319,0,0,0,27,2.0,0.023324842,4
2020-07-25-170319,170319,0,0,0,27,0.0,0.00088259054,5
2020-07-26-170319,170319,0,0,0,27,1.0,0.003856652,6
2020-07-27-170319,170319,1,0,0,28,1.0,0.004084523,0
2020-07-28-170319,170319,0,0,0,28,0.6666666666666666,0.017966801,1
2020-07-29-170319,170319,0,0,0,28,0.6666666666666666,0.026174387,2
2020-07-30-170319,170319,0,0,1,28,1.3333333333333333,0.013182493,3
2020-07-31-170319,170319,0,0,0,28,1.0,0.0063610915,4
2020-08-01-170319,170319,0,0,0,28,0.0,0.002340296,5
2020-08-02-170319,170319,0,0,0,28,0.0,0.0046539376,6
2020-08-03-170319,170319,0,0,0,28,2.333333333333333,0.01649176,0
2020-08-04-170319,170319,1,0,0,29,1.3333333333333333,0.022095943,1
2020-08-05-170319,170319,0,0,0,29,2.6666666666666665,0.021631714,2
2020-08-06-170319,170319,0,0,0,29,0.3333333333333333,0.017561203,3
2020-08-07-170319,170319,0,0,0,29,0.3333333333333333,0.025404597,4
2020-08-08-170319,170319,0,0,0,29,0.3333333333333333,0.005452619,5
2020-08-09-170319,170319,0,0,0,29,0.0,0.004719692,6
2020-08-10-170319,170319,0,0,1,29,1.3333333333333333,0.047970064,0
2020-08-11-170319,170319,0,1,0,29,1.0,0.017792473,1
2020-08-12-170319,170319,0,0,0,29,1.3333333333333333,0.012197772,2
2020-08-13-170319,170319,1,0,2,30,1.0,0.028973047,3
2020-08-14-170319,170319,0,0,1,30,1.6666666666666667,0.020069266,4
2020-08-15-170319,170319,0,0,0,30,0.0,0.07420263,5
2020-08-16-170319,170319,0,0,0,30,0.0,0.018808959,6
2020-08-17-170319,170319,0,0,0,30,2.6666666666666665,0.060176883,0
2020-08-18-170319,170319,0,0,0,30,1.0,0.034650013,1
2020-08-19-170319,170319,0,0,0,30,3.0,0.12760225,2
2020-08-20-170319,170319,0,0,0,30,0.3333333333333333,0.04496014,3
2020-08-21-170319,170319,0,0,0,30,3.6666666666666665,0.07859379,4
2020-08-22-170319,170319,0,0,0,30,2.0,0.030397194,5
2020-08-23-170319,170319,0,0,0,30,1.6666666666666667,0.029344117,6
2020-08-24-170319,170319,1,0,0,31,2.0,0.06973582,0
2020-08-25-170319,170319,0,0,2,31,4.666666666666667,0.09809941,1
2020-08-26-170319,170319,0,0,1,31,6.0,0.18653095,2
2020-08-27-170319,170319,2,0,0,33,6.666666666666668,0.1045973,3
2020-08-28-170319,170319,1,0,0,34,2.0,0.027376669,4
2020-08-29-170319,170319,0,0,0,34,4.333333333333333,0.034561973,5
2020-08-30-170319,170319,0,0,0,34,2.333333333333333,0.034925345,6
2020-08-31-170319,170319,0,0,0,34,4.666666666666667,0.08161127,0
2020-09-01-170319,170319,0,0,2,34,1.6666666666666667,0.021429427,1
2020-09-02-170319,170319,0,0,0,34,3.0,0.03289334,2
2020-09-03-170319,170319,0,0,2,34,3.333333333333333,0.039834753,3
2020-09-04-170319,170319,0,0,0,34,4.666666666666667,0.069792315,4
2020-09-05-170319,170319,0,0,0,34,3.333333333333333,0.05077021,5
2020-09-06-170319,170319,0,0,0,34,0.6666666666666666,0.022142153,6
2020-09-07-170319,170319,0,0,1,34,8.0,0.048858587,0
2020-09-08-170319,170319,2,0,1,36,7.666666666666668,0.06715431,1
2020-09-09-170319,170319,1,0,2,37,7.666666666666668,0.102165125,2
2020-09-10-170319,170319,0,0,1,37,4.666666666666667,0.07974335,3
2020-09-11-170319,170319,0,0,0,37,10.333333333333334,0.087213404,4
2020-09-12-170319,170319,0,0,0,37,2.0,0.021370154,5
2020-09-13-170319,170319,0,0,0,37,7.0,0.03523235,6
2020-09-14-170319,170319,0,0,0,37,9.333333333333334,0.21201809,0
2020-09-15-170319,170319,2,0,0,39,7.666666666666668,0.12800205,1
2020-09-16-170319,170319,0,0,0,39,10.666666666666666,0.07318399,2
2020-09-17-170319,170319,2,0,2,41,12.333333333333336,0.10210677,3
2020-09-18-170319,170319,0,0,1,41,12.666666666666664,0.08837765,4
2020-09-19-170319,170319,0,0,0,41,0.6666666666666666,0.020485789,5
2020-09-20-170319,170319,0,1,1,41,2.0,0.0328,6
2020-09-21-170319,170319,1,0,3,42,15.666666666666664,0.07838388,0
2020-09-22-170319,170319,1,0,3,43,9.666666666666666,0.057554,1
2020-09-23-170319,170319,2,0,1,45,10.333333333333334,0.06051453,2
2020-09-24-170319,170319,1,0,1,46,11.333333333333336,0.113667935,3
2020-09-25-170319,170319,0,0,1,46,9.0,0.09306124,4
2020-09-26-170319,170319,0,0,0,46,2.6666666666666665,0.018269265,5
2020-09-27-170319,170319,0,0,2,46,1.0,0.02412415,6
2020-09-28-170319,170319,0,0,0,46,13.666666666666664,0.071494564,0
2020-09-29-170319,170319,0,0,0,46,6.333333333333332,0.058076855,1
2020-09-30-170319,170319,0,0,0,46,9.666666666666666,0.061605413,2
2020-10-01-170319,170319,2,0,0,48,12.333333333333336,0.10721984,3
2020-10-02-170319,170319,1,0,0,49,17.0,0.09374003,4
2020-10-03-170319,170319,0,0,1,49,4.0,0.03371249,5
2020-10-04-170319,170319,1,0,1,50,4.0,0.07221927,6
2020-10-05-170319,170319,3,0,1,53,1.3333333333333333,0.06719407,0
2020-10-06-170319,170319,3,0,1,56,13.666666666666664,0.13342871,1
2020-10-07-170319,170319,1,0,0,57,11.666666666666664,0.1047289,2
2020-10-08-170319,170319,1,0,7,58,10.0,0.1127986,3
2020-10-09-170319,170319,1,0,0,59,16.0,0.19209841,4
2020-10-10-170319,170319,0,0,0,59,4.666666666666667,0.10532554,5
2020-10-11-170319,170319,2,0,2,61,2.333333333333333,0.030465685,6
2020-10-12-170319,170319,0,0,1,61,0.6666666666666666,0.033738367,0
2020-10-13-170319,170319,0,0,1,61,18.33333333333333,0.10600351,1
2020-10-14-170319,170319,0,0,0,61,16.333333333333332,0.1358282,2
2020-10-15-170319,170319,0,0,0,61,18.33333333333333,0.102395535,3
2020-10-16-170319,170319,0,0,1,61,14.0,0.136261,4
2020-10-17-170319,170319,1,0,0,62,5.666666666666668,0.14674486,5
2020-10-18-170319,170319,1,0,0,63,3.0,0.035084464,6
2020-10-19-170319,170319,1,0,0,64,22.33333333333333,0.1093261,0
2020-10-20-170319,170319,1,0,0,65,16.666666666666668,0.09444984,1
2020-10-21-170319,170319,0,0,0,65,17.0,0.06690896,2
2020-10-22-170319,170319,7,0,0,72,34.333333333333336,0.24821785,3
2020-10-23-170319,170319,0,0,0,72,16.666666666666668,0.12533142,4
2020-10-24-170319,170319,0,0,0,72,7.333333333333332,0.07385564,5
2020-10-25-170319,170319,2,0,0,74,3.333333333333333,0.028111417,6
2020-10-26-170319,170319,1,0,3,75,20.0,0.11739958,0
2020-10-27-170319,170319,1,0,1,76,4.666666666666667,0.07648448,1
2020-10-28-170319,170319,0,0,0,76,27.33333333333333,0.087247945,2
2020-10-29-170319,170319,0,0,1,76,18.666666666666668,0.12184121,3
2020-10-30-170319,170319,1,0,0,77,19.33333333333333,0.21683787,4
2020-10-31-170319,170319,0,0,0,77,3.6666666666666665,0.054414008,5
2020-11-01-170319,170319,0,0,0,77,4.0,0.06515878,6
2020-11-02-170319,170319,0,0,0,77,1.6666666666666667,0.0118600875,0
2020-11-03-170319,170319,0,0,0,77,24.0,0.13904406,1
2020-11-04-170319,170319,0,0,0,77,10.0,0.090576805,2
2020-11-05-170319,170319,0,0,0,77,20.666666666666668,0.17075804,3
2020-11-06-170319,170319,0,0,0,77,15.666666666666664,0.0982001,4
2020-11-07-170319,170319,0,0,0,77,1.0,0.019769851,5
2020-11-08-170319,170319,0,0,0,77,8.0,0.14243545,6
2020-11-09-170319,170319,3,1,0,80,27.33333333333333,0.2717756,0
2020-11-10-170319,170319,1,0,0,81,28.33333333333333,0.1725646,1
2020-11-11-170319,170319,0,0,0,81,18.666666666666668,0.11129966,2
2020-11-12-170319,170319,1,0,0,82,19.0,0.12178066,3
2020-11-13-170319,170319,0,0,0,82,23.66666666666667,0.31497595,4
2020-03-01-170320,170320,0,0,0,0,0.0,0.0,6
2020-03-02-170320,170320,0,0,0,0,0.0,4.8478146e-09,0
2020-03-03-170320,170320,0,0,2,0,0.0,0.0,1
2020-03-04-170320,170320,0,1,1,0,0.0,0.0,2
2020-03-05-170320,170320,0,0,0,0,0.0,5.2960015e-08,3
2020-03-06-170320,170320,0,0,1,0,0.0,7.0694415e-09,4
2020-03-07-170320,170320,0,0,0,0,0.0,4.5814317e-09,5
2020-03-08-170320,170320,0,0,0,0,0.0,1.7184985e-07,6
2020-03-09-170320,170320,0,0,0,0,0.25,8.688104e-06,0
2020-03-10-170320,170320,0,0,1,0,0.0,5.635475e-06,1
2020-03-11-170320,170320,0,0,0,0,0.0,0.00013858918,2
2020-03-12-170320,170320,0,0,0,0,0.25,0.004051064,3
2020-03-13-170320,170320,0,0,0,0,0.0,1.3969519e-06,4
2020-03-14-170320,170320,0,0,0,0,0.25,2.8574345e-06,5
2020-03-15-170320,170320,0,0,0,0,1.25,2.7841327e-07,6
2020-03-16-170320,170320,0,0,0,0,1.75,0.092279896,0
2020-03-17-170320,170320,2,0,0,2,1.5,2.5261215e-06,1
2020-03-18-170320,170320,1,0,0,3,1.75,3.3668673e-06,2
2020-03-19-170320,170320,0,1,0,3,3.25,0.17918478,3
2020-03-20-170320,170320,1,1,0,4,3.5,5.2159203e-06,4
2020-03-21-170320,170320,0,0,0,4,2.0,1.1974251e-05,5
2020-03-22-170320,170320,0,0,0,4,1.25,5.726284e-07,6
2020-03-23-170320,170320,0,0,1,4,5.25,1.9053463e-05,0
2020-03-24-170320,170320,1,0,0,5,1.75,1.1265847e-05,1
2020-03-25-170320,170320,0,0,0,5,2.0,4.059472e-06,2
2020-03-26-170320,170320,0,0,0,5,2.25,6.1314527e-06,3
2020-03-27-170320,170320,0,0,0,5,3.0,0.10569467,4
2020-03-28-170320,170320,0,0,0,5,0.5,3.021136e-06,5
2020-03-29-170320,170320,0,0,0,5,1.25,2.5572544e-06,6
2020-03-30-170320,170320,0,0,0,5,1.0,8.974636e-06,0
2020-03-31-170320,170320,0,0,0,5,0.75,5.279594e-06,1
2020-04-01-170320,170320,0,0,0,5,1.75,6.010364e-06,2
2020-04-02-170320,170320,0,0,0,5,1.25,3.2500652e-06,3
2020-04-03-170320,170320,0,0,1,5,0.75,7.690801e-06,4
2020-04-04-170320,170320,0,0,0,5,0.0,2.478753e-06,5
2020-04-05-170320,170320,0,2,0,5,1.0,4.0452564e-06,6
2020-04-06-170320,170320,1,0,0,6,1.0,7.2680327e-06,0
2020-04-07-170320,170320,0,0,0,6,1.25,4.9671307e-06,1
2020-04-08-170320,170320,0,0,0,6,2.5,5.4442057e-06,2
2020-04-09-170320,170320,0,0,0,6,0.25,5.801828e-06,3
2020-04-10-170320,170320,0,0,0,6,1.5,3.232369e-05,4
2020-04-11-170320,170320,0,0,0,6,1.25,1.9169217e-06,5
2020-04-12-170320,170320,0,2,0,6,0.75,0.009336143,6
2020-04-13-170320,170320,0,0,0,6,1.75,9.171302e-06,0
2020-04-14-170320,170320,0,0,0,6,1.25,6.538104e-06,1
2020-04-15-170320,170320,0,1,0,6,1.5,0.055513445,2
2020-04-16-170320,170320,0,0,1,6,1.0,5.9778044e-06,3
2020-04-17-170320,170320,1,0,0,7,0.0,0.026198557,4
2020-04-18-170320,170320,0,0,0,7,0.5,1.2937426e-06,5
2020-04-19-170320,170320,0,0,0,7,0.25,1.8417765e-06,6
2020-04-20-170320,170320,0,0,0,7,0.5,0.0482973,0
2020-04-21-170320,170320,0,0,0,7,1.25,0.037537176,1
2020-04-22-170320,170320,0,0,0,7,0.0,2.4325207e-06,2
2020-04-23-170320,170320,0,0,0,7,0.25,1.6910009e-06,3
2020-04-24-170320,170320,0,0,0,7,2.25,8.553979e-06,4
2020-04-25-170320,170320,0,0,0,7,0.25,5.7982047e-06,5
2020-04-26-170320,170320,0,0,0,7,0.5,3.1254644e-06,6
2020-04-27-170320,170320,0,0,0,7,0.25,7.124673e-07,0
2020-04-28-170320,170320,0,0,0,7,2.5,5.3103763e-06,1
2020-04-29-170320,170320,0,0,0,7,0.75,5.376176e-06,2
2020-04-30-170320,170320,1,0,1,8,1.0,0.08909238,3
2020-05-01-170320,170320,0,0,0,8,0.25,0.0062348777,4
2020-05-02-170320,170320,0,1,0,8,0.25,0.00081195496,5
2020-05-03-170320,170320,0,0,0,8,0.25,1.104818e-13,6
2020-05-04-170320,170320,0,0,0,8,1.25,0.029427946,0
2020-05-05-170320,170320,0,0,0,8,0.5,2.6040277e-07,1
2020-05-06-170320,170320,0,0,0,8,0.5,0.014438214,2
2020-05-07-170320,170320,0,0,0,8,1.75,0.070302695,3
2020-05-08-170320,170320,0,0,0,8,0.75,7.913131e-06,4
2020-05-09-170320,170320,0,0,0,8,0.0,4.7882356e-08,5
2020-05-10-170320,170320,0,0,0,8,0.75,2.1756857e-06,6
2020-05-11-170320,170320,0,1,0,8,0.5,4.309187e-06,0
2020-05-12-170320,170320,0,0,0,8,0.75,0.015892053,1
2020-05-13-170320,170320,0,0,0,8,2.5,0.09055857,2
2020-05-14-170320,170320,1,0,0,9,1.5,1.0805845e-06,3
2020-05-15-170320,170320,0,0,0,9,0.0,2.7725912e-06,4
2020-05-16-170320,170320,0,0,0,9,0.25,1.9630084e-08,5
2020-05-17-170320,170320,0,0,0,9,0.25,6.6681287e-07,6
2020-05-18-170320,170320,0,0,0,9,0.75,3.446936e-06,0
2020-05-19-170320,170320,0,0,0,9,0.25,0.017817616,1
2020-05-20-170320,170320,0,0,0,9,0.75,7.3149217e-06,2
2020-05-21-170320,170320,0,0,0,9,0.75,1.0937271e-05,3
2020-05-22-170320,170320,0,0,0,9,0.5,3.6415597e-06,4
2020-05-23-170320,170320,0,0,0,9,0.5,1.6800325e-07,5
2020-05-24-170320,170320,0,0,0,9,0.25,2.399836e-12,6
2020-05-25-170320,170320,0,0,0,9,1.25,2.1702506e-06,0
2020-05-26-170320,170320,0,0,0,9,1.5,0.0733656,1
2020-05-27-170320,170320,0,0,0,9,0.25,4.7185276e-06,2
2020-05-28-170320,170320,0,0,0,9,0.25,1.8412712e-06,3
2020-05-29-170320,170320,0,0,0,9,1.75,1.4046247e-05,4
2020-05-30-170320,170320,0,0,0,9,0.0,1.6948608e-06,5
2020-05-31-170320,170320,0,0,0,9,0.25,8.2557625e-07,6
2020-06-01-170320,170320,0,0,0,9,0.25,5.8749106e-06,0
2020-06-02-170320,170320,0,0,0,9,0.25,0.021882068,1
2020-06-03-170320,170320,0,0,0,9,0.75,7.142927e-06,2
2020-06-04-170320,170320,0,0,0,9,1.0,8.347902e-06,3
2020-06-05-170320,170320,0,0,0,9,0.0,4.705317e-06,4
2020-06-06-170320,170320,0,0,0,9,0.25,1.6133695e-06,5
2020-06-07-170320,170320,0,0,0,9,0.0,3.781792e-15,6
2020-06-08-170320,170320,0,0,0,9,0.5,3.3783733e-06,0
2020-06-09-170320,170320,0,0,0,9,1.0,0.03282434,1
2020-06-10-170320,170320,0,0,0,9,0.75,4.0745337e-05,2
2020-06-11-170320,170320,0,0,0,9,0.75,1.0911363e-05,3
2020-06-12-170320,170320,0,0,0,9,0.75,4.2633883e-06,4
2020-06-13-170320,170320,0,0,0,9,0.5,9.1158955e-07,5
2020-06-14-170320,170320,0,0,0,9,0.25,9.961554e-08,6
2020-06-15-170320,170320,0,0,0,9,0.75,9.842721e-06,0
2020-06-16-170320,170320,0,0,0,9,0.5,0.004539021,1
2020-06-17-170320,170320,0,0,0,9,0.25,2.3381533e-06,2
2020-06-18-170320,170320,0,0,0,9,0.75,7.5598323e-06,3
2020-06-19-170320,170320,0,0,0,9,0.25,2.2373024e-06,4
2020-06-20-170320,170320,0,0,0,9,0.5,5.535076e-06,5
2020-06-21-170320,170320,0,0,0,9,0.0,4.8845783e-07,6
2020-06-22-170320,170320,0,0,0,9,0.75,3.0819212e-06,0
2020-06-23-170320,170320,0,0,0,9,0.5,0.04790862,1
2020-06-24-170320,170320,0,0,0,9,0.5,3.0136403e-06,2
2020-06-25-170320,170320,0,1,0,9,0.5,5.4060306e-06,3
2020-06-26-170320,170320,0,1,0,9,0.25,4.684562e-06,4
2020-06-27-170320,170320,0,0,0,9,0.0,3.022927e-06,5
2020-06-28-170320,170320,0,0,0,9,0.0,2.6686928e-08,6
2020-06-29-170320,170320,0,1,0,9,0.25,1.9636398e-06,0
2020-06-30-170320,170320,0,0,0,9,1.5,0.021661486,1
2020-07-01-170320,170320,0,0,0,9,0.25,5.927019e-06,2
2020-07-02-170320,170320,0,0,0,9,1.25,1.25248835e-05,3
2020-07-03-170320,170320,0,0,0,9,0.0,3.3030915e-06,4
2020-07-04-170320,170320,0,0,0,9,0.25,1.422818e-06,5
2020-07-05-170320,170320,0,0,0,9,0.0,7.154585e-07,6
2020-07-06-170320,170320,0,0,0,9,0.75,2.423043e-05,0
2020-07-07-170320,170320,0,0,0,9,0.25,0.04703347,1
2020-07-08-170320,170320,0,0,0,9,0.5,3.3337515e-06,2
2020-07-09-170320,170320,0,0,0,9,0.0,1.8985117e-08,3
2020-07-10-170320,170320,0,0,0,9,0.75,2.545822e-06,4
2020-07-11-170320,170320,0,0,0,9,0.0,4.1134163e-06,5
2020-07-12-170320,170320,0,0,0,9,0.0,2.0835856e-07,6
2020-07-13-170320,170320,0,0,0,9,0.75,9.607205e-07,0
2020-07-14-170320,170320,0,0,0,9,0.25,0.02311291,1
2020-07-15-170320,170320,0,0,0,9,0.25,2.7486644e-06,2
2020-07-16-170320,170320,0,0,0,9,1.0,1.242152e-05,3
2020-07-17-170320,170320,0,0,0,9,0.5,2.2761715e-06,4
2020-07-18-170320,170320,0,0,0,9,0.5,1.924442e-06,5
2020-07-19-170320,170320,0,0,0,9,0.25,4.3510983e-07,6
2020-07-20-170320,170320,0,0,0,9,0.0,1.02975264e-07,0
2020-07-21-170320,170320,0,0,0,9,1.0,0.044945914,1
2020-07-22-170320,170320,0,0,0,9,0.0,2.778586e-07,2
2020-07-23-170320,170320,0,0,0,9,1.0,7.0344754e-07,3
2020-07-24-170320,170320,0,0,0,9,0.25,2.3424598e-06,4
2020-07-25-170320,170320,0,0,0,9,0.75,5.2731493e-06,5
2020-07-26-170320,170320,0,0,0,9,0.0,7.8341756e-08,6
2020-07-27-170320,170320,0,0,0,9,1.0,5.8406786e-06,0
2020-07-28-170320,170320,0,0,0,9,0.75,0.033424545,1
2020-07-29-170320,170320,0,0,0,9,1.5,7.5909384e-06,2
2020-07-30-170320,170320,0,0,0,9,0.25,5.9849293e-07,3
2020-07-31-170320,170320,0,0,0,9,0.0,1.542602e-06,4
2020-08-01-170320,170320,0,0,0,9,0.25,2.7353394e-06,5
2020-08-02-170320,170320,0,0,0,9,0.0,6.0939595e-07,6
2020-08-03-170320,170320,0,0,0,9,0.5,2.0298971e-06,0
2020-08-04-170320,170320,0,0,1,9,0.75,0.049739778,1
2020-08-05-170320,170320,0,0,0,9,1.0,6.963971e-06,2
2020-08-06-170320,170320,0,0,0,9,0.25,6.7767946e-06,3
2020-08-07-170320,170320,0,0,1,9,1.0,2.4061333e-06,4
2020-08-08-170320,170320,0,0,0,9,0.25,2.8274874e-06,5
2020-08-09-170320,170320,0,0,1,9,0.0,4.476537e-06,6
2020-08-10-170320,170320,0,0,0,9,1.75,1.3327299e-05,0
2020-08-11-170320,170320,0,0,0,9,1.0,0.058757,1
2020-08-12-170320,170320,0,0,0,9,3.75,4.1706262e-05,2
2020-08-13-170320,170320,0,0,0,9,1.75,2.0349324e-05,3
2020-08-14-170320,170320,0,0,0,9,1.75,9.832261e-06,4
2020-08-15-170320,170320,0,0,0,9,2.0,4.9952287e-06,5
2020-08-16-170320,170320,0,0,0,9,0.25,7.5149246e-06,6
2020-08-17-170320,170320,0,0,0,9,2.0,7.998917e-06,0
2020-08-18-170320,170320,1,0,0,10,1.5,0.1522807,1
2020-08-19-170320,170320,0,0,0,10,4.5,1.5704876e-05,2
2020-08-20-170320,170320,0,0,0,10,1.75,8.875246e-06,3
2020-08-21-170320,170320,1,0,0,11,5.75,6.238557e-05,4
2020-08-22-170320,170320,0,0,1,11,1.0,8.933962e-06,5
2020-08-23-170320,170320,1,0,0,12,3.25,2.846953e-05,6
2020-08-24-170320,170320,0,0,0,12,2.0,3.718904e-05,0
2020-08-25-170320,170320,0,0,0,12,4.25,0.2658733,1
2020-08-26-170320,170320,0,0,0,12,3.75,4.7140955e-05,2
2020-08-27-170320,170320,0,0,2,12,1.5,5.7120888e-05,3
2020-08-28-170320,170320,0,0,0,12,0.5,5.520738e-06,4
2020-08-29-170320,170320,0,0,0,12,0.0,3.2882906e-06,5
2020-08-30-170320,170320,0,0,0,12,1.0,4.1380886e-06,6
2020-08-31-170320,170320,0,0,0,12,1.75,1.1923335e-05,0
2020-09-01-170320,170320,0,0,0,12,1.0,0.037279714,1
2020-09-02-170320,170320,0,0,1,12,0.75,1.199958e-05,2
2020-09-03-170320,170320,0,0,0,12,1.5,8.514396e-06,3
2020-09-04-170320,170320,0,0,1,12,0.75,2.7544253e-05,4
2020-09-05-170320,170320,1,0,0,13,0.5,7.652443e-06,5
2020-09-06-170320,170320,0,0,0,13,1.25,9.345931e-06,6
2020-09-07-170320,170320,0,0,1,13,1.0,1.041056e-05,0
2020-09-08-170320,170320,0,0,1,13,1.5,0.092155315,1
2020-09-09-170320,170320,0,0,0,13,1.5,1.1121874e-05,2
2020-09-10-170320,170320,2,0,0,15,1.25,1.9037798e-05,3
2020-09-11-170320,170320,0,0,0,15,0.0,6.7964615e-06,4
2020-09-12-170320,170320,0,0,1,15,0.5,4.325538e-06,5
2020-09-13-170320,170320,0,0,0,15,0.25,4.160674e-06,6
2020-09-14-170320,170320,0,0,0,15,6.25,5.619544e-06,0
2020-09-15-170320,170320,0,0,0,15,3.25,0.2682294,1
2020-09-16-170320,170320,1,0,1,16,1.0,1.4992649e-05,2
2020-09-17-170320,170320,0,0,1,16,1.5,8.706429e-06,3
2020-09-18-170320,170320,1,0,1,17,1.5,2.4013572e-05,4
2020-09-19-170320,170320,0,1,0,17,1.0,3.009039e-06,5
2020-09-20-170320,170320,0,0,2,17,1.75,1.7120705e-05,6
2020-09-21-170320,170320,1,0,0,18,2.75,1.0311975e-05,0
2020-09-22-170320,170320,1,0,3,19,0.75,0.04848984,1
2020-09-23-170320,170320,0,0,0,19,1.25,9.34985e-06,2
2020-09-24-170320,170320,0,0,0,19,1.25,1.4949151e-05,3
2020-09-25-170320,170320,0,0,0,19,2.0,7.23529e-06,4
2020-09-26-170320,170320,1,0,0,20,1.75,3.1942123e-05,5
2020-09-27-170320,170320,0,0,0,20,1.0,4.507723e-06,6
2020-09-28-170320,170320,0,0,0,20,2.0,8.973193e-06,0
2020-09-29-170320,170320,0,0,0,20,3.25,0.13021173,1
2020-09-30-170320,170320,1,0,0,21,2.75,1.5781483e-05,2
2020-10-01-170320,170320,1,0,0,22,3.0,3.4895522e-05,3
2020-10-02-170320,170320,1,0,0,23,2.0,1.2775272e-05,4
2020-10-03-170320,170320,0,0,0,23,1.5,8.6733735e-06,5
2020-10-04-170320,170320,2,0,2,25,3.0,1.7723733e-05,6
2020-10-05-170320,170320,0,0,0,25,3.75,3.6746267e-05,0
2020-10-06-170320,170320,3,0,0,28,2.0,0.22422734,1
2020-10-07-170320,170320,0,0,0,28,1.75,1.5419437e-05,2
2020-10-08-170320,170320,0,0,0,28,4.0,3.434925e-05,3
2020-10-09-170320,170320,0,0,0,28,4.75,1.0430018e-05,4
2020-10-10-170320,170320,0,0,0,28,2.75,2.016961e-05,5
2020-10-11-170320,170320,0,0,1,28,1.25,8.92382e-06,6
2020-10-12-170320,170320,0,0,1,28,3.25,1.4983581e-05,0
2020-10-13-170320,170320,0,0,2,28,3.0,0.12497783,1
2020-10-14-170320,170320,0,0,2,28,4.5,1.5414058e-05,2
2020-10-15-170320,170320,0,0,1,28,2.75,2.4576053e-05,3
2020-10-16-170320,170320,0,0,0,28,1.5,3.5736466e-05,4
2020-10-17-170320,170320,0,0,0,28,6.75,3.2436794e-05,5
2020-10-18-170320,170320,2,0,6,30,3.0,1.977873e-05,6
2020-10-19-170320,170320,0,0,0,30,4.5,3.196788e-05,0
2020-10-20-170320,170320,0,0,0,30,11.25,0.14429922,1
2020-10-21-170320,170320,0,0,1,30,2.5,2.7448397e-05,2
2020-10-22-170320,170320,0,0,0,30,6.75,3.4332694e-05,3
2020-10-23-170320,170320,0,0,3,30,5.25,2.0658437e-05,4
2020-10-24-170320,170320,0,0,0,30,7.0,2.8694187e-05,5
2020-10-25-170320,170320,1,0,0,31,2.0,1.01064e-05,6
2020-10-26-170320,170320,1,0,1,32,1.75,1.5550586e-05,0
2020-10-27-170320,170320,2,1,1,34,1.5,0.13120575,1
2020-10-28-170320,170320,2,0,1,36,8.5,5.7340305e-05,2
2020-10-29-170320,170320,1,0,1,37,5.5,2.8065953e-05,3
2020-10-30-170320,170320,0,0,0,37,5.5,3.3134722e-05,4
2020-10-31-170320,170320,0,0,0,37,2.5,1.5209287e-05,5
2020-11-01-170320,170320,6,0,0,43,6.0,2.448555e-05,6
2020-11-02-170320,170320,0,0,0,43,2.5,1.3552135e-05,0
2020-11-03-170320,170320,0,1,0,43,5.75,0.08729914,1
2020-11-04-170320,170320,1,0,0,44,4.0,3.025691e-05,2
2020-11-05-170320,170320,0,0,0,44,3.5,3.9059283e-05,3
2020-11-06-170320,170320,3,0,0,47,2.0,1.2392768e-05,4
2020-11-07-170320,170320,0,0,0,47,3.5,2.0608524e-05,5
2020-11-08-170320,170320,0,0,0,47,4.75,1.0055981e-05,6
2020-11-09-170320,170320,1,1,0,48,5.25,1.7795837e-05,0
2020-11-10-170320,170320,1,0,0,49,2.75,0.22607778,1
2020-11-11-170320,170320,1,0,0,50,2.25,1.4859089e-05,2
2020-11-12-170320,170320,1,0,0,51,6.0,5.6207176e-05,3
2020-11-13-170320,170320,0,0,0,51,5.75,3.1017957e-05,4
2020-03-01-170321,170321,0,0,1,0,0.0,1.09829825e-08,6
2020-03-02-170321,170321,0,0,0,0,0.0,0.00016785882,0
2020-03-03-170321,170321,0,0,1,0,0.0,7.5015734e-08,1
2020-03-04-170321,170321,0,1,1,0,0.0,5.8410376e-05,2
2020-03-05-170321,170321,0,0,1,0,0.0,2.3961858e-08,3
2020-03-06-170321,170321,0,0,2,0,0.0,0.0004807063,4
2020-03-07-170321,170321,0,0,0,0,0.0,0.000556761,5
2020-03-08-170321,170321,0,0,1,0,0.0,0.00039644918,6
2020-03-09-170321,170321,0,0,1,0,0.0,0.014783417,0
2020-03-10-170321,170321,0,0,1,0,0.0,0.00056229084,1
2020-03-11-170321,170321,0,0,2,0,0.0,0.0010908492,2
2020-03-12-170321,170321,0,0,0,0,0.0,0.0080581065,3
2020-03-13-170321,170321,0,0,1,0,0.0,0.004489786,4
2020-03-14-170321,170321,0,0,0,0,0.6,0.015059448,5
2020-03-15-170321,170321,1,0,0,1,1.6,0.091458544,6
2020-03-16-170321,170321,0,0,0,1,9.2,0.40954915,0
2020-03-17-170321,170321,1,0,1,2,5.0,0.34133464,1
2020-03-18-170321,170321,1,1,0,3,5.6,0.40088946,2
2020-03-19-170321,170321,1,0,0,4,8.0,0.6714905,3
2020-03-20-170321,170321,2,1,3,6,7.8,0.664973,4
2020-03-21-170321,170321,0,1,0,6,1.0,0.07030514,5
2020-03-22-170321,170321,1,0,0,7,2.0,0.095147185,6
2020-03-23-170321,170321,1,0,0,8,11.0,0.6021405,0
2020-03-24-170321,170321,1,0,1,9,7.0,0.54194313,1
2020-03-25-170321,170321,2,0,0,11,7.2,0.6443549,2
2020-03-26-170321,170321,0,0,0,11,5.6,0.2851247,3
2020-03-27-170321,170321,1,0,1,12,6.8,0.4539908,4
2020-03-28-170321,170321,0,0,0,12,1.2,0.13488553,5
2020-03-29-170321,170321,0,0,0,12,0.8,0.04292997,6
2020-03-30-170321,170321,0,0,0,12,7.2,0.3071503,0
2020-03-31-170321,170321,1,0,0,13,3.4,0.27465436,1
2020-04-01-170321,170321,0,0,0,13,4.0,0.41639754,2
2020-04-02-170321,170321,0,1,0,13,2.8,0.109648556,3
2020-04-03-170321,170321,3,0,0,16,3.4,0.2944518,4
2020-04-04-170321,170321,0,0,0,16,1.0,0.106970005,5
2020-04-05-170321,170321,0,0,0,16,0.8,0.016915211,6
2020-04-06-170321,170321,0,1,0,16,9.8,0.4015631,0
2020-04-07-170321,170321,1,4,0,17,3.6,0.3303684,1
2020-04-08-170321,170321,0,1,1,17,3.4,0.26785263,2
2020-04-09-170321,170321,0,0,0,17,3.4,0.16212079,3
2020-04-10-170321,170321,1,0,1,18,3.4,0.27467465,4
2020-04-11-170321,170321,0,0,0,18,0.8,0.052452724,5
2020-04-12-170321,170321,0,0,0,18,1.0,0.036488224,6
2020-04-13-170321,170321,0,0,1,18,3.8,0.31231028,0
2020-04-14-170321,170321,0,1,0,18,5.6,0.5469972,1
2020-04-15-170321,170321,0,0,2,18,3.8,0.3228379,2
2020-04-16-170321,170321,0,0,0,18,4.4,0.26119706,3
2020-04-17-170321,170321,0,1,0,18,3.0,0.13033654,4
2020-04-18-170321,170321,0,0,0,18,0.2,0.011564741,5
2020-04-19-170321,170321,0,0,0,18,0.6,0.0114726,6
2020-04-20-170321,170321,0,1,1,18,7.6,0.23372714,0
2020-04-21-170321,170321,0,0,0,18,2.6,0.18125325,1
2020-04-22-170321,170321,1,0,1,19,2.2,0.2698324,2
2020-04-23-170321,170321,0,0,0,19,2.0,0.035459407,3
2020-04-24-170321,170321,1,0,1,20,5.2,0.2471984,4
2020-04-25-170321,170321,0,0,0,20,0.6,0.05484873,5
2020-04-26-170321,170321,0,0,1,20,0.6,0.031377807,6
2020-04-27-170321,170321,1,2,0,21,1.8,0.124943055,0
2020-04-28-170321,170321,0,3,0,21,1.8,0.17362577,1
2020-04-29-170321,170321,2,0,0,23,1.4,0.1791874,2
2020-04-30-170321,170321,0,0,0,23,1.8,0.08913832,3
2020-05-01-170321,170321,0,0,0,23,0.4,0.00915628,4
2020-05-02-170321,170321,0,0,1,23,0.4,0.0154849645,5
2020-05-03-170321,170321,0,0,0,23,0.4,0.01431285,6
2020-05-04-170321,170321,1,0,0,24,1.0,0.12485911,0
2020-05-05-170321,170321,0,0,0,24,1.2,0.1994054,1
2020-05-06-170321,170321,1,0,0,25,1.6,0.19114096,2
2020-05-07-170321,170321,0,0,0,25,2.2,0.18187061,3
2020-05-08-170321,170321,1,0,0,26,1.6,0.16470486,4
2020-05-09-170321,170321,0,0,0,26,0.6,0.04403785,5
2020-05-10-170321,170321,1,0,0,27,0.4,0.046987183,6
2020-05-11-170321,170321,0,0,2,27,1.0,0.11986069,0
2020-05-12-170321,170321,0,0,0,27,0.4,0.04115269,1
2020-05-13-170321,170321,0,0,1,27,1.4,0.1204543,2
2020-05-14-170321,170321,0,0,0,27,2.4,0.2917041,3
2020-05-15-170321,170321,0,0,0,27,1.8,0.051373467,4
2020-05-16-170321,170321,1,0,0,28,0.2,0.075274244,5
2020-05-17-170321,170321,0,0,0,28,0.0,0.009419878,6
2020-05-18-170321,170321,0,0,0,28,1.0,0.061904788,0
2020-05-19-170321,170321,0,0,0,28,1.4,0.12997882,1
2020-05-20-170321,170321,0,0,0,28,1.2,0.09612065,2
2020-05-21-170321,170321,0,0,0,28,2.4,0.16485628,3
2020-05-22-170321,170321,0,0,2,28,2.2,0.10428388,4
2020-05-23-170321,170321,0,0,0,28,0.6,0.04149668,5
2020-05-24-170321,170321,0,0,0,28,0.2,0.00895455,6
2020-05-25-170321,170321,2,0,1,30,1.2,0.26824117,0
2020-05-26-170321,170321,0,0,0,30,1.8,0.09630769,1
2020-05-27-170321,170321,1,0,1,31,0.6,0.18612936,2
2020-05-28-170321,170321,0,0,0,31,1.0,0.0830413,3
2020-05-29-170321,170321,0,0,0,31,1.6,0.10117403,4
2020-05-30-170321,170321,0,0,0,31,0.6,0.034033954,5
2020-05-31-170321,170321,0,0,0,31,0.2,0.017867282,6
2020-06-01-170321,170321,0,0,0,31,1.4,0.10949033,0
2020-06-02-170321,170321,0,0,0,31,1.2,0.1577766,1
2020-06-03-170321,170321,0,0,1,31,2.0,0.076823674,2
2020-06-04-170321,170321,0,0,1,31,0.8,0.045659687,3
2020-06-05-170321,170321,2,0,0,33,1.4,0.23484403,4
2020-06-06-170321,170321,0,0,0,33,0.0,0.00144156,5
2020-06-07-170321,170321,0,0,0,33,0.0,0.0020213937,6
2020-06-08-170321,170321,1,0,0,34,1.0,0.22259861,0
2020-06-09-170321,170321,0,0,0,34,1.4,0.19674362,1
2020-06-10-170321,170321,1,0,0,35,0.8,0.30072063,2
2020-06-11-170321,170321,0,0,0,35,1.2,0.09663221,3
2020-06-12-170321,170321,0,0,0,35,0.2,0.060301542,4
2020-06-13-170321,170321,0,0,0,35,0.2,0.009918632,5
2020-06-14-170321,170321,0,0,0,35,0.2,0.007125745,6
2020-06-15-170321,170321,0,1,0,35,0.4,0.089865215,0
2020-06-16-170321,170321,0,0,0,35,0.4,0.03227035,1
2020-06-17-170321,170321,1,1,0,36,0.0,0.08766357,2
2020-06-18-170321,170321,1,0,0,37,0.8,0.08488343,3
2020-06-19-170321,170321,0,0,0,37,0.2,0.01877925,4
2020-06-20-170321,170321,0,0,0,37,0.0,0.0035553304,5
2020-06-21-170321,170321,0,0,0,37,0.0,0.00024561927,6
2020-06-22-170321,170321,0,0,0,37,0.8,0.09685617,0
2020-06-23-170321,170321,0,0,0,37,0.4,0.09583549,1
2020-06-24-170321,170321,0,0,0,37,0.0,0.038380794,2
2020-06-25-170321,170321,0,0,0,37,0.2,0.062344775,3
2020-06-26-170321,170321,0,0,0,37,0.2,0.026227396,4
2020-06-27-170321,170321,0,0,0,37,0.0,0.0026207943,5
2020-06-28-170321,170321,0,0,0,37,0.0,0.00040464295,6
2020-06-29-170321,170321,0,0,0,37,0.0,0.008873546,0
2020-06-30-170321,170321,0,0,0,37,0.2,0.017683664,1
2020-07-01-170321,170321,0,0,0,37,0.0,0.005819797,2
2020-07-02-170321,170321,0,0,0,37,0.2,0.021470584,3
2020-07-03-170321,170321,0,0,0,37,0.2,0.03610631,4
2020-07-04-170321,170321,0,0,1,37,0.0,0.00012587503,5
2020-07-05-170321,170321,0,0,0,37,0.0,0.0018202143,6
2020-07-06-170321,170321,0,0,0,37,0.0,0.03275717,0
2020-07-07-170321,170321,0,0,1,37,0.6,0.054024223,1
2020-07-08-170321,170321,0,0,0,37,0.2,0.01860078,2
2020-07-09-170321,170321,0,0,0,37,0.4,0.08605415,3
2020-07-10-170321,170321,0,0,0,37,0.4,0.041885268,4
2020-07-11-170321,170321,0,0,0,37,0.0,0.011810394,5
2020-07-12-170321,170321,0,0,0,37,0.2,0.007307017,6
2020-07-13-170321,170321,0,0,0,37,0.4,0.017852439,0
2020-07-14-170321,170321,0,0,0,37,0.2,0.0149491085,1
2020-07-15-170321,170321,0,0,0,37,0.4,0.015673414,2
2020-07-16-170321,170321,0,0,0,37,0.2,0.025106085,3
2020-07-17-170321,170321,0,0,0,37,0.4,0.10316181,4
2020-07-18-170321,170321,1,0,0,38,0.2,0.098712474,5
2020-07-19-170321,170321,0,0,0,38,0.2,0.021538382,6
2020-07-20-170321,170321,0,0,1,38,0.4,0.022583948,0
2020-07-21-170321,170321,1,0,0,39,0.6,0.18011826,1
2020-07-22-170321,170321,0,0,0,39,0.6,0.029779999,2
2020-07-23-170321,170321,0,0,0,39,1.0,0.05150221,3
2020-07-24-170321,170321,0,0,0,39,0.6,0.04535726,4
2020-07-25-170321,170321,0,0,0,39,0.0,0.0008384469,5
2020-07-26-170321,170321,0,0,0,39,0.0,0.0047494574,6
2020-07-27-170321,170321,0,0,0,39,0.4,0.018209286,0
2020-07-28-170321,170321,0,0,0,39,0.2,0.106373884,1
2020-07-29-170321,170321,0,0,0,39,0.2,0.014217325,2
2020-07-30-170321,170321,0,0,0,39,0.2,0.016832232,3
2020-07-31-170321,170321,0,0,0,39,0.4,0.027767574,4
2020-08-01-170321,170321,0,0,0,39,0.0,0.003450342,5
2020-08-02-170321,170321,0,0,1,39,0.0,0.03431317,6
2020-08-03-170321,170321,1,0,0,40,0.2,0.111410685,0
2020-08-04-170321,170321,0,0,0,40,0.6,0.13191077,1
2020-08-05-170321,170321,0,0,1,40,0.4,0.05745489,2
2020-08-06-170321,170321,0,0,0,40,0.6,0.07031902,3
2020-08-07-170321,170321,0,0,4,40,0.8,0.05043826,4
2020-08-08-170321,170321,0,0,0,40,0.0,0.030115468,5
2020-08-09-170321,170321,0,0,1,40,0.0,0.04747079,6
2020-08-10-170321,170321,0,0,1,40,1.0,0.1188806,0
2020-08-11-170321,170321,0,0,0,40,1.2,0.16132432,1
2020-08-12-170321,170321,0,0,1,40,0.8,0.04480961,2
2020-08-13-170321,170321,0,0,1,40,0.8,0.21503048,3
2020-08-14-170321,170321,0,0,1,40,0.6,0.0612657,4
2020-08-15-170321,170321,0,0,2,40,1.2,0.1025931,5
2020-08-16-170321,170321,1,0,0,41,0.2,0.09649896,6
2020-08-17-170321,170321,0,0,0,41,1.4,0.11662306,0
2020-08-18-170321,170321,0,0,0,41,0.2,0.05616455,1
2020-08-19-170321,170321,1,0,0,42,3.6,0.33474073,2
2020-08-20-170321,170321,0,0,0,42,1.0,0.18839112,3
2020-08-21-170321,170321,4,0,4,46,3.2,1.0508338,4
2020-08-22-170321,170321,0,0,7,46,0.2,0.094476864,5
2020-08-23-170321,170321,1,0,0,47,0.4,0.1477787,6
2020-08-24-170321,170321,1,0,0,48,0.6,0.63785964,0
2020-08-25-170321,170321,0,0,0,48,4.0,0.7798173,1
2020-08-26-170321,170321,1,0,0,49,2.4,0.4467716,2
2020-08-27-170321,170321,1,0,6,50,2.0,0.41683513,3
2020-08-28-170321,170321,1,0,1,51,1.4,0.24439324,4
2020-08-29-170321,170321,2,0,3,53,1.8,0.5951358,5
2020-08-30-170321,170321,0,0,0,53,0.8,0.111883,6
2020-08-31-170321,170321,0,0,6,53,2.8,0.40802315,0
2020-09-01-170321,170321,0,0,0,53,1.6,0.11940501,1
2020-09-02-170321,170321,0,0,5,53,1.0,0.24569055,2
2020-09-03-170321,170321,0,0,1,53,1.6,0.103283614,3
2020-09-04-170321,170321,4,0,3,57,2.2,0.6757911,4
2020-09-05-170321,170321,7,0,0,64,0.4,0.5649909,5
2020-09-06-170321,170321,0,0,2,64,0.6,0.08537384,6
2020-09-07-170321,170321,0,0,1,64,3.0,0.32044327,0
2020-09-08-170321,170321,0,0,0,64,2.4,0.1988938,1
2020-09-09-170321,170321,0,0,2,64,3.8,0.54911107,2
2020-09-10-170321,170321,6,0,0,70,3.4,0.8115596,3
2020-09-11-170321,170321,1,0,0,71,2.2,0.6866272,4
2020-09-12-170321,170321,3,0,1,74,1.0,0.2498354,5
2020-09-13-170321,170321,0,0,0,74,0.8,0.07408708,6
2020-09-14-170321,170321,6,0,3,80,5.4,0.66971374,0
2020-09-15-170321,170321,0,0,2,80,3.4,0.3519506,1
2020-09-16-170321,170321,5,0,0,85,4.6,0.63499373,2
2020-09-17-170321,170321,1,0,1,86,3.2,0.6366899,3
2020-09-18-170321,170321,3,0,0,89,2.6,0.37415862,4
2020-09-19-170321,170321,0,0,1,89,1.0,0.08164529,5
2020-09-20-170321,170321,2,0,2,91,1.4,0.0794648,6
2020-09-21-170321,170321,1,0,0,92,5.4,0.43536076,0
2020-09-22-170321,170321,0,0,0,92,4.0,0.5240267,1
2020-09-23-170321,170321,2,0,0,94,3.0,0.51901567,2
2020-09-24-170321,170321,0,0,2,94,5.0,1.400197,3
2020-09-25-170321,170321,0,0,0,94,4.0,0.6474509,4
2020-09-26-170321,170321,1,0,0,95,0.2,0.13533607,5
2020-09-27-170321,170321,0,0,0,95,1.0,0.084666595,6
2020-09-28-170321,170321,3,0,1,98,3.4,0.48262078,0
2020-09-29-170321,170321,2,0,0,100,2.0,0.37731495,1
2020-09-30-170321,170321,0,0,0,100,2.4,0.49647865,2
2020-10-01-170321,170321,1,0,0,101,4.6,0.6706992,3
2020-10-02-170321,170321,0,0,0,101,5.8,0.6309092,4
2020-10-03-170321,170321,1,0,0,102,1.4,0.36724922,5
2020-10-04-170321,170321,2,1,0,104,1.2,0.26424855,6
2020-10-05-170321,170321,0,0,3,104,2.4,0.2779049,0
2020-10-06-170321,170321,0,0,0,104,3.4,0.48596016,1
2020-10-07-170321,170321,0,0,0,104,5.4,0.5664334,2
2020-10-08-170321,170321,2,0,1,106,5.2,0.6936865,3
2020-10-09-170321,170321,0,0,0,106,16.0,1.0094686,4
2020-10-10-170321,170321,0,0,4,106,2.8,0.2956858,5
2020-10-11-170321,170321,0,0,1,106,0.8,0.04776937,6
2020-10-12-170321,170321,1,0,2,107,1.6,0.260325,0
2020-10-13-170321,170321,0,0,2,107,9.2,0.91474783,1
2020-10-14-170321,170321,0,0,0,107,5.0,0.8874429,2
2020-10-15-170321,170321,0,0,5,107,4.2,1.1083659,3
2020-10-16-170321,170321,0,0,1,107,4.8,0.95115286,4
2020-10-17-170321,170321,0,0,1,107,3.6,0.47957227,5
2020-10-18-170321,170321,0,0,3,107,1.8,0.31701607,6
2020-10-19-170321,170321,3,0,0,110,10.2,1.1578231,0
2020-10-20-170321,170321,0,0,0,110,3.8,0.4783499,1
2020-10-21-170321,170321,0,0,2,110,5.6,0.35067055,2
2020-10-22-170321,170321,1,0,0,111,7.4,0.9730501,3
2020-10-23-170321,170321,0,0,0,111,5.2,0.808262,4
2020-10-24-170321,170321,4,1,1,115,1.2,0.3353149,5
2020-10-25-170321,170321,1,1,0,116,0.8,0.23472294,6
2020-10-26-170321,170321,2,0,0,118,8.0,1.1020323,0
2020-10-27-170321,170321,2,0,4,120,3.4,0.45950347,1
2020-10-28-170321,170321,0,1,0,120,5.4,0.45177004,2
2020-10-29-170321,170321,5,0,1,125,7.2,0.9155845,3
2020-10-30-170321,170321,1,0,0,126,11.4,1.1725562,4
2020-10-31-170321,170321,1,0,0,127,0.4,0.16389363,5
2020-11-01-170321,170321,3,0,0,130,1.8,0.2822725,6
2020-11-02-170321,170321,0,0,0,130,0.8,0.21543206,0
2020-11-03-170321,170321,0,1,0,130,8.4,1.169903,1
2020-11-04-170321,170321,2,0,0,132,3.6,0.7764188,2
2020-11-05-170321,170321,0,0,0,132,8.4,0.74593985,3
2020-11-06-170321,170321,0,0,0,132,9.2,0.6323351,4
2020-11-07-170321,170321,1,0,0,133,0.2,0.1934245,5
2020-11-08-170321,170321,0,0,0,133,3.8,0.1769776,6
2020-11-09-170321,170321,0,0,0,133,18.2,2.1764846,0
2020-11-10-170321,170321,4,1,0,137,7.8,0.93854064,1
2020-11-11-170321,170321,0,0,0,137,6.0,0.7611781,2
2020-11-12-170321,170321,1,0,0,138,5.0,0.7857653,3
2020-11-13-170321,170321,0,1,0,138,9.0,0.71992236,4
2020-03-01-170322,170322,0,0,2,0,0.0,5.4732667e-05,6
2020-03-02-170322,170322,0,0,10,0,0.0,0.0005030983,0
2020-03-03-170322,170322,0,0,13,0,0.0,1.8713083e-06,1
2020-03-04-170322,170322,0,1,11,0,0.0,0.0016161071,2
2020-03-05-170322,170322,0,0,7,0,0.0,0.00019045341,3
2020-03-06-170322,170322,0,0,12,0,0.0,0.0007368169,4
2020-03-07-170322,170322,0,0,7,0,0.0,0.0021313583,5
2020-03-08-170322,170322,0,0,10,0,0.125,0.002854439,6
2020-03-09-170322,170322,0,0,29,0,0.25,0.059603464,0
2020-03-10-170322,170322,0,0,16,0,0.25,0.0088248765,1
2020-03-11-170322,170322,0,0,12,0,0.125,0.0096492795,2
2020-03-12-170322,170322,0,0,10,0,0.375,0.074200094,3
2020-03-13-170322,170322,0,0,27,0,0.625,0.15450934,4
2020-03-14-170322,170322,4,0,9,4,0.875,0.8381357,5
2020-03-15-170322,170322,2,0,2,6,1.375,0.41104925,6
2020-03-16-170322,170322,10,0,22,16,6.125,2.2498112,0
2020-03-17-170322,170322,13,0,14,29,14.25,3.4885197,1
2020-03-18-170322,170322,11,0,14,40,13.375,3.4033308,2
2020-03-19-170322,170322,7,0,11,47,15.5,3.0977266,3
2020-03-20-170322,170322,12,0,12,59,11.375,3.296102,4
2020-03-21-170322,170322,7,0,6,66,4.25,1.3959497,5
2020-03-22-170322,170322,10,1,1,76,4.375,1.672896,6
2020-03-23-170322,170322,29,0,9,105,18.125,6.775877,0
2020-03-24-170322,170322,16,0,9,121,17.0,4.812838,1
2020-03-25-170322,170322,12,0,45,133,15.875,4.175519,2
2020-03-26-170322,170322,10,0,8,143,13.75,3.1376867,3
2020-03-27-170322,170322,27,0,10,170,13.0,5.4318633,4
2020-03-28-170322,170322,9,0,2,179,3.625,1.4908601,5
2020-03-29-170322,170322,2,0,5,181,3.125,0.5447664,6
2020-03-30-170322,170322,22,0,3,203,11.25,4.351854,0
2020-03-31-170322,170322,14,0,6,217,11.625,2.9264913,1
2020-04-01-170322,170322,14,0,5,231,8.0,2.6867895,2
2020-04-02-170322,170322,11,0,10,242,6.875,2.490095,3
2020-04-03-170322,170322,12,0,4,254,7.0,2.305021,4
2020-04-04-170322,170322,6,0,0,260,1.75,0.99946207,5
2020-04-05-170322,170322,1,0,2,261,1.375,0.2857187,6
2020-04-06-170322,170322,9,0,20,270,8.75,2.1816988,0
2020-04-07-170322,170322,9,0,38,279,6.25,2.2335906,1
2020-04-08-170322,170322,45,0,2,324,5.5,7.3269753,2
2020-04-09-170322,170322,8,0,0,332,5.375,1.3520386,3
2020-04-10-170322,170322,10,0,3,342,9.0,1.9238029,4
2020-04-11-170322,170322,2,0,1,344,2.375,0.553775,5
2020-04-12-170322,170322,5,1,0,349,4.625,1.2273759,6
2020-04-13-170322,170322,3,0,4,352,10.0,1.4876164,0
2020-04-14-170322,170322,6,0,4,358,7.125,1.6374971,1
2020-04-15-170322,170322,5,0,1,363,7.125,1.0613592,2
2020-04-16-170322,170322,10,0,0,373,5.5,1.8580894,3
2020-04-17-170322,170322,4,0,0,377,5.125,1.1881692,4
2020-04-18-170322,170322,0,0,2,377,1.0,0.025133548,5
2020-04-19-170322,170322,2,0,0,379,2.5,0.17819333,6
2020-04-20-170322,170322,20,0,2,399,4.375,3.7243087,0
2020-04-21-170322,170322,38,1,1,437,5.875,5.931984,1
2020-04-22-170322,170322,2,0,3,439,3.0,0.7372097,2
2020-04-23-170322,170322,0,0,0,439,0.625,0.03204193,3
2020-04-24-170322,170322,3,0,8,442,10.625,2.0547717,4
2020-04-25-170322,170322,1,0,1,443,1.625,0.33264533,5
2020-04-26-170322,170322,0,0,0,443,0.75,0.0592671,6
2020-04-27-170322,170322,4,0,0,447,2.75,1.0413995,0
2020-04-28-170322,170322,4,0,0,451,3.375,1.321391,1
2020-04-29-170322,170322,1,0,1,452,2.125,0.2826578,2
2020-04-30-170322,170322,0,0,2,452,3.75,0.22251211,3
2020-05-01-170322,170322,0,0,3,452,0.5,0.09993247,4
2020-05-02-170322,170322,2,0,0,454,1.0,0.4020002,5
2020-05-03-170322,170322,0,0,0,454,0.75,0.19980004,6
2020-05-04-170322,170322,2,0,2,456,3.875,0.93480706,0
2020-05-05-170322,170322,1,0,7,457,3.625,1.0649676,1
2020-05-06-170322,170322,3,0,2,460,2.875,0.90716857,2
2020-05-07-170322,170322,0,0,1,460,2.375,0.37727252,3
2020-05-08-170322,170322,8,0,4,468,2.125,1.7196952,4
2020-05-09-170322,170322,1,1,0,469,0.5,0.2512145,5
2020-05-10-170322,170322,0,1,0,469,0.375,0.051961277,6
2020-05-11-170322,170322,0,0,0,469,2.625,0.4294579,0
2020-05-12-170322,170322,0,0,3,469,2.75,0.43217418,1
2020-05-13-170322,170322,1,0,0,470,4.25,0.6622622,2
2020-05-14-170322,170322,2,1,1,472,3.25,0.90204006,3
2020-05-15-170322,170322,3,0,1,475,2.375,0.6114047,4
2020-05-16-170322,170322,0,2,0,475,0.375,0.04733346,5
2020-05-17-170322,170322,0,0,0,475,0.375,0.027762678,6
2020-05-18-170322,170322,2,0,0,477,2.625,0.76700014,0
2020-05-19-170322,170322,7,0,0,484,2.375,1.7137759,1
2020-05-20-170322,170322,2,0,1,486,2.25,0.7306544,2
2020-05-21-170322,170322,1,0,0,487,2.25,0.7881138,3
2020-05-22-170322,170322,4,0,1,491,1.625,0.8988461,4
2020-05-23-170322,170322,0,0,0,491,0.5,0.041708656,5
2020-05-24-170322,170322,0,0,0,491,0.25,0.014869867,6
2020-05-25-170322,170322,0,0,0,491,2.375,0.23225863,0
2020-05-26-170322,170322,3,0,4,494,1.25,0.91460305,1
2020-05-27-170322,170322,0,0,0,494,1.5,0.5671578,2
2020-05-28-170322,170322,1,0,3,495,2.5,0.8583203,3
2020-05-29-170322,170322,1,0,1,496,2.375,0.6554029,4
2020-05-30-170322,170322,0,0,1,496,0.375,0.057702903,5
2020-05-31-170322,170322,0,0,0,496,0.375,0.005343986,6
2020-06-01-170322,170322,0,0,0,496,3.0,0.67919517,0
2020-06-02-170322,170322,0,0,1,496,3.125,0.4915494,1
2020-06-03-170322,170322,1,0,0,497,2.125,0.5174826,2
2020-06-04-170322,170322,0,0,1,497,3.375,0.7112506,3
2020-06-05-170322,170322,1,0,0,498,1.375,0.49351516,4
2020-06-06-170322,170322,0,0,0,498,0.375,0.06936177,5
2020-06-07-170322,170322,0,0,0,498,0.375,0.043034095,6
2020-06-08-170322,170322,0,0,0,498,1.625,0.23316447,0
2020-06-09-170322,170322,4,0,0,502,1.375,1.0679619,1
2020-06-10-170322,170322,0,0,0,502,3.625,0.89530313,2
2020-06-11-170322,170322,3,0,3,505,2.0,0.86931235,3
2020-06-12-170322,170322,1,0,0,506,2.125,0.6203354,4
2020-06-13-170322,170322,1,0,1,507,0.25,0.19688861,5
2020-06-14-170322,170322,0,1,0,507,0.125,0.004687402,6
2020-06-15-170322,170322,0,1,0,507,1.375,0.3309657,0
2020-06-16-170322,170322,1,0,2,508,1.375,0.4158219,1
2020-06-17-170322,170322,0,0,0,508,1.0,0.21529207,2
2020-06-18-170322,170322,1,1,1,509,0.75,0.27917153,3
2020-06-19-170322,170322,0,0,0,509,0.75,0.077527314,4
2020-06-20-170322,170322,0,1,0,509,0.0,0.0019205731,5
2020-06-21-170322,170322,0,0,0,509,0.0,0.006868593,6
2020-06-22-170322,170322,0,0,0,509,0.875,0.18370645,0
2020-06-23-170322,170322,0,0,1,509,1.5,0.27489462,1
2020-06-24-170322,170322,0,0,1,509,0.875,0.24003565,2
2020-06-25-170322,170322,3,0,0,512,1.25,1.0082667,3
2020-06-26-170322,170322,0,0,0,512,0.625,0.0690645,4
2020-06-27-170322,170322,1,0,0,513,0.0,0.25291526,5
2020-06-28-170322,170322,0,0,1,513,0.0,4.588469e-05,6
2020-06-29-170322,170322,0,0,2,513,0.5,0.25378257,0
2020-06-30-170322,170322,2,0,0,515,0.5,0.66189057,1
2020-07-01-170322,170322,0,0,2,515,0.25,0.012187011,2
2020-07-02-170322,170322,1,0,1,516,0.375,0.3635665,3
2020-07-03-170322,170322,0,0,0,516,0.875,0.07839163,4
2020-07-04-170322,170322,0,0,1,516,0.0,0.0015967672,5
2020-07-05-170322,170322,0,0,1,516,0.25,0.005255521,6
2020-07-06-170322,170322,0,0,2,516,1.125,0.2136367,0
2020-07-07-170322,170322,1,0,1,517,0.375,0.23414177,1
2020-07-08-170322,170322,1,0,2,518,0.5,0.33677214,2
2020-07-09-170322,170322,0,0,2,518,0.875,0.27579024,3
2020-07-10-170322,170322,0,0,3,518,0.625,0.04105117,4
2020-07-11-170322,170322,0,0,0,518,0.25,0.0046036313,5
2020-07-12-170322,170322,1,0,1,519,0.0,0.23957531,6
2020-07-13-170322,170322,2,0,1,521,0.625,0.6393702,0
2020-07-14-170322,170322,0,0,2,521,0.5,0.05898211,1
2020-07-15-170322,170322,2,0,1,523,0.5,0.01654593,2
2020-07-16-170322,170322,1,0,4,524,0.5,0.080553025,3
2020-07-17-170322,170322,0,0,1,524,0.375,0.059661683,4
2020-07-18-170322,170322,1,0,0,525,0.25,0.46936974,5
2020-07-19-170322,170322,1,1,0,526,0.0,0.27075765,6
2020-07-20-170322,170322,2,0,0,528,0.75,0.5149736,0
2020-07-21-170322,170322,1,0,2,529,0.125,0.25624093,1
2020-07-22-170322,170322,2,1,1,531,0.75,0.50754696,2
2020-07-23-170322,170322,2,0,2,533,0.25,0.58027744,3
2020-07-24-170322,170322,3,1,0,536,0.5,0.67116994,4
2020-07-25-170322,170322,0,0,0,536,0.0,0.004347228,5
2020-07-26-170322,170322,1,0,0,537,0.0,0.26111802,6
2020-07-27-170322,170322,1,0,1,538,0.375,0.3085428,0
2020-07-28-170322,170322,2,0,0,540,0.75,0.49441648,1
2020-07-29-170322,170322,1,0,1,541,0.625,0.02690357,2
2020-07-30-170322,170322,4,0,1,545,0.25,1.0476073,3
2020-07-31-170322,170322,1,0,1,546,0.625,0.4106617,4
2020-08-01-170322,170322,0,0,0,546,0.125,0.10110679,5
2020-08-02-170322,170322,0,0,2,546,0.125,0.17800558,6
2020-08-03-170322,170322,0,0,0,546,0.625,0.06892064,0
2020-08-04-170322,170322,2,0,2,548,1.0,0.75000525,1
2020-08-05-170322,170322,1,0,2,549,0.75,0.50155944,2
2020-08-06-170322,170322,2,0,6,551,1.25,1.0699725,3
2020-08-07-170322,170322,0,0,7,551,2.0,0.15398549,4
2020-08-08-170322,170322,0,0,0,551,0.25,0.22463617,5
2020-08-09-170322,170322,0,0,4,551,0.0,0.054393053,6
2020-08-10-170322,170322,1,0,3,552,0.5,0.23926459,0
2020-08-11-170322,170322,0,0,6,552,0.625,0.12642373,1
2020-08-12-170322,170322,1,0,1,553,1.0,0.28186858,2
2020-08-13-170322,170322,1,0,10,554,0.25,0.18097165,3
2020-08-14-170322,170322,1,0,2,555,0.625,0.34653634,4
2020-08-15-170322,170322,0,0,0,555,1.0,0.5735107,5
2020-08-16-170322,170322,2,0,4,557,0.25,0.5653404,6
2020-08-17-170322,170322,0,0,7,557,0.5,0.09844968,0
2020-08-18-170322,170322,2,0,2,559,1.375,1.0249171,1
2020-08-19-170322,170322,2,0,2,561,1.375,0.60943764,2
2020-08-20-170322,170322,6,0,8,567,1.375,1.0529003,3
2020-08-21-170322,170322,7,0,4,574,0.625,0.90898925,4
2020-08-22-170322,170322,0,0,3,574,0.25,0.16809018,5
2020-08-23-170322,170322,4,0,2,578,0.875,0.7611382,6
2020-08-24-170322,170322,3,0,7,581,0.625,0.590697,0
2020-08-25-170322,170322,6,0,2,587,2.375,1.4841912,1
2020-08-26-170322,170322,1,0,7,588,4.0,1.7988178,2
2020-08-27-170322,170322,10,0,1,598,2.875,2.416394,3
2020-08-28-170322,170322,2,0,1,600,3.125,1.5175956,4
2020-08-29-170322,170322,0,0,1,600,1.875,0.4731191,5
2020-08-30-170322,170322,4,0,6,604,3.875,2.0496259,6
2020-08-31-170322,170322,7,0,2,611,2.0,1.6285648,0
2020-09-01-170322,170322,2,1,10,613,2.625,1.1516266,1
2020-09-02-170322,170322,2,0,10,615,2.25,0.7812468,2
2020-09-03-170322,170322,8,0,15,623,2.375,2.10834,3
2020-09-04-170322,170322,4,0,7,627,2.25,1.5153518,4
2020-09-05-170322,170322,3,0,3,630,1.0,0.05925072,5
2020-09-06-170322,170322,2,0,1,632,2.625,0.7223701,6
2020-09-07-170322,170322,7,0,11,639,2.75,1.9990995,0
2020-09-08-170322,170322,2,0,6,641,2.375,0.36955762,1
2020-09-09-170322,170322,7,0,11,648,8.25,2.125014,2
2020-09-10-170322,170322,1,0,3,649,5.0,0.7235793,3
2020-09-11-170322,170322,1,0,14,650,5.375,1.3447349,4
2020-09-12-170322,170322,1,0,2,651,2.0,0.37254158,5
2020-09-13-170322,170322,6,0,0,657,3.25,1.6372385,6
2020-09-14-170322,170322,2,0,8,659,4.625,0.6970451,0
2020-09-15-170322,170322,10,0,9,669,5.75,2.2462695,1
2020-09-16-170322,170322,10,0,2,679,3.75,1.2210158,2
2020-09-17-170322,170322,15,0,29,694,3.5,1.801723,3
2020-09-18-170322,170322,7,0,15,701,3.0,0.8848123,4
2020-09-19-170322,170322,3,0,1,704,2.625,0.45521957,5
2020-09-20-170322,170322,1,1,0,705,2.875,0.4519158,6
2020-09-21-170322,170322,11,1,6,716,5.625,1.6565585,0
2020-09-22-170322,170322,6,1,4,722,4.375,1.9793038,1
2020-09-23-170322,170322,11,2,3,733,5.0,1.9359689,2
2020-09-24-170322,170322,3,1,9,736,5.875,1.9653838,3
2020-09-25-170322,170322,14,1,6,750,4.5,2.9044852,4
2020-09-26-170322,170322,2,0,1,752,3.375,1.0386515,5
2020-09-27-170322,170322,0,0,1,752,1.375,0.13688858,6
2020-09-28-170322,170322,8,0,0,760,6.0,2.2195415,0
2020-09-29-170322,170322,9,0,13,769,4.25,1.893122,1
2020-09-30-170322,170322,2,0,20,771,7.625,1.4870377,2
2020-10-01-170322,170322,29,0,12,800,10.25,6.0048127,3
2020-10-02-170322,170322,15,0,12,815,6.875,3.237276,4
2020-10-03-170322,170322,1,0,1,816,2.375,0.5634904,5
2020-10-04-170322,170322,0,1,2,816,3.25,0.20972013,6
2020-10-05-170322,170322,6,1,21,822,3.0,1.8834552,0
2020-10-06-170322,170322,4,1,8,826,9.25,1.4981183,1
2020-10-07-170322,170322,3,1,11,829,5.5,0.7206664,2
2020-10-08-170322,170322,9,0,9,838,8.125,1.9779295,3
2020-10-09-170322,170322,6,0,9,844,13.125,2.9222116,4
2020-10-10-170322,170322,1,0,8,845,2.375,0.4505505,5
2020-10-11-170322,170322,1,0,4,846,2.75,0.8356468,6
2020-10-12-170322,170322,0,0,9,846,3.875,0.6040617,0
2020-10-13-170322,170322,13,0,7,859,14.0,3.4228754,1
2020-10-14-170322,170322,20,0,10,879,8.75,4.077099,2
2020-10-15-170322,170322,12,0,26,891,12.25,2.971695,3
2020-10-16-170322,170322,12,0,10,903,12.875,3.238545,4
2020-10-17-170322,170322,1,0,5,904,4.375,1.1214842,5
2020-10-18-170322,170322,2,1,3,906,4.0,0.72826904,6
2020-10-19-170322,170322,21,0,6,927,8.25,4.433684,0
2020-10-20-170322,170322,8,0,17,935,8.375,2.3241656,1
2020-10-21-170322,170322,11,1,5,946,9.625,2.8914468,2
2020-10-22-170322,170322,9,0,22,955,8.75,2.5084257,3
2020-10-23-170322,170322,9,1,14,964,10.0,3.2481456,4
2020-10-24-170322,170322,8,1,6,972,3.75,1.8171557,5
2020-10-25-170322,170322,4,3,4,976,2.875,0.90362716,6
2020-10-26-170322,170322,9,1,13,985,8.875,2.675956,0
2020-10-27-170322,170322,7,0,9,992,7.375,2.5632257,1
2020-10-28-170322,170322,10,1,8,1002,7.125,2.6264014,2
2020-10-29-170322,170322,26,0,11,1028,11.875,5.395101,3
2020-10-30-170322,170322,10,1,28,1038,8.75,2.9429076,4
2020-10-31-170322,170322,5,0,0,1043,5.0,1.8220607,5
2020-11-01-170322,170322,3,0,0,1046,5.75,0.6962902,6
2020-11-02-170322,170322,6,2,0,1052,2.25,1.9758742,0
2020-11-03-170322,170322,17,0,0,1069,11.375,4.280621,1
2020-11-04-170322,170322,5,1,0,1074,5.625,1.3516313,2
2020-11-05-170322,170322,22,2,0,1096,9.625,5.582463,3
2020-11-06-170322,170322,14,1,0,1110,11.625,3.5092406,4
2020-11-07-170322,170322,6,0,0,1116,4.25,1.9928844,5
2020-11-08-170322,170322,4,0,0,1120,3.375,0.7185699,6
2020-11-09-170322,170322,13,0,0,1133,14.25,3.309223,0
2020-11-10-170322,170322,9,0,0,1142,7.75,2.624526,1
2020-11-11-170322,170322,8,1,0,1150,6.625,2.2223895,2
2020-11-12-170322,170322,11,0,0,1161,7.0,2.3019066,3
2020-11-13-170322,170322,28,0,0,1189,7.375,4.7984653,4
2020-03-01-170323,170323,0,0,0,0,0.0,4.368748e-08,6
2020-03-02-170323,170323,0,0,4,0,0.0,0.00027525204,0
2020-03-03-170323,170323,0,0,1,0,0.0,0.00039112865,1
2020-03-04-170323,170323,0,0,2,0,0.0,0.0017083285,2
2020-03-05-170323,170323,0,0,0,0,0.0,2.8470313e-07,3
2020-03-06-170323,170323,0,0,1,0,0.0,0.0005918893,4
2020-03-07-170323,170323,0,0,0,0,0.0,0.00076294574,5
2020-03-08-170323,170323,0,0,0,0,0.0,0.0042768223,6
2020-03-09-170323,170323,0,0,4,0,0.125,0.07481509,0
2020-03-10-170323,170323,0,0,2,0,0.0,0.0012340626,1
2020-03-11-170323,170323,0,0,3,0,0.125,0.027847312,2
2020-03-12-170323,170323,0,1,1,0,0.125,0.022254772,3
2020-03-13-170323,170323,0,0,1,0,0.125,0.02820655,4
2020-03-14-170323,170323,0,0,0,0,0.125,0.0272646,5
2020-03-15-170323,170323,0,0,1,0,0.875,0.070405684,6
2020-03-16-170323,170323,4,0,1,4,1.0,0.46346575,0
2020-03-17-170323,170323,1,1,2,5,1.0,0.36558944,1
2020-03-18-170323,170323,2,0,1,7,1.0,0.46840206,2
2020-03-19-170323,170323,0,2,0,7,2.75,0.76291525,3
2020-03-20-170323,170323,1,2,2,8,3.5,0.7156705,4
2020-03-21-170323,170323,0,0,1,8,1.5,0.20573938,5
2020-03-22-170323,170323,0,0,0,8,1.0,0.093977645,6
2020-03-23-170323,170323,4,1,1,12,3.5,0.8771878,0
2020-03-24-170323,170323,2,0,0,14,2.125,0.6565231,1
2020-03-25-170323,170323,3,0,3,17,2.0,0.76123446,2
2020-03-26-170323,170323,1,0,0,18,1.625,0.38613072,3
2020-03-27-170323,170323,1,0,1,19,2.5,0.5330724,4
2020-03-28-170323,170323,0,0,1,19,0.75,0.1718448,5
2020-03-29-170323,170323,1,0,1,20,0.5,0.06564656,6
2020-03-30-170323,170323,1,0,1,21,1.625,0.39164004,0
2020-03-31-170323,170323,2,0,2,23,1.0,0.3335315,1
2020-04-01-170323,170323,1,0,2,24,2.0,0.5179914,2
2020-04-02-170323,170323,0,0,1,24,0.75,0.15588155,3
2020-04-03-170323,170323,2,0,0,26,1.25,0.3415122,4
2020-04-04-170323,170323,1,0,0,27,0.625,0.23678572,5
2020-04-05-170323,170323,0,0,0,27,0.75,0.04695107,6
2020-04-06-170323,170323,1,0,2,28,1.375,0.3370134,0
2020-04-07-170323,170323,0,0,1,28,1.625,0.36706915,1
2020-04-08-170323,170323,3,1,1,31,1.25,0.39143527,2
2020-04-09-170323,170323,0,0,0,31,0.5,0.14814042,3
2020-04-10-170323,170323,1,0,0,32,4.125,0.35082996,4
2020-04-11-170323,170323,1,0,1,33,0.75,0.103288054,5
2020-04-12-170323,170323,1,0,1,34,0.25,0.047904573,6
2020-04-13-170323,170323,1,0,0,35,1.875,0.42110997,0
2020-04-14-170323,170323,2,0,1,37,1.375,0.6268664,1
2020-04-15-170323,170323,2,0,1,39,1.0,0.31353346,2
2020-04-16-170323,170323,1,0,0,40,0.75,0.23927847,3
2020-04-17-170323,170323,0,0,0,40,0.5,0.2890075,4
2020-04-18-170323,170323,0,0,0,40,0.25,0.041571252,5
2020-04-19-170323,170323,0,0,0,40,0.125,0.015702087,6
2020-04-20-170323,170323,2,0,0,42,0.375,0.24145503,0
2020-04-21-170323,170323,1,0,0,43,0.5,0.2019507,1
2020-04-22-170323,170323,1,0,1,44,0.625,0.2577039,2
2020-04-23-170323,170323,0,0,2,44,0.125,0.02199107,3
2020-04-24-170323,170323,0,0,1,44,1.25,0.28023872,4
2020-04-25-170323,170323,1,0,1,45,0.75,0.18414737,5
2020-04-26-170323,170323,1,0,0,46,0.5,0.062745534,6
2020-04-27-170323,170323,0,0,0,46,0.25,0.11674045,0
2020-04-28-170323,170323,1,0,1,47,1.5,0.32197055,1
2020-04-29-170323,170323,1,0,0,48,0.625,0.17002635,2
2020-04-30-170323,170323,0,0,0,48,0.25,0.079247825,3
2020-05-01-170323,170323,0,0,0,48,0.125,0.008335143,4
2020-05-02-170323,170323,0,0,0,48,0.125,0.05131556,5
2020-05-03-170323,170323,0,0,0,48,0.0,0.030690802,6
2020-05-04-170323,170323,0,0,0,48,0.875,0.1339243,0
2020-05-05-170323,170323,0,0,0,48,0.375,0.23425788,1
2020-05-06-170323,170323,1,0,0,49,0.625,0.23212181,2
2020-05-07-170323,170323,2,0,0,51,1.125,0.39007536,3
2020-05-08-170323,170323,1,0,0,52,0.5,0.20752531,4
2020-05-09-170323,170323,1,0,1,53,0.0,0.08098269,5
2020-05-10-170323,170323,0,3,0,53,0.5,0.028411662,6
2020-05-11-170323,170323,0,5,0,53,0.375,0.14788026,0
2020-05-12-170323,170323,1,1,0,54,0.25,0.09097276,1
2020-05-13-170323,170323,0,0,1,54,1.5,0.1863401,2
2020-05-14-170323,170323,0,0,0,54,1.0,0.30755132,3
2020-05-15-170323,170323,0,0,0,54,0.125,0.077934556,4
2020-05-16-170323,170323,0,1,0,54,0.25,0.037205756,5
2020-05-17-170323,170323,0,0,0,54,0.0,0.024355445,6
2020-05-18-170323,170323,0,0,2,54,0.75,0.16492775,0
2020-05-19-170323,170323,0,0,0,54,0.25,0.17301995,1
2020-05-20-170323,170323,0,0,0,54,0.625,0.14757879,2
2020-05-21-170323,170323,0,0,0,54,0.625,0.17705841,3
2020-05-22-170323,170323,0,0,0,54,0.375,0.12408396,4
2020-05-23-170323,170323,1,1,0,55,0.25,0.084930174,5
2020-05-24-170323,170323,0,0,0,55,0.0,0.003728877,6
2020-05-25-170323,170323,0,0,0,55,0.75,0.12989858,0
2020-05-26-170323,170323,0,0,0,55,1.0,0.1685727,1
2020-05-27-170323,170323,1,0,1,56,0.125,0.31023988,2
2020-05-28-170323,170323,0,0,0,56,0.375,0.113038935,3
2020-05-29-170323,170323,0,0,0,56,1.25,0.14501214,4
2020-05-30-170323,170323,0,0,0,56,0.0,0.04139005,5
2020-05-31-170323,170323,0,0,0,56,0.375,0.05236655,6
2020-06-01-170323,170323,2,0,0,58,0.125,0.21438815,0
2020-06-02-170323,170323,0,0,0,58,0.75,0.19262518,1
2020-06-03-170323,170323,0,0,0,58,0.25,0.05271019,2
2020-06-04-170323,170323,0,0,0,58,0.375,0.0753695,3
2020-06-05-170323,170323,0,0,0,58,0.5,0.16674408,4
2020-06-06-170323,170323,0,0,0,58,0.0,0.00688875,5
2020-06-07-170323,170323,0,0,0,58,0.0,0.0025576293,6
2020-06-08-170323,170323,0,0,0,58,0.375,0.1814502,0
2020-06-09-170323,170323,0,0,1,58,0.875,0.22585928,1
2020-06-10-170323,170323,1,0,0,59,2.375,0.3584185,2
2020-06-11-170323,170323,0,0,0,59,0.5,0.14773963,3
2020-06-12-170323,170323,0,0,0,59,0.25,0.08629163,4
2020-06-13-170323,170323,0,0,0,59,0.25,0.025997419,5
2020-06-14-170323,170323,0,1,0,59,0.125,0.024304625,6
2020-06-15-170323,170323,0,0,0,59,0.5,0.13990285,0
2020-06-16-170323,170323,0,0,0,59,0.125,0.025482144,1
2020-06-17-170323,170323,0,0,0,59,0.25,0.041154742,2
2020-06-18-170323,170323,0,0,0,59,0.625,0.06454352,3
2020-06-19-170323,170323,0,1,1,59,0.0,0.025488017,4
2020-06-20-170323,170323,0,0,0,59,0.125,0.016300803,5
2020-06-21-170323,170323,0,0,0,59,0.0,0.0030786423,6
2020-06-22-170323,170323,0,0,0,59,0.375,0.081966706,0
2020-06-23-170323,170323,1,0,0,60,0.5,0.18551438,1
2020-06-24-170323,170323,0,0,0,60,0.0,0.1153295,2
2020-06-25-170323,170323,0,0,0,60,0.375,0.11077017,3
2020-06-26-170323,170323,0,1,1,60,0.375,0.0999806,4
2020-06-27-170323,170323,0,0,0,60,0.0,0.017686402,5
2020-06-28-170323,170323,0,0,0,60,0.0,0.00073118013,6
2020-06-29-170323,170323,0,0,0,60,0.125,0.038779,0
2020-06-30-170323,170323,0,0,0,60,0.375,0.046267208,1
2020-07-01-170323,170323,0,0,0,60,0.125,0.036353275,2
2020-07-02-170323,170323,0,0,0,60,0.5,0.052327137,3
2020-07-03-170323,170323,1,0,0,61,0.125,0.14454919,4
2020-07-04-170323,170323,0,0,0,61,0.0,0.0018304221,5
2020-07-05-170323,170323,0,0,0,61,0.0,0.0013153832,6
2020-07-06-170323,170323,0,0,0,61,0.875,0.16271769,0
2020-07-07-170323,170323,0,1,0,61,0.0,0.044510446,1
2020-07-08-170323,170323,0,0,0,61,0.0,0.03782439,2
2020-07-09-170323,170323,0,2,0,61,0.125,0.08008772,3
2020-07-10-170323,170323,1,0,0,62,0.125,0.14790799,4
2020-07-11-170323,170323,0,0,0,62,0.25,0.07230309,5
2020-07-12-170323,170323,0,0,0,62,0.0,0.0028007112,6
2020-07-13-170323,170323,0,0,0,62,0.125,0.014101377,0
2020-07-14-170323,170323,0,0,0,62,0.0,0.056266863,1
2020-07-15-170323,170323,0,0,0,62,0.375,0.048150226,2
2020-07-16-170323,170323,0,0,0,62,0.375,0.110578276,3
2020-07-17-170323,170323,0,0,1,62,0.375,0.13176143,4
2020-07-18-170323,170323,0,0,0,62,0.25,0.02470334,5
2020-07-19-170323,170323,0,0,0,62,0.125,0.06284402,6
2020-07-20-170323,170323,0,0,0,62,0.125,0.031739533,0
2020-07-21-170323,170323,0,0,0,62,0.375,0.1510114,1
2020-07-22-170323,170323,0,0,0,62,0.125,0.016344631,2
2020-07-23-170323,170323,0,0,0,62,0.0,0.0882175,3
2020-07-24-170323,170323,0,0,0,62,0.125,0.054375254,4
2020-07-25-170323,170323,0,0,0,62,0.25,0.007606128,5
2020-07-26-170323,170323,0,0,0,62,0.0,0.0014609203,6
2020-07-27-170323,170323,0,0,1,62,0.375,0.06524258,0
2020-07-28-170323,170323,0,0,0,62,0.75,0.1710053,1
2020-07-29-170323,170323,0,0,0,62,0.0,0.034939796,2
2020-07-30-170323,170323,0,0,0,62,0.5,0.025809392,3
2020-07-31-170323,170323,1,0,0,63,0.125,0.03556291,4
2020-08-01-170323,170323,0,0,0,63,0.0,0.022386698,5
2020-08-02-170323,170323,0,0,0,63,0.125,0.07094071,6
2020-08-03-170323,170323,0,0,1,63,0.25,0.05815644,0
2020-08-04-170323,170323,0,0,0,63,0.25,0.17903565,1
2020-08-05-170323,170323,0,0,2,63,0.125,0.16119774,2
2020-08-06-170323,170323,0,0,0,63,0.375,0.17771517,3
2020-08-07-170323,170323,0,0,7,63,0.25,0.073506035,4
2020-08-08-170323,170323,0,0,0,63,0.0,0.06528021,5
2020-08-09-170323,170323,0,0,0,63,0.125,0.1089369,6
2020-08-10-170323,170323,1,0,0,64,0.5,0.23627461,0
2020-08-11-170323,170323,0,0,4,64,0.625,0.25249702,1
2020-08-12-170323,170323,0,0,6,64,0.875,0.17962292,2
2020-08-13-170323,170323,0,0,4,64,1.125,0.27973574,3
2020-08-14-170323,170323,0,0,3,64,0.125,0.113133214,4
2020-08-15-170323,170323,0,0,5,64,0.75,0.12091098,5
2020-08-16-170323,170323,0,0,1,64,0.5,0.10221738,6
2020-08-17-170323,170323,1,0,3,65,0.625,0.23072655,0
2020-08-18-170323,170323,0,0,0,65,0.875,0.13065355,1
2020-08-19-170323,170323,2,0,1,67,2.125,0.3685718,2
2020-08-20-170323,170323,0,0,0,67,0.875,0.2818543,3
2020-08-21-170323,170323,7,0,1,74,3.5,0.9787464,4
2020-08-22-170323,170323,0,0,0,74,0.625,0.2805669,5
2020-08-23-170323,170323,0,0,0,74,1.0,0.15843756,6
2020-08-24-170323,170323,0,0,0,74,1.5,0.6350023,0
2020-08-25-170323,170323,4,0,0,78,2.0,1.1771771,1
2020-08-26-170323,170323,6,0,2,84,0.5,0.82221484,2
2020-08-27-170323,170323,4,0,2,88,2.875,0.79076755,3
2020-08-28-170323,170323,3,0,0,91,0.375,0.34883234,4
2020-08-29-170323,170323,5,0,0,96,0.5,0.6669722,5
2020-08-30-170323,170323,1,0,0,97,0.625,0.15357472,6
2020-08-31-170323,170323,3,0,0,100,0.375,0.5390397,0
2020-09-01-170323,170323,0,0,0,100,0.875,0.27057233,1
2020-09-02-170323,170323,1,0,1,101,0.875,0.41872036,2
2020-09-03-170323,170323,0,0,0,101,1.25,0.16495831,3
2020-09-04-170323,170323,1,0,0,102,1.625,0.71491885,4
2020-09-05-170323,170323,0,0,0,102,1.0,0.20651247,5
2020-09-06-170323,170323,0,0,0,102,0.75,0.13776627,6
2020-09-07-170323,170323,0,0,0,102,1.75,0.41873837,0
2020-09-08-170323,170323,0,0,5,102,1.75,0.34755227,1
2020-09-09-170323,170323,2,0,0,104,2.0,0.9927447,2
2020-09-10-170323,170323,2,0,0,106,2.25,0.8681875,3
2020-09-11-170323,170323,0,0,1,106,0.75,1.0463574,4
2020-09-12-170323,170323,0,0,0,106,0.75,0.1548615,5
2020-09-13-170323,170323,0,0,0,106,0.125,0.14543605,6
2020-09-14-170323,170323,0,0,1,106,3.375,0.50657994,0
2020-09-15-170323,170323,0,0,0,106,1.875,0.46620905,1
2020-09-16-170323,170323,1,0,0,107,1.875,0.6008074,2
2020-09-17-170323,170323,0,0,0,107,1.0,0.86057836,3
2020-09-18-170323,170323,0,0,0,107,1.75,0.56775373,4
2020-09-19-170323,170323,0,0,0,107,0.25,0.10814965,5
2020-09-20-170323,170323,0,1,1,107,1.5,0.13088126,6
2020-09-21-170323,170323,0,0,0,107,2.5,0.6459553,0
2020-09-22-170323,170323,5,0,0,112,0.75,0.6778952,1
2020-09-23-170323,170323,0,1,2,112,2.5,0.84376675,2
2020-09-24-170323,170323,0,0,2,112,2.125,2.3135145,3
2020-09-25-170323,170323,1,0,1,113,6.0,2.4424648,4
2020-09-26-170323,170323,0,0,0,113,2.0,0.3330177,5
2020-09-27-170323,170323,0,0,0,113,0.125,0.1328587,6
2020-09-28-170323,170323,1,0,3,114,1.375,0.44658944,0
2020-09-29-170323,170323,0,0,1,114,2.125,0.5226362,1
2020-09-30-170323,170323,0,0,1,114,2.5,0.75226027,2
2020-10-01-170323,170323,0,0,2,114,2.5,0.9865989,3
2020-10-02-170323,170323,0,0,0,114,1.75,0.8877101,4
2020-10-03-170323,170323,0,0,1,114,1.25,0.45493755,5
2020-10-04-170323,170323,1,0,0,115,1.875,0.2960476,6
2020-10-05-170323,170323,0,0,1,115,2.875,0.569044,0
2020-10-06-170323,170323,0,0,0,115,1.25,0.60798115,1
2020-10-07-170323,170323,2,0,1,117,1.625,0.9528739,2
2020-10-08-170323,170323,2,0,2,119,3.5,0.8410767,3
2020-10-09-170323,170323,1,1,4,120,2.125,1.0571961,4
2020-10-10-170323,170323,0,0,0,120,2.0,0.6345412,5
2020-10-11-170323,170323,0,0,0,120,0.5,0.105867945,6
2020-10-12-170323,170323,3,0,1,123,1.25,0.39390624,0
2020-10-13-170323,170323,1,0,1,124,2.125,1.0370622,1
2020-10-14-170323,170323,1,0,0,125,1.25,1.1290885,2
2020-10-15-170323,170323,2,0,3,127,1.875,1.8579148,3
2020-10-16-170323,170323,0,0,3,127,1.5,1.2489585,4
2020-10-17-170323,170323,1,0,0,128,2.5,0.7729804,5
2020-10-18-170323,170323,0,1,2,128,2.0,0.562802,6
2020-10-19-170323,170323,1,0,1,129,4.75,1.2045454,0
2020-10-20-170323,170323,0,0,0,129,2.0,0.777306,1
2020-10-21-170323,170323,1,0,2,130,3.75,0.5594586,2
2020-10-22-170323,170323,2,1,1,132,4.375,1.370093,3
2020-10-23-170323,170323,4,0,4,136,1.25,1.6020466,4
2020-10-24-170323,170323,0,2,0,136,2.625,0.33556414,5
2020-10-25-170323,170323,0,0,0,136,1.625,0.31142136,6
2020-10-26-170323,170323,1,0,3,137,2.875,1.2343132,0
2020-10-27-170323,170323,1,0,3,138,1.25,0.54078513,1
2020-10-28-170323,170323,0,0,7,138,4.0,0.6384384,2
2020-10-29-170323,170323,3,0,3,141,2.375,1.0136298,3
2020-10-30-170323,170323,3,0,1,144,2.125,1.3039843,4
2020-10-31-170323,170323,0,0,0,144,1.125,0.2843456,5
2020-11-01-170323,170323,2,0,0,146,2.375,0.41500416,6
2020-11-02-170323,170323,1,0,0,147,1.625,0.33380115,0
2020-11-03-170323,170323,0,0,0,147,3.625,1.2799709,1
2020-11-04-170323,170323,2,1,0,149,3.0,1.2015642,2
2020-11-05-170323,170323,1,0,0,150,3.875,1.1791704,3
2020-11-06-170323,170323,4,1,0,154,4.0,1.0884923,4
2020-11-07-170323,170323,0,0,0,154,1.125,0.48362577,5
2020-11-08-170323,170323,0,0,0,154,1.125,0.25830072,6
2020-11-09-170323,170323,3,0,0,157,4.75,2.1266763,0
2020-11-10-170323,170323,3,0,0,160,3.375,1.1379968,1
2020-11-11-170323,170323,7,0,0,167,1.25,1.3259546,2
2020-11-12-170323,170323,3,0,0,170,4.75,1.1758059,3
2020-11-13-170323,170323,1,1,0,171,1.125,1.2465707,4
2020-03-01-170324,170324,0,0,3,0,0.16666666666666666,0.0013220959,6
2020-03-02-170324,170324,0,0,14,0,0.0,0.00038183402,0
2020-03-03-170324,170324,0,0,19,0,0.0,4.1994772e-07,1
2020-03-04-170324,170324,0,1,15,0,0.0,0.0012576104,2
2020-03-05-170324,170324,0,0,25,0,0.0,0.00046197436,3
2020-03-06-170324,170324,0,0,13,0,0.0,0.001544486,4
2020-03-07-170324,170324,0,0,3,0,0.0,0.0021331566,5
2020-03-08-170324,170324,0,0,5,0,0.0,0.0014677659,6
2020-03-09-170324,170324,0,0,27,0,0.0,0.022306815,0
2020-03-10-170324,170324,0,0,14,0,0.0,0.0020223812,1
2020-03-11-170324,170324,0,0,15,0,0.16666666666666666,0.0033769985,2
2020-03-12-170324,170324,0,0,14,0,0.16666666666666666,0.047782663,3
2020-03-13-170324,170324,0,0,20,0,0.16666666666666666,0.031366132,4
2020-03-14-170324,170324,0,0,1,0,1.5,0.21006079,5
2020-03-15-170324,170324,3,0,2,3,1.0,0.15896165,6
2020-03-16-170324,170324,14,0,15,17,7.0,1.5356199,0
2020-03-17-170324,170324,19,0,9,36,13.0,1.6910309,1
2020-03-18-170324,170324,15,0,11,51,13.333333333333336,1.9903728,2
2020-03-19-170324,170324,25,0,6,76,14.333333333333336,2.3566442,3
2020-03-20-170324,170324,13,0,6,89,12.833333333333336,1.8987527,4
2020-03-21-170324,170324,3,0,0,92,2.6666666666666665,0.39545542,5
2020-03-22-170324,170324,5,0,2,97,3.8333333333333335,0.3098087,6
2020-03-23-170324,170324,27,0,9,124,19.666666666666668,3.1137762,0
2020-03-24-170324,170324,14,0,12,138,16.0,2.07808,1
2020-03-25-170324,170324,15,0,8,153,16.0,2.4875512,2
2020-03-26-170324,170324,14,0,8,167,18.666666666666668,2.211065,3
2020-03-27-170324,170324,20,1,0,187,16.333333333333332,2.742128,4
2020-03-28-170324,170324,1,0,0,188,3.5,0.2776726,5
2020-03-29-170324,170324,2,0,2,190,1.1666666666666667,0.2028843,6
2020-03-30-170324,170324,15,0,20,205,17.833333333333332,2.4320724,0
2020-03-31-170324,170324,9,0,11,214,14.666666666666664,1.4745985,1
2020-04-01-170324,170324,11,0,9,225,10.333333333333334,1.4262869,2
2020-04-02-170324,170324,6,0,7,231,7.666666666666668,1.1193781,3
2020-04-03-170324,170324,6,0,7,237,9.5,1.2078176,4
2020-04-04-170324,170324,0,0,3,237,2.333333333333333,0.23325603,5
2020-04-05-170324,170324,2,0,0,239,1.1666666666666667,0.15975288,6
2020-04-06-170324,170324,9,0,5,248,8.666666666666666,1.4132049,0
2020-04-07-170324,170324,12,0,7,260,7.0,1.2755425,1
2020-04-08-170324,170324,8,0,5,268,12.666666666666664,1.5100665,2
2020-04-09-170324,170324,8,0,2,276,8.333333333333334,0.8463925,3
2020-04-10-170324,170324,0,0,6,276,6.166666666666668,0.847209,4
2020-04-11-170324,170324,0,0,6,276,1.3333333333333333,0.19130765,5
2020-04-12-170324,170324,2,0,1,278,1.5,0.23977973,6
2020-04-13-170324,170324,20,0,6,298,7.0,2.0367935,0
2020-04-14-170324,170324,11,0,4,309,5.333333333333333,1.6299281,1
2020-04-15-170324,170324,9,0,4,318,6.166666666666668,1.5660965,2
2020-04-16-170324,170324,7,0,3,325,5.166666666666667,1.4471803,3
2020-04-17-170324,170324,7,0,0,332,5.333333333333333,1.0743264,4
2020-04-18-170324,170324,3,0,3,335,0.3333333333333333,0.11526125,5
2020-04-19-170324,170324,0,0,1,335,1.1666666666666667,0.11918171,6
2020-04-20-170324,170324,5,0,2,340,8.666666666666666,1.4014261,0
2020-04-21-170324,170324,7,0,2,347,9.333333333333334,1.2744753,1
2020-04-22-170324,170324,5,0,4,352,9.166666666666666,1.3813797,2
2020-04-23-170324,170324,2,0,5,354,0.16666666666666666,0.14494278,3
2020-04-24-170324,170324,6,0,2,360,12.5,2.140506,4
2020-04-25-170324,170324,6,0,0,366,0.3333333333333333,0.2474764,5
2020-04-26-170324,170324,1,0,0,367,0.5,0.061750464,6
2020-04-27-170324,170324,6,0,3,373,4.333333333333333,0.7377912,0
2020-04-28-170324,170324,4,2,3,377,3.0,0.5805154,1
2020-04-29-170324,170324,4,0,0,381,4.166666666666667,0.5609506,2
2020-04-30-170324,170324,3,0,4,384,5.166666666666667,0.6293736,3
2020-05-01-170324,170324,0,0,4,384,0.16666666666666666,0.013377968,4
2020-05-02-170324,170324,3,0,0,387,0.8333333333333334,0.16206335,5
2020-05-03-170324,170324,1,0,1,388,0.6666666666666666,0.05120895,6
2020-05-04-170324,170324,2,0,2,390,6.166666666666668,0.65958005,0
2020-05-05-170324,170324,2,0,3,392,3.333333333333333,0.6194707,1
2020-05-06-170324,170324,4,0,3,396,2.6666666666666665,0.61850953,2
2020-05-07-170324,170324,5,0,1,401,2.1666666666666665,0.50245225,3
2020-05-08-170324,170324,2,0,7,403,4.5,0.7548432,4
2020-05-09-170324,170324,0,1,0,403,0.5,0.08724672,5
2020-05-10-170324,170324,0,3,0,403,0.16666666666666666,0.007377957,6
2020-05-11-170324,170324,3,2,3,406,3.0,0.44279125,0
2020-05-12-170324,170324,3,0,0,409,3.333333333333333,0.44917345,1
2020-05-13-170324,170324,0,1,3,409,5.833333333333332,0.44395345,2
2020-05-14-170324,170324,4,0,2,413,4.5,0.89619493,3
2020-05-15-170324,170324,4,0,3,417,1.8333333333333333,0.45510805,4
2020-05-16-170324,170324,0,0,0,417,0.8333333333333334,0.13449124,5
2020-05-17-170324,170324,1,0,2,418,0.0,0.034680907,6
2020-05-18-170324,170324,2,0,7,420,3.333333333333333,0.44701296,0
2020-05-19-170324,170324,3,0,4,423,3.333333333333333,0.62816536,1
2020-05-20-170324,170324,3,0,5,426,2.333333333333333,0.4501984,2
2020-05-21-170324,170324,1,0,4,427,3.0,0.6411197,3
2020-05-22-170324,170324,7,0,2,434,4.333333333333333,0.92398083,4
2020-05-23-170324,170324,0,0,0,434,0.5,0.05845989,5
2020-05-24-170324,170324,0,0,0,434,0.16666666666666666,0.060831234,6
2020-05-25-170324,170324,3,0,3,437,3.5,0.5898637,0
2020-05-26-170324,170324,0,0,2,437,2.0,0.44729683,1
2020-05-27-170324,170324,3,0,4,440,2.0,0.46797445,2
2020-05-28-170324,170324,2,4,5,442,2.5,0.68109906,3
2020-05-29-170324,170324,3,1,3,445,2.5,0.67369825,4
2020-05-30-170324,170324,0,0,0,445,0.5,0.058239818,5
2020-05-31-170324,170324,2,0,1,447,0.3333333333333333,0.0632113,6
2020-06-01-170324,170324,7,0,0,454,3.1666666666666665,0.777921,0
2020-06-02-170324,170324,4,0,1,458,2.1666666666666665,0.62612474,1
2020-06-03-170324,170324,5,0,0,463,3.5,0.70769316,2
2020-06-04-170324,170324,4,0,0,467,3.333333333333333,0.55061597,3
2020-06-05-170324,170324,2,0,4,469,3.1666666666666665,0.70186466,4
2020-06-06-170324,170324,0,0,0,469,0.16666666666666666,0.0069820844,5
2020-06-07-170324,170324,0,0,0,469,0.16666666666666666,0.033116564,6
2020-06-08-170324,170324,3,0,1,472,3.333333333333333,0.76214683,0
2020-06-09-170324,170324,2,0,5,474,3.6666666666666665,0.77358294,1
2020-06-10-170324,170324,4,0,1,478,2.0,0.78018725,2
2020-06-11-170324,170324,5,0,1,483,2.833333333333333,0.6202813,3
2020-06-12-170324,170324,3,0,0,486,1.8333333333333333,0.42910367,4
2020-06-13-170324,170324,0,0,0,486,0.8333333333333334,0.04895321,5
2020-06-14-170324,170324,1,0,0,487,0.16666666666666666,0.06728745,6
2020-06-15-170324,170324,0,0,1,487,1.3333333333333333,0.24642505,0
2020-06-16-170324,170324,1,0,0,488,1.6666666666666667,0.28252032,1
2020-06-17-170324,170324,0,0,1,488,0.6666666666666666,0.20754513,2
2020-06-18-170324,170324,0,0,0,488,0.8333333333333334,0.13478088,3
2020-06-19-170324,170324,4,0,1,492,0.8333333333333334,0.33345747,4
2020-06-20-170324,170324,0,0,0,492,0.0,0.0012519949,5
2020-06-21-170324,170324,0,0,1,492,0.16666666666666666,0.0090052355,6
2020-06-22-170324,170324,1,0,1,493,0.5,0.10028604,0
2020-06-23-170324,170324,5,0,2,498,0.6666666666666666,0.35899407,1
2020-06-24-170324,170324,1,0,0,499,0.3333333333333333,0.08879859,2
2020-06-25-170324,170324,1,0,1,500,1.3333333333333333,0.2306016,3
2020-06-26-170324,170324,0,1,1,500,1.0,0.10427098,4
2020-06-27-170324,170324,0,0,0,500,0.16666666666666666,0.023033869,5
2020-06-28-170324,170324,0,0,0,500,0.0,0.0013441229,6
2020-06-29-170324,170324,1,0,1,501,0.6666666666666666,0.15658052,0
2020-06-30-170324,170324,0,0,0,501,0.6666666666666666,0.13049957,1
2020-07-01-170324,170324,1,0,1,502,0.3333333333333333,0.07428885,2
2020-07-02-170324,170324,0,0,0,502,0.3333333333333333,0.0472977,3
2020-07-03-170324,170324,1,0,2,503,1.1666666666666667,0.14844222,4
2020-07-04-170324,170324,0,0,0,503,0.0,0.000938457,5
2020-07-05-170324,170324,1,0,0,504,0.3333333333333333,0.050523944,6
2020-07-06-170324,170324,1,0,5,505,1.1666666666666667,0.17249581,0
2020-07-07-170324,170324,2,0,1,507,1.1666666666666667,0.2478114,1
2020-07-08-170324,170324,0,0,3,507,0.6666666666666666,0.09851545,2
2020-07-09-170324,170324,1,1,1,508,0.6666666666666666,0.19090411,3
2020-07-10-170324,170324,1,0,1,509,1.0,0.14676666,4
2020-07-11-170324,170324,0,0,0,509,0.3333333333333333,0.031549998,5
2020-07-12-170324,170324,0,0,0,509,0.16666666666666666,0.03384573,6
2020-07-13-170324,170324,1,0,1,510,1.5,0.2410476,0
2020-07-14-170324,170324,0,0,2,510,0.6666666666666666,0.09195312,1
2020-07-15-170324,170324,1,0,1,511,1.1666666666666667,0.09717712,2
2020-07-16-170324,170324,0,0,1,511,0.6666666666666666,0.12864456,3
2020-07-17-170324,170324,2,0,1,513,0.6666666666666666,0.25476965,4
2020-07-18-170324,170324,0,0,0,513,0.5,0.12308273,5
2020-07-19-170324,170324,0,0,0,513,0.5,0.09926662,6
2020-07-20-170324,170324,5,0,2,518,0.8333333333333334,0.3105455,0
2020-07-21-170324,170324,1,0,1,519,0.6666666666666666,0.17414308,1
2020-07-22-170324,170324,3,0,2,522,0.8333333333333334,0.22645035,2
2020-07-23-170324,170324,1,0,1,523,0.5,0.19031683,3
2020-07-24-170324,170324,1,0,5,524,1.8333333333333333,0.28626242,4
2020-07-25-170324,170324,0,0,0,524,0.0,0.0024979308,5
2020-07-26-170324,170324,0,0,0,524,0.8333333333333334,0.089790866,6
2020-07-27-170324,170324,1,0,1,525,0.6666666666666666,0.17380472,0
2020-07-28-170324,170324,2,0,1,527,1.0,0.21382567,1
2020-07-29-170324,170324,1,1,1,528,1.0,0.038428828,2
2020-07-30-170324,170324,1,0,0,529,1.3333333333333333,0.30018526,3
2020-07-31-170324,170324,1,0,0,530,1.0,0.19649863,4
2020-08-01-170324,170324,0,0,0,530,0.16666666666666666,0.023022272,5
2020-08-02-170324,170324,0,0,1,530,0.16666666666666666,0.08840357,6
2020-08-03-170324,170324,2,0,3,532,1.5,0.3099758,0
2020-08-04-170324,170324,1,0,4,533,1.5,0.34631264,1
2020-08-05-170324,170324,2,0,2,535,1.3333333333333333,0.3790672,2
2020-08-06-170324,170324,1,0,4,536,0.8333333333333334,0.23858209,3
2020-08-07-170324,170324,5,1,1,541,0.8333333333333334,0.24827829,4
2020-08-08-170324,170324,0,0,1,541,0.5,0.07881203,5
2020-08-09-170324,170324,0,0,5,541,0.0,0.059574675,6
2020-08-10-170324,170324,1,0,2,542,1.3333333333333333,0.23867571,0
2020-08-11-170324,170324,1,0,2,543,0.6666666666666666,0.21803574,1
2020-08-12-170324,170324,1,0,11,544,1.3333333333333333,0.23134963,2
2020-08-13-170324,170324,0,0,2,544,1.0,0.15169434,3
2020-08-14-170324,170324,0,0,6,544,1.6666666666666667,0.20879076,4
2020-08-15-170324,170324,0,0,6,544,0.16666666666666666,0.088364765,5
2020-08-16-170324,170324,1,0,6,545,0.5,0.111697,6
2020-08-17-170324,170324,3,0,3,548,1.1666666666666667,0.3876673,0
2020-08-18-170324,170324,4,0,4,552,2.0,0.42456546,1
2020-08-19-170324,170324,2,0,5,554,2.6666666666666665,0.45364818,2
2020-08-20-170324,170324,4,0,7,558,2.0,0.3652343,3
2020-08-21-170324,170324,1,0,2,559,3.8333333333333335,0.6928401,4
2020-08-22-170324,170324,1,0,3,560,1.0,0.25996178,5
2020-08-23-170324,170324,5,0,9,565,1.8333333333333333,0.28914285,6
2020-08-24-170324,170324,2,0,5,567,2.0,0.66302514,0
2020-08-25-170324,170324,2,0,4,569,6.0,1.1788803,1
2020-08-26-170324,170324,11,0,14,580,4.333333333333333,0.97952205,2
2020-08-27-170324,170324,2,0,11,582,6.833333333333332,1.0915843,3
2020-08-28-170324,170324,6,0,16,588,2.6666666666666665,0.79932326,4
2020-08-29-170324,170324,6,0,3,594,3.8333333333333335,0.68322617,5
2020-08-30-170324,170324,6,0,7,600,3.8333333333333335,0.64523256,6
2020-08-31-170324,170324,3,0,14,603,5.0,1.0170975,0
2020-09-01-170324,170324,4,0,13,607,2.1666666666666665,0.6991349,1
2020-09-02-170324,170324,5,0,11,612,2.6666666666666665,0.70217645,2
2020-09-03-170324,170324,7,0,4,619,3.8333333333333335,1.1032089,3
2020-09-04-170324,170324,2,0,6,621,5.0,0.90955883,4
2020-09-05-170324,170324,3,0,5,624,3.8333333333333335,0.35947827,5
2020-09-06-170324,170324,9,0,5,633,2.833333333333333,0.60040396,6
2020-09-07-170324,170324,5,0,12,638,8.166666666666666,1.6500279,0
2020-09-08-170324,170324,4,0,9,642,6.833333333333332,1.2114829,1
2020-09-09-170324,170324,14,0,17,656,7.5,1.9623733,2
2020-09-10-170324,170324,11,0,20,667,6.833333333333332,1.7987108,3
2020-09-11-170324,170324,16,0,10,683,8.0,2.4473486,4
2020-09-12-170324,170324,3,0,3,686,2.5,0.4804006,5
2020-09-13-170324,170324,7,0,4,693,8.5,1.1441585,6
2020-09-14-170324,170324,14,0,17,707,7.666666666666668,1.6375031,0
2020-09-15-170324,170324,13,0,8,720,8.0,1.4785769,1
2020-09-16-170324,170324,11,0,12,731,9.833333333333334,1.936698,2
2020-09-17-170324,170324,4,0,27,735,12.0,2.0367324,3
2020-09-18-170324,170324,6,0,13,741,10.5,1.8143563,4
2020-09-19-170324,170324,5,0,5,746,2.833333333333333,0.45583448,5
2020-09-20-170324,170324,5,0,13,751,3.0,0.4057199,6
2020-09-21-170324,170324,12,1,3,763,14.5,1.9790651,0
2020-09-22-170324,170324,9,2,19,772,8.666666666666666,2.0184624,1
2020-09-23-170324,170324,17,0,9,789,11.5,2.2142928,2
2020-09-24-170324,170324,20,2,10,809,9.0,2.8086112,3
2020-09-25-170324,170324,10,1,27,819,9.333333333333334,1.8772091,4
2020-09-26-170324,170324,3,0,4,822,3.333333333333333,0.50530124,5
2020-09-27-170324,170324,4,0,1,826,0.8333333333333334,0.29717427,6
2020-09-28-170324,170324,17,1,6,843,13.5,2.74177,0
2020-09-29-170324,170324,8,0,43,851,7.166666666666668,1.4169345,1
2020-09-30-170324,170324,12,0,11,863,8.5,2.1750054,2
2020-10-01-170324,170324,27,0,24,890,15.166666666666664,4.3407974,3
2020-10-02-170324,170324,13,0,15,903,15.333333333333336,3.0125945,4
2020-10-03-170324,170324,5,0,8,908,4.666666666666667,0.7393142,5
2020-10-04-170324,170324,13,3,5,921,3.8333333333333335,0.7862673,6
2020-10-05-170324,170324,3,1,27,924,2.333333333333333,0.71417046,0
2020-10-06-170324,170324,19,0,15,943,10.333333333333334,3.2537248,1
2020-10-07-170324,170324,9,1,19,952,10.5,1.8754995,2
2020-10-08-170324,170324,10,2,13,962,12.0,2.5635946,3
2020-10-09-170324,170324,27,7,29,989,12.333333333333336,3.7238123,4
2020-10-10-170324,170324,4,0,4,993,3.5,0.54026276,5
2020-10-11-170324,170324,1,0,10,994,2.5,0.3167762,6
2020-10-12-170324,170324,6,0,13,1000,4.166666666666667,0.51208,0
2020-10-13-170324,170324,43,0,17,1043,19.83333333333333,4.9462814,1
2020-10-14-170324,170324,11,0,14,1054,16.833333333333332,3.1496902,2
2020-10-15-170324,170324,24,0,19,1078,16.0,3.6523044,3
2020-10-16-170324,170324,15,0,18,1093,17.666666666666668,3.2971978,4
2020-10-17-170324,170324,8,0,6,1101,3.5,0.70154935,5
2020-10-18-170324,170324,5,0,17,1106,4.5,0.61096394,6
2020-10-19-170324,170324,27,0,4,1133,21.33333333333333,4.7577744,0
2020-10-20-170324,170324,15,0,38,1148,14.166666666666664,2.920879,1
2020-10-21-170324,170324,19,0,18,1167,14.333333333333336,3.2486875,2
2020-10-22-170324,170324,13,0,18,1180,22.5,3.9045317,3
2020-10-23-170324,170324,29,0,26,1209,14.333333333333336,3.5048325,4
2020-10-24-170324,170324,4,2,5,1213,7.333333333333332,0.66529065,5
2020-10-25-170324,170324,10,2,4,1223,3.333333333333333,0.6480632,6
2020-10-26-170324,170324,13,0,33,1236,19.33333333333333,3.7340977,0
2020-10-27-170324,170324,17,1,21,1253,6.666666666666668,1.9170924,1
2020-10-28-170324,170324,14,0,15,1267,21.66666666666667,4.0559454,2
2020-10-29-170324,170324,19,1,14,1286,18.666666666666668,3.9418828,3
2020-10-30-170324,170324,18,4,26,1304,14.666666666666664,4.0880003,4
2020-10-31-170324,170324,6,1,0,1310,4.166666666666667,0.9062076,5
2020-11-01-170324,170324,17,2,0,1327,6.833333333333332,0.7383999,6
2020-11-02-170324,170324,4,0,0,1331,2.5,0.6694372,0
2020-11-03-170324,170324,38,0,0,1369,20.166666666666668,5.612234,1
2020-11-04-170324,170324,18,0,0,1387,8.333333333333334,2.2684677,2
2020-11-05-170324,170324,18,2,0,1405,17.833333333333332,3.841409,3
2020-11-06-170324,170324,26,4,0,1431,15.333333333333336,3.9275134,4
2020-11-07-170324,170324,5,1,0,1436,4.166666666666667,0.77574825,5
2020-11-08-170324,170324,4,0,0,1440,9.166666666666666,0.55155915,6
2020-11-09-170324,170324,33,2,0,1473,25.5,5.1523547,0
2020-11-10-170324,170324,21,0,0,1494,20.166666666666668,4.3718443,1
2020-11-11-170324,170324,15,5,0,1509,13.5,3.3862727,2
2020-11-12-170324,170324,14,0,0,1523,16.333333333333332,2.5580213,3
2020-11-13-170324,170324,26,0,0,1549,16.333333333333332,3.8691077,4
2020-03-01-170325,170325,0,0,1,0,0.0,7.2000905e-05,6
2020-03-02-170325,170325,0,0,0,0,0.0,0.00095401617,0
2020-03-03-170325,170325,0,0,3,0,0.0,5.240972e-07,1
2020-03-04-170325,170325,0,1,8,0,0.0,0.002619374,2
2020-03-05-170325,170325,0,1,9,0,0.0,0.00020543665,3
2020-03-06-170325,170325,0,0,8,0,0.0,0.00024406682,4
2020-03-07-170325,170325,0,0,2,0,0.0,0.00088391954,5
2020-03-08-170325,170325,0,1,4,0,0.0,0.0009169936,6
2020-03-09-170325,170325,0,0,8,0,0.5,0.1475703,0
2020-03-10-170325,170325,0,0,4,0,0.0,0.0020997114,1
2020-03-11-170325,170325,0,0,10,0,0.0,0.010242712,2
2020-03-12-170325,170325,0,0,7,0,0.5,0.08926456,3
2020-03-13-170325,170325,0,0,8,0,0.0,0.044326313,4
2020-03-14-170325,170325,0,0,3,0,1.0,0.1332565,5
2020-03-15-170325,170325,1,0,1,1,1.0,0.2388054,6
2020-03-16-170325,170325,0,0,7,1,7.5,1.1878611,0
2020-03-17-170325,170325,3,0,6,4,10.5,2.2537317,1
2020-03-18-170325,170325,8,0,6,12,13.5,3.0144336,2
2020-03-19-170325,170325,9,0,7,21,10.0,2.8917227,3
2020-03-20-170325,170325,8,0,2,29,10.75,2.5291827,4
2020-03-21-170325,170325,2,0,0,31,5.25,0.99910045,5
2020-03-22-170325,170325,4,0,4,35,4.0,0.7191299,6
2020-03-23-170325,170325,8,0,2,43,21.5,4.540425,0
2020-03-24-170325,170325,4,0,4,47,15.75,3.3873045,1
2020-03-25-170325,170325,10,0,5,57,13.75,3.459761,2
2020-03-26-170325,170325,7,0,0,64,7.0,2.0438125,3
2020-03-27-170325,170325,8,0,1,72,15.75,2.7345052,4
2020-03-28-170325,170325,3,0,2,75,4.5,0.7516867,5
2020-03-29-170325,170325,1,0,0,76,4.25,0.45251316,6
2020-03-30-170325,170325,7,0,2,83,10.5,2.1947877,0
2020-03-31-170325,170325,6,0,0,89,10.0,2.1384869,1
2020-04-01-170325,170325,6,0,2,95,8.75,2.01377,2
2020-04-02-170325,170325,7,0,2,102,7.75,1.7190982,3
2020-04-03-170325,170325,2,0,0,104,6.5,1.1563632,4
2020-04-04-170325,170325,0,0,0,104,2.5,0.23860914,5
2020-04-05-170325,170325,4,0,1,108,1.25,0.3990839,6
2020-04-06-170325,170325,2,1,3,110,8.75,1.7693946,0
2020-04-07-170325,170325,4,0,2,114,5.75,1.340094,1
2020-04-08-170325,170325,5,0,2,119,15.0,2.2323036,2
2020-04-09-170325,170325,0,0,0,119,3.25,0.48680136,3
2020-04-10-170325,170325,1,0,1,120,14.5,1.2622085,4
2020-04-11-170325,170325,2,0,4,122,3.0,0.47607377,5
2020-04-12-170325,170325,0,0,1,122,9.0,1.3171289,6
2020-04-13-170325,170325,2,0,4,124,8.5,1.219633,0
2020-04-14-170325,170325,0,0,4,124,10.5,1.7809886,1
2020-04-15-170325,170325,2,0,0,126,7.5,0.7643163,2
2020-04-16-170325,170325,2,0,0,128,7.5,1.0014008,3
2020-04-17-170325,170325,0,0,1,128,2.75,0.7314427,4
2020-04-18-170325,170325,0,0,1,128,0.25,0.069101095,5
2020-04-19-170325,170325,1,0,4,129,0.75,0.11782193,6
2020-04-20-170325,170325,3,1,3,132,6.75,1.0019113,0
2020-04-21-170325,170325,2,0,6,134,12.0,1.4966849,1
2020-04-22-170325,170325,2,0,2,136,1.0,0.37213624,2
2020-04-23-170325,170325,0,0,3,136,0.25,0.025452953,3
2020-04-24-170325,170325,1,0,3,137,11.5,2.6493447,4
2020-04-25-170325,170325,4,0,2,141,1.25,0.47191077,5
2020-04-26-170325,170325,1,0,2,142,0.75,0.17515865,6
2020-04-27-170325,170325,4,0,4,146,2.5,0.8612364,0
2020-04-28-170325,170325,4,0,2,150,3.25,0.8692458,1
2020-04-29-170325,170325,0,0,2,150,0.75,0.20168445,2
2020-04-30-170325,170325,0,0,5,150,2.25,0.31754312,3
2020-05-01-170325,170325,1,0,0,151,0.25,0.08572525,4
2020-05-02-170325,170325,1,0,0,152,1.0,0.23878527,5
2020-05-03-170325,170325,4,0,0,156,0.25,0.36823127,6
2020-05-04-170325,170325,3,0,6,159,2.75,0.69291866,0
2020-05-05-170325,170325,6,0,5,165,3.75,1.565542,1
2020-05-06-170325,170325,2,0,5,167,4.0,0.8596636,2
2020-05-07-170325,170325,3,0,1,170,1.0,0.8272581,3
2020-05-08-170325,170325,3,0,0,173,3.75,0.73010343,4
2020-05-09-170325,170325,2,0,1,175,0.75,0.27873012,5
2020-05-10-170325,170325,2,0,0,177,0.0,0.15894045,6
2020-05-11-170325,170325,4,0,0,181,1.5,0.74372345,0
2020-05-12-170325,170325,2,0,3,183,1.25,0.5701048,1
2020-05-13-170325,170325,2,2,0,185,2.5,0.90910923,2
2020-05-14-170325,170325,5,0,6,190,3.75,1.1586326,3
2020-05-15-170325,170325,0,0,1,190,2.0,0.23760897,4
2020-05-16-170325,170325,0,0,1,190,0.5,0.13263935,5
2020-05-17-170325,170325,0,1,0,190,0.25,0.07656459,6
2020-05-18-170325,170325,6,0,3,196,1.5,0.8555056,0
2020-05-19-170325,170325,5,0,5,201,3.25,1.1273457,1
2020-05-20-170325,170325,5,0,2,206,0.75,0.77514255,2
2020-05-21-170325,170325,1,0,3,207,2.5,0.6007339,3
2020-05-22-170325,170325,0,0,0,207,2.0,0.4781472,4
2020-05-23-170325,170325,1,0,1,208,0.0,0.096244454,5
2020-05-24-170325,170325,0,0,2,208,0.5,0.016305618,6
2020-05-25-170325,170325,0,0,3,208,1.25,0.16535996,0
2020-05-26-170325,170325,3,0,3,211,1.25,0.6324949,1
2020-05-27-170325,170325,0,0,14,211,0.75,0.81708354,2
2020-05-28-170325,170325,6,0,6,217,1.5,0.98400754,3
2020-05-29-170325,170325,1,0,4,218,1.5,0.5009858,4
2020-05-30-170325,170325,1,0,0,219,0.25,0.19006841,5
2020-05-31-170325,170325,0,0,0,219,0.0,0.006824543,6
2020-06-01-170325,170325,3,1,4,222,1.25,0.6504556,0
2020-06-02-170325,170325,5,0,2,227,2.25,0.8745793,1
2020-06-03-170325,170325,2,0,2,229,1.0,0.48810554,2
2020-06-04-170325,170325,3,0,0,232,1.5,0.82758135,3
2020-06-05-170325,170325,0,0,0,232,1.25,0.3300799,4
2020-06-06-170325,170325,1,0,0,233,0.0,0.11952615,5
2020-06-07-170325,170325,2,0,0,235,0.0,0.09589782,6
2020-06-08-170325,170325,3,0,1,238,0.75,0.49713615,0
2020-06-09-170325,170325,3,0,3,241,1.5,0.6805123,1
2020-06-10-170325,170325,14,0,1,255,2.25,1.5142794,2
2020-06-11-170325,170325,6,0,3,261,1.0,0.7207912,3
2020-06-12-170325,170325,4,0,1,265,1.5,0.7565786,4
2020-06-13-170325,170325,0,2,0,265,0.25,0.030677333,5
2020-06-14-170325,170325,0,0,0,265,0.0,0.003776903,6
2020-06-15-170325,170325,4,1,0,269,1.0,0.7251443,0
2020-06-16-170325,170325,2,1,2,271,0.5,0.25940976,1
2020-06-17-170325,170325,2,0,0,273,1.25,0.32883152,2
2020-06-18-170325,170325,0,0,0,273,0.75,0.12334678,3
2020-06-19-170325,170325,0,0,0,273,0.0,0.036572874,4
2020-06-20-170325,170325,0,0,0,273,0.0,0.0010911059,5
2020-06-21-170325,170325,0,0,0,273,0.0,0.006035612,6
2020-06-22-170325,170325,1,0,4,274,0.5,0.28861228,0
2020-06-23-170325,170325,3,0,0,277,0.75,0.5651943,1
2020-06-24-170325,170325,1,1,1,278,1.25,0.5812501,2
2020-06-25-170325,170325,3,0,2,281,2.0,0.7818426,3
2020-06-26-170325,170325,1,0,0,282,0.0,0.1504242,4
2020-06-27-170325,170325,0,0,0,282,0.25,0.03839228,5
2020-06-28-170325,170325,0,0,0,282,0.0,0.00019538123,6
2020-06-29-170325,170325,0,1,0,282,0.5,0.19927084,0
2020-06-30-170325,170325,2,0,1,284,0.75,0.4016744,1
2020-07-01-170325,170325,0,0,0,284,0.0,0.023116738,2
2020-07-02-170325,170325,0,0,0,284,1.0,0.25775445,3
2020-07-03-170325,170325,0,0,0,284,0.25,0.09887956,4
2020-07-04-170325,170325,0,0,0,284,0.0,0.00068041665,5
2020-07-05-170325,170325,0,0,0,284,0.0,0.0035094775,6
2020-07-06-170325,170325,4,0,0,288,0.0,0.470552,0
2020-07-07-170325,170325,0,0,0,288,0.25,0.03948089,1
2020-07-08-170325,170325,1,0,0,289,0.5,0.27701747,2
2020-07-09-170325,170325,2,0,0,291,0.5,0.30737442,3
2020-07-10-170325,170325,0,0,2,291,0.0,0.06757856,4
2020-07-11-170325,170325,0,0,0,291,0.0,0.0060809315,5
2020-07-12-170325,170325,0,0,0,291,0.25,0.028747393,6
2020-07-13-170325,170325,0,0,0,291,0.75,0.15265751,0
2020-07-14-170325,170325,1,0,0,292,0.0,0.11813719,1
2020-07-15-170325,170325,0,0,0,292,0.5,0.021387642,2
2020-07-16-170325,170325,0,0,1,292,0.5,0.10384698,3
2020-07-17-170325,170325,0,0,2,292,0.25,0.058030806,4
2020-07-18-170325,170325,0,0,0,292,0.5,0.10916596,5
2020-07-19-170325,170325,0,0,0,292,0.25,0.060314827,6
2020-07-20-170325,170325,0,0,0,292,0.75,0.08463404,0
2020-07-21-170325,170325,0,0,0,292,0.25,0.07385491,1
2020-07-22-170325,170325,0,0,0,292,0.5,0.07455725,2
2020-07-23-170325,170325,0,0,0,292,1.0,0.26530784,3
2020-07-24-170325,170325,2,0,0,294,1.0,0.38940972,4
2020-07-25-170325,170325,0,0,0,294,0.0,0.0013620106,5
2020-07-26-170325,170325,0,0,0,294,0.25,0.030768452,6
2020-07-27-170325,170325,0,0,1,294,0.5,0.113097526,0
2020-07-28-170325,170325,0,0,1,294,0.75,0.11254602,1
2020-07-29-170325,170325,0,0,0,294,0.25,0.0196584,2
2020-07-30-170325,170325,1,0,0,295,1.0,0.25656003,3
2020-07-31-170325,170325,2,0,0,297,0.5,0.29138508,4
2020-08-01-170325,170325,0,0,0,297,0.25,0.0824664,5
2020-08-02-170325,170325,0,0,0,297,0.25,0.14644566,6
2020-08-03-170325,170325,0,0,0,297,0.25,0.052144293,0
2020-08-04-170325,170325,0,0,1,297,1.0,0.24652146,1
2020-08-05-170325,170325,0,0,0,297,1.0,0.28739336,2
2020-08-06-170325,170325,0,0,3,297,3.25,1.0160754,3
2020-08-07-170325,170325,0,0,0,297,0.5,0.120273985,4
2020-08-08-170325,170325,0,0,0,297,0.25,0.14151376,5
2020-08-09-170325,170325,0,0,0,297,0.25,0.25416338,6
2020-08-10-170325,170325,1,0,0,298,0.75,0.3500087,0
2020-08-11-170325,170325,1,0,0,299,0.5,0.32182077,1
2020-08-12-170325,170325,0,0,0,299,1.5,0.38256684,2
2020-08-13-170325,170325,0,0,0,299,0.75,0.19685797,3
2020-08-14-170325,170325,0,0,0,299,0.5,0.213724,4
2020-08-15-170325,170325,0,0,0,299,1.75,0.649596,5
2020-08-16-170325,170325,0,0,0,299,0.5,0.09227201,6
2020-08-17-170325,170325,0,0,1,299,0.0,0.09775403,0
2020-08-18-170325,170325,1,0,4,300,0.75,0.3658133,1
2020-08-19-170325,170325,0,0,5,300,0.75,0.23083884,2
2020-08-20-170325,170325,3,0,0,303,2.0,0.7151212,3
2020-08-21-170325,170325,0,0,1,303,2.0,0.43278852,4
2020-08-22-170325,170325,0,0,0,303,0.25,0.45669997,5
2020-08-23-170325,170325,0,0,0,303,1.0,0.24632779,6
2020-08-24-170325,170325,0,0,0,303,1.25,0.75025815,0
2020-08-25-170325,170325,0,0,0,303,4.0,1.1376013,1
2020-08-26-170325,170325,0,0,0,303,1.25,1.0714624,2
2020-08-27-170325,170325,0,1,0,303,4.5,0.8942249,3
2020-08-28-170325,170325,0,0,0,303,2.0,0.5507254,4
2020-08-29-170325,170325,0,0,1,303,0.75,0.3237962,5
2020-08-30-170325,170325,0,0,4,303,5.75,1.6622832,6
2020-08-31-170325,170325,1,0,1,304,4.0,0.84631264,0
2020-09-01-170325,170325,4,0,1,308,2.25,1.0426341,1
2020-09-02-170325,170325,5,0,4,313,1.5,1.0581815,2
2020-09-03-170325,170325,0,0,1,313,3.25,0.51747036,3
2020-09-04-170325,170325,1,0,0,314,3.75,0.81360507,4
2020-09-05-170325,170325,0,0,0,314,0.75,0.05268194,5
2020-09-06-170325,170325,0,0,1,314,2.75,0.35013375,6
2020-09-07-170325,170325,0,0,1,314,3.75,0.51144224,0
2020-09-08-170325,170325,0,0,3,314,2.0,0.42125788,1
2020-09-09-170325,170325,0,0,3,314,8.0,1.9039351,2
2020-09-10-170325,170325,0,0,7,314,4.0,0.9574194,3
2020-09-11-170325,170325,0,0,4,314,4.25,1.6226925,4
2020-09-12-170325,170325,1,0,8,315,2.25,0.43052652,5
2020-09-13-170325,170325,4,0,0,319,2.0,0.56650215,6
2020-09-14-170325,170325,1,0,3,320,2.5,0.69662577,0
2020-09-15-170325,170325,1,0,5,321,6.25,1.235977,1
2020-09-16-170325,170325,4,0,8,325,4.5,1.1423064,2
2020-09-17-170325,170325,1,0,4,326,7.25,1.4280328,3
2020-09-18-170325,170325,0,0,2,326,4.25,1.0087147,4
2020-09-19-170325,170325,0,0,1,326,2.5,0.3036588,5
2020-09-20-170325,170325,1,0,1,327,1.75,0.4006702,6
2020-09-21-170325,170325,1,0,13,328,6.75,1.4358569,0
2020-09-22-170325,170325,3,0,5,331,5.0,1.6444031,1
2020-09-23-170325,170325,3,1,3,334,7.5,1.7773837,2
2020-09-24-170325,170325,7,0,4,341,19.75,5.5341315,3
2020-09-25-170325,170325,4,0,38,345,10.25,2.0894473,4
2020-09-26-170325,170325,8,0,1,353,1.25,1.0591866,5
2020-09-27-170325,170325,0,0,9,353,2.0,0.33034384,6
2020-09-28-170325,170325,3,0,0,356,6.25,1.5149053,0
2020-09-29-170325,170325,5,0,8,361,8.75,1.7365121,1
2020-09-30-170325,170325,8,0,12,369,11.0,2.0611858,2
2020-10-01-170325,170325,4,0,13,373,20.5,3.5829349,3
2020-10-02-170325,170325,2,0,19,375,14.0,2.2866569,4
2020-10-03-170325,170325,1,0,6,376,5.25,1.0071071,5
2020-10-04-170325,170325,1,0,3,377,0.75,0.25268555,6
2020-10-05-170325,170325,13,1,9,390,5.0,2.5557685,0
2020-10-06-170325,170325,5,0,10,395,11.5,1.6347588,1
2020-10-07-170325,170325,3,1,5,398,5.0,1.4538133,2
2020-10-08-170325,170325,4,0,13,402,9.25,2.0066013,3
2020-10-09-170325,170325,38,3,6,440,8.0,3.809494,4
2020-10-10-170325,170325,1,0,5,441,2.0,0.44697788,5
2020-10-11-170325,170325,9,0,6,450,2.0,1.1377711,6
2020-10-12-170325,170325,0,0,4,450,2.25,0.34201977,0
2020-10-13-170325,170325,8,0,11,458,11.75,2.3896163,1
2020-10-14-170325,170325,12,0,4,470,12.5,2.6362016,2
2020-10-15-170325,170325,13,0,4,483,19.75,5.2038755,3
2020-10-16-170325,170325,19,0,8,502,10.0,3.3074267,4
2020-10-17-170325,170325,6,0,8,508,2.75,1.2759145,5
2020-10-18-170325,170325,3,0,3,511,1.75,0.90780467,6
2020-10-19-170325,170325,9,2,0,520,10.75,2.3137496,0
2020-10-20-170325,170325,10,0,9,530,7.5,2.3894613,1
2020-10-21-170325,170325,5,1,0,535,8.5,1.370522,2
2020-10-22-170325,170325,13,0,3,548,7.25,2.8374708,3
2020-10-23-170325,170325,6,1,13,554,15.5,4.4895096,4
2020-10-24-170325,170325,5,0,3,559,4.25,1.1079053,5
2020-10-25-170325,170325,6,1,2,565,1.5,0.8420534,6
2020-10-26-170325,170325,4,3,4,569,9.5,2.18676,0
2020-10-27-170325,170325,11,2,8,580,5.75,1.7639905,1
2020-10-28-170325,170325,4,2,6,584,6.25,1.6835891,2
2020-10-29-170325,170325,4,3,3,588,18.25,2.549649,3
2020-10-30-170325,170325,8,0,6,596,11.25,3.1183221,4
2020-10-31-170325,170325,8,1,0,604,4.5,1.6375146,5
2020-11-01-170325,170325,3,0,0,607,1.25,0.72566706,6
2020-11-02-170325,170325,0,0,0,607,3.0,0.4718118,0
2020-11-03-170325,170325,9,1,0,616,10.0,2.5284324,1
2020-11-04-170325,170325,0,0,0,616,5.0,1.3143439,2
2020-11-05-170325,170325,3,0,0,619,17.5,3.7534306,3
2020-11-06-170325,170325,13,2,0,632,12.0,3.3183353,4
2020-11-07-170325,170325,3,1,0,635,4.75,1.2069292,5
2020-11-08-170325,170325,2,0,0,637,3.25,0.53285396,6
2020-11-09-170325,170325,4,0,0,641,12.5,2.750369,0
2020-11-10-170325,170325,8,1,0,649,8.25,2.2798872,1
2020-11-11-170325,170325,6,2,0,655,8.25,2.5120275,2
2020-11-12-170325,170325,3,1,0,658,11.25,1.9684005,3
2020-11-13-170325,170325,6,0,0,664,13.0,3.2773225,4
2020-03-01-170326,170326,0,0,0,0,0.0,0.00014184824,6
2020-03-02-170326,170326,0,0,2,0,0.0,0.000692789,0
2020-03-03-170326,170326,0,2,0,0,0.0,3.148058e-05,1
2020-03-04-170326,170326,0,0,3,0,0.16666666666666666,0.008479925,2
2020-03-05-170326,170326,0,0,2,0,0.0,0.00015941283,3
2020-03-06-170326,170326,0,0,4,0,0.0,0.00027014452,4
2020-03-07-170326,170326,0,0,2,0,0.0,0.0013057445,5
2020-03-08-170326,170326,0,0,1,0,0.0,0.00015742058,6
2020-03-09-170326,170326,0,0,2,0,0.3333333333333333,0.078476354,0
2020-03-10-170326,170326,0,1,4,0,0.0,0.007050055,1
2020-03-11-170326,170326,0,0,0,0,0.0,0.040005025,2
2020-03-12-170326,170326,0,0,3,0,0.16666666666666666,0.012065979,3
2020-03-13-170326,170326,0,0,3,0,0.0,0.015057349,4
2020-03-14-170326,170326,0,0,0,0,0.0,0.0046333903,5
2020-03-15-170326,170326,0,0,0,0,0.5,0.038335364,6
2020-03-16-170326,170326,2,0,0,2,2.333333333333333,0.333923,0
2020-03-17-170326,170326,0,0,0,2,5.5,0.42752856,1
2020-03-18-170326,170326,3,0,0,5,7.166666666666668,0.6749599,2
2020-03-19-170326,170326,2,0,0,7,5.333333333333333,0.7152456,3
2020-03-20-170326,170326,4,0,0,11,5.0,0.5598214,4
2020-03-21-170326,170326,2,0,0,13,2.1666666666666665,0.2766362,5
2020-03-22-170326,170326,1,0,0,14,1.8333333333333333,0.16558741,6
2020-03-23-170326,170326,2,0,0,16,9.833333333333334,0.9738934,0
2020-03-24-170326,170326,4,0,0,20,7.833333333333332,0.7821684,1
2020-03-25-170326,170326,0,0,0,20,6.0,0.7451584,2
2020-03-26-170326,170326,3,0,1,23,3.333333333333333,0.46703556,3
2020-03-27-170326,170326,3,0,0,26,5.166666666666667,0.6117635,4
2020-03-28-170326,170326,0,0,0,26,1.1666666666666667,0.15666208,5
2020-03-29-170326,170326,0,0,0,26,1.6666666666666667,0.04288026,6
2020-03-30-170326,170326,0,0,0,26,3.333333333333333,0.23454164,0
2020-03-31-170326,170326,0,0,1,26,4.666666666666667,0.4795651,1
2020-04-01-170326,170326,0,0,0,26,4.166666666666667,0.58449244,2
2020-04-02-170326,170326,0,0,0,26,4.0,0.16623127,3
2020-04-03-170326,170326,0,0,0,26,2.833333333333333,0.26295975,4
2020-04-04-170326,170326,0,0,0,26,0.8333333333333334,0.06652617,5
2020-04-05-170326,170326,0,0,0,26,0.6666666666666666,0.037695546,6
2020-04-06-170326,170326,0,0,1,26,5.333333333333333,0.2840341,0
2020-04-07-170326,170326,0,1,1,26,3.0,0.2790512,1
2020-04-08-170326,170326,0,0,0,26,2.6666666666666665,0.2798788,2
2020-04-09-170326,170326,1,0,0,27,3.8333333333333335,0.14347634,3
2020-04-10-170326,170326,0,0,0,27,5.833333333333332,0.2075842,4
2020-04-11-170326,170326,0,0,2,27,1.5,0.06942554,5
2020-04-12-170326,170326,0,0,0,27,4.333333333333333,0.061510615,6
2020-04-13-170326,170326,0,0,0,27,2.833333333333333,0.33768123,0
2020-04-14-170326,170326,1,0,1,28,5.166666666666667,0.68818635,1
2020-04-15-170326,170326,0,0,1,28,0.8333333333333334,0.18756878,2
2020-04-16-170326,170326,0,0,0,28,2.5,0.2442704,3
2020-04-17-170326,170326,0,0,0,28,2.0,0.24258183,4
2020-04-18-170326,170326,0,0,0,28,0.6666666666666666,0.08150875,5
2020-04-19-170326,170326,0,0,0,28,0.16666666666666666,0.012704961,6
2020-04-20-170326,170326,1,1,1,29,0.8333333333333334,0.18866873,0
2020-04-21-170326,170326,1,0,0,30,2.5,0.3311265,1
2020-04-22-170326,170326,0,0,1,30,0.8333333333333334,0.1297993,2
2020-04-23-170326,170326,0,0,0,30,0.5,0.01521687,3
2020-04-24-170326,170326,0,0,0,30,7.833333333333332,0.42768192,4
2020-04-25-170326,170326,2,0,0,32,0.5,0.19967164,5
2020-04-26-170326,170326,0,0,0,32,0.5,0.047881622,6
2020-04-27-170326,170326,0,0,0,32,2.5,0.22373591,0
2020-04-28-170326,170326,1,0,0,33,2.5,0.19031435,1
2020-04-29-170326,170326,1,0,0,34,1.0,0.16798148,2
2020-04-30-170326,170326,0,0,0,34,2.1666666666666665,0.12942593,3
2020-05-01-170326,170326,0,0,1,34,0.16666666666666666,0.010612042,4
2020-05-02-170326,170326,0,0,0,34,0.5,0.059190806,5
2020-05-03-170326,170326,0,0,0,34,0.3333333333333333,0.107937254,6
2020-05-04-170326,170326,1,0,1,35,1.8333333333333333,0.16976707,0
2020-05-05-170326,170326,0,0,1,35,3.0,0.31539273,1
2020-05-06-170326,170326,1,0,0,36,2.6666666666666665,0.3735099,2
2020-05-07-170326,170326,0,0,0,36,5.666666666666668,0.535868,3
2020-05-08-170326,170326,0,0,0,36,1.8333333333333333,0.22028302,4
2020-05-09-170326,170326,0,0,0,36,0.5,0.07730424,5
2020-05-10-170326,170326,0,0,0,36,0.3333333333333333,0.04111062,6
2020-05-11-170326,170326,0,1,1,36,1.3333333333333333,0.24038598,0
2020-05-12-170326,170326,0,0,0,36,1.5,0.11097342,1
2020-05-13-170326,170326,0,0,0,36,4.0,0.31051132,2
2020-05-14-170326,170326,0,0,0,36,2.6666666666666665,0.39399335,3
2020-05-15-170326,170326,1,1,0,37,1.0,0.08267667,4
2020-05-16-170326,170326,0,0,0,37,0.5,0.06881392,5
2020-05-17-170326,170326,0,0,0,37,0.16666666666666666,0.04560321,6
2020-05-18-170326,170326,1,0,0,38,1.5,0.20354195,0
2020-05-19-170326,170326,1,0,0,39,1.6666666666666667,0.20368202,1
2020-05-20-170326,170326,0,0,0,39,1.6666666666666667,0.13718386,2
2020-05-21-170326,170326,0,0,0,39,1.5,0.1545288,3
2020-05-22-170326,170326,0,0,1,39,1.8333333333333333,0.24430902,4
2020-05-23-170326,170326,0,0,0,39,0.0,0.011283147,5
2020-05-24-170326,170326,0,0,0,39,0.0,0.0012415571,6
2020-05-25-170326,170326,1,0,1,40,0.3333333333333333,0.04436061,0
2020-05-26-170326,170326,0,0,0,40,0.8333333333333334,0.13767642,1
2020-05-27-170326,170326,0,0,1,40,0.5,0.41654465,2
2020-05-28-170326,170326,0,0,1,40,1.6666666666666667,0.18356588,3
2020-05-29-170326,170326,0,0,0,40,1.1666666666666667,0.101350136,4
2020-05-30-170326,170326,0,0,0,40,0.16666666666666666,0.073876426,5
2020-05-31-170326,170326,0,0,0,40,0.16666666666666666,0.050745063,6
2020-06-01-170326,170326,0,0,1,40,1.1666666666666667,0.12454875,0
2020-06-02-170326,170326,0,0,0,40,1.5,0.10146534,1
2020-06-03-170326,170326,0,0,0,40,1.0,0.056245822,2
2020-06-04-170326,170326,0,0,0,40,2.6666666666666665,0.11352697,3
2020-06-05-170326,170326,1,0,0,41,0.8333333333333334,0.15182917,4
2020-06-06-170326,170326,0,0,0,41,0.16666666666666666,0.01475124,5
2020-06-07-170326,170326,0,0,0,41,0.0,0.006362299,6
2020-06-08-170326,170326,1,0,0,42,1.1666666666666667,0.25688612,0
2020-06-09-170326,170326,0,0,0,42,0.6666666666666666,0.17531441,1
2020-06-10-170326,170326,1,0,0,43,0.6666666666666666,0.19394216,2
2020-06-11-170326,170326,1,0,1,44,0.6666666666666666,0.1600326,3
2020-06-12-170326,170326,0,0,1,44,1.3333333333333333,0.19930409,4
2020-06-13-170326,170326,0,1,0,44,0.0,0.0011003152,5
2020-06-14-170326,170326,0,2,0,44,0.0,0.027559346,6
2020-06-15-170326,170326,1,0,1,45,1.0,0.15894224,0
2020-06-16-170326,170326,0,0,1,45,0.16666666666666666,0.034100577,1
2020-06-17-170326,170326,0,0,1,45,0.5,0.043590955,2
2020-06-18-170326,170326,0,0,0,45,0.5,0.023544913,3
2020-06-19-170326,170326,0,0,0,45,0.0,0.010309989,4
2020-06-20-170326,170326,0,0,0,45,0.0,0.00078606536,5
2020-06-21-170326,170326,0,0,0,45,0.0,0.0002531546,6
2020-06-22-170326,170326,0,0,0,45,0.5,0.035386562,0
2020-06-23-170326,170326,0,0,0,45,1.0,0.1706421,1
2020-06-24-170326,170326,0,0,2,45,1.3333333333333333,0.20389749,2
2020-06-25-170326,170326,1,0,0,46,0.8333333333333334,0.20445964,3
2020-06-26-170326,170326,1,1,1,47,0.5,0.08583735,4
2020-06-27-170326,170326,0,0,1,47,0.16666666666666666,0.013638023,5
2020-06-28-170326,170326,0,1,0,47,0.0,0.0010130211,6
2020-06-29-170326,170326,1,0,0,48,0.5,0.059602343,0
2020-06-30-170326,170326,1,0,0,49,0.3333333333333333,0.08168045,1
2020-07-01-170326,170326,1,0,1,50,0.0,0.033053815,2
2020-07-02-170326,170326,0,0,0,50,0.6666666666666666,0.026240425,3
2020-07-03-170326,170326,0,0,0,50,0.3333333333333333,0.028722756,4
2020-07-04-170326,170326,0,0,0,50,0.0,0.0008107765,5
2020-07-05-170326,170326,0,0,1,50,0.0,0.0038146535,6
2020-07-06-170326,170326,0,0,0,50,0.3333333333333333,0.07919382,0
2020-07-07-170326,170326,0,0,0,50,0.0,0.0044632875,1
2020-07-08-170326,170326,2,0,0,52,0.3333333333333333,0.09362254,2
2020-07-09-170326,170326,0,0,0,52,0.5,0.039060187,3
2020-07-10-170326,170326,1,0,0,53,0.6666666666666666,0.12765762,4
2020-07-11-170326,170326,1,0,0,54,0.16666666666666666,0.039155688,5
2020-07-12-170326,170326,0,0,0,54,0.0,0.0007502335,6
2020-07-13-170326,170326,0,0,0,54,0.16666666666666666,0.0076657757,0
2020-07-14-170326,170326,0,0,0,54,0.0,0.012608951,1
2020-07-15-170326,170326,1,0,0,55,0.0,0.042279534,2
2020-07-16-170326,170326,0,0,0,55,0.16666666666666666,0.044708688,3
2020-07-17-170326,170326,0,0,0,55,0.16666666666666666,0.08165461,4
2020-07-18-170326,170326,0,0,0,55,0.16666666666666666,0.007072232,5
2020-07-19-170326,170326,1,0,1,56,0.16666666666666666,0.07208813,6
2020-07-20-170326,170326,0,0,0,56,0.3333333333333333,0.033205785,0
2020-07-21-170326,170326,0,0,0,56,0.16666666666666666,0.067367785,1
2020-07-22-170326,170326,0,0,0,56,0.16666666666666666,0.004246223,2
2020-07-23-170326,170326,0,0,0,56,0.5,0.12016312,3
2020-07-24-170326,170326,0,0,0,56,0.16666666666666666,0.02928329,4
2020-07-25-170326,170326,0,0,0,56,0.0,0.0009800805,5
2020-07-26-170326,170326,0,0,0,56,0.0,0.0009618605,6
2020-07-27-170326,170326,0,0,1,56,0.3333333333333333,0.011453866,0
2020-07-28-170326,170326,0,0,0,56,0.5,0.06608443,1
2020-07-29-170326,170326,0,0,0,56,0.5,0.030629404,2
2020-07-30-170326,170326,0,0,0,56,0.5,0.028969286,3
2020-07-31-170326,170326,0,0,0,56,0.8333333333333334,0.042525932,4
2020-08-01-170326,170326,0,0,0,56,0.16666666666666666,0.004685866,5
2020-08-02-170326,170326,1,1,0,57,0.16666666666666666,0.11257973,6
2020-08-03-170326,170326,0,0,0,57,0.6666666666666666,0.08248903,0
2020-08-04-170326,170326,0,0,0,57,0.16666666666666666,0.10140036,1
2020-08-05-170326,170326,0,0,0,57,0.8333333333333334,0.12477948,2
2020-08-06-170326,170326,0,0,3,57,2.0,0.21196404,3
2020-08-07-170326,170326,0,0,0,57,0.5,0.06465125,4
2020-08-08-170326,170326,0,0,0,57,0.16666666666666666,0.11644338,5
2020-08-09-170326,170326,0,0,0,57,0.6666666666666666,0.18033339,6
2020-08-10-170326,170326,1,0,0,58,0.3333333333333333,0.15438953,0
2020-08-11-170326,170326,0,0,3,58,0.6666666666666666,0.22214785,1
2020-08-12-170326,170326,0,0,0,58,1.1666666666666667,0.11385546,2
2020-08-13-170326,170326,0,0,2,58,0.6666666666666666,0.14406587,3
2020-08-14-170326,170326,0,0,1,58,0.6666666666666666,0.17249282,4
2020-08-15-170326,170326,0,0,1,58,2.5,0.12825367,5
2020-08-16-170326,170326,0,0,0,58,0.3333333333333333,0.045610055,6
2020-08-17-170326,170326,0,0,0,58,1.0,0.19067886,0
2020-08-18-170326,170326,0,0,0,58,1.3333333333333333,0.1470124,1
2020-08-19-170326,170326,0,0,1,58,1.1666666666666667,0.17507958,2
2020-08-20-170326,170326,3,0,0,61,1.8333333333333333,0.40523088,3
2020-08-21-170326,170326,0,0,2,61,2.5,0.32587156,4
2020-08-22-170326,170326,0,0,0,61,0.6666666666666666,0.2944127,5
2020-08-23-170326,170326,0,0,0,61,0.16666666666666666,0.10574717,6
2020-08-24-170326,170326,0,0,0,61,0.6666666666666666,0.53684795,0
2020-08-25-170326,170326,3,0,0,64,2.1666666666666665,0.70882213,1
2020-08-26-170326,170326,0,0,3,64,2.6666666666666665,0.471729,2
2020-08-27-170326,170326,2,0,3,66,2.1666666666666665,0.38992384,3
2020-08-28-170326,170326,1,0,5,67,1.3333333333333333,0.19132856,4
2020-08-29-170326,170326,1,0,2,68,1.0,0.26098126,5
2020-08-30-170326,170326,0,0,0,68,3.5,0.16329166,6
2020-08-31-170326,170326,0,0,3,68,1.6666666666666667,0.32878888,0
2020-09-01-170326,170326,0,0,1,68,1.3333333333333333,0.28387415,1
2020-09-02-170326,170326,1,0,2,69,2.6666666666666665,0.5253215,2
2020-09-03-170326,170326,0,0,10,69,2.0,0.23989858,3
2020-09-04-170326,170326,2,1,3,71,3.0,0.41173768,4
2020-09-05-170326,170326,0,0,3,71,0.5,0.06628735,5
2020-09-06-170326,170326,0,0,1,71,0.3333333333333333,0.126214,6
2020-09-07-170326,170326,0,0,1,71,1.1666666666666667,0.37702098,0
2020-09-08-170326,170326,0,0,2,71,2.1666666666666665,0.34285158,1
2020-09-09-170326,170326,3,0,4,74,3.6666666666666665,1.091795,2
2020-09-10-170326,170326,3,0,0,77,1.5,0.6453726,3
2020-09-11-170326,170326,5,0,0,82,2.333333333333333,1.0683655,4
2020-09-12-170326,170326,2,0,0,84,0.5,0.23584822,5
2020-09-13-170326,170326,0,0,0,84,0.5,0.14060944,6
2020-09-14-170326,170326,3,0,0,87,0.8333333333333334,0.3202586,0
2020-09-15-170326,170326,1,0,0,88,2.1666666666666665,0.28659397,1
2020-09-16-170326,170326,2,0,1,90,1.5,0.4633496,2
2020-09-17-170326,170326,10,0,0,100,2.833333333333333,1.327411,3
2020-09-18-170326,170326,3,0,3,103,4.0,0.623759,4
2020-09-19-170326,170326,3,0,1,106,2.1666666666666665,0.2616374,5
2020-09-20-170326,170326,1,0,0,107,1.6666666666666667,0.09713179,6
2020-09-21-170326,170326,1,1,0,108,3.6666666666666665,1.0495241,0
2020-09-22-170326,170326,2,0,1,110,3.1666666666666665,0.79123956,1
2020-09-23-170326,170326,4,0,1,114,6.0,1.2039573,2
2020-09-24-170326,170326,0,0,1,114,12.333333333333336,3.399214,3
2020-09-25-170326,170326,0,0,1,114,11.833333333333336,2.1261115,4
2020-09-26-170326,170326,0,0,3,114,1.6666666666666667,0.32266867,5
2020-09-27-170326,170326,0,0,0,114,1.1666666666666667,0.30058086,6
2020-09-28-170326,170326,0,0,0,114,1.8333333333333333,0.6132902,0
2020-09-29-170326,170326,0,0,7,114,5.666666666666668,0.7700305,1
2020-09-30-170326,170326,1,0,0,115,4.833333333333333,1.0424194,2
2020-10-01-170326,170326,0,0,1,115,4.666666666666667,1.2527071,3
2020-10-02-170326,170326,3,0,2,118,4.666666666666667,1.2463746,4
2020-10-03-170326,170326,1,1,0,119,4.0,0.5966513,5
2020-10-04-170326,170326,0,0,2,119,0.8333333333333334,0.16692898,6
2020-10-05-170326,170326,0,0,0,119,2.833333333333333,0.8637014,0
2020-10-06-170326,170326,1,0,1,120,2.833333333333333,0.5499255,1
2020-10-07-170326,170326,1,0,2,121,5.0,0.9365809,2
2020-10-08-170326,170326,1,0,1,122,3.6666666666666665,0.9780879,3
2020-10-09-170326,170326,1,1,1,123,8.333333333333334,1.2335247,4
2020-10-10-170326,170326,3,0,0,126,1.6666666666666667,0.36851934,5
2020-10-11-170326,170326,0,0,2,126,0.5,0.2311647,6
2020-10-12-170326,170326,0,0,0,126,1.3333333333333333,0.37096167,0
2020-10-13-170326,170326,7,0,1,133,2.6666666666666665,0.9954702,1
2020-10-14-170326,170326,0,0,2,133,5.833333333333332,1.1757923,2
2020-10-15-170326,170326,1,0,0,134,12.666666666666664,3.1996737,3
2020-10-16-170326,170326,2,0,4,136,7.333333333333332,1.1982439,4
2020-10-17-170326,170326,0,0,1,136,3.0,0.62979543,5
2020-10-18-170326,170326,2,0,19,138,2.0,0.7087696,6
2020-10-19-170326,170326,0,0,1,138,3.333333333333333,1.2227508,0
2020-10-20-170326,170326,1,0,1,139,7.166666666666668,1.2031972,1
2020-10-21-170326,170326,2,0,2,141,7.166666666666668,1.1891303,2
2020-10-22-170326,170326,1,0,5,142,5.0,1.4902314,3
2020-10-23-170326,170326,1,0,12,143,16.666666666666668,3.4826062,4
2020-10-24-170326,170326,0,0,7,143,2.333333333333333,0.4850616,5
2020-10-25-170326,170326,2,1,0,145,4.0,0.5284115,6
2020-10-26-170326,170326,0,1,0,145,7.166666666666668,1.2223464,0
2020-10-27-170326,170326,1,0,3,146,3.333333333333333,0.63177073,1
2020-10-28-170326,170326,2,0,5,148,10.166666666666666,1.0590296,2
2020-10-29-170326,170326,0,0,19,148,9.666666666666666,1.4242454,3
2020-10-30-170326,170326,4,0,27,152,14.5,1.7856922,4
2020-10-31-170326,170326,1,0,0,153,2.333333333333333,0.38379127,5
2020-11-01-170326,170326,19,0,0,172,3.0,0.7131157,6
2020-11-02-170326,170326,1,0,0,173,1.0,0.21204714,0
2020-11-03-170326,170326,1,0,0,174,6.666666666666668,1.2575008,1
2020-11-04-170326,170326,2,0,0,176,8.166666666666666,1.3145006,2
2020-11-05-170326,170326,5,0,0,181,13.833333333333336,1.7501007,3
2020-11-06-170326,170326,12,1,0,193,8.833333333333334,1.6152337,4
2020-11-07-170326,170326,7,0,0,200,4.166666666666667,0.83132744,5
2020-11-08-170326,170326,0,0,0,200,1.3333333333333333,0.22150858,6
2020-11-09-170326,170326,0,0,0,200,7.666666666666668,1.3049399,0
2020-11-10-170326,170326,3,1,0,203,6.333333333333332,1.209955,1
2020-11-11-170326,170326,5,1,0,208,12.166666666666664,1.7705318,2
2020-11-12-170326,170326,19,1,0,227,9.166666666666666,1.4363981,3
2020-11-13-170326,170326,27,1,0,254,6.666666666666668,2.3466308,4
2020-03-01-170327,170327,0,0,0,0,0.0,7.1419396e-05,6
2020-03-02-170327,170327,0,0,2,0,0.0,0.0012245361,0
2020-03-03-170327,170327,0,1,4,0,0.0,0.0007008282,1
2020-03-04-170327,170327,0,1,6,0,0.0,0.00577506,2
2020-03-05-170327,170327,0,0,6,0,0.0,0.00022424922,3
2020-03-06-170327,170327,0,1,3,0,0.0,0.0010729509,4
2020-03-07-170327,170327,0,0,4,0,0.0,0.0012431612,5
2020-03-08-170327,170327,0,0,2,0,0.0,0.0002723651,6
2020-03-09-170327,170327,1,0,10,1,0.16666666666666666,0.36930734,0
2020-03-10-170327,170327,0,0,6,1,0.0,0.0018047078,1
2020-03-11-170327,170327,0,0,6,1,0.0,0.026563546,2
2020-03-12-170327,170327,0,0,3,1,0.3333333333333333,0.041668512,3
2020-03-13-170327,170327,0,0,5,1,0.0,0.017537769,4
2020-03-14-170327,170327,0,0,2,1,0.0,0.028049516,5
2020-03-15-170327,170327,0,0,0,1,0.5,0.09094933,6
2020-03-16-170327,170327,2,0,2,3,4.0,1.4252518,0
2020-03-17-170327,170327,4,0,6,7,5.0,1.8473002,1
2020-03-18-170327,170327,6,0,7,13,8.166666666666666,2.9413214,2
2020-03-19-170327,170327,6,0,0,19,7.666666666666668,3.4445937,3
2020-03-20-170327,170327,3,0,2,22,8.0,2.5185313,4
2020-03-21-170327,170327,4,0,0,26,2.333333333333333,1.2625196,5
2020-03-22-170327,170327,2,0,0,28,1.5,0.57461405,6
2020-03-23-170327,170327,10,1,2,38,9.833333333333334,4.099993,0
2020-03-24-170327,170327,6,0,2,44,9.166666666666666,3.1524887,1
2020-03-25-170327,170327,6,0,4,50,9.0,3.1613908,2
2020-03-26-170327,170327,3,0,0,53,4.333333333333333,1.7711463,3
2020-03-27-170327,170327,5,0,2,58,7.5,2.6204863,4
2020-03-28-170327,170327,2,0,1,60,2.0,0.82382035,5
2020-03-29-170327,170327,0,0,0,60,2.6666666666666665,0.16656731,6
2020-03-30-170327,170327,2,0,2,62,4.5,1.2252249,0
2020-03-31-170327,170327,6,0,9,68,4.333333333333333,2.3377721,1
2020-04-01-170327,170327,7,0,2,75,4.0,2.7237542,2
2020-04-02-170327,170327,0,0,2,75,4.5,0.6166122,3
2020-04-03-170327,170327,2,0,2,77,2.833333333333333,1.0248319,4
2020-04-04-170327,170327,0,0,1,77,1.0,0.23972279,5
2020-04-05-170327,170327,0,0,0,77,1.5,0.14994562,6
2020-04-06-170327,170327,2,1,2,79,5.333333333333333,1.2733537,0
2020-04-07-170327,170327,2,0,1,81,3.6666666666666665,1.2108446,1
2020-04-08-170327,170327,4,0,0,85,2.833333333333333,1.7138861,2
2020-04-09-170327,170327,0,0,0,85,1.5,0.3366847,3
2020-04-10-170327,170327,2,1,3,87,8.333333333333334,0.8969359,4
2020-04-11-170327,170327,1,0,2,88,1.8333333333333333,0.38994393,5
2020-04-12-170327,170327,0,0,1,88,5.333333333333333,0.22972886,6
2020-04-13-170327,170327,2,0,2,90,6.166666666666668,1.3172992,0
2020-04-14-170327,170327,9,0,0,99,5.666666666666668,3.2597027,1
2020-04-15-170327,170327,2,0,1,101,4.5,1.0496634,2
2020-04-16-170327,170327,2,0,1,103,3.5,0.97531176,3
2020-04-17-170327,170327,2,0,0,105,1.0,0.8343349,4
2020-04-18-170327,170327,1,0,1,106,0.0,0.26763538,5
2020-04-19-170327,170327,0,0,1,106,0.3333333333333333,0.043862604,6
2020-04-20-170327,170327,2,0,1,108,1.5,0.9056439,0
2020-04-21-170327,170327,1,0,4,109,2.1666666666666665,0.85760844,1
2020-04-22-170327,170327,0,0,3,109,1.1666666666666667,0.46861508,2
2020-04-23-170327,170327,0,0,3,109,0.16666666666666666,0.028052362,3
2020-04-24-170327,170327,3,0,1,112,7.0,1.5145648,4
2020-04-25-170327,170327,2,0,1,114,1.3333333333333333,0.78130394,5
2020-04-26-170327,170327,1,0,0,115,0.5,0.27720848,6
2020-04-27-170327,170327,2,0,2,117,1.3333333333333333,0.9001883,0
2020-04-28-170327,170327,0,0,0,117,2.6666666666666665,0.6618593,1
2020-04-29-170327,170327,1,0,2,118,0.3333333333333333,0.55852205,2
2020-04-30-170327,170327,1,0,4,119,1.3333333333333333,0.42670467,3
2020-05-01-170327,170327,0,0,0,119,0.3333333333333333,0.046067152,4
2020-05-02-170327,170327,1,0,1,120,0.3333333333333333,0.30987105,5
2020-05-03-170327,170327,1,0,1,121,0.6666666666666666,0.46390137,6
2020-05-04-170327,170327,1,0,0,122,2.0,0.6652873,0
2020-05-05-170327,170327,4,0,1,126,3.0,1.530953,1
2020-05-06-170327,170327,3,0,0,129,2.333333333333333,1.3059043,2
2020-05-07-170327,170327,3,0,1,132,0.8333333333333334,1.45753,3
2020-05-08-170327,170327,1,0,2,133,1.5,0.67602897,4
2020-05-09-170327,170327,1,1,0,134,0.5,0.40958247,5
2020-05-10-170327,170327,0,0,0,134,0.3333333333333333,0.09236624,6
2020-05-11-170327,170327,2,2,0,136,1.5,0.940832,0
2020-05-12-170327,170327,0,0,1,136,1.1666666666666667,0.25077614,1
2020-05-13-170327,170327,2,0,1,138,1.6666666666666667,0.9365215,2
2020-05-14-170327,170327,4,0,0,142,2.833333333333333,1.8185269,3
2020-05-15-170327,170327,0,0,0,142,1.0,0.18703249,4
2020-05-16-170327,170327,1,0,1,143,0.16666666666666666,0.29097077,5
2020-05-17-170327,170327,1,0,0,144,0.0,0.23258151,6
2020-05-18-170327,170327,0,0,0,144,1.8333333333333333,0.549013,0
2020-05-19-170327,170327,1,0,0,145,2.0,0.89946955,1
2020-05-20-170327,170327,0,0,0,145,1.3333333333333333,0.47063637,2
2020-05-21-170327,170327,1,0,0,146,1.6666666666666667,0.6178981,3
2020-05-22-170327,170327,2,0,1,148,0.5,0.8482334,4
2020-05-23-170327,170327,0,0,0,148,0.16666666666666666,0.10195137,5
2020-05-24-170327,170327,0,0,0,148,0.3333333333333333,0.013639609,6
2020-05-25-170327,170327,0,0,2,148,1.1666666666666667,0.185709,0
2020-05-26-170327,170327,1,0,1,149,0.6666666666666666,0.63520193,1
2020-05-27-170327,170327,1,0,0,150,0.3333333333333333,1.9474003,2
2020-05-28-170327,170327,0,0,1,150,2.0,0.54436797,3
2020-05-29-170327,170327,0,1,2,150,1.1666666666666667,0.22033742,4
2020-05-30-170327,170327,1,0,0,151,0.16666666666666666,0.3883386,5
2020-05-31-170327,170327,0,0,0,151,0.16666666666666666,0.041791327,6
2020-06-01-170327,170327,0,0,1,151,1.3333333333333333,0.41666195,0
2020-06-02-170327,170327,0,0,0,151,2.5,0.56658524,1
2020-06-03-170327,170327,0,0,0,151,0.8333333333333334,0.21704493,2
2020-06-04-170327,170327,0,0,0,151,1.5,0.37168992,3
2020-06-05-170327,170327,1,0,0,152,0.6666666666666666,0.59116983,4
2020-06-06-170327,170327,0,0,0,152,0.16666666666666666,0.0633805,5
2020-06-07-170327,170327,0,0,0,152,0.3333333333333333,0.05067271,6
2020-06-08-170327,170327,2,0,0,154,1.0,1.0368518,0
2020-06-09-170327,170327,1,0,1,155,1.1666666666666667,0.8158265,1
2020-06-10-170327,170327,0,1,2,155,4.333333333333333,1.1031202,2
2020-06-11-170327,170327,1,0,2,156,1.1666666666666667,0.77965504,3
2020-06-12-170327,170327,2,0,0,158,1.1666666666666667,1.0296751,4
2020-06-13-170327,170327,0,0,0,158,0.0,0.006358462,5
2020-06-14-170327,170327,0,0,0,158,0.0,0.010671332,6
2020-06-15-170327,170327,1,1,0,159,1.5,0.7859952,0
2020-06-16-170327,170327,0,0,0,159,0.5,0.15918083,1
2020-06-17-170327,170327,0,0,0,159,1.1666666666666667,0.18705265,2
2020-06-18-170327,170327,0,0,0,159,0.3333333333333333,0.06497706,3
2020-06-19-170327,170327,0,0,0,159,0.0,0.019437663,4
2020-06-20-170327,170327,0,0,0,159,0.0,0.0013234402,5
2020-06-21-170327,170327,0,0,0,159,0.0,0.0009225797,6
2020-06-22-170327,170327,0,0,0,159,0.6666666666666666,0.18597035,0
2020-06-23-170327,170327,1,0,0,160,1.0,0.71551794,1
2020-06-24-170327,170327,2,0,0,162,0.6666666666666666,0.8891424,2
2020-06-25-170327,170327,2,0,0,164,1.1666666666666667,1.0593783,3
2020-06-26-170327,170327,0,1,0,164,0.3333333333333333,0.19494604,4
2020-06-27-170327,170327,0,0,0,164,0.0,0.017224204,5
2020-06-28-170327,170327,0,0,0,164,0.0,0.001746706,6
2020-06-29-170327,170327,0,0,0,164,0.5,0.14081809,0
2020-06-30-170327,170327,0,0,0,164,0.6666666666666666,0.2654353,1
2020-07-01-170327,170327,0,0,0,164,0.16666666666666666,0.10046529,2
2020-07-02-170327,170327,0,0,0,164,0.5,0.06990828,3
2020-07-03-170327,170327,0,0,0,164,0.16666666666666666,0.11076726,4
2020-07-04-170327,170327,0,0,0,164,0.0,0.00070907193,5
2020-07-05-170327,170327,0,0,0,164,0.0,0.0025821812,6
2020-07-06-170327,170327,0,0,0,164,0.8333333333333334,0.3075132,0
2020-07-07-170327,170327,0,0,0,164,0.0,0.0247916,1
2020-07-08-170327,170327,0,0,0,164,0.6666666666666666,0.30447465,2
2020-07-09-170327,170327,0,0,1,164,0.8333333333333334,0.22770633,3
2020-07-10-170327,170327,0,0,0,164,0.16666666666666666,0.25184035,4
2020-07-11-170327,170327,0,0,0,164,0.3333333333333333,0.04237671,5
2020-07-12-170327,170327,0,0,0,164,0.0,0.0058614113,6
2020-07-13-170327,170327,0,1,0,164,0.16666666666666666,0.035135124,0
2020-07-14-170327,170327,0,0,0,164,0.16666666666666666,0.07681068,1
2020-07-15-170327,170327,0,0,0,164,0.16666666666666666,0.10946892,2
2020-07-16-170327,170327,0,0,0,164,0.3333333333333333,0.089463316,3
2020-07-17-170327,170327,0,0,0,164,0.3333333333333333,0.17924915,4
2020-07-18-170327,170327,0,0,0,164,0.16666666666666666,0.03784499,5
2020-07-19-170327,170327,0,0,1,164,0.3333333333333333,0.14270662,6
2020-07-20-170327,170327,0,0,1,164,0.16666666666666666,0.051258676,0
2020-07-21-170327,170327,0,0,1,164,0.3333333333333333,0.17774332,1
2020-07-22-170327,170327,0,0,1,164,0.16666666666666666,0.025642423,2
2020-07-23-170327,170327,1,0,2,165,0.16666666666666666,0.47555685,3
2020-07-24-170327,170327,0,0,0,165,0.5,0.19265236,4
2020-07-25-170327,170327,0,0,1,165,0.0,0.0009472126,5
2020-07-26-170327,170327,0,0,1,165,0.0,0.006801851,6
2020-07-27-170327,170327,0,0,1,165,0.3333333333333333,0.035921905,0
2020-07-28-170327,170327,0,1,1,165,0.5,0.17810845,1
2020-07-29-170327,170327,0,0,0,165,0.0,0.029829668,2
2020-07-30-170327,170327,0,0,2,165,0.5,0.118526325,3
2020-07-31-170327,170327,0,0,1,165,0.6666666666666666,0.17938778,4
2020-08-01-170327,170327,0,0,0,165,0.16666666666666666,0.023137456,5
2020-08-02-170327,170327,1,0,0,166,0.16666666666666666,0.49725354,6
2020-08-03-170327,170327,1,0,0,167,0.0,0.15220676,0
2020-08-04-170327,170327,1,0,0,168,0.3333333333333333,0.54598606,1
2020-08-05-170327,170327,1,0,0,169,0.3333333333333333,0.49838907,2
2020-08-06-170327,170327,2,0,1,171,1.5,1.0627334,3
2020-08-07-170327,170327,0,1,1,171,0.3333333333333333,0.086082734,4
2020-08-08-170327,170327,1,0,1,172,0.0,0.48676753,5
2020-08-09-170327,170327,1,0,0,173,0.0,0.8207094,6
2020-08-10-170327,170327,1,0,1,174,0.5,0.73578,0
2020-08-11-170327,170327,1,0,5,175,0.6666666666666666,0.70912,1
2020-08-12-170327,170327,0,0,1,175,1.0,0.20198783,2
2020-08-13-170327,170327,2,0,0,177,0.5,0.6997166,3
2020-08-14-170327,170327,1,0,1,178,0.0,0.5225276,4
2020-08-15-170327,170327,0,0,1,178,1.1666666666666667,0.21181878,5
2020-08-16-170327,170327,0,0,0,178,0.0,0.081903294,6
2020-08-17-170327,170327,0,0,2,178,0.0,0.21556422,0
2020-08-18-170327,170327,0,0,1,178,0.3333333333333333,0.22591285,1
2020-08-19-170327,170327,0,0,3,178,0.16666666666666666,0.3511227,2
2020-08-20-170327,170327,1,0,2,179,1.3333333333333333,1.1826104,3
2020-08-21-170327,170327,1,0,5,180,0.5,1.1845989,4
2020-08-22-170327,170327,1,0,0,181,0.3333333333333333,1.0474098,5
2020-08-23-170327,170327,0,0,2,181,0.0,0.45493385,6
2020-08-24-170327,170327,1,0,2,182,0.5,2.2751775,0
2020-08-25-170327,170327,5,0,0,187,2.6666666666666665,3.0534081,1
2020-08-26-170327,170327,1,0,13,188,0.6666666666666666,1.9565111,2
2020-08-27-170327,170327,0,0,4,188,3.1666666666666665,1.2228183,3
2020-08-28-170327,170327,1,0,6,189,1.3333333333333333,0.78680277,4
2020-08-29-170327,170327,1,0,2,190,0.8333333333333334,1.142087,5
2020-08-30-170327,170327,0,0,1,190,3.1666666666666665,0.45567027,6
2020-08-31-170327,170327,2,0,1,192,1.5,1.4957813,0
2020-09-01-170327,170327,1,0,2,193,1.6666666666666667,1.0827059,1
2020-09-02-170327,170327,3,0,4,196,1.8333333333333333,1.9741989,2
2020-09-03-170327,170327,2,0,6,198,1.1666666666666667,0.62535375,3
2020-09-04-170327,170327,5,0,6,203,2.1666666666666665,1.4860184,4
2020-09-05-170327,170327,0,0,1,203,0.0,0.13717252,5
2020-09-06-170327,170327,2,0,0,205,1.1666666666666667,0.75333387,6
2020-09-07-170327,170327,2,0,13,207,2.333333333333333,0.98762804,0
2020-09-08-170327,170327,0,0,6,207,1.3333333333333333,0.41004536,1
2020-09-09-170327,170327,13,0,12,220,3.5,5.047473,2
2020-09-10-170327,170327,4,0,63,224,2.833333333333333,3.009685,3
2020-09-11-170327,170327,6,0,16,230,3.1666666666666665,4.6630583,4
2020-09-12-170327,170327,2,0,1,232,1.5,0.93151146,5
2020-09-13-170327,170327,1,0,3,233,0.8333333333333334,0.55452585,6
2020-09-14-170327,170327,1,0,7,234,2.0,1.1841651,0
2020-09-15-170327,170327,2,0,16,236,3.0,1.1045585,1
2020-09-16-170327,170327,4,0,15,240,2.5,2.3857014,2
2020-09-17-170327,170327,6,0,17,246,3.8333333333333335,4.4102125,3
2020-09-18-170327,170327,6,0,20,252,2.0,2.413017,4
2020-09-19-170327,170327,1,0,16,253,1.5,0.7548693,5
2020-09-20-170327,170327,0,0,1,253,1.5,0.20087282,6
2020-09-21-170327,170327,13,1,10,266,2.0,4.4721193,0
2020-09-22-170327,170327,6,0,5,272,3.0,3.4156764,1
2020-09-23-170327,170327,12,1,9,284,4.666666666666667,4.982409,2
2020-09-24-170327,170327,63,0,6,347,5.333333333333333,19.672876,3
2020-09-25-170327,170327,16,1,13,363,10.0,5.6522884,4
2020-09-26-170327,170327,1,1,1,364,2.333333333333333,1.3274467,5
2020-09-27-170327,170327,3,0,0,367,0.8333333333333334,0.9482001,6
2020-09-28-170327,170327,7,1,2,374,2.333333333333333,2.9477425,0
2020-09-29-170327,170327,16,1,7,390,2.833333333333333,3.463196,1
2020-09-30-170327,170327,15,1,13,405,7.333333333333332,4.5676703,2
2020-10-01-170327,170327,17,1,39,422,7.0,6.7682743,3
2020-10-02-170327,170327,20,0,6,442,5.166666666666667,6.4790606,4
2020-10-03-170327,170327,16,1,3,458,1.5,3.0400712,5
2020-10-04-170327,170327,1,2,4,459,1.0,0.56311834,6
2020-10-05-170327,170327,10,2,7,469,3.333333333333333,4.4086256,0
2020-10-06-170327,170327,5,0,12,474,7.666666666666668,2.4426556,1
2020-10-07-170327,170327,9,2,0,483,3.333333333333333,4.0801473,2
2020-10-08-170327,170327,6,1,10,489,5.5,3.5195997,3
2020-10-09-170327,170327,13,4,41,502,9.666666666666666,5.4834366,4
2020-10-10-170327,170327,1,0,4,503,2.6666666666666665,1.2165723,5
2020-10-11-170327,170327,0,0,2,503,2.6666666666666665,0.608368,6
2020-10-12-170327,170327,2,0,13,505,1.3333333333333333,1.0038068,0
2020-10-13-170327,170327,7,0,2,512,8.166666666666666,4.2851243,1
2020-10-14-170327,170327,13,0,5,525,5.833333333333332,4.9871607,2
2020-10-15-170327,170327,39,0,20,564,7.5,14.232103,3
2020-10-16-170327,170327,6,0,12,570,8.333333333333334,4.51074,4
2020-10-17-170327,170327,3,1,2,573,3.333333333333333,2.0340233,5
2020-10-18-170327,170327,4,3,2,577,2.333333333333333,2.1296043,6
2020-10-19-170327,170327,7,4,0,584,6.666666666666668,4.1424236,0
2020-10-20-170327,170327,12,2,5,596,4.0,4.1860695,1
2020-10-21-170327,170327,0,0,7,596,6.0,1.5356714,2
2020-10-22-170327,170327,10,1,11,606,6.166666666666668,5.661419,3
2020-10-23-170327,170327,41,1,10,647,3.333333333333333,13.755215,4
2020-10-24-170327,170327,4,1,10,651,1.6666666666666667,1.5436233,5
2020-10-25-170327,170327,2,2,4,653,2.0,1.2514251,6
2020-10-26-170327,170327,13,1,12,666,4.833333333333333,5.4623847,0
2020-10-27-170327,170327,2,2,15,668,4.833333333333333,1.9616779,1
2020-10-28-170327,170327,5,2,13,673,3.0,2.8767152,2
2020-10-29-170327,170327,20,1,15,693,6.333333333333332,4.978524,3
2020-10-30-170327,170327,12,0,16,705,7.166666666666668,6.358698,4
2020-10-31-170327,170327,2,2,0,707,3.5,1.2618212,5
2020-11-01-170327,170327,2,1,0,709,3.6666666666666665,2.1058862,6
2020-11-02-170327,170327,0,2,0,709,1.6666666666666667,0.57540256,0
2020-11-03-170327,170327,5,0,0,714,5.833333333333332,4.1796265,1
2020-11-04-170327,170327,7,1,0,721,2.333333333333333,3.7500095,2
2020-11-05-170327,170327,11,2,0,732,9.5,6.0588117,3
2020-11-06-170327,170327,10,4,0,742,12.666666666666664,6.399551,4
2020-11-07-170327,170327,10,0,0,752,2.1666666666666665,3.3240597,5
2020-11-08-170327,170327,4,1,0,756,1.3333333333333333,1.0696458,6
2020-11-09-170327,170327,12,0,0,768,10.0,7.112991,0
2020-11-10-170327,170327,15,1,0,783,4.666666666666667,5.6242228,1
2020-11-11-170327,170327,13,2,0,796,4.0,6.447485,2
2020-11-12-170327,170327,15,1,0,811,7.833333333333332,4.958444,3
2020-11-13-170327,170327,16,1,0,827,7.5,8.843226,4
2020-03-01-170328,170328,0,0,2,0,0.25,0.00020200574,6
2020-03-02-170328,170328,0,0,3,0,0.0,0.000929981,0
2020-03-03-170328,170328,0,0,33,0,0.0,0.00043104598,1
2020-03-04-170328,170328,0,0,18,0,0.0,0.0017572688,2
2020-03-05-170328,170328,0,0,26,0,0.0,7.0660455e-05,3
2020-03-06-170328,170328,0,0,19,0,0.0,0.00078280503,4
2020-03-07-170328,170328,0,0,2,0,0.0,0.0007681343,5
2020-03-08-170328,170328,0,0,6,0,0.0,0.00080412446,6
2020-03-09-170328,170328,0,0,28,0,0.0,0.010606919,0
2020-03-10-170328,170328,0,0,32,0,0.0,0.0012058779,1
2020-03-11-170328,170328,1,0,25,1,0.0,0.0027316974,2
2020-03-12-170328,170328,0,0,42,1,0.5,0.023704024,3
2020-03-13-170328,170328,0,0,15,1,0.0,0.013362996,4
2020-03-14-170328,170328,1,0,6,2,1.0,0.103861436,5
2020-03-15-170328,170328,2,0,3,4,1.25,0.070534326,6
2020-03-16-170328,170328,3,0,17,7,12.75,0.6851024,0
2020-03-17-170328,170328,33,0,31,40,12.25,0.82931983,1
2020-03-18-170328,170328,18,0,11,58,15.5,0.8470385,2
2020-03-19-170328,170328,26,0,7,84,14.75,0.8854078,3
2020-03-20-170328,170328,19,0,10,103,13.5,0.86241674,4
2020-03-21-170328,170328,2,0,2,105,3.75,0.20355186,5
2020-03-22-170328,170328,6,0,1,111,3.75,0.1650423,6
2020-03-23-170328,170328,28,0,15,139,22.25,1.534639,0
2020-03-24-170328,170328,32,0,7,171,13.5,0.9120478,1
2020-03-25-170328,170328,25,0,9,196,14.5,0.953809,2
2020-03-26-170328,170328,42,0,11,238,8.75,0.78012335,3
2020-03-27-170328,170328,15,0,8,253,21.25,1.1438984,4
2020-03-28-170328,170328,6,0,2,259,3.75,0.17718992,5
2020-03-29-170328,170328,3,0,1,262,3.5,0.107487425,6
2020-03-30-170328,170328,17,0,8,279,13.75,0.8959758,0
2020-03-31-170328,170328,31,0,11,310,11.75,0.6061263,1
2020-04-01-170328,170328,11,0,15,321,10.0,0.61762524,2
2020-04-02-170328,170328,7,0,6,328,8.25,0.47603506,3
2020-04-03-170328,170328,10,0,9,338,8.75,0.51067233,4
2020-04-04-170328,170328,2,0,1,340,2.25,0.14173487,5
2020-04-05-170328,170328,1,0,0,341,1.25,0.053522818,6
2020-04-06-170328,170328,15,1,10,356,7.5,0.5332928,0
2020-04-07-170328,170328,7,3,4,363,7.5,0.4958276,1
2020-04-08-170328,170328,9,2,7,372,15.0,0.9141629,2
2020-04-09-170328,170328,11,0,0,383,5.25,0.30160117,3
2020-04-10-170328,170328,8,0,8,391,13.0,0.44046032,4
2020-04-11-170328,170328,2,0,1,393,1.75,0.09506344,5
2020-04-12-170328,170328,1,1,1,394,3.5,0.13971753,6
2020-04-13-170328,170328,8,0,5,402,14.0,0.77982634,0
2020-04-14-170328,170328,11,0,5,413,8.5,0.69566554,1
2020-04-15-170328,170328,15,0,9,428,10.5,0.6938474,2
2020-04-16-170328,170328,6,0,15,434,8.75,0.73885405,3
2020-04-17-170328,170328,9,0,0,443,3.75,0.37541467,4
2020-04-18-170328,170328,1,0,2,444,0.75,0.033301953,5
2020-04-19-170328,170328,0,0,0,444,0.75,0.033575125,6
2020-04-20-170328,170328,10,2,11,454,8.25,0.6762299,0
2020-04-21-170328,170328,4,0,6,458,13.75,0.87985724,1
2020-04-22-170328,170328,7,0,2,465,2.5,0.36007336,2
2020-04-23-170328,170328,0,0,3,465,1.0,0.04739358,3
2020-04-24-170328,170328,8,1,3,473,4.25,0.5902147,4
2020-04-25-170328,170328,1,0,1,474,2.0,0.08932897,5
2020-04-26-170328,170328,1,0,0,475,0.5,0.021095594,6
2020-04-27-170328,170328,5,0,5,480,2.75,0.24999234,0
2020-04-28-170328,170328,5,0,7,485,3.25,0.30018687,1
2020-04-29-170328,170328,9,0,21,494,2.25,0.16173625,2
2020-04-30-170328,170328,15,0,5,509,3.0,0.17627963,3
2020-05-01-170328,170328,0,0,3,509,0.25,0.0063562426,4
2020-05-02-170328,170328,2,0,0,511,1.25,0.064491965,5
2020-05-03-170328,170328,0,0,0,511,1.0,0.0217757,6
2020-05-04-170328,170328,11,0,5,522,3.25,0.22698937,0
2020-05-05-170328,170328,6,0,4,528,1.0,0.19810942,1
2020-05-06-170328,170328,2,0,3,530,4.0,0.29356638,2
2020-05-07-170328,170328,3,0,5,533,2.0,0.13724102,3
2020-05-08-170328,170328,3,0,3,536,4.25,0.35225612,4
2020-05-09-170328,170328,1,0,1,537,0.5,0.043488532,5
2020-05-10-170328,170328,0,3,0,537,0.0,0.0056039877,6
2020-05-11-170328,170328,5,1,7,542,2.5,0.14206421,0
2020-05-12-170328,170328,7,0,2,549,1.75,0.13463055,1
2020-05-13-170328,170328,21,0,3,570,0.5,0.11483285,2
2020-05-14-170328,170328,5,3,2,575,3.25,0.28300095,3
2020-05-15-170328,170328,3,0,2,578,2.75,0.19415127,4
2020-05-16-170328,170328,0,0,1,578,0.0,0.025008408,5
2020-05-17-170328,170328,0,0,1,578,0.25,0.012617896,6
2020-05-18-170328,170328,5,0,4,583,2.0,0.16626607,0
2020-05-19-170328,170328,4,0,4,587,3.0,0.31430286,1
2020-05-20-170328,170328,3,0,4,590,1.5,0.16072376,2
2020-05-21-170328,170328,5,0,8,595,2.25,0.24538438,3
2020-05-22-170328,170328,3,0,2,598,3.25,0.27798298,4
2020-05-23-170328,170328,1,0,1,599,0.0,0.012701099,5
2020-05-24-170328,170328,0,0,1,599,0.5,0.019418947,6
2020-05-25-170328,170328,7,0,5,606,2.25,0.16366117,0
2020-05-26-170328,170328,2,0,3,608,1.0,0.17892806,1
2020-05-27-170328,170328,3,0,0,611,1.75,0.17316723,2
2020-05-28-170328,170328,2,0,3,613,1.25,0.21509705,3
2020-05-29-170328,170328,2,1,3,615,1.25,0.19881117,4
2020-05-30-170328,170328,1,0,2,616,0.25,0.019430254,5
2020-05-31-170328,170328,1,0,0,617,0.75,0.01952545,6
2020-06-01-170328,170328,4,0,2,621,3.25,0.24420689,0
2020-06-02-170328,170328,4,0,4,625,2.75,0.23073003,1
2020-06-03-170328,170328,4,0,1,629,2.75,0.20719987,2
2020-06-04-170328,170328,8,0,3,637,1.5,0.16827755,3
2020-06-05-170328,170328,2,0,0,639,1.75,0.20985106,4
2020-06-06-170328,170328,1,0,0,640,0.0,0.004336178,5
2020-06-07-170328,170328,1,0,0,641,0.0,0.008989474,6
2020-06-08-170328,170328,5,0,2,646,1.0,0.19789924,0
2020-06-09-170328,170328,3,0,1,649,1.75,0.25528815,1
2020-06-10-170328,170328,0,0,1,649,2.75,0.2592678,2
2020-06-11-170328,170328,3,0,2,652,2.5,0.21790512,3
2020-06-12-170328,170328,3,0,3,655,1.25,0.15151738,4
2020-06-13-170328,170328,2,0,0,657,0.25,0.021032063,5
2020-06-14-170328,170328,0,0,0,657,0.25,0.014443015,6
2020-06-15-170328,170328,2,0,0,659,0.0,0.07352117,0
2020-06-16-170328,170328,4,0,0,663,0.75,0.10669465,1
2020-06-17-170328,170328,1,0,1,664,1.25,0.0850694,2
2020-06-18-170328,170328,3,0,0,667,0.75,0.067138046,3
2020-06-19-170328,170328,0,0,4,667,1.0,0.086906426,4
2020-06-20-170328,170328,0,0,0,667,0.0,0.0005936666,5
2020-06-21-170328,170328,0,0,1,667,0.0,0.0014469535,6
2020-06-22-170328,170328,2,0,3,669,0.5,0.035574377,0
2020-06-23-170328,170328,1,0,1,670,1.5,0.10642204,1
2020-06-24-170328,170328,1,0,2,671,0.5,0.040610164,2
2020-06-25-170328,170328,2,0,1,673,1.75,0.1311608,3
2020-06-26-170328,170328,3,0,4,676,0.0,0.03232081,4
2020-06-27-170328,170328,0,0,2,676,0.25,0.01778921,5
2020-06-28-170328,170328,0,0,0,676,0.0,0.00013875088,6
2020-06-29-170328,170328,0,0,2,676,0.25,0.045116745,0
2020-06-30-170328,170328,0,0,2,676,0.75,0.080535844,1
2020-07-01-170328,170328,1,0,2,677,0.25,0.019807229,2
2020-07-02-170328,170328,0,0,3,677,0.5,0.03811303,3
2020-07-03-170328,170328,4,0,0,681,0.25,0.038381677,4
2020-07-04-170328,170328,0,0,0,681,0.0,0.0003119997,5
2020-07-05-170328,170328,1,0,0,682,0.25,0.012095762,6
2020-07-06-170328,170328,3,0,0,685,0.5,0.047932547,0
2020-07-07-170328,170328,1,0,0,686,1.0,0.07942371,1
2020-07-08-170328,170328,2,0,2,688,0.25,0.047314007,2
2020-07-09-170328,170328,1,0,0,689,0.25,0.062766045,3
2020-07-10-170328,170328,4,1,0,693,0.25,0.043777388,4
2020-07-11-170328,170328,2,0,0,695,0.0,0.0093752155,5
2020-07-12-170328,170328,0,0,0,695,0.25,0.021136822,6
2020-07-13-170328,170328,2,0,1,697,0.75,0.09526572,0
2020-07-14-170328,170328,2,0,2,699,0.0,0.025442835,1
2020-07-15-170328,170328,2,0,4,701,1.0,0.02764084,2
2020-07-16-170328,170328,3,0,0,704,0.5,0.03830696,3
2020-07-17-170328,170328,0,0,1,704,0.75,0.071243376,4
2020-07-18-170328,170328,0,0,0,704,0.25,0.041984353,5
2020-07-19-170328,170328,0,0,0,704,0.25,0.033159286,6
2020-07-20-170328,170328,0,0,0,704,2.5,0.12562522,0
2020-07-21-170328,170328,0,1,2,704,0.75,0.05664512,1
2020-07-22-170328,170328,2,1,0,706,1.5,0.101992644,2
2020-07-23-170328,170328,0,0,0,706,0.75,0.079828106,3
2020-07-24-170328,170328,0,0,3,706,1.5,0.10716825,4
2020-07-25-170328,170328,0,0,0,706,0.0,0.00086714275,5
2020-07-26-170328,170328,0,0,0,706,0.5,0.027701125,6
2020-07-27-170328,170328,1,0,1,707,0.5,0.059581503,0
2020-07-28-170328,170328,2,0,2,709,1.25,0.09150534,1
2020-07-29-170328,170328,4,1,2,713,0.5,0.009575163,2
2020-07-30-170328,170328,0,0,1,713,1.25,0.14109227,3
2020-07-31-170328,170328,1,0,4,714,1.0,0.07556889,4
2020-08-01-170328,170328,0,0,0,714,0.25,0.011377319,5
2020-08-02-170328,170328,0,0,1,714,0.0,0.03276877,6
2020-08-03-170328,170328,0,0,0,714,1.0,0.07157614,0
2020-08-04-170328,170328,2,0,1,716,1.0,0.13679288,1
2020-08-05-170328,170328,0,0,5,716,1.0,0.13651043,2
2020-08-06-170328,170328,0,0,2,716,1.25,0.12539053,3
2020-08-07-170328,170328,3,0,3,719,1.25,0.08281306,4
2020-08-08-170328,170328,0,0,0,719,0.25,0.02405435,5
2020-08-09-170328,170328,0,0,2,719,0.0,0.02215407,6
2020-08-10-170328,170328,1,0,1,720,1.5,0.076519005,0
2020-08-11-170328,170328,2,0,9,722,0.5,0.06972906,1
2020-08-12-170328,170328,2,0,9,724,1.0,0.08174764,2
2020-08-13-170328,170328,1,0,9,725,0.25,0.060270634,3
2020-08-14-170328,170328,4,0,5,729,0.5,0.06944754,4
2020-08-15-170328,170328,0,0,4,729,0.0,0.043277327,5
2020-08-16-170328,170328,1,0,1,730,0.75,0.054312788,6
2020-08-17-170328,170328,0,0,4,730,0.75,0.10571499,0
2020-08-18-170328,170328,1,0,1,731,2.0,0.17559953,1
2020-08-19-170328,170328,5,0,0,736,1.5,0.18615684,2
2020-08-20-170328,170328,2,0,3,738,3.0,0.16085935,3
2020-08-21-170328,170328,3,0,5,741,2.5,0.2255873,4
2020-08-22-170328,170328,0,0,3,741,0.25,0.06566194,5
2020-08-23-170328,170328,2,0,3,743,2.25,0.11376601,6
2020-08-24-170328,170328,1,0,9,744,1.75,0.20257516,0
2020-08-25-170328,170328,9,0,8,753,4.0,0.389772,1
2020-08-26-170328,170328,9,0,12,762,3.5,0.3529999,2
2020-08-27-170328,170328,9,0,15,771,4.0,0.43460345,3
2020-08-28-170328,170328,5,0,13,776,3.75,0.30776376,4
2020-08-29-170328,170328,4,0,5,780,2.75,0.17712234,5
2020-08-30-170328,170328,1,0,9,781,4.0,0.21813296,6
2020-08-31-170328,170328,4,0,13,785,5.5,0.40442413,0
2020-09-01-170328,170328,1,0,12,786,3.0,0.2440369,1
2020-09-02-170328,170328,0,0,8,786,3.0,0.23388757,2
2020-09-03-170328,170328,3,0,12,789,4.75,0.4228482,3
2020-09-04-170328,170328,5,1,11,794,4.0,0.35977003,4
2020-09-05-170328,170328,3,0,10,797,3.0,0.08505539,5
2020-09-06-170328,170328,3,0,7,800,6.5,0.23110121,6
2020-09-07-170328,170328,9,0,21,809,6.25,0.51320535,0
2020-09-08-170328,170328,8,0,7,817,4.75,0.31847653,1
2020-09-09-170328,170328,12,0,11,829,8.75,0.68143755,2
2020-09-10-170328,170328,15,0,6,844,8.0,0.58658004,3
2020-09-11-170328,170328,13,0,9,857,6.75,0.6942078,4
2020-09-12-170328,170328,5,0,7,862,3.25,0.17231715,5
2020-09-13-170328,170328,9,0,1,871,6.25,0.3205526,6
2020-09-14-170328,170328,13,0,13,884,7.0,0.45817047,0
2020-09-15-170328,170328,12,0,9,896,8.0,0.5267031,1
2020-09-16-170328,170328,8,0,9,904,7.75,0.59246904,2
2020-09-17-170328,170328,12,0,12,916,8.25,0.70569694,3
2020-09-18-170328,170328,11,0,16,927,6.25,0.50103587,4
2020-09-19-170328,170328,10,1,5,937,4.0,0.15928802,5
2020-09-20-170328,170328,7,0,6,944,3.0,0.13470906,6
2020-09-21-170328,170328,21,1,3,965,8.0,0.607689,0
2020-09-22-170328,170328,7,3,11,972,6.75,0.6891839,1
2020-09-23-170328,170328,11,0,18,983,12.0,0.7568499,2
2020-09-24-170328,170328,6,2,18,989,11.0,0.877348,3
2020-09-25-170328,170328,9,0,16,998,10.0,0.7612511,4
2020-09-26-170328,170328,7,1,6,1005,1.75,0.2050184,5
2020-09-27-170328,170328,1,0,3,1006,2.0,0.104684025,6
2020-09-28-170328,170328,13,0,13,1019,12.25,0.8091021,0
2020-09-29-170328,170328,9,0,29,1028,7.0,0.5041086,1
2020-09-30-170328,170328,9,0,19,1037,12.5,0.7562336,2
2020-10-01-170328,170328,12,0,16,1049,25.5,1.7583127,3
2020-10-02-170328,170328,16,0,37,1065,14.75,1.0895156,4
2020-10-03-170328,170328,5,0,4,1070,4.5,0.1960107,5
2020-10-04-170328,170328,6,2,16,1076,5.5,0.20561899,6
2020-10-05-170328,170328,3,1,8,1079,3.0,0.32563692,0
2020-10-06-170328,170328,11,0,24,1090,15.25,1.083647,1
2020-10-07-170328,170328,18,0,18,1108,7.0,0.5308543,2
2020-10-08-170328,170328,18,0,19,1126,13.5,0.92803365,3
2020-10-09-170328,170328,16,0,23,1142,12.75,1.1987882,4
2020-10-10-170328,170328,6,0,10,1148,3.25,0.17869423,5
2020-10-11-170328,170328,3,0,5,1151,2.5,0.120617114,6
2020-10-12-170328,170328,13,0,33,1164,4.25,0.17360114,0
2020-10-13-170328,170328,29,0,10,1193,26.0,1.5960393,1
2020-10-14-170328,170328,19,0,25,1212,14.75,1.1639382,2
2020-10-15-170328,170328,16,0,11,1228,19.0,1.275435,3
2020-10-16-170328,170328,37,0,13,1265,15.75,1.1264799,4
2020-10-17-170328,170328,4,0,4,1269,4.75,0.23075216,5
2020-10-18-170328,170328,16,0,26,1285,2.0,0.20443897,6
2020-10-19-170328,170328,8,0,2,1293,23.25,1.4865816,0
2020-10-20-170328,170328,24,0,19,1317,9.5,0.93859786,1
2020-10-21-170328,170328,18,1,10,1335,14.0,1.1400926,2
2020-10-22-170328,170328,19,0,14,1354,8.5,1.1347574,3
2020-10-23-170328,170328,23,2,27,1377,13.25,1.2641841,4
2020-10-24-170328,170328,10,1,7,1387,5.25,0.2827535,5
2020-10-25-170328,170328,5,0,16,1392,3.75,0.20626897,6
2020-10-26-170328,170328,33,0,40,1425,12.25,1.1996051,0
2020-10-27-170328,170328,10,0,19,1435,11.0,0.72534114,1
2020-10-28-170328,170328,25,0,10,1460,10.5,1.1099471,2
2020-10-29-170328,170328,11,1,11,1471,21.0,1.5180379,3
2020-10-30-170328,170328,13,0,14,1484,13.25,1.3119979,4
2020-10-31-170328,170328,4,1,0,1488,5.0,0.30522415,5
2020-11-01-170328,170328,26,2,0,1514,5.25,0.19946364,6
2020-11-02-170328,170328,2,0,0,1516,4.0,0.32697356,0
2020-11-03-170328,170328,19,1,0,1535,21.25,1.8604746,1
2020-11-04-170328,170328,10,1,0,1545,9.25,0.78066087,2
2020-11-05-170328,170328,14,6,0,1559,14.25,1.3160888,3
2020-11-06-170328,170328,27,1,0,1586,16.25,1.3334453,4
2020-11-07-170328,170328,7,0,0,1593,3.75,0.2590105,5
2020-11-08-170328,170328,16,3,0,1609,9.5,0.18674791,6
2020-11-09-170328,170328,40,2,0,1649,23.0,1.6348075,0
2020-11-10-170328,170328,19,0,0,1668,11.5,1.2220385,1
2020-11-11-170328,170328,10,3,0,1678,10.25,1.0821058,2
2020-11-12-170328,170328,11,2,0,1689,14.75,0.8523058,3
2020-11-13-170328,170328,14,0,0,1703,15.75,1.355402,4
2020-03-01-170401,170401,0,0,1,0,0.0,8.727422e-09,6
2020-03-02-170401,170401,0,0,3,0,0.0,7.3088995e-05,0
2020-03-03-170401,170401,0,0,1,0,0.0,1.22582735e-08,1
2020-03-04-170401,170401,0,3,13,0,0.0,0.00018581757,2
2020-03-05-170401,170401,0,0,10,0,0.0,0.00025228434,3
2020-03-06-170401,170401,0,1,3,0,0.2,0.0074081356,4
2020-03-07-170401,170401,0,0,2,0,0.0,0.00094915245,5
2020-03-08-170401,170401,0,0,13,0,0.0,0.0021907503,6
2020-03-09-170401,170401,0,0,9,0,0.0,0.00518108,0
2020-03-10-170401,170401,0,0,12,0,0.0,0.0076831533,1
2020-03-11-170401,170401,0,0,15,0,0.0,0.000991137,2
2020-03-12-170401,170401,0,0,16,0,0.2,0.024067048,3
2020-03-13-170401,170401,0,0,10,0,0.2,0.049880747,4
2020-03-14-170401,170401,0,0,6,0,0.4,0.28145677,5
2020-03-15-170401,170401,1,0,6,1,0.2,0.21479876,6
2020-03-16-170401,170401,3,0,12,4,1.2,0.46576983,0
2020-03-17-170401,170401,1,0,10,5,3.2,1.7264725,1
2020-03-18-170401,170401,13,0,6,18,2.2,1.5731876,2
2020-03-19-170401,170401,10,0,9,28,3.4,2.1046863,3
2020-03-20-170401,170401,3,0,8,31,2.6,1.2017092,4
2020-03-21-170401,170401,2,0,12,33,1.6,0.18236032,5
2020-03-22-170401,170401,13,0,5,46,1.6,0.8350874,6
2020-03-23-170401,170401,9,0,14,55,4.8,1.9521937,0
2020-03-24-170401,170401,12,0,7,67,5.6,2.4224224,1
2020-03-25-170401,170401,15,0,6,82,7.8,3.3001294,2
2020-03-26-170401,170401,16,0,7,98,6.2,2.0846884,3
2020-03-27-170401,170401,10,0,7,108,5.8,1.2412186,4
2020-03-28-170401,170401,6,0,4,114,2.6,0.6802979,5
2020-03-29-170401,170401,6,0,1,120,5.6,0.58688927,6
2020-03-30-170401,170401,12,0,8,132,4.6,1.4106965,0
2020-03-31-170401,170401,10,0,10,142,4.6,1.567236,1
2020-04-01-170401,170401,6,0,6,148,3.8,0.9089029,2
2020-04-02-170401,170401,9,0,7,157,3.2,1.0546333,3
2020-04-03-170401,170401,8,0,3,165,2.0,0.9120282,4
2020-04-04-170401,170401,12,0,2,177,2.8,0.7070694,5
2020-04-05-170401,170401,5,0,1,182,0.4,0.20560198,6
2020-04-06-170401,170401,14,5,4,196,2.4,1.2658131,0
2020-04-07-170401,170401,7,0,7,203,2.6,1.467899,1
2020-04-08-170401,170401,6,0,0,209,2.6,0.8301805,2
2020-04-09-170401,170401,7,0,3,216,5.2,0.739045,3
2020-04-10-170401,170401,7,0,2,223,0.6,0.34329417,4
2020-04-11-170401,170401,4,0,4,227,0.8,0.40320444,5
2020-04-12-170401,170401,1,0,2,228,0.4,0.11970312,6
2020-04-13-170401,170401,8,0,2,236,1.4,1.2988404,0
2020-04-14-170401,170401,10,0,3,246,2.4,0.58894646,1
2020-04-15-170401,170401,6,0,4,252,1.2,0.42338812,2
2020-04-16-170401,170401,7,0,3,259,1.0,0.44777653,3
2020-04-17-170401,170401,3,0,6,262,2.6,0.5969447,4
2020-04-18-170401,170401,2,0,3,264,0.2,0.11515639,5
2020-04-19-170401,170401,1,0,3,265,0.4,0.07793872,6
2020-04-20-170401,170401,4,0,5,269,1.8,0.4058885,0
2020-04-21-170401,170401,7,0,3,276,1.0,0.5373892,1
2020-04-22-170401,170401,0,0,5,276,2.6,0.6322457,2
2020-04-23-170401,170401,3,0,4,279,0.4,0.16294919,3
2020-04-24-170401,170401,2,0,2,281,2.6,0.508171,4
2020-04-25-170401,170401,4,0,5,285,0.2,0.20314781,5
2020-04-26-170401,170401,2,0,2,287,0.4,0.08919957,6
2020-04-27-170401,170401,2,1,4,289,1.2,0.18458709,0
2020-04-28-170401,170401,3,0,2,292,1.2,0.72947997,1
2020-04-29-170401,170401,4,0,4,296,1.8,0.2785715,2
2020-04-30-170401,170401,3,0,1,299,1.0,0.23771769,3
2020-05-01-170401,170401,6,0,6,305,0.4,0.3129585,4
2020-05-02-170401,170401,3,0,0,308,0.2,0.19043717,5
2020-05-03-170401,170401,3,0,2,311,0.4,0.13018952,6
2020-05-04-170401,170401,5,0,7,316,2.0,0.44972906,0
2020-05-05-170401,170401,3,0,3,319,1.0,0.70519185,1
2020-05-06-170401,170401,5,0,2,324,0.8,0.41518244,2
2020-05-07-170401,170401,4,0,0,328,0.4,0.29415426,3
2020-05-08-170401,170401,2,0,6,330,2.0,0.43319714,4
2020-05-09-170401,170401,5,0,0,335,1.2,0.30921164,5
2020-05-10-170401,170401,2,1,1,337,0.4,0.116809025,6
2020-05-11-170401,170401,4,1,2,341,1.0,0.5176672,0
2020-05-12-170401,170401,2,1,1,343,1.6,0.42442852,1
2020-05-13-170401,170401,4,0,10,347,0.8,0.34359425,2
2020-05-14-170401,170401,1,0,6,348,1.2,0.12830815,3
2020-05-15-170401,170401,6,0,4,354,1.4,0.5030726,4
2020-05-16-170401,170401,0,0,0,354,0.2,0.007387822,5
2020-05-17-170401,170401,2,0,0,356,0.0,0.121544786,6
2020-05-18-170401,170401,7,0,1,363,0.6,0.59041744,0
2020-05-19-170401,170401,3,0,5,366,0.6,0.2646773,1
2020-05-20-170401,170401,2,0,7,368,0.8,0.2037122,2
2020-05-21-170401,170401,0,0,1,368,1.0,0.089360945,3
2020-05-22-170401,170401,6,0,4,374,1.0,0.47712055,4
2020-05-23-170401,170401,0,0,0,374,0.4,0.014602139,5
2020-05-24-170401,170401,1,0,2,375,0.0,0.07118475,6
2020-05-25-170401,170401,2,0,7,377,0.2,0.45109737,0
2020-05-26-170401,170401,1,0,6,378,0.8,0.3847763,1
2020-05-27-170401,170401,10,0,3,388,0.6,1.0463032,2
2020-05-28-170401,170401,6,0,3,394,2.0,1.012834,3
2020-05-29-170401,170401,4,0,4,398,1.4,0.63442093,4
2020-05-30-170401,170401,0,0,0,398,0.0,0.006958781,5
2020-05-31-170401,170401,0,0,0,398,0.0,0.0008612015,6
2020-06-01-170401,170401,1,0,5,399,1.4,1.0931844,0
2020-06-02-170401,170401,5,0,3,404,1.2,0.4307685,1
2020-06-03-170401,170401,7,0,3,411,0.4,0.56346816,2
2020-06-04-170401,170401,1,0,0,412,1.0,0.1823093,3
2020-06-05-170401,170401,4,0,3,416,0.8,0.5510699,4
2020-06-06-170401,170401,0,0,1,416,0.0,0.00695934,5
2020-06-07-170401,170401,2,0,0,418,0.0,0.14735582,6
2020-06-08-170401,170401,7,0,2,425,0.8,0.57585335,0
2020-06-09-170401,170401,6,1,7,431,1.6,0.3844189,1
2020-06-10-170401,170401,3,0,2,434,0.4,0.54035556,2
2020-06-11-170401,170401,3,0,4,437,0.8,0.31302288,3
2020-06-12-170401,170401,4,0,2,441,0.4,0.49783623,4
2020-06-13-170401,170401,0,1,0,441,0.0,0.004194624,5
2020-06-14-170401,170401,0,0,1,441,0.0,0.001574809,6
2020-06-15-170401,170401,5,0,3,446,0.0,0.41650808,0
2020-06-16-170401,170401,3,1,3,449,1.4,0.28329077,1
2020-06-17-170401,170401,3,0,0,452,0.6,0.17690785,2
2020-06-18-170401,170401,0,0,1,452,0.2,0.02127272,3
2020-06-19-170401,170401,3,0,3,455,0.2,0.24946252,4
2020-06-20-170401,170401,1,0,1,456,0.0,0.078663714,5
2020-06-21-170401,170401,0,0,0,456,0.0,0.001486125,6
2020-06-22-170401,170401,2,0,0,458,0.2,0.17563345,0
2020-06-23-170401,170401,7,0,1,465,0.0,0.46790642,1
2020-06-24-170401,170401,2,0,1,467,0.2,0.20599194,2
2020-06-25-170401,170401,4,0,1,471,0.0,0.3822084,3
2020-06-26-170401,170401,2,0,2,473,0.2,0.1897994,4
2020-06-27-170401,170401,0,0,0,473,0.0,0.0067095896,5
2020-06-28-170401,170401,1,0,0,474,0.0,1.547185e-07,6
2020-06-29-170401,170401,3,0,1,477,0.2,0.30601773,0
2020-06-30-170401,170401,3,0,1,480,0.2,0.25594246,1
2020-07-01-170401,170401,0,0,3,480,0.2,0.035076723,2
2020-07-02-170401,170401,1,0,3,481,0.2,0.092893034,3
2020-07-03-170401,170401,3,0,2,484,0.2,0.24505526,4
2020-07-04-170401,170401,1,0,0,485,0.0,0.078941755,5
2020-07-05-170401,170401,0,0,1,485,0.2,0.0063379467,6
2020-07-06-170401,170401,0,0,4,485,0.0,0.01564223,0
2020-07-07-170401,170401,1,0,1,486,0.2,0.1019136,1
2020-07-08-170401,170401,1,1,3,487,0.4,0.10959056,2
2020-07-09-170401,170401,1,0,4,488,0.2,0.12998755,3
2020-07-10-170401,170401,2,0,2,490,0.0,0.113251,4
2020-07-11-170401,170401,0,0,3,490,0.0,0.00049587234,5
2020-07-12-170401,170401,0,0,0,490,0.0,0.0031288918,6
2020-07-13-170401,170401,1,0,0,491,0.4,0.21978739,0
2020-07-14-170401,170401,1,0,4,492,0.4,0.10099372,1
2020-07-15-170401,170401,3,0,4,495,0.4,0.24791099,2
2020-07-16-170401,170401,3,0,5,498,0.2,0.37290022,3
2020-07-17-170401,170401,2,0,2,500,0.0,0.20024653,4
2020-07-18-170401,170401,0,1,0,500,0.2,0.09825545,5
2020-07-19-170401,170401,1,0,2,501,0.0,0.029242793,6
2020-07-20-170401,170401,4,0,4,505,0.0,0.3948442,0
2020-07-21-170401,170401,1,0,5,506,0.0,0.11412313,1
2020-07-22-170401,170401,3,0,9,509,0.2,0.31687456,2
2020-07-23-170401,170401,4,0,3,513,0.0,0.38495308,3
2020-07-24-170401,170401,2,0,6,515,0.0,0.102764465,4
2020-07-25-170401,170401,3,0,0,518,0.0,0.22440076,5
2020-07-26-170401,170401,0,0,0,518,0.0,0.007604342,6
2020-07-27-170401,170401,0,0,4,518,0.0,0.015939005,0
2020-07-28-170401,170401,4,0,0,522,0.0,0.3301834,1
2020-07-29-170401,170401,4,0,4,526,0.0,0.37129584,2
2020-07-30-170401,170401,5,0,2,531,0.2,0.42390704,3
2020-07-31-170401,170401,2,0,0,533,0.2,0.17975436,4
2020-08-01-170401,170401,0,0,0,533,0.0,0.08343598,5
2020-08-02-170401,170401,2,0,0,535,0.2,0.224453,6
2020-08-03-170401,170401,4,0,1,539,0.0,0.3762141,0
2020-08-04-170401,170401,5,0,3,544,0.4,0.74574643,1
2020-08-05-170401,170401,9,0,3,553,0.2,1.0558535,2
2020-08-06-170401,170401,3,0,4,556,0.2,0.31133887,3
2020-08-07-170401,170401,6,0,1,562,0.6,0.59753776,4
2020-08-08-170401,170401,0,0,4,562,0.4,0.104566306,5
2020-08-09-170401,170401,0,0,1,562,0.0,0.018849432,6
2020-08-10-170401,170401,4,0,4,566,0.8,0.6803985,0
2020-08-11-170401,170401,0,0,4,566,1.0,0.045092575,1
2020-08-12-170401,170401,4,0,0,570,0.8,0.35909298,2
2020-08-13-170401,170401,2,0,3,572,1.0,0.25497636,3
2020-08-14-170401,170401,0,0,1,572,0.0,0.08161167,4
2020-08-15-170401,170401,0,0,2,572,0.2,0.09187431,5
2020-08-16-170401,170401,0,0,0,572,1.0,0.121921994,6
2020-08-17-170401,170401,1,0,6,573,0.4,0.114188135,0
2020-08-18-170401,170401,3,0,3,576,1.8,0.4622485,1
2020-08-19-170401,170401,3,0,1,579,0.6,0.38553897,2
2020-08-20-170401,170401,4,1,4,583,1.0,0.45023194,3
2020-08-21-170401,170401,1,0,3,584,0.2,0.1486364,4
2020-08-22-170401,170401,4,0,4,588,0.6,0.28671545,5
2020-08-23-170401,170401,1,0,6,589,0.0,0.09648496,6
2020-08-24-170401,170401,4,0,0,593,0.8,0.4507855,0
2020-08-25-170401,170401,4,0,0,597,1.0,0.49256152,1
2020-08-26-170401,170401,0,0,0,597,2.0,1.9706234,2
2020-08-27-170401,170401,3,0,2,600,1.0,0.7145103,3
2020-08-28-170401,170401,1,0,2,601,1.4,0.92320573,4
2020-08-29-170401,170401,2,0,1,603,1.0,0.5198471,5
2020-08-30-170401,170401,0,0,4,603,1.0,0.16761392,6
2020-08-31-170401,170401,6,0,0,609,0.6,0.5285241,0
2020-09-01-170401,170401,3,0,2,612,1.2,1.1713339,1
2020-09-02-170401,170401,1,1,2,613,0.8,0.21016337,2
2020-09-03-170401,170401,4,0,6,617,1.0,1.3893969,3
2020-09-04-170401,170401,3,0,4,620,1.2,0.74140364,4
2020-09-05-170401,170401,4,0,5,624,0.8,0.2608378,5
2020-09-06-170401,170401,6,0,1,630,1.0,0.5564924,6
2020-09-07-170401,170401,0,2,4,630,1.8,0.21508649,0
2020-09-08-170401,170401,0,0,3,630,0.6,0.122910514,1
2020-09-09-170401,170401,0,0,9,630,0.6,0.1624401,2
2020-09-10-170401,170401,2,0,2,632,1.4,0.30466127,3
2020-09-11-170401,170401,2,0,5,634,1.4,0.79867357,4
2020-09-12-170401,170401,1,0,0,635,0.2,0.118654475,5
2020-09-13-170401,170401,4,0,6,639,1.4,0.521578,6
2020-09-14-170401,170401,0,0,10,639,0.8,0.13595034,0
2020-09-15-170401,170401,2,0,8,641,1.4,0.80988866,1
2020-09-16-170401,170401,2,0,9,643,2.4,0.29379278,2
2020-09-17-170401,170401,6,0,11,649,2.2,0.6968581,3
2020-09-18-170401,170401,4,0,14,653,1.8,0.5863761,4
2020-09-19-170401,170401,5,0,6,658,1.2,0.4789938,5
2020-09-20-170401,170401,1,0,3,659,1.2,0.34224096,6
2020-09-21-170401,170401,4,0,7,663,1.8,0.6624359,0
2020-09-22-170401,170401,3,0,3,666,4.2,0.50233346,1
2020-09-23-170401,170401,9,0,4,675,2.0,0.90053535,2
2020-09-24-170401,170401,2,1,8,677,1.8,0.26997337,3
2020-09-25-170401,170401,5,1,6,682,4.0,0.58301866,4
2020-09-26-170401,170401,0,0,3,682,1.0,0.12532134,5
2020-09-27-170401,170401,6,0,3,688,2.2,0.5558557,6
2020-09-28-170401,170401,10,0,3,698,2.0,1.2300537,0
2020-09-29-170401,170401,8,0,9,706,1.4,0.7362547,1
2020-09-30-170401,170401,9,0,8,715,1.2,0.9801036,2
2020-10-01-170401,170401,11,0,7,726,4.0,1.2940664,3
2020-10-02-170401,170401,14,0,5,740,4.8,1.4968879,4
2020-10-03-170401,170401,6,1,6,746,2.6,1.0090809,5
2020-10-04-170401,170401,3,0,3,749,1.2,0.29813364,6
2020-10-05-170401,170401,7,0,1,756,5.0,0.999958,0
2020-10-06-170401,170401,3,1,2,759,2.4,0.6613427,1
2020-10-07-170401,170401,4,0,9,763,3.8,0.50526774,2
2020-10-08-170401,170401,8,2,3,771,3.0,0.8292939,3
2020-10-09-170401,170401,6,0,9,777,3.6,1.6619236,4
2020-10-10-170401,170401,3,0,3,780,2.6,0.39676473,5
2020-10-11-170401,170401,3,0,2,783,2.8,0.65359706,6
2020-10-12-170401,170401,3,0,7,786,2.6,0.5021422,0
2020-10-13-170401,170401,9,0,3,795,2.6,1.101065,1
2020-10-14-170401,170401,8,0,31,803,2.0,1.3919502,2
2020-10-15-170401,170401,7,0,23,810,1.6,1.1193775,3
2020-10-16-170401,170401,5,0,11,815,4.4,1.0857472,4
2020-10-17-170401,170401,6,0,4,821,3.2,0.79851025,5
2020-10-18-170401,170401,3,0,10,824,2.2,0.77144915,6
2020-10-19-170401,170401,1,0,6,825,4.2,0.6189414,0
2020-10-20-170401,170401,2,0,13,827,6.2,1.1487082,1
2020-10-21-170401,170401,9,0,15,836,5.2,1.4051417,2
2020-10-22-170401,170401,3,2,9,839,5.6,0.8609113,3
2020-10-23-170401,170401,9,1,12,848,8.2,1.3646965,4
2020-10-24-170401,170401,3,1,9,851,3.2,0.6120359,5
2020-10-25-170401,170401,2,0,10,853,1.8,0.17548689,6
2020-10-26-170401,170401,7,1,6,860,6.2,1.6097102,0
2020-10-27-170401,170401,3,1,16,863,8.4,1.3435822,1
2020-10-28-170401,170401,31,1,21,894,2.6,2.9716413,2
2020-10-29-170401,170401,23,0,7,917,8.2,3.8660038,3
2020-10-30-170401,170401,11,1,19,928,8.8,1.7898006,4
2020-10-31-170401,170401,4,1,0,932,4.2,1.390765,5
2020-11-01-170401,170401,10,2,0,942,3.8,0.85435426,6
2020-11-02-170401,170401,6,0,0,948,3.8,0.48988876,0
2020-11-03-170401,170401,13,1,0,961,6.6,2.841089,1
2020-11-04-170401,170401,15,0,0,976,6.4,1.9639947,2
2020-11-05-170401,170401,9,1,0,985,4.8,1.2473631,3
2020-11-06-170401,170401,12,4,0,997,7.6,1.2934613,4
2020-11-07-170401,170401,9,1,0,1006,4.2,1.4103842,5
2020-11-08-170401,170401,10,3,0,1016,1.6,0.66862476,6
2020-11-09-170401,170401,6,1,0,1022,4.2,1.0946747,0
2020-11-10-170401,170401,16,1,0,1038,3.0,1.562414,1
2020-11-11-170401,170401,21,4,0,1059,6.0,2.6525586,2
2020-11-12-170401,170401,7,0,0,1066,3.6,1.2859168,3
2020-11-13-170401,170401,19,1,0,1085,4.2,1.5919237,4
2020-03-01-170402,170402,0,0,0,0,0.0,5.1712993e-07,6
2020-03-02-170402,170402,0,0,0,0,0.0,0.0002561185,0
2020-03-03-170402,170402,0,0,0,0,0.0,1.4890913e-06,1
2020-03-04-170402,170402,0,0,4,0,0.0,0.0003995889,2
2020-03-05-170402,170402,0,0,4,0,0.0,1.21865025e-08,3
2020-03-06-170402,170402,0,0,3,0,0.0,0.008196695,4
2020-03-07-170402,170402,0,0,3,0,0.0,9.8584394e-05,5
2020-03-08-170402,170402,0,0,0,0,0.0,0.0002041469,6
2020-03-09-170402,170402,0,0,4,0,0.0,0.0012356048,0
2020-03-10-170402,170402,0,0,8,0,0.2857142857142857,0.006720005,1
2020-03-11-170402,170402,0,0,5,0,0.14285714285714285,0.00013609466,2
2020-03-12-170402,170402,0,0,4,0,0.7142857142857143,0.02856089,3
2020-03-13-170402,170402,0,0,5,0,0.42857142857142855,0.010844831,4
2020-03-14-170402,170402,0,0,1,0,0.14285714285714285,0.028484587,5
2020-03-15-170402,170402,0,0,1,0,0.5714285714285714,0.09719831,6
2020-03-16-170402,170402,0,0,5,0,3.2857142857142856,0.12086777,0
2020-03-17-170402,170402,0,1,0,0,2.7142857142857144,0.57229227,1
2020-03-18-170402,170402,4,0,0,4,5.7142857142857135,0.58413136,2
2020-03-19-170402,170402,4,0,5,8,6.571428571428571,0.7066152,3
2020-03-20-170402,170402,3,0,5,11,5.428571428571429,0.56942284,4
2020-03-21-170402,170402,3,0,3,14,2.7142857142857144,0.27745712,5
2020-03-22-170402,170402,0,0,1,14,3.1428571428571432,0.18011042,6
2020-03-23-170402,170402,4,0,3,18,6.7142857142857135,0.6237417,0
2020-03-24-170402,170402,8,0,2,26,7.428571428571429,0.69388634,1
2020-03-25-170402,170402,5,0,1,31,7.2857142857142865,1.0048524,2
2020-03-26-170402,170402,4,0,3,35,6.7142857142857135,0.55946535,3
2020-03-27-170402,170402,5,0,4,40,6.0,0.5484157,4
2020-03-28-170402,170402,1,0,1,41,3.1428571428571432,0.18287186,5
2020-03-29-170402,170402,1,0,1,42,2.8571428571428568,0.17440826,6
2020-03-30-170402,170402,5,0,1,47,4.285714285714286,0.32125276,0
2020-03-31-170402,170402,0,0,5,47,4.285714285714286,0.4150022,1
2020-04-01-170402,170402,0,0,2,47,3.1428571428571432,0.28218603,2
2020-04-02-170402,170402,5,0,3,52,4.428571428571429,0.40080503,3
2020-04-03-170402,170402,5,0,1,57,4.285714285714286,0.58350885,4
2020-04-04-170402,170402,3,0,2,60,1.7142857142857142,0.25681275,5
2020-04-05-170402,170402,1,0,3,61,1.0,0.035143223,6
2020-04-06-170402,170402,3,3,4,64,3.4285714285714284,0.48993546,0
2020-04-07-170402,170402,2,15,5,66,2.4285714285714284,0.34999844,1
2020-04-08-170402,170402,1,1,4,67,2.8571428571428568,0.25369397,2
2020-04-09-170402,170402,3,0,0,70,3.571428571428572,0.18557227,3
2020-04-10-170402,170402,4,0,1,74,2.8571428571428568,0.16351444,4
2020-04-11-170402,170402,1,0,2,75,1.5714285714285714,0.13553572,5
2020-04-12-170402,170402,1,0,0,76,0.5714285714285714,0.046724528,6
2020-04-13-170402,170402,1,0,3,77,3.2857142857142856,0.2685737,0
2020-04-14-170402,170402,5,0,1,82,2.7142857142857144,0.42145297,1
2020-04-15-170402,170402,2,0,5,84,1.4285714285714286,0.19067569,2
2020-04-16-170402,170402,3,0,2,87,1.8571428571428568,0.16414398,3
2020-04-17-170402,170402,1,0,1,88,2.142857142857143,0.13656224,4
2020-04-18-170402,170402,2,0,0,90,0.5714285714285714,0.059435036,5
2020-04-19-170402,170402,3,0,0,93,0.7142857142857143,0.13654682,6
2020-04-20-170402,170402,4,0,5,97,2.4285714285714284,0.28972727,0
2020-04-21-170402,170402,5,0,0,102,1.0,0.2613569,1
2020-04-22-170402,170402,4,0,0,106,2.0,0.383604,2
2020-04-23-170402,170402,0,0,1,106,2.571428571428572,0.09577214,3
2020-04-24-170402,170402,1,0,4,107,3.4285714285714284,0.25192758,4
2020-04-25-170402,170402,2,0,2,109,0.5714285714285714,0.11612684,5
2020-04-26-170402,170402,0,0,0,109,1.0,0.012910049,6
2020-04-27-170402,170402,3,0,0,112,3.0,0.26490796,0
2020-04-28-170402,170402,1,0,1,113,1.4285714285714286,0.15446231,1
2020-04-29-170402,170402,5,0,0,118,1.8571428571428568,0.21675132,2
2020-04-30-170402,170402,2,0,0,120,1.7142857142857142,0.22046027,3
2020-05-01-170402,170402,1,0,1,121,0.8571428571428571,0.039739262,4
2020-05-02-170402,170402,0,0,0,121,1.0,0.020279368,5
2020-05-03-170402,170402,0,1,0,121,0.5714285714285714,0.07759613,6
2020-05-04-170402,170402,5,0,1,126,1.7142857142857142,0.25040066,0
2020-05-05-170402,170402,0,0,0,126,1.5714285714285714,0.10197752,1
2020-05-06-170402,170402,0,0,0,126,1.8571428571428568,0.100467585,2
2020-05-07-170402,170402,1,0,0,127,0.7142857142857143,0.060636293,3
2020-05-08-170402,170402,4,0,1,131,0.8571428571428571,0.2836666,4
2020-05-09-170402,170402,2,0,0,133,0.5714285714285714,0.17229883,5
2020-05-10-170402,170402,0,0,0,133,0.2857142857142857,0.11977727,6
2020-05-11-170402,170402,0,1,0,133,1.7142857142857142,0.17695576,0
2020-05-12-170402,170402,1,0,1,134,1.7142857142857142,0.13365938,1
2020-05-13-170402,170402,0,0,1,134,1.2857142857142858,0.046547875,2
2020-05-14-170402,170402,0,0,0,134,0.8571428571428571,0.04037505,3
2020-05-15-170402,170402,1,0,1,135,2.0,0.12425003,4
2020-05-16-170402,170402,0,0,0,135,0.14285714285714285,0.0016267875,5
2020-05-17-170402,170402,0,0,0,135,0.5714285714285714,0.0077621737,6
2020-05-18-170402,170402,1,0,0,136,1.1428571428571428,0.12846756,0
2020-05-19-170402,170402,0,0,0,136,0.7142857142857143,0.045396842,1
2020-05-20-170402,170402,0,1,0,136,0.7142857142857143,0.12413597,2
2020-05-21-170402,170402,0,0,0,136,1.0,0.13532193,3
2020-05-22-170402,170402,1,0,0,137,2.0,0.3494841,4
2020-05-23-170402,170402,0,0,0,137,0.0,0.013629153,5
2020-05-24-170402,170402,0,0,0,137,0.0,0.0016511157,6
2020-05-25-170402,170402,0,0,0,137,0.8571428571428571,0.35741028,0
2020-05-26-170402,170402,1,0,0,138,1.4285714285714286,0.16553946,1
2020-05-27-170402,170402,1,0,0,139,1.0,0.13343507,2
2020-05-28-170402,170402,0,0,0,139,0.7142857142857143,0.13898009,3
2020-05-29-170402,170402,1,0,1,140,0.7142857142857143,0.10420703,4
2020-05-30-170402,170402,0,0,0,140,0.2857142857142857,0.095571324,5
2020-05-31-170402,170402,0,1,0,140,0.0,0.0010984878,6
2020-06-01-170402,170402,0,0,0,140,0.2857142857142857,0.16821674,0
2020-06-02-170402,170402,0,0,0,140,0.7142857142857143,0.14344476,1
2020-06-03-170402,170402,0,0,1,140,0.5714285714285714,0.044650763,2
2020-06-04-170402,170402,0,0,0,140,0.5714285714285714,0.030277954,3
2020-06-05-170402,170402,0,2,0,140,0.42857142857142855,0.16875213,4
2020-06-06-170402,170402,0,0,0,140,0.42857142857142855,0.009736333,5
2020-06-07-170402,170402,0,0,0,140,0.2857142857142857,0.014764495,6
2020-06-08-170402,170402,0,1,0,140,0.14285714285714285,0.03227108,0
2020-06-09-170402,170402,0,0,0,140,1.4285714285714286,0.08601405,1
2020-06-10-170402,170402,0,0,1,140,1.1428571428571428,0.09656747,2
2020-06-11-170402,170402,0,0,0,140,0.42857142857142855,0.1262962,3
2020-06-12-170402,170402,1,0,0,141,0.42857142857142855,0.08844844,4
2020-06-13-170402,170402,0,0,0,141,0.14285714285714285,0.0041296924,5
2020-06-14-170402,170402,0,0,0,141,0.14285714285714285,0.003494113,6
2020-06-15-170402,170402,0,3,0,141,1.2857142857142858,0.05268413,0
2020-06-16-170402,170402,0,0,0,141,0.5714285714285714,0.06880031,1
2020-06-17-170402,170402,1,0,0,142,0.8571428571428571,0.08303819,2
2020-06-18-170402,170402,0,0,0,142,0.7142857142857143,0.020583108,3
2020-06-19-170402,170402,0,0,0,142,0.2857142857142857,0.01613068,4
2020-06-20-170402,170402,0,0,0,142,0.2857142857142857,0.017016424,5
2020-06-21-170402,170402,0,0,0,142,0.14285714285714285,0.0033440583,6
2020-06-22-170402,170402,0,0,0,142,1.1428571428571428,0.047922786,0
2020-06-23-170402,170402,0,0,0,142,0.2857142857142857,0.030354727,1
2020-06-24-170402,170402,1,0,0,143,1.2857142857142858,0.080638915,2
2020-06-25-170402,170402,0,0,0,143,0.0,0.015005174,3
2020-06-26-170402,170402,0,0,0,143,0.14285714285714285,0.016019674,4
2020-06-27-170402,170402,0,0,0,143,0.14285714285714285,0.004884885,5
2020-06-28-170402,170402,0,0,0,143,0.0,3.4743703e-06,6
2020-06-29-170402,170402,0,0,1,143,1.2857142857142858,0.06066846,0
2020-06-30-170402,170402,0,0,0,143,0.5714285714285714,0.031013824,1
2020-07-01-170402,170402,0,0,0,143,1.7142857142857142,0.16658589,2
2020-07-02-170402,170402,0,0,1,143,0.2857142857142857,0.022419548,3
2020-07-03-170402,170402,0,0,0,143,0.0,0.008913096,4
2020-07-04-170402,170402,0,0,0,143,0.14285714285714285,0.013109478,5
2020-07-05-170402,170402,0,0,0,143,0.0,0.0058817444,6
2020-07-06-170402,170402,0,0,0,143,0.7142857142857143,0.023665894,0
2020-07-07-170402,170402,0,0,4,143,0.42857142857142855,0.123902,1
2020-07-08-170402,170402,0,0,0,143,0.42857142857142855,0.12243456,2
2020-07-09-170402,170402,0,0,0,143,0.42857142857142855,0.03095727,3
2020-07-10-170402,170402,0,0,0,143,0.8571428571428571,0.13311552,4
2020-07-11-170402,170402,0,0,0,143,0.0,0.0005804115,5
2020-07-12-170402,170402,0,0,0,143,0.0,0.00014766748,6
2020-07-13-170402,170402,1,0,0,144,0.8571428571428571,0.098098904,0
2020-07-14-170402,170402,0,0,1,144,0.2857142857142857,0.121272095,1
2020-07-15-170402,170402,0,0,0,144,0.7142857142857143,0.032063648,2
2020-07-16-170402,170402,1,0,0,145,0.42857142857142855,0.17201442,3
2020-07-17-170402,170402,0,0,0,145,0.0,0.00832553,4
2020-07-18-170402,170402,0,0,0,145,0.14285714285714285,0.109521486,5
2020-07-19-170402,170402,0,0,0,145,0.5714285714285714,0.41723683,6
2020-07-20-170402,170402,0,0,0,145,0.5714285714285714,0.13950564,0
2020-07-21-170402,170402,4,0,0,149,1.0,0.26213193,1
2020-07-22-170402,170402,0,0,0,149,0.7142857142857143,0.0511537,2
2020-07-23-170402,170402,0,0,0,149,0.7142857142857143,0.233679,3
2020-07-24-170402,170402,0,0,0,149,0.2857142857142857,0.01658688,4
2020-07-25-170402,170402,0,0,0,149,0.14285714285714285,0.010469131,5
2020-07-26-170402,170402,0,0,0,149,0.14285714285714285,0.011642269,6
2020-07-27-170402,170402,0,0,0,149,0.7142857142857143,0.022782525,0
2020-07-28-170402,170402,1,0,1,150,0.42857142857142855,0.15280813,1
2020-07-29-170402,170402,0,0,0,150,1.0,0.038472973,2
2020-07-30-170402,170402,0,0,0,150,0.7142857142857143,0.042056084,3
2020-07-31-170402,170402,0,0,4,150,0.5714285714285714,0.025448853,4
2020-08-01-170402,170402,0,0,0,150,0.0,0.0047443304,5
2020-08-02-170402,170402,0,0,0,150,0.0,0.0094319,6
2020-08-03-170402,170402,0,0,0,150,1.1428571428571428,0.057827,0
2020-08-04-170402,170402,0,0,1,150,0.7142857142857143,0.06948258,1
2020-08-05-170402,170402,0,0,0,150,1.0,0.10856274,2
2020-08-06-170402,170402,0,0,0,150,0.8571428571428571,0.15450186,3
2020-08-07-170402,170402,0,0,0,150,1.4285714285714286,0.3802766,4
2020-08-08-170402,170402,0,0,2,150,0.14285714285714285,0.018116511,5
2020-08-09-170402,170402,0,0,0,150,0.5714285714285714,0.050140947,6
2020-08-10-170402,170402,0,0,0,150,1.7142857142857142,0.2205356,0
2020-08-11-170402,170402,1,0,1,151,1.0,0.18525267,1
2020-08-12-170402,170402,0,0,0,151,1.2857142857142858,0.15767878,2
2020-08-13-170402,170402,0,0,5,151,1.1428571428571428,0.061007716,3
2020-08-14-170402,170402,4,0,2,155,0.5714285714285714,0.27561155,4
2020-08-15-170402,170402,0,0,2,155,0.42857142857142855,0.21467702,5
2020-08-16-170402,170402,0,0,0,155,0.14285714285714285,0.024534129,6
2020-08-17-170402,170402,0,0,0,155,1.0,0.047760077,0
2020-08-18-170402,170402,1,0,2,156,1.2857142857142858,0.27697873,1
2020-08-19-170402,170402,0,0,1,156,1.1428571428571428,0.06505489,2
2020-08-20-170402,170402,0,0,0,156,0.5714285714285714,0.0817154,3
2020-08-21-170402,170402,0,0,0,156,1.0,0.14336899,4
2020-08-22-170402,170402,2,0,0,158,0.42857142857142855,0.115720704,5
2020-08-23-170402,170402,0,0,1,158,0.0,0.005428389,6
2020-08-24-170402,170402,0,0,0,158,1.7142857142857142,0.07585228,0
2020-08-25-170402,170402,1,0,0,159,1.0,0.13328406,1
2020-08-26-170402,170402,0,0,1,159,1.1428571428571428,0.32257193,2
2020-08-27-170402,170402,5,0,1,164,1.0,0.27530578,3
2020-08-28-170402,170402,2,1,1,166,1.4285714285714286,0.39939114,4
2020-08-29-170402,170402,2,0,1,168,0.42857142857142855,0.13742013,5
2020-08-30-170402,170402,0,0,0,168,0.14285714285714285,0.041510444,6
2020-08-31-170402,170402,0,0,0,168,0.2857142857142857,0.049510088,0
2020-09-01-170402,170402,2,0,3,170,1.2857142857142858,0.23727807,1
2020-09-02-170402,170402,1,0,4,171,0.5714285714285714,0.086302735,2
2020-09-03-170402,170402,0,0,3,171,0.5714285714285714,0.28413847,3
2020-09-04-170402,170402,0,0,4,171,1.0,0.48385486,4
2020-09-05-170402,170402,0,0,0,171,0.8571428571428571,0.15052284,5
2020-09-06-170402,170402,1,0,0,172,0.7142857142857143,0.17672619,6
2020-09-07-170402,170402,0,0,2,172,0.8571428571428571,0.078159906,0
2020-09-08-170402,170402,0,0,2,172,0.8571428571428571,0.44852933,1
2020-09-09-170402,170402,1,0,3,173,0.7142857142857143,0.2703523,2
2020-09-10-170402,170402,1,0,3,174,1.4285714285714286,0.19551049,3
2020-09-11-170402,170402,1,0,4,175,2.0,0.21296841,4
2020-09-12-170402,170402,1,0,0,176,1.5714285714285714,0.25302264,5
2020-09-13-170402,170402,0,0,1,176,0.7142857142857143,0.049652617,6
2020-09-14-170402,170402,0,0,6,176,1.1428571428571428,0.073606625,0
2020-09-15-170402,170402,3,0,0,179,2.142857142857143,0.5676619,1
2020-09-16-170402,170402,4,0,3,183,3.0,0.15160492,2
2020-09-17-170402,170402,3,0,2,186,3.2857142857142856,0.5807295,3
2020-09-18-170402,170402,4,0,3,190,3.2857142857142856,0.43958777,4
2020-09-19-170402,170402,0,0,0,190,1.7142857142857142,0.09191663,5
2020-09-20-170402,170402,0,2,0,190,0.42857142857142855,0.054780923,6
2020-09-21-170402,170402,2,0,2,192,3.8571428571428568,0.51562107,0
2020-09-22-170402,170402,2,0,1,194,5.285714285714286,0.72626543,1
2020-09-23-170402,170402,3,2,3,197,3.2857142857142856,0.30767962,2
2020-09-24-170402,170402,3,0,0,200,3.8571428571428568,0.55789906,3
2020-09-25-170402,170402,4,0,4,204,2.4285714285714284,0.5674256,4
2020-09-26-170402,170402,0,0,37,204,0.8571428571428571,0.046858303,5
2020-09-27-170402,170402,1,0,3,205,0.8571428571428571,0.16974397,6
2020-09-28-170402,170402,6,0,6,211,3.8571428571428568,0.41651714,0
2020-09-29-170402,170402,0,0,2,211,3.4285714285714284,0.39352906,1
2020-09-30-170402,170402,3,0,1,214,2.142857142857143,0.3401712,2
2020-10-01-170402,170402,2,0,2,216,5.285714285714286,0.5047209,3
2020-10-02-170402,170402,3,0,1,219,3.2857142857142856,0.36786714,4
2020-10-03-170402,170402,0,0,0,219,0.7142857142857143,0.114500344,5
2020-10-04-170402,170402,0,0,3,219,2.4285714285714284,0.12859914,6
2020-10-05-170402,170402,2,0,2,221,3.7142857142857135,0.34073305,0
2020-10-06-170402,170402,1,1,5,222,2.8571428571428568,0.2230114,1
2020-10-07-170402,170402,3,1,8,225,4.0,0.34909746,2
2020-10-08-170402,170402,0,3,5,225,4.571428571428571,0.27257058,3
2020-10-09-170402,170402,4,2,10,229,4.0,0.4632219,4
2020-10-10-170402,170402,37,0,2,266,3.0,1.2547958,5
2020-10-11-170402,170402,3,0,4,269,3.571428571428572,0.49297088,6
2020-10-12-170402,170402,6,0,3,275,5.142857142857143,0.39474565,0
2020-10-13-170402,170402,2,0,3,277,3.4285714285714284,0.3853301,1
2020-10-14-170402,170402,1,0,2,278,4.285714285714286,0.29463574,2
2020-10-15-170402,170402,2,0,1,280,3.0,0.27355242,3
2020-10-16-170402,170402,1,0,6,281,8.714285714285714,0.5299194,4
2020-10-17-170402,170402,0,0,40,281,6.142857142857142,0.3333248,5
2020-10-18-170402,170402,3,0,9,284,4.142857142857143,0.2528932,6
2020-10-19-170402,170402,2,0,2,286,3.0,0.35007012,0
2020-10-20-170402,170402,5,0,9,291,6.857142857142858,0.6502067,1
2020-10-21-170402,170402,8,1,7,299,5.7142857142857135,0.73455614,2
2020-10-22-170402,170402,5,1,6,304,9.142857142857142,0.8758665,3
2020-10-23-170402,170402,10,0,15,314,9.428571428571429,0.7927845,4
2020-10-24-170402,170402,2,4,2,316,4.428571428571429,0.30301765,5
2020-10-25-170402,170402,4,3,8,320,2.571428571428572,0.17153728,6
2020-10-26-170402,170402,3,0,7,323,4.285714285714286,0.52346903,0
2020-10-27-170402,170402,3,0,8,326,5.857142857142858,0.8146804,1
2020-10-28-170402,170402,2,1,9,328,6.142857142857142,0.6908742,2
2020-10-29-170402,170402,1,1,4,329,8.0,0.82831967,3
2020-10-30-170402,170402,6,0,7,335,10.857142857142858,1.6530002,4
2020-10-31-170402,170402,40,0,0,375,4.571428571428571,1.80495,5
2020-11-01-170402,170402,9,1,0,384,5.142857142857143,0.45443267,6
2020-11-02-170402,170402,2,1,0,386,3.7142857142857135,0.5001095,0
2020-11-03-170402,170402,9,0,0,395,5.857142857142858,1.0607036,1
2020-11-04-170402,170402,7,2,0,402,8.714285714285714,1.2203084,2
2020-11-05-170402,170402,6,3,0,408,7.0,1.5344323,3
2020-11-06-170402,170402,15,2,0,423,10.857142857142858,1.1628467,4
2020-11-07-170402,170402,2,0,0,425,3.8571428571428568,0.612708,5
2020-11-08-170402,170402,8,1,0,433,3.2857142857142856,0.37872073,6
2020-11-09-170402,170402,7,2,0,440,7.571428571428571,1.4545414,0
2020-11-10-170402,170402,8,2,0,448,5.571428571428571,0.7957277,1
2020-11-11-170402,170402,9,2,0,457,10.285714285714286,1.8803935,2
2020-11-12-170402,170402,4,2,0,461,6.142857142857142,1.0232905,3
2020-11-13-170402,170402,7,1,0,468,5.285714285714286,0.9341181,4
2020-03-01-170403,170403,0,0,0,0,0.0,2.741359e-05,6
2020-03-02-170403,170403,0,0,0,0,0.0,0.00036483406,0
2020-03-03-170403,170403,0,0,0,0,0.0,0.0,1
2020-03-04-170403,170403,0,0,1,0,0.0,2.631969e-07,2
2020-03-05-170403,170403,0,0,1,0,0.0,1.5943823e-13,3
2020-03-06-170403,170403,0,0,0,0,0.0,0.0014064492,4
2020-03-07-170403,170403,0,0,0,0,0.0,4.8810205e-07,5
2020-03-08-170403,170403,0,0,1,0,0.0,1.7826353e-05,6
2020-03-09-170403,170403,0,0,0,0,0.0,0.00081717694,0
2020-03-10-170403,170403,0,0,1,0,0.25,0.0012838426,1
2020-03-11-170403,170403,0,0,0,0,0.25,0.00010575881,2
2020-03-12-170403,170403,0,0,2,0,0.75,0.0060586534,3
2020-03-13-170403,170403,0,0,0,0,0.25,0.004740842,4
2020-03-14-170403,170403,0,0,0,0,0.25,0.012275436,5
2020-03-15-170403,170403,0,0,0,0,0.75,0.013961981,6
2020-03-16-170403,170403,0,0,0,0,2.75,0.032347076,0
2020-03-17-170403,170403,0,0,1,0,2.75,0.1330487,1
2020-03-18-170403,170403,1,0,0,1,5.5,0.15286806,2
2020-03-19-170403,170403,1,0,0,2,7.5,0.21948443,3
2020-03-20-170403,170403,0,0,0,2,5.75,0.10008754,4
2020-03-21-170403,170403,0,0,1,2,3.75,0.064751185,5
2020-03-22-170403,170403,1,2,0,3,2.5,0.054122023,6
2020-03-23-170403,170403,0,0,1,3,5.5,0.14981882,0
2020-03-24-170403,170403,1,0,1,4,9.75,0.22809975,1
2020-03-25-170403,170403,0,1,1,4,8.5,0.24452463,2
2020-03-26-170403,170403,2,0,2,6,3.75,0.19002917,3
2020-03-27-170403,170403,0,0,1,6,4.0,0.108435504,4
2020-03-28-170403,170403,0,0,2,6,2.0,0.037305113,5
2020-03-29-170403,170403,0,0,0,6,0.75,0.04406016,6
2020-03-30-170403,170403,0,0,2,6,4.5,0.09249877,0
2020-03-31-170403,170403,1,0,3,7,2.5,0.113749035,1
2020-04-01-170403,170403,0,0,0,7,2.5,0.07005019,2
2020-04-02-170403,170403,0,0,2,7,4.75,0.11461902,3
2020-04-03-170403,170403,0,0,0,7,5.5,0.09686983,4
2020-04-04-170403,170403,1,0,1,8,1.5,0.08508371,5
2020-04-05-170403,170403,0,0,0,8,1.25,0.00930398,6
2020-04-06-170403,170403,1,1,0,9,4.5,0.121362984,0
2020-04-07-170403,170403,1,0,2,10,2.5,0.08080572,1
2020-04-08-170403,170403,1,3,0,11,2.5,0.07916459,2
2020-04-09-170403,170403,2,0,14,13,2.75,0.07383616,3
2020-04-10-170403,170403,1,0,5,14,3.25,0.047619477,4
2020-04-11-170403,170403,2,0,0,16,1.25,0.058623627,5
2020-04-12-170403,170403,0,0,0,16,0.5,0.023933634,6
2020-04-13-170403,170403,2,0,6,18,2.0,0.10061158,0
2020-04-14-170403,170403,3,0,1,21,3.0,0.15533815,1
2020-04-15-170403,170403,0,0,1,21,1.0,0.03815169,2
2020-04-16-170403,170403,2,0,5,23,3.0,0.07443403,3
2020-04-17-170403,170403,0,0,0,23,2.0,0.031315524,4
2020-04-18-170403,170403,1,0,0,24,0.75,0.03270264,5
2020-04-19-170403,170403,0,0,0,24,1.0,0.023071343,6
2020-04-20-170403,170403,0,0,0,24,3.0,0.060763784,0
2020-04-21-170403,170403,2,0,1,26,2.0,0.097215466,1
2020-04-22-170403,170403,0,0,7,26,3.0,0.07621746,2
2020-04-23-170403,170403,14,0,1,40,0.25,0.25041208,3
2020-04-24-170403,170403,5,0,0,45,2.0,0.15494302,4
2020-04-25-170403,170403,0,0,0,45,1.25,0.029631907,5
2020-04-26-170403,170403,0,0,0,45,1.0,0.004518424,6
2020-04-27-170403,170403,6,0,2,51,2.25,0.17301258,0
2020-04-28-170403,170403,1,0,2,52,0.75,0.056480214,1
2020-04-29-170403,170403,1,0,0,53,2.5,0.08783814,2
2020-04-30-170403,170403,5,1,0,58,1.5,0.17559832,3
2020-05-01-170403,170403,0,0,1,58,0.75,0.014071172,4
2020-05-02-170403,170403,0,0,0,58,0.5,0.0052599027,5
2020-05-03-170403,170403,0,0,0,58,0.25,0.015432451,6
2020-05-04-170403,170403,0,0,1,58,2.25,0.056225285,0
2020-05-05-170403,170403,1,0,0,59,0.75,0.053732593,1
2020-05-06-170403,170403,7,0,0,66,1.0,0.17896035,2
2020-05-07-170403,170403,1,0,0,67,1.0,0.034920044,3
2020-05-08-170403,170403,0,0,1,67,1.75,0.0843804,4
2020-05-09-170403,170403,0,0,0,67,0.75,0.03289359,5
2020-05-10-170403,170403,0,1,0,67,0.25,0.023575077,6
2020-05-11-170403,170403,2,0,1,69,0.5,0.07544984,0
2020-05-12-170403,170403,2,0,1,71,1.5,0.072432,1
2020-05-13-170403,170403,0,2,1,71,0.5,0.0147665255,2
2020-05-14-170403,170403,0,0,0,71,0.0,0.01182241,3
2020-05-15-170403,170403,1,0,1,72,1.75,0.05810973,4
2020-05-16-170403,170403,0,0,0,72,0.0,0.0003802077,5
2020-05-17-170403,170403,0,0,0,72,0.75,0.0036549745,6
2020-05-18-170403,170403,1,0,0,73,0.5,0.057247076,0
2020-05-19-170403,170403,0,0,0,73,0.5,0.013215888,1
2020-05-20-170403,170403,0,0,0,73,1.0,0.043815076,2
2020-05-21-170403,170403,0,0,0,73,1.5,0.045727722,3
2020-05-22-170403,170403,1,0,0,74,1.25,0.090156995,4
2020-05-23-170403,170403,0,0,0,74,0.0,0.0021723746,5
2020-05-24-170403,170403,0,0,0,74,0.0,0.0015150064,6
2020-05-25-170403,170403,1,0,0,75,1.0,0.07042917,0
2020-05-26-170403,170403,1,0,0,76,0.75,0.05987071,1
2020-05-27-170403,170403,1,0,2,77,0.75,0.04114721,2
2020-05-28-170403,170403,0,0,0,77,0.75,0.045764085,3
2020-05-29-170403,170403,1,1,0,78,0.75,0.056854263,4
2020-05-30-170403,170403,0,0,0,78,0.5,0.012910321,5
2020-05-31-170403,170403,0,0,0,78,0.0,0.00019900093,6
2020-06-01-170403,170403,0,0,1,78,0.25,0.038254,0
2020-06-02-170403,170403,0,0,0,78,0.75,0.055591486,1
2020-06-03-170403,170403,0,0,0,78,0.0,0.022849107,2
2020-06-04-170403,170403,0,0,0,78,0.25,0.0155954985,3
2020-06-05-170403,170403,0,0,0,78,0.5,0.037093863,4
2020-06-06-170403,170403,0,0,0,78,0.0,0.0023415983,5
2020-06-07-170403,170403,0,0,0,78,0.25,0.0062013986,6
2020-06-08-170403,170403,0,0,1,78,0.0,0.016896795,0
2020-06-09-170403,170403,0,0,0,78,0.5,0.022891406,1
2020-06-10-170403,170403,2,0,0,80,0.0,0.105546676,2
2020-06-11-170403,170403,0,0,0,80,0.25,0.025805093,3
2020-06-12-170403,170403,0,0,0,80,0.5,0.022749724,4
2020-06-13-170403,170403,0,0,0,80,0.0,0.0009803134,5
2020-06-14-170403,170403,0,0,0,80,0.25,0.0007175025,6
2020-06-15-170403,170403,1,0,2,81,0.5,0.040963046,0
2020-06-16-170403,170403,0,0,0,81,0.0,0.020287123,1
2020-06-17-170403,170403,0,0,2,81,0.75,0.021595031,2
2020-06-18-170403,170403,0,0,0,81,0.5,0.0047518765,3
2020-06-19-170403,170403,0,0,0,81,0.0,0.0103336675,4
2020-06-20-170403,170403,0,0,1,81,0.0,0.00503184,5
2020-06-21-170403,170403,0,0,0,81,0.25,0.00075994566,6
2020-06-22-170403,170403,1,0,1,82,0.75,0.036856513,0
2020-06-23-170403,170403,0,0,0,82,0.5,0.017978488,1
2020-06-24-170403,170403,0,0,0,82,0.75,0.021769999,2
2020-06-25-170403,170403,0,0,1,82,0.0,0.008694269,3
2020-06-26-170403,170403,0,0,0,82,0.0,0.0071166065,4
2020-06-27-170403,170403,0,0,0,82,0.0,0.0011841928,5
2020-06-28-170403,170403,0,0,0,82,0.0,4.7069495e-08,6
2020-06-29-170403,170403,2,0,3,84,0.75,0.06832574,0
2020-06-30-170403,170403,0,0,0,84,1.0,0.011180648,1
2020-07-01-170403,170403,2,0,1,86,0.25,0.08319474,2
2020-07-02-170403,170403,0,0,0,86,0.25,0.0059428513,3
2020-07-03-170403,170403,0,0,0,86,0.0,0.0074929902,4
2020-07-04-170403,170403,1,0,0,87,0.0,0.033610456,5
2020-07-05-170403,170403,0,0,0,87,0.0,0.0017565463,6
2020-07-06-170403,170403,1,0,0,88,0.5,0.029720787,0
2020-07-07-170403,170403,0,0,0,88,0.5,0.020853173,1
2020-07-08-170403,170403,0,0,0,88,0.5,0.023386797,2
2020-07-09-170403,170403,1,0,0,89,0.25,0.034057997,3
2020-07-10-170403,170403,0,0,0,89,0.75,0.022607554,4
2020-07-11-170403,170403,0,0,0,89,0.0,6.401845e-05,5
2020-07-12-170403,170403,0,0,1,89,0.0,0.00022499236,6
2020-07-13-170403,170403,3,0,0,92,0.5,0.105825685,0
2020-07-14-170403,170403,0,0,0,92,0.5,0.019924097,1
2020-07-15-170403,170403,1,0,0,93,0.75,0.03618416,2
2020-07-16-170403,170403,0,0,0,93,0.75,0.040001366,3
2020-07-17-170403,170403,0,0,0,93,0.0,0.010565229,4
2020-07-18-170403,170403,0,0,0,93,0.25,0.024270512,5
2020-07-19-170403,170403,0,0,0,93,1.0,0.049763877,6
2020-07-20-170403,170403,0,0,1,93,1.0,0.026091693,0
2020-07-21-170403,170403,0,0,0,93,2.25,0.047621913,1
2020-07-22-170403,170403,0,0,1,93,0.0,0.018040728,2
2020-07-23-170403,170403,0,0,0,93,1.25,0.044454854,3
2020-07-24-170403,170403,0,0,0,93,0.5,0.0063323467,4
2020-07-25-170403,170403,0,0,0,93,0.0,0.0069220145,5
2020-07-26-170403,170403,1,0,0,94,0.0,0.02866404,6
2020-07-27-170403,170403,0,0,2,94,0.75,0.005117938,0
2020-07-28-170403,170403,0,0,1,94,0.5,0.031541158,1
2020-07-29-170403,170403,0,0,2,94,0.75,0.015752533,2
2020-07-30-170403,170403,0,0,0,94,0.25,0.024321977,3
2020-07-31-170403,170403,0,0,0,94,0.25,0.0076628495,4
2020-08-01-170403,170403,0,0,0,94,0.0,0.0074362555,5
2020-08-02-170403,170403,0,0,0,94,0.0,0.014684828,6
2020-08-03-170403,170403,1,0,1,95,0.25,0.025101205,0
2020-08-04-170403,170403,0,0,0,95,0.75,0.026164273,1
2020-08-05-170403,170403,1,0,1,96,0.75,0.06459559,2
2020-08-06-170403,170403,0,0,0,96,1.0,0.030715832,3
2020-08-07-170403,170403,0,1,0,96,1.75,0.07836907,4
2020-08-08-170403,170403,0,0,0,96,0.0,0.009801114,5
2020-08-09-170403,170403,0,0,0,96,0.5,0.008281634,6
2020-08-10-170403,170403,2,0,1,98,0.75,0.10823132,0
2020-08-11-170403,170403,1,0,1,99,0.5,0.059473444,1
2020-08-12-170403,170403,2,0,0,101,0.5,0.09722521,2
2020-08-13-170403,170403,0,0,1,101,0.75,0.020056253,3
2020-08-14-170403,170403,0,0,1,101,1.75,0.05700378,4
2020-08-15-170403,170403,0,0,0,101,0.5,0.048269805,5
2020-08-16-170403,170403,0,0,0,101,0.0,0.010712163,6
2020-08-17-170403,170403,1,0,0,102,0.25,0.034516204,0
2020-08-18-170403,170403,0,0,0,102,1.0,0.07108789,1
2020-08-19-170403,170403,1,0,1,103,0.0,0.051719673,2
2020-08-20-170403,170403,0,0,0,103,0.75,0.031509463,3
2020-08-21-170403,170403,0,0,0,103,0.5,0.033114105,4
2020-08-22-170403,170403,0,0,0,103,0.75,0.035292335,5
2020-08-23-170403,170403,0,0,0,103,0.0,0.0053060786,6
2020-08-24-170403,170403,1,0,0,104,0.75,0.07235622,0
2020-08-25-170403,170403,1,0,0,105,0.75,0.06988049,1
2020-08-26-170403,170403,0,1,0,105,0.25,0.0837443,2
2020-08-27-170403,170403,1,0,0,106,1.5,0.09379884,3
2020-08-28-170403,170403,1,0,0,107,0.75,0.13350926,4
2020-08-29-170403,170403,0,0,0,107,0.75,0.038820904,5
2020-08-30-170403,170403,0,0,0,107,0.0,0.01635779,6
2020-08-31-170403,170403,0,0,0,107,0.0,0.02326556,0
2020-09-01-170403,170403,0,0,0,107,1.0,0.060059983,1
2020-09-02-170403,170403,1,0,1,108,1.0,0.0479758,2
2020-09-03-170403,170403,0,0,0,108,0.0,0.053292338,3
2020-09-04-170403,170403,0,0,1,108,1.75,0.098570205,4
2020-09-05-170403,170403,0,0,0,108,1.0,0.033868168,5
2020-09-06-170403,170403,0,1,0,108,1.0,0.04667626,6
2020-09-07-170403,170403,0,0,3,108,0.75,0.024125146,0
2020-09-08-170403,170403,0,0,3,108,1.5,0.08736628,1
2020-09-09-170403,170403,0,0,0,108,1.25,0.055800546,2
2020-09-10-170403,170403,0,0,0,108,2.0,0.051479794,3
2020-09-11-170403,170403,0,0,1,108,3.0,0.050400488,4
2020-09-12-170403,170403,0,0,2,108,1.5,0.056817353,5
2020-09-13-170403,170403,0,0,0,108,0.25,0.051284343,6
2020-09-14-170403,170403,0,0,0,108,1.75,0.01910053,0
2020-09-15-170403,170403,0,0,1,108,3.25,0.12454618,1
2020-09-16-170403,170403,1,0,0,109,2.75,0.12677707,2
2020-09-17-170403,170403,0,0,4,109,4.75,0.1015452,3
2020-09-18-170403,170403,1,0,4,110,4.0,0.13283798,4
2020-09-19-170403,170403,0,1,0,110,1.75,0.08231483,5
2020-09-20-170403,170403,0,0,0,110,0.5,0.052914925,6
2020-09-21-170403,170403,3,1,0,113,3.75,0.20303379,0
2020-09-22-170403,170403,3,1,0,116,5.0,0.2509272,1
2020-09-23-170403,170403,0,0,0,116,1.75,0.079695866,2
2020-09-24-170403,170403,0,0,0,116,4.75,0.1405926,3
2020-09-25-170403,170403,1,0,2,117,3.5,0.17554902,4
2020-09-26-170403,170403,2,0,2,119,0.25,0.071789,5
2020-09-27-170403,170403,0,0,9,119,1.25,0.07162398,6
2020-09-28-170403,170403,0,0,17,119,5.0,0.175604,0
2020-09-29-170403,170403,1,0,0,120,3.0,0.12337175,1
2020-09-30-170403,170403,0,0,2,120,2.0,0.084015876,2
2020-10-01-170403,170403,4,0,6,124,2.5,0.19156359,3
2020-10-02-170403,170403,4,0,1,128,3.25,0.23317227,4
2020-10-03-170403,170403,0,0,10,128,1.0,0.08381901,5
2020-10-04-170403,170403,0,0,0,128,2.0,0.07870663,6
2020-10-05-170403,170403,0,0,0,128,3.75,0.10538557,0
2020-10-06-170403,170403,0,0,0,128,3.5,0.0705704,1
2020-10-07-170403,170403,0,0,5,128,5.0,0.074406855,2
2020-10-08-170403,170403,0,2,22,128,4.5,0.097406626,3
2020-10-09-170403,170403,2,2,1,130,3.75,0.17222464,4
2020-10-10-170403,170403,2,0,0,132,12.0,0.39718604,5
2020-10-11-170403,170403,9,0,1,141,3.25,0.37456307,6
2020-10-12-170403,170403,17,0,0,158,4.75,0.47299486,0
2020-10-13-170403,170403,0,0,0,158,2.5,0.10764902,1
2020-10-14-170403,170403,2,0,3,160,3.75,0.11162545,2
2020-10-15-170403,170403,6,0,2,166,2.75,0.15468138,3
2020-10-16-170403,170403,1,0,5,167,7.75,0.14940238,4
2020-10-17-170403,170403,10,0,2,177,2.75,0.26563188,5
2020-10-18-170403,170403,0,0,3,177,3.25,0.063717276,6
2020-10-19-170403,170403,0,0,8,177,3.5,0.07901472,0
2020-10-20-170403,170403,0,0,2,177,8.25,0.23234555,1
2020-10-21-170403,170403,5,1,8,182,7.0,0.25808147,2
2020-10-22-170403,170403,22,1,2,204,7.25,0.59214973,3
2020-10-23-170403,170403,1,0,7,205,9.5,0.25709286,4
2020-10-24-170403,170403,0,0,6,205,4.75,0.077771924,5
2020-10-25-170403,170403,1,0,1,206,3.75,0.057446357,6
2020-10-26-170403,170403,0,2,5,206,4.0,0.12978922,0
2020-10-27-170403,170403,0,0,4,206,6.5,0.17834947,1
2020-10-28-170403,170403,3,2,5,209,5.5,0.31073996,2
2020-10-29-170403,170403,2,0,8,211,6.0,0.28409803,3
2020-10-30-170403,170403,5,1,1,216,11.5,0.4080143,4
2020-10-31-170403,170403,2,1,0,218,14.0,0.45507288,5
2020-11-01-170403,170403,3,1,0,221,6.5,0.24543856,6
2020-11-02-170403,170403,8,0,0,229,2.5,0.23669505,0
2020-11-03-170403,170403,2,1,0,231,7.5,0.43585464,1
2020-11-04-170403,170403,8,1,0,239,10.0,0.56362236,2
2020-11-05-170403,170403,2,0,0,241,7.75,0.29353824,3
2020-11-06-170403,170403,7,3,0,248,9.5,0.2930963,4
2020-11-07-170403,170403,6,0,0,254,3.5,0.18476619,5
2020-11-08-170403,170403,1,0,0,255,4.75,0.0881871,6
2020-11-09-170403,170403,5,0,0,260,10.25,0.28616816,0
2020-11-10-170403,170403,4,1,0,264,5.75,0.25677562,1
2020-11-11-170403,170403,5,2,0,269,10.75,0.49313396,2
2020-11-12-170403,170403,8,1,0,277,6.0,0.4155861,3
2020-11-13-170403,170403,1,0,0,278,4.25,0.23468788,4
2020-03-01-170404,170404,0,0,0,0,0.0,0.000121447156,6
2020-03-02-170404,170404,0,0,2,0,0.0,0.00015942872,0
2020-03-03-170404,170404,0,0,5,0,0.0,5.477683e-09,1
2020-03-04-170404,170404,0,0,6,0,0.0,0.00013146606,2
2020-03-05-170404,170404,0,0,4,0,0.0,0.00041675413,3
2020-03-06-170404,170404,1,0,7,1,0.0,0.050953463,4
2020-03-07-170404,170404,0,0,4,1,0.0,0.002305223,5
2020-03-08-170404,170404,0,0,4,1,0.0,0.0015178606,6
2020-03-09-170404,170404,0,0,10,1,0.0,0.008460724,0
2020-03-10-170404,170404,0,0,9,1,0.2857142857142857,0.031343047,1
2020-03-11-170404,170404,0,0,16,1,0.14285714285714285,0.0020283672,2
2020-03-12-170404,170404,1,0,14,2,0.5714285714285714,0.15149936,3
2020-03-13-170404,170404,0,0,18,2,0.42857142857142855,0.051957946,4
2020-03-14-170404,170404,0,0,7,2,0.2857142857142857,0.12082021,5
2020-03-15-170404,170404,0,0,9,2,0.5714285714285714,0.112268485,6
2020-03-16-170404,170404,2,0,10,4,2.8571428571428568,0.50773424,0
2020-03-17-170404,170404,5,0,12,9,3.1428571428571432,1.043426,1
2020-03-18-170404,170404,6,5,12,15,6.142857142857142,1.2217561,2
2020-03-19-170404,170404,4,0,6,19,7.428571428571429,1.4333552,3
2020-03-20-170404,170404,7,0,6,26,5.285714285714286,1.1372142,4
2020-03-21-170404,170404,4,0,8,30,2.571428571428572,0.36096302,5
2020-03-22-170404,170404,4,0,2,34,4.285714285714286,0.42107257,6
2020-03-23-170404,170404,10,0,7,44,7.428571428571429,1.4574636,0
2020-03-24-170404,170404,9,0,6,53,9.571428571428571,1.6257668,1
2020-03-25-170404,170404,16,0,9,69,10.0,2.2525115,2
2020-03-26-170404,170404,14,0,13,83,7.428571428571429,1.602856,3
2020-03-27-170404,170404,18,0,2,101,5.857142857142858,1.3791835,4
2020-03-28-170404,170404,7,0,2,108,2.7142857142857144,0.6012629,5
2020-03-29-170404,170404,9,0,1,117,1.7142857142857142,0.57219595,6
2020-03-30-170404,170404,10,0,2,127,5.285714285714286,1.0401994,0
2020-03-31-170404,170404,12,0,9,139,4.571428571428571,1.0203509,1
2020-04-01-170404,170404,12,0,5,151,2.7142857142857144,0.91407466,2
2020-04-02-170404,170404,6,0,5,157,5.142857142857143,0.81642336,3
2020-04-03-170404,170404,6,0,8,163,4.0,0.80563486,4
2020-04-04-170404,170404,8,0,1,171,2.7142857142857144,0.46236554,5
2020-04-05-170404,170404,2,0,2,173,1.5714285714285714,0.13285367,6
2020-04-06-170404,170404,7,0,7,180,4.428571428571429,0.8499116,0
2020-04-07-170404,170404,6,1,5,186,3.0,0.8304273,1
2020-04-08-170404,170404,9,0,7,195,2.8571428571428568,0.7512725,2
2020-04-09-170404,170404,13,0,2,208,3.7142857142857135,0.68714184,3
2020-04-10-170404,170404,2,0,7,210,3.0,0.32772243,4
2020-04-11-170404,170404,2,0,1,212,1.5714285714285714,0.25460047,5
2020-04-12-170404,170404,1,0,2,213,0.42857142857142855,0.097883664,6
2020-04-13-170404,170404,2,0,4,215,4.0,0.72663164,0
2020-04-14-170404,170404,9,0,1,224,2.571428571428572,0.7476575,1
2020-04-15-170404,170404,5,0,9,229,1.7142857142857142,0.41615924,2
2020-04-16-170404,170404,5,0,5,234,2.571428571428572,0.46831086,3
2020-04-17-170404,170404,8,0,1,242,2.7142857142857144,0.6200607,4
2020-04-18-170404,170404,1,0,1,243,0.7142857142857143,0.092725374,5
2020-04-19-170404,170404,2,0,1,245,0.5714285714285714,0.12888071,6
2020-04-20-170404,170404,7,0,6,252,2.7142857142857144,0.5680086,0
2020-04-21-170404,170404,5,0,2,257,1.4285714285714286,0.47841594,1
2020-04-22-170404,170404,7,1,3,264,1.8571428571428568,0.6717048,2
2020-04-23-170404,170404,2,0,0,266,1.0,0.14268382,3
2020-04-24-170404,170404,7,0,6,273,2.2857142857142856,0.6624408,4
2020-04-25-170404,170404,1,0,4,274,1.0,0.13792743,5
2020-04-26-170404,170404,2,0,1,276,1.2857142857142858,0.10899286,6
2020-04-27-170404,170404,4,0,4,280,2.0,0.38616806,0
2020-04-28-170404,170404,1,0,5,281,2.0,0.39716983,1
2020-04-29-170404,170404,9,0,3,290,2.0,0.5446516,2
2020-04-30-170404,170404,5,0,3,295,1.0,0.36883426,3
2020-05-01-170404,170404,1,0,5,296,1.5714285714285714,0.13687216,4
2020-05-02-170404,170404,1,0,0,297,1.1428571428571428,0.13595122,5
2020-05-03-170404,170404,1,0,0,298,0.7142857142857143,0.096340485,6
2020-05-04-170404,170404,6,0,2,304,2.142857142857143,0.50733215,0
2020-05-05-170404,170404,2,0,2,306,2.0,0.4280778,1
2020-05-06-170404,170404,3,0,2,309,1.4285714285714286,0.3295954,2
2020-05-07-170404,170404,0,0,2,309,1.0,0.1677272,3
2020-05-08-170404,170404,6,0,0,315,1.1428571428571428,0.49795607,4
2020-05-09-170404,170404,4,0,2,319,1.0,0.26818803,5
2020-05-10-170404,170404,1,0,0,320,0.5714285714285714,0.11745875,6
2020-05-11-170404,170404,4,0,0,324,2.0,0.37655202,0
2020-05-12-170404,170404,5,2,3,329,1.4285714285714286,0.45863602,1
2020-05-13-170404,170404,3,3,2,332,1.7142857142857142,0.2817344,2
2020-05-14-170404,170404,3,0,7,335,1.0,0.18104024,3
2020-05-15-170404,170404,5,0,3,340,2.142857142857143,0.4968342,4
2020-05-16-170404,170404,0,0,0,340,0.14285714285714285,0.007228042,5
2020-05-17-170404,170404,0,0,0,340,0.8571428571428571,0.05908898,6
2020-05-18-170404,170404,2,1,3,342,1.2857142857142858,0.40700504,0
2020-05-19-170404,170404,2,0,3,344,0.8571428571428571,0.2446178,1
2020-05-20-170404,170404,2,0,1,346,0.7142857142857143,0.24448183,2
2020-05-21-170404,170404,2,0,1,348,0.8571428571428571,0.21856847,3
2020-05-22-170404,170404,0,0,3,348,1.7142857142857142,0.4259398,4
2020-05-23-170404,170404,2,0,0,350,0.0,0.08306892,5
2020-05-24-170404,170404,0,0,0,350,0.14285714285714285,0.017232554,6
2020-05-25-170404,170404,0,0,1,350,0.8571428571428571,0.3522602,0
2020-05-26-170404,170404,3,0,6,353,0.7142857142857143,0.4827439,1
2020-05-27-170404,170404,2,0,1,355,2.4285714285714284,0.5072171,2
2020-05-28-170404,170404,7,0,3,362,1.7142857142857142,0.6822411,3
2020-05-29-170404,170404,3,0,1,365,1.2857142857142858,0.33188215,4
2020-05-30-170404,170404,0,0,0,365,0.14285714285714285,0.055451363,5
2020-05-31-170404,170404,0,0,0,365,0.0,0.004915368,6
2020-06-01-170404,170404,3,0,0,368,1.0,0.58814436,0
2020-06-02-170404,170404,3,0,3,371,1.2857142857142858,0.3378658,1
2020-06-03-170404,170404,1,1,1,372,1.0,0.28982553,2
2020-06-04-170404,170404,1,0,1,373,0.5714285714285714,0.15743223,3
2020-06-05-170404,170404,3,0,0,376,1.0,0.40414345,4
2020-06-06-170404,170404,0,0,0,376,0.14285714285714285,0.050145075,5
2020-06-07-170404,170404,0,0,0,376,0.5714285714285714,0.0624576,6
2020-06-08-170404,170404,1,0,1,377,1.0,0.24505606,0
2020-06-09-170404,170404,6,0,0,383,2.0,0.4870759,1
2020-06-10-170404,170404,1,0,1,384,1.2857142857142858,0.31291804,2
2020-06-11-170404,170404,3,0,0,387,0.5714285714285714,0.28489172,3
2020-06-12-170404,170404,1,0,1,388,1.1428571428571428,0.2776612,4
2020-06-13-170404,170404,0,0,0,388,0.0,0.02192925,5
2020-06-14-170404,170404,0,1,0,388,0.14285714285714285,0.012632015,6
2020-06-15-170404,170404,0,7,0,388,1.5714285714285714,0.24260487,0
2020-06-16-170404,170404,3,1,1,391,0.8571428571428571,0.26838148,1
2020-06-17-170404,170404,1,0,1,392,1.0,0.22087663,2
2020-06-18-170404,170404,1,0,1,393,0.7142857142857143,0.1115775,3
2020-06-19-170404,170404,0,1,0,393,0.5714285714285714,0.11508682,4
2020-06-20-170404,170404,0,0,0,393,0.2857142857142857,0.05602975,5
2020-06-21-170404,170404,0,0,1,393,0.14285714285714285,0.014504946,6
2020-06-22-170404,170404,1,0,0,394,1.0,0.22055015,0
2020-06-23-170404,170404,0,0,1,394,1.2857142857142858,0.19369398,1
2020-06-24-170404,170404,1,0,1,395,1.1428571428571428,0.25776458,2
2020-06-25-170404,170404,0,0,0,395,0.5714285714285714,0.117944814,3
2020-06-26-170404,170404,1,0,0,396,0.42857142857142855,0.114705466,4
2020-06-27-170404,170404,0,0,0,396,0.0,0.025591634,5
2020-06-28-170404,170404,0,0,0,396,0.14285714285714285,0.0023054448,6
2020-06-29-170404,170404,0,0,1,396,1.0,0.23224553,0
2020-06-30-170404,170404,1,0,0,397,1.0,0.17950945,1
2020-07-01-170404,170404,1,0,0,398,0.8571428571428571,0.26102602,2
2020-07-02-170404,170404,1,0,1,399,0.2857142857142857,0.12773135,3
2020-07-03-170404,170404,0,0,0,399,0.42857142857142855,0.08463326,4
2020-07-04-170404,170404,0,0,0,399,0.14285714285714285,0.029987648,5
2020-07-05-170404,170404,1,0,0,400,0.0,0.04242443,6
2020-07-06-170404,170404,0,0,0,400,0.42857142857142855,0.07856773,0
2020-07-07-170404,170404,1,0,0,401,0.42857142857142855,0.15514019,1
2020-07-08-170404,170404,1,0,1,402,0.42857142857142855,0.15344812,2
2020-07-09-170404,170404,0,1,0,402,0.42857142857142855,0.081491396,3
2020-07-10-170404,170404,0,0,0,402,0.5714285714285714,0.20062569,4
2020-07-11-170404,170404,0,0,0,402,0.0,0.00043521362,5
2020-07-12-170404,170404,0,0,0,402,0.0,0.0029501664,6
2020-07-13-170404,170404,1,0,0,403,0.42857142857142855,0.1954501,0
2020-07-14-170404,170404,0,0,0,403,0.2857142857142857,0.103124924,1
2020-07-15-170404,170404,0,0,0,403,0.8571428571428571,0.14543132,2
2020-07-16-170404,170404,1,0,1,404,0.7142857142857143,0.26983613,3
2020-07-17-170404,170404,0,0,1,404,0.2857142857142857,0.06155299,4
2020-07-18-170404,170404,0,0,0,404,0.0,0.0810564,5
2020-07-19-170404,170404,0,0,0,404,0.14285714285714285,0.20657441,6
2020-07-20-170404,170404,0,0,0,404,1.0,0.22067341,0
2020-07-21-170404,170404,0,0,0,404,1.0,0.26631266,1
2020-07-22-170404,170404,1,0,0,405,1.0,0.1919761,2
2020-07-23-170404,170404,0,0,1,405,1.0,0.24778286,3
2020-07-24-170404,170404,0,0,2,405,0.5714285714285714,0.07451997,4
2020-07-25-170404,170404,0,0,1,405,0.5714285714285714,0.077172354,5
2020-07-26-170404,170404,0,0,0,405,0.0,0.011303498,6
2020-07-27-170404,170404,0,0,2,405,0.5714285714285714,0.09199346,0
2020-07-28-170404,170404,0,0,3,405,0.7142857142857143,0.21370614,1
2020-07-29-170404,170404,0,0,1,405,1.1428571428571428,0.2194112,2
2020-07-30-170404,170404,1,0,2,406,1.0,0.25609702,3
2020-07-31-170404,170404,1,0,0,407,0.5714285714285714,0.1400541,4
2020-08-01-170404,170404,0,0,0,407,0.0,0.018955763,5
2020-08-02-170404,170404,0,0,3,407,0.2857142857142857,0.064195246,6
2020-08-03-170404,170404,0,0,2,407,1.2857142857142858,0.22434239,0
2020-08-04-170404,170404,0,0,4,407,1.4285714285714286,0.35796282,1
2020-08-05-170404,170404,0,0,3,407,1.8571428571428568,0.47782606,2
2020-08-06-170404,170404,1,0,4,408,0.8571428571428571,0.26417667,3
2020-08-07-170404,170404,2,0,1,410,1.8571428571428568,0.61080116,4
2020-08-08-170404,170404,1,0,2,411,0.0,0.094723746,5
2020-08-09-170404,170404,0,0,0,411,0.42857142857142855,0.09536637,6
2020-08-10-170404,170404,2,0,2,413,1.5714285714285714,0.5560929,0
2020-08-11-170404,170404,3,0,1,416,0.7142857142857143,0.22873516,1
2020-08-12-170404,170404,1,0,2,417,1.5714285714285714,0.34427932,2
2020-08-13-170404,170404,2,0,1,419,1.1428571428571428,0.27651802,3
2020-08-14-170404,170404,0,0,3,419,0.2857142857142857,0.27372855,4
2020-08-15-170404,170404,0,0,2,419,0.14285714285714285,0.142102,5
2020-08-16-170404,170404,3,0,0,422,0.14285714285714285,0.15686598,6
2020-08-17-170404,170404,2,0,2,424,0.5714285714285714,0.21677458,0
2020-08-18-170404,170404,4,0,2,428,1.2857142857142858,0.5145745,1
2020-08-19-170404,170404,3,0,2,431,1.1428571428571428,0.31802496,2
2020-08-20-170404,170404,4,0,1,435,1.1428571428571428,0.487237,3
2020-08-21-170404,170404,1,0,2,436,0.7142857142857143,0.24480002,4
2020-08-22-170404,170404,2,0,2,438,0.7142857142857143,0.2955869,5
2020-08-23-170404,170404,0,0,3,438,0.14285714285714285,0.0401359,6
2020-08-24-170404,170404,2,0,7,440,1.4285714285714286,0.3339071,0
2020-08-25-170404,170404,1,0,3,441,1.1428571428571428,0.36610126,1
2020-08-26-170404,170404,2,0,0,443,1.2857142857142858,1.1845502,2
2020-08-27-170404,170404,1,0,4,444,1.2857142857142858,0.5786444,3
2020-08-28-170404,170404,3,0,4,447,1.2857142857142858,0.6366457,4
2020-08-29-170404,170404,2,0,1,449,0.8571428571428571,0.3788123,5
2020-08-30-170404,170404,0,0,2,449,0.0,0.13949104,6
2020-08-31-170404,170404,2,0,4,451,0.8571428571428571,0.2855996,0
2020-09-01-170404,170404,2,0,3,453,1.2857142857142858,0.8191729,1
2020-09-02-170404,170404,2,0,6,455,0.5714285714285714,0.25545436,2
2020-09-03-170404,170404,1,0,9,456,1.7142857142857142,0.8610546,3
2020-09-04-170404,170404,2,0,6,458,1.4285714285714286,0.66120416,4
2020-09-05-170404,170404,2,0,5,460,1.1428571428571428,0.27446717,5
2020-09-06-170404,170404,3,1,2,463,1.2857142857142858,0.36322856,6
2020-09-07-170404,170404,7,0,5,470,0.5714285714285714,0.47210535,0
2020-09-08-170404,170404,3,1,11,473,0.42857142857142855,0.4884469,1
2020-09-09-170404,170404,0,0,7,473,0.42857142857142855,0.2597551,2
2020-09-10-170404,170404,4,0,1,477,1.2857142857142858,0.45308107,3
2020-09-11-170404,170404,4,0,6,481,2.2857142857142856,0.9082361,4
2020-09-12-170404,170404,1,0,1,482,1.2857142857142858,0.3166769,5
2020-09-13-170404,170404,2,0,3,484,1.0,0.32452357,6
2020-09-14-170404,170404,4,0,1,488,1.1428571428571428,0.40814352,0
2020-09-15-170404,170404,3,0,5,491,1.7142857142857142,0.79136676,1
2020-09-16-170404,170404,6,0,3,497,1.8571428571428568,0.43551248,2
2020-09-17-170404,170404,9,0,12,506,2.7142857142857144,1.0396574,3
2020-09-18-170404,170404,6,0,15,512,2.4285714285714284,0.79427934,4
2020-09-19-170404,170404,5,0,4,517,2.142857142857143,0.48866406,5
2020-09-20-170404,170404,2,0,2,519,0.7142857142857143,0.24092856,6
2020-09-21-170404,170404,5,1,22,524,2.7142857142857144,0.6988117,0
2020-09-22-170404,170404,11,0,10,535,3.571428571428572,1.3210204,1
2020-09-23-170404,170404,7,1,17,542,3.0,0.9476007,2
2020-09-24-170404,170404,1,0,15,543,3.0,0.67438954,3
2020-09-25-170404,170404,6,0,12,549,1.7142857142857142,0.7216295,4
2020-09-26-170404,170404,1,0,9,550,0.42857142857142855,0.14919192,5
2020-09-27-170404,170404,3,0,11,553,1.4285714285714286,0.4100801,6
2020-09-28-170404,170404,1,0,3,554,5.0,0.9702941,0
2020-09-29-170404,170404,5,0,11,559,3.2857142857142856,0.8984266,1
2020-09-30-170404,170404,3,0,7,562,3.2857142857142856,0.85417634,2
2020-10-01-170404,170404,12,0,5,574,4.714285714285714,1.5678287,3
2020-10-02-170404,170404,15,0,11,589,4.428571428571429,1.3979396,4
2020-10-03-170404,170404,4,0,6,593,1.8571428571428568,0.5955748,5
2020-10-04-170404,170404,2,0,8,595,2.571428571428572,0.33062115,6
2020-10-05-170404,170404,22,0,7,617,4.714285714285714,1.8681765,0
2020-10-06-170404,170404,10,0,14,627,2.8571428571428568,1.1301442,1
2020-10-07-170404,170404,17,0,14,644,4.0,1.4063594,2
2020-10-08-170404,170404,15,1,20,659,5.571428571428571,1.5459993,3
2020-10-09-170404,170404,12,0,30,671,4.142857142857143,1.7103391,4
2020-10-10-170404,170404,9,0,15,680,2.7142857142857144,1.6937009,5
2020-10-11-170404,170404,11,0,3,691,2.2857142857142856,1.0087416,6
2020-10-12-170404,170404,3,0,22,694,2.8571428571428568,0.6651784,0
2020-10-13-170404,170404,11,0,29,705,4.571428571428571,1.3665565,1
2020-10-14-170404,170404,7,0,4,712,4.428571428571429,1.3478504,2
2020-10-15-170404,170404,5,0,21,717,3.0,1.1041882,3
2020-10-16-170404,170404,11,0,26,728,7.2857142857142865,1.793127,4
2020-10-17-170404,170404,6,1,14,734,4.428571428571429,1.0360302,5
2020-10-18-170404,170404,8,0,16,742,4.285714285714286,0.9398445,6
2020-10-19-170404,170404,7,0,18,749,2.8571428571428568,1.0145671,0
2020-10-20-170404,170404,14,0,18,763,6.857142857142858,2.1131508,1
2020-10-21-170404,170404,14,0,19,777,5.857142857142858,1.9638691,2
2020-10-22-170404,170404,20,0,18,797,5.857142857142858,2.0099025,3
2020-10-23-170404,170404,30,0,31,827,8.285714285714286,2.6297607,4
2020-10-24-170404,170404,15,1,10,842,4.285714285714286,1.112253,5
2020-10-25-170404,170404,3,1,8,845,2.4285714285714284,0.39727935,6
2020-10-26-170404,170404,22,0,11,867,4.714285714285714,2.053609,0
2020-10-27-170404,170404,29,0,5,896,5.0,2.5649211,1
2020-10-28-170404,170404,4,1,19,900,8.428571428571429,1.8333575,2
2020-10-29-170404,170404,21,1,10,921,10.428571428571429,3.1860182,3
2020-10-30-170404,170404,26,2,11,947,9.571428571428571,2.9530082,4
2020-10-31-170404,170404,14,0,0,961,4.285714285714286,2.334152,5
2020-11-01-170404,170404,16,0,0,977,5.571428571428571,1.2618424,6
2020-11-02-170404,170404,18,0,0,995,2.7142857142857144,1.1309798,0
2020-11-03-170404,170404,18,1,0,1013,6.857142857142858,2.7202172,1
2020-11-04-170404,170404,19,2,0,1032,8.0,2.7034798,2
2020-11-05-170404,170404,18,3,0,1050,5.142857142857143,2.47203,3
2020-11-06-170404,170404,31,2,0,1081,9.285714285714286,2.7811322,4
2020-11-07-170404,170404,10,0,0,1091,3.1428571428571432,1.2294313,5
2020-11-08-170404,170404,8,0,0,1099,3.4285714285714284,0.7442979,6
2020-11-09-170404,170404,11,0,0,1110,5.7142857142857135,2.1016555,0
2020-11-10-170404,170404,5,0,0,1115,5.7142857142857135,1.4656062,1
2020-11-11-170404,170404,19,0,0,1134,8.857142857142858,3.2369494,2
2020-11-12-170404,170404,10,0,0,1144,4.428571428571429,1.8032624,3
2020-11-13-170404,170404,11,3,0,1155,5.285714285714286,1.9286005,4
2020-03-01-170405,170405,0,0,1,0,0.0,7.401161e-05,6
2020-03-02-170405,170405,0,0,11,0,0.0,0.00045143944,0
2020-03-03-170405,170405,0,0,7,0,0.0,3.676014e-08,1
2020-03-04-170405,170405,0,0,15,0,0.0,0.0007518186,2
2020-03-05-170405,170405,0,0,22,0,0.0,0.00013189651,3
2020-03-06-170405,170405,0,0,16,0,0.16666666666666666,0.04540551,4
2020-03-07-170405,170405,0,0,9,0,0.0,0.0019962657,5
2020-03-08-170405,170405,0,0,8,0,0.0,0.00071454997,6
2020-03-09-170405,170405,0,0,15,0,0.0,0.0030662701,0
2020-03-10-170405,170405,1,0,28,1,0.16666666666666666,0.025528494,1
2020-03-11-170405,170405,1,0,23,2,0.0,0.0008239853,2
2020-03-12-170405,170405,3,0,9,5,0.5,0.12815504,3
2020-03-13-170405,170405,1,0,8,6,0.3333333333333333,0.040742457,4
2020-03-14-170405,170405,1,0,6,7,0.0,0.077006385,5
2020-03-15-170405,170405,1,0,1,8,0.0,0.08542904,6
2020-03-16-170405,170405,11,0,13,19,2.0,0.39789066,0
2020-03-17-170405,170405,7,0,7,26,2.1666666666666665,0.8357298,1
2020-03-18-170405,170405,15,0,8,41,5.5,1.0283962,2
2020-03-19-170405,170405,22,0,12,63,4.5,1.1543152,3
2020-03-20-170405,170405,16,0,13,79,4.166666666666667,0.9360233,4
2020-03-21-170405,170405,9,0,1,88,2.333333333333333,0.3450516,5
2020-03-22-170405,170405,8,0,4,96,2.6666666666666665,0.28214842,6
2020-03-23-170405,170405,15,0,11,111,6.166666666666668,1.2166333,0
2020-03-24-170405,170405,28,0,6,139,6.0,1.2568827,1
2020-03-25-170405,170405,23,0,8,162,7.166666666666668,1.8911008,2
2020-03-26-170405,170405,9,0,8,171,8.5,1.2394516,3
2020-03-27-170405,170405,8,0,8,179,8.5,1.0979317,4
2020-03-28-170405,170405,6,0,3,185,3.8333333333333335,0.45787695,5
2020-03-29-170405,170405,1,0,0,186,4.333333333333333,0.45551878,6
2020-03-30-170405,170405,13,0,7,199,4.833333333333333,0.82183415,0
2020-03-31-170405,170405,7,0,4,206,5.333333333333333,0.8447374,1
2020-04-01-170405,170405,8,0,2,214,4.0,0.68432933,2
2020-04-02-170405,170405,12,0,9,226,4.5,0.6783127,3
2020-04-03-170405,170405,13,0,7,239,3.8333333333333335,0.66967773,4
2020-04-04-170405,170405,1,0,1,240,3.5,0.34845015,5
2020-04-05-170405,170405,4,0,0,244,1.0,0.08886784,6
2020-04-06-170405,170405,11,0,7,255,3.1666666666666665,0.6390536,0
2020-04-07-170405,170405,6,0,2,261,2.6666666666666665,0.6415694,1
2020-04-08-170405,170405,8,0,4,269,3.5,0.56861305,2
2020-04-09-170405,170405,8,1,1,277,5.166666666666667,0.5281272,3
2020-04-10-170405,170405,8,0,6,285,2.6666666666666665,0.25203001,4
2020-04-11-170405,170405,3,0,2,288,1.6666666666666667,0.19344865,5
2020-04-12-170405,170405,0,0,4,288,1.0,0.07228037,6
2020-04-13-170405,170405,7,0,4,295,3.0,0.5940028,0
2020-04-14-170405,170405,4,0,2,299,4.166666666666667,0.6315512,1
2020-04-15-170405,170405,2,0,5,301,2.1666666666666665,0.3026267,2
2020-04-16-170405,170405,9,0,3,310,2.0,0.32917926,3
2020-04-17-170405,170405,7,0,2,317,2.833333333333333,0.43218297,4
2020-04-18-170405,170405,1,0,2,318,1.0,0.06650235,5
2020-04-19-170405,170405,0,0,0,318,1.3333333333333333,0.10884229,6
2020-04-20-170405,170405,7,0,4,325,2.833333333333333,0.43564427,0
2020-04-21-170405,170405,2,0,3,327,2.333333333333333,0.33208042,1
2020-04-22-170405,170405,4,0,4,331,3.0,0.5259417,2
2020-04-23-170405,170405,1,0,3,332,3.1666666666666665,0.10862809,3
2020-04-24-170405,170405,6,0,1,338,4.166666666666667,0.5016957,4
2020-04-25-170405,170405,2,0,0,340,0.5,0.107625805,5
2020-04-26-170405,170405,4,0,0,344,0.8333333333333334,0.06926724,6
2020-04-27-170405,170405,4,3,1,348,3.1666666666666665,0.34381175,0
2020-04-28-170405,170405,2,0,5,350,1.3333333333333333,0.28690967,1
2020-04-29-170405,170405,5,0,2,355,3.6666666666666665,0.42776823,2
2020-04-30-170405,170405,3,0,0,358,2.333333333333333,0.29913718,3
2020-05-01-170405,170405,2,0,6,360,1.0,0.07318382,4
2020-05-02-170405,170405,2,0,0,362,1.0,0.08323446,5
2020-05-03-170405,170405,0,0,3,362,0.6666666666666666,0.06452422,6
2020-05-04-170405,170405,4,0,1,366,2.6666666666666665,0.41421852,0
2020-05-05-170405,170405,3,0,2,369,1.6666666666666667,0.2947154,1
2020-05-06-170405,170405,4,0,2,373,1.8333333333333333,0.22641042,2
2020-05-07-170405,170405,3,0,4,376,0.5,0.11127046,3
2020-05-08-170405,170405,1,0,2,377,2.333333333333333,0.39228022,4
2020-05-09-170405,170405,0,0,0,377,1.5,0.19263701,5
2020-05-10-170405,170405,0,1,0,377,0.3333333333333333,0.12732854,6
2020-05-11-170405,170405,1,9,1,378,1.6666666666666667,0.29641348,0
2020-05-12-170405,170405,5,1,2,383,2.1666666666666665,0.3408703,1
2020-05-13-170405,170405,2,0,2,385,1.6666666666666667,0.18179226,2
2020-05-14-170405,170405,0,0,3,385,1.1666666666666667,0.12891398,3
2020-05-15-170405,170405,6,0,2,391,2.0,0.37000084,4
2020-05-16-170405,170405,0,0,1,391,0.16666666666666666,0.0055567515,5
2020-05-17-170405,170405,3,0,0,394,0.16666666666666666,0.032447226,6
2020-05-18-170405,170405,1,0,1,395,1.6666666666666667,0.31430855,0
2020-05-19-170405,170405,2,0,1,397,0.8333333333333334,0.16926277,1
2020-05-20-170405,170405,2,0,0,399,0.6666666666666666,0.18963821,2
2020-05-21-170405,170405,4,0,1,403,0.5,0.19173446,3
2020-05-22-170405,170405,2,0,1,405,1.8333333333333333,0.35353097,4
2020-05-23-170405,170405,0,0,0,405,0.3333333333333333,0.061608728,5
2020-05-24-170405,170405,0,0,1,405,0.0,0.0059909727,6
2020-05-25-170405,170405,1,0,0,406,0.3333333333333333,0.3232416,0
2020-05-26-170405,170405,2,0,2,408,1.8333333333333333,0.38536173,1
2020-05-27-170405,170405,2,0,0,410,1.0,0.33871034,2
2020-05-28-170405,170405,3,1,0,413,1.3333333333333333,0.4890644,3
2020-05-29-170405,170405,2,0,1,415,1.1666666666666667,0.22875632,4
2020-05-30-170405,170405,1,0,0,416,0.0,0.056939002,5
2020-05-31-170405,170405,0,0,1,416,0.0,0.004075659,6
2020-06-01-170405,170405,1,0,2,417,0.5,0.44187453,0
2020-06-02-170405,170405,1,0,0,418,1.0,0.24781579,1
2020-06-03-170405,170405,0,0,2,418,0.8333333333333334,0.18801731,2
2020-06-04-170405,170405,1,0,2,419,0.6666666666666666,0.119185485,3
2020-06-05-170405,170405,1,0,0,420,0.6666666666666666,0.29546613,4
2020-06-06-170405,170405,0,0,0,420,0.5,0.037990194,5
2020-06-07-170405,170405,1,0,1,421,0.0,0.040315885,6
2020-06-08-170405,170405,0,0,3,421,0.3333333333333333,0.14701185,0
2020-06-09-170405,170405,2,0,2,423,2.1666666666666665,0.36366317,1
2020-06-10-170405,170405,0,0,2,423,1.3333333333333333,0.24086308,2
2020-06-11-170405,170405,0,0,0,423,0.8333333333333334,0.22410281,3
2020-06-12-170405,170405,1,0,0,424,0.6666666666666666,0.20846206,4
2020-06-13-170405,170405,0,0,0,424,0.16666666666666666,0.016172145,5
2020-06-14-170405,170405,1,0,0,425,0.0,0.010184422,6
2020-06-15-170405,170405,2,0,3,427,1.0,0.16595392,0
2020-06-16-170405,170405,0,1,4,427,1.1666666666666667,0.22255005,1
2020-06-17-170405,170405,2,0,0,429,0.6666666666666666,0.18883295,2
2020-06-18-170405,170405,2,0,1,431,0.6666666666666666,0.08770845,3
2020-06-19-170405,170405,0,0,0,431,0.3333333333333333,0.065068975,4
2020-06-20-170405,170405,0,1,0,431,0.16666666666666666,0.044083893,5
2020-06-21-170405,170405,1,0,0,432,0.0,0.010799156,6
2020-06-22-170405,170405,3,0,2,435,1.0,0.1690391,0
2020-06-23-170405,170405,2,0,1,437,0.0,0.11337813,1
2020-06-24-170405,170405,2,0,1,439,1.5,0.20509538,2
2020-06-25-170405,170405,0,0,1,439,0.0,0.06384295,3
2020-06-26-170405,170405,0,0,2,439,0.3333333333333333,0.07786995,4
2020-06-27-170405,170405,0,0,0,439,0.16666666666666666,0.018677618,5
2020-06-28-170405,170405,0,0,0,439,0.0,0.000506792,6
2020-06-29-170405,170405,3,0,1,442,1.0,0.1796769,0
2020-06-30-170405,170405,4,0,1,446,0.16666666666666666,0.12487481,1
2020-07-01-170405,170405,0,0,2,446,1.5,0.25433898,2
2020-07-02-170405,170405,1,0,1,447,0.3333333333333333,0.09387549,3
2020-07-03-170405,170405,0,0,0,447,0.0,0.044573292,4
2020-07-04-170405,170405,0,1,0,447,0.16666666666666666,0.021886613,5
2020-07-05-170405,170405,0,0,0,447,0.16666666666666666,0.030033449,6
2020-07-06-170405,170405,2,0,3,449,0.5,0.06707752,0
2020-07-07-170405,170405,1,0,4,450,0.3333333333333333,0.13350497,1
2020-07-08-170405,170405,1,0,0,451,0.16666666666666666,0.1354535,2
2020-07-09-170405,170405,1,0,3,452,0.16666666666666666,0.06730584,3
2020-07-10-170405,170405,2,0,2,454,0.5,0.17283955,4
2020-07-11-170405,170405,0,0,0,454,0.0,0.0014052584,5
2020-07-12-170405,170405,0,0,0,454,0.0,0.001039113,6
2020-07-13-170405,170405,1,0,3,455,1.0,0.17509161,0
2020-07-14-170405,170405,1,0,0,456,0.0,0.0943363,1
2020-07-15-170405,170405,2,0,3,458,0.5,0.100656345,2
2020-07-16-170405,170405,1,0,1,459,0.5,0.21953262,3
2020-07-17-170405,170405,0,0,1,459,0.0,0.041672293,4
2020-07-18-170405,170405,0,0,0,459,0.0,0.074589,5
2020-07-19-170405,170405,0,0,0,459,0.0,0.22230382,6
2020-07-20-170405,170405,3,0,1,462,0.0,0.17478964,0
2020-07-21-170405,170405,4,0,3,466,1.0,0.27317205,1
2020-07-22-170405,170405,0,0,2,466,0.5,0.14210023,2
2020-07-23-170405,170405,3,0,2,469,0.0,0.2050488,3
2020-07-24-170405,170405,2,0,4,471,0.0,0.047085203,4
2020-07-25-170405,170405,0,0,0,471,0.16666666666666666,0.037681684,5
2020-07-26-170405,170405,0,0,2,471,0.16666666666666666,0.009292139,6
2020-07-27-170405,170405,3,0,2,474,0.3333333333333333,0.076012895,0
2020-07-28-170405,170405,0,0,0,474,0.5,0.164362,1
2020-07-29-170405,170405,3,0,2,477,0.6666666666666666,0.14575683,2
2020-07-30-170405,170405,1,0,2,478,0.8333333333333334,0.17270103,3
2020-07-31-170405,170405,1,0,2,479,0.6666666666666666,0.094740294,4
2020-08-01-170405,170405,0,0,0,479,0.0,0.012648482,5
2020-08-02-170405,170405,0,0,0,479,0.0,0.030427597,6
2020-08-03-170405,170405,1,0,1,480,0.8333333333333334,0.16726378,0
2020-08-04-170405,170405,3,0,0,483,0.3333333333333333,0.23026437,1
2020-08-05-170405,170405,2,0,0,485,0.6666666666666666,0.29980782,2
2020-08-06-170405,170405,2,0,3,487,0.3333333333333333,0.21070643,3
2020-08-07-170405,170405,4,0,1,491,0.8333333333333334,0.48005384,4
2020-08-08-170405,170405,0,0,1,491,0.3333333333333333,0.06457434,5
2020-08-09-170405,170405,2,0,0,493,0.3333333333333333,0.08917546,6
2020-08-10-170405,170405,2,0,2,495,1.8333333333333333,0.4354346,0
2020-08-11-170405,170405,0,0,2,495,1.5,0.22859727,1
2020-08-12-170405,170405,2,0,1,497,1.3333333333333333,0.27983925,2
2020-08-13-170405,170405,2,0,0,499,1.3333333333333333,0.21911773,3
2020-08-14-170405,170405,2,0,0,501,0.8333333333333334,0.28228274,4
2020-08-15-170405,170405,0,0,1,501,0.16666666666666666,0.12524019,5
2020-08-16-170405,170405,0,0,0,501,0.6666666666666666,0.09949164,6
2020-08-17-170405,170405,1,0,0,502,1.3333333333333333,0.1631392,0
2020-08-18-170405,170405,0,0,2,502,2.0,0.42114615,1
2020-08-19-170405,170405,0,0,3,502,1.8333333333333333,0.24605782,2
2020-08-20-170405,170405,3,0,0,505,0.8333333333333334,0.34352267,3
2020-08-21-170405,170405,1,0,5,506,0.8333333333333334,0.2086901,4
2020-08-22-170405,170405,1,0,3,507,1.0,0.22357504,5
2020-08-23-170405,170405,0,0,2,507,0.0,0.015796958,6
2020-08-24-170405,170405,2,0,2,509,2.0,0.24757323,0
2020-08-25-170405,170405,2,0,2,511,1.1666666666666667,0.28961357,1
2020-08-26-170405,170405,1,0,1,512,1.5,0.8114954,2
2020-08-27-170405,170405,0,0,5,512,2.1666666666666665,0.48888096,3
2020-08-28-170405,170405,0,0,10,512,2.333333333333333,0.49990493,4
2020-08-29-170405,170405,1,0,3,513,1.0,0.2613441,5
2020-08-30-170405,170405,0,0,0,513,0.16666666666666666,0.08847581,6
2020-08-31-170405,170405,0,0,7,513,0.6666666666666666,0.20861791,0
2020-09-01-170405,170405,2,0,5,515,1.8333333333333333,0.624876,1
2020-09-02-170405,170405,3,0,4,518,0.6666666666666666,0.21075353,2
2020-09-03-170405,170405,0,0,11,518,0.8333333333333334,0.62807745,3
2020-09-04-170405,170405,5,1,8,523,0.3333333333333333,0.5690739,4
2020-09-05-170405,170405,3,0,6,526,0.6666666666666666,0.21499753,5
2020-09-06-170405,170405,2,0,0,528,1.0,0.23666123,6
2020-09-07-170405,170405,2,0,5,530,1.6666666666666667,0.37568802,0
2020-09-08-170405,170405,2,0,10,532,0.5,0.413939,1
2020-09-09-170405,170405,1,0,3,533,0.3333333333333333,0.21328978,2
2020-09-10-170405,170405,5,0,9,538,1.5,0.38352078,3
2020-09-11-170405,170405,10,0,2,548,1.5,0.64554954,4
2020-09-12-170405,170405,3,0,1,551,1.1666666666666667,0.27619305,5
2020-09-13-170405,170405,0,0,3,551,1.1666666666666667,0.18410584,6
2020-09-14-170405,170405,7,0,10,558,0.8333333333333334,0.32284343,0
2020-09-15-170405,170405,5,0,7,563,2.0,0.6646502,1
2020-09-16-170405,170405,4,0,3,567,4.5,0.35478717,2
2020-09-17-170405,170405,11,0,4,578,3.1666666666666665,0.8221657,3
2020-09-18-170405,170405,8,0,5,586,3.8333333333333335,0.69736123,4
2020-09-19-170405,170405,6,0,2,592,1.8333333333333333,0.36097327,5
2020-09-20-170405,170405,0,0,6,592,0.8333333333333334,0.14902906,6
2020-09-21-170405,170405,5,0,12,597,3.5,0.63686204,0
2020-09-22-170405,170405,10,1,12,607,5.666666666666668,1.1420513,1
2020-09-23-170405,170405,3,1,14,610,4.666666666666667,0.7399794,2
2020-09-24-170405,170405,9,1,18,619,2.5,0.62612027,3
2020-09-25-170405,170405,2,1,8,621,2.833333333333333,0.66997916,4
2020-09-26-170405,170405,1,0,9,622,1.0,0.11853597,5
2020-09-27-170405,170405,3,0,7,625,1.0,0.26897043,6
2020-09-28-170405,170405,10,0,11,635,3.6666666666666665,0.7965231,0
2020-09-29-170405,170405,7,0,6,642,2.833333333333333,0.7284721,1
2020-09-30-170405,170405,3,0,14,645,2.333333333333333,0.6735936,2
2020-10-01-170405,170405,4,0,9,649,7.166666666666668,1.2485889,3
2020-10-02-170405,170405,5,0,28,654,5.833333333333332,1.0696198,4
2020-10-03-170405,170405,2,1,10,656,1.1666666666666667,0.4302837,5
2020-10-04-170405,170405,6,0,10,662,2.0,0.22406271,6
2020-10-05-170405,170405,12,0,11,674,6.333333333333332,1.3880768,0
2020-10-06-170405,170405,12,1,23,686,3.1666666666666665,0.8651575,1
2020-10-07-170405,170405,14,0,18,700,5.333333333333333,1.1090276,2
2020-10-08-170405,170405,18,3,20,718,4.833333333333333,1.142813,3
2020-10-09-170405,170405,8,1,25,726,6.0,1.2870226,4
2020-10-10-170405,170405,9,0,16,735,9.666666666666666,1.6811646,5
2020-10-11-170405,170405,7,0,11,742,5.0,0.7491943,6
2020-10-12-170405,170405,11,0,11,753,5.666666666666668,0.5230969,0
2020-10-13-170405,170405,6,0,17,759,4.833333333333333,1.0576558,1
2020-10-14-170405,170405,14,0,13,773,3.8333333333333335,1.0094668,2
2020-10-15-170405,170405,9,0,18,782,3.1666666666666665,0.7941183,3
2020-10-16-170405,170405,28,0,27,810,7.0,1.3808645,4
2020-10-17-170405,170405,10,0,11,820,6.333333333333332,0.8375526,5
2020-10-18-170405,170405,10,0,14,830,5.0,0.63908523,6
2020-10-19-170405,170405,11,0,5,841,2.833333333333333,0.83812046,0
2020-10-20-170405,170405,23,0,12,864,6.833333333333332,1.7208617,1
2020-10-21-170405,170405,18,0,20,882,6.833333333333332,1.5820891,2
2020-10-22-170405,170405,20,0,11,902,11.0,1.7300174,3
2020-10-23-170405,170405,25,0,19,927,13.333333333333336,2.1103616,4
2020-10-24-170405,170405,16,0,8,943,5.0,0.8305633,5
2020-10-25-170405,170405,11,0,9,954,2.333333333333333,0.30960342,6
2020-10-26-170405,170405,11,0,17,965,7.0,1.6031511,0
2020-10-27-170405,170405,17,1,10,982,8.166666666666666,2.1101298,1
2020-10-28-170405,170405,13,4,15,995,5.0,1.3817466,2
2020-10-29-170405,170405,18,1,11,1013,8.833333333333334,2.3158617,3
2020-10-30-170405,170405,27,1,4,1040,10.833333333333336,2.4950604,4
2020-10-31-170405,170405,11,0,0,1051,11.833333333333336,2.1680877,5
2020-11-01-170405,170405,14,2,0,1065,7.666666666666668,0.90756357,6
2020-11-02-170405,170405,5,2,0,1070,6.333333333333332,0.87890136,0
2020-11-03-170405,170405,12,1,0,1082,8.666666666666666,2.2377164,1
2020-11-04-170405,170405,20,1,0,1102,9.833333333333334,2.3156927,2
2020-11-05-170405,170405,11,1,0,1113,8.333333333333334,2.2683973,3
2020-11-06-170405,170405,19,2,0,1132,16.5,2.26104,4
2020-11-07-170405,170405,8,1,0,1140,4.5,0.8703883,5
2020-11-08-170405,170405,9,1,0,1149,4.666666666666667,0.51779693,6
2020-11-09-170405,170405,17,0,0,1166,6.333333333333332,1.8816005,0
2020-11-10-170405,170405,10,1,0,1176,5.833333333333332,1.1397308,1
2020-11-11-170405,170405,15,1,0,1191,11.166666666666664,2.62057,2
2020-11-12-170405,170405,11,1,0,1202,6.166666666666668,1.4871504,3
2020-11-13-170405,170405,4,1,0,1206,7.5,1.4758191,4
2020-03-01-170406,170406,0,0,0,0,0.0,2.824851e-06,6
2020-03-02-170406,170406,0,0,3,0,0.0,4.1436655e-05,0
2020-03-03-170406,170406,0,0,7,0,0.0,1.953328e-09,1
2020-03-04-170406,170406,0,0,10,0,0.0,6.268282e-05,2
2020-03-05-170406,170406,0,0,8,0,0.0,2.2296916e-05,3
2020-03-06-170406,170406,0,0,10,0,0.2,0.010477284,4
2020-03-07-170406,170406,0,0,4,0,0.0,0.00027735537,5
2020-03-08-170406,170406,0,0,8,0,0.0,0.00015453818,6
2020-03-09-170406,170406,0,0,13,0,0.0,0.00092462124,0
2020-03-10-170406,170406,1,0,10,1,0.2,0.0063779387,1
2020-03-11-170406,170406,0,0,10,1,0.2,0.00034519786,2
2020-03-12-170406,170406,1,0,16,2,1.0,0.031033754,3
2020-03-13-170406,170406,2,0,17,4,0.2,0.009413513,4
2020-03-14-170406,170406,0,0,5,4,0.2,0.015145723,5
2020-03-15-170406,170406,0,0,1,4,0.4,0.019534921,6
2020-03-16-170406,170406,3,0,5,7,4.4,0.09721178,0
2020-03-17-170406,170406,7,0,9,14,2.6,0.17349847,1
2020-03-18-170406,170406,10,0,2,24,7.2,0.23946156,2
2020-03-19-170406,170406,8,0,8,32,8.2,0.26427394,3
2020-03-20-170406,170406,10,1,4,42,6.8,0.21845815,4
2020-03-21-170406,170406,4,0,4,46,3.8,0.07934189,5
2020-03-22-170406,170406,8,0,2,54,3.0,0.07095351,6
2020-03-23-170406,170406,13,0,4,67,9.0,0.28723556,0
2020-03-24-170406,170406,10,0,1,77,11.0,0.28302386,1
2020-03-25-170406,170406,10,0,4,87,11.2,0.40280876,2
2020-03-26-170406,170406,16,0,7,103,9.0,0.2833642,3
2020-03-27-170406,170406,17,0,5,120,9.0,0.25450242,4
2020-03-28-170406,170406,5,0,3,125,4.8,0.112308085,5
2020-03-29-170406,170406,1,0,1,126,5.6,0.107986234,6
2020-03-30-170406,170406,5,0,6,131,8.0,0.18907753,0
2020-03-31-170406,170406,9,0,0,140,5.8,0.17875916,1
2020-04-01-170406,170406,2,0,2,142,6.0,0.16640398,2
2020-04-02-170406,170406,8,0,2,150,6.4,0.15386598,3
2020-04-03-170406,170406,4,0,7,154,6.6,0.16112025,4
2020-04-04-170406,170406,4,0,2,158,3.2,0.08183589,5
2020-04-05-170406,170406,2,0,2,160,1.6,0.022905823,6
2020-04-06-170406,170406,4,1,5,164,5.0,0.15611634,0
2020-04-07-170406,170406,1,1,1,165,4.2,0.13876387,1
2020-04-08-170406,170406,4,0,5,169,4.8,0.1322689,2
2020-04-09-170406,170406,7,0,3,176,6.4,0.12601712,3
2020-04-10-170406,170406,5,0,7,181,3.8,0.06685116,4
2020-04-11-170406,170406,3,0,0,184,1.6,0.04548046,5
2020-04-12-170406,170406,1,0,3,185,0.8,0.017309697,6
2020-04-13-170406,170406,6,0,5,191,3.6,0.12510858,0
2020-04-14-170406,170406,0,0,3,191,5.4,0.14572945,1
2020-04-15-170406,170406,2,0,5,193,3.0,0.07883593,2
2020-04-16-170406,170406,2,0,0,195,3.4,0.08720624,3
2020-04-17-170406,170406,7,0,3,202,3.4,0.11227791,4
2020-04-18-170406,170406,2,0,3,204,0.8,0.017847933,5
2020-04-19-170406,170406,2,0,2,206,1.4,0.027573202,6
2020-04-20-170406,170406,5,0,3,211,4.4,0.10930544,0
2020-04-21-170406,170406,1,0,6,212,2.6,0.085681185,1
2020-04-22-170406,170406,5,0,0,217,3.2,0.13168918,2
2020-04-23-170406,170406,3,1,0,220,0.6,0.02610392,3
2020-04-24-170406,170406,7,0,3,227,3.8,0.12570938,4
2020-04-25-170406,170406,0,0,2,227,1.2,0.027319096,5
2020-04-26-170406,170406,3,0,0,230,1.2,0.020266447,6
2020-04-27-170406,170406,5,0,4,235,3.0,0.08380793,0
2020-04-28-170406,170406,3,1,2,238,1.6,0.06554993,1
2020-04-29-170406,170406,5,0,6,243,4.2,0.11174599,2
2020-04-30-170406,170406,0,0,4,243,2.6,0.0769219,3
2020-05-01-170406,170406,3,0,1,246,1.0,0.020288311,4
2020-05-02-170406,170406,3,0,1,249,1.0,0.023723386,5
2020-05-03-170406,170406,2,0,1,251,0.4,0.018955247,6
2020-05-04-170406,170406,3,0,1,254,4.0,0.10202048,0
2020-05-05-170406,170406,6,0,1,260,1.2,0.06878188,1
2020-05-06-170406,170406,0,0,0,260,1.8,0.05565351,2
2020-05-07-170406,170406,0,0,0,260,1.0,0.028982006,3
2020-05-08-170406,170406,3,0,4,263,2.2,0.09860835,4
2020-05-09-170406,170406,2,0,0,265,1.4,0.051388294,5
2020-05-10-170406,170406,0,0,0,265,0.4,0.027629958,6
2020-05-11-170406,170406,4,2,1,269,1.8,0.06847982,0
2020-05-12-170406,170406,2,0,0,271,2.8,0.086908326,1
2020-05-13-170406,170406,6,0,2,277,1.2,0.048998844,2
2020-05-14-170406,170406,4,0,0,281,1.0,0.03405234,3
2020-05-15-170406,170406,1,0,2,282,3.6,0.095075935,4
2020-05-16-170406,170406,1,0,0,283,0.0,0.0013666833,5
2020-05-17-170406,170406,1,0,0,284,0.6,0.009224098,6
2020-05-18-170406,170406,1,1,0,285,1.8,0.07562051,0
2020-05-19-170406,170406,1,0,2,286,1.2,0.044679485,1
2020-05-20-170406,170406,0,0,0,286,1.0,0.0493743,2
2020-05-21-170406,170406,0,0,2,286,1.4,0.04808955,3
2020-05-22-170406,170406,4,0,1,290,1.6,0.09105526,4
2020-05-23-170406,170406,0,0,1,290,0.4,0.016746745,5
2020-05-24-170406,170406,0,0,0,290,0.0,0.0016810889,6
2020-05-25-170406,170406,1,0,0,291,0.2,0.07589309,0
2020-05-26-170406,170406,0,0,5,291,2.6,0.09708274,1
2020-05-27-170406,170406,2,0,4,293,1.4,0.07683722,2
2020-05-28-170406,170406,0,0,1,293,2.4,0.11848519,3
2020-05-29-170406,170406,2,0,2,295,1.2,0.05597791,4
2020-05-30-170406,170406,0,0,0,295,0.2,0.01494851,5
2020-05-31-170406,170406,0,0,0,295,0.0,0.0010797803,6
2020-06-01-170406,170406,0,0,3,295,1.0,0.09980257,0
2020-06-02-170406,170406,2,0,2,297,0.8,0.061533723,1
2020-06-03-170406,170406,0,0,0,297,1.0,0.04621134,2
2020-06-04-170406,170406,2,0,3,299,0.6,0.029879548,3
2020-06-05-170406,170406,1,0,1,300,0.8,0.07262499,4
2020-06-06-170406,170406,1,0,0,301,0.4,0.010684953,5
2020-06-07-170406,170406,0,0,0,301,0.4,0.009413565,6
2020-06-08-170406,170406,0,0,2,301,0.4,0.03482952,0
2020-06-09-170406,170406,5,0,0,306,2.2,0.09279222,1
2020-06-10-170406,170406,4,0,4,310,0.6,0.054826517,2
2020-06-11-170406,170406,1,0,0,311,0.8,0.05556512,3
2020-06-12-170406,170406,2,0,1,313,0.6,0.04759327,4
2020-06-13-170406,170406,0,0,0,313,0.2,0.0046516596,5
2020-06-14-170406,170406,0,1,0,313,0.2,0.002770152,6
2020-06-15-170406,170406,3,0,1,316,1.0,0.04223415,0
2020-06-16-170406,170406,2,0,0,318,1.0,0.05201018,1
2020-06-17-170406,170406,0,0,3,318,1.6,0.0465445,2
2020-06-18-170406,170406,3,0,0,321,0.6,0.023062162,3
2020-06-19-170406,170406,1,0,0,322,0.2,0.016023735,4
2020-06-20-170406,170406,0,0,0,322,0.4,0.010213567,5
2020-06-21-170406,170406,0,0,0,322,0.2,0.0032557717,6
2020-06-22-170406,170406,2,0,1,324,1.2,0.04371669,0
2020-06-23-170406,170406,0,0,1,324,0.4,0.02591328,1
2020-06-24-170406,170406,4,0,0,328,1.4,0.05287829,2
2020-06-25-170406,170406,0,0,0,328,0.0,0.015129259,3
2020-06-26-170406,170406,1,0,0,329,0.2,0.019620975,4
2020-06-27-170406,170406,0,0,0,329,0.2,0.0051603494,5
2020-06-28-170406,170406,0,0,0,329,0.0,0.0007410256,6
2020-06-29-170406,170406,1,0,0,330,1.2,0.04529574,0
2020-06-30-170406,170406,0,0,0,330,1.0,0.031753063,1
2020-07-01-170406,170406,3,0,0,333,1.4,0.062010933,2
2020-07-02-170406,170406,0,0,1,333,0.6,0.025030931,3
2020-07-03-170406,170406,0,0,0,333,0.0,0.011159455,4
2020-07-04-170406,170406,0,0,0,333,0.0,0.0042096353,5
2020-07-05-170406,170406,0,0,0,333,0.2,0.008595416,6
2020-07-06-170406,170406,1,0,0,334,0.6,0.017425392,0
2020-07-07-170406,170406,1,0,2,335,0.4,0.03425087,1
2020-07-08-170406,170406,0,0,1,335,0.6,0.03413905,2
2020-07-09-170406,170406,0,0,0,335,0.4,0.015835913,3
2020-07-10-170406,170406,0,1,0,335,1.0,0.044047132,4
2020-07-11-170406,170406,0,0,1,335,0.0,0.00010320272,5
2020-07-12-170406,170406,0,0,0,335,0.0,0.00045086446,6
2020-07-13-170406,170406,0,0,1,335,1.0,0.04010017,0
2020-07-14-170406,170406,0,0,1,335,0.2,0.023714134,1
2020-07-15-170406,170406,0,0,1,335,0.6,0.02462598,2
2020-07-16-170406,170406,1,0,1,336,0.6,0.052941304,3
2020-07-17-170406,170406,0,0,1,336,0.0,0.007960845,4
2020-07-18-170406,170406,0,0,0,336,0.0,0.019981813,5
2020-07-19-170406,170406,0,0,0,336,0.0,0.054366756,6
2020-07-20-170406,170406,0,0,2,336,0.6,0.04144721,0
2020-07-21-170406,170406,2,0,1,338,1.6,0.06690624,1
2020-07-22-170406,170406,1,0,1,339,1.0,0.034139764,2
2020-07-23-170406,170406,0,0,0,339,0.6,0.050332323,3
2020-07-24-170406,170406,0,0,3,339,0.4,0.013085308,4
2020-07-25-170406,170406,1,0,0,340,0.0,0.009008855,5
2020-07-26-170406,170406,0,0,1,340,0.0,0.002211287,6
2020-07-27-170406,170406,1,0,5,341,0.8,0.019704903,0
2020-07-28-170406,170406,1,0,4,342,0.4,0.039710447,1
2020-07-29-170406,170406,1,0,5,343,1.2,0.037801646,2
2020-07-30-170406,170406,1,0,3,344,1.0,0.042377695,3
2020-07-31-170406,170406,1,1,0,345,0.8,0.024271553,4
2020-08-01-170406,170406,0,0,1,345,0.0,0.003022041,5
2020-08-02-170406,170406,0,0,1,345,0.0,0.0074240416,6
2020-08-03-170406,170406,2,0,2,347,1.0,0.038763955,0
2020-08-04-170406,170406,1,0,5,348,0.8,0.05759826,1
2020-08-05-170406,170406,1,0,5,349,0.8,0.072428256,2
2020-08-06-170406,170406,0,0,1,349,1.0,0.053803653,3
2020-08-07-170406,170406,3,0,2,352,1.2,0.12363334,4
2020-08-08-170406,170406,0,0,0,352,0.4,0.0168568,5
2020-08-09-170406,170406,1,0,0,353,0.6,0.022056766,6
2020-08-10-170406,170406,5,0,3,358,1.2,0.10409533,0
2020-08-11-170406,170406,4,0,2,362,1.0,0.05402536,1
2020-08-12-170406,170406,5,0,1,367,0.6,0.06748022,2
2020-08-13-170406,170406,3,0,3,370,1.2,0.052622363,3
2020-08-14-170406,170406,0,0,4,370,1.4,0.067046404,4
2020-08-15-170406,170406,1,0,2,371,0.0,0.03653739,5
2020-08-16-170406,170406,1,0,0,372,0.6,0.028309433,6
2020-08-17-170406,170406,2,0,0,374,1.2,0.043060426,0
2020-08-18-170406,170406,5,0,2,379,1.2,0.10705821,1
2020-08-19-170406,170406,5,0,0,384,1.0,0.06011237,2
2020-08-20-170406,170406,1,0,2,385,1.4,0.09152357,3
2020-08-21-170406,170406,2,0,0,387,1.0,0.05106516,4
2020-08-22-170406,170406,0,0,1,387,1.4,0.05848651,5
2020-08-23-170406,170406,0,1,1,387,0.0,0.004928608,6
2020-08-24-170406,170406,3,0,2,390,1.8,0.060553215,0
2020-08-25-170406,170406,2,0,0,392,1.2,0.06871256,1
2020-08-26-170406,170406,1,0,0,393,1.8,0.20054102,2
2020-08-27-170406,170406,3,0,1,396,1.6,0.113607205,3
2020-08-28-170406,170406,4,0,1,400,1.8,0.12369294,4
2020-08-29-170406,170406,2,0,4,402,1.0,0.0649481,5
2020-08-30-170406,170406,0,0,2,402,0.2,0.027739538,6
2020-08-31-170406,170406,0,0,1,402,0.8,0.047347695,0
2020-09-01-170406,170406,2,0,2,404,2.2,0.1496186,1
2020-09-02-170406,170406,0,0,4,404,1.2,0.05177488,2
2020-09-03-170406,170406,2,0,2,406,0.6,0.14298278,3
2020-09-04-170406,170406,0,0,3,406,1.4,0.13852501,4
2020-09-05-170406,170406,1,0,3,407,1.2,0.05545005,5
2020-09-06-170406,170406,1,0,1,408,1.4,0.06208641,6
2020-09-07-170406,170406,2,0,7,410,2.0,0.096747704,0
2020-09-08-170406,170406,0,0,8,410,1.0,0.11009256,1
2020-09-09-170406,170406,0,0,8,410,0.6,0.055246264,2
2020-09-10-170406,170406,1,0,6,411,2.4,0.09681243,3
2020-09-11-170406,170406,1,0,3,412,3.4,0.16996297,4
2020-09-12-170406,170406,4,0,2,416,1.4,0.07602736,5
2020-09-13-170406,170406,2,0,1,418,0.8,0.049263593,6
2020-09-14-170406,170406,1,0,10,419,2.2,0.08408638,0
2020-09-15-170406,170406,2,0,6,421,2.8,0.16795292,1
2020-09-16-170406,170406,4,0,7,425,4.6,0.08765304,2
2020-09-17-170406,170406,2,0,14,427,5.6,0.21843486,3
2020-09-18-170406,170406,3,0,7,430,5.0,0.16996078,4
2020-09-19-170406,170406,3,0,1,433,2.6,0.091158606,5
2020-09-20-170406,170406,1,0,8,434,0.4,0.036931243,6
2020-09-21-170406,170406,7,1,12,441,3.2,0.15160652,0
2020-09-22-170406,170406,8,0,3,449,6.2,0.28606963,1
2020-09-23-170406,170406,8,0,9,457,4.8,0.18880136,2
2020-09-24-170406,170406,6,0,13,463,3.6,0.14995417,3
2020-09-25-170406,170406,3,0,9,466,3.0,0.15782648,4
2020-09-26-170406,170406,2,0,5,468,0.6,0.029771527,5
2020-09-27-170406,170406,1,0,4,469,1.6,0.073815845,6
2020-09-28-170406,170406,10,0,4,479,4.0,0.18755308,0
2020-09-29-170406,170406,6,0,13,485,3.4,0.18340468,1
2020-09-30-170406,170406,7,0,7,492,2.4,0.16339488,2
2020-10-01-170406,170406,14,0,2,506,5.8,0.31182143,3
2020-10-02-170406,170406,7,0,15,513,5.0,0.2585018,4
2020-10-03-170406,170406,1,1,14,514,1.2,0.09962855,5
2020-10-04-170406,170406,8,1,15,522,1.8,0.06206108,6
2020-10-05-170406,170406,12,1,5,534,7.4,0.370489,0
2020-10-06-170406,170406,3,0,10,537,5.4,0.22261032,1
2020-10-07-170406,170406,9,0,11,546,7.2,0.2962536,2
2020-10-08-170406,170406,13,3,14,559,6.8,0.30271554,3
2020-10-09-170406,170406,9,0,20,568,6.0,0.3231356,4
2020-10-10-170406,170406,5,0,9,573,11.6,0.41496426,5
2020-10-11-170406,170406,4,0,3,577,4.6,0.20191152,6
2020-10-12-170406,170406,4,0,12,581,4.4,0.13231531,0
2020-10-13-170406,170406,13,0,10,594,4.4,0.27135357,1
2020-10-14-170406,170406,7,0,9,601,5.8,0.25462022,2
2020-10-15-170406,170406,2,0,20,603,4.0,0.1923969,3
2020-10-16-170406,170406,15,0,21,618,11.0,0.3624102,4
2020-10-17-170406,170406,14,0,11,632,4.8,0.21309902,5
2020-10-18-170406,170406,15,0,11,647,5.0,0.17421456,6
2020-10-19-170406,170406,5,0,8,652,4.8,0.20807026,0
2020-10-20-170406,170406,10,0,13,662,10.4,0.42716923,1
2020-10-21-170406,170406,11,0,13,673,8.8,0.4019096,2
2020-10-22-170406,170406,14,0,14,687,9.8,0.4273756,3
2020-10-23-170406,170406,20,0,32,707,16.4,0.5418419,4
2020-10-24-170406,170406,9,0,3,716,7.6,0.22033393,5
2020-10-25-170406,170406,3,0,5,719,4.2,0.08542262,6
2020-10-26-170406,170406,12,0,7,731,8.2,0.40070522,0
2020-10-27-170406,170406,10,0,9,741,11.4,0.535889,1
2020-10-28-170406,170406,9,0,20,750,6.0,0.32052776,2
2020-10-29-170406,170406,20,0,11,770,10.2,0.5988099,3
2020-10-30-170406,170406,21,2,13,791,13.8,0.63096666,4
2020-10-31-170406,170406,11,1,0,802,13.6,0.53625965,5
2020-11-01-170406,170406,11,0,0,813,8.8,0.24603006,6
2020-11-02-170406,170406,8,0,0,821,5.4,0.23084503,0
2020-11-03-170406,170406,13,0,0,834,8.8,0.5455347,1
2020-11-04-170406,170406,13,1,0,847,10.6,0.55652946,2
2020-11-05-170406,170406,14,0,0,861,8.6,0.5454355,3
2020-11-06-170406,170406,32,1,0,893,15.8,0.58931756,4
2020-11-07-170406,170406,3,0,0,896,5.2,0.22783203,5
2020-11-08-170406,170406,5,1,0,901,6.2,0.14533068,6
2020-11-09-170406,170406,7,2,0,908,8.4,0.46877557,0
2020-11-10-170406,170406,9,0,0,917,6.8,0.28867927,1
2020-11-11-170406,170406,20,2,0,937,11.2,0.6821025,2
2020-11-12-170406,170406,11,0,0,948,5.8,0.3787272,3
2020-11-13-170406,170406,13,2,0,961,7.0,0.38942036,4
2020-03-01-170407,170407,0,0,1,0,0.0,6.139116e-10,6
2020-03-02-170407,170407,0,0,2,0,0.0,7.388231e-08,0
2020-03-03-170407,170407,0,0,0,0,0.0,8.109396e-10,1
2020-03-04-170407,170407,0,0,0,0,0.0,0.00029931727,2
2020-03-05-170407,170407,0,0,2,0,0.0,8.542464e-12,3
2020-03-06-170407,170407,0,3,3,0,0.2,0.0006594437,4
2020-03-07-170407,170407,0,0,1,0,0.0,0.0010218655,5
2020-03-08-170407,170407,0,0,0,0,0.0,0.00031787757,6
2020-03-09-170407,170407,0,0,7,0,0.0,0.0017305866,0
2020-03-10-170407,170407,0,0,5,0,0.2,0.0016092928,1
2020-03-11-170407,170407,0,0,2,0,0.0,0.00024851967,2
2020-03-12-170407,170407,0,0,3,0,0.4,0.0052556284,3
2020-03-13-170407,170407,0,0,3,0,0.4,0.00472377,4
2020-03-14-170407,170407,0,0,0,0,0.0,0.010148482,5
2020-03-15-170407,170407,1,0,2,1,0.4,0.016099833,6
2020-03-16-170407,170407,2,0,3,3,1.0,0.045886952,0
2020-03-17-170407,170407,0,0,0,3,3.2,0.12721741,1
2020-03-18-170407,170407,0,1,0,3,4.4,0.12123778,2
2020-03-19-170407,170407,2,0,2,5,3.8,0.13044196,3
2020-03-20-170407,170407,3,0,1,8,4.8,0.08918884,4
2020-03-21-170407,170407,1,0,0,9,2.8,0.030954605,5
2020-03-22-170407,170407,0,0,0,9,2.8,0.025183298,6
2020-03-23-170407,170407,7,0,0,16,5.8,0.14453408,0
2020-03-24-170407,170407,5,0,1,21,5.4,0.12584297,1
2020-03-25-170407,170407,2,0,0,23,7.6,0.15546232,2
2020-03-26-170407,170407,3,0,2,26,7.2,0.099340156,3
2020-03-27-170407,170407,3,1,1,29,8.6,0.08675348,4
2020-03-28-170407,170407,0,0,0,29,2.8,0.033904918,5
2020-03-29-170407,170407,2,0,0,31,2.4,0.0315619,6
2020-03-30-170407,170407,3,0,1,34,4.0,0.07639634,0
2020-03-31-170407,170407,0,0,2,34,4.8,0.071059056,1
2020-04-01-170407,170407,0,0,2,34,3.2,0.05055816,2
2020-04-02-170407,170407,2,0,0,36,4.2,0.06310611,3
2020-04-03-170407,170407,1,0,0,37,3.8,0.068262264,4
2020-04-04-170407,170407,0,0,0,37,3.2,0.027042326,5
2020-04-05-170407,170407,0,0,1,37,1.0,0.008075426,6
2020-04-06-170407,170407,0,1,3,37,3.6,0.0629389,0
2020-04-07-170407,170407,1,0,0,38,2.2,0.06558966,1
2020-04-08-170407,170407,0,0,0,38,3.0,0.044392772,2
2020-04-09-170407,170407,2,0,0,40,4.6,0.030482901,3
2020-04-10-170407,170407,1,0,0,41,2.4,0.03405838,4
2020-04-11-170407,170407,0,0,1,41,1.4,0.019452216,5
2020-04-12-170407,170407,0,0,0,41,0.6,0.01289047,6
2020-04-13-170407,170407,1,0,3,42,2.2,0.052959085,0
2020-04-14-170407,170407,2,0,2,44,3.2,0.046694398,1
2020-04-15-170407,170407,2,0,0,46,1.8,0.021286912,2
2020-04-16-170407,170407,0,0,1,46,2.0,0.022542085,3
2020-04-17-170407,170407,0,0,0,46,3.2,0.028662967,4
2020-04-18-170407,170407,0,0,0,46,1.0,0.006461877,5
2020-04-19-170407,170407,1,0,0,47,1.6,0.011356771,6
2020-04-20-170407,170407,3,0,3,50,3.4,0.034414705,0
2020-04-21-170407,170407,0,0,0,50,2.4,0.028579628,1
2020-04-22-170407,170407,0,0,1,50,3.8,0.047999084,2
2020-04-23-170407,170407,0,0,0,50,1.0,0.009665085,3
2020-04-24-170407,170407,0,0,0,50,3.2,0.046565596,4
2020-04-25-170407,170407,1,0,0,51,0.8,0.012821909,5
2020-04-26-170407,170407,0,0,0,51,1.0,0.0031577188,6
2020-04-27-170407,170407,3,0,4,54,2.8,0.030783279,0
2020-04-28-170407,170407,2,0,0,56,1.0,0.038797136,1
2020-04-29-170407,170407,0,1,0,56,3.8,0.022203157,2
2020-04-30-170407,170407,1,0,2,57,1.6,0.024437565,3
2020-05-01-170407,170407,0,0,2,57,1.0,0.004304747,4
2020-05-02-170407,170407,0,0,0,57,0.8,0.00571873,5
2020-05-03-170407,170407,0,0,0,57,0.8,0.0060094274,6
2020-05-04-170407,170407,3,0,0,60,2.8,0.031628985,0
2020-05-05-170407,170407,0,0,0,60,1.6,0.032638416,1
2020-05-06-170407,170407,1,0,0,61,0.6,0.01629455,2
2020-05-07-170407,170407,0,0,1,61,0.2,0.011005582,3
2020-05-08-170407,170407,0,0,0,61,2.8,0.032062534,4
2020-05-09-170407,170407,0,0,0,61,1.8,0.0130839115,5
2020-05-10-170407,170407,0,0,0,61,0.8,0.0116845565,6
2020-05-11-170407,170407,4,2,0,65,1.8,0.03434989,0
2020-05-12-170407,170407,0,0,1,65,1.6,0.027820652,1
2020-05-13-170407,170407,0,2,2,65,1.8,0.013359893,2
2020-05-14-170407,170407,2,0,1,67,1.4,0.013838162,3
2020-05-15-170407,170407,2,0,0,69,1.4,0.02164203,4
2020-05-16-170407,170407,0,0,0,69,0.2,0.0010999287,5
2020-05-17-170407,170407,0,0,0,69,0.2,0.0021727707,6
2020-05-18-170407,170407,0,0,1,69,0.8,0.024392495,0
2020-05-19-170407,170407,0,0,0,69,0.6,0.014913289,1
2020-05-20-170407,170407,0,0,0,69,0.6,0.015033921,2
2020-05-21-170407,170407,1,0,0,70,0.6,0.016127381,3
2020-05-22-170407,170407,0,0,0,70,1.4,0.0302753,4
2020-05-23-170407,170407,0,0,0,70,0.4,0.0021689837,5
2020-05-24-170407,170407,0,0,1,70,0.0,0.00024926214,6
2020-05-25-170407,170407,0,0,0,70,1.0,0.039757647,0
2020-05-26-170407,170407,1,0,1,71,0.8,0.028280685,1
2020-05-27-170407,170407,2,0,1,73,1.0,0.026995817,2
2020-05-28-170407,170407,1,1,0,74,1.4,0.036177363,3
2020-05-29-170407,170407,0,0,0,74,1.2,0.027043378,4
2020-05-30-170407,170407,0,0,0,74,0.2,0.007767265,5
2020-05-31-170407,170407,0,1,0,74,0.0,0.0001358204,6
2020-06-01-170407,170407,1,0,1,75,0.6,0.05308464,0
2020-06-02-170407,170407,0,1,0,75,1.2,0.016933825,1
2020-06-03-170407,170407,0,0,2,75,0.2,0.01329839,2
2020-06-04-170407,170407,0,0,0,75,0.6,0.014849216,3
2020-06-05-170407,170407,0,0,0,75,1.0,0.025460321,4
2020-06-06-170407,170407,0,3,1,75,0.2,0.0023918445,5
2020-06-07-170407,170407,1,0,0,76,0.0,0.003535118,6
2020-06-08-170407,170407,0,0,0,76,0.2,0.005183745,0
2020-06-09-170407,170407,1,0,0,77,2.2,0.014443563,1
2020-06-10-170407,170407,1,0,0,78,1.0,0.025987588,2
2020-06-11-170407,170407,0,0,0,78,1.0,0.012404582,3
2020-06-12-170407,170407,0,0,0,78,0.8,0.02089535,4
2020-06-13-170407,170407,0,0,0,78,0.0,0.0009767027,5
2020-06-14-170407,170407,0,0,0,78,0.0,0.00051654945,6
2020-06-15-170407,170407,1,0,0,79,0.6,0.0131589845,0
2020-06-16-170407,170407,0,0,0,79,1.2,0.016883608,1
2020-06-17-170407,170407,2,0,3,81,0.4,0.014031879,2
2020-06-18-170407,170407,0,0,0,81,0.8,0.004679988,3
2020-06-19-170407,170407,0,0,0,81,0.2,0.0031715103,4
2020-06-20-170407,170407,1,0,0,82,0.0,0.0033172057,5
2020-06-21-170407,170407,0,0,0,82,0.0,0.0007563021,6
2020-06-22-170407,170407,0,0,0,82,0.6,0.0087792985,0
2020-06-23-170407,170407,0,0,0,82,0.0,0.008260612,1
2020-06-24-170407,170407,0,1,1,82,1.2,0.015084247,2
2020-06-25-170407,170407,0,0,1,82,0.0,0.010889319,3
2020-06-26-170407,170407,0,0,0,82,0.4,0.0032091422,4
2020-06-27-170407,170407,0,0,0,82,0.0,0.0011716449,5
2020-06-28-170407,170407,0,0,0,82,0.0,1.3933208e-06,6
2020-06-29-170407,170407,0,0,1,82,0.2,0.010673977,0
2020-06-30-170407,170407,0,0,0,82,0.2,0.007258341,1
2020-07-01-170407,170407,3,0,0,85,1.0,0.019631268,2
2020-07-02-170407,170407,0,0,0,85,0.2,0.009168264,3
2020-07-03-170407,170407,0,0,0,85,0.0,0.003294233,4
2020-07-04-170407,170407,0,0,0,85,0.0,0.0011258267,5
2020-07-05-170407,170407,0,0,0,85,0.2,0.0008683425,6
2020-07-06-170407,170407,0,0,0,85,0.2,0.0036087385,0
2020-07-07-170407,170407,0,0,0,85,0.6,0.010192173,1
2020-07-08-170407,170407,1,0,3,86,0.4,0.0128584495,2
2020-07-09-170407,170407,1,0,0,87,0.0,0.009948133,3
2020-07-10-170407,170407,0,1,0,87,0.2,0.013749897,4
2020-07-11-170407,170407,0,0,0,87,0.0,0.000121540186,5
2020-07-12-170407,170407,0,0,0,87,0.0,0.0002523584,6
2020-07-13-170407,170407,1,0,0,88,0.4,0.013744483,0
2020-07-14-170407,170407,0,0,0,88,0.2,0.010103787,1
2020-07-15-170407,170407,0,0,0,88,0.0,0.004594002,2
2020-07-16-170407,170407,0,0,0,88,0.8,0.016900424,3
2020-07-17-170407,170407,0,0,0,88,0.0,0.002103203,4
2020-07-18-170407,170407,0,0,0,88,0.2,0.011771731,5
2020-07-19-170407,170407,0,0,0,88,0.8,0.028571205,6
2020-07-20-170407,170407,0,0,2,88,0.2,0.013006153,0
2020-07-21-170407,170407,0,0,0,88,1.4,0.023662815,1
2020-07-22-170407,170407,3,0,0,91,0.4,0.010759751,2
2020-07-23-170407,170407,0,0,1,91,0.4,0.022027653,3
2020-07-24-170407,170407,0,0,0,91,0.0,0.0060943775,4
2020-07-25-170407,170407,0,0,0,91,0.2,0.0019840281,5
2020-07-26-170407,170407,0,0,0,91,0.0,0.0010729431,6
2020-07-27-170407,170407,0,0,0,91,0.2,0.0045248796,0
2020-07-28-170407,170407,0,0,1,91,0.6,0.01442278,1
2020-07-29-170407,170407,0,0,0,91,0.2,0.005455234,2
2020-07-30-170407,170407,0,0,0,91,0.4,0.007769972,3
2020-07-31-170407,170407,0,0,0,91,0.4,0.0055648508,4
2020-08-01-170407,170407,0,1,0,91,0.0,0.0031018378,5
2020-08-02-170407,170407,0,0,0,91,0.0,0.0020242154,6
2020-08-03-170407,170407,2,0,0,93,0.4,0.015140569,0
2020-08-04-170407,170407,0,0,0,93,0.2,0.025282092,1
2020-08-05-170407,170407,0,0,0,93,0.4,0.029049944,2
2020-08-06-170407,170407,1,0,0,94,0.6,0.037830107,3
2020-08-07-170407,170407,0,0,1,94,1.6,0.03919391,4
2020-08-08-170407,170407,0,0,0,94,0.2,0.0038762102,5
2020-08-09-170407,170407,0,1,0,94,0.2,0.019007761,6
2020-08-10-170407,170407,0,0,0,94,1.6,0.031075425,0
2020-08-11-170407,170407,1,0,0,95,1.8,0.019261211,1
2020-08-12-170407,170407,0,0,0,95,1.2,0.028167682,2
2020-08-13-170407,170407,0,0,0,95,1.0,0.008758298,3
2020-08-14-170407,170407,0,0,0,95,1.0,0.024918152,4
2020-08-15-170407,170407,0,0,0,95,0.6,0.041424427,5
2020-08-16-170407,170407,0,0,0,95,0.8,0.006570085,6
2020-08-17-170407,170407,0,0,0,95,0.8,0.0074607786,0
2020-08-18-170407,170407,0,0,0,95,2.4,0.031192107,1
2020-08-19-170407,170407,0,0,0,95,1.6,0.0158089,2
2020-08-20-170407,170407,0,0,0,95,1.0,0.016509756,3
2020-08-21-170407,170407,1,0,0,96,0.8,0.027541047,4
2020-08-22-170407,170407,0,0,0,96,0.8,0.026427357,5
2020-08-23-170407,170407,0,0,0,96,0.0,0.003428372,6
2020-08-24-170407,170407,0,0,0,96,1.0,0.017302014,0
2020-08-25-170407,170407,0,0,0,96,0.8,0.02352446,1
2020-08-26-170407,170407,0,0,0,96,0.6,0.13306668,2
2020-08-27-170407,170407,0,0,0,96,2.0,0.05707104,3
2020-08-28-170407,170407,0,0,0,96,2.0,0.06404176,4
2020-08-29-170407,170407,0,0,1,96,1.2,0.022129785,5
2020-08-30-170407,170407,0,0,0,96,0.0,0.048971977,6
2020-08-31-170407,170407,0,0,0,96,0.4,0.011650668,0
2020-09-01-170407,170407,0,0,0,96,1.2,0.05724133,1
2020-09-02-170407,170407,0,0,0,96,0.6,0.011936038,2
2020-09-03-170407,170407,0,0,0,96,1.0,0.09042456,3
2020-09-04-170407,170407,0,0,0,96,0.8,0.05394334,4
2020-09-05-170407,170407,0,0,0,96,0.8,0.012912075,5
2020-09-06-170407,170407,0,0,0,96,1.2,0.020466628,6
2020-09-07-170407,170407,0,0,1,96,2.0,0.012188416,0
2020-09-08-170407,170407,0,0,1,96,1.6,0.052677155,1
2020-09-09-170407,170407,0,0,1,96,0.8,0.040477324,2
2020-09-10-170407,170407,0,0,2,96,1.4,0.024495054,3
2020-09-11-170407,170407,0,0,1,96,1.2,0.051594604,4
2020-09-12-170407,170407,1,0,0,97,1.6,0.02420359,5
2020-09-13-170407,170407,0,0,0,97,0.8,0.011857586,6
2020-09-14-170407,170407,0,0,1,97,1.0,0.018569395,0
2020-09-15-170407,170407,0,0,1,97,2.4,0.08874801,1
2020-09-16-170407,170407,0,0,2,97,2.8,0.02143069,2
2020-09-17-170407,170407,0,0,1,97,3.8,0.05868272,3
2020-09-18-170407,170407,0,0,0,97,3.0,0.04426996,4
2020-09-19-170407,170407,0,0,0,97,1.6,0.012386871,5
2020-09-20-170407,170407,0,0,0,97,0.6,0.014006816,6
2020-09-21-170407,170407,1,0,0,98,4.2,0.06511315,0
2020-09-22-170407,170407,1,0,0,99,5.2,0.06641435,1
2020-09-23-170407,170407,1,0,0,100,3.8,0.042816445,2
2020-09-24-170407,170407,2,1,0,102,3.0,0.059024177,3
2020-09-25-170407,170407,1,0,0,103,4.0,0.05893869,4
2020-09-26-170407,170407,0,1,0,103,0.6,0.010763272,5
2020-09-27-170407,170407,0,0,0,103,1.2,0.020819644,6
2020-09-28-170407,170407,1,0,0,104,3.6,0.05390167,0
2020-09-29-170407,170407,1,0,1,105,3.0,0.04746051,1
2020-09-30-170407,170407,2,0,1,107,3.0,0.060141563,2
2020-10-01-170407,170407,1,0,0,108,6.4,0.07015659,3
2020-10-02-170407,170407,0,0,1,108,5.2,0.057217848,4
2020-10-03-170407,170407,0,0,0,108,1.0,0.025656376,5
2020-10-04-170407,170407,0,0,0,108,2.2,0.013771709,6
2020-10-05-170407,170407,0,0,1,108,7.2,0.054203358,0
2020-10-06-170407,170407,0,0,2,108,2.8,0.043869916,1
2020-10-07-170407,170407,0,0,1,108,6.2,0.05325244,2
2020-10-08-170407,170407,0,1,0,108,5.6,0.047973964,3
2020-10-09-170407,170407,0,0,0,108,5.0,0.087275945,4
2020-10-10-170407,170407,0,0,1,108,10.2,0.11158979,5
2020-10-11-170407,170407,0,0,0,108,4.0,0.07772817,6
2020-10-12-170407,170407,0,0,1,108,2.6,0.04774733,0
2020-10-13-170407,170407,1,0,2,109,5.6,0.06418585,1
2020-10-14-170407,170407,1,0,2,110,3.0,0.07760886,2
2020-10-15-170407,170407,0,0,3,110,1.8,0.056756493,3
2020-10-16-170407,170407,1,0,4,111,5.8,0.08418789,4
2020-10-17-170407,170407,0,0,0,111,4.2,0.053680453,5
2020-10-18-170407,170407,0,0,1,111,5.2,0.045917775,6
2020-10-19-170407,170407,1,0,0,112,3.2,0.0554111,0
2020-10-20-170407,170407,2,0,1,114,6.4,0.09928862,1
2020-10-21-170407,170407,1,0,1,115,7.0,0.08996671,2
2020-10-22-170407,170407,0,0,0,115,8.4,0.10416013,3
2020-10-23-170407,170407,0,0,1,115,12.2,0.09788472,4
2020-10-24-170407,170407,1,0,0,116,5.4,0.048393097,5
2020-10-25-170407,170407,0,0,0,116,2.0,0.021643277,6
2020-10-26-170407,170407,1,0,4,117,7.6,0.071984306,0
2020-10-27-170407,170407,2,0,3,119,9.4,0.11252438,1
2020-10-28-170407,170407,2,0,1,121,3.8,0.08680294,2
2020-10-29-170407,170407,3,0,0,124,9.2,0.13661468,3
2020-10-30-170407,170407,4,1,0,128,13.0,0.15788577,4
2020-10-31-170407,170407,0,0,0,128,13.8,0.18727659,5
2020-11-01-170407,170407,1,0,0,129,7.2,0.053619027,6
2020-11-02-170407,170407,0,0,0,129,6.2,0.052833833,0
2020-11-03-170407,170407,1,0,0,130,8.6,0.15728414,1
2020-11-04-170407,170407,1,0,0,131,9.2,0.12553957,2
2020-11-05-170407,170407,0,0,0,131,10.0,0.17817992,3
2020-11-06-170407,170407,1,0,0,132,16.2,0.123513,4
2020-11-07-170407,170407,0,0,0,132,3.8,0.06312947,5
2020-11-08-170407,170407,0,0,0,132,4.6,0.03929915,6
2020-11-09-170407,170407,4,0,0,136,7.4,0.1653871,0
2020-11-10-170407,170407,3,0,0,139,5.2,0.09341668,1
2020-11-11-170407,170407,1,0,0,140,13.0,0.19412799,2
2020-11-12-170407,170407,0,0,0,140,6.8,0.10969613,3
2020-11-13-170407,170407,0,0,0,140,7.4,0.095038764,4
2020-03-01-170408,170408,0,0,0,0,0.0,9.5133364e-05,6
2020-03-02-170408,170408,0,0,0,0,0.0,2.6133699e-05,0
2020-03-03-170408,170408,0,0,0,0,0.0,0.0,1
2020-03-04-170408,170408,0,0,1,0,0.0,1.0884671e-09,2
2020-03-05-170408,170408,0,0,1,0,0.0,0.00036181067,3
2020-03-06-170408,170408,0,1,0,0,0.14285714285714285,0.0030791312,4
2020-03-07-170408,170408,0,1,1,0,0.0,0.0003668961,5
2020-03-08-170408,170408,0,0,0,0,0.0,0.0001331394,6
2020-03-09-170408,170408,0,1,1,0,0.0,0.0006036329,0
2020-03-10-170408,170408,0,0,3,0,0.14285714285714285,0.0021529256,1
2020-03-11-170408,170408,0,0,2,0,0.14285714285714285,0.00037222911,2
2020-03-12-170408,170408,0,0,0,0,0.5714285714285714,0.0103352405,3
2020-03-13-170408,170408,0,0,0,0,0.2857142857142857,0.009432201,4
2020-03-14-170408,170408,0,0,0,0,0.2857142857142857,0.04335958,5
2020-03-15-170408,170408,0,0,0,0,0.2857142857142857,0.030674132,6
2020-03-16-170408,170408,0,0,0,0,2.7142857142857144,0.07338285,0
2020-03-17-170408,170408,0,0,0,0,2.4285714285714284,0.3021011,1
2020-03-18-170408,170408,1,0,0,1,5.571428571428571,0.26773033,2
2020-03-19-170408,170408,1,0,1,2,6.2857142857142865,0.3448062,3
2020-03-20-170408,170408,0,0,0,2,4.285714285714286,0.19814083,4
2020-03-21-170408,170408,1,0,1,3,3.0,0.06572949,5
2020-03-22-170408,170408,0,0,0,3,4.142857142857143,0.13960089,6
2020-03-23-170408,170408,1,0,0,4,6.2857142857142865,0.31067374,0
2020-03-24-170408,170408,3,0,0,7,9.285714285714286,0.43285626,1
2020-03-25-170408,170408,2,0,0,9,9.285714285714286,0.4678583,2
2020-03-26-170408,170408,0,1,0,9,7.7142857142857135,0.34790888,3
2020-03-27-170408,170408,0,0,0,9,7.0,0.2137672,4
2020-03-28-170408,170408,0,1,0,9,3.4285714285714284,0.10207311,5
2020-03-29-170408,170408,0,0,1,9,4.857142857142857,0.10589677,6
2020-03-30-170408,170408,0,0,0,9,7.0,0.22554794,0
2020-03-31-170408,170408,0,0,1,9,5.0,0.22256911,1
2020-04-01-170408,170408,0,0,0,9,4.285714285714286,0.14350682,2
2020-04-02-170408,170408,1,0,0,10,5.428571428571429,0.1768538,3
2020-04-03-170408,170408,0,0,0,10,4.857142857142857,0.1611719,4
2020-04-04-170408,170408,1,0,0,11,4.142857142857143,0.13988529,5
2020-04-05-170408,170408,0,1,0,11,1.7142857142857142,0.027785841,6
2020-04-06-170408,170408,0,0,0,11,5.571428571428571,0.20636478,0
2020-04-07-170408,170408,0,0,0,11,3.2857142857142856,0.20413986,1
2020-04-08-170408,170408,0,0,1,11,3.8571428571428568,0.14167097,2
2020-04-09-170408,170408,0,0,0,11,6.2857142857142865,0.13366483,3
2020-04-10-170408,170408,0,0,0,11,3.2857142857142856,0.07643183,4
2020-04-11-170408,170408,0,0,0,11,1.8571428571428568,0.095151864,5
2020-04-12-170408,170408,1,0,0,12,0.42857142857142855,0.03130091,6
2020-04-13-170408,170408,0,0,0,12,3.0,0.20759565,0
2020-04-14-170408,170408,1,0,0,13,4.571428571428571,0.18657441,1
2020-04-15-170408,170408,0,1,0,13,2.2857142857142856,0.07548793,2
2020-04-16-170408,170408,0,0,0,13,3.7142857142857135,0.10773791,3
2020-04-17-170408,170408,0,0,0,13,3.1428571428571432,0.086576976,4
2020-04-18-170408,170408,0,0,0,13,1.0,0.035834413,5
2020-04-19-170408,170408,0,0,0,13,0.8571428571428571,0.021301044,6
2020-04-20-170408,170408,0,0,0,13,3.4285714285714284,0.09149087,0
2020-04-21-170408,170408,0,0,0,13,3.0,0.114419855,1
2020-04-22-170408,170408,1,0,0,14,2.4285714285714284,0.14482693,2
2020-04-23-170408,170408,0,0,0,14,2.8571428571428568,0.24627264,3
2020-04-24-170408,170408,0,0,1,14,3.7142857142857135,0.19478342,4
2020-04-25-170408,170408,0,0,0,14,1.2857142857142858,0.03837219,5
2020-04-26-170408,170408,0,0,0,14,1.1428571428571428,0.013427191,6
2020-04-27-170408,170408,0,0,0,14,3.0,0.15325816,0
2020-04-28-170408,170408,0,0,0,14,1.2857142857142858,0.12552004,1
2020-04-29-170408,170408,0,1,0,14,3.4285714285714284,0.09406907,2
2020-04-30-170408,170408,0,0,0,14,2.571428571428572,0.17113765,3
2020-05-01-170408,170408,0,0,0,14,1.5714285714285714,0.045005877,4
2020-05-02-170408,170408,0,0,0,14,0.8571428571428571,0.02604011,5
2020-05-03-170408,170408,0,0,0,14,0.7142857142857143,0.027157001,6
2020-05-04-170408,170408,0,0,0,14,3.4285714285714284,0.09445935,0
2020-05-05-170408,170408,0,0,0,14,1.4285714285714286,0.12230888,1
2020-05-06-170408,170408,0,0,1,14,2.8571428571428568,0.1962549,2
2020-05-07-170408,170408,0,0,1,14,1.5714285714285714,0.06233818,3
2020-05-08-170408,170408,1,0,0,15,2.142857142857143,0.11580916,4
2020-05-09-170408,170408,0,0,0,15,1.8571428571428568,0.05484951,5
2020-05-10-170408,170408,0,2,0,15,0.5714285714285714,0.021748923,6
2020-05-11-170408,170408,0,0,0,15,1.5714285714285714,0.117649525,0
2020-05-12-170408,170408,0,0,0,15,2.4285714285714284,0.11382327,1
2020-05-13-170408,170408,0,1,0,15,1.4285714285714286,0.053830847,2
2020-05-14-170408,170408,0,0,0,15,1.0,0.02720446,3
2020-05-15-170408,170408,0,0,0,15,3.0,0.10678337,4
2020-05-16-170408,170408,0,0,0,15,0.14285714285714285,0.0004012557,5
2020-05-17-170408,170408,0,0,0,15,0.7142857142857143,0.015475267,6
2020-05-18-170408,170408,0,0,0,15,1.8571428571428568,0.110427834,0
2020-05-19-170408,170408,0,0,1,15,1.1428571428571428,0.04695823,1
2020-05-20-170408,170408,1,0,0,16,1.0,0.06468317,2
2020-05-21-170408,170408,1,0,0,17,1.1428571428571428,0.052518867,3
2020-05-22-170408,170408,0,0,0,17,2.142857142857143,0.1256934,4
2020-05-23-170408,170408,0,0,0,17,0.2857142857142857,0.005505511,5
2020-05-24-170408,170408,0,0,0,17,0.14285714285714285,0.009208932,6
2020-05-25-170408,170408,0,0,0,17,0.5714285714285714,0.11140694,0
2020-05-26-170408,170408,0,0,0,17,1.1428571428571428,0.09660951,1
2020-05-27-170408,170408,0,0,0,17,2.2857142857142856,0.15015063,2
2020-05-28-170408,170408,0,3,0,17,2.4285714285714284,0.1563032,3
2020-05-29-170408,170408,0,0,0,17,2.0,0.11638831,4
2020-05-30-170408,170408,0,0,0,17,0.14285714285714285,0.011790067,5
2020-05-31-170408,170408,0,1,0,17,0.0,0.00021490005,6
2020-06-01-170408,170408,0,0,0,17,0.7142857142857143,0.14877155,0
2020-06-02-170408,170408,1,0,0,18,1.5714285714285714,0.10448366,1
2020-06-03-170408,170408,0,0,0,18,1.2857142857142858,0.08251035,2
2020-06-04-170408,170408,0,0,0,18,1.0,0.040174954,3
2020-06-05-170408,170408,0,4,0,18,1.1428571428571428,0.08863614,4
2020-06-06-170408,170408,0,0,0,18,0.0,0.0032816383,5
2020-06-07-170408,170408,0,1,0,18,0.42857142857142855,0.022850966,6
2020-06-08-170408,170408,0,0,0,18,1.5714285714285714,0.08757784,0
2020-06-09-170408,170408,0,0,0,18,2.2857142857142856,0.071388036,1
2020-06-10-170408,170408,0,0,0,18,0.8571428571428571,0.1489193,2
2020-06-11-170408,170408,0,0,0,18,1.0,0.05684314,3
2020-06-12-170408,170408,0,0,0,18,1.0,0.071935445,4
2020-06-13-170408,170408,0,0,0,18,0.0,0.0014291753,5
2020-06-14-170408,170408,0,1,0,18,0.14285714285714285,0.0008445907,6
2020-06-15-170408,170408,0,0,0,18,1.1428571428571428,0.085546315,0
2020-06-16-170408,170408,0,0,0,18,1.4285714285714286,0.053688943,1
2020-06-17-170408,170408,0,0,0,18,1.2857142857142858,0.037250742,2
2020-06-18-170408,170408,0,0,0,18,0.42857142857142855,0.007822353,3
2020-06-19-170408,170408,0,0,0,18,0.5714285714285714,0.038220115,4
2020-06-20-170408,170408,0,0,0,18,0.14285714285714285,0.014077378,5
2020-06-21-170408,170408,0,0,0,18,0.14285714285714285,0.0009282806,6
2020-06-22-170408,170408,0,0,0,18,1.0,0.05300913,0
2020-06-23-170408,170408,0,0,0,18,1.2857142857142858,0.073200226,1
2020-06-24-170408,170408,0,0,0,18,0.8571428571428571,0.039012685,2
2020-06-25-170408,170408,0,0,0,18,0.5714285714285714,0.053409044,3
2020-06-26-170408,170408,0,0,0,18,0.42857142857142855,0.030605013,4
2020-06-27-170408,170408,0,0,0,18,0.0,0.0019096085,5
2020-06-28-170408,170408,0,0,0,18,0.14285714285714285,3.368689e-09,6
2020-06-29-170408,170408,0,0,0,18,1.2857142857142858,0.098389566,0
2020-06-30-170408,170408,0,0,0,18,1.1428571428571428,0.041983817,1
2020-07-01-170408,170408,0,0,1,18,0.42857142857142855,0.07291033,2
2020-07-02-170408,170408,0,1,0,18,0.42857142857142855,0.01834903,3
2020-07-03-170408,170408,0,0,0,18,0.5714285714285714,0.038337857,4
2020-07-04-170408,170408,0,0,0,18,0.2857142857142857,0.038526073,5
2020-07-05-170408,170408,0,0,0,18,0.14285714285714285,0.0032693865,6
2020-07-06-170408,170408,0,0,0,18,0.42857142857142855,0.028408699,0
2020-07-07-170408,170408,0,0,0,18,0.42857142857142855,0.027217668,1
2020-07-08-170408,170408,0,0,0,18,0.5714285714285714,0.03028497,2
2020-07-09-170408,170408,0,0,0,18,0.5714285714285714,0.04544938,3
2020-07-10-170408,170408,0,0,0,18,0.5714285714285714,0.03174771,4
2020-07-11-170408,170408,0,0,0,18,0.0,0.00015236986,5
2020-07-12-170408,170408,0,0,0,18,0.0,0.00029563648,6
2020-07-13-170408,170408,0,0,0,18,1.1428571428571428,0.12793882,0
2020-07-14-170408,170408,0,0,0,18,0.5714285714285714,0.024504842,1
2020-07-15-170408,170408,1,0,0,19,1.0,0.06410319,2
2020-07-16-170408,170408,0,0,0,19,0.8571428571428571,0.0702462,3
2020-07-17-170408,170408,0,0,0,19,0.2857142857142857,0.03411946,4
2020-07-18-170408,170408,0,0,0,19,0.14285714285714285,0.032015994,5
2020-07-19-170408,170408,0,0,0,19,0.14285714285714285,0.04856258,6
2020-07-20-170408,170408,0,0,0,19,1.0,0.06430695,0
2020-07-21-170408,170408,0,0,0,19,1.2857142857142858,0.048465483,1
2020-07-22-170408,170408,0,0,0,19,0.5714285714285714,0.05152782,2
2020-07-23-170408,170408,0,0,0,19,1.0,0.06960352,3
2020-07-24-170408,170408,0,0,0,19,0.5714285714285714,0.016125672,4
2020-07-25-170408,170408,0,0,0,19,0.42857142857142855,0.03628767,5
2020-07-26-170408,170408,0,0,0,19,0.14285714285714285,0.024318596,6
2020-07-27-170408,170408,0,0,0,19,0.42857142857142855,0.0073937573,0
2020-07-28-170408,170408,0,0,0,19,0.7142857142857143,0.06448887,1
2020-07-29-170408,170408,0,0,0,19,1.0,0.059288237,2
2020-07-30-170408,170408,0,0,1,19,1.0,0.07226797,3
2020-07-31-170408,170408,0,0,0,19,0.5714285714285714,0.029806936,4
2020-08-01-170408,170408,0,0,0,19,0.0,0.021208197,5
2020-08-02-170408,170408,0,0,0,19,0.42857142857142855,0.042313196,6
2020-08-03-170408,170408,0,0,0,19,0.8571428571428571,0.06602115,0
2020-08-04-170408,170408,0,0,1,19,1.2857142857142858,0.10590741,1
2020-08-05-170408,170408,0,0,0,19,1.7142857142857142,0.17870815,2
2020-08-06-170408,170408,0,0,0,19,0.8571428571428571,0.05839367,3
2020-08-07-170408,170408,0,0,0,19,1.8571428571428568,0.12184295,4
2020-08-08-170408,170408,0,0,0,19,0.2857142857142857,0.024628483,5
2020-08-09-170408,170408,0,1,0,19,0.2857142857142857,0.009492352,6
2020-08-10-170408,170408,0,0,1,19,1.7142857142857142,0.17907915,0
2020-08-11-170408,170408,0,0,0,19,1.0,0.05732002,1
2020-08-12-170408,170408,0,0,0,19,1.7142857142857142,0.11569497,2
2020-08-13-170408,170408,1,0,1,20,1.1428571428571428,0.048550207,3
2020-08-14-170408,170408,0,0,0,20,0.8571428571428571,0.04566137,4
2020-08-15-170408,170408,0,0,0,20,0.14285714285714285,0.043017656,5
2020-08-16-170408,170408,0,0,0,20,0.7142857142857143,0.026548592,6
2020-08-17-170408,170408,0,0,0,20,0.7142857142857143,0.04590924,0
2020-08-18-170408,170408,1,0,0,21,1.7142857142857142,0.108359344,1
2020-08-19-170408,170408,0,0,0,21,1.0,0.09415664,2
2020-08-20-170408,170408,0,0,0,21,1.7142857142857142,0.08861267,3
2020-08-21-170408,170408,0,0,0,21,0.42857142857142855,0.04150955,4
2020-08-22-170408,170408,0,0,0,21,1.4285714285714286,0.062128738,5
2020-08-23-170408,170408,0,0,0,21,0.14285714285714285,0.014298711,6
2020-08-24-170408,170408,1,0,0,22,1.4285714285714286,0.12829977,0
2020-08-25-170408,170408,0,0,0,22,1.8571428571428568,0.12539631,1
2020-08-26-170408,170408,0,0,0,22,0.5714285714285714,0.27348652,2
2020-08-27-170408,170408,1,0,1,23,1.7142857142857142,0.15407838,3
2020-08-28-170408,170408,0,0,1,23,1.0,0.18659902,4
2020-08-29-170408,170408,0,0,0,23,1.2857142857142858,0.08643753,5
2020-08-30-170408,170408,0,0,1,23,0.7142857142857143,0.028775977,6
2020-08-31-170408,170408,0,0,0,23,1.2857142857142858,0.07300077,0
2020-09-01-170408,170408,0,0,1,23,1.5714285714285714,0.17019497,1
2020-09-02-170408,170408,0,0,3,23,1.4285714285714286,0.07212241,2
2020-09-03-170408,170408,0,0,0,23,0.7142857142857143,0.17191078,3
2020-09-04-170408,170408,0,0,2,23,1.7142857142857142,0.15465845,4
2020-09-05-170408,170408,0,0,1,23,1.5714285714285714,0.052759048,5
2020-09-06-170408,170408,0,0,2,23,2.0,0.10655663,6
2020-09-07-170408,170408,0,0,1,23,1.5714285714285714,0.050585624,0
2020-09-08-170408,170408,0,0,3,23,0.7142857142857143,0.06255475,1
2020-09-09-170408,170408,0,0,0,23,0.42857142857142855,0.044869304,2
2020-09-10-170408,170408,1,0,2,24,2.0,0.06630056,3
2020-09-11-170408,170408,1,0,1,25,2.4285714285714284,0.1267591,4
2020-09-12-170408,170408,0,0,0,25,0.8571428571428571,0.04517427,5
2020-09-13-170408,170408,1,0,0,26,1.4285714285714286,0.12514772,6
2020-09-14-170408,170408,0,0,3,26,1.5714285714285714,0.04144294,0
2020-09-15-170408,170408,1,0,1,27,2.0,0.17363323,1
2020-09-16-170408,170408,3,0,0,30,2.8571428571428568,0.1517227,2
2020-09-17-170408,170408,0,0,1,30,4.428571428571429,0.18071455,3
2020-09-18-170408,170408,2,0,4,32,3.4285714285714284,0.17848346,4
2020-09-19-170408,170408,1,0,2,33,2.2857142857142856,0.13138922,5
2020-09-20-170408,170408,2,0,1,35,0.5714285714285714,0.08575798,6
2020-09-21-170408,170408,1,1,1,36,3.0,0.21031824,0
2020-09-22-170408,170408,3,0,1,39,5.142857142857143,0.28338742,1
2020-09-23-170408,170408,0,0,1,39,3.571428571428572,0.16400334,2
2020-09-24-170408,170408,2,0,0,41,3.0,0.14408104,3
2020-09-25-170408,170408,1,0,3,42,4.428571428571429,0.1961226,4
2020-09-26-170408,170408,0,0,2,42,1.1428571428571428,0.0687977,5
2020-09-27-170408,170408,0,0,1,42,3.0,0.13300158,6
2020-09-28-170408,170408,3,0,2,45,4.571428571428571,0.28382078,0
2020-09-29-170408,170408,1,0,1,46,3.1428571428571432,0.20133975,1
2020-09-30-170408,170408,0,0,0,46,2.7142857142857144,0.18085499,2
2020-10-01-170408,170408,1,0,0,47,5.571428571428571,0.31752077,3
2020-10-02-170408,170408,4,0,0,51,6.428571428571429,0.41090417,4
2020-10-03-170408,170408,2,0,0,53,2.4285714285714284,0.18973103,5
2020-10-04-170408,170408,1,0,0,54,2.0,0.0995758,6
2020-10-05-170408,170408,1,0,0,55,6.2857142857142865,0.2182658,0
2020-10-06-170408,170408,1,0,4,56,3.7142857142857135,0.14540383,1
2020-10-07-170408,170408,1,2,0,57,5.571428571428571,0.12430247,2
2020-10-08-170408,170408,0,1,1,57,5.857142857142858,0.18496847,3
2020-10-09-170408,170408,3,1,2,60,4.571428571428571,0.33051023,4
2020-10-10-170408,170408,2,0,0,62,8.857142857142858,0.34445432,5
2020-10-11-170408,170408,1,0,0,63,4.857142857142857,0.39500546,6
2020-10-12-170408,170408,2,0,1,65,6.857142857142858,0.50516444,0
2020-10-13-170408,170408,1,0,1,66,4.0,0.2168626,1
2020-10-14-170408,170408,0,0,3,66,4.857142857142857,0.24274807,2
2020-10-15-170408,170408,0,0,1,66,4.142857142857143,0.282721,3
2020-10-16-170408,170408,0,0,1,66,7.857142857142858,0.2639051,4
2020-10-17-170408,170408,0,0,1,66,5.857142857142858,0.32822353,5
2020-10-18-170408,170408,0,0,3,66,3.571428571428572,0.14566362,6
2020-10-19-170408,170408,0,0,0,66,4.857142857142857,0.12840575,0
2020-10-20-170408,170408,4,0,6,70,7.428571428571429,0.34652212,1
2020-10-21-170408,170408,0,0,6,70,9.142857142857142,0.34266856,2
2020-10-22-170408,170408,1,0,2,71,10.571428571428571,0.6691155,3
2020-10-23-170408,170408,2,0,1,73,11.714285714285715,0.39809856,4
2020-10-24-170408,170408,0,0,0,73,5.142857142857143,0.13409159,5
2020-10-25-170408,170408,0,1,0,73,3.7142857142857135,0.06406871,6
2020-10-26-170408,170408,1,1,5,74,7.142857142857142,0.29909098,0
2020-10-27-170408,170408,1,0,1,75,8.857142857142858,0.32801566,1
2020-10-28-170408,170408,3,1,2,78,8.285714285714286,0.5785792,2
2020-10-29-170408,170408,1,0,0,79,10.857142857142858,0.675044,3
2020-10-30-170408,170408,1,0,0,80,12.714285714285715,0.58066773,4
2020-10-31-170408,170408,1,1,0,81,10.571428571428571,0.4850019,5
2020-11-01-170408,170408,3,0,0,84,7.428571428571429,0.32043046,6
2020-11-02-170408,170408,0,0,0,84,5.7142857142857135,0.2800948,0
2020-11-03-170408,170408,6,0,0,90,8.571428571428571,0.65962195,1
2020-11-04-170408,170408,6,0,0,96,10.714285714285714,0.7719273,2
2020-11-05-170408,170408,2,0,0,98,7.142857142857142,0.3721741,3
2020-11-06-170408,170408,1,1,0,99,12.857142857142858,0.402004,4
2020-11-07-170408,170408,0,0,0,99,6.2857142857142865,0.36187264,5
2020-11-08-170408,170408,0,0,0,99,5.142857142857143,0.15414171,6
2020-11-09-170408,170408,5,0,0,104,7.142857142857142,0.44637972,0
2020-11-10-170408,170408,1,0,0,105,7.2857142857142865,0.38281012,1
2020-11-11-170408,170408,2,0,0,107,10.714285714285714,0.67216784,2
2020-11-12-170408,170408,0,0,0,107,6.571428571428571,0.4673156,3
2020-11-13-170408,170408,0,0,0,107,7.2857142857142865,0.37724984,4
2020-03-01-170409,170409,0,0,0,0,0.0,4.230246e-08,6
2020-03-02-170409,170409,0,0,1,0,0.0,0.0,0
2020-03-03-170409,170409,0,1,2,0,0.0,0.0,1
2020-03-04-170409,170409,0,2,0,0,0.0,9.484425e-07,2
2020-03-05-170409,170409,0,1,0,0,0.0,6.573022e-10,3
2020-03-06-170409,170409,0,0,0,0,0.0,0.0006887395,4
2020-03-07-170409,170409,0,0,2,0,0.0,0.00014793193,5
2020-03-08-170409,170409,0,0,0,0,0.0,2.2832348e-05,6
2020-03-09-170409,170409,0,0,6,0,0.0,0.00018372394,0
2020-03-10-170409,170409,0,0,4,0,0.0,0.00065176655,1
2020-03-11-170409,170409,0,0,6,0,0.0,2.3517587e-05,2
2020-03-12-170409,170409,0,0,5,0,0.0,0.0017184836,3
2020-03-13-170409,170409,0,0,7,0,0.25,0.053326927,4
2020-03-14-170409,170409,0,0,3,0,0.5,0.10203774,5
2020-03-15-170409,170409,0,0,15,0,0.25,0.012912233,6
2020-03-16-170409,170409,1,0,7,1,1.25,0.10119211,0
2020-03-17-170409,170409,2,0,4,3,2.0,0.2927409,1
2020-03-18-170409,170409,0,1,3,3,3.75,0.11527527,2
2020-03-19-170409,170409,0,0,5,3,3.75,0.20801772,3
2020-03-20-170409,170409,0,1,2,3,1.0,0.07087709,4
2020-03-21-170409,170409,2,0,2,5,1.25,0.08975699,5
2020-03-22-170409,170409,0,0,0,5,4.5,0.1268304,6
2020-03-23-170409,170409,6,0,3,11,2.5,0.17696626,0
2020-03-24-170409,170409,4,0,1,15,5.25,0.38867503,1
2020-03-25-170409,170409,6,0,1,21,4.25,0.25345597,2
2020-03-26-170409,170409,5,0,3,26,5.0,0.31424308,3
2020-03-27-170409,170409,7,0,1,33,3.0,0.30082703,4
2020-03-28-170409,170409,3,0,0,36,1.75,0.102276176,5
2020-03-29-170409,170409,15,0,0,51,2.5,0.3146205,6
2020-03-30-170409,170409,7,0,0,58,3.75,0.2788899,0
2020-03-31-170409,170409,4,0,0,62,3.0,0.17086458,1
2020-04-01-170409,170409,3,0,1,65,2.0,0.15107846,2
2020-04-02-170409,170409,5,0,0,70,2.75,0.16987939,3
2020-04-03-170409,170409,2,0,1,72,2.5,0.15849406,4
2020-04-04-170409,170409,2,0,0,74,3.75,0.0860256,5
2020-04-05-170409,170409,0,0,0,74,1.25,0.013112582,6
2020-04-06-170409,170409,3,1,1,77,4.25,0.196669,0
2020-04-07-170409,170409,1,0,0,78,2.0,0.10580902,1
2020-04-08-170409,170409,1,0,0,79,2.0,0.11215411,2
2020-04-09-170409,170409,3,0,0,82,3.75,0.15369487,3
2020-04-10-170409,170409,1,0,2,83,2.25,0.057439648,4
2020-04-11-170409,170409,0,0,0,83,1.5,0.06290984,5
2020-04-12-170409,170409,0,0,0,83,0.5,0.005178323,6
2020-04-13-170409,170409,0,0,2,83,2.5,0.112045124,0
2020-04-14-170409,170409,0,0,1,83,3.0,0.041739114,1
2020-04-15-170409,170409,1,0,0,84,1.5,0.049946144,2
2020-04-16-170409,170409,0,0,0,84,1.75,0.033248704,3
2020-04-17-170409,170409,1,1,0,85,1.5,0.070108965,4
2020-04-18-170409,170409,0,0,0,85,0.5,0.008066721,5
2020-04-19-170409,170409,0,0,0,85,0.25,0.002711401,6
2020-04-20-170409,170409,1,0,1,86,1.5,0.118127696,0
2020-04-21-170409,170409,0,0,1,86,1.75,0.03953122,1
2020-04-22-170409,170409,0,0,0,86,0.75,0.06963179,2
2020-04-23-170409,170409,0,0,2,86,0.75,0.01681154,3
2020-04-24-170409,170409,2,0,1,88,1.25,0.17257743,4
2020-04-25-170409,170409,0,0,2,88,1.0,0.013368236,5
2020-04-26-170409,170409,0,0,0,88,0.5,0.0053755916,6
2020-04-27-170409,170409,2,0,0,90,0.5,0.05684175,0
2020-04-28-170409,170409,1,0,2,91,0.75,0.04911834,1
2020-04-29-170409,170409,0,0,1,91,1.0,0.020521358,2
2020-04-30-170409,170409,0,0,2,91,0.75,0.0202219,3
2020-05-01-170409,170409,0,0,0,91,2.0,0.061928127,4
2020-05-02-170409,170409,0,0,1,91,0.75,0.0134669095,5
2020-05-03-170409,170409,0,0,0,91,1.0,0.026354352,6
2020-05-04-170409,170409,1,0,1,92,2.0,0.1520743,0
2020-05-05-170409,170409,1,0,1,93,1.0,0.12000543,1
2020-05-06-170409,170409,0,0,1,93,1.75,0.102451,2
2020-05-07-170409,170409,2,0,1,95,1.0,0.07851773,3
2020-05-08-170409,170409,1,0,5,96,1.0,0.08595058,4
2020-05-09-170409,170409,2,0,0,98,1.25,0.06518853,5
2020-05-10-170409,170409,0,2,0,98,0.75,0.007770938,6
2020-05-11-170409,170409,0,0,0,98,1.0,0.032174006,0
2020-05-12-170409,170409,2,0,0,100,1.0,0.128884,1
2020-05-13-170409,170409,1,0,0,101,1.25,0.09948915,2
2020-05-14-170409,170409,2,0,1,103,0.5,0.08831656,3
2020-05-15-170409,170409,0,0,3,103,2.0,0.103829496,4
2020-05-16-170409,170409,1,2,0,104,0.0,0.02464261,5
2020-05-17-170409,170409,0,0,0,104,0.5,0.0077709486,6
2020-05-18-170409,170409,1,0,0,105,1.75,0.079979636,0
2020-05-19-170409,170409,1,0,2,106,0.75,0.051846586,1
2020-05-20-170409,170409,1,0,1,107,0.75,0.0453704,2
2020-05-21-170409,170409,1,0,2,108,0.5,0.1083838,3
2020-05-22-170409,170409,5,0,0,113,1.75,0.2086861,4
2020-05-23-170409,170409,0,0,0,113,0.0,0.0018432306,5
2020-05-24-170409,170409,0,0,0,113,0.25,0.005264584,6
2020-05-25-170409,170409,0,0,3,113,0.75,0.07362451,0
2020-05-26-170409,170409,0,0,2,113,0.25,0.022144986,1
2020-05-27-170409,170409,0,1,0,113,2.75,0.11983729,2
2020-05-28-170409,170409,1,0,0,114,1.5,0.09731486,3
2020-05-29-170409,170409,3,0,0,117,1.25,0.18852133,4
2020-05-30-170409,170409,0,0,0,117,0.0,0.001163843,5
2020-05-31-170409,170409,0,0,0,117,0.0,0.00014272115,6
2020-06-01-170409,170409,0,0,0,117,0.25,0.045356847,0
2020-06-02-170409,170409,2,0,3,119,1.5,0.099808894,1
2020-06-03-170409,170409,1,0,2,120,1.75,0.08317635,2
2020-06-04-170409,170409,2,0,0,122,0.75,0.14948659,3
2020-06-05-170409,170409,0,0,1,122,1.0,0.0369197,4
2020-06-06-170409,170409,0,0,0,122,0.0,0.00064458384,5
2020-06-07-170409,170409,0,0,0,122,0.5,0.0119814295,6
2020-06-08-170409,170409,3,0,0,125,1.75,0.14524877,0
2020-06-09-170409,170409,2,0,0,127,1.5,0.098180324,1
2020-06-10-170409,170409,0,0,0,127,0.75,0.035988398,2
2020-06-11-170409,170409,0,0,0,127,1.0,0.07003778,3
2020-06-12-170409,170409,0,0,0,127,1.0,0.03154534,4
2020-06-13-170409,170409,0,0,0,127,0.0,0.0009683051,5
2020-06-14-170409,170409,0,0,0,127,0.0,0.0005686819,6
2020-06-15-170409,170409,0,0,0,127,1.5,0.08249926,0
2020-06-16-170409,170409,3,0,0,130,1.0,0.18622012,1
2020-06-17-170409,170409,2,0,0,132,0.75,0.08102644,2
2020-06-18-170409,170409,0,1,0,132,0.0,0.004578441,3
2020-06-19-170409,170409,1,0,1,133,0.75,0.060905457,4
2020-06-20-170409,170409,0,0,0,133,0.25,0.007908042,5
2020-06-21-170409,170409,0,0,0,133,0.0,0.00025111635,6
2020-06-22-170409,170409,0,0,0,133,0.5,0.020767182,0
2020-06-23-170409,170409,0,0,0,133,1.75,0.05053653,1
2020-06-24-170409,170409,0,0,1,133,0.5,0.019098882,2
2020-06-25-170409,170409,0,0,0,133,1.0,0.036364757,3
2020-06-26-170409,170409,0,0,0,133,0.5,0.019672235,4
2020-06-27-170409,170409,0,0,0,133,0.0,0.0009698505,5
2020-06-28-170409,170409,0,0,0,133,0.25,0.0010690466,6
2020-06-29-170409,170409,0,0,0,133,1.0,0.0827216,0
2020-06-30-170409,170409,0,0,2,133,0.75,0.0259201,1
2020-07-01-170409,170409,0,0,0,133,0.0,0.006985204,2
2020-07-02-170409,170409,0,0,0,133,0.25,0.010792937,3
2020-07-03-170409,170409,1,0,0,134,0.75,0.06291903,4
2020-07-04-170409,170409,0,0,0,134,0.25,0.00954396,5
2020-07-05-170409,170409,0,0,0,134,0.0,0.00056631665,6
2020-07-06-170409,170409,0,0,0,134,0.0,0.005079366,0
2020-07-07-170409,170409,0,0,0,134,0.25,0.01158915,1
2020-07-08-170409,170409,1,0,0,135,0.25,0.04477004,2
2020-07-09-170409,170409,0,0,0,135,0.5,0.0721194,3
2020-07-10-170409,170409,0,0,0,135,0.5,0.015293528,4
2020-07-11-170409,170409,0,0,0,135,0.0,0.00020978725,5
2020-07-12-170409,170409,0,0,0,135,0.0,0.0010226222,6
2020-07-13-170409,170409,0,0,0,135,1.0,0.18327886,0
2020-07-14-170409,170409,2,0,0,137,0.25,0.076566525,1
2020-07-15-170409,170409,0,0,0,137,1.25,0.03055269,2
2020-07-16-170409,170409,0,0,0,137,0.75,0.03858916,3
2020-07-17-170409,170409,0,0,0,137,0.75,0.07570035,4
2020-07-18-170409,170409,0,0,0,137,0.5,0.13860804,5
2020-07-19-170409,170409,0,0,0,137,0.25,0.004260677,6
2020-07-20-170409,170409,0,1,0,137,1.25,0.08649741,0
2020-07-21-170409,170409,0,0,0,137,0.25,0.013102014,1
2020-07-22-170409,170409,0,0,0,137,1.0,0.07979718,2
2020-07-23-170409,170409,0,0,0,137,1.0,0.036964923,3
2020-07-24-170409,170409,0,0,0,137,0.5,0.012084956,4
2020-07-25-170409,170409,0,0,0,137,0.75,0.021282021,5
2020-07-26-170409,170409,0,0,0,137,0.0,0.003137824,6
2020-07-27-170409,170409,0,0,2,137,0.0,0.0030865015,0
2020-07-28-170409,170409,0,0,2,137,1.0,0.033038728,1
2020-07-29-170409,170409,0,0,3,137,1.25,0.08761212,2
2020-07-30-170409,170409,0,0,1,137,1.75,0.13255791,3
2020-07-31-170409,170409,0,0,0,137,0.5,0.024785448,4
2020-08-01-170409,170409,0,0,0,137,0.5,0.11286852,5
2020-08-02-170409,170409,0,0,2,137,1.0,0.11968009,6
2020-08-03-170409,170409,0,0,0,137,1.25,0.08638055,0
2020-08-04-170409,170409,0,0,0,137,1.5,0.10993816,1
2020-08-05-170409,170409,0,0,0,137,2.25,0.09433337,2
2020-08-06-170409,170409,0,0,0,137,0.75,0.031073561,3
2020-08-07-170409,170409,0,0,0,137,1.75,0.058498707,4
2020-08-08-170409,170409,0,0,1,137,0.5,0.11715917,5
2020-08-09-170409,170409,0,0,0,137,0.0,0.0025015136,6
2020-08-10-170409,170409,2,0,0,139,1.0,0.11110713,0
2020-08-11-170409,170409,2,0,1,141,0.25,0.054366916,1
2020-08-12-170409,170409,3,0,0,144,1.0,0.111595474,2
2020-08-13-170409,170409,1,0,0,145,1.0,0.0877749,3
2020-08-14-170409,170409,0,0,0,145,0.25,0.06886356,4
2020-08-15-170409,170409,0,0,0,145,0.25,0.06797537,5
2020-08-16-170409,170409,2,0,0,147,0.5,0.16728128,6
2020-08-17-170409,170409,0,0,0,147,0.25,0.017027691,0
2020-08-18-170409,170409,0,0,0,147,2.0,0.23382574,1
2020-08-19-170409,170409,0,0,1,147,1.25,0.14942683,2
2020-08-20-170409,170409,0,0,0,147,1.25,0.09816552,3
2020-08-21-170409,170409,0,0,0,147,0.25,0.0416508,4
2020-08-22-170409,170409,1,0,0,148,1.0,0.053309947,5
2020-08-23-170409,170409,0,0,0,148,0.25,0.014311964,6
2020-08-24-170409,170409,0,0,0,148,1.75,0.15266535,0
2020-08-25-170409,170409,1,0,0,149,1.75,0.24242884,1
2020-08-26-170409,170409,0,0,0,149,0.25,0.20748393,2
2020-08-27-170409,170409,0,0,0,149,1.5,0.16021334,3
2020-08-28-170409,170409,0,0,0,149,1.25,0.2824006,4
2020-08-29-170409,170409,0,0,0,149,1.0,0.1338202,5
2020-08-30-170409,170409,0,1,0,149,1.25,0.1387012,6
2020-08-31-170409,170409,0,0,0,149,1.75,0.11170872,0
2020-09-01-170409,170409,0,0,0,149,1.5,0.21455051,1
2020-09-02-170409,170409,1,0,1,150,0.5,0.1480523,2
2020-09-03-170409,170409,0,0,1,150,1.0,0.12802774,3
2020-09-04-170409,170409,0,0,1,150,1.25,0.2373791,4
2020-09-05-170409,170409,0,0,0,150,1.5,0.030017165,5
2020-09-06-170409,170409,0,0,0,150,2.0,0.16923472,6
2020-09-07-170409,170409,0,0,1,150,0.5,0.218617,0
2020-09-08-170409,170409,0,0,4,150,0.25,0.060736243,1
2020-09-09-170409,170409,0,0,1,150,0.25,0.06149788,2
2020-09-10-170409,170409,0,0,5,150,1.25,0.13501798,3
2020-09-11-170409,170409,0,0,13,150,0.75,0.17736177,4
2020-09-12-170409,170409,0,1,2,150,0.25,0.013727528,5
2020-09-13-170409,170409,0,0,7,150,2.5,0.26396203,6
2020-09-14-170409,170409,0,0,4,150,0.5,0.11191269,0
2020-09-15-170409,170409,0,0,1,150,1.25,0.15136163,1
2020-09-16-170409,170409,1,0,1,151,1.75,0.08426016,2
2020-09-17-170409,170409,1,0,5,152,1.75,0.20151253,3
2020-09-18-170409,170409,1,0,4,153,1.75,0.14467748,4
2020-09-19-170409,170409,0,0,5,153,1.5,0.037447914,5
2020-09-20-170409,170409,0,1,2,153,1.0,0.022669652,6
2020-09-21-170409,170409,1,0,1,154,1.5,0.12629321,0
2020-09-22-170409,170409,4,1,0,158,2.25,0.28348085,1
2020-09-23-170409,170409,1,1,1,159,2.75,0.18751167,2
2020-09-24-170409,170409,5,0,0,164,1.25,0.162373,3
2020-09-25-170409,170409,13,1,0,177,2.0,0.38847542,4
2020-09-26-170409,170409,2,0,1,179,0.5,0.13313909,5
2020-09-27-170409,170409,7,0,0,186,2.25,0.24536686,6
2020-09-28-170409,170409,4,1,3,190,4.0,0.32404435,0
2020-09-29-170409,170409,1,0,0,191,2.25,0.09387016,1
2020-09-30-170409,170409,1,0,0,192,2.25,0.109974265,2
2020-10-01-170409,170409,5,0,0,197,3.25,0.24044698,3
2020-10-02-170409,170409,4,0,6,201,4.75,0.21556091,4
2020-10-03-170409,170409,5,0,8,206,2.25,0.18902832,5
2020-10-04-170409,170409,2,0,1,208,1.25,0.08691323,6
2020-10-05-170409,170409,1,0,10,209,2.0,0.09686383,0
2020-10-06-170409,170409,0,0,8,209,1.0,0.049364153,1
2020-10-07-170409,170409,1,1,10,210,1.25,0.064565584,2
2020-10-08-170409,170409,0,0,1,210,2.25,0.11730477,3
2020-10-09-170409,170409,0,0,6,210,2.25,0.11936878,4
2020-10-10-170409,170409,1,0,0,211,1.5,0.103361525,5
2020-10-11-170409,170409,0,0,5,211,1.25,0.08734655,6
2020-10-12-170409,170409,3,0,6,214,2.5,0.3147602,0
2020-10-13-170409,170409,0,0,7,214,2.5,0.103017464,1
2020-10-14-170409,170409,0,0,3,214,2.5,0.20929736,2
2020-10-15-170409,170409,0,0,6,214,1.75,0.089308016,3
2020-10-16-170409,170409,6,0,14,220,2.25,0.30034038,4
2020-10-17-170409,170409,8,0,3,228,1.75,0.24317838,5
2020-10-18-170409,170409,1,0,0,229,0.75,0.06659066,6
2020-10-19-170409,170409,10,1,1,239,1.0,0.4443474,0
2020-10-20-170409,170409,8,0,5,247,1.5,0.23324257,1
2020-10-21-170409,170409,10,0,6,257,2.25,0.28906235,2
2020-10-22-170409,170409,1,0,2,258,1.75,0.27292612,3
2020-10-23-170409,170409,6,0,6,264,3.25,0.32798815,4
2020-10-24-170409,170409,0,0,2,264,0.75,0.039163303,5
2020-10-25-170409,170409,5,0,0,269,0.5,0.09407386,6
2020-10-26-170409,170409,6,1,3,275,2.25,0.29906595,0
2020-10-27-170409,170409,7,1,6,282,2.0,0.35614344,1
2020-10-28-170409,170409,3,1,4,285,9.0,0.401687,2
2020-10-29-170409,170409,6,0,5,291,7.25,0.6188326,3
2020-10-30-170409,170409,14,1,9,305,3.0,0.43204284,4
2020-10-31-170409,170409,3,0,0,308,1.25,0.13844983,5
2020-11-01-170409,170409,0,0,0,308,3.5,0.106871456,6
2020-11-02-170409,170409,1,1,0,309,1.5,0.05706915,0
2020-11-03-170409,170409,5,0,0,314,5.25,0.39745417,1
2020-11-04-170409,170409,6,0,0,320,5.75,0.40741858,2
2020-11-05-170409,170409,2,0,0,322,3.5,0.32069185,3
2020-11-06-170409,170409,6,0,0,328,3.5,0.32559067,4
2020-11-07-170409,170409,2,2,0,330,4.0,0.3704537,5
2020-11-08-170409,170409,0,1,0,330,2.5,0.0497773,6
2020-11-09-170409,170409,3,0,0,333,3.0,0.20853625,0
2020-11-10-170409,170409,6,0,0,339,4.75,0.31198144,1
2020-11-11-170409,170409,4,4,0,343,6.75,0.3893475,2
2020-11-12-170409,170409,5,1,0,348,2.0,0.24888803,3
2020-11-13-170409,170409,9,0,0,357,4.75,0.35677487,4
2020-03-01-170410,170410,0,0,2,0,0.0,3.935785e-05,6
2020-03-02-170410,170410,0,0,0,0,0.0,7.458492e-05,0
2020-03-03-170410,170410,0,0,4,0,0.0,1.1226266e-06,1
2020-03-04-170410,170410,0,2,2,0,0.0,0.01480087,2
2020-03-05-170410,170410,0,0,3,0,0.0,8.8806065e-09,3
2020-03-06-170410,170410,0,0,4,0,0.0,0.003970179,4
2020-03-07-170410,170410,0,0,2,0,0.0,0.00040721154,5
2020-03-08-170410,170410,0,0,2,0,0.0,0.00012864658,6
2020-03-09-170410,170410,0,0,2,0,0.0,0.003332322,0
2020-03-10-170410,170410,0,0,0,0,0.0,0.005223067,1
2020-03-11-170410,170410,0,0,4,0,0.0,0.00287465,2
2020-03-12-170410,170410,0,0,2,0,0.0,0.02094721,3
2020-03-13-170410,170410,0,0,3,0,0.0,0.0073937536,4
2020-03-14-170410,170410,0,0,1,0,0.0,0.033074975,5
2020-03-15-170410,170410,2,0,1,2,0.3333333333333333,0.13681793,6
2020-03-16-170410,170410,0,0,0,2,0.6666666666666666,0.10722718,0
2020-03-17-170410,170410,4,0,3,6,0.0,0.87797296,1
2020-03-18-170410,170410,2,0,2,8,1.6666666666666667,0.7258681,2
2020-03-19-170410,170410,3,0,1,11,2.333333333333333,0.84983945,3
2020-03-20-170410,170410,4,0,4,15,2.0,0.7579556,4
2020-03-21-170410,170410,2,0,1,17,1.3333333333333333,0.3414033,5
2020-03-22-170410,170410,2,1,0,19,0.3333333333333333,0.26253322,6
2020-03-23-170410,170410,2,0,4,21,3.6666666666666665,0.69573516,0
2020-03-24-170410,170410,0,0,2,21,4.666666666666667,0.62394035,1
2020-03-25-170410,170410,4,0,1,25,2.333333333333333,1.1550759,2
2020-03-26-170410,170410,2,0,0,27,3.0,0.56048495,3
2020-03-27-170410,170410,3,0,1,30,2.6666666666666665,0.6815574,4
2020-03-28-170410,170410,1,0,1,31,0.3333333333333333,0.20085052,5
2020-03-29-170410,170410,1,0,0,32,1.0,0.1717427,6
2020-03-30-170410,170410,0,0,0,32,2.6666666666666665,0.28828895,0
2020-03-31-170410,170410,3,0,2,35,0.3333333333333333,0.656524,1
2020-04-01-170410,170410,2,0,0,37,0.0,0.45939285,2
2020-04-02-170410,170410,1,0,0,38,2.333333333333333,0.42326123,3
2020-04-03-170410,170410,4,0,0,42,2.0,0.72492355,4
2020-04-04-170410,170410,1,0,0,43,1.3333333333333333,0.35486487,5
2020-04-05-170410,170410,0,0,1,43,0.3333333333333333,0.028740779,6
2020-04-06-170410,170410,4,0,1,47,1.3333333333333333,0.694703,0
2020-04-07-170410,170410,2,0,1,49,1.3333333333333333,0.47301883,1
2020-04-08-170410,170410,1,0,3,50,0.6666666666666666,0.3018218,2
2020-04-09-170410,170410,0,0,0,50,2.333333333333333,0.1380317,3
2020-04-10-170410,170410,1,0,1,51,2.0,0.1979127,4
2020-04-11-170410,170410,1,0,1,52,1.0,0.18500765,5
2020-04-12-170410,170410,0,0,0,52,0.3333333333333333,0.030835388,6
2020-04-13-170410,170410,0,0,2,52,1.3333333333333333,0.18554549,0
2020-04-14-170410,170410,2,0,0,54,3.333333333333333,0.4732363,1
2020-04-15-170410,170410,0,1,0,54,1.3333333333333333,0.24329887,2
2020-04-16-170410,170410,0,0,1,54,1.6666666666666667,0.14132653,3
2020-04-17-170410,170410,0,0,0,54,0.3333333333333333,0.12280236,4
2020-04-18-170410,170410,0,0,0,54,1.0,0.046674695,5
2020-04-19-170410,170410,1,0,1,55,1.3333333333333333,0.17262988,6
2020-04-20-170410,170410,1,0,0,56,2.333333333333333,0.3103524,0
2020-04-21-170410,170410,1,0,0,57,2.333333333333333,0.3056778,1
2020-04-22-170410,170410,3,0,0,60,1.3333333333333333,0.43148795,2
2020-04-23-170410,170410,0,0,0,60,4.666666666666667,0.07255574,3
2020-04-24-170410,170410,1,0,1,61,2.0,0.30361938,4
2020-04-25-170410,170410,1,0,1,62,1.0,0.16306292,5
2020-04-26-170410,170410,0,0,1,62,0.0,0.007410158,6
2020-04-27-170410,170410,2,0,1,64,4.0,0.27727142,0
2020-04-28-170410,170410,0,0,0,64,1.3333333333333333,0.13947493,1
2020-04-29-170410,170410,0,0,0,64,2.0,0.16085882,2
2020-04-30-170410,170410,1,1,0,65,2.6666666666666665,0.2579203,3
2020-05-01-170410,170410,0,0,0,65,0.3333333333333333,0.031679247,4
2020-05-02-170410,170410,0,0,0,65,0.0,0.010308933,5
2020-05-03-170410,170410,1,0,0,66,0.0,0.13683246,6
2020-05-04-170410,170410,0,0,0,66,2.6666666666666665,0.18024276,0
2020-05-05-170410,170410,0,0,0,66,0.3333333333333333,0.09849319,1
2020-05-06-170410,170410,0,0,1,66,2.6666666666666665,0.096281566,2
2020-05-07-170410,170410,0,0,1,66,0.6666666666666666,0.074614644,3
2020-05-08-170410,170410,1,0,2,67,1.3333333333333333,0.35302967,4
2020-05-09-170410,170410,1,0,0,68,0.6666666666666666,0.20772931,5
2020-05-10-170410,170410,1,0,0,69,0.0,0.15075491,6
2020-05-11-170410,170410,1,1,3,70,2.0,0.23138873,0
2020-05-12-170410,170410,0,0,0,70,1.0,0.11772814,1
2020-05-13-170410,170410,0,0,0,70,0.0,0.050993454,2
2020-05-14-170410,170410,0,0,0,70,0.6666666666666666,0.045507163,3
2020-05-15-170410,170410,0,0,0,70,1.3333333333333333,0.07892706,4
2020-05-16-170410,170410,0,0,1,70,0.0,0.0026262293,5
2020-05-17-170410,170410,0,0,0,70,0.0,0.0036840294,6
2020-05-18-170410,170410,0,0,0,70,0.6666666666666666,0.093146585,0
2020-05-19-170410,170410,0,0,1,70,0.0,0.04888114,1
2020-05-20-170410,170410,1,0,0,71,0.0,0.21992727,2
2020-05-21-170410,170410,1,0,0,72,0.3333333333333333,0.19878207,3
2020-05-22-170410,170410,2,0,1,74,0.6666666666666666,0.52612776,4
2020-05-23-170410,170410,0,0,0,74,0.0,0.012926045,5
2020-05-24-170410,170410,0,0,0,74,0.0,0.0012612072,6
2020-05-25-170410,170410,3,0,0,77,0.3333333333333333,0.5690262,0
2020-05-26-170410,170410,0,0,0,77,1.0,0.12120464,1
2020-05-27-170410,170410,0,0,0,77,1.3333333333333333,0.112877324,2
2020-05-28-170410,170410,0,2,1,77,0.3333333333333333,0.1183827,3
2020-05-29-170410,170410,0,2,0,77,0.6666666666666666,0.08175679,4
2020-05-30-170410,170410,1,0,0,78,0.0,0.18140197,5
2020-05-31-170410,170410,0,0,0,78,0.0,0.00071926176,6
2020-06-01-170410,170410,0,0,0,78,0.3333333333333333,0.11939921,0
2020-06-02-170410,170410,1,0,0,79,0.0,0.22509563,1
2020-06-03-170410,170410,0,0,0,79,0.0,0.040527012,2
2020-06-04-170410,170410,0,0,0,79,0.0,0.047821626,3
2020-06-05-170410,170410,1,0,0,80,0.0,0.21482892,4
2020-06-06-170410,170410,0,0,0,80,0.0,0.0060494742,5
2020-06-07-170410,170410,0,0,0,80,0.3333333333333333,0.009083454,6
2020-06-08-170410,170410,0,0,0,80,0.0,0.018725155,0
2020-06-09-170410,170410,0,0,0,80,0.3333333333333333,0.060235366,1
2020-06-10-170410,170410,0,0,0,80,1.0,0.09726188,2
2020-06-11-170410,170410,1,0,0,81,0.0,0.20137651,3
2020-06-12-170410,170410,0,0,0,81,0.3333333333333333,0.07309842,4
2020-06-13-170410,170410,0,0,0,81,0.0,0.0033036948,5
2020-06-14-170410,170410,0,0,0,81,0.0,0.0014420673,6
2020-06-15-170410,170410,0,0,0,81,0.6666666666666666,0.04453156,0
2020-06-16-170410,170410,0,0,0,81,0.0,0.04272034,1
2020-06-17-170410,170410,0,0,1,81,1.0,0.060737498,2
2020-06-18-170410,170410,0,0,0,81,0.0,0.014344412,3
2020-06-19-170410,170410,0,0,0,81,0.0,0.014951242,4
2020-06-20-170410,170410,0,0,0,81,0.3333333333333333,0.011699737,5
2020-06-21-170410,170410,0,0,0,81,0.0,0.001800794,6
2020-06-22-170410,170410,0,0,0,81,0.3333333333333333,0.03195607,0
2020-06-23-170410,170410,0,0,1,81,0.0,0.026938645,1
2020-06-24-170410,170410,0,0,1,81,0.3333333333333333,0.06028796,2
2020-06-25-170410,170410,0,0,0,81,0.0,0.019481476,3
2020-06-26-170410,170410,0,1,1,81,0.0,0.012293144,4
2020-06-27-170410,170410,0,0,0,81,0.0,0.0037741344,5
2020-06-28-170410,170410,0,0,0,81,0.0,4.2246586e-07,6
2020-06-29-170410,170410,0,0,0,81,0.6666666666666666,0.035144005,0
2020-06-30-170410,170410,0,0,1,81,0.0,0.03636263,1
2020-07-01-170410,170410,1,0,0,82,1.6666666666666667,0.21440907,2
2020-07-02-170410,170410,0,0,1,82,0.0,0.029063404,3
2020-07-03-170410,170410,0,0,0,82,0.0,0.019500205,4
2020-07-04-170410,170410,0,0,1,82,0.3333333333333333,0.0071222084,5
2020-07-05-170410,170410,0,0,4,82,0.0,0.0048498097,6
2020-07-06-170410,170410,0,0,1,82,0.3333333333333333,0.018243061,0
2020-07-07-170410,170410,1,0,1,83,0.0,0.21823753,1
2020-07-08-170410,170410,1,0,0,84,0.3333333333333333,0.2184718,2
2020-07-09-170410,170410,0,0,2,84,0.6666666666666666,0.033626266,3
2020-07-10-170410,170410,1,0,0,85,0.0,0.21818475,4
2020-07-11-170410,170410,0,0,0,85,0.0,0.0010429858,5
2020-07-12-170410,170410,0,0,0,85,0.0,0.00048329233,6
2020-07-13-170410,170410,0,0,0,85,1.6666666666666667,0.07413278,0
2020-07-14-170410,170410,1,0,1,86,0.0,0.21387945,1
2020-07-15-170410,170410,0,0,0,86,0.3333333333333333,0.022740677,2
2020-07-16-170410,170410,1,0,0,87,0.3333333333333333,0.24921528,3
2020-07-17-170410,170410,0,0,0,87,0.0,0.013138155,4
2020-07-18-170410,170410,1,0,0,88,0.0,0.21591656,5
2020-07-19-170410,170410,4,0,0,92,0.0,0.8432816,6
2020-07-20-170410,170410,1,0,0,93,0.0,0.22521977,0
2020-07-21-170410,170410,1,0,0,94,1.3333333333333333,0.32508895,1
2020-07-22-170410,170410,0,0,1,94,1.0,0.03963266,2
2020-07-23-170410,170410,2,0,2,96,0.0,0.49823663,3
2020-07-24-170410,170410,0,0,3,96,0.0,0.020500887,4
2020-07-25-170410,170410,0,0,0,96,0.0,0.008067281,5
2020-07-26-170410,170410,0,0,0,96,0.3333333333333333,0.0076632937,6
2020-07-27-170410,170410,0,0,1,96,0.0,0.015235163,0
2020-07-28-170410,170410,1,0,1,97,0.3333333333333333,0.22508626,1
2020-07-29-170410,170410,0,0,0,97,0.0,0.024636585,2
2020-07-30-170410,170410,0,0,0,97,0.0,0.028351286,3
2020-07-31-170410,170410,0,0,1,97,0.0,0.024249492,4
2020-08-01-170410,170410,0,0,2,97,0.0,0.009267726,5
2020-08-02-170410,170410,0,0,0,97,0.0,0.0055141104,6
2020-08-03-170410,170410,0,0,0,97,1.0,0.042074267,0
2020-08-04-170410,170410,0,0,2,97,0.0,0.07270223,1
2020-08-05-170410,170410,1,0,0,98,0.3333333333333333,0.10975588,2
2020-08-06-170410,170410,2,0,0,100,0.3333333333333333,0.24816331,3
2020-08-07-170410,170410,3,0,1,103,0.0,0.5944758,4
2020-08-08-170410,170410,0,0,0,103,0.0,0.017611293,5
2020-08-09-170410,170410,0,0,0,103,0.0,0.04147639,6
2020-08-10-170410,170410,1,0,0,104,0.6666666666666666,0.27719098,0
2020-08-11-170410,170410,1,0,0,105,1.0,0.2675608,1
2020-08-12-170410,170410,0,0,0,105,0.6666666666666666,0.24677417,2
2020-08-13-170410,170410,0,0,0,105,0.0,0.056367047,3
2020-08-14-170410,170410,1,0,1,106,1.3333333333333333,0.33486232,4
2020-08-15-170410,170410,2,0,0,108,0.0,0.36759686,5
2020-08-16-170410,170410,0,0,0,108,0.0,0.01707383,6
2020-08-17-170410,170410,0,0,0,108,0.3333333333333333,0.04803638,0
2020-08-18-170410,170410,2,0,0,110,0.3333333333333333,0.44070637,1
2020-08-19-170410,170410,0,0,0,110,0.3333333333333333,0.06499362,2
2020-08-20-170410,170410,0,0,0,110,0.0,0.07625267,3
2020-08-21-170410,170410,1,0,2,111,0.3333333333333333,0.2623727,4
2020-08-22-170410,170410,0,0,1,111,0.6666666666666666,0.091815725,5
2020-08-23-170410,170410,0,0,1,111,0.0,0.008238322,6
2020-08-24-170410,170410,0,0,1,111,0.3333333333333333,0.05036382,0
2020-08-25-170410,170410,0,0,4,111,0.6666666666666666,0.15295452,1
2020-08-26-170410,170410,0,0,3,111,0.0,0.38732898,2
2020-08-27-170410,170410,0,0,1,111,2.0,0.2705731,3
2020-08-28-170410,170410,1,0,0,112,1.0,0.5019361,4
2020-08-29-170410,170410,0,0,2,112,0.6666666666666666,0.15428416,5
2020-08-30-170410,170410,0,0,0,112,0.0,0.056295075,6
2020-08-31-170410,170410,0,0,0,112,0.0,0.049643654,0
2020-09-01-170410,170410,0,0,4,112,0.6666666666666666,0.21002966,1
2020-09-02-170410,170410,0,0,0,112,0.6666666666666666,0.11021767,2
2020-09-03-170410,170410,0,0,5,112,0.0,0.26798797,3
2020-09-04-170410,170410,2,0,2,114,0.0,0.7454504,4
2020-09-05-170410,170410,1,0,0,115,0.0,0.20440263,5
2020-09-06-170410,170410,1,0,0,116,0.3333333333333333,0.20821792,6
2020-09-07-170410,170410,1,0,7,117,0.0,0.05763005,0
2020-09-08-170410,170410,4,0,5,121,0.0,0.73868227,1
2020-09-09-170410,170410,3,0,1,124,0.3333333333333333,0.44338474,2
2020-09-10-170410,170410,1,0,5,125,0.3333333333333333,0.30080548,3
2020-09-11-170410,170410,0,0,7,125,0.3333333333333333,0.20715468,4
2020-09-12-170410,170410,2,0,0,127,0.6666666666666666,0.3562351,5
2020-09-13-170410,170410,0,0,1,127,0.0,0.05052646,6
2020-09-14-170410,170410,0,0,1,127,0.0,0.05817837,0
2020-09-15-170410,170410,4,0,4,131,1.0,0.83581275,1
2020-09-16-170410,170410,0,0,2,131,1.6666666666666667,0.1855499,2
2020-09-17-170410,170410,5,0,3,136,1.0,0.973307,3
2020-09-18-170410,170410,2,0,1,138,1.6666666666666667,0.4996621,4
2020-09-19-170410,170410,0,0,0,138,0.0,0.07930149,5
2020-09-20-170410,170410,0,0,1,138,0.0,0.04741684,6
2020-09-21-170410,170410,7,0,0,145,2.0,0.61104566,0
2020-09-22-170410,170410,5,0,0,150,2.0,0.9107998,1
2020-09-23-170410,170410,1,2,2,151,1.3333333333333333,0.34276888,2
2020-09-24-170410,170410,5,0,0,156,1.6666666666666667,0.82239795,3
2020-09-25-170410,170410,7,1,0,163,2.0,0.8231997,4
2020-09-26-170410,170410,0,0,0,163,0.6666666666666666,0.04496278,5
2020-09-27-170410,170410,1,0,2,164,0.3333333333333333,0.17877999,6
2020-09-28-170410,170410,1,0,0,165,2.333333333333333,0.35026622,0
2020-09-29-170410,170410,4,0,1,169,0.6666666666666666,0.5045958,1
2020-09-30-170410,170410,2,0,0,171,1.6666666666666667,0.41574517,2
2020-10-01-170410,170410,3,0,0,174,2.333333333333333,0.55589736,3
2020-10-02-170410,170410,1,0,2,175,2.333333333333333,0.37601218,4
2020-10-03-170410,170410,0,0,1,175,0.0,0.11084411,5
2020-10-04-170410,170410,1,2,0,176,0.0,0.14825152,6
2020-10-05-170410,170410,0,0,1,176,0.6666666666666666,0.22616856,0
2020-10-06-170410,170410,0,0,1,176,0.3333333333333333,0.16966575,1
2020-10-07-170410,170410,2,1,2,178,1.0,0.33579028,2
2020-10-08-170410,170410,0,0,3,178,0.0,0.3335992,3
2020-10-09-170410,170410,0,0,1,178,2.0,0.41405338,4
2020-10-10-170410,170410,0,0,1,178,13.0,1.0141335,5
2020-10-11-170410,170410,2,0,0,180,4.0,0.54325414,6
2020-10-12-170410,170410,0,0,1,180,7.666666666666668,0.30081898,0
2020-10-13-170410,170410,1,0,5,181,1.0,0.37225413,1
2020-10-14-170410,170410,0,0,4,181,1.3333333333333333,0.3103459,2
2020-10-15-170410,170410,0,0,4,181,2.6666666666666665,0.46425995,3
2020-10-16-170410,170410,2,0,12,183,1.0,0.6826623,4
2020-10-17-170410,170410,1,0,4,184,3.333333333333333,0.42192513,5
2020-10-18-170410,170410,0,0,0,184,1.0,0.18391353,6
2020-10-19-170410,170410,1,0,3,185,1.0,0.32695156,0
2020-10-20-170410,170410,1,0,3,186,2.333333333333333,0.8365381,1
2020-10-21-170410,170410,2,0,7,188,4.666666666666667,0.91845745,2
2020-10-22-170410,170410,3,0,12,191,9.0,0.9519947,3
2020-10-23-170410,170410,1,0,3,192,3.6666666666666665,0.8377984,4
2020-10-24-170410,170410,1,0,4,193,1.0,0.2978855,5
2020-10-25-170410,170410,0,0,2,193,1.6666666666666667,0.11626574,6
2020-10-26-170410,170410,1,1,12,194,1.3333333333333333,0.46066177,0
2020-10-27-170410,170410,5,0,4,199,1.6666666666666667,0.8792631,1
2020-10-28-170410,170410,4,0,17,203,2.333333333333333,0.91735744,2
2020-10-29-170410,170410,4,0,9,207,2.0,0.9194594,3
2020-10-30-170410,170410,12,2,6,219,5.0,1.993743,4
2020-10-31-170410,170410,4,1,0,223,14.0,1.5662849,5
2020-11-01-170410,170410,0,2,0,223,4.333333333333333,0.34774637,6
2020-11-02-170410,170410,3,0,0,226,3.333333333333333,0.5014523,0
2020-11-03-170410,170410,3,0,0,229,4.0,1.0039805,1
2020-11-04-170410,170410,7,1,0,236,5.333333333333333,1.4066797,2
2020-11-05-170410,170410,12,1,0,248,2.6666666666666665,2.0611074,3
2020-11-06-170410,170410,3,1,0,251,7.666666666666668,1.1968945,4
2020-11-07-170410,170410,4,0,0,255,2.6666666666666665,0.63009787,5
2020-11-08-170410,170410,2,0,0,257,3.0,0.39314935,6
2020-11-09-170410,170410,12,1,0,269,5.333333333333333,1.7035074,0
2020-11-10-170410,170410,4,0,0,273,5.0,0.9481062,1
2020-11-11-170410,170410,17,1,0,290,5.0,2.3894308,2
2020-11-12-170410,170410,9,0,0,299,4.0,1.2966,3
2020-11-13-170410,170410,6,1,0,305,2.6666666666666665,1.1203101,4
2020-03-01-170411,170411,0,0,0,0,0.0,5.675794e-05,6
2020-03-02-170411,170411,0,0,7,0,0.0,0.000205606,0
2020-03-03-170411,170411,0,0,1,0,0.0,2.8851249e-08,1
2020-03-04-170411,170411,0,0,11,0,0.0,0.000589504,2
2020-03-05-170411,170411,0,0,9,0,0.0,9.5999094e-05,3
2020-03-06-170411,170411,0,1,5,0,0.0,0.032375887,4
2020-03-07-170411,170411,0,1,2,0,0.0,0.0014585587,5
2020-03-08-170411,170411,0,0,3,0,0.0,0.00045612679,6
2020-03-09-170411,170411,0,0,9,0,0.0,0.0019395105,0
2020-03-10-170411,170411,0,0,5,0,0.6666666666666666,0.017771536,1
2020-03-11-170411,170411,0,0,10,0,0.3333333333333333,0.00058898295,2
2020-03-12-170411,170411,1,0,15,1,1.3333333333333333,0.08926476,3
2020-03-13-170411,170411,0,0,11,1,1.0,0.027757334,4
2020-03-14-170411,170411,0,0,10,1,0.3333333333333333,0.05045021,5
2020-03-15-170411,170411,0,0,15,1,0.3333333333333333,0.052089807,6
2020-03-16-170411,170411,7,0,9,8,4.666666666666667,0.26958048,0
2020-03-17-170411,170411,1,0,10,9,4.666666666666667,0.5335296,1
2020-03-18-170411,170411,11,0,10,20,9.666666666666666,0.68056387,2
2020-03-19-170411,170411,9,1,7,29,11.333333333333336,0.7554818,3
2020-03-20-170411,170411,5,0,8,34,9.666666666666666,0.6164921,4
2020-03-21-170411,170411,2,0,4,36,5.333333333333333,0.22562322,5
2020-03-22-170411,170411,3,0,1,39,5.333333333333333,0.18956266,6
2020-03-23-170411,170411,9,0,4,48,10.666666666666666,0.79906857,0
2020-03-24-170411,170411,5,0,6,53,15.333333333333336,0.8222396,1
2020-03-25-170411,170411,10,0,6,63,12.666666666666664,1.2430893,2
2020-03-26-170411,170411,15,0,6,78,9.666666666666666,0.82289284,3
2020-03-27-170411,170411,11,0,4,89,10.0,0.7331244,4
2020-03-28-170411,170411,10,0,2,99,4.0,0.31493312,5
2020-03-29-170411,170411,15,0,2,114,1.0,0.3073162,6
2020-03-30-170411,170411,9,0,7,123,7.666666666666668,0.55172443,0
2020-03-31-170411,170411,10,0,7,133,5.333333333333333,0.554954,1
2020-04-01-170411,170411,10,0,4,143,3.333333333333333,0.46129885,2
2020-04-02-170411,170411,7,0,0,150,8.333333333333334,0.44764104,3
2020-04-03-170411,170411,8,0,1,158,7.333333333333332,0.4352359,4
2020-04-04-170411,170411,4,0,0,162,2.6666666666666665,0.23309563,5
2020-04-05-170411,170411,1,0,1,163,2.333333333333333,0.061078075,6
2020-04-06-170411,170411,4,0,1,167,6.0,0.42122146,0
2020-04-07-170411,170411,6,0,1,173,3.0,0.4212265,1
2020-04-08-170411,170411,6,0,1,179,4.333333333333333,0.38455868,2
2020-04-09-170411,170411,6,0,0,185,6.0,0.3608064,3
2020-04-10-170411,170411,4,0,5,189,5.666666666666668,0.1682199,4
2020-04-11-170411,170411,2,0,0,191,2.333333333333333,0.12725057,5
2020-04-12-170411,170411,2,0,0,193,0.6666666666666666,0.04799089,6
2020-04-13-170411,170411,7,0,1,200,4.666666666666667,0.38125354,0
2020-04-14-170411,170411,7,0,2,207,3.0,0.41591638,1
2020-04-15-170411,170411,4,0,2,211,2.0,0.196783,2
2020-04-16-170411,170411,0,0,2,211,4.666666666666667,0.21873969,3
2020-04-17-170411,170411,1,0,1,212,5.0,0.28758666,4
2020-04-18-170411,170411,0,0,2,212,1.6666666666666667,0.0429105,5
2020-04-19-170411,170411,1,0,1,213,1.6666666666666667,0.066588394,6
2020-04-20-170411,170411,1,0,2,214,5.333333333333333,0.28237748,0
2020-04-21-170411,170411,1,0,1,215,2.6666666666666665,0.21629205,1
2020-04-22-170411,170411,1,0,1,216,4.333333333333333,0.33240128,2
2020-04-23-170411,170411,0,0,1,216,1.3333333333333333,0.070892,3
2020-04-24-170411,170411,5,0,0,221,4.666666666666667,0.33339384,4
2020-04-25-170411,170411,0,0,1,221,1.3333333333333333,0.06738149,5
2020-04-26-170411,170411,0,0,1,221,2.333333333333333,0.048313018,6
2020-04-27-170411,170411,1,0,0,222,4.0,0.22502182,0
2020-04-28-170411,170411,2,0,3,224,2.0,0.18221617,1
2020-04-29-170411,170411,2,0,1,226,5.0,0.28757724,2
2020-04-30-170411,170411,2,0,0,228,1.6666666666666667,0.19831203,3
2020-05-01-170411,170411,1,0,4,229,2.0,0.048701633,4
2020-05-02-170411,170411,2,0,0,231,1.6666666666666667,0.056986686,5
2020-05-03-170411,170411,1,0,0,232,0.6666666666666666,0.04123009,6
2020-05-04-170411,170411,2,0,5,234,4.0,0.26965752,0
2020-05-05-170411,170411,1,0,2,235,3.0,0.19591667,1
2020-05-06-170411,170411,1,0,1,236,1.3333333333333333,0.15220937,2
2020-05-07-170411,170411,1,0,0,237,1.3333333333333333,0.07409842,3
2020-05-08-170411,170411,0,0,5,237,2.6666666666666665,0.25633577,4
2020-05-09-170411,170411,1,0,0,238,1.3333333333333333,0.12593175,5
2020-05-10-170411,170411,1,1,0,239,0.0,0.077865966,6
2020-05-11-170411,170411,0,3,0,239,1.6666666666666667,0.19489887,0
2020-05-12-170411,170411,3,0,6,242,2.6666666666666665,0.22883265,1
2020-05-13-170411,170411,1,1,0,243,2.6666666666666665,0.1241286,2
2020-05-14-170411,170411,0,0,1,243,1.3333333333333333,0.08771935,3
2020-05-15-170411,170411,4,0,0,247,2.6666666666666665,0.24931479,4
2020-05-16-170411,170411,0,0,0,247,0.3333333333333333,0.0037354038,5
2020-05-17-170411,170411,0,1,0,247,1.3333333333333333,0.02214474,6
2020-05-18-170411,170411,5,0,0,252,1.0,0.20955347,0
2020-05-19-170411,170411,2,0,0,254,1.0,0.1156351,1
2020-05-20-170411,170411,1,0,4,255,0.6666666666666666,0.1255044,2
2020-05-21-170411,170411,0,0,1,255,1.3333333333333333,0.12667486,3
2020-05-22-170411,170411,5,0,0,260,2.333333333333333,0.22923338,4
2020-05-23-170411,170411,0,0,2,260,0.0,0.042744398,5
2020-05-24-170411,170411,0,0,0,260,0.0,0.0039596213,6
2020-05-25-170411,170411,0,0,1,260,0.6666666666666666,0.20355757,0
2020-05-26-170411,170411,6,0,2,266,1.0,0.25671268,1
2020-05-27-170411,170411,0,0,1,266,1.6666666666666667,0.22284758,2
2020-05-28-170411,170411,1,2,1,267,1.0,0.32981017,3
2020-05-29-170411,170411,0,2,0,267,1.6666666666666667,0.15137504,4
2020-05-30-170411,170411,0,2,1,267,0.3333333333333333,0.034627683,5
2020-05-31-170411,170411,0,0,0,267,0.0,0.002760768,6
2020-06-01-170411,170411,0,0,2,267,0.3333333333333333,0.29224083,0
2020-06-02-170411,170411,0,0,2,267,1.0,0.16820094,1
2020-06-03-170411,170411,4,0,2,271,0.0,0.12819879,2
2020-06-04-170411,170411,1,0,0,272,1.0,0.08200905,3
2020-06-05-170411,170411,0,1,1,272,0.6666666666666666,0.19694012,4
2020-06-06-170411,170411,2,0,1,274,0.3333333333333333,0.026136832,5
2020-06-07-170411,170411,0,0,0,274,0.3333333333333333,0.025975097,6
2020-06-08-170411,170411,1,0,2,275,0.0,0.10039173,0
2020-06-09-170411,170411,2,0,0,277,2.333333333333333,0.25078663,1
2020-06-10-170411,170411,1,0,3,278,1.3333333333333333,0.16160035,2
2020-06-11-170411,170411,1,0,0,279,0.3333333333333333,0.15166335,3
2020-06-12-170411,170411,0,0,0,279,1.3333333333333333,0.1393343,4
2020-06-13-170411,170411,1,0,1,280,0.0,0.01118082,5
2020-06-14-170411,170411,0,8,0,280,0.3333333333333333,0.006822394,6
2020-06-15-170411,170411,2,0,3,282,1.6666666666666667,0.11303344,0
2020-06-16-170411,170411,2,0,0,284,0.6666666666666666,0.14967082,1
2020-06-17-170411,170411,2,0,3,286,1.0,0.12615718,2
2020-06-18-170411,170411,0,1,1,286,1.6666666666666667,0.06032617,3
2020-06-19-170411,170411,1,0,0,287,0.3333333333333333,0.044394284,4
2020-06-20-170411,170411,1,0,0,288,0.0,0.029137356,5
2020-06-21-170411,170411,0,0,0,288,0.3333333333333333,0.0072260504,6
2020-06-22-170411,170411,2,0,1,290,1.6666666666666667,0.11586097,0
2020-06-23-170411,170411,0,0,0,290,0.6666666666666666,0.07657662,1
2020-06-24-170411,170411,3,1,0,293,2.333333333333333,0.13970828,2
2020-06-25-170411,170411,0,1,0,293,0.0,0.04337309,3
2020-06-26-170411,170411,0,0,3,293,0.3333333333333333,0.05410579,4
2020-06-27-170411,170411,1,0,0,294,0.0,0.012713491,5
2020-06-28-170411,170411,0,0,0,294,0.0,0.00039567842,6
2020-06-29-170411,170411,3,0,1,297,1.3333333333333333,0.12375568,0
2020-06-30-170411,170411,0,0,0,297,1.3333333333333333,0.08634757,1
2020-07-01-170411,170411,3,0,1,300,1.0,0.16784132,2
2020-07-02-170411,170411,1,0,0,301,0.3333333333333333,0.064718686,3
2020-07-03-170411,170411,0,0,0,301,0.0,0.030482851,4
2020-07-04-170411,170411,0,0,0,301,0.0,0.014927278,5
2020-07-05-170411,170411,0,0,0,301,0.0,0.02100499,6
2020-07-06-170411,170411,1,0,0,302,1.0,0.0461143,0
2020-07-07-170411,170411,0,0,0,302,0.6666666666666666,0.089104764,1
2020-07-08-170411,170411,0,0,1,302,0.3333333333333333,0.0886775,2
2020-07-09-170411,170411,0,0,0,302,0.3333333333333333,0.044122513,3
2020-07-10-170411,170411,3,0,0,305,0.6666666666666666,0.11499173,4
2020-07-11-170411,170411,0,0,0,305,0.0,0.0006589694,5
2020-07-12-170411,170411,0,0,0,305,0.0,0.0007105358,6
2020-07-13-170411,170411,1,0,1,306,0.6666666666666666,0.11735132,0
2020-07-14-170411,170411,0,0,1,306,0.3333333333333333,0.059583336,1
2020-07-15-170411,170411,1,0,3,307,0.6666666666666666,0.068778254,2
2020-07-16-170411,170411,0,0,3,307,1.0,0.14431362,3
2020-07-17-170411,170411,0,0,2,307,0.0,0.028631885,4
2020-07-18-170411,170411,0,0,0,307,0.0,0.047531206,5
2020-07-19-170411,170411,0,0,0,307,0.0,0.13640574,6
2020-07-20-170411,170411,0,1,2,307,1.0,0.11466902,0
2020-07-21-170411,170411,0,1,1,307,3.333333333333333,0.17701188,1
2020-07-22-170411,170411,1,0,2,308,0.3333333333333333,0.09530859,2
2020-07-23-170411,170411,0,0,1,308,1.0,0.1338527,3
2020-07-24-170411,170411,0,0,0,308,0.6666666666666666,0.031856917,4
2020-07-25-170411,170411,0,0,1,308,0.3333333333333333,0.025489194,5
2020-07-26-170411,170411,0,0,1,308,0.0,0.0062149917,6
2020-07-27-170411,170411,1,0,2,309,1.3333333333333333,0.051526338,0
2020-07-28-170411,170411,1,0,0,310,0.6666666666666666,0.10669298,1
2020-07-29-170411,170411,3,0,0,313,1.3333333333333333,0.098352596,2
2020-07-30-170411,170411,3,0,2,316,0.6666666666666666,0.119078256,3
2020-07-31-170411,170411,2,0,1,318,0.6666666666666666,0.06456769,4
2020-08-01-170411,170411,0,0,0,318,0.0,0.007815953,5
2020-08-02-170411,170411,0,0,0,318,0.0,0.02050556,6
2020-08-03-170411,170411,2,0,3,320,1.0,0.11149389,0
2020-08-04-170411,170411,1,0,1,321,1.3333333333333333,0.15595898,1
2020-08-05-170411,170411,2,0,2,323,1.0,0.20349966,2
2020-08-06-170411,170411,1,0,0,324,0.6666666666666666,0.13893647,3
2020-08-07-170411,170411,0,0,2,324,2.333333333333333,0.31686568,4
2020-08-08-170411,170411,1,0,2,325,0.0,0.044303548,5
2020-08-09-170411,170411,1,1,0,326,1.0,0.05706575,6
2020-08-10-170411,170411,2,0,5,328,2.333333333333333,0.29289752,0
2020-08-11-170411,170411,0,0,2,328,1.6666666666666667,0.15158786,1
2020-08-12-170411,170411,0,0,6,328,2.333333333333333,0.18988799,2
2020-08-13-170411,170411,2,0,2,330,1.6666666666666667,0.15015504,3
2020-08-14-170411,170411,1,0,4,331,2.0,0.18358047,4
2020-08-15-170411,170411,0,0,0,331,0.3333333333333333,0.07825446,5
2020-08-16-170411,170411,0,0,1,331,0.3333333333333333,0.06937752,6
2020-08-17-170411,170411,3,0,2,334,1.0,0.112638295,0
2020-08-18-170411,170411,1,0,5,335,2.0,0.28359893,1
2020-08-19-170411,170411,2,0,0,337,1.6666666666666667,0.1688818,2
2020-08-20-170411,170411,0,0,2,337,1.3333333333333333,0.23731,3
2020-08-21-170411,170411,2,0,0,339,1.0,0.13800447,4
2020-08-22-170411,170411,2,0,1,341,1.0,0.14949536,5
2020-08-23-170411,170411,0,0,1,341,0.0,0.010423217,6
2020-08-24-170411,170411,5,0,1,346,1.6666666666666667,0.16875918,0
2020-08-25-170411,170411,2,0,0,348,1.6666666666666667,0.19415358,1
2020-08-26-170411,170411,6,0,1,354,0.6666666666666666,0.5330293,2
2020-08-27-170411,170411,2,0,2,356,2.6666666666666665,0.32329103,3
2020-08-28-170411,170411,4,0,2,360,2.0,0.32832628,4
2020-08-29-170411,170411,0,0,1,360,1.6666666666666667,0.17602639,5
2020-08-30-170411,170411,1,0,2,361,0.0,0.058441013,6
2020-08-31-170411,170411,2,0,0,363,0.0,0.14306559,0
2020-09-01-170411,170411,5,0,3,368,2.0,0.42293486,1
2020-09-02-170411,170411,0,0,9,368,1.3333333333333333,0.14390391,2
2020-09-03-170411,170411,2,0,5,370,0.6666666666666666,0.40765777,3
2020-09-04-170411,170411,0,0,7,370,1.6666666666666667,0.37678123,4
2020-09-05-170411,170411,1,0,2,371,1.3333333333333333,0.14626056,5
2020-09-06-170411,170411,1,0,0,372,1.3333333333333333,0.15544204,6
2020-09-07-170411,170411,1,0,3,373,1.3333333333333333,0.2626592,0
2020-09-08-170411,170411,0,0,7,373,0.6666666666666666,0.26295823,1
2020-09-09-170411,170411,1,0,10,374,0.6666666666666666,0.13582548,2
2020-09-10-170411,170411,2,0,3,376,2.333333333333333,0.26136053,3
2020-09-11-170411,170411,2,0,2,378,4.0,0.43940642,4
2020-09-12-170411,170411,1,0,1,379,2.6666666666666665,0.1789964,5
2020-09-13-170411,170411,2,0,1,381,0.6666666666666666,0.12589224,6
2020-09-14-170411,170411,0,0,2,381,2.6666666666666665,0.22341606,0
2020-09-15-170411,170411,3,0,4,384,3.333333333333333,0.43733838,1
2020-09-16-170411,170411,9,0,1,393,4.0,0.24080187,2
2020-09-17-170411,170411,5,0,10,398,5.333333333333333,0.5438112,3
2020-09-18-170411,170411,7,0,2,405,5.0,0.46799892,4
2020-09-19-170411,170411,2,0,0,407,3.0,0.24972466,5
2020-09-20-170411,170411,0,0,1,407,0.3333333333333333,0.09955714,6
2020-09-21-170411,170411,3,0,1,410,4.666666666666667,0.42087594,0
2020-09-22-170411,170411,7,0,4,417,6.666666666666668,0.765406,1
2020-09-23-170411,170411,10,1,2,427,4.666666666666667,0.50518936,2
2020-09-24-170411,170411,3,0,1,430,6.0,0.40702578,3
2020-09-25-170411,170411,2,0,6,432,3.0,0.44667977,4
2020-09-26-170411,170411,1,0,3,433,1.0,0.08052757,5
2020-09-27-170411,170411,1,0,2,434,1.6666666666666667,0.17975707,6
2020-09-28-170411,170411,2,0,2,436,8.666666666666666,0.5345062,0
2020-09-29-170411,170411,4,0,2,440,4.333333333333333,0.49192178,1
2020-09-30-170411,170411,1,0,6,441,4.333333333333333,0.4544154,2
2020-10-01-170411,170411,10,0,4,451,6.666666666666668,0.8467822,3
2020-10-02-170411,170411,2,0,14,453,5.0,0.73290706,4
2020-10-03-170411,170411,0,0,8,453,1.0,0.2978748,5
2020-10-04-170411,170411,1,0,4,454,4.666666666666667,0.1506277,6
2020-10-05-170411,170411,1,0,3,455,8.666666666666666,0.9645429,0
2020-10-06-170411,170411,4,0,8,459,5.333333333333333,0.596334,1
2020-10-07-170411,170411,2,0,3,461,8.666666666666666,0.76375514,2
2020-10-08-170411,170411,1,1,4,462,10.333333333333334,0.78983754,3
2020-10-09-170411,170411,6,0,17,468,7.0,0.8736086,4
2020-10-10-170411,170411,3,0,4,471,17.0,1.10255,5
2020-10-11-170411,170411,2,0,3,473,4.666666666666667,0.5004454,6
2020-10-12-170411,170411,2,0,4,475,7.0,0.34595767,0
2020-10-13-170411,170411,2,0,6,477,7.0,0.72254294,1
2020-10-14-170411,170411,6,0,9,483,7.333333333333332,0.6858097,2
2020-10-15-170411,170411,4,0,8,487,4.333333333333333,0.53771937,3
2020-10-16-170411,170411,14,0,6,501,14.666666666666664,0.93817604,4
2020-10-17-170411,170411,8,0,3,509,8.0,0.5735618,5
2020-10-18-170411,170411,4,0,4,513,9.333333333333334,0.43123263,6
2020-10-19-170411,170411,3,0,2,516,6.0,0.56555015,0
2020-10-20-170411,170411,8,0,4,524,12.666666666666664,1.1748418,1
2020-10-21-170411,170411,3,0,6,527,12.333333333333336,1.0698485,2
2020-10-22-170411,170411,4,0,8,531,13.0,1.1661155,3
2020-10-23-170411,170411,17,0,13,548,18.33333333333333,1.4353133,4
2020-10-24-170411,170411,4,0,6,552,9.0,0.56859803,5
2020-10-25-170411,170411,3,1,6,555,6.0,0.20778213,6
2020-10-26-170411,170411,4,0,3,559,8.666666666666666,1.0960785,0
2020-10-27-170411,170411,6,0,8,565,10.0,1.4483953,1
2020-10-28-170411,170411,9,0,12,574,8.0,0.9191943,2
2020-10-29-170411,170411,8,1,4,582,13.0,1.5738455,3
2020-10-30-170411,170411,6,0,13,588,18.0,1.6724128,4
2020-10-31-170411,170411,3,0,0,591,20.666666666666668,1.4241053,5
2020-11-01-170411,170411,4,0,0,595,11.333333333333336,0.6115351,6
2020-11-02-170411,170411,2,0,0,597,5.0,0.59835786,0
2020-11-03-170411,170411,4,1,0,601,11.333333333333336,1.5127078,1
2020-11-04-170411,170411,6,2,0,607,13.333333333333336,1.56461,2
2020-11-05-170411,170411,8,0,0,615,10.333333333333334,1.5068033,3
2020-11-06-170411,170411,13,0,0,628,22.0,1.5338181,4
2020-11-07-170411,170411,6,0,0,634,4.333333333333333,0.5839336,5
2020-11-08-170411,170411,6,0,0,640,7.333333333333332,0.34828693,6
2020-11-09-170411,170411,3,0,0,643,10.333333333333334,1.2373091,0
2020-11-10-170411,170411,8,1,0,651,9.0,0.7538005,1
2020-11-11-170411,170411,12,0,0,663,14.666666666666664,1.7340246,2
2020-11-12-170411,170411,4,1,0,667,8.666666666666666,0.9938695,3
2020-11-13-170411,170411,13,0,0,680,8.0,0.9864743,4
2020-03-01-170501,170501,0,0,1,0,0.0,0.0001422815,6
2020-03-02-170501,170501,0,0,0,0,0.0,0.0001728452,0
2020-03-03-170501,170501,0,0,1,0,0.0,0.004020769,1
2020-03-04-170501,170501,0,0,1,0,0.0,0.017082233,2
2020-03-05-170501,170501,0,0,1,0,0.0,0.0007203873,3
2020-03-06-170501,170501,0,0,1,0,0.0,0.013435805,4
2020-03-07-170501,170501,0,1,1,0,0.0,0.0001504678,5
2020-03-08-170501,170501,0,0,0,0,0.0,0.0062949806,6
2020-03-09-170501,170501,0,0,2,0,0.0,0.067100786,0
2020-03-10-170501,170501,0,0,2,0,0.0,0.002181153,1
2020-03-11-170501,170501,0,0,0,0,0.0,0.00952916,2
2020-03-12-170501,170501,0,0,6,0,0.6,0.34324658,3
2020-03-13-170501,170501,0,0,2,0,0.2,0.22129054,4
2020-03-14-170501,170501,0,0,1,0,0.6,0.30988944,5
2020-03-15-170501,170501,1,0,1,1,0.4,0.12891403,6
2020-03-16-170501,170501,0,0,4,1,0.2,0.24681477,0
2020-03-17-170501,170501,1,0,1,2,0.8,0.33763844,1
2020-03-18-170501,170501,1,0,4,3,0.2,0.25286126,2
2020-03-19-170501,170501,1,0,1,4,1.4,0.6472978,3
2020-03-20-170501,170501,1,0,3,5,2.0,0.9646501,4
2020-03-21-170501,170501,1,0,2,6,1.0,0.33148646,5
2020-03-22-170501,170501,0,0,1,6,0.4,0.062423173,6
2020-03-23-170501,170501,2,0,2,8,2.4,1.0206463,0
2020-03-24-170501,170501,2,0,3,10,0.8,0.473544,1
2020-03-25-170501,170501,0,0,0,10,0.8,0.5036978,2
2020-03-26-170501,170501,6,0,1,16,0.8,0.67791563,3
2020-03-27-170501,170501,2,0,2,18,2.2,1.0370188,4
2020-03-28-170501,170501,1,0,1,19,0.2,0.123267226,5
2020-03-29-170501,170501,1,0,1,20,0.8,0.18410328,6
2020-03-30-170501,170501,4,0,2,24,0.6,0.55835885,0
2020-03-31-170501,170501,1,0,1,25,0.4,0.23389743,1
2020-04-01-170501,170501,4,0,0,29,0.4,0.43014076,2
2020-04-02-170501,170501,1,0,1,30,0.6,0.3764791,3
2020-04-03-170501,170501,3,0,2,33,0.4,0.40789354,4
2020-04-04-170501,170501,2,0,1,35,0.2,0.12329743,5
2020-04-05-170501,170501,1,0,0,36,0.6,0.09942605,6
2020-04-06-170501,170501,2,6,2,38,0.6,0.3202962,0
2020-04-07-170501,170501,3,0,3,41,0.6,0.42026234,1
2020-04-08-170501,170501,0,0,0,41,1.4,0.5820145,2
2020-04-09-170501,170501,1,0,0,42,0.2,0.3076187,3
2020-04-10-170501,170501,2,0,0,44,0.4,0.20878243,4
2020-04-11-170501,170501,1,0,0,45,0.6,0.119007446,5
2020-04-12-170501,170501,1,0,0,46,0.0,0.034814496,6
2020-04-13-170501,170501,2,0,0,48,0.8,0.43783987,0
2020-04-14-170501,170501,1,0,1,49,0.8,0.49898767,1
2020-04-15-170501,170501,0,0,1,49,0.4,0.2798669,2
2020-04-16-170501,170501,1,0,0,50,0.2,0.23103392,3
2020-04-17-170501,170501,2,0,0,52,0.2,0.42701653,4
2020-04-18-170501,170501,1,0,0,53,0.0,0.108962715,5
2020-04-19-170501,170501,0,0,0,53,0.4,0.10667815,6
2020-04-20-170501,170501,2,0,1,55,0.4,0.82742244,0
2020-04-21-170501,170501,3,0,1,58,0.0,0.18334073,1
2020-04-22-170501,170501,0,0,2,58,0.4,0.27125943,2
2020-04-23-170501,170501,0,0,0,58,0.0,0.040116254,3
2020-04-24-170501,170501,0,0,2,58,0.2,0.16508639,4
2020-04-25-170501,170501,0,0,1,58,0.4,0.087838,5
2020-04-26-170501,170501,0,0,0,58,0.0,0.016554495,6
2020-04-27-170501,170501,0,0,3,58,0.2,0.116198,0
2020-04-28-170501,170501,1,0,2,59,0.6,0.27065036,1
2020-04-29-170501,170501,1,0,3,60,0.2,0.27597082,2
2020-04-30-170501,170501,0,0,2,60,0.6,0.2798545,3
2020-05-01-170501,170501,0,0,2,60,0.8,0.16619705,4
2020-05-02-170501,170501,0,0,0,60,0.2,0.053998966,5
2020-05-03-170501,170501,0,0,0,60,0.2,7.293411e-05,6
2020-05-04-170501,170501,1,0,1,61,1.6,0.7124363,0
2020-05-05-170501,170501,1,0,1,62,0.6,0.2086585,1
2020-05-06-170501,170501,2,0,1,64,0.6,0.33576646,2
2020-05-07-170501,170501,0,0,0,64,0.2,0.18180804,3
2020-05-08-170501,170501,2,0,3,66,0.6,0.4017147,4
2020-05-09-170501,170501,1,0,0,67,0.2,0.05248057,5
2020-05-10-170501,170501,0,1,0,67,0.2,0.04480322,6
2020-05-11-170501,170501,3,1,1,70,0.8,0.40701312,0
2020-05-12-170501,170501,2,0,3,72,0.4,0.2622247,1
2020-05-13-170501,170501,3,2,0,75,0.0,0.25008038,2
2020-05-14-170501,170501,2,0,2,77,0.2,0.23525722,3
2020-05-15-170501,170501,2,0,1,79,0.4,0.36067677,4
2020-05-16-170501,170501,0,0,1,79,0.0,0.00033100156,5
2020-05-17-170501,170501,0,0,3,79,0.4,0.091864094,6
2020-05-18-170501,170501,1,0,0,80,0.2,0.20105228,0
2020-05-19-170501,170501,1,0,5,81,0.2,0.20159851,1
2020-05-20-170501,170501,1,0,0,82,0.4,0.39616215,2
2020-05-21-170501,170501,0,0,3,82,0.4,0.3042065,3
2020-05-22-170501,170501,3,0,3,85,1.2,0.6019314,4
2020-05-23-170501,170501,0,0,1,85,0.0,0.020775232,5
2020-05-24-170501,170501,0,0,0,85,0.0,0.0002764305,6
2020-05-25-170501,170501,1,0,1,86,0.2,0.18630293,0
2020-05-26-170501,170501,3,0,0,89,0.6,0.42806146,1
2020-05-27-170501,170501,0,0,0,89,0.4,0.18240605,2
2020-05-28-170501,170501,2,1,0,91,0.0,0.21598399,3
2020-05-29-170501,170501,1,5,1,92,0.2,0.25082576,4
2020-05-30-170501,170501,1,0,0,93,0.0,0.05019981,5
2020-05-31-170501,170501,3,1,1,96,0.0,0.14784956,6
2020-06-01-170501,170501,0,0,9,96,0.2,0.17542161,0
2020-06-02-170501,170501,5,0,2,101,0.8,0.5840849,1
2020-06-03-170501,170501,0,0,1,101,0.6,0.3799347,2
2020-06-04-170501,170501,3,0,0,104,0.0,0.1577753,3
2020-06-05-170501,170501,3,0,1,107,0.4,0.5797241,4
2020-06-06-170501,170501,1,0,0,108,0.4,0.20315482,5
2020-06-07-170501,170501,0,0,1,108,0.0,7.811064e-05,6
2020-06-08-170501,170501,1,0,0,109,0.4,0.31708446,0
2020-06-09-170501,170501,0,0,0,109,0.4,0.17357433,1
2020-06-10-170501,170501,0,0,0,109,0.4,0.5386056,2
2020-06-11-170501,170501,0,0,0,109,0.6,0.3715502,3
2020-06-12-170501,170501,1,0,1,110,0.2,0.18491404,4
2020-06-13-170501,170501,0,0,0,110,0.2,0.091431685,5
2020-06-14-170501,170501,1,0,0,111,0.0,0.032777146,6
2020-06-15-170501,170501,9,0,0,120,0.6,0.6669301,0
2020-06-16-170501,170501,2,0,0,122,0.2,0.23172544,1
2020-06-17-170501,170501,1,0,0,123,0.0,0.090658486,2
2020-06-18-170501,170501,0,0,0,123,0.0,0.107700884,3
2020-06-19-170501,170501,1,0,0,124,0.2,0.19382936,4
2020-06-20-170501,170501,0,0,1,124,0.4,0.2680098,5
2020-06-21-170501,170501,1,0,2,125,0.2,0.12391216,6
2020-06-22-170501,170501,0,0,4,125,0.0,0.022051165,0
2020-06-23-170501,170501,0,0,2,125,0.2,0.18896945,1
2020-06-24-170501,170501,0,0,0,125,0.4,0.22784871,2
2020-06-25-170501,170501,0,0,0,125,0.2,0.06745202,3
2020-06-26-170501,170501,1,0,1,126,0.0,0.108974874,4
2020-06-27-170501,170501,0,0,0,126,0.2,0.283796,5
2020-06-28-170501,170501,0,0,1,126,0.0,0.002451444,6
2020-06-29-170501,170501,0,0,0,126,0.2,0.11424328,0
2020-06-30-170501,170501,0,0,0,126,0.8,0.561993,1
2020-07-01-170501,170501,0,0,0,126,0.2,0.17115462,2
2020-07-02-170501,170501,0,0,0,126,0.6,0.38993934,3
2020-07-03-170501,170501,0,0,0,126,0.0,0.21762091,4
2020-07-04-170501,170501,1,0,0,127,0.2,0.19415025,5
2020-07-05-170501,170501,2,0,0,129,0.2,0.1468397,6
2020-07-06-170501,170501,4,0,0,133,0.4,0.4992194,0
2020-07-07-170501,170501,2,0,0,135,0.4,0.28382868,1
2020-07-08-170501,170501,0,0,0,135,0.4,0.3279421,2
2020-07-09-170501,170501,0,0,0,135,0.2,0.08691666,3
2020-07-10-170501,170501,1,0,0,136,0.4,0.23323081,4
2020-07-11-170501,170501,0,0,4,136,0.0,0.016242653,5
2020-07-12-170501,170501,1,0,1,137,0.4,0.18237567,6
2020-07-13-170501,170501,0,0,0,137,0.2,0.108176544,0
2020-07-14-170501,170501,0,0,3,137,0.0,0.09526351,1
2020-07-15-170501,170501,0,0,4,137,0.2,0.10335993,2
2020-07-16-170501,170501,0,0,1,137,0.6,0.6491002,3
2020-07-17-170501,170501,0,0,1,137,0.2,0.30960435,4
2020-07-18-170501,170501,0,0,0,137,0.0,0.029557962,5
2020-07-19-170501,170501,0,0,2,137,0.2,0.04448995,6
2020-07-20-170501,170501,0,0,2,137,0.0,0.01247836,0
2020-07-21-170501,170501,0,0,3,137,0.6,0.26710305,1
2020-07-22-170501,170501,0,0,4,137,0.0,0.015064535,2
2020-07-23-170501,170501,0,0,2,137,0.0,0.10852786,3
2020-07-24-170501,170501,0,0,1,137,0.2,0.1680778,4
2020-07-25-170501,170501,4,0,0,141,0.2,0.35631165,5
2020-07-26-170501,170501,1,0,0,142,0.0,0.05108657,6
2020-07-27-170501,170501,0,0,1,142,0.4,0.33013654,0
2020-07-28-170501,170501,3,0,2,145,0.0,0.23866692,1
2020-07-29-170501,170501,4,0,1,149,1.0,0.9184576,2
2020-07-30-170501,170501,1,0,3,150,0.0,0.16226777,3
2020-07-31-170501,170501,1,0,5,151,0.4,0.16064513,4
2020-08-01-170501,170501,0,0,0,151,0.2,0.19129531,5
2020-08-02-170501,170501,2,0,4,153,0.2,0.18727955,6
2020-08-03-170501,170501,2,0,3,155,0.4,0.2988858,0
2020-08-04-170501,170501,3,0,15,158,1.0,0.7706003,1
2020-08-05-170501,170501,4,1,4,162,1.0,1.0585122,2
2020-08-06-170501,170501,2,0,1,164,0.0,0.33200115,3
2020-08-07-170501,170501,1,0,1,165,0.6,0.36541083,4
2020-08-08-170501,170501,0,0,2,165,0.4,0.33602118,5
2020-08-09-170501,170501,0,0,2,165,0.0,0.027814984,6
2020-08-10-170501,170501,1,0,6,166,1.4,1.0476171,0
2020-08-11-170501,170501,2,0,0,168,2.2,1.1002699,1
2020-08-12-170501,170501,1,0,5,169,3.2,2.4863687,2
2020-08-13-170501,170501,3,0,2,172,2.2,1.5362197,3
2020-08-14-170501,170501,5,0,0,177,1.6,1.3743632,4
2020-08-15-170501,170501,0,0,1,177,0.6,0.5327929,5
2020-08-16-170501,170501,4,0,2,181,0.2,0.59460163,6
2020-08-17-170501,170501,3,0,4,184,0.6,0.8779742,0
2020-08-18-170501,170501,15,0,5,199,0.0,1.334066,1
2020-08-19-170501,170501,4,0,8,203,0.6,0.65313596,2
2020-08-20-170501,170501,1,0,5,204,0.6,0.6312662,3
2020-08-21-170501,170501,1,0,2,205,1.4,1.4862858,4
2020-08-22-170501,170501,2,0,1,207,0.4,0.63786125,5
2020-08-23-170501,170501,2,0,0,209,2.0,1.1432489,6
2020-08-24-170501,170501,6,0,1,215,1.8,1.7893312,0
2020-08-25-170501,170501,0,0,2,215,2.8,3.0746036,1
2020-08-26-170501,170501,5,0,1,220,2.0,3.7704844,2
2020-08-27-170501,170501,2,0,2,222,1.8,1.5267799,3
2020-08-28-170501,170501,0,0,2,222,0.6,0.48753172,4
2020-08-29-170501,170501,1,0,1,223,0.0,0.18013874,5
2020-08-30-170501,170501,2,0,3,225,0.6,0.4351724,6
2020-08-31-170501,170501,4,0,12,229,1.2,0.7116475,0
2020-09-01-170501,170501,5,0,6,234,0.0,0.76708394,1
2020-09-02-170501,170501,8,0,2,242,0.4,0.6021085,2
2020-09-03-170501,170501,5,0,6,247,0.8,0.90787613,3
2020-09-04-170501,170501,2,0,9,249,0.6,0.37042424,4
2020-09-05-170501,170501,1,0,8,250,1.2,0.34524596,5
2020-09-06-170501,170501,0,0,5,250,0.0,0.20907186,6
2020-09-07-170501,170501,1,0,6,251,0.0,0.18300745,0
2020-09-08-170501,170501,2,0,5,253,0.4,0.65205604,1
2020-09-09-170501,170501,1,0,4,254,0.2,0.44268522,2
2020-09-10-170501,170501,2,0,3,256,1.2,0.8407879,3
2020-09-11-170501,170501,2,0,5,258,0.6,0.80389696,4
2020-09-12-170501,170501,1,0,0,259,0.8,0.573064,5
2020-09-13-170501,170501,3,0,5,262,0.6,0.5118522,6
2020-09-14-170501,170501,12,0,1,274,0.2,0.94259804,0
2020-09-15-170501,170501,6,0,3,280,1.2,1.0441993,1
2020-09-16-170501,170501,2,0,4,282,0.8,0.6961382,2
2020-09-17-170501,170501,6,0,6,288,0.8,0.7922443,3
2020-09-18-170501,170501,9,0,1,297,1.2,0.97476673,4
2020-09-19-170501,170501,8,0,5,305,0.4,0.5351247,5
2020-09-20-170501,170501,5,0,0,310,0.4,0.42852953,6
2020-09-21-170501,170501,6,1,4,316,0.4,0.46789953,0
2020-09-22-170501,170501,5,1,6,321,0.6,0.48595235,1
2020-09-23-170501,170501,4,1,1,325,1.6,0.9859907,2
2020-09-24-170501,170501,3,0,6,328,1.8,0.7649731,3
2020-09-25-170501,170501,5,2,6,333,1.0,0.6064715,4
2020-09-26-170501,170501,0,0,5,333,0.6,0.64346576,5
2020-09-27-170501,170501,5,0,4,338,1.0,0.5364714,6
2020-09-28-170501,170501,1,1,3,339,0.4,0.49568436,0
2020-09-29-170501,170501,3,0,9,342,1.2,1.0782229,1
2020-09-30-170501,170501,4,0,13,346,0.2,0.63596857,2
2020-10-01-170501,170501,6,0,5,352,0.2,0.79893404,3
2020-10-02-170501,170501,1,0,18,353,1.2,1.0697743,4
2020-10-03-170501,170501,5,0,13,358,1.0,0.73355275,5
2020-10-04-170501,170501,0,0,20,358,0.2,0.20251144,6
2020-10-05-170501,170501,4,0,5,362,0.8,0.8488296,0
2020-10-06-170501,170501,6,0,17,368,0.8,1.0578861,1
2020-10-07-170501,170501,1,0,13,369,0.2,0.64031714,2
2020-10-08-170501,170501,6,1,38,375,0.0,0.64073277,3
2020-10-09-170501,170501,6,0,13,381,1.4,0.94869345,4
2020-10-10-170501,170501,5,0,19,386,0.8,0.9968366,5
2020-10-11-170501,170501,4,0,21,390,1.2,0.82703096,6
2020-10-12-170501,170501,3,0,18,393,2.2,1.2428454,0
2020-10-13-170501,170501,9,0,20,402,1.0,1.2833217,1
2020-10-14-170501,170501,13,0,15,415,3.2,2.6254332,2
2020-10-15-170501,170501,5,0,31,420,0.6,1.3357952,3
2020-10-16-170501,170501,18,0,11,438,0.6,2.0745559,4
2020-10-17-170501,170501,13,0,4,451,3.4,2.3442912,5
2020-10-18-170501,170501,20,0,10,471,1.8,1.6271286,6
2020-10-19-170501,170501,5,0,14,476,2.0,1.5536115,0
2020-10-20-170501,170501,17,0,13,493,7.6,4.625653,1
2020-10-21-170501,170501,13,0,13,506,2.2,1.6685939,2
2020-10-22-170501,170501,38,0,9,544,2.6,3.0739717,3
2020-10-23-170501,170501,13,0,8,557,4.6,3.0907114,4
2020-10-24-170501,170501,19,1,11,576,3.0,1.6831937,5
2020-10-25-170501,170501,21,1,12,597,2.4,1.2420741,6
2020-10-26-170501,170501,18,0,9,615,1.2,1.6458523,0
2020-10-27-170501,170501,20,0,2,635,2.4,2.1860185,1
2020-10-28-170501,170501,15,0,2,650,3.8,3.014379,2
2020-10-29-170501,170501,31,0,12,681,4.6,4.41003,3
2020-10-30-170501,170501,11,1,13,692,4.2,2.6890604,4
2020-10-31-170501,170501,4,0,0,696,2.6,1.0999526,5
2020-11-01-170501,170501,10,0,0,706,2.8,1.3539588,6
2020-11-02-170501,170501,14,0,0,720,1.6,1.2140142,0
2020-11-03-170501,170501,13,1,0,733,2.2,2.402244,1
2020-11-04-170501,170501,13,1,0,746,2.0,1.5608914,2
2020-11-05-170501,170501,9,1,0,755,2.4,2.1708455,3
2020-11-06-170501,170501,8,0,0,763,1.0,1.2093917,4
2020-11-07-170501,170501,11,0,0,774,2.2,1.2949063,5
2020-11-08-170501,170501,12,0,0,786,2.2,1.0387006,6
2020-11-09-170501,170501,9,2,0,795,2.0,1.6206694,0
2020-11-10-170501,170501,2,0,0,797,1.4,1.1912729,1
2020-11-11-170501,170501,2,1,0,799,0.4,0.58032197,2
2020-11-12-170501,170501,12,0,0,811,1.8,2.0765314,3
2020-11-13-170501,170501,13,0,0,824,1.2,2.0759785,4
2020-03-01-170502,170502,0,0,0,0,0.0,0.00026692048,6
2020-03-02-170502,170502,0,0,0,0,0.0,0.00035570504,0
2020-03-03-170502,170502,0,0,0,0,0.0,0.0027436523,1
2020-03-04-170502,170502,0,0,0,0,0.0,0.0012063028,2
2020-03-05-170502,170502,0,0,0,0,0.0,0.00011919168,3
2020-03-06-170502,170502,0,0,1,0,0.0,0.001418714,4
2020-03-07-170502,170502,0,0,0,0,0.0,0.00023763625,5
2020-03-08-170502,170502,0,0,1,0,0.16666666666666666,0.029007547,6
2020-03-09-170502,170502,0,0,0,0,0.16666666666666666,0.015622303,0
2020-03-10-170502,170502,0,0,0,0,0.16666666666666666,0.007174268,1
2020-03-11-170502,170502,0,0,2,0,0.0,0.009153848,2
2020-03-12-170502,170502,0,0,2,0,0.3333333333333333,0.05208019,3
2020-03-13-170502,170502,0,0,4,0,0.5,0.08423024,4
2020-03-14-170502,170502,1,0,1,1,0.3333333333333333,0.22030786,5
2020-03-15-170502,170502,0,0,0,1,1.1666666666666667,0.055844195,6
2020-03-16-170502,170502,0,0,1,1,2.5,0.18727574,0
2020-03-17-170502,170502,0,0,0,1,3.333333333333333,0.3125545,1
2020-03-18-170502,170502,0,0,0,1,2.5,0.21310346,2
2020-03-19-170502,170502,0,0,0,1,4.166666666666667,0.40678912,3
2020-03-20-170502,170502,1,1,1,2,3.333333333333333,0.41097146,4
2020-03-21-170502,170502,0,0,0,2,3.333333333333333,0.14052318,5
2020-03-22-170502,170502,1,0,0,3,2.333333333333333,0.11956205,6
2020-03-23-170502,170502,0,1,0,3,6.666666666666668,0.61805797,0
2020-03-24-170502,170502,0,0,4,3,4.666666666666667,0.45216385,1
2020-03-25-170502,170502,2,0,1,5,4.166666666666667,0.43564555,2
2020-03-26-170502,170502,2,0,0,7,4.166666666666667,0.4783897,3
2020-03-27-170502,170502,4,0,1,11,4.0,0.5950404,4
2020-03-28-170502,170502,1,0,0,12,1.8333333333333333,0.14385046,5
2020-03-29-170502,170502,0,0,0,12,1.8333333333333333,0.09739858,6
2020-03-30-170502,170502,1,0,0,13,3.0,0.34924436,0
2020-03-31-170502,170502,0,0,0,13,2.6666666666666665,0.2095152,1
2020-04-01-170502,170502,0,0,0,13,3.6666666666666665,0.26793763,2
2020-04-02-170502,170502,0,0,0,13,3.0,0.21473281,3
2020-04-03-170502,170502,1,0,0,14,2.1666666666666665,0.24060073,4
2020-04-04-170502,170502,0,0,0,14,1.1666666666666667,0.07127998,5
2020-04-05-170502,170502,0,1,0,14,2.5,0.13322954,6
2020-04-06-170502,170502,0,2,0,14,2.333333333333333,0.25051606,0
2020-04-07-170502,170502,4,0,0,18,1.3333333333333333,0.3982939,1
2020-04-08-170502,170502,1,0,0,19,1.6666666666666667,0.3213958,2
2020-04-09-170502,170502,0,0,0,19,1.8333333333333333,0.15558141,3
2020-04-10-170502,170502,1,0,0,20,1.1666666666666667,0.1476905,4
2020-04-11-170502,170502,0,0,0,20,1.1666666666666667,0.055856418,5
2020-04-12-170502,170502,0,0,0,20,1.8333333333333333,0.028743202,6
2020-04-13-170502,170502,0,0,0,20,1.6666666666666667,0.16170391,0
2020-04-14-170502,170502,0,0,0,20,0.8333333333333334,0.079066075,1
2020-04-15-170502,170502,0,0,0,20,2.1666666666666665,0.16738805,2
2020-04-16-170502,170502,0,0,0,20,1.8333333333333333,0.17848293,3
2020-04-17-170502,170502,0,1,0,20,1.3333333333333333,0.13800009,4
2020-04-18-170502,170502,0,0,0,20,0.16666666666666666,0.0015382568,5
2020-04-19-170502,170502,0,0,0,20,0.5,0.024491815,6
2020-04-20-170502,170502,0,0,1,20,1.1666666666666667,0.16822723,0
2020-04-21-170502,170502,0,0,1,20,1.0,0.116347775,1
2020-04-22-170502,170502,0,0,0,20,1.1666666666666667,0.09982676,2
2020-04-23-170502,170502,0,0,0,20,0.6666666666666666,0.039154716,3
2020-04-24-170502,170502,0,0,0,20,1.0,0.10705991,4
2020-04-25-170502,170502,0,0,0,20,0.16666666666666666,0.016085276,5
2020-04-26-170502,170502,0,0,0,20,0.6666666666666666,0.031548396,6
2020-04-27-170502,170502,0,1,2,20,0.3333333333333333,0.058897037,0
2020-04-28-170502,170502,0,0,2,20,1.3333333333333333,0.1430113,1
2020-04-29-170502,170502,0,0,0,20,0.8333333333333334,0.119210966,2
2020-04-30-170502,170502,0,0,0,20,1.0,0.053931464,3
2020-05-01-170502,170502,0,0,0,20,0.3333333333333333,0.007798516,4
2020-05-02-170502,170502,0,0,0,20,0.5,0.01982596,5
2020-05-03-170502,170502,0,0,0,20,0.5,0.025253443,6
2020-05-04-170502,170502,1,0,0,21,0.8333333333333334,0.19607794,0
2020-05-05-170502,170502,1,1,1,22,1.0,0.22744906,1
2020-05-06-170502,170502,0,0,0,22,1.3333333333333333,0.13949417,2
2020-05-07-170502,170502,0,0,0,22,2.0,0.1828184,3
2020-05-08-170502,170502,0,0,0,22,0.5,0.054820735,4
2020-05-09-170502,170502,0,0,0,22,0.16666666666666666,0.010776664,5
2020-05-10-170502,170502,0,1,0,22,0.3333333333333333,0.013523747,6
2020-05-11-170502,170502,2,0,0,24,1.8333333333333333,0.3770907,0
2020-05-12-170502,170502,2,1,0,26,0.5,0.27078715,1
2020-05-13-170502,170502,0,0,0,26,0.8333333333333334,0.10208086,2
2020-05-14-170502,170502,0,2,0,26,0.6666666666666666,0.096958466,3
2020-05-15-170502,170502,0,0,0,26,1.1666666666666667,0.15387075,4
2020-05-16-170502,170502,0,4,0,26,0.6666666666666666,0.038276505,5
2020-05-17-170502,170502,0,0,0,26,0.3333333333333333,0.02042338,6
2020-05-18-170502,170502,0,0,0,26,1.3333333333333333,0.119321264,0
2020-05-19-170502,170502,1,0,0,27,1.3333333333333333,0.21524356,1
2020-05-20-170502,170502,0,0,0,27,0.8333333333333334,0.096257664,2
2020-05-21-170502,170502,0,0,0,27,1.0,0.17438021,3
2020-05-22-170502,170502,0,0,0,27,1.1666666666666667,0.23885567,4
2020-05-23-170502,170502,0,0,0,27,0.0,0.0011365943,5
2020-05-24-170502,170502,0,0,0,27,0.0,0.00019912416,6
2020-05-25-170502,170502,0,0,0,27,1.0,0.08679851,0
2020-05-26-170502,170502,0,0,0,27,0.8333333333333334,0.07679014,1
2020-05-27-170502,170502,0,0,0,27,0.6666666666666666,0.05740696,2
2020-05-28-170502,170502,0,1,0,27,0.6666666666666666,0.09247168,3
2020-05-29-170502,170502,0,2,0,27,0.5,0.19373842,4
2020-05-30-170502,170502,0,1,0,27,0.16666666666666666,0.017079424,5
2020-05-31-170502,170502,0,0,0,27,0.16666666666666666,0.017956533,6
2020-06-01-170502,170502,0,0,0,27,0.3333333333333333,0.05195108,0
2020-06-02-170502,170502,0,0,0,27,0.3333333333333333,0.04930251,1
2020-06-03-170502,170502,0,0,0,27,0.3333333333333333,0.050853904,2
2020-06-04-170502,170502,0,0,0,27,0.3333333333333333,0.06364256,3
2020-06-05-170502,170502,0,1,0,27,0.5,0.09344447,4
2020-06-06-170502,170502,0,0,0,27,0.3333333333333333,0.036161676,5
2020-06-07-170502,170502,0,1,0,27,0.0,0.00013440065,6
2020-06-08-170502,170502,0,0,0,27,0.5,0.024236275,0
2020-06-09-170502,170502,0,0,0,27,0.16666666666666666,0.02634996,1
2020-06-10-170502,170502,0,0,1,27,0.16666666666666666,0.047236323,2
2020-06-11-170502,170502,0,0,0,27,0.16666666666666666,0.039462857,3
2020-06-12-170502,170502,0,0,0,27,0.6666666666666666,0.14044078,4
2020-06-13-170502,170502,0,2,0,27,0.0,0.025835438,5
2020-06-14-170502,170502,0,0,0,27,0.0,6.7461086e-05,6
2020-06-15-170502,170502,0,0,0,27,0.16666666666666666,0.03128832,0
2020-06-16-170502,170502,0,0,0,27,0.3333333333333333,0.049216535,1
2020-06-17-170502,170502,0,0,0,27,0.5,0.030926479,2
2020-06-18-170502,170502,0,0,0,27,1.0,0.25112662,3
2020-06-19-170502,170502,0,0,0,27,0.8333333333333334,0.051508404,4
2020-06-20-170502,170502,0,0,0,27,0.3333333333333333,0.006865057,5
2020-06-21-170502,170502,0,0,0,27,0.0,0.0026979172,6
2020-06-22-170502,170502,0,0,1,27,0.16666666666666666,0.0112401005,0
2020-06-23-170502,170502,0,0,0,27,0.0,0.012311909,1
2020-06-24-170502,170502,1,0,0,28,0.8333333333333334,0.077038884,2
2020-06-25-170502,170502,0,0,0,28,0.3333333333333333,0.057483893,3
2020-06-26-170502,170502,0,0,0,28,0.6666666666666666,0.055135567,4
2020-06-27-170502,170502,0,0,0,28,0.16666666666666666,0.026987787,5
2020-06-28-170502,170502,0,0,0,28,0.0,0.0011819734,6
2020-06-29-170502,170502,0,0,0,28,0.16666666666666666,0.029202785,0
2020-06-30-170502,170502,0,0,1,28,0.3333333333333333,0.01953619,1
2020-07-01-170502,170502,0,1,0,28,0.0,0.007524851,2
2020-07-02-170502,170502,0,0,0,28,0.3333333333333333,0.104940794,3
2020-07-03-170502,170502,0,0,0,28,0.16666666666666666,0.02863545,4
2020-07-04-170502,170502,0,0,0,28,0.16666666666666666,0.0012629867,5
2020-07-05-170502,170502,0,0,0,28,0.0,0.0015630694,6
2020-07-06-170502,170502,1,0,0,29,0.3333333333333333,0.14464937,0
2020-07-07-170502,170502,0,0,0,29,0.5,0.058854777,1
2020-07-08-170502,170502,0,0,0,29,0.0,0.002930333,2
2020-07-09-170502,170502,0,0,0,29,0.3333333333333333,0.026501402,3
2020-07-10-170502,170502,0,0,0,29,0.5,0.054450907,4
2020-07-11-170502,170502,0,0,0,29,0.16666666666666666,0.00069241226,5
2020-07-12-170502,170502,0,0,0,29,0.16666666666666666,0.020837551,6
2020-07-13-170502,170502,0,0,1,29,0.16666666666666666,0.008121133,0
2020-07-14-170502,170502,1,0,0,30,0.8333333333333334,0.021034105,1
2020-07-15-170502,170502,0,0,0,30,1.0,0.026353063,2
2020-07-16-170502,170502,0,0,0,30,0.3333333333333333,0.02630501,3
2020-07-17-170502,170502,0,0,0,30,0.16666666666666666,0.010813821,4
2020-07-18-170502,170502,0,0,0,30,0.0,0.0028030386,5
2020-07-19-170502,170502,0,0,0,30,0.16666666666666666,0.015002597,6
2020-07-20-170502,170502,0,0,0,30,0.0,0.010049938,0
2020-07-21-170502,170502,0,0,0,30,0.3333333333333333,0.086070575,1
2020-07-22-170502,170502,0,0,0,30,0.16666666666666666,0.03623663,2
2020-07-23-170502,170502,0,0,0,30,0.5,0.11319819,3
2020-07-24-170502,170502,0,0,0,30,0.16666666666666666,0.036776397,4
2020-07-25-170502,170502,0,0,0,30,0.0,0.0036800997,5
2020-07-26-170502,170502,0,0,1,30,0.16666666666666666,0.00043388276,6
2020-07-27-170502,170502,1,0,0,31,0.16666666666666666,0.213783,0
2020-07-28-170502,170502,0,0,0,31,0.16666666666666666,0.08756617,1
2020-07-29-170502,170502,0,0,1,31,0.5,0.045830954,2
2020-07-30-170502,170502,0,0,3,31,0.8333333333333334,0.09731223,3
2020-07-31-170502,170502,0,0,1,31,0.5,0.07150072,4
2020-08-01-170502,170502,0,0,0,31,0.16666666666666666,0.021042947,5
2020-08-02-170502,170502,0,0,0,31,0.16666666666666666,0.086514995,6
2020-08-03-170502,170502,0,0,1,31,0.5,0.08089283,0
2020-08-04-170502,170502,0,0,1,31,0.8333333333333334,0.14744988,1
2020-08-05-170502,170502,0,0,1,31,0.8333333333333334,0.21629354,2
2020-08-06-170502,170502,0,0,1,31,1.3333333333333333,0.18163787,3
2020-08-07-170502,170502,0,0,1,31,1.0,0.13160776,4
2020-08-08-170502,170502,0,0,0,31,0.16666666666666666,0.0987727,5
2020-08-09-170502,170502,1,0,0,32,0.16666666666666666,0.18276358,6
2020-08-10-170502,170502,0,0,2,32,0.16666666666666666,0.05654003,0
2020-08-11-170502,170502,0,0,0,32,1.1666666666666667,0.13540448,1
2020-08-12-170502,170502,1,0,0,33,2.0,0.38622186,2
2020-08-13-170502,170502,3,0,0,36,2.0,0.19293272,3
2020-08-14-170502,170502,1,0,0,37,1.3333333333333333,0.38496196,4
2020-08-15-170502,170502,0,0,0,37,1.8333333333333333,0.1951855,5
2020-08-16-170502,170502,0,0,0,37,0.6666666666666666,0.17154503,6
2020-08-17-170502,170502,1,0,0,38,2.0,0.42188925,0
2020-08-18-170502,170502,1,0,1,39,1.8333333333333333,0.35868058,1
2020-08-19-170502,170502,1,0,0,40,1.3333333333333333,0.48209864,2
2020-08-20-170502,170502,1,0,4,41,2.0,0.39011174,3
2020-08-21-170502,170502,1,0,0,42,2.6666666666666665,0.6697164,4
2020-08-22-170502,170502,0,0,0,42,0.3333333333333333,0.20784481,5
2020-08-23-170502,170502,0,0,3,42,1.8333333333333333,0.287277,6
2020-08-24-170502,170502,2,0,2,44,2.5,0.2466799,0
2020-08-25-170502,170502,0,0,2,44,1.8333333333333333,0.11276978,1
2020-08-26-170502,170502,0,0,3,44,1.6666666666666667,0.195428,2
2020-08-27-170502,170502,0,0,0,44,1.8333333333333333,0.14367113,3
2020-08-28-170502,170502,0,0,1,44,2.5,0.40306282,4
2020-08-29-170502,170502,0,0,1,44,1.1666666666666667,0.096057855,5
2020-08-30-170502,170502,0,0,0,44,2.0,0.27541727,6
2020-08-31-170502,170502,0,0,1,44,0.6666666666666666,0.14679213,0
2020-09-01-170502,170502,1,0,7,45,1.3333333333333333,0.33583727,1
2020-09-02-170502,170502,0,0,1,45,0.8333333333333334,0.17966044,2
2020-09-03-170502,170502,4,0,1,49,3.0,0.74824417,3
2020-09-04-170502,170502,0,0,7,49,2.833333333333333,0.43237665,4
2020-09-05-170502,170502,0,0,0,49,0.3333333333333333,0.19499522,5
2020-09-06-170502,170502,3,0,1,52,3.1666666666666665,0.5985508,6
2020-09-07-170502,170502,2,0,1,54,1.6666666666666667,0.317734,0
2020-09-08-170502,170502,2,0,0,56,3.1666666666666665,0.71635664,1
2020-09-09-170502,170502,3,0,3,59,2.0,0.6597106,2
2020-09-10-170502,170502,0,0,0,59,3.333333333333333,0.6264602,3
2020-09-11-170502,170502,1,0,1,60,2.6666666666666665,0.50486314,4
2020-09-12-170502,170502,1,0,1,61,3.1666666666666665,0.30940717,5
2020-09-13-170502,170502,0,0,1,61,1.3333333333333333,0.22343244,6
2020-09-14-170502,170502,1,0,2,62,3.8333333333333335,0.43320638,0
2020-09-15-170502,170502,7,0,0,69,3.1666666666666665,1.2128114,1
2020-09-16-170502,170502,1,0,0,70,3.5,0.35259333,2
2020-09-17-170502,170502,1,0,0,71,4.833333333333333,0.29595813,3
2020-09-18-170502,170502,7,0,0,78,4.333333333333333,1.0116465,4
2020-09-19-170502,170502,0,0,2,78,1.3333333333333333,0.079936445,5
2020-09-20-170502,170502,1,0,0,79,2.6666666666666665,0.26613885,6
2020-09-21-170502,170502,1,0,0,80,3.0,0.4156851,0
2020-09-22-170502,170502,0,0,0,80,2.333333333333333,0.09140338,1
2020-09-23-170502,170502,3,0,0,83,3.333333333333333,0.2673468,2
2020-09-24-170502,170502,0,1,0,83,2.833333333333333,0.2728695,3
2020-09-25-170502,170502,1,0,0,84,3.8333333333333335,0.17694804,4
2020-09-26-170502,170502,1,0,0,85,2.0,0.29075724,5
2020-09-27-170502,170502,1,0,0,86,1.5,0.18617348,6
2020-09-28-170502,170502,2,0,0,88,2.1666666666666665,0.35931882,0
2020-09-29-170502,170502,0,0,1,88,3.6666666666666665,0.11474808,1
2020-09-30-170502,170502,0,0,0,88,3.1666666666666665,0.40804544,2
2020-10-01-170502,170502,0,0,2,88,3.333333333333333,0.22500964,3
2020-10-02-170502,170502,0,0,1,88,3.333333333333333,0.3383643,4
2020-10-03-170502,170502,2,0,0,90,1.3333333333333333,0.4599985,5
2020-10-04-170502,170502,0,1,0,90,1.1666666666666667,0.19441722,6
2020-10-05-170502,170502,0,0,1,90,1.5,0.32585794,0
2020-10-06-170502,170502,0,0,1,90,3.5,0.49203444,1
2020-10-07-170502,170502,0,0,1,90,2.0,0.3752653,2
2020-10-08-170502,170502,0,0,0,90,4.0,0.5248065,3
2020-10-09-170502,170502,0,1,2,90,3.5,0.2590671,4
2020-10-10-170502,170502,0,0,0,90,2.1666666666666665,0.30805883,5
2020-10-11-170502,170502,0,0,0,90,0.5,0.114176385,6
2020-10-12-170502,170502,0,0,5,90,0.8333333333333334,0.053704374,0
2020-10-13-170502,170502,1,0,2,91,0.5,0.26452035,1
2020-10-14-170502,170502,0,0,9,91,4.666666666666667,0.6917017,2
2020-10-15-170502,170502,2,0,5,93,2.5,0.5380265,3
2020-10-16-170502,170502,1,0,0,94,3.6666666666666665,0.4667085,4
2020-10-17-170502,170502,0,0,2,94,1.3333333333333333,0.17401856,5
2020-10-18-170502,170502,0,0,2,94,1.1666666666666667,0.13531636,6
2020-10-19-170502,170502,1,0,0,95,3.1666666666666665,0.4786193,0
2020-10-20-170502,170502,1,0,1,96,4.333333333333333,0.53364235,1
2020-10-21-170502,170502,1,0,9,97,2.6666666666666665,0.38614357,2
2020-10-22-170502,170502,0,0,5,97,3.5,0.49088678,3
2020-10-23-170502,170502,2,0,20,99,7.333333333333332,1.1903007,4
2020-10-24-170502,170502,0,0,4,99,5.5,0.5177704,5
2020-10-25-170502,170502,0,0,0,99,1.8333333333333333,0.15723996,6
2020-10-26-170502,170502,5,0,3,104,3.5,1.0764216,0
2020-10-27-170502,170502,2,0,6,106,4.333333333333333,0.7275161,1
2020-10-28-170502,170502,9,0,0,115,6.5,1.7535341,2
2020-10-29-170502,170502,5,0,5,120,4.833333333333333,1.2884248,3
2020-10-30-170502,170502,0,0,1,120,8.5,1.016363,4
2020-10-31-170502,170502,2,0,0,122,4.0,0.7377692,5
2020-11-01-170502,170502,2,0,0,124,3.0,0.63525885,6
2020-11-02-170502,170502,0,1,0,124,0.8333333333333334,0.14992642,0
2020-11-03-170502,170502,1,0,0,125,6.166666666666668,0.67316926,1
2020-11-04-170502,170502,9,0,0,134,5.666666666666668,1.7391449,2
2020-11-05-170502,170502,5,1,0,139,8.5,3.0122695,3
2020-11-06-170502,170502,20,0,0,159,7.333333333333332,1.2032603,4
2020-11-07-170502,170502,4,0,0,163,11.5,1.1684277,5
2020-11-08-170502,170502,0,0,0,163,2.1666666666666665,0.13767083,6
2020-11-09-170502,170502,3,0,0,166,3.1666666666666665,0.90411997,0
2020-11-10-170502,170502,6,0,0,172,3.8333333333333335,0.8008323,1
2020-11-11-170502,170502,0,0,0,172,3.5,0.2794871,2
2020-11-12-170502,170502,5,1,0,177,2.6666666666666665,1.1941265,3
2020-11-13-170502,170502,1,1,0,178,7.333333333333332,1.1405581,4
2020-03-01-170503,170503,0,0,0,0,0.0,1.0152815e-05,6
2020-03-02-170503,170503,0,0,0,0,0.0,1.1961497e-05,0
2020-03-03-170503,170503,0,1,0,0,0.0,0.00023468891,1
2020-03-04-170503,170503,0,0,0,0,0.0,0.0014506191,2
2020-03-05-170503,170503,0,0,1,0,0.0,0.0006590166,3
2020-03-06-170503,170503,0,1,0,0,0.0,0.0027255695,4
2020-03-07-170503,170503,0,0,1,0,0.0,0.0010470076,5
2020-03-08-170503,170503,0,0,1,0,0.16666666666666666,0.07996265,6
2020-03-09-170503,170503,0,0,1,0,0.16666666666666666,0.21888608,0
2020-03-10-170503,170503,0,0,1,0,0.0,0.0020930367,1
2020-03-11-170503,170503,0,0,0,0,0.0,0.006062049,2
2020-03-12-170503,170503,0,0,1,0,0.5,0.2715392,3
2020-03-13-170503,170503,0,0,5,0,0.3333333333333333,0.26977482,4
2020-03-14-170503,170503,0,0,2,0,0.5,0.18846169,5
2020-03-15-170503,170503,0,0,0,0,0.5,0.089030035,6
2020-03-16-170503,170503,0,0,5,0,1.0,0.48043317,0
2020-03-17-170503,170503,0,0,1,0,0.5,0.15383223,1
2020-03-18-170503,170503,0,0,5,0,0.8333333333333334,0.3186623,2
2020-03-19-170503,170503,1,0,1,1,1.1666666666666667,0.6623553,3
2020-03-20-170503,170503,0,0,2,1,2.833333333333333,0.91192746,4
2020-03-21-170503,170503,1,0,2,2,1.6666666666666667,0.6244117,5
2020-03-22-170503,170503,1,1,0,3,1.0,0.26059633,6
2020-03-23-170503,170503,1,0,2,4,2.6666666666666665,1.1749543,0
2020-03-24-170503,170503,1,0,0,5,1.6666666666666667,0.8352275,1
2020-03-25-170503,170503,0,0,3,5,1.5,0.54802144,2
2020-03-26-170503,170503,1,1,12,6,2.1666666666666665,0.92402023,3
2020-03-27-170503,170503,5,1,1,11,3.8333333333333335,1.8243386,4
2020-03-28-170503,170503,2,0,1,13,1.0,0.4240232,5
2020-03-29-170503,170503,0,0,3,13,1.1666666666666667,0.40415052,6
2020-03-30-170503,170503,5,0,5,18,2.5,1.2484721,0
2020-03-31-170503,170503,1,0,2,19,1.3333333333333333,0.57838416,1
2020-04-01-170503,170503,5,0,1,24,1.6666666666666667,1.0251217,2
2020-04-02-170503,170503,1,0,3,25,1.5,0.44964197,3
2020-04-03-170503,170503,2,0,16,27,0.8333333333333334,0.44101626,4
2020-04-04-170503,170503,2,0,0,29,0.8333333333333334,0.40707323,5
2020-04-05-170503,170503,0,0,2,29,0.8333333333333334,0.28921244,6
2020-04-06-170503,170503,2,0,14,31,1.6666666666666667,0.6870558,0
2020-04-07-170503,170503,0,0,0,31,1.0,0.46846247,1
2020-04-08-170503,170503,3,0,2,34,2.1666666666666665,1.064973,2
2020-04-09-170503,170503,12,0,4,46,1.5,1.1621643,3
2020-04-10-170503,170503,1,0,1,47,5.5,1.499896,4
2020-04-11-170503,170503,1,0,1,48,0.5,0.1865995,5
2020-04-12-170503,170503,3,0,1,51,0.16666666666666666,0.17535125,6
2020-04-13-170503,170503,5,0,0,56,1.1666666666666667,0.99937564,0
2020-04-14-170503,170503,2,0,0,58,0.8333333333333334,0.5719366,1
2020-04-15-170503,170503,1,0,3,59,1.3333333333333333,0.6674391,2
2020-04-16-170503,170503,3,0,1,62,0.3333333333333333,0.4865218,3
2020-04-17-170503,170503,16,0,0,78,0.5,1.8037229,4
2020-04-18-170503,170503,0,0,3,78,0.0,0.009170426,5
2020-04-19-170503,170503,2,0,0,80,0.3333333333333333,0.1600359,6
2020-04-20-170503,170503,14,0,2,94,0.6666666666666666,1.6056088,0
2020-04-21-170503,170503,0,0,0,94,0.6666666666666666,0.3873285,1
2020-04-22-170503,170503,2,0,0,96,0.5,0.4265879,2
2020-04-23-170503,170503,4,0,2,100,0.0,0.294216,3
2020-04-24-170503,170503,1,0,3,101,0.8333333333333334,0.440562,4
2020-04-25-170503,170503,1,0,0,102,1.0,0.42980912,5
2020-04-26-170503,170503,1,0,0,103,0.3333333333333333,0.1845145,6
2020-04-27-170503,170503,0,0,0,103,0.8333333333333334,0.24411747,0
2020-04-28-170503,170503,0,0,1,103,0.6666666666666666,0.2935397,1
2020-04-29-170503,170503,3,0,1,106,0.3333333333333333,0.5804726,2
2020-04-30-170503,170503,1,0,0,107,0.6666666666666666,0.39350668,3
2020-05-01-170503,170503,0,0,2,107,0.6666666666666666,0.17381828,4
2020-05-02-170503,170503,3,0,0,110,0.16666666666666666,0.26795638,5
2020-05-03-170503,170503,0,0,0,110,0.0,0.0006344205,6
2020-05-04-170503,170503,2,0,0,112,1.1666666666666667,0.83814013,0
2020-05-05-170503,170503,0,0,2,112,0.16666666666666666,0.047352817,1
2020-05-06-170503,170503,0,0,3,112,0.5,0.335288,2
2020-05-07-170503,170503,2,0,2,114,0.3333333333333333,0.45836478,3
2020-05-08-170503,170503,3,0,0,117,1.0,0.6159261,4
2020-05-09-170503,170503,0,0,0,117,0.0,0.010268143,5
2020-05-10-170503,170503,0,0,0,117,0.3333333333333333,0.10345298,6
2020-05-11-170503,170503,0,2,0,117,0.5,0.27900475,0
2020-05-12-170503,170503,1,0,0,118,0.6666666666666666,0.41365868,1
2020-05-13-170503,170503,1,1,1,119,0.3333333333333333,0.32984284,2
2020-05-14-170503,170503,0,1,0,119,0.3333333333333333,0.10859713,3
2020-05-15-170503,170503,2,0,0,121,0.5,0.49705154,4
2020-05-16-170503,170503,0,0,0,121,0.0,0.0024593421,5
2020-05-17-170503,170503,0,0,0,121,0.16666666666666666,0.07117848,6
2020-05-18-170503,170503,0,0,3,121,0.5,0.1481177,0
2020-05-19-170503,170503,2,0,0,123,0.16666666666666666,0.37908116,1
2020-05-20-170503,170503,3,0,1,126,0.3333333333333333,0.55810827,2
2020-05-21-170503,170503,2,0,1,128,0.8333333333333334,0.7060617,3
2020-05-22-170503,170503,0,0,5,128,1.0,0.49701333,4
2020-05-23-170503,170503,0,0,0,128,0.16666666666666666,0.084218875,5
2020-05-24-170503,170503,0,0,0,128,0.0,1.0818485e-05,6
2020-05-25-170503,170503,0,0,2,128,0.16666666666666666,0.09058988,0
2020-05-26-170503,170503,0,0,0,128,0.6666666666666666,0.34051466,1
2020-05-27-170503,170503,1,0,2,129,0.3333333333333333,0.43348578,2
2020-05-28-170503,170503,0,0,3,129,0.5,0.3097614,3
2020-05-29-170503,170503,0,3,1,129,1.1666666666666667,0.7077286,4
2020-05-30-170503,170503,0,0,0,129,0.0,0.027282912,5
2020-05-31-170503,170503,0,0,0,129,0.5,0.24816266,6
2020-06-01-170503,170503,3,0,2,132,0.5,0.5263708,0
2020-06-02-170503,170503,0,0,0,132,0.8333333333333334,0.41199824,1
2020-06-03-170503,170503,1,0,1,133,0.3333333333333333,0.36768287,2
2020-06-04-170503,170503,1,0,2,134,0.6666666666666666,0.49237823,3
2020-06-05-170503,170503,5,0,1,139,0.6666666666666666,0.8860107,4
2020-06-06-170503,170503,0,0,1,139,0.3333333333333333,0.13448149,5
2020-06-07-170503,170503,0,0,0,139,0.0,1.0405034e-05,6
2020-06-08-170503,170503,2,0,0,141,0.16666666666666666,0.3000588,0
2020-06-09-170503,170503,0,0,0,141,0.5,0.3268088,1
2020-06-10-170503,170503,2,0,1,143,2.5,1.5735841,2
2020-06-11-170503,170503,3,0,0,146,1.0,0.9883787,3
2020-06-12-170503,170503,1,0,1,147,0.3333333333333333,0.33608377,4
2020-06-13-170503,170503,0,0,1,147,0.3333333333333333,0.11811064,5
2020-06-14-170503,170503,0,0,0,147,0.0,0.003515141,6
2020-06-15-170503,170503,2,0,1,149,0.3333333333333333,0.5255405,0
2020-06-16-170503,170503,0,0,0,149,0.0,0.0542077,1
2020-06-17-170503,170503,1,0,1,150,0.0,0.15198438,2
2020-06-18-170503,170503,2,0,1,152,0.16666666666666666,0.3881515,3
2020-06-19-170503,170503,1,0,1,153,0.0,0.19069836,4
2020-06-20-170503,170503,1,0,0,154,0.16666666666666666,0.23292412,5
2020-06-21-170503,170503,0,0,1,154,0.16666666666666666,0.09949635,6
2020-06-22-170503,170503,0,0,1,154,0.0,0.014279768,0
2020-06-23-170503,170503,0,0,0,154,0.3333333333333333,0.22481032,1
2020-06-24-170503,170503,1,1,1,155,0.16666666666666666,0.30907467,2
2020-06-25-170503,170503,0,0,0,155,0.5,0.26199585,3
2020-06-26-170503,170503,1,0,1,156,0.5,0.3566683,4
2020-06-27-170503,170503,1,0,1,157,0.16666666666666666,0.23697293,5
2020-06-28-170503,170503,0,0,0,157,0.0,0.00018297398,6
2020-06-29-170503,170503,1,0,0,158,0.16666666666666666,0.2033588,0
2020-06-30-170503,170503,0,0,2,158,0.16666666666666666,0.29819205,1
2020-07-01-170503,170503,1,0,4,159,0.16666666666666666,0.2549544,2
2020-07-02-170503,170503,1,0,4,160,0.3333333333333333,0.3892938,3
2020-07-03-170503,170503,1,0,0,161,0.16666666666666666,0.4052845,4
2020-07-04-170503,170503,0,0,0,161,0.0,0.013121846,5
2020-07-05-170503,170503,1,0,0,162,0.16666666666666666,0.07200745,6
2020-07-06-170503,170503,1,0,0,163,0.8333333333333334,0.7300902,0
2020-07-07-170503,170503,0,0,0,163,0.16666666666666666,0.02967624,1
2020-07-08-170503,170503,1,1,0,164,0.0,0.18551663,2
2020-07-09-170503,170503,0,0,0,164,0.0,0.028256789,3
2020-07-10-170503,170503,1,0,2,165,0.16666666666666666,0.29614198,4
2020-07-11-170503,170503,1,0,1,166,0.16666666666666666,0.12583302,5
2020-07-12-170503,170503,0,0,0,166,0.0,0.03694084,6
2020-07-13-170503,170503,0,0,2,166,0.0,0.015181621,0
2020-07-14-170503,170503,2,0,2,168,0.0,0.529376,1
2020-07-15-170503,170503,4,0,0,172,0.5,0.4737903,2
2020-07-16-170503,170503,4,0,0,176,0.3333333333333333,0.79405254,3
2020-07-17-170503,170503,0,0,4,176,0.0,0.09265162,4
2020-07-18-170503,170503,0,0,1,176,0.0,0.0069379103,5
2020-07-19-170503,170503,0,0,0,176,0.3333333333333333,0.1424135,6
2020-07-20-170503,170503,0,0,0,176,0.16666666666666666,0.06321716,0
2020-07-21-170503,170503,0,0,0,176,0.0,0.027898563,1
2020-07-22-170503,170503,0,0,1,176,0.16666666666666666,0.14581743,2
2020-07-23-170503,170503,0,0,0,176,0.3333333333333333,0.32836193,3
2020-07-24-170503,170503,2,0,0,178,0.16666666666666666,0.47883666,4
2020-07-25-170503,170503,1,0,0,179,0.0,0.03350611,5
2020-07-26-170503,170503,0,0,0,179,0.0,0.0041381437,6
2020-07-27-170503,170503,2,0,0,181,0.3333333333333333,0.40793326,0
2020-07-28-170503,170503,2,0,0,183,0.16666666666666666,0.2982923,1
2020-07-29-170503,170503,0,0,5,183,0.0,0.10215511,2
2020-07-30-170503,170503,0,0,0,183,0.16666666666666666,0.091121934,3
2020-07-31-170503,170503,4,0,0,187,0.0,0.21193922,4
2020-08-01-170503,170503,1,0,0,188,0.0,0.18003795,5
2020-08-02-170503,170503,0,0,0,188,0.16666666666666666,0.095808744,6
2020-08-03-170503,170503,0,0,0,188,0.0,0.05569896,0
2020-08-04-170503,170503,0,0,4,188,0.0,0.16091357,1
2020-08-05-170503,170503,1,0,1,189,0.3333333333333333,0.60350275,2
2020-08-06-170503,170503,0,0,1,189,0.6666666666666666,0.53672564,3
2020-08-07-170503,170503,0,0,0,189,0.16666666666666666,0.18205371,4
2020-08-08-170503,170503,0,0,1,189,0.0,0.16931508,5
2020-08-09-170503,170503,0,0,3,189,0.16666666666666666,0.12914513,6
2020-08-10-170503,170503,0,0,1,189,0.6666666666666666,0.3834941,0
2020-08-11-170503,170503,0,0,7,189,1.0,0.54564124,1
2020-08-12-170503,170503,5,0,3,194,0.6666666666666666,1.0150589,2
2020-08-13-170503,170503,0,0,16,194,1.1666666666666667,0.46143547,3
2020-08-14-170503,170503,0,0,5,194,0.3333333333333333,0.3171968,4
2020-08-15-170503,170503,0,0,1,194,0.16666666666666666,0.26305524,5
2020-08-16-170503,170503,0,0,2,194,1.3333333333333333,0.8488332,6
2020-08-17-170503,170503,0,0,3,194,1.0,0.7235347,0
2020-08-18-170503,170503,4,0,1,198,0.3333333333333333,0.7359126,1
2020-08-19-170503,170503,1,0,0,199,0.3333333333333333,0.58815724,2
2020-08-20-170503,170503,1,0,0,200,1.0,0.87559026,3
2020-08-21-170503,170503,0,0,3,200,3.5,2.3744156,4
2020-08-22-170503,170503,1,0,0,201,1.3333333333333333,0.91061646,5
2020-08-23-170503,170503,3,0,0,204,0.8333333333333334,0.59204537,6
2020-08-24-170503,170503,1,0,1,205,1.5,0.98318046,0
2020-08-25-170503,170503,7,0,5,212,0.5,1.256088,1
2020-08-26-170503,170503,3,0,3,215,1.0,0.99205315,2
2020-08-27-170503,170503,16,0,4,231,1.8333333333333333,3.5528421,3
2020-08-28-170503,170503,5,0,4,236,0.0,0.5985102,4
2020-08-29-170503,170503,1,0,0,237,0.0,0.39107397,5
2020-08-30-170503,170503,2,0,0,239,0.5,0.39142084,6
2020-08-31-170503,170503,3,0,1,242,0.16666666666666666,0.4604346,0
2020-09-01-170503,170503,1,0,0,243,0.8333333333333334,0.7323268,1
2020-09-02-170503,170503,0,0,2,243,0.16666666666666666,0.3522107,2
2020-09-03-170503,170503,0,0,3,243,1.0,0.48544,3
2020-09-04-170503,170503,3,0,1,246,1.3333333333333333,1.3157638,4
2020-09-05-170503,170503,0,0,0,246,0.6666666666666666,0.3908407,5
2020-09-06-170503,170503,0,0,2,246,1.1666666666666667,0.65762913,6
2020-09-07-170503,170503,1,0,0,247,0.3333333333333333,0.45868123,0
2020-09-08-170503,170503,5,0,2,252,1.3333333333333333,1.1263772,1
2020-09-09-170503,170503,3,0,1,255,2.333333333333333,1.3984739,2
2020-09-10-170503,170503,4,0,2,259,1.3333333333333333,1.3811525,3
2020-09-11-170503,170503,4,0,2,263,1.5,1.5654559,4
2020-09-12-170503,170503,0,0,4,263,1.1666666666666667,0.55462563,5
2020-09-13-170503,170503,0,0,1,263,2.833333333333333,0.53429794,6
2020-09-14-170503,170503,1,0,0,264,1.6666666666666667,0.9935459,0
2020-09-15-170503,170503,0,0,0,264,3.0,0.81068486,1
2020-09-16-170503,170503,2,0,3,266,1.3333333333333333,1.1040344,2
2020-09-17-170503,170503,3,0,4,269,0.5,0.81015235,3
2020-09-18-170503,170503,1,0,5,270,1.6666666666666667,1.0133822,4
2020-09-19-170503,170503,0,0,0,270,0.6666666666666666,0.10966239,5
2020-09-20-170503,170503,2,2,6,272,1.0,0.7939116,6
2020-09-21-170503,170503,0,0,2,272,0.6666666666666666,0.28261578,0
2020-09-22-170503,170503,2,0,7,274,0.16666666666666666,0.14854214,1
2020-09-23-170503,170503,1,0,6,275,1.6666666666666667,0.8254772,2
2020-09-24-170503,170503,2,0,2,277,1.1666666666666667,0.71836364,3
2020-09-25-170503,170503,2,0,0,279,0.3333333333333333,0.52432126,4
2020-09-26-170503,170503,4,0,8,283,1.3333333333333333,1.3325562,5
2020-09-27-170503,170503,1,0,0,284,0.6666666666666666,0.3707306,6
2020-09-28-170503,170503,0,0,2,284,0.6666666666666666,0.48648766,0
2020-09-29-170503,170503,0,0,4,284,1.1666666666666667,0.92976314,1
2020-09-30-170503,170503,3,0,1,287,0.6666666666666666,0.72360605,2
2020-10-01-170503,170503,4,0,3,291,1.5,1.2467581,3
2020-10-02-170503,170503,5,0,4,296,3.333333333333333,1.5721693,4
2020-10-03-170503,170503,0,0,0,296,1.3333333333333333,0.4899996,5
2020-10-04-170503,170503,6,0,0,302,0.6666666666666666,0.9088706,6
2020-10-05-170503,170503,2,0,0,304,1.6666666666666667,1.2682673,0
2020-10-06-170503,170503,7,1,4,311,0.6666666666666666,1.4467661,1
2020-10-07-170503,170503,6,0,1,317,0.3333333333333333,1.1554565,2
2020-10-08-170503,170503,2,0,0,319,1.1666666666666667,1.2511007,3
2020-10-09-170503,170503,0,0,2,319,0.5,0.3647421,4
2020-10-10-170503,170503,8,0,0,327,1.8333333333333333,1.8595356,5
2020-10-11-170503,170503,0,0,3,327,0.5,0.3192768,6
2020-10-12-170503,170503,2,0,2,329,0.3333333333333333,0.39194274,0
2020-10-13-170503,170503,4,0,3,333,0.5,0.7088281,1
2020-10-14-170503,170503,1,0,4,334,1.0,2.2340472,2
2020-10-15-170503,170503,3,0,3,337,1.0,1.2976049,3
2020-10-16-170503,170503,4,0,1,341,0.8333333333333334,2.10333,4
2020-10-17-170503,170503,0,0,1,341,0.8333333333333334,0.69376874,5
2020-10-18-170503,170503,0,0,1,341,0.6666666666666666,0.5078231,6
2020-10-19-170503,170503,0,0,2,341,2.0,0.7340112,0
2020-10-20-170503,170503,4,0,7,345,1.3333333333333333,1.5494552,1
2020-10-21-170503,170503,1,0,1,346,1.0,0.91361946,2
2020-10-22-170503,170503,0,0,3,346,2.6666666666666665,1.1385655,3
2020-10-23-170503,170503,2,1,1,348,2.6666666666666665,1.3309271,4
2020-10-24-170503,170503,0,0,1,348,1.1666666666666667,0.67283875,5
2020-10-25-170503,170503,3,1,0,351,1.8333333333333333,0.9776164,6
2020-10-26-170503,170503,2,0,2,353,1.6666666666666667,1.0776123,0
2020-10-27-170503,170503,3,0,2,356,2.0,1.158638,1
2020-10-28-170503,170503,4,0,1,360,2.1666666666666665,2.1174548,2
2020-10-29-170503,170503,3,0,2,363,2.1666666666666665,1.7086602,3
2020-10-30-170503,170503,1,0,4,364,1.5,1.8960859,4
2020-10-31-170503,170503,1,0,0,365,1.1666666666666667,0.7154233,5
2020-11-01-170503,170503,1,0,0,366,0.8333333333333334,0.6190096,6
2020-11-02-170503,170503,2,1,0,368,1.6666666666666667,0.68809503,0
2020-11-03-170503,170503,7,0,0,375,1.3333333333333333,1.7306769,1
2020-11-04-170503,170503,1,0,0,376,3.0,1.4186345,2
2020-11-05-170503,170503,3,0,0,379,3.1666666666666665,2.4521105,3
2020-11-06-170503,170503,1,0,0,380,1.0,0.743022,4
2020-11-07-170503,170503,1,0,0,381,0.6666666666666666,1.4284657,5
2020-11-08-170503,170503,0,1,0,381,3.0,0.8396977,6
2020-11-09-170503,170503,2,0,0,383,0.8333333333333334,0.84264135,0
2020-11-10-170503,170503,2,0,0,385,3.333333333333333,1.6307261,1
2020-11-11-170503,170503,1,1,0,386,0.8333333333333334,0.75984466,2
2020-11-12-170503,170503,2,0,0,388,3.1666666666666665,1.9286952,3
2020-11-13-170503,170503,4,0,0,392,1.3333333333333333,1.5445489,4
2020-03-01-170504,170504,0,0,0,0,0.0,0.00029838583,6
2020-03-02-170504,170504,0,0,0,0,0.0,4.1257772e-05,0
2020-03-03-170504,170504,0,0,2,0,0.0,0.0003858106,1
2020-03-04-170504,170504,0,0,1,0,0.0,0.0023890405,2
2020-03-05-170504,170504,0,0,2,0,0.0,0.00041654203,3
2020-03-06-170504,170504,0,0,3,0,0.0,0.0030206435,4
2020-03-07-170504,170504,0,0,2,0,0.0,0.00054599874,5
2020-03-08-170504,170504,0,0,1,0,0.0,0.006811389,6
2020-03-09-170504,170504,0,0,4,0,0.2,0.09057533,0
2020-03-10-170504,170504,0,0,0,0,0.0,0.00042446575,1
2020-03-11-170504,170504,0,0,0,0,0.0,0.001218104,2
2020-03-12-170504,170504,0,0,1,0,0.6,0.21220098,3
2020-03-13-170504,170504,0,0,1,0,0.2,0.097668275,4
2020-03-14-170504,170504,0,0,0,0,0.8,0.22157183,5
2020-03-15-170504,170504,0,0,1,0,0.4,0.053409506,6
2020-03-16-170504,170504,0,0,0,0,0.2,0.116308816,0
2020-03-17-170504,170504,2,0,0,2,0.8,0.20914915,1
2020-03-18-170504,170504,1,0,0,3,0.8,0.15046807,2
2020-03-19-170504,170504,2,0,0,5,1.4,0.32796815,3
2020-03-20-170504,170504,3,0,2,8,1.6,0.51992667,4
2020-03-21-170504,170504,2,0,0,10,2.0,0.32282367,5
2020-03-22-170504,170504,1,0,2,11,0.2,0.017878521,6
2020-03-23-170504,170504,4,0,1,15,3.0,0.76014864,0
2020-03-24-170504,170504,0,0,1,15,1.8,0.21514164,1
2020-03-25-170504,170504,0,0,2,15,1.0,0.22353739,2
2020-03-26-170504,170504,1,0,0,16,2.2,0.3462085,3
2020-03-27-170504,170504,1,0,0,17,2.4,0.4818988,4
2020-03-28-170504,170504,0,0,0,17,0.6,0.07177475,5
2020-03-29-170504,170504,1,0,0,18,0.6,0.09634089,6
2020-03-30-170504,170504,0,0,1,18,1.6,0.27150792,0
2020-03-31-170504,170504,0,0,1,18,1.0,0.14169142,1
2020-04-01-170504,170504,0,0,0,18,1.8,0.21780689,2
2020-04-02-170504,170504,0,0,0,18,1.0,0.19262184,3
2020-04-03-170504,170504,2,0,0,20,1.2,0.30554515,4
2020-04-04-170504,170504,0,0,0,20,0.6,0.05502537,5
2020-04-05-170504,170504,2,0,0,22,1.0,0.12937908,6
2020-04-06-170504,170504,1,0,0,23,1.4,0.18130556,0
2020-04-07-170504,170504,1,0,0,24,1.6,0.22299136,1
2020-04-08-170504,170504,2,0,0,26,0.6,0.304417,2
2020-04-09-170504,170504,0,0,0,26,0.4,0.113636136,3
2020-04-10-170504,170504,0,0,1,26,5.2,0.3071851,4
2020-04-11-170504,170504,0,0,1,26,0.6,0.03836245,5
2020-04-12-170504,170504,0,0,0,26,0.4,0.02614073,6
2020-04-13-170504,170504,1,0,0,27,1.0,0.2512519,0
2020-04-14-170504,170504,1,0,1,28,1.4,0.28911784,1
2020-04-15-170504,170504,0,0,1,28,0.8,0.14020757,2
2020-04-16-170504,170504,0,0,0,28,1.2,0.14489838,3
2020-04-17-170504,170504,0,1,0,28,0.6,0.22760257,4
2020-04-18-170504,170504,0,0,0,28,0.4,0.12085076,5
2020-04-19-170504,170504,0,0,1,28,0.4,0.09727597,6
2020-04-20-170504,170504,0,0,3,28,0.8,0.60429955,0
2020-04-21-170504,170504,0,0,0,28,1.0,0.09697828,1
2020-04-22-170504,170504,0,0,0,28,0.2,0.13553959,2
2020-04-23-170504,170504,0,0,0,28,0.2,0.02453371,3
2020-04-24-170504,170504,1,0,1,29,1.0,0.14505598,4
2020-04-25-170504,170504,1,0,0,30,0.8,0.102243684,5
2020-04-26-170504,170504,0,0,1,30,0.4,0.028502563,6
2020-04-27-170504,170504,0,0,2,30,0.0,0.024395674,0
2020-04-28-170504,170504,1,0,1,31,1.8,0.17442764,1
2020-04-29-170504,170504,1,0,0,32,0.8,0.17330793,2
2020-04-30-170504,170504,0,0,1,32,1.0,0.16893078,3
2020-05-01-170504,170504,0,0,0,32,0.8,0.13233554,4
2020-05-02-170504,170504,0,0,0,32,0.2,0.030605687,5
2020-05-03-170504,170504,1,0,1,33,0.0,8.233646e-08,6
2020-05-04-170504,170504,3,0,0,36,2.0,0.46712625,0
2020-05-05-170504,170504,0,0,0,36,0.4,0.059190936,1
2020-05-06-170504,170504,0,0,0,36,1.0,0.14056401,2
2020-05-07-170504,170504,0,0,1,36,0.8,0.11753238,3
2020-05-08-170504,170504,1,0,0,37,1.2,0.260759,4
2020-05-09-170504,170504,0,0,0,37,0.2,0.016259845,5
2020-05-10-170504,170504,1,0,0,38,0.2,0.06560703,6
2020-05-11-170504,170504,2,1,0,40,1.0,0.25356135,0
2020-05-12-170504,170504,1,0,0,41,1.0,0.15382366,1
2020-05-13-170504,170504,0,0,1,41,1.4,0.14669329,2
2020-05-14-170504,170504,1,0,0,42,0.6,0.136128,3
2020-05-15-170504,170504,0,0,0,42,0.6,0.18662757,4
2020-05-16-170504,170504,0,0,0,42,0.0,0.00016167582,5
2020-05-17-170504,170504,1,0,0,43,0.0,0.06676848,6
2020-05-18-170504,170504,0,0,1,43,0.8,0.114432566,0
2020-05-19-170504,170504,0,0,0,43,0.2,0.058040217,1
2020-05-20-170504,170504,0,0,2,43,1.2,0.23135236,2
2020-05-21-170504,170504,1,0,0,44,0.8,0.2507544,3
2020-05-22-170504,170504,0,0,0,44,1.8,0.40549207,4
2020-05-23-170504,170504,0,0,1,44,0.0,0.011643847,5
2020-05-24-170504,170504,0,0,0,44,0.0,2.7766298e-05,6
2020-05-25-170504,170504,0,0,2,44,0.6,0.10885455,0
2020-05-26-170504,170504,0,0,2,44,1.6,0.3061139,1
2020-05-27-170504,170504,1,0,1,45,0.2,0.12791033,2
2020-05-28-170504,170504,0,2,1,45,0.6,0.09919214,3
2020-05-29-170504,170504,0,0,1,45,1.6,0.21527402,4
2020-05-30-170504,170504,0,0,1,45,0.2,0.048339132,5
2020-05-31-170504,170504,0,0,0,45,0.6,0.08871351,6
2020-06-01-170504,170504,1,0,1,46,0.2,0.15742287,0
2020-06-02-170504,170504,0,0,1,46,1.6,0.3145828,1
2020-06-03-170504,170504,2,1,0,48,0.4,0.3677532,2
2020-06-04-170504,170504,0,0,0,48,1.2,0.16231991,3
2020-06-05-170504,170504,0,0,1,48,1.0,0.34111992,4
2020-06-06-170504,170504,1,1,2,49,0.4,0.19266006,5
2020-06-07-170504,170504,0,0,0,49,0.0,0.00017635168,6
2020-06-08-170504,170504,2,0,0,51,0.2,0.2545168,0
2020-06-09-170504,170504,2,0,1,53,0.4,0.15776981,1
2020-06-10-170504,170504,1,1,2,54,3.2,0.6949977,2
2020-06-11-170504,170504,1,0,0,55,0.8,0.30609477,3
2020-06-12-170504,170504,1,0,0,56,0.6,0.14792839,4
2020-06-13-170504,170504,1,0,0,57,0.0,0.09317029,5
2020-06-14-170504,170504,0,0,0,57,0.2,0.022613807,6
2020-06-15-170504,170504,1,0,1,58,2.6,0.48083073,0
2020-06-16-170504,170504,1,0,4,59,0.6,0.16532218,1
2020-06-17-170504,170504,0,0,1,59,0.4,0.060132295,2
2020-06-18-170504,170504,0,0,3,59,0.8,0.090239964,3
2020-06-19-170504,170504,1,0,0,60,0.2,0.18555826,4
2020-06-20-170504,170504,2,0,1,62,0.2,0.2858674,5
2020-06-21-170504,170504,0,0,0,62,0.2,0.056834325,6
2020-06-22-170504,170504,0,0,2,62,0.2,0.034883123,0
2020-06-23-170504,170504,1,0,1,63,0.4,0.19414201,1
2020-06-24-170504,170504,2,0,2,65,0.0,0.26834252,2
2020-06-25-170504,170504,0,0,0,65,0.8,0.081086196,3
2020-06-26-170504,170504,0,0,2,65,0.4,0.10096019,4
2020-06-27-170504,170504,0,1,0,65,0.2,0.2635973,5
2020-06-28-170504,170504,0,0,0,65,0.0,0.0006332741,6
2020-06-29-170504,170504,1,0,1,66,0.0,0.13420178,0
2020-06-30-170504,170504,4,0,0,70,0.6,0.5540833,1
2020-07-01-170504,170504,1,0,0,71,0.2,0.19572192,2
2020-07-02-170504,170504,3,0,3,74,0.6,0.45383468,3
2020-07-03-170504,170504,0,0,1,74,0.0,0.17893845,4
2020-07-04-170504,170504,1,0,0,75,0.2,0.19046539,5
2020-07-05-170504,170504,0,0,0,75,0.6,0.1265604,6
2020-07-06-170504,170504,2,0,0,77,2.0,0.64103854,0
2020-07-07-170504,170504,1,0,2,78,0.6,0.23668347,1
2020-07-08-170504,170504,2,0,0,80,0.0,0.32233188,2
2020-07-09-170504,170504,0,0,0,80,0.0,0.01404641,3
2020-07-10-170504,170504,2,0,0,82,0.2,0.20928812,4
2020-07-11-170504,170504,0,0,1,82,0.2,0.058720067,5
2020-07-12-170504,170504,0,0,0,82,0.2,0.052737247,6
2020-07-13-170504,170504,1,0,2,83,0.0,0.124564156,0
2020-07-14-170504,170504,0,0,0,83,0.0,0.055422213,1
2020-07-15-170504,170504,0,0,5,83,0.6,0.060620114,2
2020-07-16-170504,170504,3,0,0,86,0.4,0.6599221,3
2020-07-17-170504,170504,1,0,0,87,0.0,0.25803226,4
2020-07-18-170504,170504,0,0,1,87,0.2,0.030517135,5
2020-07-19-170504,170504,0,0,0,87,0.0,0.027260534,6
2020-07-20-170504,170504,0,0,1,87,0.0,0.0021843542,0
2020-07-21-170504,170504,2,0,2,89,0.0,0.2587071,1
2020-07-22-170504,170504,0,0,2,89,0.0,0.010484164,2
2020-07-23-170504,170504,0,0,0,89,0.0,0.051069092,3
2020-07-24-170504,170504,0,0,2,89,0.0,0.08669,4
2020-07-25-170504,170504,1,0,1,90,1.2,0.38775894,5
2020-07-26-170504,170504,0,0,0,90,0.2,0.03995986,6
2020-07-27-170504,170504,2,0,5,92,0.2,0.3293159,0
2020-07-28-170504,170504,0,0,2,92,1.0,0.16958049,1
2020-07-29-170504,170504,5,0,13,97,0.8,0.8686478,2
2020-07-30-170504,170504,0,0,5,97,0.4,0.0650335,3
2020-07-31-170504,170504,0,0,5,97,0.2,0.041970428,4
2020-08-01-170504,170504,1,0,2,98,0.0,0.19798453,5
2020-08-02-170504,170504,0,0,0,98,0.4,0.09738102,6
2020-08-03-170504,170504,1,0,3,99,0.4,0.24595559,0
2020-08-04-170504,170504,2,1,0,101,0.6,0.5309448,1
2020-08-05-170504,170504,2,0,2,103,1.2,0.80647165,2
2020-08-06-170504,170504,0,0,2,103,0.6,0.22390057,3
2020-08-07-170504,170504,2,0,7,105,0.2,0.26800215,4
2020-08-08-170504,170504,1,0,1,106,0.0,0.2370006,5
2020-08-09-170504,170504,0,0,8,106,0.2,0.07036081,6
2020-08-10-170504,170504,5,0,8,111,0.6,0.8196298,0
2020-08-11-170504,170504,2,0,10,113,1.4,0.851552,1
2020-08-12-170504,170504,13,0,9,126,1.4,2.6466022,2
2020-08-13-170504,170504,5,0,1,131,1.0,1.5189945,3
2020-08-14-170504,170504,5,0,2,136,1.0,1.1849178,4
2020-08-15-170504,170504,2,0,0,138,0.0,0.5078543,5
2020-08-16-170504,170504,0,0,0,138,1.2,0.40671483,6
2020-08-17-170504,170504,3,0,3,141,0.8,0.6761508,0
2020-08-18-170504,170504,0,0,0,141,4.4,0.9646335,1
2020-08-19-170504,170504,2,0,1,143,1.6,0.5890234,2
2020-08-20-170504,170504,2,0,4,145,0.6,0.55037296,3
2020-08-21-170504,170504,7,0,1,152,3.8,1.7341542,4
2020-08-22-170504,170504,1,0,1,153,0.8,0.46699727,5
2020-08-23-170504,170504,8,0,0,161,1.6,1.3505505,6
2020-08-24-170504,170504,8,0,0,169,2.2,1.7639264,0
2020-08-25-170504,170504,10,0,0,179,1.2,2.459781,1
2020-08-26-170504,170504,9,0,0,188,1.2,4.1730094,2
2020-08-27-170504,170504,1,0,1,189,2.6,1.4439055,3
2020-08-28-170504,170504,2,0,0,191,0.0,0.24825883,4
2020-08-29-170504,170504,0,0,1,191,0.2,0.11000409,5
2020-08-30-170504,170504,0,0,1,191,1.4,0.3423323,6
2020-08-31-170504,170504,3,0,1,194,1.2,0.62346697,0
2020-09-01-170504,170504,0,0,2,194,1.2,0.32312435,1
2020-09-02-170504,170504,1,0,1,195,2.2,0.46957675,2
2020-09-03-170504,170504,4,0,1,199,1.8,0.68621004,3
2020-09-04-170504,170504,1,0,4,200,0.8,0.42572397,4
2020-09-05-170504,170504,1,0,2,201,0.4,0.3573145,5
2020-09-06-170504,170504,0,1,2,201,1.0,0.22062828,6
2020-09-07-170504,170504,0,0,1,201,1.0,0.17843854,0
2020-09-08-170504,170504,0,0,2,201,3.0,0.5035967,1
2020-09-09-170504,170504,0,0,2,201,0.8,0.23974942,2
2020-09-10-170504,170504,1,0,2,202,1.8,0.6340801,3
2020-09-11-170504,170504,0,0,5,202,0.6,0.434573,4
2020-09-12-170504,170504,1,0,0,203,0.6,0.39323437,5
2020-09-13-170504,170504,1,0,3,204,1.0,0.43849796,6
2020-09-14-170504,170504,1,0,1,205,2.6,0.5448534,0
2020-09-15-170504,170504,2,0,4,207,2.0,0.65915346,1
2020-09-16-170504,170504,1,0,0,208,1.4,0.39457282,2
2020-09-17-170504,170504,1,0,1,209,1.6,0.51034045,3
2020-09-18-170504,170504,4,0,0,213,3.0,0.856264,4
2020-09-19-170504,170504,2,0,0,215,1.6,0.47433338,5
2020-09-20-170504,170504,2,0,0,217,1.8,0.41380984,6
2020-09-21-170504,170504,1,1,2,218,1.8,0.37705153,0
2020-09-22-170504,170504,2,0,2,220,1.4,0.32322302,1
2020-09-23-170504,170504,2,1,0,222,2.0,0.66967016,2
2020-09-24-170504,170504,2,0,0,224,1.4,0.62434745,3
2020-09-25-170504,170504,5,0,4,229,1.0,0.48106194,4
2020-09-26-170504,170504,0,0,2,229,3.0,0.7699988,5
2020-09-27-170504,170504,3,0,3,232,1.4,0.45495325,6
2020-09-28-170504,170504,1,0,10,233,1.2,0.33272314,0
2020-09-29-170504,170504,4,0,4,237,3.2,0.9458527,1
2020-09-30-170504,170504,0,0,15,237,2.8,0.4069658,2
2020-10-01-170504,170504,1,0,3,238,3.8,0.7703276,3
2020-10-02-170504,170504,0,0,2,238,2.4,0.652035,4
2020-10-03-170504,170504,0,0,16,238,2.6,0.54613745,5
2020-10-04-170504,170504,0,0,8,238,2.2,0.23249637,6
2020-10-05-170504,170504,2,0,8,240,4.0,0.75768524,0
2020-10-06-170504,170504,2,0,34,242,2.8,0.71405727,1
2020-10-07-170504,170504,0,0,8,242,1.2,0.37583208,2
2020-10-08-170504,170504,0,0,8,242,4.0,0.61346656,3
2020-10-09-170504,170504,4,0,15,246,1.6,0.75900614,4
2020-10-10-170504,170504,2,0,11,248,2.2,1.029366,5
2020-10-11-170504,170504,3,0,7,251,1.2,0.63885564,6
2020-10-12-170504,170504,10,0,1,261,1.0,1.1026384,0
2020-10-13-170504,170504,4,0,3,265,2.8,0.9809857,1
2020-10-14-170504,170504,15,0,11,280,2.8,1.990676,2
2020-10-15-170504,170504,3,0,15,283,2.6,0.883575,3
2020-10-16-170504,170504,2,0,10,285,4.2,1.5000559,4
2020-10-17-170504,170504,16,0,7,301,3.8,2.1803527,5
2020-10-18-170504,170504,8,0,8,309,5.6,1.2812903,6
2020-10-19-170504,170504,8,0,5,317,3.4,1.2058955,0
2020-10-20-170504,170504,34,1,4,351,6.2,3.824066,1
2020-10-21-170504,170504,8,0,7,359,3.6,1.2474346,2
2020-10-22-170504,170504,8,1,5,367,11.6,2.1718514,3
2020-10-23-170504,170504,15,0,3,382,4.8,2.2843885,4
2020-10-24-170504,170504,11,0,7,393,6.8,1.5775316,5
2020-10-25-170504,170504,7,4,3,400,5.6,1.0240693,6
2020-10-26-170504,170504,1,0,6,401,5.4,1.0074297,0
2020-10-27-170504,170504,3,1,1,404,6.2,1.2415354,1
2020-10-28-170504,170504,11,3,1,415,9.6,2.274457,2
2020-10-29-170504,170504,15,0,3,430,8.2,2.8707633,3
2020-10-30-170504,170504,10,0,4,440,4.6,1.8303369,4
2020-10-31-170504,170504,7,0,0,447,1.6,0.88543284,5
2020-11-01-170504,170504,8,1,0,455,5.4,1.2903723,6
2020-11-02-170504,170504,5,0,0,460,4.2,0.9554777,0
2020-11-03-170504,170504,4,2,0,464,7.8,1.6680322,1
2020-11-04-170504,170504,7,1,0,471,4.8,1.2022166,2
2020-11-05-170504,170504,5,0,0,476,5.6,1.5445012,3
2020-11-06-170504,170504,3,0,0,479,3.0,0.71949154,4
2020-11-07-170504,170504,7,1,0,486,4.2,1.0940099,5
2020-11-08-170504,170504,3,0,0,489,4.2,0.69468975,6
2020-11-09-170504,170504,6,1,0,495,3.0,0.93564314,0
2020-11-10-170504,170504,1,1,0,496,2.8,0.7479334,1
2020-11-11-170504,170504,1,3,0,497,2.0,0.38238472,2
2020-11-12-170504,170504,3,0,0,500,7.8,1.5165411,3
2020-11-13-170504,170504,4,5,0,504,3.4,1.3294322,4
2020-03-01-170505,170505,0,0,0,0,0.0,4.2388772e-05,6
2020-03-02-170505,170505,0,0,0,0,0.0,1.0567399e-05,0
2020-03-03-170505,170505,0,0,0,0,0.0,0.00036649185,1
2020-03-04-170505,170505,0,1,0,0,0.0,0.0011731798,2
2020-03-05-170505,170505,0,0,0,0,0.0,0.00046881143,3
2020-03-06-170505,170505,0,0,2,0,0.0,0.0022743293,4
2020-03-07-170505,170505,0,0,0,0,0.0,0.0006209843,5
2020-03-08-170505,170505,1,0,0,1,0.0,0.18553698,6
2020-03-09-170505,170505,0,1,0,1,0.16666666666666666,0.04783248,0
2020-03-10-170505,170505,0,0,2,1,0.0,0.0018772415,1
2020-03-11-170505,170505,0,0,1,1,0.0,0.005651807,2
2020-03-12-170505,170505,0,0,3,1,0.16666666666666666,0.111297935,3
2020-03-13-170505,170505,0,0,3,1,0.16666666666666666,0.12972803,4
2020-03-14-170505,170505,0,0,0,1,0.3333333333333333,0.10268007,5
2020-03-15-170505,170505,0,0,2,1,0.3333333333333333,0.04287966,6
2020-03-16-170505,170505,0,0,2,1,1.3333333333333333,0.38529494,0
2020-03-17-170505,170505,0,0,1,1,1.0,0.241682,1
2020-03-18-170505,170505,0,0,2,1,1.5,0.34515756,2
2020-03-19-170505,170505,0,1,2,1,1.6666666666666667,0.50998795,3
2020-03-20-170505,170505,2,1,0,3,1.1666666666666667,0.7920404,4
2020-03-21-170505,170505,0,1,1,3,0.8333333333333334,0.23118733,5
2020-03-22-170505,170505,0,0,1,3,1.0,0.20869261,6
2020-03-23-170505,170505,0,0,5,3,2.333333333333333,0.77177227,0
2020-03-24-170505,170505,2,0,1,5,1.6666666666666667,0.6880575,1
2020-03-25-170505,170505,1,0,8,6,1.3333333333333333,0.66151124,2
2020-03-26-170505,170505,3,0,8,9,2.333333333333333,1.1152625,3
2020-03-27-170505,170505,3,1,8,12,4.333333333333333,1.6662531,4
2020-03-28-170505,170505,0,0,0,12,1.1666666666666667,0.1931426,5
2020-03-29-170505,170505,2,0,0,14,0.8333333333333334,0.4668127,6
2020-03-30-170505,170505,2,0,2,16,2.5,0.98759234,0
2020-03-31-170505,170505,1,0,0,17,1.1666666666666667,0.4208641,1
2020-04-01-170505,170505,2,0,1,19,2.0,0.84291834,2
2020-04-02-170505,170505,2,0,0,21,1.6666666666666667,0.5050605,3
2020-04-03-170505,170505,0,0,0,21,0.8333333333333334,0.23462364,4
2020-04-04-170505,170505,1,0,0,22,0.6666666666666666,0.28691366,5
2020-04-05-170505,170505,1,0,0,23,1.3333333333333333,0.29170024,6
2020-04-06-170505,170505,5,0,1,28,1.3333333333333333,0.9920281,0
2020-04-07-170505,170505,1,1,3,29,1.0,0.46322426,1
2020-04-08-170505,170505,8,0,0,37,1.3333333333333333,1.8152972,2
2020-04-09-170505,170505,8,0,0,45,3.0,1.3789539,3
2020-04-10-170505,170505,8,0,1,53,1.3333333333333333,1.2553096,4
2020-04-11-170505,170505,0,0,0,53,0.6666666666666666,0.13766779,5
2020-04-12-170505,170505,0,0,0,53,0.6666666666666666,0.0864959,6
2020-04-13-170505,170505,2,0,1,55,1.3333333333333333,0.687709,0
2020-04-14-170505,170505,0,0,1,55,1.1666666666666667,0.22405915,1
2020-04-15-170505,170505,1,0,0,56,1.3333333333333333,0.4834252,2
2020-04-16-170505,170505,0,1,0,56,0.8333333333333334,0.28640786,3
2020-04-17-170505,170505,0,0,0,56,3.333333333333333,0.8545029,4
2020-04-18-170505,170505,0,0,0,56,0.0,0.0007304399,5
2020-04-19-170505,170505,0,0,0,56,0.3333333333333333,0.058048997,6
2020-04-20-170505,170505,1,0,0,57,2.833333333333333,0.9409066,0
2020-04-21-170505,170505,3,0,0,60,0.16666666666666666,0.65774685,1
2020-04-22-170505,170505,0,0,0,60,1.0,0.23020692,2
2020-04-23-170505,170505,0,0,1,60,0.8333333333333334,0.14374848,3
2020-04-24-170505,170505,1,0,0,61,0.6666666666666666,0.37052363,4
2020-04-25-170505,170505,0,0,0,61,0.3333333333333333,0.0943508,5
2020-04-26-170505,170505,0,0,0,61,0.5,0.07641943,6
2020-04-27-170505,170505,1,0,0,62,0.8333333333333334,0.27967316,0
2020-04-28-170505,170505,1,0,2,63,0.3333333333333333,0.31003574,1
2020-04-29-170505,170505,0,0,1,63,1.0,0.36288348,2
2020-04-30-170505,170505,0,0,1,63,0.5,0.19857852,3
2020-05-01-170505,170505,0,0,1,63,0.16666666666666666,0.068559006,4
2020-05-02-170505,170505,0,0,0,63,0.6666666666666666,0.11739367,5
2020-05-03-170505,170505,0,0,0,63,0.0,0.0025293645,6
2020-05-04-170505,170505,0,0,0,63,0.6666666666666666,0.38675702,0
2020-05-05-170505,170505,0,0,0,63,0.16666666666666666,0.08182948,1
2020-05-06-170505,170505,0,0,0,63,0.3333333333333333,0.19895424,2
2020-05-07-170505,170505,1,0,1,64,0.8333333333333334,0.47155443,3
2020-05-08-170505,170505,0,0,0,64,0.8333333333333334,0.22384864,4
2020-05-09-170505,170505,0,0,0,64,0.0,0.005093358,5
2020-05-10-170505,170505,0,1,0,64,0.16666666666666666,0.039549585,6
2020-05-11-170505,170505,0,1,0,64,0.3333333333333333,0.19921473,0
2020-05-12-170505,170505,2,0,0,66,0.3333333333333333,0.4733805,1
2020-05-13-170505,170505,1,0,1,67,0.3333333333333333,0.3463673,2
2020-05-14-170505,170505,1,0,2,68,0.16666666666666666,0.22005224,3
2020-05-15-170505,170505,1,0,3,69,0.6666666666666666,0.44787565,4
2020-05-16-170505,170505,0,3,0,69,0.0,0.001644274,5
2020-05-17-170505,170505,0,0,0,69,0.16666666666666666,0.040079623,6
2020-05-18-170505,170505,0,0,1,69,0.0,0.061683305,0
2020-05-19-170505,170505,0,0,0,69,1.5,0.45429745,1
2020-05-20-170505,170505,0,1,1,69,0.6666666666666666,0.31349343,2
2020-05-21-170505,170505,1,0,2,70,0.8333333333333334,0.476095,3
2020-05-22-170505,170505,0,0,0,70,1.0,0.25219983,4
2020-05-23-170505,170505,0,0,1,70,0.16666666666666666,0.046873398,5
2020-05-24-170505,170505,0,0,0,70,0.0,1.9311314e-05,6
2020-05-25-170505,170505,0,0,0,70,0.0,0.038344234,0
2020-05-26-170505,170505,0,0,1,70,0.16666666666666666,0.14184232,1
2020-05-27-170505,170505,1,0,0,71,0.16666666666666666,0.36998814,2
2020-05-28-170505,170505,2,0,2,73,0.3333333333333333,0.5336177,3
2020-05-29-170505,170505,3,0,1,76,0.5,0.8782709,4
2020-05-30-170505,170505,0,0,1,76,0.16666666666666666,0.05554538,5
2020-05-31-170505,170505,0,0,0,76,0.5,0.14397956,6
2020-06-01-170505,170505,1,0,0,77,0.8333333333333334,0.4387164,0
2020-06-02-170505,170505,0,0,0,77,0.0,0.15874055,1
2020-06-03-170505,170505,1,0,0,78,0.3333333333333333,0.35124305,2
2020-06-04-170505,170505,2,0,0,80,0.16666666666666666,0.5610229,3
2020-06-05-170505,170505,0,0,0,80,1.0,0.4374074,4
2020-06-06-170505,170505,1,1,0,81,0.0,0.26946065,5
2020-06-07-170505,170505,0,0,0,81,0.0,1.6111828e-06,6
2020-06-08-170505,170505,0,0,0,81,0.3333333333333333,0.14184755,0
2020-06-09-170505,170505,1,0,0,82,0.16666666666666666,0.29207206,1
2020-06-10-170505,170505,0,0,1,82,0.3333333333333333,0.37929276,2
2020-06-11-170505,170505,2,0,0,84,0.5,0.6658983,3
2020-06-12-170505,170505,1,0,0,85,0.6666666666666666,0.3794731,4
2020-06-13-170505,170505,1,0,0,86,0.0,0.26443198,5
2020-06-14-170505,170505,0,0,0,86,0.0,0.0009077916,6
2020-06-15-170505,170505,0,0,0,86,0.3333333333333333,0.23122905,0
2020-06-16-170505,170505,0,0,0,86,0.3333333333333333,0.09314916,1
2020-06-17-170505,170505,0,0,0,86,0.3333333333333333,0.08791783,2
2020-06-18-170505,170505,0,0,0,86,1.0,0.19996749,3
2020-06-19-170505,170505,0,0,0,86,0.5,0.21332084,4
2020-06-20-170505,170505,0,0,0,86,0.16666666666666666,0.08637484,5
2020-06-21-170505,170505,0,0,0,86,0.16666666666666666,0.0646156,6
2020-06-22-170505,170505,0,0,0,86,0.0,0.005772223,0
2020-06-23-170505,170505,0,0,0,86,0.0,0.047498614,1
2020-06-24-170505,170505,1,0,0,87,0.3333333333333333,0.38192272,2
2020-06-25-170505,170505,0,0,0,87,0.3333333333333333,0.16494788,3
2020-06-26-170505,170505,0,1,0,87,0.16666666666666666,0.13571708,4
2020-06-27-170505,170505,0,0,0,87,0.16666666666666666,0.10744491,5
2020-06-28-170505,170505,0,0,0,87,0.0,8.46951e-05,6
2020-06-29-170505,170505,0,0,0,87,0.16666666666666666,0.09398786,0
2020-06-30-170505,170505,0,0,0,87,0.0,0.12423666,1
2020-07-01-170505,170505,0,0,0,87,0.16666666666666666,0.09195367,2
2020-07-02-170505,170505,0,0,0,87,0.3333333333333333,0.14378847,3
2020-07-03-170505,170505,0,0,0,87,0.3333333333333333,0.25538075,4
2020-07-04-170505,170505,0,0,0,87,0.0,0.0042716796,5
2020-07-05-170505,170505,0,0,0,87,0.16666666666666666,0.021245321,6
2020-07-06-170505,170505,0,0,0,87,0.16666666666666666,0.19669984,0
2020-07-07-170505,170505,0,1,0,87,0.0,0.025692038,1
2020-07-08-170505,170505,0,0,1,87,0.16666666666666666,0.106552966,2
2020-07-09-170505,170505,0,0,1,87,0.0,0.030235194,3
2020-07-10-170505,170505,0,0,0,87,0.5,0.25827578,4
2020-07-11-170505,170505,0,0,0,87,0.16666666666666666,0.020415163,5
2020-07-12-170505,170505,0,0,0,87,0.0,0.029680775,6
2020-07-13-170505,170505,0,0,1,87,0.0,0.003912129,0
2020-07-14-170505,170505,0,0,0,87,0.6666666666666666,0.2920081,1
2020-07-15-170505,170505,0,0,0,87,0.6666666666666666,0.25099978,2
2020-07-16-170505,170505,0,0,0,87,0.6666666666666666,0.35419214,3
2020-07-17-170505,170505,0,0,0,87,0.16666666666666666,0.023551516,4
2020-07-18-170505,170505,0,0,0,87,0.0,0.0051219347,5
2020-07-19-170505,170505,0,0,0,87,0.3333333333333333,0.09115064,6
2020-07-20-170505,170505,0,0,0,87,0.0,0.030413534,0
2020-07-21-170505,170505,0,0,0,87,0.16666666666666666,0.02507979,1
2020-07-22-170505,170505,1,0,0,88,0.16666666666666666,0.36571887,2
2020-07-23-170505,170505,1,0,0,89,0.6666666666666666,0.5914427,3
2020-07-24-170505,170505,0,0,0,89,0.5,0.2588957,4
2020-07-25-170505,170505,0,0,0,89,0.16666666666666666,0.012439329,5
2020-07-26-170505,170505,0,0,0,89,0.0,0.0018194141,6
2020-07-27-170505,170505,1,0,0,90,0.3333333333333333,0.47564048,0
2020-07-28-170505,170505,0,0,0,90,0.5,0.17904274,1
2020-07-29-170505,170505,0,0,0,90,0.0,0.05192275,2
2020-07-30-170505,170505,0,0,1,90,0.5,0.23144814,3
2020-07-31-170505,170505,0,0,1,90,0.6666666666666666,0.13892417,4
2020-08-01-170505,170505,0,0,1,90,0.16666666666666666,0.09363234,5
2020-08-02-170505,170505,0,0,3,90,0.0,0.08628586,6
2020-08-03-170505,170505,0,0,4,90,0.16666666666666666,0.08456376,0
2020-08-04-170505,170505,0,0,1,90,0.6666666666666666,0.25362125,1
2020-08-05-170505,170505,0,0,0,90,0.6666666666666666,0.46672454,2
2020-08-06-170505,170505,0,1,3,90,0.5,0.36479264,3
2020-08-07-170505,170505,0,0,10,90,1.0,0.32575944,4
2020-08-08-170505,170505,0,0,8,90,0.6666666666666666,0.40742874,5
2020-08-09-170505,170505,0,0,0,90,0.0,0.06587535,6
2020-08-10-170505,170505,0,0,0,90,0.3333333333333333,0.15682392,0
2020-08-11-170505,170505,0,0,0,90,0.16666666666666666,0.25032687,1
2020-08-12-170505,170505,0,0,1,90,1.3333333333333333,0.5075891,2
2020-08-13-170505,170505,1,0,2,91,0.8333333333333334,0.2194566,3
2020-08-14-170505,170505,1,1,0,92,1.1666666666666667,0.5123776,4
2020-08-15-170505,170505,1,0,0,93,0.16666666666666666,0.44098428,5
2020-08-16-170505,170505,3,0,0,96,0.8333333333333334,1.2967223,6
2020-08-17-170505,170505,4,0,0,100,0.5,1.4355693,0
2020-08-18-170505,170505,1,0,2,101,1.0,0.6089364,1
2020-08-19-170505,170505,0,0,0,101,0.8333333333333334,0.734582,2
2020-08-20-170505,170505,3,0,1,104,0.8333333333333334,1.2931265,3
2020-08-21-170505,170505,10,0,4,114,1.5,3.7311082,4
2020-08-22-170505,170505,8,0,2,122,0.3333333333333333,2.1920118,5
2020-08-23-170505,170505,0,0,5,122,1.0,0.30302936,6
2020-08-24-170505,170505,0,0,0,122,1.1666666666666667,0.43462855,0
2020-08-25-170505,170505,0,0,0,122,1.6666666666666667,0.52051324,1
2020-08-26-170505,170505,1,0,6,123,1.3333333333333333,0.65173984,2
2020-08-27-170505,170505,2,0,3,125,3.1666666666666665,1.8983248,3
2020-08-28-170505,170505,0,0,3,125,1.3333333333333333,0.40113568,4
2020-08-29-170505,170505,0,0,1,125,0.5,0.2553126,5
2020-08-30-170505,170505,0,0,0,125,1.5,0.24716596,6
2020-08-31-170505,170505,0,0,0,125,0.8333333333333334,0.19132303,0
2020-09-01-170505,170505,2,0,1,127,1.5,0.99589723,1
2020-09-02-170505,170505,0,0,1,127,0.3333333333333333,0.15248585,2
2020-09-03-170505,170505,1,0,1,128,0.6666666666666666,0.44770288,3
2020-09-04-170505,170505,4,0,0,132,1.5,1.378884,4
2020-09-05-170505,170505,2,0,0,134,0.5,0.4574564,5
2020-09-06-170505,170505,5,0,0,139,0.5,1.1657534,6
2020-09-07-170505,170505,0,0,0,139,0.3333333333333333,0.2302595,0
2020-09-08-170505,170505,0,0,0,139,3.1666666666666665,0.5739662,1
2020-09-09-170505,170505,6,0,0,145,1.6666666666666667,1.8512263,2
2020-09-10-170505,170505,3,0,1,148,2.5,1.2535894,3
2020-09-11-170505,170505,3,0,2,151,2.0,1.5877309,4
2020-09-12-170505,170505,1,0,0,152,0.8333333333333334,0.5539932,5
2020-09-13-170505,170505,0,0,0,152,2.833333333333333,0.32270315,6
2020-09-14-170505,170505,0,1,1,152,3.333333333333333,0.60300463,0
2020-09-15-170505,170505,1,0,0,153,2.833333333333333,0.65556026,1
2020-09-16-170505,170505,1,0,0,154,1.8333333333333333,0.6511468,2
2020-09-17-170505,170505,1,0,0,155,0.8333333333333334,0.57837987,3
2020-09-18-170505,170505,0,0,2,155,1.5,0.6085324,4
2020-09-19-170505,170505,0,0,2,155,0.8333333333333334,0.103281006,5
2020-09-20-170505,170505,0,1,1,155,1.1666666666666667,0.41108006,6
2020-09-21-170505,170505,0,0,0,155,0.8333333333333334,0.24609499,0
2020-09-22-170505,170505,0,0,2,155,1.1666666666666667,0.16846333,1
2020-09-23-170505,170505,0,0,0,155,2.1666666666666665,0.6674333,2
2020-09-24-170505,170505,1,1,3,156,1.3333333333333333,0.40656096,3
2020-09-25-170505,170505,2,0,3,158,1.0,0.50577325,4
2020-09-26-170505,170505,0,0,3,158,1.6666666666666667,0.7225973,5
2020-09-27-170505,170505,0,0,0,158,1.1666666666666667,0.28652483,6
2020-09-28-170505,170505,1,0,1,159,1.0,0.60772514,0
2020-09-29-170505,170505,0,0,1,159,0.16666666666666666,0.2327485,1
2020-09-30-170505,170505,0,0,5,159,2.5,0.5764954,2
2020-10-01-170505,170505,0,0,3,159,2.5,0.5463094,3
2020-10-02-170505,170505,2,0,2,161,3.0,1.1032215,4
2020-10-03-170505,170505,2,1,1,163,1.3333333333333333,0.66116405,5
2020-10-04-170505,170505,1,0,1,164,2.5,0.6010618,6
2020-10-05-170505,170505,0,0,1,164,1.3333333333333333,0.67748946,0
2020-10-06-170505,170505,2,0,1,166,2.1666666666666665,1.1443831,1
2020-10-07-170505,170505,0,0,0,166,1.8333333333333333,0.72791934,2
2020-10-08-170505,170505,3,0,1,169,1.1666666666666667,1.5627077,3
2020-10-09-170505,170505,3,1,4,172,0.8333333333333334,0.31645182,4
2020-10-10-170505,170505,3,0,2,175,2.1666666666666665,1.6586123,5
2020-10-11-170505,170505,0,0,2,175,0.6666666666666666,0.18653059,6
2020-10-12-170505,170505,1,0,0,176,0.8333333333333334,0.2681116,0
2020-10-13-170505,170505,1,0,0,177,2.1666666666666665,0.7170304,1
2020-10-14-170505,170505,5,0,0,182,1.3333333333333333,2.414934,2
2020-10-15-170505,170505,3,0,1,185,1.3333333333333333,1.507202,3
2020-10-16-170505,170505,2,0,3,187,2.0,1.2736301,4
2020-10-17-170505,170505,1,0,0,188,1.3333333333333333,0.4288817,5
2020-10-18-170505,170505,1,0,1,189,0.16666666666666666,0.4401537,6
2020-10-19-170505,170505,1,0,2,190,2.5,0.6491932,0
2020-10-20-170505,170505,1,0,0,191,3.1666666666666665,1.0603485,1
2020-10-21-170505,170505,0,0,0,191,1.0,0.34833357,2
2020-10-22-170505,170505,1,0,1,192,2.6666666666666665,0.81016386,3
2020-10-23-170505,170505,4,0,0,196,1.8333333333333333,1.0451087,4
2020-10-24-170505,170505,2,0,0,198,1.0,0.74688387,5
2020-10-25-170505,170505,2,0,2,200,1.5,0.74039817,6
2020-10-26-170505,170505,0,0,3,200,1.6666666666666667,0.64915395,0
2020-10-27-170505,170505,0,0,1,200,1.6666666666666667,0.6158972,1
2020-10-28-170505,170505,0,0,0,200,1.3333333333333333,1.3284444,2
2020-10-29-170505,170505,1,1,2,201,1.8333333333333333,1.1224295,3
2020-10-30-170505,170505,3,0,1,204,2.333333333333333,2.8692346,4
2020-10-31-170505,170505,0,0,0,204,1.3333333333333333,0.47585788,5
2020-11-01-170505,170505,1,0,0,205,1.1666666666666667,0.62538797,6
2020-11-02-170505,170505,2,1,0,207,1.6666666666666667,0.69870484,0
2020-11-03-170505,170505,0,0,0,207,3.5,1.0790128,1
2020-11-04-170505,170505,0,0,0,207,3.6666666666666665,1.0822403,2
2020-11-05-170505,170505,1,1,0,208,3.0,1.9544057,3
2020-11-06-170505,170505,0,0,0,208,2.0,0.59491426,4
2020-11-07-170505,170505,0,1,0,208,9.0,1.9830672,5
2020-11-08-170505,170505,2,0,0,210,1.0,0.6749081,6
2020-11-09-170505,170505,3,2,0,213,1.8333333333333333,1.3394977,0
2020-11-10-170505,170505,1,1,0,214,2.6666666666666665,0.9790943,1
2020-11-11-170505,170505,0,0,0,214,0.6666666666666666,0.41956025,2
2020-11-12-170505,170505,2,0,0,216,2.333333333333333,1.2560416,3
2020-11-13-170505,170505,1,0,0,217,3.6666666666666665,1.3066262,4
2020-03-01-170506,170506,0,0,0,0,0.0,9.089745e-05,6
2020-03-02-170506,170506,0,0,0,0,0.0,9.259033e-05,0
2020-03-03-170506,170506,0,0,1,0,0.0,2.8937475e-09,1
2020-03-04-170506,170506,0,0,2,0,0.0,4.4029466e-08,2
2020-03-05-170506,170506,0,0,2,0,0.0,0.0010114757,3
2020-03-06-170506,170506,0,0,2,0,0.0,0.0027467876,4
2020-03-07-170506,170506,0,0,3,0,0.0,8.751898e-05,5
2020-03-08-170506,170506,0,0,0,0,0.0,0.0063020843,6
2020-03-09-170506,170506,1,0,4,1,0.0,0.46640727,0
2020-03-10-170506,170506,0,0,1,1,0.0,0.00063515466,1
2020-03-11-170506,170506,0,0,1,1,0.0,0.00023933839,2
2020-03-12-170506,170506,1,0,2,2,0.0,0.21497059,3
2020-03-13-170506,170506,0,0,1,2,0.0,0.049181636,4
2020-03-14-170506,170506,1,0,0,3,0.0,0.14906181,5
2020-03-15-170506,170506,0,0,1,3,0.8,0.014671379,6
2020-03-16-170506,170506,0,0,1,3,1.4,0.05401953,0
2020-03-17-170506,170506,1,0,0,4,1.4,0.15772153,1
2020-03-18-170506,170506,2,1,2,6,1.6,0.24585672,2
2020-03-19-170506,170506,2,0,2,8,2.2,0.4220685,3
2020-03-20-170506,170506,2,0,0,10,2.4,0.36908668,4
2020-03-21-170506,170506,3,1,0,13,1.6,0.5545462,5
2020-03-22-170506,170506,0,0,0,13,0.8,0.017732486,6
2020-03-23-170506,170506,4,0,1,17,4.2,0.9597435,0
2020-03-24-170506,170506,1,0,2,18,1.8,0.47327074,1
2020-03-25-170506,170506,1,0,1,19,1.4,0.25177076,2
2020-03-26-170506,170506,2,0,0,21,1.4,0.38814726,3
2020-03-27-170506,170506,1,0,1,22,2.6,0.47585067,4
2020-03-28-170506,170506,0,0,2,22,0.4,0.10604346,5
2020-03-29-170506,170506,1,0,1,23,1.0,0.12346749,6
2020-03-30-170506,170506,1,0,1,24,0.8,0.3585936,0
2020-03-31-170506,170506,0,0,2,24,1.4,0.25273156,1
2020-04-01-170506,170506,2,0,1,26,1.4,0.35065114,2
2020-04-02-170506,170506,2,0,3,28,0.2,0.22490112,3
2020-04-03-170506,170506,0,0,0,28,1.4,0.3576147,4
2020-04-04-170506,170506,0,0,1,28,0.4,0.100627504,5
2020-04-05-170506,170506,0,0,0,28,1.4,0.19228925,6
2020-04-06-170506,170506,1,0,0,29,1.2,0.33827028,0
2020-04-07-170506,170506,2,0,1,31,0.6,0.4317229,1
2020-04-08-170506,170506,1,0,0,32,2.4,0.2879754,2
2020-04-09-170506,170506,0,0,1,32,0.2,0.17833656,3
2020-04-10-170506,170506,1,1,3,33,5.8,1.3918371,4
2020-04-11-170506,170506,2,0,0,35,0.6,0.17292427,5
2020-04-12-170506,170506,1,0,0,36,0.2,0.11046436,6
2020-04-13-170506,170506,1,0,0,37,1.4,0.4526007,0
2020-04-14-170506,170506,2,0,6,39,1.2,0.40036395,1
2020-04-15-170506,170506,1,0,2,40,1.2,0.32386833,2
2020-04-16-170506,170506,3,0,1,43,0.4,0.40684342,3
2020-04-17-170506,170506,0,0,0,43,0.2,0.33013585,4
2020-04-18-170506,170506,1,0,1,44,0.0,0.115416326,5
2020-04-19-170506,170506,0,0,0,44,0.2,0.078816,6
2020-04-20-170506,170506,0,0,2,44,1.0,0.47838068,0
2020-04-21-170506,170506,1,0,0,45,0.6,0.20384714,1
2020-04-22-170506,170506,0,0,2,45,0.2,0.081964195,2
2020-04-23-170506,170506,1,0,3,46,0.0,0.10156856,3
2020-04-24-170506,170506,3,0,0,49,1.0,0.52251834,4
2020-04-25-170506,170506,0,0,0,49,1.2,0.29550144,5
2020-04-26-170506,170506,0,0,0,49,1.0,0.1290435,6
2020-04-27-170506,170506,0,0,0,49,0.2,0.022948237,0
2020-04-28-170506,170506,6,0,1,55,0.8,0.57648253,1
2020-04-29-170506,170506,2,0,4,57,0.6,0.34389606,2
2020-04-30-170506,170506,1,0,0,58,0.4,0.17718889,3
2020-05-01-170506,170506,0,0,0,58,0.2,0.020952549,4
2020-05-02-170506,170506,1,0,0,59,0.0,0.13783564,5
2020-05-03-170506,170506,0,0,0,59,0.2,2.6536454e-05,6
2020-05-04-170506,170506,2,0,2,61,1.4,0.599499,0
2020-05-05-170506,170506,0,0,0,61,0.2,0.017318778,1
2020-05-06-170506,170506,2,0,3,63,0.2,0.23216806,2
2020-05-07-170506,170506,3,0,1,66,1.2,0.3983214,3
2020-05-08-170506,170506,0,0,1,66,0.8,0.3013654,4
2020-05-09-170506,170506,0,0,0,66,0.2,0.0024774945,5
2020-05-10-170506,170506,0,0,0,66,0.6,0.09559661,6
2020-05-11-170506,170506,0,0,1,66,0.6,0.2112977,0
2020-05-12-170506,170506,1,0,2,67,0.6,0.24980709,1
2020-05-13-170506,170506,4,0,0,71,1.2,0.51276076,2
2020-05-14-170506,170506,0,0,1,71,1.4,0.059984352,3
2020-05-15-170506,170506,0,0,5,71,0.0,0.10181868,4
2020-05-16-170506,170506,0,0,0,71,0.2,0.0005086432,5
2020-05-17-170506,170506,0,0,0,71,0.2,0.032209978,6
2020-05-18-170506,170506,2,0,0,73,0.2,0.2617817,0
2020-05-19-170506,170506,0,0,0,73,0.2,0.06939967,1
2020-05-20-170506,170506,3,0,1,76,0.0,0.47530228,2
2020-05-21-170506,170506,1,0,1,77,0.8,0.48131588,3
2020-05-22-170506,170506,1,0,0,78,0.2,0.22556822,4
2020-05-23-170506,170506,0,0,0,78,0.6,0.01740841,5
2020-05-24-170506,170506,0,0,0,78,0.0,0.00015669936,6
2020-05-25-170506,170506,1,0,0,79,0.4,0.15804116,0
2020-05-26-170506,170506,2,0,1,81,0.8,0.48007065,1
2020-05-27-170506,170506,0,0,2,81,0.4,0.19893548,2
2020-05-28-170506,170506,1,2,0,82,0.0,0.16231862,3
2020-05-29-170506,170506,5,0,2,87,0.6,1.0683612,4
2020-05-30-170506,170506,0,1,0,87,0.0,0.13660677,5
2020-05-31-170506,170506,0,1,0,87,0.2,0.025401775,6
2020-06-01-170506,170506,0,0,2,87,0.8,0.27359152,0
2020-06-02-170506,170506,0,0,1,87,0.6,0.34965557,1
2020-06-03-170506,170506,1,0,1,88,0.6,0.44064972,2
2020-06-04-170506,170506,1,0,3,89,0.4,0.44087085,3
2020-06-05-170506,170506,0,8,0,89,0.0,0.17893732,4
2020-06-06-170506,170506,0,0,0,89,0.2,0.067496344,5
2020-06-07-170506,170506,0,1,0,89,0.0,7.857676e-09,6
2020-06-08-170506,170506,0,0,1,89,0.4,0.1509227,0
2020-06-09-170506,170506,1,0,0,90,0.8,0.32125428,1
2020-06-10-170506,170506,2,0,0,92,3.0,2.079379,2
2020-06-11-170506,170506,0,0,2,92,1.0,0.5468282,3
2020-06-12-170506,170506,2,0,0,94,0.2,0.24998765,4
2020-06-13-170506,170506,0,0,0,94,0.4,0.048248,5
2020-06-14-170506,170506,0,5,0,94,0.0,0.003569284,6
2020-06-15-170506,170506,2,1,0,96,0.4,0.5683408,0
2020-06-16-170506,170506,1,0,2,97,0.2,0.17491622,1
2020-06-17-170506,170506,1,0,0,98,0.0,0.16564983,2
2020-06-18-170506,170506,3,0,1,101,0.2,0.47870743,3
2020-06-19-170506,170506,0,0,0,101,0.2,0.107754886,4
2020-06-20-170506,170506,0,0,0,101,0.6,0.27418453,5
2020-06-21-170506,170506,0,0,0,101,0.0,0.02004695,6
2020-06-22-170506,170506,1,0,1,102,0.2,0.28148142,0
2020-06-23-170506,170506,0,0,0,102,1.0,0.3833869,1
2020-06-24-170506,170506,0,0,0,102,0.4,0.14025277,2
2020-06-25-170506,170506,2,0,0,104,0.2,0.31895867,3
2020-06-26-170506,170506,0,0,0,104,0.2,0.22114863,4
2020-06-27-170506,170506,0,0,0,104,0.0,0.11792956,5
2020-06-28-170506,170506,0,0,0,104,0.0,0.00186223,6
2020-06-29-170506,170506,0,0,0,104,0.2,0.08253764,0
2020-06-30-170506,170506,2,0,0,106,1.0,0.66771686,1
2020-07-01-170506,170506,0,0,0,106,0.4,0.25323293,2
2020-07-02-170506,170506,1,0,0,107,1.2,0.6499592,3
2020-07-03-170506,170506,0,0,0,107,0.2,0.14193274,4
2020-07-04-170506,170506,0,0,1,107,0.2,0.068465866,5
2020-07-05-170506,170506,0,0,0,107,0.0,0.024454372,6
2020-07-06-170506,170506,1,0,0,108,1.4,1.1772579,0
2020-07-07-170506,170506,0,0,0,108,0.2,0.09491472,1
2020-07-08-170506,170506,0,0,0,108,0.4,0.15073594,2
2020-07-09-170506,170506,0,0,0,108,0.0,0.001433746,3
2020-07-10-170506,170506,0,0,0,108,0.6,0.12739597,4
2020-07-11-170506,170506,0,0,2,108,0.2,0.16739087,5
2020-07-12-170506,170506,0,0,0,108,0.0,0.0075451145,6
2020-07-13-170506,170506,0,0,1,108,0.4,0.055534713,0
2020-07-14-170506,170506,0,0,2,108,0.0,0.09004921,1
2020-07-15-170506,170506,0,0,0,108,0.6,0.08905662,2
2020-07-16-170506,170506,0,0,0,108,1.0,0.4909694,3
2020-07-17-170506,170506,0,0,0,108,0.4,0.10005567,4
2020-07-18-170506,170506,1,0,0,109,0.0,0.14197786,5
2020-07-19-170506,170506,0,0,0,109,0.0,0.012164821,6
2020-07-20-170506,170506,0,0,0,109,0.0,0.0044633276,0
2020-07-21-170506,170506,0,0,0,109,0.4,0.12552582,1
2020-07-22-170506,170506,0,0,0,109,0.0,0.008902156,2
2020-07-23-170506,170506,0,0,0,109,0.0,0.03416444,3
2020-07-24-170506,170506,0,0,0,109,0.2,0.078636035,4
2020-07-25-170506,170506,2,0,0,111,0.2,0.35070133,5
2020-07-26-170506,170506,0,0,0,111,0.0,0.0027975377,6
2020-07-27-170506,170506,1,0,0,112,0.4,0.3242461,0
2020-07-28-170506,170506,2,0,0,114,0.2,0.064025044,1
2020-07-29-170506,170506,0,0,2,114,1.0,0.31919795,2
2020-07-30-170506,170506,0,0,0,114,0.4,0.03009143,3
2020-07-31-170506,170506,0,0,0,114,0.2,0.046883866,4
2020-08-01-170506,170506,0,0,0,114,0.2,0.10055974,5
2020-08-02-170506,170506,0,0,0,114,0.0,0.041814346,6
2020-08-03-170506,170506,0,0,1,114,0.4,0.10274545,0
2020-08-04-170506,170506,0,0,5,114,0.6,0.18622448,1
2020-08-05-170506,170506,0,0,3,114,0.6,0.27000198,2
2020-08-06-170506,170506,0,0,2,114,0.4,0.282711,3
2020-08-07-170506,170506,0,0,13,114,0.8,0.1361071,4
2020-08-08-170506,170506,0,0,2,114,0.2,0.10597139,5
2020-08-09-170506,170506,0,0,3,114,0.2,0.19077638,6
2020-08-10-170506,170506,0,0,0,114,1.8,0.547972,0
2020-08-11-170506,170506,0,0,3,114,0.8,0.4090021,1
2020-08-12-170506,170506,2,0,0,116,3.4,1.8812993,2
2020-08-13-170506,170506,0,0,4,116,1.8,0.94366217,3
2020-08-14-170506,170506,0,0,0,116,1.2,0.49450967,4
2020-08-15-170506,170506,0,0,0,116,1.6,0.19425792,5
2020-08-16-170506,170506,0,0,2,116,0.4,0.26668435,6
2020-08-17-170506,170506,1,0,1,117,1.4,0.42602932,0
2020-08-18-170506,170506,5,0,1,122,0.6,1.2095466,1
2020-08-19-170506,170506,3,0,2,125,3.4,0.8646384,2
2020-08-20-170506,170506,2,0,0,127,1.0,0.52608764,3
2020-08-21-170506,170506,13,0,0,140,4.4,3.6051285,4
2020-08-22-170506,170506,2,0,0,142,0.4,0.43587953,5
2020-08-23-170506,170506,3,0,4,145,2.6,1.4117255,6
2020-08-24-170506,170506,0,0,2,145,2.6,1.7337403,0
2020-08-25-170506,170506,3,0,5,148,3.8,2.0060368,1
2020-08-26-170506,170506,0,0,2,148,3.4,1.92611,2
2020-08-27-170506,170506,4,0,1,152,2.4,2.512543,3
2020-08-28-170506,170506,0,0,0,152,1.0,0.20888147,4
2020-08-29-170506,170506,0,0,0,152,1.0,0.09083911,5
2020-08-30-170506,170506,2,0,0,154,0.6,0.21293677,6
2020-08-31-170506,170506,1,0,1,155,1.4,0.57363063,0
2020-09-01-170506,170506,1,0,0,156,0.6,0.27809268,1
2020-09-02-170506,170506,2,0,1,158,0.6,0.61308664,2
2020-09-03-170506,170506,0,0,2,158,2.0,0.41641474,3
2020-09-04-170506,170506,0,0,0,158,1.0,1.649947,4
2020-09-05-170506,170506,0,0,0,158,0.4,0.516849,5
2020-09-06-170506,170506,4,0,0,162,0.4,0.5207269,6
2020-09-07-170506,170506,2,0,2,164,0.8,0.62936777,0
2020-09-08-170506,170506,5,0,1,169,1.4,1.3676794,1
2020-09-09-170506,170506,2,0,1,171,1.0,0.69070584,2
2020-09-10-170506,170506,1,0,0,172,2.4,0.7873736,3
2020-09-11-170506,170506,0,0,0,172,0.0,0.2536796,4
2020-09-12-170506,170506,0,0,7,172,0.6,0.14728723,5
2020-09-13-170506,170506,0,0,0,172,0.2,0.17170805,6
2020-09-14-170506,170506,1,0,4,173,4.0,0.33184507,0
2020-09-15-170506,170506,0,0,6,173,2.6,0.71479094,1
2020-09-16-170506,170506,1,0,7,174,1.4,0.65181684,2
2020-09-17-170506,170506,2,1,7,176,0.4,0.521348,3
2020-09-18-170506,170506,0,0,3,176,1.8,1.07792,4
2020-09-19-170506,170506,0,0,3,176,0.8,0.1366273,5
2020-09-20-170506,170506,0,0,8,176,2.2,0.7124003,6
2020-09-21-170506,170506,2,0,8,178,1.8,0.68654656,0
2020-09-22-170506,170506,1,2,3,179,1.6,0.14833075,1
2020-09-23-170506,170506,1,0,3,180,1.0,0.42438072,2
2020-09-24-170506,170506,0,1,11,180,1.4,0.7050297,3
2020-09-25-170506,170506,0,1,2,180,1.8,0.30727616,4
2020-09-26-170506,170506,7,0,2,187,1.0,1.6642209,5
2020-09-27-170506,170506,0,0,2,187,0.8,0.16037919,6
2020-09-28-170506,170506,4,1,1,191,1.0,0.7228314,0
2020-09-29-170506,170506,6,0,5,197,2.2,1.9462702,1
2020-09-30-170506,170506,7,0,0,204,1.2,0.9771035,2
2020-10-01-170506,170506,7,0,5,211,2.2,2.0951786,3
2020-10-02-170506,170506,3,0,1,214,1.4,0.7880658,4
2020-10-03-170506,170506,3,1,2,217,0.6,0.5437067,5
2020-10-04-170506,170506,8,0,4,225,1.0,0.9875454,6
2020-10-05-170506,170506,8,0,9,233,2.8,2.072901,0
2020-10-06-170506,170506,3,1,8,236,1.8,1.0538596,1
2020-10-07-170506,170506,3,0,2,239,0.8,0.8491141,2
2020-10-08-170506,170506,11,0,12,250,2.0,2.383118,3
2020-10-09-170506,170506,2,0,1,252,2.8,0.70548946,4
2020-10-10-170506,170506,2,0,13,254,1.8,0.9245461,5
2020-10-11-170506,170506,2,0,1,256,0.6,0.45487985,6
2020-10-12-170506,170506,1,0,4,257,3.0,0.67959774,0
2020-10-13-170506,170506,5,0,1,262,1.6,1.157611,1
2020-10-14-170506,170506,0,0,22,262,3.4,1.0044899,2
2020-10-15-170506,170506,5,0,3,267,1.8,1.5343262,3
2020-10-16-170506,170506,1,0,6,268,0.8,1.7419136,4
2020-10-17-170506,170506,2,0,2,270,4.2,1.5708059,5
2020-10-18-170506,170506,4,0,10,274,2.2,1.0655756,6
2020-10-19-170506,170506,9,1,5,283,2.2,1.943838,0
2020-10-20-170506,170506,8,0,19,291,7.4,3.344273,1
2020-10-21-170506,170506,2,1,7,293,2.4,1.3409647,2
2020-10-22-170506,170506,12,0,5,305,3.0,2.5414662,3
2020-10-23-170506,170506,1,0,3,306,4.8,1.2259722,4
2020-10-24-170506,170506,13,0,7,319,2.6,2.0358217,5
2020-10-25-170506,170506,1,0,1,320,1.6,0.4465634,6
2020-10-26-170506,170506,4,1,4,324,1.2,0.8290004,0
2020-10-27-170506,170506,1,0,1,325,1.6,0.74018216,1
2020-10-28-170506,170506,22,1,4,347,3.4,4.2322817,2
2020-10-29-170506,170506,3,0,16,350,4.2,1.5402187,3
2020-10-30-170506,170506,6,1,0,356,2.8,2.2256014,4
2020-10-31-170506,170506,2,0,0,358,1.6,0.7256284,5
2020-11-01-170506,170506,10,0,0,368,4.2,1.6395868,6
2020-11-02-170506,170506,5,1,0,373,1.2,0.9019352,0
2020-11-03-170506,170506,19,1,0,392,0.8,3.2136407,1
2020-11-04-170506,170506,7,0,0,399,2.8,1.8882782,2
2020-11-05-170506,170506,5,0,0,404,3.6,2.224447,3
2020-11-06-170506,170506,3,1,0,407,2.2,0.9104519,4
2020-11-07-170506,170506,7,0,0,414,1.6,1.4768897,5
2020-11-08-170506,170506,1,1,0,415,1.0,0.4670643,6
2020-11-09-170506,170506,4,0,0,419,2.6,1.1208391,0
2020-11-10-170506,170506,1,2,0,420,3.4,1.5028363,1
2020-11-11-170506,170506,4,1,0,424,2.4,1.0001948,2
2020-11-12-170506,170506,16,2,0,440,3.4,3.64661,3
2020-11-13-170506,170506,0,1,0,440,1.6,1.9010001,4
2020-03-01-170507,170507,0,0,1,0,0.0,9.514329e-05,6
2020-03-02-170507,170507,0,0,1,0,0.0,6.834473e-05,0
2020-03-03-170507,170507,0,0,0,0,0.0,0.0020674455,1
2020-03-04-170507,170507,0,0,0,0,0.0,0.0070269005,2
2020-03-05-170507,170507,0,0,3,0,0.0,0.000716473,3
2020-03-06-170507,170507,0,1,4,0,0.0,0.0070964564,4
2020-03-07-170507,170507,0,0,2,0,0.0,0.00017115416,5
2020-03-08-170507,170507,0,0,1,0,0.0,0.017019115,6
2020-03-09-170507,170507,0,0,6,0,0.0,0.090823136,0
2020-03-10-170507,170507,0,0,2,0,0.0,0.00067217054,1
2020-03-11-170507,170507,0,0,4,0,0.0,0.005438014,2
2020-03-12-170507,170507,2,0,2,2,0.2857142857142857,0.4163354,3
2020-03-13-170507,170507,1,0,7,3,0.14285714285714285,0.29155943,4
2020-03-14-170507,170507,3,0,1,6,0.0,0.45436397,5
2020-03-15-170507,170507,1,0,0,7,0.42857142857142855,0.14201021,6
2020-03-16-170507,170507,1,0,1,8,0.7142857142857143,0.4549884,0
2020-03-17-170507,170507,0,0,1,8,0.8571428571428571,0.15433957,1
2020-03-18-170507,170507,0,0,2,8,0.5714285714285714,0.2569726,2
2020-03-19-170507,170507,3,0,2,11,1.2857142857142858,0.72470415,3
2020-03-20-170507,170507,4,0,0,15,1.0,0.8393012,4
2020-03-21-170507,170507,2,0,0,17,1.2857142857142858,0.46919495,5
2020-03-22-170507,170507,1,0,0,18,0.5714285714285714,0.19113646,6
2020-03-23-170507,170507,6,0,1,24,1.7142857142857142,1.2210947,0
2020-03-24-170507,170507,2,0,2,26,1.0,0.5021988,1
2020-03-25-170507,170507,4,0,2,30,0.0,0.68540645,2
2020-03-26-170507,170507,2,0,0,32,1.8571428571428568,0.6534777,3
2020-03-27-170507,170507,7,0,0,39,2.4285714285714284,1.4376827,4
2020-03-28-170507,170507,1,0,0,40,0.8571428571428571,0.35364106,5
2020-03-29-170507,170507,0,0,0,40,1.4285714285714286,0.3398181,6
2020-03-30-170507,170507,1,0,0,41,2.2857142857142856,0.8144198,0
2020-03-31-170507,170507,1,0,3,42,0.8571428571428571,0.326513,1
2020-04-01-170507,170507,2,0,1,44,1.5714285714285714,0.69722015,2
2020-04-02-170507,170507,2,0,1,46,0.5714285714285714,0.45544314,3
2020-04-03-170507,170507,0,0,0,46,1.4285714285714286,0.29328302,4
2020-04-04-170507,170507,0,0,0,46,1.0,0.26795167,5
2020-04-05-170507,170507,0,0,1,46,1.1428571428571428,0.13759866,6
2020-04-06-170507,170507,1,1,1,47,1.1428571428571428,0.43091327,0
2020-04-07-170507,170507,2,0,0,49,1.0,0.3615298,1
2020-04-08-170507,170507,2,1,1,51,1.4285714285714286,0.89729095,2
2020-04-09-170507,170507,0,0,0,51,2.2857142857142856,0.6868004,3
2020-04-10-170507,170507,0,0,0,51,4.285714285714286,0.68058515,4
2020-04-11-170507,170507,0,0,0,51,0.8571428571428571,0.1802666,5
2020-04-12-170507,170507,0,0,0,51,0.5714285714285714,0.11784018,6
2020-04-13-170507,170507,0,0,0,51,2.0,0.6500839,0
2020-04-14-170507,170507,3,0,2,54,1.2857142857142858,0.692969,1
2020-04-15-170507,170507,1,0,0,55,1.2857142857142858,0.58313644,2
2020-04-16-170507,170507,1,0,3,56,0.7142857142857143,0.3976077,3
2020-04-17-170507,170507,0,2,4,56,3.1428571428571432,1.0724852,4
2020-04-18-170507,170507,0,0,0,56,0.14285714285714285,0.050222322,5
2020-04-19-170507,170507,1,0,0,57,0.5714285714285714,0.19672619,6
2020-04-20-170507,170507,1,0,3,58,2.7142857142857144,1.3103255,0
2020-04-21-170507,170507,0,0,1,58,0.5714285714285714,0.14048855,1
2020-04-22-170507,170507,1,0,1,59,0.7142857142857143,0.5257527,2
2020-04-23-170507,170507,0,0,1,59,0.7142857142857143,0.22057898,3
2020-04-24-170507,170507,0,0,2,59,0.7142857142857143,0.26804745,4
2020-04-25-170507,170507,0,0,0,59,1.0,0.26961657,5
2020-04-26-170507,170507,0,0,0,59,0.42857142857142855,0.092687726,6
2020-04-27-170507,170507,0,0,1,59,0.2857142857142857,0.21872053,0
2020-04-28-170507,170507,2,0,1,61,0.2857142857142857,0.34893543,1
2020-04-29-170507,170507,0,1,0,61,1.0,0.36395818,2
2020-04-30-170507,170507,3,0,0,64,0.2857142857142857,0.5245832,3
2020-05-01-170507,170507,4,0,1,68,0.0,0.40267697,4
2020-05-02-170507,170507,0,0,0,68,0.5714285714285714,0.17829171,5
2020-05-03-170507,170507,0,0,0,68,0.14285714285714285,2.8181064e-05,6
2020-05-04-170507,170507,3,0,1,71,1.7142857142857142,0.7729034,0
2020-05-05-170507,170507,1,0,0,72,0.42857142857142855,0.098479845,1
2020-05-06-170507,170507,1,0,2,73,0.7142857142857143,0.36490476,2
2020-05-07-170507,170507,1,0,1,74,0.2857142857142857,0.3062741,3
2020-05-08-170507,170507,2,0,5,76,1.1428571428571428,0.547109,4
2020-05-09-170507,170507,0,0,0,76,0.2857142857142857,0.027067723,5
2020-05-10-170507,170507,0,0,0,76,0.42857142857142855,0.10327752,6
2020-05-11-170507,170507,1,0,1,77,1.1428571428571428,0.35986388,0
2020-05-12-170507,170507,1,0,2,78,0.7142857142857143,0.32545403,1
2020-05-13-170507,170507,0,0,1,78,0.5714285714285714,0.18368368,2
2020-05-14-170507,170507,0,3,0,78,0.42857142857142855,0.121258445,3
2020-05-15-170507,170507,1,0,0,79,0.7142857142857143,0.43889225,4
2020-05-16-170507,170507,0,0,0,79,0.0,0.00022028598,5
2020-05-17-170507,170507,0,0,0,79,0.42857142857142855,0.1177291,6
2020-05-18-170507,170507,1,0,0,80,0.14285714285714285,0.19708823,0
2020-05-19-170507,170507,0,1,1,80,0.5714285714285714,0.22308421,1
2020-05-20-170507,170507,2,0,0,82,0.7142857142857143,0.50207543,2
2020-05-21-170507,170507,1,0,0,83,0.8571428571428571,0.5157928,3
2020-05-22-170507,170507,5,0,2,88,0.5714285714285714,0.8885533,4
2020-05-23-170507,170507,0,0,1,88,0.14285714285714285,0.08335803,5
2020-05-24-170507,170507,0,0,0,88,0.0,1.4014217e-05,6
2020-05-25-170507,170507,1,0,0,89,0.14285714285714285,0.18115024,0
2020-05-26-170507,170507,2,0,0,91,0.7142857142857143,0.42360294,1
2020-05-27-170507,170507,1,0,1,92,0.2857142857142857,0.3014484,2
2020-05-28-170507,170507,0,3,1,92,0.42857142857142855,0.16433722,3
2020-05-29-170507,170507,0,0,0,92,0.7142857142857143,0.35486498,4
2020-05-30-170507,170507,0,0,0,92,0.14285714285714285,0.02394709,5
2020-05-31-170507,170507,0,0,0,92,0.8571428571428571,0.27609694,6
2020-06-01-170507,170507,0,0,1,92,0.7142857142857143,0.28782156,0
2020-06-02-170507,170507,1,0,0,93,1.2857142857142858,0.39187083,1
2020-06-03-170507,170507,0,0,0,93,0.8571428571428571,0.27704385,2
2020-06-04-170507,170507,0,0,0,93,0.8571428571428571,0.25491238,3
2020-06-05-170507,170507,2,1,0,95,1.1428571428571428,0.7910881,4
2020-06-06-170507,170507,1,0,0,96,0.2857142857142857,0.20179193,5
2020-06-07-170507,170507,0,0,0,96,0.0,7.0463524e-05,6
2020-06-08-170507,170507,0,0,0,96,0.7142857142857143,0.27727544,0
2020-06-09-170507,170507,0,0,0,96,0.5714285714285714,0.22051628,1
2020-06-10-170507,170507,1,0,0,97,2.2857142857142856,0.8820416,2
2020-06-11-170507,170507,1,0,1,98,1.1428571428571428,0.6470285,3
2020-06-12-170507,170507,0,0,0,98,0.5714285714285714,0.22985592,4
2020-06-13-170507,170507,0,0,1,98,0.14285714285714285,0.061034404,5
2020-06-14-170507,170507,0,0,0,98,0.14285714285714285,0.012866094,6
2020-06-15-170507,170507,1,0,0,99,2.0,0.5644634,0
2020-06-16-170507,170507,0,0,0,99,0.5714285714285714,0.10939828,1
2020-06-17-170507,170507,0,0,0,99,0.2857142857142857,0.093936466,2
2020-06-18-170507,170507,0,0,0,99,0.42857142857142855,0.2067942,3
2020-06-19-170507,170507,0,0,0,99,0.42857142857142855,0.14943941,4
2020-06-20-170507,170507,0,0,0,99,0.5714285714285714,0.20713831,5
2020-06-21-170507,170507,0,0,1,99,0.42857142857142855,0.130192,6
2020-06-22-170507,170507,0,0,0,99,0.0,0.014568614,0
2020-06-23-170507,170507,0,0,1,99,0.42857142857142855,0.13248384,1
2020-06-24-170507,170507,0,0,0,99,0.42857142857142855,0.21434571,2
2020-06-25-170507,170507,1,0,0,100,0.2857142857142857,0.16870908,3
2020-06-26-170507,170507,0,0,0,100,0.42857142857142855,0.15972105,4
2020-06-27-170507,170507,1,0,0,101,0.14285714285714285,0.31414163,5
2020-06-28-170507,170507,0,0,0,101,0.0,0.0003682156,6
2020-06-29-170507,170507,0,0,0,101,0.2857142857142857,0.12815915,0
2020-06-30-170507,170507,0,0,0,101,0.7142857142857143,0.254482,1
2020-07-01-170507,170507,0,0,0,101,0.42857142857142855,0.17528538,2
2020-07-02-170507,170507,0,0,0,101,0.8571428571428571,0.2994253,3
2020-07-03-170507,170507,0,0,0,101,0.14285714285714285,0.24259976,4
2020-07-04-170507,170507,0,0,0,101,0.2857142857142857,0.078813024,5
2020-07-05-170507,170507,1,0,0,102,0.42857142857142855,0.1746844,6
2020-07-06-170507,170507,0,0,0,102,1.7142857142857142,0.4974175,0
2020-07-07-170507,170507,1,1,0,103,0.42857142857142855,0.11904698,1
2020-07-08-170507,170507,0,0,0,103,0.42857142857142855,0.22565532,2
2020-07-09-170507,170507,0,0,0,103,0.14285714285714285,0.050230637,3
2020-07-10-170507,170507,0,0,0,103,0.5714285714285714,0.20338738,4
2020-07-11-170507,170507,0,0,0,103,0.2857142857142857,0.06037119,5
2020-07-12-170507,170507,0,0,0,103,0.42857142857142855,0.13870786,6
2020-07-13-170507,170507,0,0,0,103,0.14285714285714285,0.052246146,0
2020-07-14-170507,170507,0,0,0,103,0.2857142857142857,0.24381031,1
2020-07-15-170507,170507,0,0,0,103,1.0,0.26328972,2
2020-07-16-170507,170507,0,0,0,103,1.2857142857142858,0.577771,3
2020-07-17-170507,170507,0,0,0,103,0.14285714285714285,0.25724444,4
2020-07-18-170507,170507,0,0,0,103,0.0,0.015181694,5
2020-07-19-170507,170507,0,0,0,103,0.14285714285714285,0.110809825,6
2020-07-20-170507,170507,0,0,0,103,0.0,0.014969811,0
2020-07-21-170507,170507,0,0,0,103,0.2857142857142857,0.10620694,1
2020-07-22-170507,170507,0,0,2,103,0.0,0.03229086,2
2020-07-23-170507,170507,0,0,0,103,0.14285714285714285,0.1734007,3
2020-07-24-170507,170507,0,0,0,103,0.5714285714285714,0.36621982,4
2020-07-25-170507,170507,0,0,0,103,0.8571428571428571,0.16782254,5
2020-07-26-170507,170507,0,0,0,103,0.14285714285714285,0.021410031,6
2020-07-27-170507,170507,0,0,0,103,0.5714285714285714,0.26776168,0
2020-07-28-170507,170507,0,0,4,103,0.7142857142857143,0.1820387,1
2020-07-29-170507,170507,0,0,0,103,1.2857142857142858,0.3860745,2
2020-07-30-170507,170507,0,0,0,103,0.2857142857142857,0.074942574,3
2020-07-31-170507,170507,0,0,0,103,0.8571428571428571,0.17721812,4
2020-08-01-170507,170507,0,0,0,103,0.2857142857142857,0.16561647,5
2020-08-02-170507,170507,0,0,1,103,0.2857142857142857,0.08867176,6
2020-08-03-170507,170507,0,0,0,103,0.42857142857142855,0.13300413,0
2020-08-04-170507,170507,0,0,0,103,1.0,0.32984072,1
2020-08-05-170507,170507,2,0,0,105,1.1428571428571428,0.85345393,2
2020-08-06-170507,170507,0,0,0,105,0.7142857142857143,0.38466984,3
2020-08-07-170507,170507,0,0,0,105,0.5714285714285714,0.19251686,4
2020-08-08-170507,170507,0,0,0,105,0.7142857142857143,0.19997436,5
2020-08-09-170507,170507,0,0,0,105,0.14285714285714285,0.06485527,6
2020-08-10-170507,170507,0,0,0,105,1.5714285714285714,0.5837006,0
2020-08-11-170507,170507,4,0,1,109,0.8571428571428571,1.0144373,1
2020-08-12-170507,170507,0,0,0,109,3.7142857142857135,1.3611119,2
2020-08-13-170507,170507,0,0,1,109,2.2857142857142856,0.8553915,3
2020-08-14-170507,170507,0,0,0,109,2.142857142857143,0.6907655,4
2020-08-15-170507,170507,0,0,0,109,0.5714285714285714,0.35745132,5
2020-08-16-170507,170507,1,0,3,110,1.2857142857142858,0.6595872,6
2020-08-17-170507,170507,0,0,0,110,1.1428571428571428,0.53633773,0
2020-08-18-170507,170507,0,0,0,110,3.1428571428571432,0.81103426,1
2020-08-19-170507,170507,0,0,0,110,1.2857142857142858,0.46299246,2
2020-08-20-170507,170507,0,0,0,110,0.8571428571428571,0.5852925,3
2020-08-21-170507,170507,0,0,0,110,2.2857142857142856,1.3806175,4
2020-08-22-170507,170507,0,0,0,110,0.7142857142857143,0.56504726,5
2020-08-23-170507,170507,0,0,0,110,2.571428571428572,0.74673015,6
2020-08-24-170507,170507,0,0,0,110,3.571428571428572,1.1068089,0
2020-08-25-170507,170507,1,0,1,111,3.1428571428571432,1.7133243,1
2020-08-26-170507,170507,0,0,0,111,2.7142857142857144,1.8878193,2
2020-08-27-170507,170507,1,0,0,112,4.428571428571429,2.2863035,3
2020-08-28-170507,170507,0,0,1,112,1.1428571428571428,0.46738675,4
2020-08-29-170507,170507,0,0,1,112,0.5714285714285714,0.25547132,5
2020-08-30-170507,170507,3,0,2,115,0.7142857142857143,0.59660417,6
2020-08-31-170507,170507,0,0,0,115,1.5714285714285714,0.4578875,0
2020-09-01-170507,170507,0,0,1,115,1.2857142857142858,0.47612762,1
2020-09-02-170507,170507,0,0,1,115,1.7142857142857142,0.3923374,2
2020-09-03-170507,170507,0,0,0,115,2.2857142857142856,0.5043588,3
2020-09-04-170507,170507,0,0,1,115,1.7142857142857142,0.5382558,4
2020-09-05-170507,170507,0,0,0,115,0.42857142857142855,0.19717258,5
2020-09-06-170507,170507,0,0,0,115,0.2857142857142857,0.38864705,6
2020-09-07-170507,170507,0,0,0,115,0.7142857142857143,0.2508642,0
2020-09-08-170507,170507,1,0,0,116,2.2857142857142856,0.8098927,1
2020-09-09-170507,170507,0,0,4,116,1.4285714285714286,0.59669006,2
2020-09-10-170507,170507,0,0,2,116,3.0,1.0027786,3
2020-09-11-170507,170507,1,0,0,117,1.8571428571428568,1.1854196,4
2020-09-12-170507,170507,1,0,3,118,1.0,0.6624985,5
2020-09-13-170507,170507,2,0,2,120,0.7142857142857143,0.5467554,6
2020-09-14-170507,170507,0,0,1,120,3.1428571428571432,0.9753926,0
2020-09-15-170507,170507,1,0,2,121,2.4285714285714284,0.699953,1
2020-09-16-170507,170507,1,0,1,122,2.2857142857142856,0.9783773,2
2020-09-17-170507,170507,0,0,0,122,1.8571428571428568,0.7413077,3
2020-09-18-170507,170507,1,0,5,123,3.0,0.7702475,4
2020-09-19-170507,170507,0,0,5,123,1.4285714285714286,0.22773546,5
2020-09-20-170507,170507,0,0,0,123,2.142857142857143,0.52971727,6
2020-09-21-170507,170507,0,0,1,123,1.1428571428571428,0.2545851,0
2020-09-22-170507,170507,0,0,1,123,1.5714285714285714,0.20055737,1
2020-09-23-170507,170507,4,0,1,127,2.0,0.9482041,2
2020-09-24-170507,170507,2,1,0,129,1.5714285714285714,0.684651,3
2020-09-25-170507,170507,0,0,0,129,1.8571428571428568,0.41292045,4
2020-09-26-170507,170507,3,1,1,132,1.2857142857142858,1.0582329,5
2020-09-27-170507,170507,2,0,0,134,1.2857142857142858,0.5293023,6
2020-09-28-170507,170507,1,0,1,135,0.5714285714285714,0.5292442,0
2020-09-29-170507,170507,2,0,0,137,1.8571428571428568,0.8727617,1
2020-09-30-170507,170507,1,0,1,138,1.5714285714285714,0.7051081,2
2020-10-01-170507,170507,0,0,0,138,2.4285714285714284,0.8841688,3
2020-10-02-170507,170507,5,0,0,143,1.8571428571428568,1.5652331,4
2020-10-03-170507,170507,5,0,1,148,1.0,0.7169822,5
2020-10-04-170507,170507,0,0,1,148,1.2857142857142858,0.54722977,6
2020-10-05-170507,170507,1,0,1,149,2.2857142857142856,0.8822653,0
2020-10-06-170507,170507,1,0,3,150,2.571428571428572,0.9991676,1
2020-10-07-170507,170507,1,1,0,151,1.2857142857142858,0.79122543,2
2020-10-08-170507,170507,0,0,5,151,1.8571428571428568,0.6021292,3
2020-10-09-170507,170507,0,0,8,151,1.8571428571428568,0.5018902,4
2020-10-10-170507,170507,1,0,2,152,3.0,1.4187722,5
2020-10-11-170507,170507,0,0,5,152,1.7142857142857142,0.6089799,6
2020-10-12-170507,170507,1,0,3,153,2.4285714285714284,0.6432031,0
2020-10-13-170507,170507,0,0,7,153,3.2857142857142856,0.7928641,1
2020-10-14-170507,170507,1,0,6,154,4.571428571428571,1.3921683,2
2020-10-15-170507,170507,0,0,6,154,2.142857142857143,0.83839196,3
2020-10-16-170507,170507,0,0,6,154,4.571428571428571,1.4959502,4
2020-10-17-170507,170507,1,0,2,155,5.571428571428571,1.218332,5
2020-10-18-170507,170507,1,0,1,156,4.285714285714286,0.91975695,6
2020-10-19-170507,170507,1,0,2,157,3.1428571428571432,0.93986976,0
2020-10-20-170507,170507,3,0,7,160,9.714285714285714,2.3486814,1
2020-10-21-170507,170507,0,0,0,160,4.285714285714286,0.990053,2
2020-10-22-170507,170507,5,0,6,165,8.142857142857142,2.0700164,3
2020-10-23-170507,170507,8,0,0,173,5.428571428571429,2.2341273,4
2020-10-24-170507,170507,2,0,2,175,4.857142857142857,1.083499,5
2020-10-25-170507,170507,5,0,6,180,5.0,1.3466364,6
2020-10-26-170507,170507,3,1,0,183,4.0,1.4054588,0
2020-10-27-170507,170507,7,0,3,190,4.571428571428571,1.7114275,1
2020-10-28-170507,170507,6,0,1,196,5.142857142857143,2.1195607,2
2020-10-29-170507,170507,6,0,3,202,7.7142857142857135,2.8541796,3
2020-10-30-170507,170507,6,0,2,208,4.285714285714286,2.152606,4
2020-10-31-170507,170507,2,0,0,210,2.2857142857142856,0.96431917,5
2020-11-01-170507,170507,1,0,0,211,3.571428571428572,0.9087499,6
2020-11-02-170507,170507,2,0,0,213,3.2857142857142856,0.91173726,0
2020-11-03-170507,170507,7,1,0,220,4.428571428571429,2.2326858,1
2020-11-04-170507,170507,0,0,0,220,4.0,0.88086426,2
2020-11-05-170507,170507,6,0,0,226,4.428571428571429,2.2318492,3
2020-11-06-170507,170507,0,0,0,226,2.142857142857143,0.99300915,4
2020-11-07-170507,170507,2,1,0,228,3.7142857142857135,1.0113955,5
2020-11-08-170507,170507,6,0,0,234,3.0,1.1008855,6
2020-11-09-170507,170507,0,0,0,234,3.4285714285714284,0.8917657,0
2020-11-10-170507,170507,3,1,0,237,2.7142857142857144,1.3497874,1
2020-11-11-170507,170507,1,1,0,238,1.0,0.569107,2
2020-11-12-170507,170507,3,1,0,241,4.142857142857143,1.8353732,3
2020-11-13-170507,170507,2,0,0,243,3.8571428571428568,1.6504598,4
2020-03-01-170508,170508,0,0,4,0,0.0,0.00029895923,6
2020-03-02-170508,170508,0,0,1,0,0.0,8.060306e-05,0
2020-03-03-170508,170508,0,1,12,0,0.0,2.517557e-06,1
2020-03-04-170508,170508,0,0,15,0,0.0,0.0010486746,2
2020-03-05-170508,170508,0,0,20,0,0.0,0.00032393236,3
2020-03-06-170508,170508,0,0,12,0,0.0,0.0032137628,4
2020-03-07-170508,170508,0,2,5,0,0.0,0.0004065587,5
2020-03-08-170508,170508,0,0,8,0,0.0,0.06797877,6
2020-03-09-170508,170508,1,0,23,1,0.6666666666666666,0.041087497,0
2020-03-10-170508,170508,0,0,22,1,0.6666666666666666,0.003373593,1
2020-03-11-170508,170508,0,0,19,1,1.0,0.0052678147,2
2020-03-12-170508,170508,1,0,21,2,1.0,0.078691624,3
2020-03-13-170508,170508,1,0,15,3,0.6666666666666666,0.08156414,4
2020-03-14-170508,170508,1,0,10,4,0.6666666666666666,0.044484466,5
2020-03-15-170508,170508,4,0,7,8,1.3333333333333333,0.03004844,6
2020-03-16-170508,170508,1,0,14,9,4.333333333333333,0.13508007,0
2020-03-17-170508,170508,12,0,14,21,6.333333333333332,1.1074926,1
2020-03-18-170508,170508,15,0,15,36,11.0,1.2027421,2
2020-03-19-170508,170508,20,1,15,56,12.666666666666664,1.510797,3
2020-03-20-170508,170508,12,0,30,68,9.666666666666666,1.3126612,4
2020-03-21-170508,170508,5,0,3,73,9.333333333333334,0.97279245,5
2020-03-22-170508,170508,8,1,6,81,8.0,0.57916594,6
2020-03-23-170508,170508,23,0,17,104,18.666666666666668,3.3642087,0
2020-03-24-170508,170508,22,0,12,126,15.666666666666664,2.5413337,1
2020-03-25-170508,170508,19,0,32,145,19.0,2.1362062,2
2020-03-26-170508,170508,21,0,16,166,19.33333333333333,2.4552755,3
2020-03-27-170508,170508,15,0,11,181,15.666666666666664,3.7467086,4
2020-03-28-170508,170508,10,0,1,191,7.0,0.5866093,5
2020-03-29-170508,170508,7,0,4,198,5.0,0.08306135,6
2020-03-30-170508,170508,14,0,12,212,17.666666666666668,2.057931,0
2020-03-31-170508,170508,14,0,31,226,11.333333333333336,1.0591697,1
2020-04-01-170508,170508,15,0,29,241,5.666666666666668,1.7886516,2
2020-04-02-170508,170508,15,0,8,256,10.666666666666666,1.6125257,3
2020-04-03-170508,170508,30,0,9,286,7.666666666666668,0.68831843,4
2020-04-04-170508,170508,3,0,12,289,2.0,0.048587393,5
2020-04-05-170508,170508,6,1,0,295,5.333333333333333,1.481394,6
2020-04-06-170508,170508,17,4,10,312,9.333333333333334,1.359857,0
2020-04-07-170508,170508,12,0,16,324,6.333333333333332,1.355904,1
2020-04-08-170508,170508,32,0,2,356,8.666666666666666,0.834226,2
2020-04-09-170508,170508,16,0,2,372,6.333333333333332,1.8744977,3
2020-04-10-170508,170508,11,1,16,383,9.0,0.9326201,4
2020-04-11-170508,170508,1,0,4,384,8.666666666666666,0.6369894,5
2020-04-12-170508,170508,4,0,2,388,0.6666666666666666,0.004964711,6
2020-04-13-170508,170508,12,0,6,400,3.333333333333333,0.8036044,0
2020-04-14-170508,170508,31,0,10,431,6.333333333333332,0.37810984,1
2020-04-15-170508,170508,29,0,5,460,4.666666666666667,0.41084346,2
2020-04-16-170508,170508,8,0,7,468,4.0,0.45535046,3
2020-04-17-170508,170508,9,0,1,477,4.0,0.53074896,4
2020-04-18-170508,170508,12,0,2,489,1.3333333333333333,0.00021198436,5
2020-04-19-170508,170508,0,0,4,489,2.0,0.007637872,6
2020-04-20-170508,170508,10,0,5,499,4.666666666666667,0.9101376,0
2020-04-21-170508,170508,16,0,3,515,7.333333333333332,0.47411445,1
2020-04-22-170508,170508,2,1,6,517,6.333333333333332,0.7080113,2
2020-04-23-170508,170508,2,0,8,519,3.333333333333333,0.019971056,3
2020-04-24-170508,170508,16,0,11,535,4.666666666666667,0.73090696,4
2020-04-25-170508,170508,4,0,2,539,1.3333333333333333,0.009287456,5
2020-04-26-170508,170508,2,0,1,541,1.3333333333333333,0.59997374,6
2020-04-27-170508,170508,6,1,5,547,4.0,0.39898682,0
2020-04-28-170508,170508,10,0,5,557,3.333333333333333,1.1114978,1
2020-04-29-170508,170508,5,0,6,562,3.333333333333333,0.81953114,2
2020-04-30-170508,170508,7,0,5,569,3.0,0.39710814,3
2020-05-01-170508,170508,1,0,0,570,1.3333333333333333,0.3106181,4
2020-05-02-170508,170508,2,0,0,572,1.3333333333333333,0.014913928,5
2020-05-03-170508,170508,4,0,2,576,0.0,0.0036110014,6
2020-05-04-170508,170508,5,0,8,581,4.666666666666667,0.8804613,0
2020-05-05-170508,170508,3,0,8,584,3.0,0.4448103,1
2020-05-06-170508,170508,6,0,5,590,2.6666666666666665,0.5208421,2
2020-05-07-170508,170508,8,0,6,598,3.333333333333333,1.2038319,3
2020-05-08-170508,170508,11,0,5,609,5.0,0.43414629,4
2020-05-09-170508,170508,2,1,1,611,1.6666666666666667,0.0051905415,5
2020-05-10-170508,170508,1,0,0,612,1.0,0.0053819483,6
2020-05-11-170508,170508,5,0,3,617,4.0,0.52095515,0
2020-05-12-170508,170508,5,1,2,622,4.0,0.51641536,1
2020-05-13-170508,170508,6,0,8,628,3.333333333333333,0.4831625,2
2020-05-14-170508,170508,5,0,5,633,3.6666666666666665,0.05912936,3
2020-05-15-170508,170508,0,1,3,633,3.333333333333333,0.9450984,4
2020-05-16-170508,170508,0,0,2,633,0.3333333333333333,0.016826576,5
2020-05-17-170508,170508,2,0,1,635,0.0,0.007792764,6
2020-05-18-170508,170508,8,0,6,643,4.333333333333333,0.07621774,0
2020-05-19-170508,170508,8,0,4,651,5.0,2.5317822,1
2020-05-20-170508,170508,5,0,5,656,0.6666666666666666,0.12072339,2
2020-05-21-170508,170508,6,0,6,662,1.6666666666666667,0.09361117,3
2020-05-22-170508,170508,5,0,0,667,2.333333333333333,0.9231142,4
2020-05-23-170508,170508,1,0,1,668,0.6666666666666666,0.0021087616,5
2020-05-24-170508,170508,0,0,1,668,0.0,0.00020131149,6
2020-05-25-170508,170508,3,0,7,671,2.6666666666666665,0.061985787,0
2020-05-26-170508,170508,2,0,1,673,4.0,0.4957975,1
2020-05-27-170508,170508,8,0,3,681,4.0,0.13170862,2
2020-05-28-170508,170508,5,0,3,686,2.333333333333333,0.58136374,3
2020-05-29-170508,170508,3,0,1,689,2.333333333333333,0.6597688,4
2020-05-30-170508,170508,2,0,2,691,0.3333333333333333,0.39734122,5
2020-05-31-170508,170508,1,0,0,692,1.0,0.039623883,6
2020-06-01-170508,170508,6,0,1,698,2.6666666666666665,0.57619566,0
2020-06-02-170508,170508,4,0,1,702,1.6666666666666667,0.07377083,1
2020-06-03-170508,170508,5,0,2,707,1.0,0.075102754,2
2020-06-04-170508,170508,6,0,2,713,2.0,0.108100116,3
2020-06-05-170508,170508,0,0,0,713,1.6666666666666667,0.1007432,4
2020-06-06-170508,170508,1,0,1,714,0.3333333333333333,0.04240395,5
2020-06-07-170508,170508,1,0,0,715,0.0,0.0001907969,6
2020-06-08-170508,170508,7,0,2,722,3.333333333333333,0.053781748,0
2020-06-09-170508,170508,1,0,1,723,1.0,0.06909634,1
2020-06-10-170508,170508,3,0,0,726,1.3333333333333333,0.11750177,2
2020-06-11-170508,170508,3,0,1,729,1.3333333333333333,0.15242265,3
2020-06-12-170508,170508,1,0,1,730,2.333333333333333,0.5697513,4
2020-06-13-170508,170508,2,0,0,732,1.0,0.053027295,5
2020-06-14-170508,170508,0,0,0,732,0.0,0.0008364168,6
2020-06-15-170508,170508,1,0,1,733,1.6666666666666667,0.14095928,0
2020-06-16-170508,170508,1,0,0,734,0.6666666666666666,0.45965904,1
2020-06-17-170508,170508,2,0,1,736,1.3333333333333333,0.050089885,2
2020-06-18-170508,170508,2,0,2,738,0.6666666666666666,0.10161581,3
2020-06-19-170508,170508,0,0,0,738,2.333333333333333,0.9939836,4
2020-06-20-170508,170508,1,0,2,739,0.6666666666666666,0.032342922,5
2020-06-21-170508,170508,0,0,0,739,0.6666666666666666,0.016361311,6
2020-06-22-170508,170508,2,0,0,741,0.6666666666666666,0.0080476245,0
2020-06-23-170508,170508,1,0,0,742,0.6666666666666666,0.024773149,1
2020-06-24-170508,170508,0,1,0,742,0.6666666666666666,0.11102198,2
2020-06-25-170508,170508,1,0,2,743,0.3333333333333333,0.5286791,3
2020-06-26-170508,170508,1,0,0,744,1.0,0.10153812,4
2020-06-27-170508,170508,0,0,0,744,0.3333333333333333,0.03192203,5
2020-06-28-170508,170508,0,0,1,744,0.0,0.0015764362,6
2020-06-29-170508,170508,1,0,1,745,1.6666666666666667,0.064017706,0
2020-06-30-170508,170508,0,0,1,745,0.3333333333333333,0.19375667,1
2020-07-01-170508,170508,1,0,1,746,0.3333333333333333,0.03208046,2
2020-07-02-170508,170508,2,0,2,748,1.0,0.092553705,3
2020-07-03-170508,170508,0,0,1,748,0.6666666666666666,0.5084244,4
2020-07-04-170508,170508,2,0,1,750,1.0,0.0034779059,5
2020-07-05-170508,170508,0,0,0,750,0.0,0.010422392,6
2020-07-06-170508,170508,0,0,1,750,0.0,0.09680869,0
2020-07-07-170508,170508,0,0,0,750,1.3333333333333333,0.05303493,1
2020-07-08-170508,170508,0,0,3,750,1.0,0.02682495,2
2020-07-09-170508,170508,2,0,0,752,1.6666666666666667,0.00878592,3
2020-07-10-170508,170508,0,0,0,752,1.6666666666666667,0.9680732,4
2020-07-11-170508,170508,0,0,0,752,0.0,0.006783417,5
2020-07-12-170508,170508,1,0,0,753,0.3333333333333333,0.009132484,6
2020-07-13-170508,170508,1,0,0,754,0.6666666666666666,0.0041433033,0
2020-07-14-170508,170508,1,0,0,755,2.333333333333333,0.06141606,1
2020-07-15-170508,170508,1,0,0,756,0.3333333333333333,0.067728676,2
2020-07-16-170508,170508,2,0,0,758,1.0,0.090245716,3
2020-07-17-170508,170508,1,0,3,759,0.3333333333333333,0.019211574,4
2020-07-18-170508,170508,1,0,1,760,0.3333333333333333,0.0017195058,5
2020-07-19-170508,170508,0,0,1,760,0.6666666666666666,0.025062345,6
2020-07-20-170508,170508,1,0,2,761,0.0,0.022613415,0
2020-07-21-170508,170508,0,0,1,761,0.6666666666666666,0.028000059,1
2020-07-22-170508,170508,3,0,1,764,0.6666666666666666,0.49489242,2
2020-07-23-170508,170508,0,0,1,764,1.6666666666666667,1.4545113,3
2020-07-24-170508,170508,0,0,1,764,0.3333333333333333,0.07583145,4
2020-07-25-170508,170508,0,0,2,764,0.0,0.010242371,5
2020-07-26-170508,170508,0,0,1,764,0.0,0.0018558025,6
2020-07-27-170508,170508,0,0,2,764,0.0,0.16132529,0
2020-07-28-170508,170508,0,0,4,764,0.0,0.16563223,1
2020-07-29-170508,170508,0,0,1,764,0.6666666666666666,0.05120607,2
2020-07-30-170508,170508,0,0,0,764,1.0,1.2974224,3
2020-07-31-170508,170508,3,0,1,767,0.0,0.050921816,4
2020-08-01-170508,170508,1,0,6,768,0.6666666666666666,0.021300094,5
2020-08-02-170508,170508,1,0,0,769,0.0,0.031569935,6
2020-08-03-170508,170508,2,0,2,771,0.6666666666666666,0.49578083,0
2020-08-04-170508,170508,1,0,1,772,0.6666666666666666,0.95289487,1
2020-08-05-170508,170508,1,0,6,773,1.6666666666666667,1.1250677,2
2020-08-06-170508,170508,1,0,2,774,1.3333333333333333,0.62739336,3
2020-08-07-170508,170508,1,0,4,775,1.6666666666666667,1.7504009,4
2020-08-08-170508,170508,2,0,4,777,1.3333333333333333,0.08430222,5
2020-08-09-170508,170508,1,0,2,778,1.3333333333333333,0.042689282,6
2020-08-10-170508,170508,2,1,3,780,0.0,0.05905619,0
2020-08-11-170508,170508,4,0,0,784,1.6666666666666667,0.49720722,1
2020-08-12-170508,170508,1,0,6,785,1.6666666666666667,1.0098008,2
2020-08-13-170508,170508,0,0,2,785,3.333333333333333,0.10924771,3
2020-08-14-170508,170508,1,0,9,786,2.6666666666666665,1.9267766,4
2020-08-15-170508,170508,6,1,3,792,2.6666666666666665,0.092194594,5
2020-08-16-170508,170508,0,1,3,792,1.0,0.27326703,6
2020-08-17-170508,170508,2,0,2,794,3.0,0.4179979,0
2020-08-18-170508,170508,1,0,1,795,0.0,0.29700956,1
2020-08-19-170508,170508,6,0,0,801,2.6666666666666665,3.5941896,2
2020-08-20-170508,170508,2,0,3,803,1.6666666666666667,0.33268064,3
2020-08-21-170508,170508,4,0,6,807,2.0,1.3011788,4
2020-08-22-170508,170508,4,0,7,811,4.333333333333333,0.69109696,5
2020-08-23-170508,170508,2,0,7,813,2.6666666666666665,0.14420627,6
2020-08-24-170508,170508,3,0,7,816,3.6666666666666665,0.6737157,0
2020-08-25-170508,170508,0,0,3,816,4.666666666666667,0.19207262,1
2020-08-26-170508,170508,6,0,3,822,3.333333333333333,0.7750395,2
2020-08-27-170508,170508,2,0,11,824,0.6666666666666666,0.53466564,3
2020-08-28-170508,170508,9,0,8,833,4.0,0.25318217,4
2020-08-29-170508,170508,3,0,9,836,4.666666666666667,0.076939225,5
2020-08-30-170508,170508,3,0,18,839,1.3333333333333333,0.47083288,6
2020-08-31-170508,170508,2,0,2,841,3.333333333333333,0.10702541,0
2020-09-01-170508,170508,1,1,5,842,2.0,2.6834974,1
2020-09-02-170508,170508,0,1,7,842,6.0,0.09695255,2
2020-09-03-170508,170508,3,0,3,845,7.0,1.4462297,3
2020-09-04-170508,170508,6,0,14,851,5.0,0.9950834,4
2020-09-05-170508,170508,7,1,4,858,3.6666666666666665,1.0355281,5
2020-09-06-170508,170508,7,1,23,865,6.333333333333332,0.30680683,6
2020-09-07-170508,170508,7,0,7,872,5.666666666666668,0.3856369,0
2020-09-08-170508,170508,3,0,8,875,6.666666666666668,0.90530443,1
2020-09-09-170508,170508,3,0,10,878,3.6666666666666665,1.1101462,2
2020-09-10-170508,170508,11,1,11,889,4.333333333333333,1.3515521,3
2020-09-11-170508,170508,8,0,12,897,5.333333333333333,0.5766838,4
2020-09-12-170508,170508,9,0,5,906,5.333333333333333,0.53181475,5
2020-09-13-170508,170508,18,0,4,924,5.0,0.6191614,6
2020-09-14-170508,170508,2,1,1,926,6.333333333333332,1.7639827,0
2020-09-15-170508,170508,5,0,10,931,10.0,1.5220569,1
2020-09-16-170508,170508,7,0,9,938,6.666666666666668,0.72179013,2
2020-09-17-170508,170508,3,0,3,941,10.333333333333334,0.32805175,3
2020-09-18-170508,170508,14,0,20,955,10.333333333333334,1.5970742,4
2020-09-19-170508,170508,4,0,12,959,4.0,0.45064718,5
2020-09-20-170508,170508,23,0,6,982,9.0,0.8853226,6
2020-09-21-170508,170508,7,1,18,989,7.333333333333332,1.2017702,0
2020-09-22-170508,170508,8,1,6,997,6.333333333333332,0.99918157,1
2020-09-23-170508,170508,10,0,6,1007,11.666666666666664,1.1644119,2
2020-09-24-170508,170508,11,0,10,1018,5.666666666666668,1.556021,3
2020-09-25-170508,170508,12,0,24,1030,7.333333333333332,0.63584065,4
2020-09-26-170508,170508,5,0,16,1035,7.666666666666668,2.1669252,5
2020-09-27-170508,170508,4,0,1,1039,8.333333333333334,1.6999887,6
2020-09-28-170508,170508,1,0,14,1040,10.333333333333334,1.6284368,0
2020-09-29-170508,170508,10,0,8,1050,6.666666666666668,0.1241407,1
2020-09-30-170508,170508,9,0,8,1059,7.333333333333332,2.0827692,2
2020-10-01-170508,170508,3,1,11,1062,5.666666666666668,1.2354249,3
2020-10-02-170508,170508,20,0,33,1082,9.666666666666666,1.9950093,4
2020-10-03-170508,170508,12,0,31,1094,9.666666666666666,1.031683,5
2020-10-04-170508,170508,6,0,4,1100,3.0,0.53389037,6
2020-10-05-170508,170508,18,1,8,1118,5.666666666666668,0.8831798,0
2020-10-06-170508,170508,6,0,7,1124,5.0,0.88811773,1
2020-10-07-170508,170508,6,1,9,1130,5.0,1.171028,2
2020-10-08-170508,170508,10,0,21,1140,4.0,1.8954324,3
2020-10-09-170508,170508,24,0,19,1164,10.0,0.60488623,4
2020-10-10-170508,170508,16,0,17,1180,7.0,0.5895096,5
2020-10-11-170508,170508,1,0,6,1181,2.6666666666666665,0.023302373,6
2020-10-12-170508,170508,14,0,20,1195,5.0,0.39806253,0
2020-10-13-170508,170508,8,0,19,1203,6.333333333333332,1.1379383,1
2020-10-14-170508,170508,8,0,20,1211,9.333333333333334,4.010978,2
2020-10-15-170508,170508,11,0,11,1222,12.0,1.7967405,3
2020-10-16-170508,170508,33,0,22,1255,13.666666666666664,1.4411451,4
2020-10-17-170508,170508,31,0,17,1286,12.666666666666664,0.5009393,5
2020-10-18-170508,170508,4,1,8,1290,4.666666666666667,0.106822215,6
2020-10-19-170508,170508,8,0,11,1298,9.333333333333334,0.73192346,0
2020-10-20-170508,170508,7,0,9,1305,8.333333333333334,2.3440938,1
2020-10-21-170508,170508,9,2,19,1314,3.6666666666666665,0.28389063,2
2020-10-22-170508,170508,21,0,21,1335,8.666666666666666,1.2860558,3
2020-10-23-170508,170508,19,0,64,1354,11.333333333333336,1.1507838,4
2020-10-24-170508,170508,17,1,23,1371,8.0,1.190001,5
2020-10-25-170508,170508,6,0,4,1377,13.666666666666664,0.5983826,6
2020-10-26-170508,170508,20,1,22,1397,10.0,1.1178108,0
2020-10-27-170508,170508,19,1,8,1416,9.666666666666666,0.9699212,1
2020-10-28-170508,170508,20,1,6,1436,10.333333333333334,2.9581141,2
2020-10-29-170508,170508,11,3,12,1447,16.666666666666668,1.2534479,3
2020-10-30-170508,170508,22,0,10,1469,13.666666666666664,2.7475686,4
2020-10-31-170508,170508,17,3,0,1486,14.333333333333336,0.712374,5
2020-11-01-170508,170508,8,1,0,1494,4.333333333333333,0.2702738,6
2020-11-02-170508,170508,11,2,0,1505,12.666666666666664,0.6147368,0
2020-11-03-170508,170508,9,3,0,1514,7.666666666666668,3.1881135,1
2020-11-04-170508,170508,19,1,0,1533,10.0,3.4422774,2
2020-11-05-170508,170508,21,2,0,1554,10.0,5.212071,3
2020-11-06-170508,170508,64,4,0,1618,14.333333333333336,1.0236614,4
2020-11-07-170508,170508,23,1,0,1641,24.66666666666667,18.633413,5
2020-11-08-170508,170508,4,2,0,1645,7.333333333333332,0.55396247,6
2020-11-09-170508,170508,22,2,0,1667,8.666666666666666,3.407567,0
2020-11-10-170508,170508,8,3,0,1675,9.0,1.4496857,1
2020-11-11-170508,170508,6,5,0,1681,7.0,0.89574426,2
2020-11-12-170508,170508,12,0,0,1693,10.333333333333334,2.4833477,3
2020-11-13-170508,170508,10,5,0,1703,14.0,5.278219,4
2020-03-01-170509,170509,0,0,2,0,0.0,0.00029045783,6
2020-03-02-170509,170509,0,0,6,0,0.0,3.30917e-05,0
2020-03-03-170509,170509,0,0,10,0,0.0,1.1686934e-05,1
2020-03-04-170509,170509,0,0,18,0,0.25,0.00031215607,2
2020-03-05-170509,170509,0,0,18,0,0.0,9.820387e-06,3
2020-03-06-170509,170509,0,0,7,0,0.0,0.00062943634,4
2020-03-07-170509,170509,0,0,15,0,0.0,0.0001724912,5
2020-03-08-170509,170509,0,1,12,0,0.0,0.01827748,6
2020-03-09-170509,170509,1,0,21,1,1.0,0.014635058,0
2020-03-10-170509,170509,1,0,20,2,0.25,0.001622185,1
2020-03-11-170509,170509,1,0,31,3,0.75,0.0022240274,2
2020-03-12-170509,170509,3,0,27,6,0.75,0.029097924,3
2020-03-13-170509,170509,1,0,20,7,1.25,0.030447213,4
2020-03-14-170509,170509,1,0,12,8,1.0,0.019237833,5
2020-03-15-170509,170509,2,0,8,10,1.5,0.0143480925,6
2020-03-16-170509,170509,6,0,25,16,6.25,0.05673704,0
2020-03-17-170509,170509,10,1,17,26,7.0,0.24617915,1
2020-03-18-170509,170509,18,0,9,44,11.5,0.25058714,2
2020-03-19-170509,170509,18,0,13,62,14.75,0.3248247,3
2020-03-20-170509,170509,7,0,13,69,15.5,0.27476406,4
2020-03-21-170509,170509,15,0,3,84,7.25,0.17229483,5
2020-03-22-170509,170509,12,0,9,96,6.75,0.093118615,6
2020-03-23-170509,170509,21,0,11,117,24.0,0.6044718,0
2020-03-24-170509,170509,20,0,7,137,21.75,0.4719126,1
2020-03-25-170509,170509,31,0,18,168,17.5,0.37867412,2
2020-03-26-170509,170509,27,0,8,195,19.5,0.47293058,3
2020-03-27-170509,170509,20,0,16,215,16.25,0.6856012,4
2020-03-28-170509,170509,12,0,4,227,8.25,0.10478445,5
2020-03-29-170509,170509,8,0,0,235,6.25,0.029248111,6
2020-03-30-170509,170509,25,0,6,260,16.5,0.34466946,0
2020-03-31-170509,170509,17,0,7,277,13.25,0.19811131,1
2020-04-01-170509,170509,9,0,9,286,9.5,0.31351814,2
2020-04-02-170509,170509,13,0,6,299,11.0,0.28717154,3
2020-04-03-170509,170509,13,0,3,312,13.5,0.11802541,4
2020-04-04-170509,170509,3,0,1,315,3.5,0.017938675,5
2020-04-05-170509,170509,9,0,1,324,5.5,0.20687304,6
2020-04-06-170509,170509,11,0,7,335,13.25,0.26247308,0
2020-04-07-170509,170509,7,0,12,342,9.0,0.26347724,1
2020-04-08-170509,170509,18,0,8,360,14.0,0.18139851,2
2020-04-09-170509,170509,8,2,2,368,10.25,0.2904619,3
2020-04-10-170509,170509,16,0,10,384,8.0,0.14337517,4
2020-04-11-170509,170509,4,0,1,388,7.75,0.096625775,5
2020-04-12-170509,170509,0,0,0,388,2.5,0.0023669077,6
2020-04-13-170509,170509,6,0,2,394,6.75,0.15385683,0
2020-04-14-170509,170509,7,0,2,401,13.0,0.07324515,1
2020-04-15-170509,170509,9,0,6,410,12.0,0.07607318,2
2020-04-16-170509,170509,6,1,5,416,9.0,0.096539676,3
2020-04-17-170509,170509,3,0,2,419,7.0,0.11911332,4
2020-04-18-170509,170509,1,0,0,420,4.5,0.00021409531,5
2020-04-19-170509,170509,1,0,0,421,2.0,0.004523008,6
2020-04-20-170509,170509,7,0,4,428,7.0,0.16086134,0
2020-04-21-170509,170509,12,0,3,440,8.0,0.107057735,1
2020-04-22-170509,170509,8,0,3,448,8.25,0.1308413,2
2020-04-23-170509,170509,2,0,4,450,2.75,0.004627827,3
2020-04-24-170509,170509,10,0,3,460,6.75,0.13800353,4
2020-04-25-170509,170509,1,0,3,461,2.0,0.0047630314,5
2020-04-26-170509,170509,0,0,1,461,2.5,0.084225364,6
2020-04-27-170509,170509,2,0,9,463,5.0,0.07551065,0
2020-04-28-170509,170509,2,0,4,465,6.25,0.18585959,1
2020-04-29-170509,170509,6,0,7,471,3.0,0.1695628,2
2020-04-30-170509,170509,5,0,6,476,5.0,0.0724234,3
2020-05-01-170509,170509,2,0,4,478,3.5,0.042228483,4
2020-05-02-170509,170509,0,0,0,478,1.75,0.005827301,5
2020-05-03-170509,170509,0,0,0,478,1.5,0.0022364373,6
2020-05-04-170509,170509,4,0,7,482,5.0,0.18205145,0
2020-05-05-170509,170509,3,0,4,485,4.5,0.09200839,1
2020-05-06-170509,170509,3,0,0,488,6.0,0.108677775,2
2020-05-07-170509,170509,4,0,3,492,4.75,0.24750078,3
2020-05-08-170509,170509,3,0,4,495,6.75,0.08076271,4
2020-05-09-170509,170509,3,0,2,498,1.5,0.0020104623,5
2020-05-10-170509,170509,1,0,0,499,1.25,0.0019447593,6
2020-05-11-170509,170509,9,1,3,508,4.5,0.13213345,0
2020-05-12-170509,170509,4,0,7,512,5.0,0.12948383,1
2020-05-13-170509,170509,7,1,4,519,5.0,0.096066624,2
2020-05-14-170509,170509,6,0,3,525,4.25,0.030302476,3
2020-05-15-170509,170509,4,0,3,529,2.0,0.18713975,4
2020-05-16-170509,170509,0,0,0,529,0.5,0.01060663,5
2020-05-17-170509,170509,0,1,1,529,0.75,0.001797683,6
2020-05-18-170509,170509,7,0,5,536,5.0,0.02558202,0
2020-05-19-170509,170509,4,0,2,540,5.75,0.51022476,1
2020-05-20-170509,170509,0,0,2,540,3.25,0.04212861,2
2020-05-21-170509,170509,3,0,3,543,3.5,0.03840434,3
2020-05-22-170509,170509,4,2,2,547,4.75,0.18794379,4
2020-05-23-170509,170509,2,0,0,549,0.75,0.000646984,5
2020-05-24-170509,170509,0,0,0,549,0.0,9.82492e-06,6
2020-05-25-170509,170509,3,1,0,552,2.5,0.02730731,0
2020-05-26-170509,170509,7,0,1,559,3.0,0.12300586,1
2020-05-27-170509,170509,4,0,4,563,5.5,0.05833101,2
2020-05-28-170509,170509,3,2,1,566,2.5,0.12699628,3
2020-05-29-170509,170509,3,0,1,569,2.25,0.16938949,4
2020-05-30-170509,170509,0,0,1,569,0.75,0.084845155,5
2020-05-31-170509,170509,1,0,0,570,0.75,0.01586108,6
2020-06-01-170509,170509,5,0,2,575,2.75,0.13675453,0
2020-06-02-170509,170509,2,0,0,577,2.0,0.026055967,1
2020-06-03-170509,170509,2,0,0,579,2.0,0.025148109,2
2020-06-04-170509,170509,3,0,1,582,2.25,0.033846185,3
2020-06-05-170509,170509,2,0,3,584,1.25,0.04376487,4
2020-06-06-170509,170509,0,1,2,584,0.5,0.016853772,5
2020-06-07-170509,170509,0,4,0,584,0.5,2.1066437e-05,6
2020-06-08-170509,170509,0,0,1,584,4.25,0.0173253,0
2020-06-09-170509,170509,1,0,1,585,1.0,0.024824094,1
2020-06-10-170509,170509,4,0,1,589,1.75,0.052118737,2
2020-06-11-170509,170509,1,0,0,590,2.0,0.04079187,3
2020-06-12-170509,170509,1,0,3,591,2.5,0.14177799,4
2020-06-13-170509,170509,1,0,0,592,1.25,0.019107476,5
2020-06-14-170509,170509,0,0,0,592,0.0,0.00065173494,6
2020-06-15-170509,170509,2,0,1,594,1.0,0.042214833,0
2020-06-16-170509,170509,0,0,1,594,1.75,0.10328075,1
2020-06-17-170509,170509,0,0,1,594,2.0,0.01483738,2
2020-06-18-170509,170509,1,0,1,595,1.0,0.03825241,3
2020-06-19-170509,170509,3,0,0,598,1.75,0.22572081,4
2020-06-20-170509,170509,2,0,2,600,0.5,0.0118156755,5
2020-06-21-170509,170509,0,0,0,600,0.75,0.0045554494,6
2020-06-22-170509,170509,1,0,0,601,1.5,0.003988044,0
2020-06-23-170509,170509,1,0,3,602,1.0,0.009565184,1
2020-06-24-170509,170509,1,0,1,603,0.5,0.028152777,2
2020-06-25-170509,170509,0,0,3,603,1.0,0.12680693,3
2020-06-26-170509,170509,3,0,2,606,0.5,0.027393896,4
2020-06-27-170509,170509,0,0,0,606,0.75,0.014801312,5
2020-06-28-170509,170509,0,0,0,606,0.0,0.0003986349,6
2020-06-29-170509,170509,1,0,1,607,1.25,0.021708533,0
2020-06-30-170509,170509,1,0,0,608,0.5,0.06445019,1
2020-07-01-170509,170509,1,0,0,609,0.5,0.0093925875,2
2020-07-02-170509,170509,1,0,1,610,1.0,0.027156277,3
2020-07-03-170509,170509,0,0,0,610,0.5,0.1323584,4
2020-07-04-170509,170509,2,1,0,612,0.75,0.0012763654,5
2020-07-05-170509,170509,0,0,1,612,0.0,0.0023152577,6
2020-07-06-170509,170509,0,0,0,612,0.25,0.0379738,0
2020-07-07-170509,170509,3,0,2,615,0.75,0.01828079,1
2020-07-08-170509,170509,1,0,0,616,0.75,0.0073011895,2
2020-07-09-170509,170509,3,0,1,619,1.0,0.0018125677,3
2020-07-10-170509,170509,2,0,1,621,1.0,0.22153072,4
2020-07-11-170509,170509,0,0,0,621,0.0,0.0017092006,5
2020-07-12-170509,170509,0,0,0,621,0.5,0.0030173557,6
2020-07-13-170509,170509,1,0,0,622,0.5,0.0017713218,0
2020-07-14-170509,170509,0,0,0,622,2.0,0.018984344,1
2020-07-15-170509,170509,0,0,1,622,1.75,0.022465982,2
2020-07-16-170509,170509,1,0,0,623,1.25,0.027549967,3
2020-07-17-170509,170509,0,0,0,623,0.5,0.0041307514,4
2020-07-18-170509,170509,0,0,2,623,0.75,0.00045827325,5
2020-07-19-170509,170509,1,0,0,624,0.25,0.008625746,6
2020-07-20-170509,170509,0,0,0,624,0.25,0.0059397393,0
2020-07-21-170509,170509,2,0,0,626,0.0,0.011824061,1
2020-07-22-170509,170509,0,0,3,626,1.25,0.119031936,2
2020-07-23-170509,170509,1,0,3,627,1.0,0.32974446,3
2020-07-24-170509,170509,1,0,1,628,0.5,0.023322942,4
2020-07-25-170509,170509,0,0,2,628,0.0,0.0031514226,5
2020-07-26-170509,170509,0,0,2,628,0.0,0.000744329,6
2020-07-27-170509,170509,0,0,0,628,0.0,0.060989436,0
2020-07-28-170509,170509,0,0,1,628,0.0,0.042575914,1
2020-07-29-170509,170509,1,0,0,629,1.0,0.016631428,2
2020-07-30-170509,170509,0,0,5,629,0.75,0.33108142,3
2020-07-31-170509,170509,0,0,2,629,1.75,0.016422674,4
2020-08-01-170509,170509,2,0,5,631,0.25,0.0076153018,5
2020-08-02-170509,170509,0,0,1,631,0.5,0.009208867,6
2020-08-03-170509,170509,0,0,4,631,1.0,0.11646366,0
2020-08-04-170509,170509,0,0,0,631,1.0,0.23198801,1
2020-08-05-170509,170509,3,0,3,634,1.25,0.27981755,2
2020-08-06-170509,170509,3,0,1,637,1.0,0.17171088,3
2020-08-07-170509,170509,1,1,3,638,2.0,0.386253,4
2020-08-08-170509,170509,2,0,7,640,1.0,0.024824206,5
2020-08-09-170509,170509,2,0,6,642,1.5,0.018676383,6
2020-08-10-170509,170509,0,0,5,642,1.25,0.017515697,0
2020-08-11-170509,170509,1,0,4,643,2.25,0.13047181,1
2020-08-12-170509,170509,0,0,7,643,2.5,0.27984175,2
2020-08-13-170509,170509,5,0,2,648,1.5,0.0322028,3
2020-08-14-170509,170509,2,0,4,650,3.25,0.47611842,4
2020-08-15-170509,170509,5,0,9,655,2.25,0.028972952,5
2020-08-16-170509,170509,1,0,2,656,0.5,0.080576204,6
2020-08-17-170509,170509,4,0,8,660,2.75,0.123556726,0
2020-08-18-170509,170509,0,0,0,660,1.75,0.09898997,1
2020-08-19-170509,170509,3,0,7,663,5.5,0.8753424,2
2020-08-20-170509,170509,1,0,12,664,1.75,0.12677602,3
2020-08-21-170509,170509,3,0,6,667,4.0,0.40060803,4
2020-08-22-170509,170509,7,0,7,674,4.0,0.1650135,5
2020-08-23-170509,170509,6,0,12,680,1.0,0.05404087,6
2020-08-24-170509,170509,5,0,7,685,4.0,0.19355106,0
2020-08-25-170509,170509,4,0,11,689,2.5,0.061187465,1
2020-08-26-170509,170509,7,0,5,696,3.75,0.19846271,2
2020-08-27-170509,170509,2,0,6,698,2.25,0.16420923,3
2020-08-28-170509,170509,4,0,7,702,6.0,0.0817544,4
2020-08-29-170509,170509,9,0,8,711,4.25,0.02342804,5
2020-08-30-170509,170509,2,0,5,713,1.5,0.12362736,6
2020-08-31-170509,170509,8,1,7,721,2.25,0.040512018,0
2020-09-01-170509,170509,0,0,23,721,2.5,0.6960686,1
2020-09-02-170509,170509,7,1,9,728,3.5,0.030071523,2
2020-09-03-170509,170509,12,0,20,740,6.25,0.40510035,3
2020-09-04-170509,170509,6,0,16,746,6.0,0.32452422,4
2020-09-05-170509,170509,7,1,5,753,5.25,0.23856989,5
2020-09-06-170509,170509,12,0,11,765,5.0,0.120853335,6
2020-09-07-170509,170509,7,0,7,772,8.0,0.1143226,0
2020-09-08-170509,170509,11,0,8,783,6.0,0.27837178,1
2020-09-09-170509,170509,5,0,19,788,4.0,0.32749325,2
2020-09-10-170509,170509,6,1,7,794,5.75,0.37142405,3
2020-09-11-170509,170509,7,1,12,801,7.25,0.19643676,4
2020-09-12-170509,170509,8,0,11,809,6.25,0.14052951,5
2020-09-13-170509,170509,5,0,14,814,7.75,0.17697152,6
2020-09-14-170509,170509,7,0,13,821,6.25,0.48642358,0
2020-09-15-170509,170509,23,0,7,844,5.25,0.40602598,1
2020-09-16-170509,170509,9,0,6,853,6.75,0.19955419,2
2020-09-17-170509,170509,20,0,10,873,6.5,0.11328381,3
2020-09-18-170509,170509,16,0,14,889,11.25,0.46067983,4
2020-09-19-170509,170509,5,1,18,894,4.5,0.11226371,5
2020-09-20-170509,170509,11,0,3,905,14.25,0.22151463,6
2020-09-21-170509,170509,7,0,10,912,9.0,0.3243573,0
2020-09-22-170509,170509,8,3,7,920,7.25,0.24032447,1
2020-09-23-170509,170509,19,1,10,939,9.25,0.31633392,2
2020-09-24-170509,170509,7,1,4,946,9.0,0.39774933,3
2020-09-25-170509,170509,12,0,16,958,8.0,0.19381437,4
2020-09-26-170509,170509,11,0,12,969,5.5,0.5590812,5
2020-09-27-170509,170509,14,0,4,983,6.0,0.3612868,6
2020-09-28-170509,170509,13,0,8,996,6.5,0.389925,0
2020-09-29-170509,170509,7,0,6,1003,6.25,0.05255603,1
2020-09-30-170509,170509,6,0,15,1009,8.25,0.45842388,2
2020-10-01-170509,170509,10,0,17,1019,5.25,0.3247423,3
2020-10-02-170509,170509,14,0,18,1033,13.5,0.5450105,4
2020-10-03-170509,170509,18,1,15,1051,10.0,0.272217,5
2020-10-04-170509,170509,3,1,4,1054,4.5,0.14195186,6
2020-10-05-170509,170509,10,0,12,1064,9.5,0.26645488,0
2020-10-06-170509,170509,7,0,16,1071,9.0,0.27707577,1
2020-10-07-170509,170509,10,0,9,1081,6.25,0.27421492,2
2020-10-08-170509,170509,4,0,9,1085,10.25,0.49940044,3
2020-10-09-170509,170509,16,0,16,1101,18.25,0.1549604,4
2020-10-10-170509,170509,12,0,7,1113,9.0,0.1362513,5
2020-10-11-170509,170509,4,0,19,1117,1.5,0.00801449,6
2020-10-12-170509,170509,8,0,13,1125,9.75,0.081829704,0
2020-10-13-170509,170509,6,0,13,1131,9.25,0.2794093,1
2020-10-14-170509,170509,15,0,14,1146,10.25,1.1512556,2
2020-10-15-170509,170509,17,0,33,1163,13.75,0.42394114,3
2020-10-16-170509,170509,18,0,19,1181,20.75,0.38487664,4
2020-10-17-170509,170509,15,0,17,1196,19.0,0.11397373,5
2020-10-18-170509,170509,4,0,7,1200,5.0,0.03734751,6
2020-10-19-170509,170509,12,1,17,1212,8.75,0.21415596,0
2020-10-20-170509,170509,16,0,6,1228,6.5,0.62238276,1
2020-10-21-170509,170509,9,0,9,1237,4.75,0.09718326,2
2020-10-22-170509,170509,9,0,11,1246,13.5,0.37302142,3
2020-10-23-170509,170509,16,0,18,1262,15.25,0.34592178,4
2020-10-24-170509,170509,7,1,11,1269,11.75,0.3028257,5
2020-10-25-170509,170509,19,0,12,1288,9.25,0.13349888,6
2020-10-26-170509,170509,13,1,11,1301,11.0,0.39281932,0
2020-10-27-170509,170509,13,1,15,1314,15.25,0.30726773,1
2020-10-28-170509,170509,14,1,6,1328,12.25,0.8381579,2
2020-10-29-170509,170509,33,0,17,1361,9.0,0.39523646,3
2020-10-30-170509,170509,19,2,15,1380,15.75,0.758526,4
2020-10-31-170509,170509,17,0,0,1397,12.25,0.18972379,5
2020-11-01-170509,170509,7,0,0,1404,4.5,0.10827789,6
2020-11-02-170509,170509,17,2,0,1421,12.75,0.16606395,0
2020-11-03-170509,170509,6,0,0,1427,8.0,0.78787893,1
2020-11-04-170509,170509,9,0,0,1436,11.75,0.85195535,2
2020-11-05-170509,170509,11,1,0,1447,15.25,1.3409892,3
2020-11-06-170509,170509,18,0,0,1465,27.0,0.33576682,4
2020-11-07-170509,170509,11,0,0,1476,24.25,4.1900945,5
2020-11-08-170509,170509,12,1,0,1488,5.5,0.13452072,6
2020-11-09-170509,170509,11,3,0,1499,12.5,0.91042197,0
2020-11-10-170509,170509,15,1,0,1514,8.5,0.39503974,1
2020-11-11-170509,170509,6,1,0,1520,7.5,0.22873507,2
2020-11-12-170509,170509,17,0,0,1537,14.25,0.6442753,3
2020-11-13-170509,170509,15,0,0,1552,14.75,1.1884179,4
2020-03-01-170510,170510,0,0,0,0,0.0,5.9999543e-06,6
2020-03-02-170510,170510,0,0,3,0,0.0,2.2375902e-05,0
2020-03-03-170510,170510,0,3,0,0,0.0,0.0006329394,1
2020-03-04-170510,170510,0,0,2,0,0.0,0.0021441705,2
2020-03-05-170510,170510,0,0,1,0,0.0,0.0006464595,3
2020-03-06-170510,170510,0,0,0,0,0.0,0.0033251639,4
2020-03-07-170510,170510,0,0,0,0,0.0,0.0006953032,5
2020-03-08-170510,170510,0,0,2,0,0.25,0.057464197,6
2020-03-09-170510,170510,0,0,0,0,0.0,0.09167933,0
2020-03-10-170510,170510,0,0,0,0,0.0,0.001676094,1
2020-03-11-170510,170510,0,0,0,0,0.0,0.004774814,2
2020-03-12-170510,170510,1,0,2,1,0.5,0.25528574,3
2020-03-13-170510,170510,0,0,2,1,0.5,0.21765593,4
2020-03-14-170510,170510,0,0,1,1,0.75,0.21972759,5
2020-03-15-170510,170510,0,0,4,1,0.5,0.07587573,6
2020-03-16-170510,170510,3,0,2,4,0.75,0.36610156,0
2020-03-17-170510,170510,0,0,0,4,0.25,0.1048104,1
2020-03-18-170510,170510,2,0,1,6,0.0,0.20532298,2
2020-03-19-170510,170510,1,0,1,7,1.25,0.49136677,3
2020-03-20-170510,170510,0,0,0,7,1.75,0.6359575,4
2020-03-21-170510,170510,0,0,1,7,0.75,0.34588104,5
2020-03-22-170510,170510,2,0,0,9,0.5,0.16775428,6
2020-03-23-170510,170510,0,0,0,9,2.0,0.7791267,0
2020-03-24-170510,170510,0,0,0,9,1.25,0.464917,1
2020-03-25-170510,170510,0,0,2,9,1.25,0.47088665,2
2020-03-26-170510,170510,2,0,0,11,1.75,0.6108578,3
2020-03-27-170510,170510,2,0,2,13,4.25,1.22706,4
2020-03-28-170510,170510,1,0,1,14,1.0,0.29168215,5
2020-03-29-170510,170510,4,0,0,18,0.5,0.28430238,6
2020-03-30-170510,170510,2,0,1,20,2.5,0.7977585,0
2020-03-31-170510,170510,0,0,1,20,0.75,0.31242013,1
2020-04-01-170510,170510,1,0,3,21,2.25,0.68292737,2
2020-04-02-170510,170510,1,0,0,22,1.25,0.35688996,3
2020-04-03-170510,170510,0,0,1,22,0.5,0.22630863,4
2020-04-04-170510,170510,1,0,0,23,0.75,0.250404,5
2020-04-05-170510,170510,0,0,0,23,0.25,0.12420845,6
2020-04-06-170510,170510,0,4,1,23,2.0,0.4645665,0
2020-04-07-170510,170510,0,0,0,23,1.25,0.28728533,1
2020-04-08-170510,170510,2,0,2,25,3.25,0.8557064,2
2020-04-09-170510,170510,0,0,0,25,5.25,0.81147367,3
2020-04-10-170510,170510,2,0,1,27,2.5,0.700877,4
2020-04-11-170510,170510,1,0,1,28,0.25,0.13187407,5
2020-04-12-170510,170510,0,0,0,28,0.75,0.110420935,6
2020-04-13-170510,170510,1,0,2,29,1.75,0.63248706,0
2020-04-14-170510,170510,1,0,0,30,2.0,0.460831,1
2020-04-15-170510,170510,3,0,1,33,1.5,0.48748803,2
2020-04-16-170510,170510,0,0,1,33,1.0,0.32198897,3
2020-04-17-170510,170510,1,0,0,34,4.5,1.153189,4
2020-04-18-170510,170510,0,0,0,34,0.0,0.00807516,5
2020-04-19-170510,170510,0,0,0,34,0.75,0.1198645,6
2020-04-20-170510,170510,1,0,0,35,4.0,1.1248446,0
2020-04-21-170510,170510,0,0,0,35,0.75,0.22389428,1
2020-04-22-170510,170510,2,0,1,37,0.75,0.3634573,2
2020-04-23-170510,170510,0,0,0,37,1.25,0.20375448,3
2020-04-24-170510,170510,1,0,0,38,0.5,0.26268756,4
2020-04-25-170510,170510,1,0,0,39,0.25,0.22474742,5
2020-04-26-170510,170510,0,0,1,39,0.25,0.09116794,6
2020-04-27-170510,170510,2,0,1,41,0.25,0.19461033,0
2020-04-28-170510,170510,0,0,0,41,0.75,0.24318354,1
2020-04-29-170510,170510,1,1,0,42,0.75,0.35587773,2
2020-04-30-170510,170510,1,0,0,43,1.0,0.34361562,3
2020-05-01-170510,170510,0,0,0,43,1.0,0.20327896,4
2020-05-02-170510,170510,0,0,0,43,0.75,0.16795966,5
2020-05-03-170510,170510,0,0,1,43,0.0,0.0008547495,6
2020-05-04-170510,170510,0,0,0,43,1.25,0.57696855,0
2020-05-05-170510,170510,0,0,0,43,0.25,0.04943921,1
2020-05-06-170510,170510,1,0,0,44,0.25,0.24978322,2
2020-05-07-170510,170510,0,0,1,44,1.0,0.30472246,3
2020-05-08-170510,170510,0,0,1,44,1.25,0.40560877,4
2020-05-09-170510,170510,0,1,1,44,0.0,0.009628122,5
2020-05-10-170510,170510,1,1,0,45,0.0,0.06572336,6
2020-05-11-170510,170510,1,0,0,46,0.25,0.21619624,0
2020-05-12-170510,170510,0,0,0,46,1.0,0.301702,1
2020-05-13-170510,170510,0,0,0,46,0.5,0.22298217,2
2020-05-14-170510,170510,0,3,0,46,0.25,0.09031259,3
2020-05-15-170510,170510,0,0,1,46,1.0,0.36122578,4
2020-05-16-170510,170510,0,0,0,46,0.0,0.0009962315,5
2020-05-17-170510,170510,1,0,3,47,0.0,0.067545876,6
2020-05-18-170510,170510,0,0,0,47,0.25,0.118185066,0
2020-05-19-170510,170510,0,0,0,47,0.5,0.24493997,1
2020-05-20-170510,170510,0,0,0,47,1.5,0.40498435,2
2020-05-21-170510,170510,1,0,0,48,1.0,0.46385854,3
2020-05-22-170510,170510,1,0,0,49,1.25,0.49593017,4
2020-05-23-170510,170510,1,0,0,50,0.0,0.068437144,5
2020-05-24-170510,170510,0,0,0,50,0.0,1.0598304e-06,6
2020-05-25-170510,170510,0,0,0,50,0.25,0.09457944,0
2020-05-26-170510,170510,0,0,1,50,0.5,0.24111594,1
2020-05-27-170510,170510,0,0,0,50,0.75,0.28000906,2
2020-05-28-170510,170510,0,0,0,50,0.75,0.21947844,3
2020-05-29-170510,170510,1,0,1,51,0.75,0.4445673,4
2020-05-30-170510,170510,0,1,0,51,0.0,0.016295776,5
2020-05-31-170510,170510,3,0,0,54,0.0,0.20963378,6
2020-06-01-170510,170510,0,0,0,54,1.0,0.31257975,0
2020-06-02-170510,170510,0,0,0,54,0.25,0.2543371,1
2020-06-03-170510,170510,0,0,0,54,0.75,0.22267027,2
2020-06-04-170510,170510,0,0,0,54,0.75,0.30421984,3
2020-06-05-170510,170510,0,2,0,54,1.75,0.6399173,4
2020-06-06-170510,170510,0,0,0,54,0.5,0.12981164,5
2020-06-07-170510,170510,0,0,1,54,0.0,7.5997204e-06,6
2020-06-08-170510,170510,0,0,0,54,0.5,0.19827066,0
2020-06-09-170510,170510,1,0,0,55,0.25,0.22208562,1
2020-06-10-170510,170510,0,0,0,55,0.75,0.7911082,2
2020-06-11-170510,170510,0,0,1,55,1.5,0.64459145,3
2020-06-12-170510,170510,1,0,0,56,0.5,0.24426553,4
2020-06-13-170510,170510,0,0,0,56,0.25,0.08086629,5
2020-06-14-170510,170510,0,0,0,56,0.0,0.0034582932,6
2020-06-15-170510,170510,0,0,0,56,0.75,0.36496955,0
2020-06-16-170510,170510,0,0,0,56,0.25,0.04908785,1
2020-06-17-170510,170510,0,0,0,56,0.25,0.100521326,2
2020-06-18-170510,170510,0,0,0,56,0.5,0.23577006,3
2020-06-19-170510,170510,0,0,0,56,0.25,0.124328725,4
2020-06-20-170510,170510,0,0,0,56,0.25,0.13792317,5
2020-06-21-170510,170510,1,0,0,57,0.0,0.08768734,6
2020-06-22-170510,170510,0,0,0,57,0.0,0.0085859075,0
2020-06-23-170510,170510,0,0,0,57,0.0,0.10220913,1
2020-06-24-170510,170510,0,0,0,57,0.5,0.22178926,2
2020-06-25-170510,170510,1,0,0,58,0.25,0.16907023,3
2020-06-26-170510,170510,0,0,0,58,0.25,0.18549743,4
2020-06-27-170510,170510,0,0,0,58,0.5,0.19472286,5
2020-06-28-170510,170510,0,0,0,58,0.0,0.00019050197,6
2020-06-29-170510,170510,0,0,0,58,0.25,0.11880068,0
2020-06-30-170510,170510,0,0,0,58,0.0,0.11605203,1
2020-07-01-170510,170510,0,0,0,58,0.25,0.14119244,2
2020-07-02-170510,170510,0,0,0,58,0.25,0.21250536,3
2020-07-03-170510,170510,0,0,0,58,0.25,0.24917006,4
2020-07-04-170510,170510,0,0,0,58,0.0,0.0137276165,5
2020-07-05-170510,170510,0,0,1,58,0.5,0.08087238,6
2020-07-06-170510,170510,0,0,0,58,0.25,0.36660594,0
2020-07-07-170510,170510,0,0,0,58,0.25,0.030821383,1
2020-07-08-170510,170510,0,0,0,58,0.25,0.13194737,2
2020-07-09-170510,170510,0,0,1,58,0.0,0.030978253,3
2020-07-10-170510,170510,0,0,1,58,0.25,0.17957531,4
2020-07-11-170510,170510,0,0,0,58,0.25,0.051566515,5
2020-07-12-170510,170510,0,0,0,58,0.0,0.055096813,6
2020-07-13-170510,170510,0,0,0,58,0.0,0.010470569,0
2020-07-14-170510,170510,0,0,0,58,0.5,0.3332237,1
2020-07-15-170510,170510,0,0,0,58,1.0,0.30126697,2
2020-07-16-170510,170510,0,0,0,58,1.0,0.49292594,3
2020-07-17-170510,170510,0,0,0,58,0.0,0.10308335,4
2020-07-18-170510,170510,0,0,0,58,0.0,0.0047137514,5
2020-07-19-170510,170510,1,0,0,59,0.0,0.10820627,6
2020-07-20-170510,170510,0,0,0,59,0.0,0.024702534,0
2020-07-21-170510,170510,0,0,0,59,0.0,0.022472655,1
2020-07-22-170510,170510,0,0,0,59,0.25,0.10130338,2
2020-07-23-170510,170510,1,0,2,60,0.25,0.24279763,3
2020-07-24-170510,170510,1,0,0,61,0.5,0.34235692,4
2020-07-25-170510,170510,0,0,0,61,0.25,0.034112565,5
2020-07-26-170510,170510,0,0,0,61,0.0,0.0052343663,6
2020-07-27-170510,170510,0,0,1,61,0.75,0.26249552,0
2020-07-28-170510,170510,0,0,0,61,0.5,0.16347529,1
2020-07-29-170510,170510,0,0,0,61,0.0,0.09087004,2
2020-07-30-170510,170510,0,0,1,61,0.0,0.06486789,3
2020-07-31-170510,170510,0,0,1,61,1.0,0.15984352,4
2020-08-01-170510,170510,0,0,0,61,0.25,0.12441414,5
2020-08-02-170510,170510,0,0,1,61,0.0,0.07216528,6
2020-08-03-170510,170510,0,0,1,61,0.0,0.049077008,0
2020-08-04-170510,170510,0,0,0,61,0.5,0.15301782,1
2020-08-05-170510,170510,0,0,0,61,1.0,0.48329136,2
2020-08-06-170510,170510,2,0,1,63,0.0,0.35084847,3
2020-08-07-170510,170510,0,0,2,63,0.25,0.12426693,4
2020-08-08-170510,170510,0,0,0,63,1.0,0.15473123,5
2020-08-09-170510,170510,0,0,1,63,0.0,0.061394762,6
2020-08-10-170510,170510,1,0,0,64,0.25,0.26747856,0
2020-08-11-170510,170510,0,0,0,64,1.0,0.4974775,1
2020-08-12-170510,170510,0,0,0,64,1.5,0.59044254,2
2020-08-13-170510,170510,1,0,0,65,0.5,0.32726082,3
2020-08-14-170510,170510,1,1,0,66,0.75,0.26001707,4
2020-08-15-170510,170510,0,0,0,66,0.5,0.22827052,5
2020-08-16-170510,170510,1,0,0,67,1.75,0.6279076,6
2020-08-17-170510,170510,1,0,0,68,1.25,0.55563504,0
2020-08-18-170510,170510,0,0,0,68,1.75,0.52899504,1
2020-08-19-170510,170510,0,0,0,68,0.25,0.35504544,2
2020-08-20-170510,170510,1,0,1,69,1.25,0.6402151,3
2020-08-21-170510,170510,2,0,0,71,3.0,1.5733994,4
2020-08-22-170510,170510,0,0,0,71,2.25,0.7142538,5
2020-08-23-170510,170510,1,0,0,72,0.75,0.37623122,6
2020-08-24-170510,170510,0,0,0,72,1.25,0.5628795,0
2020-08-25-170510,170510,0,0,0,72,2.0,0.8690576,1
2020-08-26-170510,170510,0,0,0,72,1.0,0.6513804,2
2020-08-27-170510,170510,0,0,0,72,5.5,2.2687347,3
2020-08-28-170510,170510,0,0,4,72,1.5,0.42210677,4
2020-08-29-170510,170510,0,0,3,72,0.75,0.2617302,5
2020-08-30-170510,170510,0,0,1,72,1.5,0.35755166,6
2020-08-31-170510,170510,0,0,5,72,0.75,0.2836417,0
2020-09-01-170510,170510,0,0,0,72,1.5,0.4706756,1
2020-09-02-170510,170510,0,0,4,72,0.5,0.244141,2
2020-09-03-170510,170510,1,0,1,73,0.75,0.2941473,3
2020-09-04-170510,170510,0,0,1,73,2.25,0.7548206,4
2020-09-05-170510,170510,0,0,0,73,0.75,0.19486852,5
2020-09-06-170510,170510,0,0,2,73,1.5,0.4812612,6
2020-09-07-170510,170510,0,0,0,73,0.5,0.23700616,0
2020-09-08-170510,170510,0,0,0,73,1.75,0.6978957,1
2020-09-09-170510,170510,0,0,1,73,3.25,0.831082,2
2020-09-10-170510,170510,0,0,0,73,3.25,0.90270835,3
2020-09-11-170510,170510,4,0,0,77,2.75,1.1845634,4
2020-09-12-170510,170510,3,0,1,80,0.75,0.48884276,5
2020-09-13-170510,170510,1,0,0,81,0.5,0.35713503,6
2020-09-14-170510,170510,5,0,2,86,1.0,0.76808625,0
2020-09-15-170510,170510,0,0,0,86,1.5,0.47967264,1
2020-09-16-170510,170510,4,0,1,90,1.75,0.8089066,2
2020-09-17-170510,170510,1,0,1,91,1.0,0.59452707,3
2020-09-18-170510,170510,1,0,4,92,1.0,0.5808526,4
2020-09-19-170510,170510,0,0,0,92,0.0,0.0718511,5
2020-09-20-170510,170510,2,1,1,94,0.5,0.45521706,6
2020-09-21-170510,170510,0,0,1,94,0.0,0.15651174,0
2020-09-22-170510,170510,0,0,0,94,1.0,0.09512927,1
2020-09-23-170510,170510,1,0,0,95,2.25,0.6358563,2
2020-09-24-170510,170510,0,0,0,95,1.25,0.4520602,3
2020-09-25-170510,170510,0,0,0,95,1.25,0.33362517,4
2020-09-26-170510,170510,1,0,2,96,1.75,0.86033726,5
2020-09-27-170510,170510,0,0,2,96,0.75,0.30419448,6
2020-09-28-170510,170510,2,0,0,98,0.5,0.40288386,0
2020-09-29-170510,170510,0,0,0,98,0.75,0.554866,1
2020-09-30-170510,170510,1,0,0,99,1.5,0.5108203,2
2020-10-01-170510,170510,1,0,0,100,1.0,0.7346496,3
2020-10-02-170510,170510,4,0,0,104,3.0,1.2060984,4
2020-10-03-170510,170510,0,1,0,104,2.25,0.4487292,5
2020-10-04-170510,170510,1,0,1,105,2.0,0.5820536,6
2020-10-05-170510,170510,1,0,1,106,0.75,0.71837676,0
2020-10-06-170510,170510,0,0,0,106,2.75,0.97100335,1
2020-10-07-170510,170510,0,1,0,106,2.0,0.7814575,2
2020-10-08-170510,170510,0,0,2,106,1.75,0.75448114,3
2020-10-09-170510,170510,0,0,0,106,1.0,0.2505702,4
2020-10-10-170510,170510,2,0,0,108,3.0,1.3016082,5
2020-10-11-170510,170510,2,0,1,110,0.0,0.2912444,6
2020-10-12-170510,170510,0,0,0,110,1.5,0.28335938,0
2020-10-13-170510,170510,0,0,2,110,2.5,0.5058552,1
2020-10-14-170510,170510,0,0,0,110,2.5,1.0667639,2
2020-10-15-170510,170510,0,0,1,110,1.75,0.83861107,3
2020-10-16-170510,170510,0,0,0,110,2.75,1.2760346,4
2020-10-17-170510,170510,0,0,2,110,2.25,0.4768184,5
2020-10-18-170510,170510,1,0,0,111,0.5,0.40323335,6
2020-10-19-170510,170510,1,0,0,112,1.75,0.51034534,0
2020-10-20-170510,170510,0,0,1,112,4.5,1.0823791,1
2020-10-21-170510,170510,0,0,0,112,1.25,0.53597057,2
2020-10-22-170510,170510,2,0,4,114,3.0,1.018118,3
2020-10-23-170510,170510,0,0,0,114,5.0,1.1601388,4
2020-10-24-170510,170510,0,0,1,114,1.75,0.53449714,5
2020-10-25-170510,170510,1,0,0,115,3.25,0.77433026,6
2020-10-26-170510,170510,0,0,0,115,2.75,0.8545244,0
2020-10-27-170510,170510,2,0,1,117,3.0,0.98929906,1
2020-10-28-170510,170510,0,0,1,117,2.75,1.3246174,2
2020-10-29-170510,170510,1,0,1,118,3.25,1.5297062,3
2020-10-30-170510,170510,0,0,0,118,4.0,1.5263572,4
2020-10-31-170510,170510,2,0,0,120,0.75,0.5753863,5
2020-11-01-170510,170510,0,0,0,120,1.25,0.47322008,6
2020-11-02-170510,170510,0,0,0,120,2.0,0.53330725,0
2020-11-03-170510,170510,1,0,0,121,5.0,1.408745,1
2020-11-04-170510,170510,0,0,0,121,1.0,0.6756171,2
2020-11-05-170510,170510,4,0,0,125,3.0,1.7346126,3
2020-11-06-170510,170510,0,0,0,125,0.5,0.61706847,4
2020-11-07-170510,170510,1,0,0,126,2.0,0.8215879,5
2020-11-08-170510,170510,0,0,0,126,2.5,0.66987383,6
2020-11-09-170510,170510,0,0,0,126,1.75,0.59549224,0
2020-11-10-170510,170510,1,0,0,127,2.25,1.0711946,1
2020-11-11-170510,170510,1,1,0,128,0.5,0.450223,2
2020-11-12-170510,170510,1,0,0,129,2.25,1.3010951,3
2020-11-13-170510,170510,0,0,0,129,2.75,1.1587335,4
2020-03-01-170511,170511,0,0,0,0,0.0,0.0005529242,6
2020-03-02-170511,170511,0,0,0,0,0.0,0.00049828156,0
2020-03-03-170511,170511,0,0,3,0,0.0,0.0003607708,1
2020-03-04-170511,170511,0,0,3,0,0.08333333333333333,0.0015163382,2
2020-03-05-170511,170511,0,0,4,0,0.0,0.00016458993,3
2020-03-06-170511,170511,0,0,3,0,0.0,0.004210702,4
2020-03-07-170511,170511,0,0,3,0,0.0,0.0015730415,5
2020-03-08-170511,170511,0,0,2,0,0.16666666666666666,0.17801005,6
2020-03-09-170511,170511,0,0,9,0,0.5833333333333334,0.089121826,0
2020-03-10-170511,170511,0,0,7,0,0.25,0.012786483,1
2020-03-11-170511,170511,0,0,6,0,0.3333333333333333,0.011279206,2
2020-03-12-170511,170511,0,0,8,0,0.75,0.17317067,3
2020-03-13-170511,170511,0,0,9,0,0.5833333333333334,0.19012554,4
2020-03-14-170511,170511,0,0,2,0,0.75,0.124831304,5
2020-03-15-170511,170511,0,0,0,0,1.1666666666666667,0.11873013,6
2020-03-16-170511,170511,0,0,5,0,3.8333333333333335,0.5512684,0
2020-03-17-170511,170511,3,2,4,3,4.333333333333333,2.0674472,1
2020-03-18-170511,170511,3,0,5,6,6.916666666666668,2.1951828,2
2020-03-19-170511,170511,4,0,5,10,7.916666666666668,2.903652,3
2020-03-20-170511,170511,3,0,2,13,7.833333333333332,2.7396333,4
2020-03-21-170511,170511,3,0,0,16,4.5,1.7704895,5
2020-03-22-170511,170511,2,0,5,18,3.8333333333333335,1.2250824,6
2020-03-23-170511,170511,9,0,4,27,11.166666666666664,6.0669484,0
2020-03-24-170511,170511,7,0,4,34,10.333333333333334,4.424579,1
2020-03-25-170511,170511,6,0,2,40,9.75,3.7359958,2
2020-03-26-170511,170511,8,0,5,48,10.333333333333334,4.827721,3
2020-03-27-170511,170511,9,0,3,57,9.333333333333334,7.468944,4
2020-03-28-170511,170511,2,0,2,59,4.833333333333333,1.0969734,5
2020-03-29-170511,170511,0,0,0,59,4.166666666666667,0.45415515,6
2020-03-30-170511,170511,5,0,2,64,8.833333333333334,3.6615949,0
2020-03-31-170511,170511,4,0,1,68,6.75,2.1442008,1
2020-04-01-170511,170511,5,0,1,73,5.416666666666668,3.2884507,2
2020-04-02-170511,170511,5,0,1,78,8.083333333333334,2.999584,3
2020-04-03-170511,170511,2,0,1,80,6.5,1.321533,4
2020-04-04-170511,170511,0,0,0,80,2.1666666666666665,0.3325699,5
2020-04-05-170511,170511,5,0,0,85,3.25,2.382446,6
2020-04-06-170511,170511,4,6,2,89,6.75,2.5179987,0
2020-04-07-170511,170511,4,0,1,93,4.5,2.8450124,1
2020-04-08-170511,170511,2,0,2,95,8.0,2.0950708,2
2020-04-09-170511,170511,5,0,0,100,5.333333333333333,3.267139,3
2020-04-10-170511,170511,3,0,1,103,5.0,1.972705,4
2020-04-11-170511,170511,2,0,0,105,3.25,1.0326259,5
2020-04-12-170511,170511,0,0,2,105,1.1666666666666667,0.057476997,6
2020-04-13-170511,170511,2,0,1,107,3.75,1.5561421,0
2020-04-14-170511,170511,1,0,2,108,5.25,0.69401985,1
2020-04-15-170511,170511,1,0,2,109,5.416666666666668,0.8671796,2
2020-04-16-170511,170511,1,0,1,110,4.416666666666667,0.9476337,3
2020-04-17-170511,170511,1,0,1,111,3.083333333333333,1.2248667,4
2020-04-18-170511,170511,0,0,0,111,1.5833333333333333,0.0021575587,5
2020-04-19-170511,170511,0,0,0,111,1.0,0.028112313,6
2020-04-20-170511,170511,2,0,2,113,3.333333333333333,1.7458475,0
2020-04-21-170511,170511,1,0,1,114,4.416666666666667,1.2224154,1
2020-04-22-170511,170511,2,0,1,116,3.8333333333333335,1.1380545,2
2020-04-23-170511,170511,0,0,3,116,1.25,0.07863787,3
2020-04-24-170511,170511,1,0,1,117,3.583333333333333,1.2315601,4
2020-04-25-170511,170511,0,0,0,117,0.9166666666666666,0.08423379,5
2020-04-26-170511,170511,2,0,0,119,1.1666666666666667,0.9904815,6
2020-04-27-170511,170511,1,0,1,120,3.0,0.7401774,0
2020-04-28-170511,170511,2,0,1,122,2.5,1.8287636,1
2020-04-29-170511,170511,2,1,1,124,2.083333333333333,1.4669857,2
2020-04-30-170511,170511,1,0,0,125,2.333333333333333,0.6299128,3
2020-05-01-170511,170511,1,0,2,126,1.5,0.45635352,4
2020-05-02-170511,170511,0,0,0,126,0.8333333333333334,0.07714772,5
2020-05-03-170511,170511,0,0,0,126,0.6666666666666666,0.011122747,6
2020-05-04-170511,170511,2,0,0,128,2.4166666666666665,1.6697885,0
2020-05-05-170511,170511,1,0,6,129,2.083333333333333,0.779172,1
2020-05-06-170511,170511,1,0,0,130,2.9166666666666665,1.0170478,2
2020-05-07-170511,170511,3,0,0,133,2.5,2.147161,3
2020-05-08-170511,170511,1,0,2,134,2.6666666666666665,0.74349284,4
2020-05-09-170511,170511,0,0,0,134,1.0833333333333333,0.018219586,5
2020-05-10-170511,170511,0,0,0,134,0.6666666666666666,0.023338579,6
2020-05-11-170511,170511,1,0,0,135,3.0,0.96202695,0
2020-05-12-170511,170511,1,0,1,136,2.583333333333333,1.0443084,1
2020-05-13-170511,170511,1,0,0,137,2.75,0.8754456,2
2020-05-14-170511,170511,0,0,1,137,2.25,0.21995215,3
2020-05-15-170511,170511,2,2,1,139,1.5,1.5119954,4
2020-05-16-170511,170511,0,1,1,139,0.5,0.046521302,5
2020-05-17-170511,170511,0,0,0,139,0.3333333333333333,0.021427471,6
2020-05-18-170511,170511,0,0,1,139,2.833333333333333,0.21325554,0
2020-05-19-170511,170511,6,0,0,145,2.333333333333333,3.910048,1
2020-05-20-170511,170511,0,0,0,145,1.5833333333333333,0.41955477,2
2020-05-21-170511,170511,0,0,0,145,2.333333333333333,0.36930093,3
2020-05-22-170511,170511,2,0,0,147,2.4166666666666665,1.4473513,4
2020-05-23-170511,170511,0,0,0,147,0.5,0.013315957,5
2020-05-24-170511,170511,0,0,0,147,0.0,0.0004515004,6
2020-05-25-170511,170511,0,0,0,147,1.5,0.15341152,0
2020-05-26-170511,170511,1,0,0,148,1.6666666666666667,0.852347,1
2020-05-27-170511,170511,0,0,0,148,2.6666666666666665,0.48006046,2
2020-05-28-170511,170511,1,1,0,149,1.25,1.0935681,3
2020-05-29-170511,170511,1,0,1,150,1.4166666666666667,1.4210887,4
2020-05-30-170511,170511,1,0,0,151,0.16666666666666666,0.66621,5
2020-05-31-170511,170511,0,0,0,151,0.4166666666666667,0.12024012,6
2020-06-01-170511,170511,1,0,0,152,1.6666666666666667,1.0675865,0
2020-06-02-170511,170511,0,0,1,152,1.0,0.22144833,1
2020-06-03-170511,170511,0,0,1,152,0.9166666666666666,0.26517352,2
2020-06-04-170511,170511,0,0,0,152,1.3333333333333333,0.42725846,3
2020-06-05-170511,170511,0,1,2,152,0.75,0.38176808,4
2020-06-06-170511,170511,0,0,0,152,0.25,0.15148999,5
2020-06-07-170511,170511,0,0,0,152,0.16666666666666666,4.997825e-05,6
2020-06-08-170511,170511,0,0,0,152,1.5,0.15827358,0
2020-06-09-170511,170511,0,0,0,152,0.5833333333333334,0.21316925,1
2020-06-10-170511,170511,0,1,1,152,1.0833333333333333,0.44788113,2
2020-06-11-170511,170511,0,0,1,152,1.0833333333333333,0.5611456,3
2020-06-12-170511,170511,1,0,0,153,1.3333333333333333,0.97645265,4
2020-06-13-170511,170511,0,0,0,153,0.5833333333333334,0.20916833,5
2020-06-14-170511,170511,0,2,0,153,0.0,0.0035180962,6
2020-06-15-170511,170511,0,0,0,153,1.0,0.41848037,0
2020-06-16-170511,170511,1,0,0,154,0.8333333333333334,0.6970641,1
2020-06-17-170511,170511,1,0,0,155,0.9166666666666666,0.09947948,2
2020-06-18-170511,170511,0,0,0,155,0.9166666666666666,0.28210524,3
2020-06-19-170511,170511,2,0,1,157,0.9166666666666666,1.4697281,4
2020-06-20-170511,170511,0,0,0,157,0.3333333333333333,0.08940588,5
2020-06-21-170511,170511,0,0,0,157,0.25,0.041301344,6
2020-06-22-170511,170511,0,0,0,157,0.6666666666666666,0.02063325,0
2020-06-23-170511,170511,0,0,0,157,0.4166666666666667,0.06657758,1
2020-06-24-170511,170511,1,0,0,158,0.5,0.3063958,2
2020-06-25-170511,170511,1,0,0,159,0.3333333333333333,0.8206384,3
2020-06-26-170511,170511,0,0,2,159,0.75,0.22608852,4
2020-06-27-170511,170511,0,0,0,159,0.3333333333333333,0.09804103,5
2020-06-28-170511,170511,0,0,0,159,0.08333333333333333,0.0015997515,6
2020-06-29-170511,170511,0,0,0,159,0.6666666666666666,0.16633232,0
2020-06-30-170511,170511,0,0,2,159,0.5,0.5234738,1
2020-07-01-170511,170511,0,0,0,159,0.25,0.08865663,2
2020-07-02-170511,170511,0,0,0,159,0.5833333333333334,0.2044344,3
2020-07-03-170511,170511,1,0,1,160,0.16666666666666666,0.8985913,4
2020-07-04-170511,170511,0,0,0,160,0.5,0.009632004,5
2020-07-05-170511,170511,0,0,0,160,0.08333333333333333,0.023813326,6
2020-07-06-170511,170511,0,0,0,160,0.25,0.26846415,0
2020-07-07-170511,170511,0,0,0,160,0.6666666666666666,0.11609562,1
2020-07-08-170511,170511,0,0,1,160,0.3333333333333333,0.06713788,2
2020-07-09-170511,170511,0,0,3,160,0.75,0.016298773,3
2020-07-10-170511,170511,2,0,0,162,0.5,1.5344952,4
2020-07-11-170511,170511,0,0,0,162,0.0,0.016508011,5
2020-07-12-170511,170511,0,0,0,162,0.16666666666666666,0.014266529,6
2020-07-13-170511,170511,0,0,0,162,0.3333333333333333,0.016226612,0
2020-07-14-170511,170511,2,0,0,164,0.75,0.19761069,1
2020-07-15-170511,170511,0,0,0,164,1.1666666666666667,0.20253041,2
2020-07-16-170511,170511,0,0,3,164,0.5833333333333334,0.24014455,3
2020-07-17-170511,170511,1,0,0,165,0.08333333333333333,0.035964917,4
2020-07-18-170511,170511,0,0,0,165,0.25,0.004382719,5
2020-07-19-170511,170511,0,0,0,165,0.25,0.081245534,6
2020-07-20-170511,170511,0,0,1,165,0.08333333333333333,0.06705412,0
2020-07-21-170511,170511,0,0,2,165,0.25,0.078296766,1
2020-07-22-170511,170511,1,0,2,166,0.4166666666666667,0.84853303,2
2020-07-23-170511,170511,3,0,1,169,0.25,2.4057465,3
2020-07-24-170511,170511,0,0,4,169,0.3333333333333333,0.20630014,4
2020-07-25-170511,170511,0,0,0,169,0.0,0.023700692,5
2020-07-26-170511,170511,0,0,0,169,0.08333333333333333,0.0045221997,6
2020-07-27-170511,170511,0,0,0,169,0.5,0.49323803,0
2020-07-28-170511,170511,0,0,1,169,0.25,0.45183572,1
2020-07-29-170511,170511,0,0,2,169,0.5,0.14231947,2
2020-07-30-170511,170511,3,0,2,172,0.16666666666666666,2.2258801,3
2020-07-31-170511,170511,0,0,4,172,0.8333333333333334,0.12744276,4
2020-08-01-170511,170511,0,0,0,172,0.25,0.073106565,5
2020-08-02-170511,170511,0,0,0,172,0.16666666666666666,0.10908853,6
2020-08-03-170511,170511,1,0,0,173,0.3333333333333333,0.75072885,0
2020-08-04-170511,170511,2,0,0,175,0.5,1.5348372,1
2020-08-05-170511,170511,2,0,3,177,1.5,2.0023193,2
2020-08-06-170511,170511,1,0,1,178,0.75,1.2146634,3
2020-08-07-170511,170511,4,1,1,182,0.5,2.93871,4
2020-08-08-170511,170511,0,0,1,182,0.6666666666666666,0.226425,5
2020-08-09-170511,170511,0,0,0,182,0.9166666666666666,0.14865284,6
2020-08-10-170511,170511,0,0,2,182,0.5833333333333334,0.1538604,0
2020-08-11-170511,170511,1,0,3,183,1.1666666666666667,0.91586083,1
2020-08-12-170511,170511,2,0,1,185,1.3333333333333333,1.81518,2
2020-08-13-170511,170511,2,0,0,187,1.5833333333333333,0.28061315,3
2020-08-14-170511,170511,4,0,1,191,1.8333333333333333,3.3000197,4
2020-08-15-170511,170511,0,0,0,191,1.5,0.2954732,5
2020-08-16-170511,170511,0,0,1,191,0.8333333333333334,0.95738286,6
2020-08-17-170511,170511,0,0,0,191,2.5,1.1470628,0
2020-08-18-170511,170511,0,0,5,191,1.5,0.6829767,1
2020-08-19-170511,170511,3,0,0,194,2.1666666666666665,5.8786745,2
2020-08-20-170511,170511,1,0,0,195,1.5,1.0233692,3
2020-08-21-170511,170511,1,0,2,196,3.4166666666666665,3.2532141,4
2020-08-22-170511,170511,1,0,1,197,2.5,1.7075816,5
2020-08-23-170511,170511,0,0,0,197,1.3333333333333333,0.4739102,6
2020-08-24-170511,170511,2,0,0,199,1.9166666666666667,1.3308566,0
2020-08-25-170511,170511,3,0,1,202,1.25,0.49531922,1
2020-08-26-170511,170511,1,0,0,203,2.6666666666666665,1.5501549,2
2020-08-27-170511,170511,0,0,2,203,2.0,1.4499309,3
2020-08-28-170511,170511,1,0,0,204,3.083333333333333,0.6083872,4
2020-08-29-170511,170511,0,0,1,204,2.4166666666666665,0.23088028,5
2020-08-30-170511,170511,1,0,1,205,1.5833333333333333,0.96487767,6
2020-08-31-170511,170511,0,0,6,205,1.6666666666666667,0.28535756,0
2020-09-01-170511,170511,5,0,1,210,1.5,4.5716968,1
2020-09-02-170511,170511,0,0,2,210,1.9166666666666667,0.28336376,2
2020-09-03-170511,170511,0,0,0,210,4.083333333333333,2.741889,3
2020-09-04-170511,170511,2,0,2,212,3.333333333333333,2.164154,4
2020-09-05-170511,170511,1,0,1,213,2.5,1.8868859,5
2020-09-06-170511,170511,0,0,2,213,4.5,1.2502943,6
2020-09-07-170511,170511,0,0,2,213,4.166666666666667,1.0090661,0
2020-09-08-170511,170511,1,0,2,214,4.666666666666667,1.8749844,1
2020-09-09-170511,170511,0,0,3,214,3.6666666666666665,2.6752148,2
2020-09-10-170511,170511,2,0,3,216,3.333333333333333,2.477508,3
2020-09-11-170511,170511,0,0,3,216,3.9166666666666665,1.3820971,4
2020-09-12-170511,170511,1,0,5,217,3.25,1.0798857,5
2020-09-13-170511,170511,1,0,4,218,4.916666666666667,1.330555,6
2020-09-14-170511,170511,6,0,3,224,4.333333333333333,3.0728838,0
2020-09-15-170511,170511,1,0,0,225,6.333333333333332,2.797497,1
2020-09-16-170511,170511,2,0,4,227,3.8333333333333335,1.3342106,2
2020-09-17-170511,170511,0,0,2,227,5.5,0.8229314,3
2020-09-18-170511,170511,2,0,2,229,7.666666666666668,2.8923075,4
2020-09-19-170511,170511,1,0,2,230,3.75,0.833815,5
2020-09-20-170511,170511,2,0,1,232,6.75,1.7765723,6
2020-09-21-170511,170511,2,0,1,234,4.666666666666667,2.1285167,0
2020-09-22-170511,170511,2,0,1,236,4.416666666666667,1.6140989,1
2020-09-23-170511,170511,3,1,2,239,6.333333333333332,2.0801184,2
2020-09-24-170511,170511,3,1,3,242,4.333333333333333,2.6110852,3
2020-09-25-170511,170511,3,0,3,245,4.166666666666667,1.2099653,4
2020-09-26-170511,170511,5,0,1,250,3.4166666666666665,3.6094878,5
2020-09-27-170511,170511,4,0,0,254,3.6666666666666665,2.8884764,6
2020-09-28-170511,170511,3,0,1,257,3.583333333333333,2.6676106,0
2020-09-29-170511,170511,0,0,2,257,3.25,0.35632646,1
2020-09-30-170511,170511,4,0,3,261,4.333333333333333,2.9444218,2
2020-10-01-170511,170511,2,0,4,263,4.0,2.139789,3
2020-10-02-170511,170511,2,0,2,265,7.416666666666668,3.5748034,4
2020-10-03-170511,170511,2,1,1,267,5.75,1.876246,5
2020-10-04-170511,170511,1,0,0,268,2.25,1.1462718,6
2020-10-05-170511,170511,1,0,0,269,4.916666666666667,1.8101635,0
2020-10-06-170511,170511,1,0,4,270,4.916666666666667,1.9263864,1
2020-10-07-170511,170511,2,0,0,272,3.6666666666666665,2.019714,2
2020-10-08-170511,170511,3,0,2,275,5.25,3.5190432,3
2020-10-09-170511,170511,3,0,3,278,9.0,1.1467664,4
2020-10-10-170511,170511,1,0,2,279,6.0,1.5393885,5
2020-10-11-170511,170511,0,0,1,279,1.5,0.13306352,6
2020-10-12-170511,170511,1,0,1,280,4.333333333333333,0.70504093,0
2020-10-13-170511,170511,2,0,1,282,4.5,1.8630862,1
2020-10-14-170511,170511,3,0,3,285,8.916666666666666,8.513654,2
2020-10-15-170511,170511,4,0,1,289,6.833333333333332,3.0725772,3
2020-10-16-170511,170511,2,0,4,291,10.5,2.7705474,4
2020-10-17-170511,170511,1,0,1,292,8.333333333333334,0.9624071,5
2020-10-18-170511,170511,0,0,0,292,3.083333333333333,0.50076145,6
2020-10-19-170511,170511,0,0,1,292,5.916666666666668,1.5563399,0
2020-10-20-170511,170511,4,0,6,296,5.583333333333332,4.457717,1
2020-10-21-170511,170511,0,0,6,296,3.5,0.8223162,2
2020-10-22-170511,170511,2,0,8,298,6.75,2.53702,3
2020-10-23-170511,170511,3,0,5,301,9.583333333333334,2.57075,4
2020-10-24-170511,170511,2,0,47,303,6.583333333333332,2.4497457,5
2020-10-25-170511,170511,1,0,1,304,5.5,1.2127037,6
2020-10-26-170511,170511,1,0,6,305,6.75,2.2892666,0
2020-10-27-170511,170511,1,1,2,306,8.833333333333334,1.997637,1
2020-10-28-170511,170511,3,0,1,309,8.166666666666666,6.354727,2
2020-10-29-170511,170511,1,0,3,310,8.166666666666666,2.8462834,3
2020-10-30-170511,170511,4,0,12,314,9.333333333333334,5.4617867,4
2020-10-31-170511,170511,1,0,0,315,7.833333333333332,1.7041171,5
2020-11-01-170511,170511,0,0,0,315,3.583333333333333,0.931076,6
2020-11-02-170511,170511,1,0,0,316,6.916666666666668,1.2543068,0
2020-11-03-170511,170511,6,0,0,322,4.166666666666667,5.199562,1
2020-11-04-170511,170511,6,0,0,328,7.5,6.380216,2
2020-11-05-170511,170511,8,1,0,336,7.583333333333332,9.238284,3
2020-11-06-170511,170511,5,1,0,341,14.916666666666664,2.1744444,4
2020-11-07-170511,170511,47,1,0,388,8.083333333333334,31.004541,5
2020-11-08-170511,170511,1,1,0,389,4.083333333333333,1.251366,6
2020-11-09-170511,170511,6,0,0,395,6.416666666666668,5.709453,0
2020-11-10-170511,170511,2,1,0,397,6.333333333333332,2.8550773,1
2020-11-11-170511,170511,1,0,0,398,4.333333333333333,1.8215189,2
2020-11-12-170511,170511,3,1,0,401,8.5,4.603444,3
2020-11-13-170511,170511,12,1,0,413,8.0,8.267547,4
2020-03-01-170512,170512,0,0,1,0,0.0,3.5210654e-05,6
2020-03-02-170512,170512,0,0,1,0,0.0,1.2841954e-05,0
2020-03-03-170512,170512,0,1,2,0,0.0,8.158699e-06,1
2020-03-04-170512,170512,0,0,3,0,0.0,0.00010161242,2
2020-03-05-170512,170512,0,0,1,0,0.0,7.629263e-08,3
2020-03-06-170512,170512,0,0,2,0,0.0,0.00023807763,4
2020-03-07-170512,170512,0,0,1,0,0.0,0.00010196422,5
2020-03-08-170512,170512,0,0,1,0,0.2,0.01597622,6
2020-03-09-170512,170512,1,0,1,1,0.0,0.060326383,0
2020-03-10-170512,170512,0,0,1,1,0.0,0.002537204,1
2020-03-11-170512,170512,0,0,2,1,0.0,0.008069693,2
2020-03-12-170512,170512,0,0,2,1,0.0,0.023072548,3
2020-03-13-170512,170512,0,0,5,1,0.2,0.087743364,4
2020-03-14-170512,170512,0,0,1,1,0.0,0.010597236,5
2020-03-15-170512,170512,1,0,0,2,0.2,0.06695395,6
2020-03-16-170512,170512,1,0,1,3,0.2,0.23482756,0
2020-03-17-170512,170512,2,0,1,5,0.8,0.1667606,1
2020-03-18-170512,170512,3,0,1,8,1.0,0.33152768,2
2020-03-19-170512,170512,1,0,2,9,1.6,0.44637764,3
2020-03-20-170512,170512,2,0,1,11,3.2,0.6993307,4
2020-03-21-170512,170512,1,0,1,12,1.6,0.34888956,5
2020-03-22-170512,170512,1,0,0,13,1.4,0.29180408,6
2020-03-23-170512,170512,1,0,1,14,3.8,0.9015767,0
2020-03-24-170512,170512,1,0,0,15,2.6,0.4768802,1
2020-03-25-170512,170512,2,0,0,17,1.8,0.3236263,2
2020-03-26-170512,170512,2,0,0,19,3.4,0.6273157,3
2020-03-27-170512,170512,5,0,0,24,5.0,1.211419,4
2020-03-28-170512,170512,1,0,0,25,1.2,0.18404028,5
2020-03-29-170512,170512,0,0,1,25,1.0,0.2964174,6
2020-03-30-170512,170512,1,0,0,26,3.8,0.60455,0
2020-03-31-170512,170512,1,0,0,27,2.2,0.46213174,1
2020-04-01-170512,170512,1,0,0,28,3.2,0.47222683,2
2020-04-02-170512,170512,2,0,0,30,2.0,0.20828249,3
2020-04-03-170512,170512,1,0,0,31,1.0,0.18685472,4
2020-04-04-170512,170512,1,0,0,32,1.0,0.24053174,5
2020-04-05-170512,170512,0,0,0,32,1.4,0.21868294,6
2020-04-06-170512,170512,1,1,0,33,2.4,0.21889338,0
2020-04-07-170512,170512,0,0,0,33,2.0,0.5052778,1
2020-04-08-170512,170512,0,0,0,33,3.0,0.3695727,2
2020-04-09-170512,170512,0,0,0,33,5.0,0.31718802,3
2020-04-10-170512,170512,0,0,1,33,2.6,0.48079625,4
2020-04-11-170512,170512,0,0,0,33,1.0,0.12008363,5
2020-04-12-170512,170512,1,2,0,34,0.6,0.06892471,6
2020-04-13-170512,170512,0,0,2,34,2.2,0.37057,0
2020-04-14-170512,170512,0,0,0,34,0.6,0.108418,1
2020-04-15-170512,170512,0,0,0,34,0.8,0.17089823,2
2020-04-16-170512,170512,0,0,0,34,1.0,0.21789612,3
2020-04-17-170512,170512,0,0,0,34,3.8,0.56775457,4
2020-04-18-170512,170512,0,0,1,34,0.0,0.002236431,5
2020-04-19-170512,170512,0,0,0,34,0.4,0.028456658,6
2020-04-20-170512,170512,0,0,0,34,3.4,0.4051639,0
2020-04-21-170512,170512,0,0,0,34,1.2,0.3202108,1
2020-04-22-170512,170512,0,0,0,34,0.8,0.111202136,2
2020-04-23-170512,170512,0,0,0,34,0.8,0.076440535,3
2020-04-24-170512,170512,1,0,1,35,0.6,0.15159324,4
2020-04-25-170512,170512,0,0,0,35,0.4,0.12316757,5
2020-04-26-170512,170512,0,0,0,35,0.6,0.060186643,6
2020-04-27-170512,170512,2,0,0,37,0.4,0.08972928,0
2020-04-28-170512,170512,0,0,0,37,0.8,0.13876049,1
2020-04-29-170512,170512,0,0,0,37,1.4,0.31901336,2
2020-04-30-170512,170512,0,0,1,37,0.4,0.064791545,3
2020-05-01-170512,170512,0,0,0,37,0.2,0.021037497,4
2020-05-02-170512,170512,1,0,0,38,0.6,0.10405482,5
2020-05-03-170512,170512,0,0,0,38,0.0,0.0008327576,6
2020-05-04-170512,170512,0,0,0,38,1.0,0.27342305,0
2020-05-05-170512,170512,0,0,1,38,0.2,0.02885825,1
2020-05-06-170512,170512,0,0,0,38,0.6,0.23134153,2
2020-05-07-170512,170512,0,0,0,38,1.2,0.20164536,3
2020-05-08-170512,170512,1,0,0,39,1.0,0.20718266,4
2020-05-09-170512,170512,0,0,0,39,0.0,0.006647643,5
2020-05-10-170512,170512,0,0,0,39,0.0,0.02371098,6
2020-05-11-170512,170512,0,0,0,39,0.2,0.06753663,0
2020-05-12-170512,170512,0,0,0,39,0.8,0.09217661,1
2020-05-13-170512,170512,0,0,0,39,0.8,0.12769665,2
2020-05-14-170512,170512,1,0,0,40,0.2,0.05192131,3
2020-05-15-170512,170512,0,0,0,40,1.2,0.17154129,4
2020-05-16-170512,170512,0,0,0,40,0.0,0.0014805902,5
2020-05-17-170512,170512,0,0,0,40,0.0,0.008829144,6
2020-05-18-170512,170512,0,0,1,40,0.4,0.091009006,0
2020-05-19-170512,170512,1,0,0,41,1.6,0.2125106,1
2020-05-20-170512,170512,0,3,0,41,0.8,0.22014287,2
2020-05-21-170512,170512,0,0,0,41,0.6,0.17608845,3
2020-05-22-170512,170512,0,0,0,41,0.4,0.08849074,4
2020-05-23-170512,170512,0,0,0,41,0.0,0.019574929,5
2020-05-24-170512,170512,0,0,0,41,0.0,4.878516e-05,6
2020-05-25-170512,170512,0,0,0,41,0.0,0.013912717,0
2020-05-26-170512,170512,0,0,0,41,0.4,0.13639513,1
2020-05-27-170512,170512,0,0,0,41,0.6,0.2142189,2
2020-05-28-170512,170512,0,4,0,41,0.8,0.14300442,3
2020-05-29-170512,170512,0,0,0,41,1.0,0.22889717,4
2020-05-30-170512,170512,0,1,0,41,0.2,0.029119072,5
2020-05-31-170512,170512,0,0,0,41,0.0,0.043881677,6
2020-06-01-170512,170512,1,0,0,42,1.0,0.18208972,0
2020-06-02-170512,170512,0,0,0,42,0.4,0.1597117,1
2020-06-03-170512,170512,0,1,0,42,0.4,0.095551684,2
2020-06-04-170512,170512,0,0,0,42,0.6,0.11240968,3
2020-06-05-170512,170512,0,0,0,42,1.4,0.22491749,4
2020-06-06-170512,170512,0,0,0,42,0.2,0.015919885,5
2020-06-07-170512,170512,0,0,0,42,0.0,2.2523709e-05,6
2020-06-08-170512,170512,0,0,0,42,0.6,0.11383993,0
2020-06-09-170512,170512,0,1,0,42,0.2,0.048523467,1
2020-06-10-170512,170512,0,0,0,42,0.6,0.31991383,2
2020-06-11-170512,170512,0,0,0,42,1.0,0.18101403,3
2020-06-12-170512,170512,0,0,0,42,0.6,0.08103849,4
2020-06-13-170512,170512,0,0,0,42,0.4,0.058564056,5
2020-06-14-170512,170512,0,0,0,42,0.0,0.0030754658,6
2020-06-15-170512,170512,0,0,0,42,0.6,0.22254641,0
2020-06-16-170512,170512,0,0,0,42,0.2,0.025632903,1
2020-06-17-170512,170512,0,0,0,42,0.4,0.033585288,2
2020-06-18-170512,170512,0,0,0,42,0.4,0.08768782,3
2020-06-19-170512,170512,0,0,0,42,0.6,0.09121709,4
2020-06-20-170512,170512,0,0,0,42,0.2,0.053455263,5
2020-06-21-170512,170512,0,0,0,42,0.0,0.0113890385,6
2020-06-22-170512,170512,0,0,0,42,0.0,0.003186909,0
2020-06-23-170512,170512,0,0,0,42,0.0,0.060727697,1
2020-06-24-170512,170512,0,0,0,42,0.6,0.06328549,2
2020-06-25-170512,170512,0,0,0,42,0.2,0.06444283,3
2020-06-26-170512,170512,0,0,0,42,0.6,0.18421201,4
2020-06-27-170512,170512,0,0,0,42,0.2,0.042065345,5
2020-06-28-170512,170512,0,0,0,42,0.0,0.00014290561,6
2020-06-29-170512,170512,0,0,0,42,0.4,0.11710259,0
2020-06-30-170512,170512,0,0,0,42,0.4,0.3822759,1
2020-07-01-170512,170512,0,0,0,42,0.2,0.059325807,2
2020-07-02-170512,170512,0,0,0,42,0.2,0.08322056,3
2020-07-03-170512,170512,0,0,0,42,0.6,0.20000248,4
2020-07-04-170512,170512,0,0,0,42,0.0,0.0013536734,5
2020-07-05-170512,170512,0,0,1,42,0.2,0.0025924414,6
2020-07-06-170512,170512,0,0,0,42,0.2,0.12741336,0
2020-07-07-170512,170512,0,0,0,42,0.0,0.007666449,1
2020-07-08-170512,170512,0,0,0,42,0.2,0.044452127,2
2020-07-09-170512,170512,0,0,0,42,0.0,0.0027218338,3
2020-07-10-170512,170512,0,0,0,42,0.8,0.17493835,4
2020-07-11-170512,170512,0,0,0,42,0.2,0.033290014,5
2020-07-12-170512,170512,0,0,0,42,0.0,0.0009194656,6
2020-07-13-170512,170512,0,0,0,42,0.0,0.001778953,0
2020-07-14-170512,170512,0,0,0,42,0.8,0.14069304,1
2020-07-15-170512,170512,0,0,0,42,0.8,0.13852715,2
2020-07-16-170512,170512,0,0,0,42,0.8,0.1963546,3
2020-07-17-170512,170512,0,0,0,42,0.2,0.0143773835,4
2020-07-18-170512,170512,0,0,0,42,0.0,0.0013142236,5
2020-07-19-170512,170512,1,0,0,43,0.0,0.053650197,6
2020-07-20-170512,170512,0,0,0,43,0.2,0.08250952,0
2020-07-21-170512,170512,0,0,0,43,0.0,0.011977335,1
2020-07-22-170512,170512,0,0,0,43,0.4,0.058823783,2
2020-07-23-170512,170512,0,0,0,43,0.8,0.12775916,3
2020-07-24-170512,170512,0,0,1,43,0.4,0.095816515,4
2020-07-25-170512,170512,0,0,0,43,0.2,0.0014718752,5
2020-07-26-170512,170512,0,0,0,43,0.0,0.00020968258,6
2020-07-27-170512,170512,0,0,0,43,0.8,0.14687696,0
2020-07-28-170512,170512,0,0,0,43,0.8,0.26223952,1
2020-07-29-170512,170512,0,0,0,43,0.0,0.034267414,2
2020-07-30-170512,170512,0,0,1,43,0.6,0.094610594,3
2020-07-31-170512,170512,0,0,0,43,0.8,0.049684968,4
2020-08-01-170512,170512,0,0,0,43,0.2,0.039958913,5
2020-08-02-170512,170512,0,0,1,43,0.2,0.07557176,6
2020-08-03-170512,170512,0,0,1,43,0.2,0.03673465,0
2020-08-04-170512,170512,0,0,0,43,0.4,0.06909943,1
2020-08-05-170512,170512,0,0,1,43,0.8,0.3460309,2
2020-08-06-170512,170512,0,0,1,43,0.4,0.26207525,3
2020-08-07-170512,170512,1,0,4,44,0.8,0.16758426,4
2020-08-08-170512,170512,0,0,0,44,0.0,0.023853222,5
2020-08-09-170512,170512,0,0,2,44,0.0,0.030747851,6
2020-08-10-170512,170512,0,0,0,44,0.2,0.07219928,0
2020-08-11-170512,170512,0,0,0,44,0.6,0.10002335,1
2020-08-12-170512,170512,0,0,4,44,1.4,0.1990219,2
2020-08-13-170512,170512,1,0,0,45,1.0,0.083986826,3
2020-08-14-170512,170512,0,0,0,45,1.2,0.28607947,4
2020-08-15-170512,170512,0,0,0,45,0.2,0.06594783,5
2020-08-16-170512,170512,1,0,0,46,1.0,0.361113,6
2020-08-17-170512,170512,1,0,0,47,0.8,0.17633271,0
2020-08-18-170512,170512,0,0,0,47,1.0,0.1530282,1
2020-08-19-170512,170512,1,0,0,48,0.8,0.38152555,2
2020-08-20-170512,170512,1,0,0,49,1.2,0.24647851,3
2020-08-21-170512,170512,4,0,0,53,2.4,0.68291134,4
2020-08-22-170512,170512,0,0,1,53,2.0,0.19086653,5
2020-08-23-170512,170512,2,0,1,55,0.6,0.16424687,6
2020-08-24-170512,170512,0,0,0,55,1.4,0.40657932,0
2020-08-25-170512,170512,0,0,0,55,2.0,0.3092303,1
2020-08-26-170512,170512,4,0,2,59,1.0,0.39387965,2
2020-08-27-170512,170512,0,0,0,59,4.0,0.7608416,3
2020-08-28-170512,170512,0,0,0,59,1.2,0.1683945,4
2020-08-29-170512,170512,0,0,0,59,0.2,0.123858,5
2020-08-30-170512,170512,0,0,13,59,0.6,0.08813514,6
2020-08-31-170512,170512,0,0,5,59,0.6,0.12563483,0
2020-09-01-170512,170512,0,0,12,59,2.4,0.56756634,1
2020-09-02-170512,170512,0,0,0,59,0.0,0.08387501,2
2020-09-03-170512,170512,0,0,1,59,0.6,0.43324435,3
2020-09-04-170512,170512,0,0,3,59,2.2,0.4711881,4
2020-09-05-170512,170512,1,0,4,60,0.8,0.3953226,5
2020-09-06-170512,170512,1,0,0,61,1.0,0.18802895,6
2020-09-07-170512,170512,0,0,1,61,0.6,0.31060737,0
2020-09-08-170512,170512,0,0,1,61,1.2,0.25829017,1
2020-09-09-170512,170512,2,0,4,63,3.6,1.0645443,2
2020-09-10-170512,170512,0,0,2,63,2.0,0.3033735,3
2020-09-11-170512,170512,0,0,0,63,1.6,0.30392918,4
2020-09-12-170512,170512,0,0,0,63,0.6,0.1292814,5
2020-09-13-170512,170512,13,0,2,76,0.4,0.46781427,6
2020-09-14-170512,170512,5,0,0,81,1.4,0.33892184,0
2020-09-15-170512,170512,12,0,0,93,0.6,0.47207433,1
2020-09-16-170512,170512,0,0,1,93,1.0,0.22448182,2
2020-09-17-170512,170512,1,0,2,94,0.8,0.2181153,3
2020-09-18-170512,170512,3,0,7,97,0.8,0.36755386,4
2020-09-19-170512,170512,4,0,1,101,0.2,0.11733386,5
2020-09-20-170512,170512,0,0,1,101,0.8,0.17902157,6
2020-09-21-170512,170512,1,0,1,102,1.0,0.23937853,0
2020-09-22-170512,170512,1,0,0,103,0.8,0.14774293,1
2020-09-23-170512,170512,4,1,0,107,0.8,0.299099,2
2020-09-24-170512,170512,2,1,0,109,1.2,0.28026944,3
2020-09-25-170512,170512,0,2,0,109,1.4,0.34933364,4
2020-09-26-170512,170512,0,0,1,109,1.8,0.37119174,5
2020-09-27-170512,170512,2,0,1,111,1.0,0.21095568,6
2020-09-28-170512,170512,0,0,0,111,0.8,0.1488679,0
2020-09-29-170512,170512,0,0,2,111,0.0,0.1660598,1
2020-09-30-170512,170512,1,0,0,112,1.6,0.32912472,2
2020-10-01-170512,170512,2,0,0,114,1.4,0.4316068,3
2020-10-02-170512,170512,7,0,1,121,2.2,0.67413706,4
2020-10-03-170512,170512,1,0,0,122,0.8,0.13412794,5
2020-10-04-170512,170512,1,0,0,123,1.6,0.2724233,6
2020-10-05-170512,170512,1,0,7,124,0.6,0.376215,0
2020-10-06-170512,170512,0,0,0,124,2.0,0.34894383,1
2020-10-07-170512,170512,0,1,1,124,1.6,0.33379078,2
2020-10-08-170512,170512,0,0,5,124,2.0,0.45817456,3
2020-10-09-170512,170512,0,1,0,124,1.4,0.27169695,4
2020-10-10-170512,170512,1,0,1,125,2.6,0.516878,5
2020-10-11-170512,170512,1,0,1,126,0.0,0.068604596,6
2020-10-12-170512,170512,0,0,1,126,0.8,0.1275898,0
2020-10-13-170512,170512,2,0,1,128,1.4,0.29969013,1
2020-10-14-170512,170512,0,0,0,128,8.0,3.869756,2
2020-10-15-170512,170512,0,0,3,128,2.0,0.4150194,3
2020-10-16-170512,170512,1,0,0,129,1.8,0.6638387,4
2020-10-17-170512,170512,0,0,1,129,0.4,0.1857655,5
2020-10-18-170512,170512,0,0,2,129,0.4,0.23617691,6
2020-10-19-170512,170512,7,0,5,136,0.2,0.3518712,0
2020-10-20-170512,170512,0,0,0,136,2.6,0.6597322,1
2020-10-21-170512,170512,1,0,10,137,0.6,0.4255226,2
2020-10-22-170512,170512,5,0,0,142,0.6,0.4239724,3
2020-10-23-170512,170512,0,0,5,142,2.8,0.5199423,4
2020-10-24-170512,170512,1,1,0,143,1.4,0.37062854,5
2020-10-25-170512,170512,1,0,3,144,1.6,0.319645,6
2020-10-26-170512,170512,1,0,1,145,1.6,0.52212346,0
2020-10-27-170512,170512,1,0,7,146,1.0,0.30267274,1
2020-10-28-170512,170512,0,1,1,146,4.4,1.7195573,2
2020-10-29-170512,170512,3,0,6,149,1.6,0.4482698,3
2020-10-30-170512,170512,0,0,1,149,1.6,0.70368344,4
2020-10-31-170512,170512,1,0,0,150,1.0,0.2838578,5
2020-11-01-170512,170512,2,0,0,152,0.8,0.33924797,6
2020-11-02-170512,170512,5,0,0,157,1.2,0.3168659,0
2020-11-03-170512,170512,0,0,0,157,2.6,0.45736498,1
2020-11-04-170512,170512,10,0,0,167,2.8,1.3501308,2
2020-11-05-170512,170512,0,0,0,167,2.8,0.8399407,3
2020-11-06-170512,170512,5,0,0,172,1.2,0.25858706,4
2020-11-07-170512,170512,0,0,0,172,10.8,1.6483145,5
2020-11-08-170512,170512,3,0,0,175,1.6,0.39606905,6
2020-11-09-170512,170512,1,0,0,176,2.4,0.46643087,0
2020-11-10-170512,170512,7,0,0,183,1.2,0.48030925,1
2020-11-11-170512,170512,1,0,0,184,1.0,0.5293838,2
2020-11-12-170512,170512,6,1,0,190,1.6,0.61273503,3
2020-11-13-170512,170512,1,0,0,191,4.2,0.6411961,4
2020-03-01-170513,170513,0,0,0,0,0.0,0.0009329248,6
2020-03-02-170513,170513,0,0,17,0,0.0,0.00053040107,0
2020-03-03-170513,170513,0,2,7,0,0.0,0.0002326102,1
2020-03-04-170513,170513,1,0,16,1,0.0,0.0022888803,2
2020-03-05-170513,170513,0,0,19,1,0.0,0.00015284965,3
2020-03-06-170513,170513,0,0,28,1,0.0,0.005779208,4
2020-03-07-170513,170513,0,0,11,1,0.0,0.0032162617,5
2020-03-08-170513,170513,0,0,7,1,0.0,0.16362645,6
2020-03-09-170513,170513,2,0,38,3,0.5,0.07864558,0
2020-03-10-170513,170513,0,0,38,3,0.5,0.010495619,1
2020-03-11-170513,170513,1,0,25,4,0.75,0.015383725,2
2020-03-12-170513,170513,2,0,26,6,0.75,0.26052245,3
2020-03-13-170513,170513,3,0,23,9,0.5,0.22564098,4
2020-03-14-170513,170513,2,0,14,11,0.5,0.15856,5
2020-03-15-170513,170513,0,0,11,11,1.0,0.104390465,6
2020-03-16-170513,170513,17,0,24,28,3.25,0.50795513,0
2020-03-17-170513,170513,7,0,22,35,5.0,2.2232552,1
2020-03-18-170513,170513,16,0,15,51,9.75,2.1909611,2
2020-03-19-170513,170513,19,0,10,70,10.25,2.8275552,3
2020-03-20-170513,170513,28,0,14,98,8.25,2.4236863,4
2020-03-21-170513,170513,11,0,8,109,7.25,1.446546,5
2020-03-22-170513,170513,7,0,9,116,6.25,0.82548356,6
2020-03-23-170513,170513,38,0,19,154,14.0,5.4492946,0
2020-03-24-170513,170513,38,0,12,192,13.25,3.9971442,1
2020-03-25-170513,170513,25,0,16,217,15.0,3.557543,2
2020-03-26-170513,170513,26,0,14,243,15.5,4.159568,3
2020-03-27-170513,170513,23,0,10,266,12.0,6.4450593,4
2020-03-28-170513,170513,14,0,8,280,6.25,0.89888316,5
2020-03-29-170513,170513,11,0,4,291,4.0,0.18882972,6
2020-03-30-170513,170513,24,0,11,315,15.25,3.2135932,0
2020-03-31-170513,170513,22,1,9,337,9.25,1.7532107,1
2020-04-01-170513,170513,15,0,14,352,5.25,2.7959197,2
2020-04-02-170513,170513,10,0,22,362,8.75,2.6240978,3
2020-04-03-170513,170513,14,0,10,376,6.0,1.1883769,4
2020-04-04-170513,170513,8,0,3,384,1.75,0.17721577,5
2020-04-05-170513,170513,9,0,3,393,4.5,1.6541029,6
2020-04-06-170513,170513,19,0,11,412,7.75,2.284571,0
2020-04-07-170513,170513,12,0,6,424,5.0,2.5900578,1
2020-04-08-170513,170513,16,0,20,440,6.75,1.795185,2
2020-04-09-170513,170513,14,0,1,454,5.5,2.4303997,3
2020-04-10-170513,170513,10,0,7,464,7.25,1.2715918,4
2020-04-11-170513,170513,8,0,1,472,7.25,0.9041457,5
2020-04-12-170513,170513,4,0,4,476,0.75,0.02171615,6
2020-04-13-170513,170513,11,0,4,487,2.75,1.498397,0
2020-04-14-170513,170513,9,0,7,496,5.25,0.64027745,1
2020-04-15-170513,170513,14,0,3,510,4.0,0.8018354,2
2020-04-16-170513,170513,22,0,9,532,3.5,0.9280967,3
2020-04-17-170513,170513,10,0,11,542,4.0,1.105307,4
2020-04-18-170513,170513,3,0,1,545,1.0,0.0028068344,5
2020-04-19-170513,170513,3,0,2,548,1.5,0.02754534,6
2020-04-20-170513,170513,11,0,5,559,4.0,1.5001523,0
2020-04-21-170513,170513,6,0,9,565,6.0,0.9477592,1
2020-04-22-170513,170513,20,0,13,585,5.0,1.2166866,2
2020-04-23-170513,170513,1,0,5,586,2.5,0.058464378,3
2020-04-24-170513,170513,7,0,4,593,3.5,1.2797331,4
2020-04-25-170513,170513,1,0,2,594,1.25,0.046353076,5
2020-04-26-170513,170513,4,0,2,598,2.0,0.7116398,6
2020-04-27-170513,170513,4,2,10,602,4.75,0.69626105,0
2020-04-28-170513,170513,7,0,7,609,2.5,1.7925488,1
2020-04-29-170513,170513,3,0,11,612,2.75,1.4289185,2
2020-04-30-170513,170513,9,0,7,621,2.25,0.6450386,3
2020-05-01-170513,170513,11,0,2,632,1.25,0.39595413,4
2020-05-02-170513,170513,1,0,1,633,1.0,0.0582304,5
2020-05-03-170513,170513,2,0,1,635,0.25,0.01401454,6
2020-05-04-170513,170513,5,0,6,640,3.5,1.5838768,0
2020-05-05-170513,170513,9,0,4,649,2.5,0.8491789,1
2020-05-06-170513,170513,13,0,6,662,2.0,1.0011432,2
2020-05-07-170513,170513,5,0,6,667,2.75,2.1984582,3
2020-05-08-170513,170513,4,0,11,671,4.25,0.7462427,4
2020-05-09-170513,170513,2,0,2,673,1.75,0.023200177,5
2020-05-10-170513,170513,2,1,0,675,0.75,0.019605046,6
2020-05-11-170513,170513,10,2,2,685,3.25,1.1133221,0
2020-05-12-170513,170513,7,0,5,692,3.25,1.0738399,1
2020-05-13-170513,170513,11,0,6,703,3.0,0.910471,2
2020-05-14-170513,170513,7,2,1,710,3.0,0.23985931,3
2020-05-15-170513,170513,2,1,2,712,3.0,1.7024398,4
2020-05-16-170513,170513,1,0,0,713,0.25,0.06980109,5
2020-05-17-170513,170513,1,0,0,714,0.0,0.020493422,6
2020-05-18-170513,170513,6,0,2,720,3.25,0.2652131,0
2020-05-19-170513,170513,4,0,1,724,4.25,4.253446,1
2020-05-20-170513,170513,6,1,2,730,1.0,0.36214092,2
2020-05-21-170513,170513,6,0,0,736,2.0,0.38684177,3
2020-05-22-170513,170513,11,0,2,747,1.75,1.5915208,4
2020-05-23-170513,170513,2,0,0,749,0.75,0.008675499,5
2020-05-24-170513,170513,0,0,1,749,0.0,0.00015070506,6
2020-05-25-170513,170513,2,0,0,751,2.25,0.23257592,0
2020-05-26-170513,170513,5,0,1,756,3.0,1.024825,1
2020-05-27-170513,170513,6,0,4,762,3.75,0.37052864,2
2020-05-28-170513,170513,1,1,2,763,1.75,1.1299222,3
2020-05-29-170513,170513,2,1,3,765,2.0,1.4378293,4
2020-05-30-170513,170513,0,0,1,765,0.25,0.69737494,5
2020-05-31-170513,170513,0,0,0,765,0.75,0.11595872,6
2020-06-01-170513,170513,2,0,0,767,2.25,1.1066107,0
2020-06-02-170513,170513,1,0,4,768,1.5,0.20281652,1
2020-06-03-170513,170513,2,0,2,770,0.75,0.22318864,2
2020-06-04-170513,170513,0,0,1,770,2.0,0.3198484,3
2020-06-05-170513,170513,2,0,3,772,1.25,0.4145797,4
2020-06-06-170513,170513,0,1,1,772,0.25,0.13167393,5
2020-06-07-170513,170513,1,0,1,773,0.0,0.00045511656,6
2020-06-08-170513,170513,0,0,3,773,2.75,0.16435346,0
2020-06-09-170513,170513,1,0,2,774,0.75,0.21416509,1
2020-06-10-170513,170513,4,0,1,778,1.25,0.45669594,2
2020-06-11-170513,170513,2,0,2,780,1.25,0.41325212,3
2020-06-12-170513,170513,3,0,1,783,1.75,1.2229323,4
2020-06-13-170513,170513,1,0,2,784,0.75,0.18535379,5
2020-06-14-170513,170513,0,0,0,784,0.0,0.004699138,6
2020-06-15-170513,170513,0,0,0,784,1.25,0.39089355,0
2020-06-16-170513,170513,4,0,2,788,0.75,0.8908518,1
2020-06-17-170513,170513,2,0,1,790,1.5,0.1361628,2
2020-06-18-170513,170513,1,0,0,791,0.5,0.32868552,3
2020-06-19-170513,170513,3,0,0,794,2.25,1.902366,4
2020-06-20-170513,170513,1,0,0,795,0.5,0.09896918,5
2020-06-21-170513,170513,1,0,0,796,0.5,0.04370686,6
2020-06-22-170513,170513,3,0,1,799,0.5,0.024837244,0
2020-06-23-170513,170513,2,0,2,801,0.5,0.07134784,1
2020-06-24-170513,170513,1,0,1,802,0.75,0.28417823,2
2020-06-25-170513,170513,2,3,0,804,0.25,1.039363,3
2020-06-26-170513,170513,1,1,1,805,1.5,0.24427475,4
2020-06-27-170513,170513,2,0,0,807,0.25,0.105905145,5
2020-06-28-170513,170513,0,0,0,807,0.25,0.0032612318,6
2020-06-29-170513,170513,0,0,0,807,1.25,0.17825095,0
2020-06-30-170513,170513,2,0,0,809,0.25,0.40890846,1
2020-07-01-170513,170513,1,0,5,810,0.25,0.09305485,2
2020-07-02-170513,170513,0,0,1,810,0.75,0.23470782,3
2020-07-03-170513,170513,0,0,0,810,0.75,1.0723058,4
2020-07-04-170513,170513,0,0,1,810,0.75,0.011866356,5
2020-07-05-170513,170513,0,0,0,810,0.25,0.028455451,6
2020-07-06-170513,170513,1,0,0,811,0.0,0.34899434,0
2020-07-07-170513,170513,2,0,0,813,1.0,0.18704902,1
2020-07-08-170513,170513,1,0,0,814,0.75,0.07263532,2
2020-07-09-170513,170513,0,0,0,814,1.5,0.01667645,3
2020-07-10-170513,170513,1,0,2,815,1.5,1.8393003,4
2020-07-11-170513,170513,0,0,0,815,0.0,0.018302612,5
2020-07-12-170513,170513,0,0,0,815,0.25,0.020340394,6
2020-07-13-170513,170513,0,0,0,815,0.75,0.019193945,0
2020-07-14-170513,170513,0,0,0,815,2.0,0.17751849,1
2020-07-15-170513,170513,5,0,3,820,0.5,0.19416088,2
2020-07-16-170513,170513,1,0,0,821,0.75,0.24406844,3
2020-07-17-170513,170513,0,0,4,821,0.25,0.031369645,4
2020-07-18-170513,170513,1,0,0,822,0.25,0.006508926,5
2020-07-19-170513,170513,0,0,1,822,0.5,0.06372696,6
2020-07-20-170513,170513,0,0,0,822,0.0,0.05277969,0
2020-07-21-170513,170513,0,0,1,822,0.5,0.0769292,1
2020-07-22-170513,170513,0,0,2,822,0.5,1.0400664,2
2020-07-23-170513,170513,0,0,2,822,1.25,2.796664,3
2020-07-24-170513,170513,2,0,3,824,0.25,0.22260703,4
2020-07-25-170513,170513,0,0,0,824,0.0,0.023049615,5
2020-07-26-170513,170513,0,0,3,824,0.0,0.006602442,6
2020-07-27-170513,170513,0,0,3,824,0.0,0.49717274,0
2020-07-28-170513,170513,0,0,1,824,0.0,0.35361302,1
2020-07-29-170513,170513,3,0,4,827,0.5,0.14386606,2
2020-07-30-170513,170513,0,0,1,827,0.75,2.7523444,3
2020-07-31-170513,170513,4,1,6,831,0.0,0.16125076,4
2020-08-01-170513,170513,0,0,0,831,0.5,0.069215864,5
2020-08-02-170513,170513,1,0,0,832,0.0,0.09263878,6
2020-08-03-170513,170513,0,0,4,832,0.5,0.9656814,0
2020-08-04-170513,170513,1,0,6,833,0.75,1.8919584,1
2020-08-05-170513,170513,2,0,11,835,1.25,2.3091063,2
2020-08-06-170513,170513,2,0,1,837,1.0,1.4426489,3
2020-08-07-170513,170513,3,0,9,840,1.25,3.517293,4
2020-08-08-170513,170513,0,0,6,840,1.0,0.1909764,5
2020-08-09-170513,170513,3,0,0,843,1.25,0.18931484,6
2020-08-10-170513,170513,3,0,7,846,0.0,0.14597517,0
2020-08-11-170513,170513,1,0,0,847,1.25,1.0850427,1
2020-08-12-170513,170513,4,0,6,851,1.75,2.2525473,2
2020-08-13-170513,170513,1,0,7,852,2.75,0.31459737,3
2020-08-14-170513,170513,6,0,7,858,2.0,4.0020328,4
2020-08-15-170513,170513,0,0,9,858,2.0,0.23015802,5
2020-08-16-170513,170513,0,0,1,858,0.75,0.6984588,6
2020-08-17-170513,170513,4,0,5,862,2.5,1.1170648,0
2020-08-18-170513,170513,6,0,3,868,0.25,0.9318609,1
2020-08-19-170513,170513,11,0,3,879,2.0,7.360765,2
2020-08-20-170513,170513,1,0,13,880,1.75,1.0276663,3
2020-08-21-170513,170513,9,0,9,889,1.5,3.3723211,4
2020-08-22-170513,170513,6,0,10,895,3.25,1.5443772,5
2020-08-23-170513,170513,0,0,6,895,2.5,0.4633945,6
2020-08-24-170513,170513,7,0,15,902,2.75,1.5974647,0
2020-08-25-170513,170513,0,0,12,902,3.75,0.51664144,1
2020-08-26-170513,170513,6,0,7,908,2.75,1.7435524,2
2020-08-27-170513,170513,7,0,5,915,1.0,1.4030254,3
2020-08-28-170513,170513,7,0,12,922,3.0,0.74362385,4
2020-08-29-170513,170513,9,0,8,931,3.5,0.23543312,5
2020-08-30-170513,170513,1,0,3,932,1.0,1.0528468,6
2020-08-31-170513,170513,5,0,11,937,2.75,0.32670483,0
2020-09-01-170513,170513,3,1,9,940,3.25,5.591665,1
2020-09-02-170513,170513,3,0,9,943,4.5,0.26825774,2
2020-09-03-170513,170513,13,0,12,956,5.75,3.3794227,3
2020-09-04-170513,170513,9,0,16,965,4.0,2.6634467,4
2020-09-05-170513,170513,10,0,7,975,2.75,2.1121726,5
2020-09-06-170513,170513,6,0,18,981,6.25,1.1118294,6
2020-09-07-170513,170513,15,0,14,996,4.25,1.0922208,0
2020-09-08-170513,170513,12,0,10,1008,5.5,2.3698168,1
2020-09-09-170513,170513,7,0,11,1015,3.25,2.8525732,2
2020-09-10-170513,170513,5,0,15,1020,3.75,3.0191734,3
2020-09-11-170513,170513,12,0,10,1032,4.5,1.6335703,4
2020-09-12-170513,170513,8,0,5,1040,4.25,1.2512058,5
2020-09-13-170513,170513,3,0,9,1043,5.0,1.3473288,6
2020-09-14-170513,170513,11,1,7,1054,5.0,4.0598774,0
2020-09-15-170513,170513,9,0,2,1063,9.75,3.5724533,1
2020-09-16-170513,170513,9,0,8,1072,5.75,1.7211652,2
2020-09-17-170513,170513,12,0,11,1084,8.5,1.0221945,3
2020-09-18-170513,170513,16,0,19,1100,8.5,4.122841,4
2020-09-19-170513,170513,7,1,17,1107,3.5,0.9928062,5
2020-09-20-170513,170513,18,0,6,1125,7.25,1.8088684,6
2020-09-21-170513,170513,14,0,13,1139,6.5,2.8297029,0
2020-09-22-170513,170513,10,1,22,1149,5.0,2.0807,1
2020-09-23-170513,170513,11,1,14,1160,9.75,2.498333,2
2020-09-24-170513,170513,15,1,23,1175,4.5,3.4160686,3
2020-09-25-170513,170513,10,1,35,1185,5.5,1.6260165,4
2020-09-26-170513,170513,5,0,11,1190,6.75,4.5209265,5
2020-09-27-170513,170513,9,0,1,1199,7.5,3.1107743,6
2020-09-28-170513,170513,7,0,18,1206,7.75,3.5461583,0
2020-09-29-170513,170513,2,0,16,1208,5.5,0.45951092,1
2020-09-30-170513,170513,8,0,20,1216,7.0,3.6482463,2
2020-10-01-170513,170513,11,0,25,1227,5.0,2.8055482,3
2020-10-02-170513,170513,19,0,27,1246,7.75,4.5224824,4
2020-10-03-170513,170513,17,0,22,1263,7.25,2.278661,5
2020-10-04-170513,170513,6,2,6,1269,2.25,1.2255565,6
2020-10-05-170513,170513,13,1,11,1282,4.25,2.358667,0
2020-10-06-170513,170513,22,2,10,1304,3.75,2.3077164,1
2020-10-07-170513,170513,14,0,8,1318,3.75,2.4006386,2
2020-10-08-170513,170513,23,0,16,1341,3.25,4.144406,3
2020-10-09-170513,170513,35,0,24,1376,8.0,1.2665344,4
2020-10-10-170513,170513,11,0,13,1387,8.0,1.1765107,5
2020-10-11-170513,170513,1,0,9,1388,3.0,0.050456297,6
2020-10-12-170513,170513,18,0,7,1406,4.75,0.68867034,0
2020-10-13-170513,170513,16,0,26,1422,6.25,2.2702498,1
2020-10-14-170513,170513,20,0,12,1442,7.75,8.011957,2
2020-10-15-170513,170513,25,0,8,1467,9.75,3.672438,3
2020-10-16-170513,170513,27,0,19,1494,11.75,3.1785877,4
2020-10-17-170513,170513,22,0,6,1516,11.0,0.9286482,5
2020-10-18-170513,170513,6,0,4,1522,4.0,0.27559406,6
2020-10-19-170513,170513,11,0,19,1533,8.5,1.7675152,0
2020-10-20-170513,170513,10,1,6,1543,7.25,5.307569,1
2020-10-21-170513,170513,8,0,7,1551,3.5,0.7172793,2
2020-10-22-170513,170513,16,1,21,1567,6.75,2.993156,3
2020-10-23-170513,170513,24,0,19,1591,9.0,3.0683928,4
2020-10-24-170513,170513,13,0,11,1604,6.0,2.6863492,5
2020-10-25-170513,170513,9,0,8,1613,10.25,1.1186306,6
2020-10-26-170513,170513,7,0,13,1620,8.25,3.104259,0
2020-10-27-170513,170513,26,1,14,1646,7.25,2.5547383,1
2020-10-28-170513,170513,12,0,9,1658,8.0,7.6980753,2
2020-10-29-170513,170513,8,0,31,1666,13.5,3.4660282,3
2020-10-30-170513,170513,19,0,22,1685,10.75,6.4373283,4
2020-10-31-170513,170513,6,1,0,1691,11.25,1.9625875,5
2020-11-01-170513,170513,4,2,0,1695,4.25,0.848443,6
2020-11-02-170513,170513,19,1,0,1714,11.0,1.2870396,0
2020-11-03-170513,170513,6,1,0,1720,6.5,7.109725,1
2020-11-04-170513,170513,7,0,0,1727,7.5,8.12081,2
2020-11-05-170513,170513,21,1,0,1748,8.25,11.986641,3
2020-11-06-170513,170513,19,1,0,1767,14.0,2.8627105,4
2020-11-07-170513,170513,11,0,0,1778,20.5,33.695225,5
2020-11-08-170513,170513,8,0,0,1786,7.25,1.2064669,6
2020-11-09-170513,170513,13,1,0,1799,7.75,7.2047787,0
2020-11-10-170513,170513,14,1,0,1813,7.0,3.5544212,1
2020-11-11-170513,170513,9,0,0,1822,5.25,1.9719054,2
2020-11-12-170513,170513,31,2,0,1853,9.25,5.4924803,3
2020-11-13-170513,170513,22,1,0,1875,13.0,10.175964,4
2020-03-01-170514,170514,0,0,0,0,0.0,6.5276663e-07,6
2020-03-02-170514,170514,0,0,0,0,0.0,7.871712e-05,0
2020-03-03-170514,170514,0,0,0,0,0.0,7.056966e-05,1
2020-03-04-170514,170514,0,2,0,0,0.0,0.00035062182,2
2020-03-05-170514,170514,0,1,1,0,0.0,0.00088388263,3
2020-03-06-170514,170514,0,0,0,0,0.0,0.00060088193,4
2020-03-07-170514,170514,0,1,4,0,0.0,0.0001508974,5
2020-03-08-170514,170514,0,0,0,0,0.0,0.029827999,6
2020-03-09-170514,170514,0,0,3,0,0.16666666666666666,0.59483016,0
2020-03-10-170514,170514,0,0,3,0,0.0,0.00060884573,1
2020-03-11-170514,170514,0,0,0,0,0.0,0.0014514935,2
2020-03-12-170514,170514,0,0,1,0,0.5,0.22656307,3
2020-03-13-170514,170514,0,0,2,0,0.3333333333333333,0.23105906,4
2020-03-14-170514,170514,0,0,1,0,0.6666666666666666,0.2040855,5
2020-03-15-170514,170514,0,0,1,0,0.3333333333333333,0.07207602,6
2020-03-16-170514,170514,0,0,2,0,1.0,0.36476776,0
2020-03-17-170514,170514,0,0,3,0,0.8333333333333334,0.13470575,1
2020-03-18-170514,170514,0,0,1,0,0.8333333333333334,0.26460865,2
2020-03-19-170514,170514,1,0,0,1,1.5,0.7164405,3
2020-03-20-170514,170514,0,0,3,1,3.1666666666666665,0.64870554,4
2020-03-21-170514,170514,4,0,1,5,1.8333333333333333,1.093912,5
2020-03-22-170514,170514,0,0,4,5,0.8333333333333334,0.18567763,6
2020-03-23-170514,170514,3,0,2,8,4.166666666666667,1.5420371,0
2020-03-24-170514,170514,3,0,1,11,1.3333333333333333,1.351555,1
2020-03-25-170514,170514,0,0,0,11,1.6666666666666667,0.41878214,2
2020-03-26-170514,170514,1,0,1,12,1.6666666666666667,0.79546994,3
2020-03-27-170514,170514,2,0,23,14,3.1666666666666665,1.6957116,4
2020-03-28-170514,170514,1,0,0,15,0.8333333333333334,0.47412175,5
2020-03-29-170514,170514,1,0,0,16,0.5,0.3271554,6
2020-03-30-170514,170514,2,0,2,18,2.5,1.4260402,0
2020-03-31-170514,170514,3,0,1,21,1.0,0.75658906,1
2020-04-01-170514,170514,1,0,2,22,2.1666666666666665,1.0344203,2
2020-04-02-170514,170514,0,0,1,22,1.1666666666666667,0.3685076,3
2020-04-03-170514,170514,3,0,0,25,1.1666666666666667,0.86655617,4
2020-04-04-170514,170514,1,0,0,26,0.6666666666666666,0.46053374,5
2020-04-05-170514,170514,4,0,1,30,0.3333333333333333,0.56154406,6
2020-04-06-170514,170514,2,3,1,32,1.1666666666666667,0.8088448,0
2020-04-07-170514,170514,1,0,1,33,1.1666666666666667,0.42502522,1
2020-04-08-170514,170514,0,0,0,33,2.0,0.6954857,2
2020-04-09-170514,170514,1,0,0,34,2.0,1.1956412,3
2020-04-10-170514,170514,23,0,2,57,0.5,3.4817557,4
2020-04-11-170514,170514,0,1,4,57,1.0,0.21209082,5
2020-04-12-170514,170514,0,0,2,57,0.8333333333333334,0.24949726,6
2020-04-13-170514,170514,2,0,0,59,1.6666666666666667,1.2362072,0
2020-04-14-170514,170514,1,0,0,60,1.6666666666666667,0.6831745,1
2020-04-15-170514,170514,2,0,1,62,1.0,0.8241827,2
2020-04-16-170514,170514,1,0,0,63,1.3333333333333333,0.6545851,3
2020-04-17-170514,170514,0,0,0,63,3.0,1.983203,4
2020-04-18-170514,170514,0,0,0,63,0.16666666666666666,0.036230795,5
2020-04-19-170514,170514,1,0,0,64,0.5,0.26954532,6
2020-04-20-170514,170514,1,0,4,65,2.833333333333333,1.8140016,0
2020-04-21-170514,170514,1,0,0,66,0.3333333333333333,0.34072438,1
2020-04-22-170514,170514,0,0,0,66,0.6666666666666666,0.37409037,2
2020-04-23-170514,170514,0,0,0,66,0.8333333333333334,0.33520985,3
2020-04-24-170514,170514,2,0,2,68,0.8333333333333334,0.7227009,4
2020-04-25-170514,170514,4,0,0,72,0.6666666666666666,0.8479656,5
2020-04-26-170514,170514,2,0,1,74,0.3333333333333333,0.38040745,6
2020-04-27-170514,170514,0,0,1,74,0.0,0.17164427,0
2020-04-28-170514,170514,0,1,1,74,1.8333333333333333,0.28362077,1
2020-04-29-170514,170514,1,2,0,75,1.1666666666666667,0.6577824,2
2020-04-30-170514,170514,0,0,0,75,0.8333333333333334,0.38768038,3
2020-05-01-170514,170514,0,0,0,75,0.6666666666666666,0.118649416,4
2020-05-02-170514,170514,0,0,0,75,0.6666666666666666,0.332438,5
2020-05-03-170514,170514,0,0,0,75,0.16666666666666666,0.00042656218,6
2020-05-04-170514,170514,4,0,0,79,1.6666666666666667,1.0611148,0
2020-05-05-170514,170514,0,0,0,79,0.16666666666666666,0.016995791,1
2020-05-06-170514,170514,0,0,0,79,0.8333333333333334,0.268335,2
2020-05-07-170514,170514,0,0,2,79,1.3333333333333333,0.50722116,3
2020-05-08-170514,170514,2,0,0,81,1.3333333333333333,0.888216,4
2020-05-09-170514,170514,0,1,0,81,0.16666666666666666,0.008605502,5
2020-05-10-170514,170514,1,1,0,82,0.16666666666666666,0.20689783,6
2020-05-11-170514,170514,1,0,0,83,0.5,0.39460024,0
2020-05-12-170514,170514,1,0,1,84,0.8333333333333334,0.46559966,1
2020-05-13-170514,170514,0,0,0,84,1.0,0.3042279,2
2020-05-14-170514,170514,0,2,0,84,0.16666666666666666,0.06994587,3
2020-05-15-170514,170514,0,0,2,84,0.6666666666666666,0.50411826,4
2020-05-16-170514,170514,0,0,0,84,0.0,0.0038188247,5
2020-05-17-170514,170514,0,0,0,84,0.16666666666666666,0.056746442,6
2020-05-18-170514,170514,0,0,1,84,0.8333333333333334,0.16725479,0
2020-05-19-170514,170514,0,0,2,84,0.3333333333333333,0.34155962,1
2020-05-20-170514,170514,0,0,1,84,1.3333333333333333,0.571321,2
2020-05-21-170514,170514,2,0,2,86,0.8333333333333334,0.9951509,3
2020-05-22-170514,170514,0,0,0,86,1.0,0.39302278,4
2020-05-23-170514,170514,0,0,0,86,0.16666666666666666,0.060625784,5
2020-05-24-170514,170514,0,0,0,86,0.0,1.0552301e-07,6
2020-05-25-170514,170514,0,0,0,86,0.3333333333333333,0.08763763,0
2020-05-26-170514,170514,1,0,1,87,0.8333333333333334,0.5606901,1
2020-05-27-170514,170514,0,0,13,87,0.6666666666666666,0.49930784,2
2020-05-28-170514,170514,0,1,3,87,0.3333333333333333,0.16238318,3
2020-05-29-170514,170514,2,0,0,89,1.0,0.9389413,4
2020-05-30-170514,170514,0,0,0,89,0.0,0.04624084,5
2020-05-31-170514,170514,0,0,0,89,0.0,0.17745274,6
2020-06-01-170514,170514,1,0,1,90,1.0,0.7206721,0
2020-06-02-170514,170514,2,0,0,92,0.5,0.675347,1
2020-06-03-170514,170514,1,0,0,93,0.6666666666666666,0.57382065,2
2020-06-04-170514,170514,2,0,1,95,0.3333333333333333,0.7223223,3
2020-06-05-170514,170514,0,2,0,95,1.5,0.9141378,4
2020-06-06-170514,170514,0,0,1,95,0.3333333333333333,0.09117145,5
2020-06-07-170514,170514,0,0,0,95,0.0,9.4373245e-06,6
2020-06-08-170514,170514,0,0,0,95,0.8333333333333334,0.3623306,0
2020-06-09-170514,170514,1,0,2,96,0.5,0.4192005,1
2020-06-10-170514,170514,13,0,0,109,1.3333333333333333,3.4655194,2
2020-06-11-170514,170514,3,0,1,112,0.8333333333333334,1.2882963,3
2020-06-12-170514,170514,0,0,1,112,0.6666666666666666,0.3053766,4
2020-06-13-170514,170514,0,0,0,112,0.3333333333333333,0.07572493,5
2020-06-14-170514,170514,0,0,0,112,0.0,0.0028734447,6
2020-06-15-170514,170514,1,0,0,113,1.0,0.67960936,0
2020-06-16-170514,170514,0,0,1,113,0.3333333333333333,0.06925871,1
2020-06-17-170514,170514,0,0,1,113,0.3333333333333333,0.17533648,2
2020-06-18-170514,170514,1,0,2,114,0.8333333333333334,0.5917675,3
2020-06-19-170514,170514,0,0,0,114,0.3333333333333333,0.19324262,4
2020-06-20-170514,170514,1,0,0,115,0.5,0.41251644,5
2020-06-21-170514,170514,0,0,0,115,0.0,0.0728889,6
2020-06-22-170514,170514,0,0,5,115,0.16666666666666666,0.073020265,0
2020-06-23-170514,170514,2,0,0,117,0.3333333333333333,0.5500502,1
2020-06-24-170514,170514,0,0,0,117,0.5,0.24629222,2
2020-06-25-170514,170514,1,0,0,118,0.5,0.38531563,3
2020-06-26-170514,170514,1,0,0,119,0.5,0.5067648,4
2020-06-27-170514,170514,0,1,1,119,0.3333333333333333,0.23499997,5
2020-06-28-170514,170514,0,0,0,119,0.0,0.0004410953,6
2020-06-29-170514,170514,0,0,0,119,0.5,0.20612164,0
2020-06-30-170514,170514,1,0,0,120,1.0,0.54102147,1
2020-07-01-170514,170514,1,0,3,121,0.3333333333333333,0.47662303,2
2020-07-02-170514,170514,2,0,2,123,0.8333333333333334,0.80149037,3
2020-07-03-170514,170514,0,0,0,123,0.5,0.3886475,4
2020-07-04-170514,170514,0,0,0,123,0.16666666666666666,0.03636413,5
2020-07-05-170514,170514,0,0,0,123,0.3333333333333333,0.05653059,6
2020-07-06-170514,170514,5,0,0,128,0.6666666666666666,1.7285701,0
2020-07-07-170514,170514,0,0,0,128,0.3333333333333333,0.056458235,1
2020-07-08-170514,170514,0,0,0,128,0.5,0.23166542,2
2020-07-09-170514,170514,0,0,0,128,0.0,0.007597925,3
2020-07-10-170514,170514,0,0,0,128,0.8333333333333334,0.3037236,4
2020-07-11-170514,170514,1,0,0,129,0.16666666666666666,0.33859068,5
2020-07-12-170514,170514,0,0,0,129,0.0,0.013686158,6
2020-07-13-170514,170514,0,0,0,129,0.16666666666666666,0.045236807,0
2020-07-14-170514,170514,0,0,0,129,0.3333333333333333,0.51715016,1
2020-07-15-170514,170514,3,0,0,132,0.6666666666666666,0.50937986,2
2020-07-16-170514,170514,2,0,1,134,1.1666666666666667,1.0591254,3
2020-07-17-170514,170514,0,0,0,134,0.16666666666666666,0.10594172,4
2020-07-18-170514,170514,0,0,0,134,0.16666666666666666,0.04347988,5
2020-07-19-170514,170514,0,0,0,134,0.0,0.08098168,6
2020-07-20-170514,170514,0,0,0,134,0.16666666666666666,0.061965715,0
2020-07-21-170514,170514,0,0,0,134,0.3333333333333333,0.075301774,1
2020-07-22-170514,170514,0,0,0,134,0.0,0.057687737,2
2020-07-23-170514,170514,0,0,1,134,0.0,0.15831605,3
2020-07-24-170514,170514,0,0,0,134,0.3333333333333333,0.46706107,4
2020-07-25-170514,170514,0,0,0,134,0.6666666666666666,0.12388412,5
2020-07-26-170514,170514,0,0,1,134,0.0,0.0026219634,6
2020-07-27-170514,170514,0,0,2,134,1.0,0.45159853,0
2020-07-28-170514,170514,0,0,1,134,0.8333333333333334,0.27188304,1
2020-07-29-170514,170514,0,0,4,134,0.8333333333333334,0.22628075,2
2020-07-30-170514,170514,1,0,2,135,0.0,0.05652299,3
2020-07-31-170514,170514,0,0,0,135,0.8333333333333334,0.19133748,4
2020-08-01-170514,170514,0,0,0,135,0.3333333333333333,0.21111332,5
2020-08-02-170514,170514,0,0,1,135,0.16666666666666666,0.06399197,6
2020-08-03-170514,170514,0,0,0,135,0.16666666666666666,0.06690162,0
2020-08-04-170514,170514,0,0,1,135,0.3333333333333333,0.14541587,1
2020-08-05-170514,170514,0,0,1,135,0.8333333333333334,0.5305398,2
2020-08-06-170514,170514,1,0,0,136,0.16666666666666666,0.59673065,3
2020-08-07-170514,170514,0,0,4,136,0.3333333333333333,0.13624871,4
2020-08-08-170514,170514,0,0,0,136,0.16666666666666666,0.11008187,5
2020-08-09-170514,170514,1,0,2,137,0.0,0.31109044,6
2020-08-10-170514,170514,2,1,5,139,1.1666666666666667,0.7331405,0
2020-08-11-170514,170514,1,0,2,140,1.1666666666666667,0.72844535,1
2020-08-12-170514,170514,4,0,1,144,3.333333333333333,2.389553,2
2020-08-13-170514,170514,2,0,6,146,1.1666666666666667,1.0088446,3
2020-08-14-170514,170514,0,0,0,146,0.8333333333333334,0.33189645,4
2020-08-15-170514,170514,0,0,0,146,0.3333333333333333,0.19166847,5
2020-08-16-170514,170514,1,0,0,147,0.3333333333333333,0.6801519,6
2020-08-17-170514,170514,0,0,1,147,0.8333333333333334,0.4488722,0
2020-08-18-170514,170514,1,0,0,148,1.5,1.1175873,1
2020-08-19-170514,170514,1,0,1,149,1.3333333333333333,0.8757584,2
2020-08-20-170514,170514,0,0,4,149,1.0,0.63739485,3
2020-08-21-170514,170514,4,0,2,153,4.666666666666667,3.102914,4
2020-08-22-170514,170514,0,0,0,153,0.6666666666666666,0.5648209,5
2020-08-23-170514,170514,2,0,1,155,2.333333333333333,1.256851,6
2020-08-24-170514,170514,5,0,2,160,2.1666666666666665,2.0728333,0
2020-08-25-170514,170514,2,0,7,162,4.166666666666667,2.1334696,1
2020-08-26-170514,170514,1,0,1,163,3.0,1.9372315,2
2020-08-27-170514,170514,6,0,4,169,4.666666666666667,4.792879,3
2020-08-28-170514,170514,0,0,0,169,1.6666666666666667,0.6110182,4
2020-08-29-170514,170514,0,0,1,169,1.0,0.39176983,5
2020-08-30-170514,170514,0,0,0,169,1.3333333333333333,0.33869767,6
2020-08-31-170514,170514,1,0,0,170,1.6666666666666667,0.81477803,0
2020-09-01-170514,170514,0,0,3,170,0.8333333333333334,0.5428444,1
2020-09-02-170514,170514,1,0,2,171,0.6666666666666666,0.61943966,2
2020-09-03-170514,170514,4,0,0,175,0.6666666666666666,0.5713281,3
2020-09-04-170514,170514,2,0,4,177,1.1666666666666667,1.9127716,4
2020-09-05-170514,170514,0,0,0,177,0.3333333333333333,0.43438664,5
2020-09-06-170514,170514,1,0,4,178,0.6666666666666666,0.5848978,6
2020-09-07-170514,170514,2,0,0,180,0.5,0.76539767,0
2020-09-08-170514,170514,7,0,0,187,1.8333333333333333,1.9288769,1
2020-09-09-170514,170514,1,0,1,188,2.0,1.1667123,2
2020-09-10-170514,170514,4,0,2,192,1.5,1.9927192,3
2020-09-11-170514,170514,0,0,0,192,1.0,1.2583481,4
2020-09-12-170514,170514,1,0,4,193,0.5,0.35625502,5
2020-09-13-170514,170514,0,0,0,193,0.6666666666666666,0.4459907,6
2020-09-14-170514,170514,0,0,0,193,0.5,0.68902445,0
2020-09-15-170514,170514,3,0,5,196,0.6666666666666666,1.3166732,1
2020-09-16-170514,170514,2,0,1,198,1.0,1.3455191,2
2020-09-17-170514,170514,0,0,5,198,1.0,0.81023955,3
2020-09-18-170514,170514,4,0,2,202,1.1666666666666667,1.8112513,4
2020-09-19-170514,170514,0,0,0,202,0.3333333333333333,0.1291783,5
2020-09-20-170514,170514,4,0,1,206,0.6666666666666666,1.5000393,6
2020-09-21-170514,170514,0,0,7,206,1.0,0.49276832,0
2020-09-22-170514,170514,0,1,1,206,1.6666666666666667,0.1617555,1
2020-09-23-170514,170514,1,0,1,207,1.3333333333333333,0.87877846,2
2020-09-24-170514,170514,2,1,3,209,1.0,1.1915087,3
2020-09-25-170514,170514,0,1,0,209,1.3333333333333333,0.5060762,4
2020-09-26-170514,170514,4,0,3,213,2.333333333333333,2.1167936,5
2020-09-27-170514,170514,0,1,0,213,1.0,0.31309405,6
2020-09-28-170514,170514,0,0,0,213,1.1666666666666667,0.44691673,0
2020-09-29-170514,170514,5,0,0,218,2.0,2.0937061,1
2020-09-30-170514,170514,1,0,0,219,1.8333333333333333,0.97673786,2
2020-10-01-170514,170514,5,0,3,224,2.1666666666666665,2.193918,3
2020-10-02-170514,170514,2,0,2,226,2.1666666666666665,1.3214667,4
2020-10-03-170514,170514,0,1,3,226,1.3333333333333333,0.41492793,5
2020-10-04-170514,170514,1,0,1,227,2.5,1.2365218,6
2020-10-05-170514,170514,7,0,2,234,2.1666666666666665,2.5271256,0
2020-10-06-170514,170514,1,0,3,235,2.1666666666666665,1.693476,1
2020-10-07-170514,170514,1,0,3,236,2.0,1.3111197,2
2020-10-08-170514,170514,3,2,3,239,2.6666666666666665,1.8305602,3
2020-10-09-170514,170514,0,0,2,239,1.1666666666666667,0.46242216,4
2020-10-10-170514,170514,3,0,0,242,2.333333333333333,1.8885218,5
2020-10-11-170514,170514,0,0,0,242,0.8333333333333334,0.3708951,6
2020-10-12-170514,170514,0,0,1,242,2.833333333333333,0.65119934,0
2020-10-13-170514,170514,0,0,1,242,2.333333333333333,0.8979068,1
2020-10-14-170514,170514,0,0,3,242,3.0,1.0780215,2
2020-10-15-170514,170514,3,0,0,245,2.1666666666666665,1.6159438,3
2020-10-16-170514,170514,2,0,0,247,1.1666666666666667,2.9766243,4
2020-10-17-170514,170514,3,0,0,250,3.333333333333333,1.471029,5
2020-10-18-170514,170514,1,0,0,251,2.1666666666666665,0.8047281,6
2020-10-19-170514,170514,2,0,0,253,3.1666666666666665,1.3511065,0
2020-10-20-170514,170514,3,1,0,256,8.333333333333334,2.4342868,1
2020-10-21-170514,170514,3,0,3,259,2.333333333333333,1.7983377,2
2020-10-22-170514,170514,3,1,8,262,4.5,1.3919026,3
2020-10-23-170514,170514,2,0,1,264,5.333333333333333,1.2539434,4
2020-10-24-170514,170514,0,0,1,264,4.666666666666667,0.94020945,5
2020-10-25-170514,170514,0,1,2,264,3.0,1.2017541,6
2020-10-26-170514,170514,1,0,1,265,2.6666666666666665,1.0964819,0
2020-10-27-170514,170514,1,1,7,266,2.6666666666666665,1.1892214,1
2020-10-28-170514,170514,3,0,2,269,7.833333333333332,2.92864,2
2020-10-29-170514,170514,0,0,7,269,5.333333333333333,1.5514361,3
2020-10-30-170514,170514,0,0,2,269,4.333333333333333,1.8666618,4
2020-10-31-170514,170514,0,0,0,269,2.333333333333333,0.78295225,5
2020-11-01-170514,170514,0,0,0,269,3.8333333333333335,0.86775905,6
2020-11-02-170514,170514,0,1,0,269,2.6666666666666665,0.7431873,0
2020-11-03-170514,170514,0,1,0,269,6.166666666666668,2.1327314,1
2020-11-04-170514,170514,3,0,0,272,3.6666666666666665,2.1926491,2
2020-11-05-170514,170514,8,0,0,280,3.333333333333333,3.0022388,3
2020-11-06-170514,170514,1,0,0,281,1.8333333333333333,0.82751286,4
2020-11-07-170514,170514,1,0,0,282,2.833333333333333,1.2837703,5
2020-11-08-170514,170514,2,0,0,284,2.5,0.9220453,6
2020-11-09-170514,170514,1,0,0,285,2.5,1.0516005,0
2020-11-10-170514,170514,7,0,0,292,1.8333333333333333,2.543404,1
2020-11-11-170514,170514,2,0,0,294,2.333333333333333,1.0606347,2
2020-11-12-170514,170514,7,0,0,301,4.5,3.246479,3
2020-11-13-170514,170514,2,0,0,303,2.1666666666666665,1.8804139,4
2020-03-01-170515,170515,0,0,2,0,0.0,0.00043557578,6
2020-03-02-170515,170515,0,0,7,0,0.0,0.00024396801,0
2020-03-03-170515,170515,0,1,6,0,0.0,3.821362e-07,1
2020-03-04-170515,170515,0,0,12,0,0.25,0.00046670262,2
2020-03-05-170515,170515,0,0,16,0,0.0,3.558388e-05,3
2020-03-06-170515,170515,0,0,19,0,0.0,0.0016933789,4
2020-03-07-170515,170515,0,0,10,0,0.0,0.0008872902,5
2020-03-08-170515,170515,0,0,10,0,0.0,0.054272935,6
2020-03-09-170515,170515,1,1,26,1,1.0,0.024753332,0
2020-03-10-170515,170515,1,0,20,2,0.25,0.004801111,1
2020-03-11-170515,170515,2,0,20,4,0.5,0.0054755593,2
2020-03-12-170515,170515,0,0,23,4,1.5,0.06923975,3
2020-03-13-170515,170515,1,0,18,5,1.25,0.06775963,4
2020-03-14-170515,170515,1,0,7,6,1.0,0.037706994,5
2020-03-15-170515,170515,2,0,7,8,1.5,0.030868415,6
2020-03-16-170515,170515,7,0,23,15,6.0,0.16081892,0
2020-03-17-170515,170515,6,0,13,21,8.0,0.7400229,1
2020-03-18-170515,170515,12,0,3,33,13.0,0.7287713,2
2020-03-19-170515,170515,16,0,14,49,15.25,0.9681838,3
2020-03-20-170515,170515,19,0,8,68,12.5,0.8580819,4
2020-03-21-170515,170515,10,0,3,78,8.5,0.51671445,5
2020-03-22-170515,170515,10,0,2,88,7.25,0.3110869,6
2020-03-23-170515,170515,26,0,13,114,22.75,1.8576381,0
2020-03-24-170515,170515,20,0,8,134,21.75,1.4737246,1
2020-03-25-170515,170515,20,0,6,154,20.25,1.2391906,2
2020-03-26-170515,170515,23,0,6,177,20.5,1.5350459,3
2020-03-27-170515,170515,18,0,8,195,16.75,2.3427157,4
2020-03-28-170515,170515,7,0,20,202,9.5,0.35184202,5
2020-03-29-170515,170515,7,0,2,209,6.5,0.07371166,6
2020-03-30-170515,170515,23,0,2,232,17.0,1.1691141,0
2020-03-31-170515,170515,13,0,11,245,14.25,0.62918663,1
2020-04-01-170515,170515,3,0,4,248,11.0,1.0330287,2
2020-04-02-170515,170515,14,0,5,262,10.75,0.9750323,3
2020-04-03-170515,170515,8,0,8,270,14.75,0.42642272,4
2020-04-04-170515,170515,3,0,3,273,3.5,0.057971615,5
2020-04-05-170515,170515,2,0,5,275,7.25,0.71624154,6
2020-04-06-170515,170515,13,0,5,288,12.75,0.8543796,0
2020-04-07-170515,170515,8,5,9,296,8.75,0.88722086,1
2020-04-08-170515,170515,6,0,9,302,17.0,0.6913209,2
2020-04-09-170515,170515,6,1,8,308,10.75,0.9968501,3
2020-04-10-170515,170515,8,0,3,316,10.0,0.5646321,4
2020-04-11-170515,170515,20,0,3,336,3.75,0.32463184,5
2020-04-12-170515,170515,2,0,2,338,2.0,0.01173444,6
2020-04-13-170515,170515,2,0,9,340,7.75,0.5470193,0
2020-04-14-170515,170515,11,0,6,351,12.0,0.23702958,1
2020-04-15-170515,170515,4,0,2,355,13.25,0.28618824,2
2020-04-16-170515,170515,5,0,3,360,9.25,0.3083713,3
2020-04-17-170515,170515,8,0,1,368,5.75,0.35320267,4
2020-04-18-170515,170515,3,1,4,371,4.0,0.0007916689,5
2020-04-19-170515,170515,5,0,0,376,1.0,0.008394992,6
2020-04-20-170515,170515,5,0,8,381,7.5,0.548482,0
2020-04-21-170515,170515,9,0,5,390,8.75,0.33976322,1
2020-04-22-170515,170515,9,0,4,399,8.0,0.42167297,2
2020-04-23-170515,170515,8,0,3,407,1.25,0.018952006,3
2020-04-24-170515,170515,3,0,11,410,8.5,0.46854925,4
2020-04-25-170515,170515,3,0,2,413,1.5,0.012834188,5
2020-04-26-170515,170515,2,0,2,415,2.0,0.31599107,6
2020-04-27-170515,170515,9,0,2,424,3.25,0.24648617,0
2020-04-28-170515,170515,6,0,7,430,5.25,0.65948844,1
2020-04-29-170515,170515,2,0,2,432,4.0,0.50242645,2
2020-04-30-170515,170515,3,0,5,435,5.5,0.22265661,3
2020-05-01-170515,170515,1,0,4,436,3.75,0.15800641,4
2020-05-02-170515,170515,4,0,1,440,0.75,0.021448227,5
2020-05-03-170515,170515,0,0,0,440,1.5,0.0034871704,6
2020-05-04-170515,170515,8,0,6,448,4.0,0.5594984,0
2020-05-05-170515,170515,5,0,5,453,4.0,0.27791166,1
2020-05-06-170515,170515,4,0,2,457,5.75,0.3402072,2
2020-05-07-170515,170515,3,0,2,460,5.0,0.7884663,3
2020-05-08-170515,170515,11,0,1,471,4.75,0.26267108,4
2020-05-09-170515,170515,2,0,0,473,1.75,0.0053915377,5
2020-05-10-170515,170515,2,0,0,475,1.0,0.0067806705,6
2020-05-11-170515,170515,2,0,5,477,6.25,0.3528547,0
2020-05-12-170515,170515,7,0,4,484,4.25,0.3522492,1
2020-05-13-170515,170515,2,0,8,486,6.25,0.3101484,2
2020-05-14-170515,170515,5,1,3,491,4.5,0.06984375,3
2020-05-15-170515,170515,4,0,3,495,2.0,0.5667464,4
2020-05-16-170515,170515,1,0,0,496,0.25,0.01801093,5
2020-05-17-170515,170515,0,0,2,496,0.75,0.0050240927,6
2020-05-18-170515,170515,6,0,2,502,5.25,0.07061745,0
2020-05-19-170515,170515,5,0,3,507,5.5,1.4818175,1
2020-05-20-170515,170515,2,0,1,509,2.75,0.109876215,2
2020-05-21-170515,170515,2,0,3,511,3.75,0.114226535,3
2020-05-22-170515,170515,1,0,3,512,5.5,0.53101885,4
2020-05-23-170515,170515,0,0,1,512,1.25,0.0036854688,5
2020-05-24-170515,170515,0,0,0,512,0.0,2.8149865e-05,6
2020-05-25-170515,170515,5,0,10,517,2.0,0.059022553,0
2020-05-26-170515,170515,4,0,2,521,3.75,0.32847798,1
2020-05-27-170515,170515,8,1,0,529,4.5,0.121276125,2
2020-05-28-170515,170515,3,1,3,532,2.5,0.37715393,3
2020-05-29-170515,170515,3,0,5,535,2.25,0.5043284,4
2020-05-30-170515,170515,0,0,2,535,0.75,0.23994672,5
2020-05-31-170515,170515,2,0,0,537,0.5,0.045214318,6
2020-06-01-170515,170515,2,1,3,539,3.5,0.37394136,0
2020-06-02-170515,170515,3,0,1,542,1.75,0.0669438,1
2020-06-03-170515,170515,1,0,3,543,2.25,0.08575695,2
2020-06-04-170515,170515,3,0,1,546,2.25,0.12560672,3
2020-06-05-170515,170515,3,0,2,549,1.0,0.120108284,4
2020-06-06-170515,170515,1,0,0,550,0.25,0.04671135,5
2020-06-07-170515,170515,0,0,2,550,0.5,8.893731e-06,6
2020-06-08-170515,170515,10,0,1,560,1.75,0.054327276,0
2020-06-09-170515,170515,2,0,1,562,0.75,0.07220591,1
2020-06-10-170515,170515,0,0,0,562,2.75,0.13019794,2
2020-06-11-170515,170515,3,0,0,565,1.5,0.16042899,3
2020-06-12-170515,170515,5,0,0,570,1.5,0.38865218,4
2020-06-13-170515,170515,2,0,1,572,1.0,0.0643934,5
2020-06-14-170515,170515,0,1,0,572,0.0,0.0015365428,6
2020-06-15-170515,170515,3,0,4,575,0.75,0.1265607,0
2020-06-16-170515,170515,1,0,0,576,1.5,0.28756478,1
2020-06-17-170515,170515,3,0,0,579,1.25,0.038170718,2
2020-06-18-170515,170515,1,0,2,580,1.0,0.094146766,3
2020-06-19-170515,170515,2,0,1,582,2.0,0.60797995,4
2020-06-20-170515,170515,0,0,1,582,1.0,0.02972534,5
2020-06-21-170515,170515,2,0,0,584,0.25,0.015367344,6
2020-06-22-170515,170515,1,0,0,585,1.5,0.008629504,0
2020-06-23-170515,170515,1,0,1,586,1.0,0.023766797,1
2020-06-24-170515,170515,0,0,2,586,0.75,0.106462374,2
2020-06-25-170515,170515,0,0,2,586,1.0,0.33657634,3
2020-06-26-170515,170515,0,1,1,586,1.25,0.0705776,4
2020-06-27-170515,170515,1,0,0,587,0.5,0.030692125,5
2020-06-28-170515,170515,0,0,1,587,0.0,0.00121167,6
2020-06-29-170515,170515,4,0,1,591,0.5,0.051673766,0
2020-06-30-170515,170515,0,0,5,591,0.75,0.12096299,1
2020-07-01-170515,170515,0,0,1,591,0.75,0.02905064,2
2020-07-02-170515,170515,2,0,2,593,0.75,0.06283656,3
2020-07-03-170515,170515,1,0,0,594,0.25,0.34083438,4
2020-07-04-170515,170515,1,0,1,595,1.0,0.004809204,5
2020-07-05-170515,170515,0,0,1,595,0.0,0.008099173,6
2020-07-06-170515,170515,0,0,0,595,0.25,0.09531322,0
2020-07-07-170515,170515,1,0,0,596,1.25,0.044069156,1
2020-07-08-170515,170515,2,0,1,598,0.5,0.025430273,2
2020-07-09-170515,170515,2,0,1,600,1.25,0.0052773054,3
2020-07-10-170515,170515,1,0,0,601,1.25,0.606031,4
2020-07-11-170515,170515,0,0,0,601,0.0,0.004404497,5
2020-07-12-170515,170515,1,0,0,602,0.25,0.003783511,6
2020-07-13-170515,170515,1,0,0,603,0.5,0.0045111123,0
2020-07-14-170515,170515,5,0,0,608,0.75,0.06197749,1
2020-07-15-170515,170515,1,0,1,609,1.5,0.065389894,2
2020-07-16-170515,170515,2,0,0,611,1.0,0.08220695,3
2020-07-17-170515,170515,0,0,0,611,0.5,0.011067392,4
2020-07-18-170515,170515,1,0,0,612,0.5,0.002526996,5
2020-07-19-170515,170515,1,0,0,613,0.25,0.02149807,6
2020-07-20-170515,170515,0,0,1,613,0.25,0.018978162,0
2020-07-21-170515,170515,0,0,0,613,0.5,0.025444014,1
2020-07-22-170515,170515,1,0,0,614,1.0,0.33060837,2
2020-07-23-170515,170515,1,0,0,615,1.0,0.9370022,3
2020-07-24-170515,170515,0,0,0,615,0.75,0.07118027,4
2020-07-25-170515,170515,0,0,2,615,0.0,0.0076147714,5
2020-07-26-170515,170515,0,0,2,615,0.0,0.0020976043,6
2020-07-27-170515,170515,0,0,0,615,0.0,0.160847,0
2020-07-28-170515,170515,0,0,3,615,0.0,0.11310681,1
2020-07-29-170515,170515,1,0,3,616,1.0,0.03817372,2
2020-07-30-170515,170515,0,0,3,616,0.75,0.88188773,3
2020-07-31-170515,170515,0,0,2,616,1.75,0.04430687,4
2020-08-01-170515,170515,0,0,3,616,0.75,0.01846247,5
2020-08-02-170515,170515,0,0,2,616,0.5,0.024011947,6
2020-08-03-170515,170515,1,0,5,617,0.75,0.29623526,0
2020-08-04-170515,170515,0,0,0,617,1.0,0.57617676,1
2020-08-05-170515,170515,0,0,2,617,2.0,0.71984786,2
2020-08-06-170515,170515,0,0,3,617,1.75,0.4304624,3
2020-08-07-170515,170515,0,0,2,617,2.25,1.1094062,4
2020-08-08-170515,170515,2,0,5,619,1.0,0.06729817,5
2020-08-09-170515,170515,2,0,2,621,1.5,0.047511496,6
2020-08-10-170515,170515,0,0,4,621,1.25,0.051904637,0
2020-08-11-170515,170515,3,0,7,624,1.75,0.32622918,1
2020-08-12-170515,170515,3,0,2,627,1.75,0.69351065,2
2020-08-13-170515,170515,3,0,0,630,2.0,0.084578305,3
2020-08-14-170515,170515,2,0,7,632,3.25,1.2210737,4
2020-08-15-170515,170515,3,0,5,635,2.75,0.09399204,5
2020-08-16-170515,170515,2,0,1,637,0.25,0.25798225,6
2020-08-17-170515,170515,5,0,2,642,2.5,0.36747006,0
2020-08-18-170515,170515,0,0,1,642,1.75,0.26253825,1
2020-08-19-170515,170515,2,0,11,644,5.75,2.2741249,2
2020-08-20-170515,170515,3,0,9,647,1.25,0.3335155,3
2020-08-21-170515,170515,2,0,7,649,4.25,1.1444566,4
2020-08-22-170515,170515,5,0,3,654,4.5,0.545609,5
2020-08-23-170515,170515,2,0,7,656,2.0,0.14158636,6
2020-08-24-170515,170515,4,0,10,660,4.25,0.4806219,0
2020-08-25-170515,170515,7,0,8,667,1.75,0.15037802,1
2020-08-26-170515,170515,2,0,6,669,5.0,0.5495446,2
2020-08-27-170515,170515,0,1,5,669,2.75,0.45981112,3
2020-08-28-170515,170515,7,0,9,676,5.25,0.19798495,4
2020-08-29-170515,170515,5,0,7,681,5.25,0.064831235,5
2020-08-30-170515,170515,1,0,9,682,1.75,0.3246501,6
2020-08-31-170515,170515,2,0,6,684,3.75,0.094501145,0
2020-09-01-170515,170515,1,0,6,685,2.25,1.7132647,1
2020-09-02-170515,170515,11,0,9,696,2.5,0.0788817,2
2020-09-03-170515,170515,9,0,11,705,7.0,0.9618338,3
2020-09-04-170515,170515,7,0,13,712,5.75,0.78016436,4
2020-09-05-170515,170515,3,0,6,715,6.25,0.66767496,5
2020-09-06-170515,170515,7,0,14,722,6.25,0.3480878,6
2020-09-07-170515,170515,10,0,13,732,7.25,0.31084847,0
2020-09-08-170515,170515,8,0,9,740,6.75,0.6424241,1
2020-09-09-170515,170515,6,0,13,746,3.75,0.8248882,2
2020-09-10-170515,170515,5,0,7,751,6.0,0.9733103,3
2020-09-11-170515,170515,9,0,7,760,6.75,0.4973147,4
2020-09-12-170515,170515,7,0,7,767,6.5,0.3941536,5
2020-09-13-170515,170515,9,0,7,776,6.75,0.4418457,6
2020-09-14-170515,170515,6,0,15,782,6.5,1.2224264,0
2020-09-15-170515,170515,6,0,13,788,9.5,1.039993,1
2020-09-16-170515,170515,9,0,12,797,6.75,0.49920255,2
2020-09-17-170515,170515,11,0,5,808,8.75,0.30220678,3
2020-09-18-170515,170515,13,0,13,821,12.0,1.1338286,4
2020-09-19-170515,170515,6,0,9,827,4.25,0.3090063,5
2020-09-20-170515,170515,14,0,5,841,13.5,0.5886692,6
2020-09-21-170515,170515,13,0,6,854,7.5,0.86889905,0
2020-09-22-170515,170515,9,0,7,863,7.0,0.6611824,1
2020-09-23-170515,170515,13,0,3,876,10.75,0.8084347,2
2020-09-24-170515,170515,7,1,5,883,9.0,1.0703506,3
2020-09-25-170515,170515,7,0,11,890,9.25,0.4955712,4
2020-09-26-170515,170515,7,0,8,897,6.5,1.354091,5
2020-09-27-170515,170515,7,0,4,904,7.75,0.9901301,6
2020-09-28-170515,170515,15,0,6,919,6.0,1.1008011,0
2020-09-29-170515,170515,13,0,11,932,4.75,0.1206956,1
2020-09-30-170515,170515,12,0,10,944,6.75,1.1282356,2
2020-10-01-170515,170515,5,0,15,949,6.5,0.84457594,3
2020-10-02-170515,170515,13,0,21,962,13.75,1.3740689,4
2020-10-03-170515,170515,9,0,22,971,12.25,0.6803583,5
2020-10-04-170515,170515,5,0,10,976,4.0,0.40867963,6
2020-10-05-170515,170515,6,0,16,982,10.5,0.6884162,0
2020-10-06-170515,170515,7,0,5,989,9.0,0.68104386,1
2020-10-07-170515,170515,3,1,2,992,8.0,0.73357767,2
2020-10-08-170515,170515,5,0,15,997,10.0,1.2691638,3
2020-10-09-170515,170515,11,1,15,1008,19.5,0.3962734,4
2020-10-10-170515,170515,8,0,15,1016,10.0,0.40895894,5
2020-10-11-170515,170515,4,0,21,1020,1.5,0.021676248,6
2020-10-12-170515,170515,6,0,16,1026,10.25,0.23706156,0
2020-10-13-170515,170515,11,0,15,1037,8.0,0.720143,1
2020-10-14-170515,170515,10,0,14,1047,11.5,2.2821996,2
2020-10-15-170515,170515,15,0,16,1062,14.25,1.0950941,3
2020-10-16-170515,170515,21,0,18,1083,20.0,0.98487127,4
2020-10-17-170515,170515,22,0,25,1105,17.25,0.30543458,5
2020-10-18-170515,170515,10,0,6,1115,3.5,0.092478596,6
2020-10-19-170515,170515,16,0,20,1131,7.75,0.53349787,0
2020-10-20-170515,170515,5,0,11,1136,9.25,1.6173586,1
2020-10-21-170515,170515,2,0,15,1138,6.5,0.21736139,2
2020-10-22-170515,170515,15,0,11,1153,12.0,0.9008437,3
2020-10-23-170515,170515,15,0,20,1168,15.5,0.9062489,4
2020-10-24-170515,170515,15,0,16,1183,9.75,0.79361403,5
2020-10-25-170515,170515,21,1,9,1204,8.75,0.38537306,6
2020-10-26-170515,170515,16,1,9,1220,10.25,0.8349522,0
2020-10-27-170515,170515,15,1,10,1235,14.75,0.69221133,1
2020-10-28-170515,170515,14,0,14,1249,12.25,2.1658041,2
2020-10-29-170515,170515,16,1,11,1265,13.25,0.97139513,3
2020-10-30-170515,170515,18,3,15,1283,16.0,1.9963523,4
2020-10-31-170515,170515,25,0,0,1308,10.25,0.5366416,5
2020-11-01-170515,170515,6,0,0,1314,4.75,0.2470414,6
2020-11-02-170515,170515,20,1,0,1334,12.0,0.40761933,0
2020-11-03-170515,170515,11,2,0,1345,6.75,2.0517826,1
2020-11-04-170515,170515,15,0,0,1360,10.25,2.1900961,2
2020-11-05-170515,170515,11,1,0,1371,15.25,3.414687,3
2020-11-06-170515,170515,20,0,0,1391,26.5,0.7502943,4
2020-11-07-170515,170515,16,0,0,1407,23.0,10.919035,5
2020-11-08-170515,170515,9,4,0,1416,6.25,0.38038138,6
2020-11-09-170515,170515,9,0,0,1425,13.0,2.1294417,0
2020-11-10-170515,170515,10,2,0,1435,9.75,1.0138719,1
2020-11-11-170515,170515,14,2,0,1449,5.5,0.6015558,2
2020-11-12-170515,170515,11,0,0,1460,15.75,1.6678985,3
2020-11-13-170515,170515,15,2,0,1475,14.75,3.1830342,4
2020-03-01-170516,170516,0,0,0,0,0.0,1.4393099e-05,6
2020-03-02-170516,170516,0,0,2,0,0.0,0.00019508625,0
2020-03-03-170516,170516,0,0,0,0,0.0,0.0028234534,1
2020-03-04-170516,170516,0,0,1,0,0.0,0.0012909683,2
2020-03-05-170516,170516,0,0,2,0,0.0,3.360498e-05,3
2020-03-06-170516,170516,0,0,1,0,0.0,0.0012672952,4
2020-03-07-170516,170516,0,0,0,0,0.0,0.00023415686,5
2020-03-08-170516,170516,0,0,0,0,0.14285714285714285,0.021928705,6
2020-03-09-170516,170516,0,0,2,0,0.14285714285714285,0.014858251,0
2020-03-10-170516,170516,0,0,1,0,0.14285714285714285,0.007164701,1
2020-03-11-170516,170516,0,0,0,0,0.0,0.009139356,2
2020-03-12-170516,170516,0,0,0,0,0.0,0.03432793,3
2020-03-13-170516,170516,0,0,3,0,0.42857142857142855,0.07515978,4
2020-03-14-170516,170516,2,0,0,2,0.14285714285714285,0.20790163,5
2020-03-15-170516,170516,0,0,1,2,0.42857142857142855,0.032540854,6
2020-03-16-170516,170516,2,0,0,4,1.2857142857142858,0.14669807,0
2020-03-17-170516,170516,0,0,1,4,1.4285714285714286,0.23325624,1
2020-03-18-170516,170516,1,0,0,5,1.0,0.15494394,2
2020-03-19-170516,170516,2,0,1,7,2.142857142857143,0.32407877,3
2020-03-20-170516,170516,1,0,0,8,2.0,0.34589913,4
2020-03-21-170516,170516,0,3,0,8,1.7142857142857142,0.10914363,5
2020-03-22-170516,170516,0,2,3,8,1.7142857142857142,0.10311611,6
2020-03-23-170516,170516,2,0,1,10,3.1428571428571432,0.4945793,0
2020-03-24-170516,170516,1,0,0,11,3.0,0.3698456,1
2020-03-25-170516,170516,0,0,1,11,2.2857142857142856,0.35244244,2
2020-03-26-170516,170516,0,0,0,11,3.4285714285714284,0.38469803,3
2020-03-27-170516,170516,3,0,1,14,3.4285714285714284,0.50591695,4
2020-03-28-170516,170516,0,0,0,14,1.1428571428571428,0.11321052,5
2020-03-29-170516,170516,1,0,0,15,0.5714285714285714,0.06844174,6
2020-03-30-170516,170516,0,0,0,15,2.4285714285714284,0.30058715,0
2020-03-31-170516,170516,1,0,0,16,1.5714285714285714,0.16530031,1
2020-04-01-170516,170516,0,0,0,16,2.0,0.19045931,2
2020-04-02-170516,170516,1,0,1,17,1.8571428571428568,0.16032843,3
2020-04-03-170516,170516,0,0,0,17,1.2857142857142858,0.19349663,4
2020-04-04-170516,170516,0,0,0,17,0.42857142857142855,0.049681764,5
2020-04-05-170516,170516,3,0,0,20,1.2857142857142858,0.114352,6
2020-04-06-170516,170516,1,0,0,21,2.142857142857143,0.21612523,0
2020-04-07-170516,170516,0,0,0,21,2.0,0.34535143,1
2020-04-08-170516,170516,1,0,0,22,2.0,0.28423524,2
2020-04-09-170516,170516,0,1,0,22,2.571428571428572,0.1396183,3
2020-04-10-170516,170516,1,1,0,23,2.142857142857143,0.13487153,4
2020-04-11-170516,170516,0,0,0,23,0.5714285714285714,0.038788896,5
2020-04-12-170516,170516,0,0,0,23,1.2857142857142858,0.02715487,6
2020-04-13-170516,170516,0,0,0,23,0.8571428571428571,0.1029335,0
2020-04-14-170516,170516,0,0,0,23,1.1428571428571428,0.066899106,1
2020-04-15-170516,170516,0,0,0,23,1.7142857142857142,0.14598496,2
2020-04-16-170516,170516,1,0,0,24,0.7142857142857143,0.13591984,3
2020-04-17-170516,170516,0,0,0,24,1.1428571428571428,0.115661055,4
2020-04-18-170516,170516,0,0,0,24,0.14285714285714285,0.0014406479,5
2020-04-19-170516,170516,0,0,0,24,0.0,0.016775956,6
2020-04-20-170516,170516,0,0,0,24,0.8571428571428571,0.13248603,0
2020-04-21-170516,170516,0,0,0,24,1.1428571428571428,0.09870299,1
2020-04-22-170516,170516,0,0,0,24,0.42857142857142855,0.0664631,2
2020-04-23-170516,170516,0,0,0,24,0.42857142857142855,0.030065365,3
2020-04-24-170516,170516,0,0,0,24,0.42857142857142855,0.085836746,4
2020-04-25-170516,170516,0,0,0,24,0.0,0.011017443,5
2020-04-26-170516,170516,0,1,0,24,0.2857142857142857,0.021134213,6
2020-04-27-170516,170516,0,0,0,24,0.2857142857142857,0.045780636,0
2020-04-28-170516,170516,0,0,0,24,0.7142857142857143,0.10784542,1
2020-04-29-170516,170516,0,0,0,24,0.42857142857142855,0.09177471,2
2020-04-30-170516,170516,0,0,0,24,0.7142857142857143,0.044798553,3
2020-05-01-170516,170516,0,0,0,24,0.2857142857142857,0.0058597964,4
2020-05-02-170516,170516,0,0,0,24,0.14285714285714285,0.012979235,5
2020-05-03-170516,170516,0,0,0,24,0.42857142857142855,0.021652952,6
2020-05-04-170516,170516,0,0,0,24,0.5714285714285714,0.17136204,0
2020-05-05-170516,170516,0,0,0,24,0.5714285714285714,0.19448072,1
2020-05-06-170516,170516,0,0,0,24,0.42857142857142855,0.097631395,2
2020-05-07-170516,170516,0,0,2,24,1.1428571428571428,0.1378492,3
2020-05-08-170516,170516,0,0,3,24,0.42857142857142855,0.048111934,4
2020-05-09-170516,170516,0,0,0,24,0.0,0.004753073,5
2020-05-10-170516,170516,0,0,0,24,0.14285714285714285,0.008899037,6
2020-05-11-170516,170516,0,1,0,24,0.8571428571428571,0.3103995,0
2020-05-12-170516,170516,0,0,0,24,0.7142857142857143,0.23246758,1
2020-05-13-170516,170516,0,0,0,24,0.7142857142857143,0.08395516,2
2020-05-14-170516,170516,0,0,0,24,0.5714285714285714,0.08118718,3
2020-05-15-170516,170516,0,0,1,24,0.42857142857142855,0.11558194,4
2020-05-16-170516,170516,0,0,0,24,0.0,0.020464394,5
2020-05-17-170516,170516,0,0,0,24,0.14285714285714285,0.015302184,6
2020-05-18-170516,170516,0,0,0,24,0.7142857142857143,0.09247499,0
2020-05-19-170516,170516,0,0,0,24,1.1428571428571428,0.18240598,1
2020-05-20-170516,170516,0,0,0,24,0.5714285714285714,0.0738794,2
2020-05-21-170516,170516,2,0,0,26,0.42857142857142855,0.15014827,3
2020-05-22-170516,170516,3,0,1,29,0.2857142857142857,0.21810111,4
2020-05-23-170516,170516,0,0,0,29,0.0,0.0010975747,5
2020-05-24-170516,170516,0,0,0,29,0.0,7.344607e-05,6
2020-05-25-170516,170516,0,0,0,29,0.2857142857142857,0.058431502,0
2020-05-26-170516,170516,0,0,0,29,0.42857142857142855,0.053664207,1
2020-05-27-170516,170516,0,0,0,29,0.7142857142857143,0.055140667,2
2020-05-28-170516,170516,0,2,0,29,1.1428571428571428,0.08228824,3
2020-05-29-170516,170516,1,0,1,30,0.8571428571428571,0.17737317,4
2020-05-30-170516,170516,0,1,0,30,0.14285714285714285,0.013167486,5
2020-05-31-170516,170516,0,0,0,30,0.0,0.010550131,6
2020-06-01-170516,170516,0,0,0,30,0.2857142857142857,0.04463506,0
2020-06-02-170516,170516,0,0,0,30,0.2857142857142857,0.037256412,1
2020-06-03-170516,170516,0,0,0,30,0.5714285714285714,0.049077302,2
2020-06-04-170516,170516,0,0,4,30,0.5714285714285714,0.06343671,3
2020-06-05-170516,170516,1,0,0,31,0.14285714285714285,0.080237314,4
2020-06-06-170516,170516,0,0,0,31,0.42857142857142855,0.03648924,5
2020-06-07-170516,170516,0,0,0,31,0.0,9.772891e-05,6
2020-06-08-170516,170516,0,0,0,31,0.14285714285714285,0.017589418,0
2020-06-09-170516,170516,0,0,0,31,0.2857142857142857,0.023492208,1
2020-06-10-170516,170516,0,0,0,31,0.14285714285714285,0.03319812,2
2020-06-11-170516,170516,0,0,0,31,0.42857142857142855,0.036470518,3
2020-06-12-170516,170516,1,0,0,32,0.2857142857142857,0.11407499,4
2020-06-13-170516,170516,0,0,0,32,0.2857142857142857,0.025804842,5
2020-06-14-170516,170516,0,1,0,32,0.0,4.849957e-07,6
2020-06-15-170516,170516,0,0,0,32,0.0,0.018692497,0
2020-06-16-170516,170516,0,0,0,32,0.7142857142857143,0.041674964,1
2020-06-17-170516,170516,0,1,0,32,0.14285714285714285,0.02067316,2
2020-06-18-170516,170516,4,0,1,36,0.42857142857142855,0.23317395,3
2020-06-19-170516,170516,0,0,0,36,0.7142857142857143,0.036654413,4
2020-06-20-170516,170516,0,0,0,36,0.2857142857142857,0.006396675,5
2020-06-21-170516,170516,0,0,0,36,0.0,0.0023305975,6
2020-06-22-170516,170516,0,0,0,36,0.14285714285714285,0.009481262,0
2020-06-23-170516,170516,0,0,0,36,0.0,0.00878651,1
2020-06-24-170516,170516,0,0,0,36,0.8571428571428571,0.07008935,2
2020-06-25-170516,170516,0,0,0,36,0.14285714285714285,0.043609455,3
2020-06-26-170516,170516,0,0,0,36,0.42857142857142855,0.04595632,4
2020-06-27-170516,170516,0,0,0,36,0.0,0.019557858,5
2020-06-28-170516,170516,0,0,0,36,0.0,0.000882801,6
2020-06-29-170516,170516,0,0,0,36,0.0,0.01751362,0
2020-06-30-170516,170516,0,0,0,36,0.14285714285714285,0.014649593,1
2020-07-01-170516,170516,0,0,0,36,0.0,0.0053505404,2
2020-07-02-170516,170516,1,0,0,37,0.0,0.09290243,3
2020-07-03-170516,170516,0,0,0,37,0.14285714285714285,0.02165919,4
2020-07-04-170516,170516,0,0,0,37,0.0,0.00069124385,5
2020-07-05-170516,170516,0,0,0,37,0.0,0.0012636159,6
2020-07-06-170516,170516,0,0,0,37,0.2857142857142857,0.12945761,0
2020-07-07-170516,170516,0,0,1,37,0.14285714285714285,0.038243152,1
2020-07-08-170516,170516,0,0,0,37,0.0,0.0020604844,2
2020-07-09-170516,170516,0,0,0,37,0.2857142857142857,0.027044177,3
2020-07-10-170516,170516,0,0,0,37,0.42857142857142855,0.043058597,4
2020-07-11-170516,170516,0,0,0,37,0.14285714285714285,0.00046362693,5
2020-07-12-170516,170516,0,0,0,37,0.14285714285714285,0.02218597,6
2020-07-13-170516,170516,0,0,0,37,0.14285714285714285,0.007026379,0
2020-07-14-170516,170516,0,0,1,37,0.7142857142857143,0.019781768,1
2020-07-15-170516,170516,0,0,0,37,0.14285714285714285,0.026340423,2
2020-07-16-170516,170516,0,0,0,37,0.14285714285714285,0.023267647,3
2020-07-17-170516,170516,0,0,0,37,0.14285714285714285,0.00926157,4
2020-07-18-170516,170516,0,0,0,37,0.0,0.0025940002,5
2020-07-19-170516,170516,0,0,0,37,0.14285714285714285,0.015531143,6
2020-07-20-170516,170516,0,0,0,37,0.0,0.008732599,0
2020-07-21-170516,170516,1,0,0,38,0.14285714285714285,0.08063914,1
2020-07-22-170516,170516,0,0,0,38,0.2857142857142857,0.028558265,2
2020-07-23-170516,170516,0,0,0,38,0.7142857142857143,0.09591145,3
2020-07-24-170516,170516,0,0,0,38,0.0,0.024068648,4
2020-07-25-170516,170516,0,0,0,38,0.0,0.0028922786,5
2020-07-26-170516,170516,0,0,0,38,0.0,0.00029826557,6
2020-07-27-170516,170516,0,0,0,38,0.2857142857142857,0.18962751,0
2020-07-28-170516,170516,1,0,0,39,0.0,0.081564106,1
2020-07-29-170516,170516,0,0,0,39,0.2857142857142857,0.03650163,2
2020-07-30-170516,170516,0,0,0,39,0.42857142857142855,0.081302814,3
2020-07-31-170516,170516,0,0,0,39,0.0,0.060822736,4
2020-08-01-170516,170516,0,0,0,39,0.14285714285714285,0.02165783,5
2020-08-02-170516,170516,0,0,0,39,0.2857142857142857,0.09289942,6
2020-08-03-170516,170516,0,0,0,39,0.2857142857142857,0.06768778,0
2020-08-04-170516,170516,0,1,0,39,0.8571428571428571,0.1373149,1
2020-08-05-170516,170516,0,0,0,39,0.7142857142857143,0.1868878,2
2020-08-06-170516,170516,0,0,0,39,0.7142857142857143,0.15150179,3
2020-08-07-170516,170516,0,0,0,39,1.0,0.11042052,4
2020-08-08-170516,170516,0,1,0,39,0.7142857142857143,0.09981754,5
2020-08-09-170516,170516,0,0,0,39,0.14285714285714285,0.16269913,6
2020-08-10-170516,170516,0,0,0,39,0.14285714285714285,0.048742544,0
2020-08-11-170516,170516,0,0,0,39,0.5714285714285714,0.11584212,1
2020-08-12-170516,170516,0,0,0,39,1.5714285714285714,0.37215838,2
2020-08-13-170516,170516,0,0,0,39,2.0,0.17965725,3
2020-08-14-170516,170516,0,0,1,39,1.5714285714285714,0.33203763,4
2020-08-15-170516,170516,0,0,0,39,1.5714285714285714,0.19692628,5
2020-08-16-170516,170516,0,0,5,39,1.2857142857142858,0.17462566,6
2020-08-17-170516,170516,0,0,2,39,1.7142857142857142,0.38474292,0
2020-08-18-170516,170516,0,0,0,39,1.7142857142857142,0.30189407,1
2020-08-19-170516,170516,0,0,0,39,1.2857142857142858,0.42018026,2
2020-08-20-170516,170516,0,0,1,39,2.2857142857142856,0.3671997,3
2020-08-21-170516,170516,0,0,2,39,3.4285714285714284,0.60839534,4
2020-08-22-170516,170516,0,0,0,39,1.4285714285714286,0.20176798,5
2020-08-23-170516,170516,0,0,1,39,1.4285714285714286,0.27630836,6
2020-08-24-170516,170516,0,0,0,39,2.7142857142857144,0.20925017,0
2020-08-25-170516,170516,0,0,12,39,1.1428571428571428,0.09421029,1
2020-08-26-170516,170516,0,0,1,39,0.7142857142857143,0.15340199,2
2020-08-27-170516,170516,0,0,3,39,1.2857142857142858,0.1253729,3
2020-08-28-170516,170516,1,0,1,40,1.4285714285714286,0.3530229,4
2020-08-29-170516,170516,0,0,0,40,0.8571428571428571,0.08230997,5
2020-08-30-170516,170516,5,0,2,45,0.7142857142857143,0.24240957,6
2020-08-31-170516,170516,2,0,0,47,0.2857142857142857,0.13436244,0
2020-09-01-170516,170516,0,0,0,47,1.8571428571428568,0.29090685,1
2020-09-02-170516,170516,0,0,0,47,1.0,0.16267246,2
2020-09-03-170516,170516,1,0,0,48,3.7142857142857135,0.6540433,3
2020-09-04-170516,170516,2,0,0,50,1.7142857142857142,0.35276404,4
2020-09-05-170516,170516,0,0,0,50,0.7142857142857143,0.15949139,5
2020-09-06-170516,170516,1,0,1,51,3.571428571428572,0.5239144,6
2020-09-07-170516,170516,0,0,2,51,1.1428571428571428,0.24977745,0
2020-09-08-170516,170516,12,0,0,63,0.8571428571428571,0.62644494,1
2020-09-09-170516,170516,1,0,0,64,3.0,0.5996012,2
2020-09-10-170516,170516,3,0,1,67,3.0,0.58580923,3
2020-09-11-170516,170516,1,0,0,68,3.2857142857142856,0.45142052,4
2020-09-12-170516,170516,0,0,0,68,2.571428571428572,0.2913283,5
2020-09-13-170516,170516,2,0,0,70,0.42857142857142855,0.18772434,6
2020-09-14-170516,170516,0,0,1,70,2.2857142857142856,0.3333584,0
2020-09-15-170516,170516,0,0,0,70,3.8571428571428568,1.0672653,1
2020-09-16-170516,170516,0,0,4,70,3.1428571428571432,0.3023838,2
2020-09-17-170516,170516,0,0,6,70,1.5714285714285714,0.22604539,3
2020-09-18-170516,170516,0,0,0,70,2.8571428571428568,0.84792125,4
2020-09-19-170516,170516,0,0,3,70,0.5714285714285714,0.043426815,5
2020-09-20-170516,170516,1,0,5,71,1.5714285714285714,0.21421462,6
2020-09-21-170516,170516,2,0,3,73,1.5714285714285714,0.35492685,0
2020-09-22-170516,170516,0,0,4,73,1.2857142857142858,0.0694877,1
2020-09-23-170516,170516,0,0,2,73,2.142857142857143,0.23543873,2
2020-09-24-170516,170516,1,0,0,74,1.4285714285714286,0.21327318,3
2020-09-25-170516,170516,0,0,1,74,2.142857142857143,0.15676717,4
2020-09-26-170516,170516,0,0,1,74,1.4285714285714286,0.24134412,5
2020-09-27-170516,170516,0,0,1,74,1.2857142857142858,0.15195802,6
2020-09-28-170516,170516,1,0,0,75,2.0,0.31132835,0
2020-09-29-170516,170516,0,0,0,75,2.571428571428572,0.08638647,1
2020-09-30-170516,170516,4,0,1,79,1.8571428571428568,0.351074,2
2020-10-01-170516,170516,6,0,0,85,1.0,0.16623183,3
2020-10-02-170516,170516,0,0,0,85,1.8571428571428568,0.26739606,4
2020-10-03-170516,170516,3,0,0,88,1.2857142857142858,0.4128104,5
2020-10-04-170516,170516,5,0,0,93,0.5714285714285714,0.17838326,6
2020-10-05-170516,170516,3,0,2,96,0.42857142857142855,0.2721204,0
2020-10-06-170516,170516,4,0,1,100,2.0,0.40943477,1
2020-10-07-170516,170516,2,0,0,102,1.0,0.31320888,2
2020-10-08-170516,170516,0,1,1,102,2.142857142857143,0.37134862,3
2020-10-09-170516,170516,1,0,0,103,1.4285714285714286,0.22229335,4
2020-10-10-170516,170516,1,0,0,104,1.1428571428571428,0.24091223,5
2020-10-11-170516,170516,1,0,0,105,0.14285714285714285,0.10008415,6
2020-10-12-170516,170516,0,0,0,105,1.2857142857142858,0.04552214,0
2020-10-13-170516,170516,0,0,1,105,1.5714285714285714,0.23301037,1
2020-10-14-170516,170516,1,0,0,106,4.142857142857143,0.56922156,2
2020-10-15-170516,170516,0,0,0,106,2.571428571428572,0.48352548,3
2020-10-16-170516,170516,0,0,3,106,2.7142857142857144,0.34775877,4
2020-10-17-170516,170516,0,0,3,106,1.8571428571428568,0.13526638,5
2020-10-18-170516,170516,0,0,2,106,0.42857142857142855,0.1006448,6
2020-10-19-170516,170516,2,0,0,108,2.571428571428572,0.41199365,0
2020-10-20-170516,170516,1,0,1,109,3.0,0.3844102,1
2020-10-21-170516,170516,0,0,2,109,2.571428571428572,0.3417376,2
2020-10-22-170516,170516,1,0,1,110,2.4285714285714284,0.37742516,3
2020-10-23-170516,170516,0,0,0,110,3.8571428571428568,1.0419801,4
2020-10-24-170516,170516,0,0,0,110,2.2857142857142856,0.35473108,5
2020-10-25-170516,170516,0,0,0,110,1.4285714285714286,0.11834641,6
2020-10-26-170516,170516,0,0,0,110,2.8571428571428568,0.88381636,0
2020-10-27-170516,170516,1,0,1,111,2.0,0.57041794,1
2020-10-28-170516,170516,0,0,0,111,5.428571428571429,1.5908434,2
2020-10-29-170516,170516,0,0,0,111,3.8571428571428568,1.088547,3
2020-10-30-170516,170516,3,0,1,114,5.857142857142858,0.91605914,4
2020-10-31-170516,170516,3,0,0,117,1.7142857142857142,0.6270268,5
2020-11-01-170516,170516,2,0,0,119,2.571428571428572,0.57911897,6
2020-11-02-170516,170516,0,1,0,119,1.1428571428571428,0.13138266,0
2020-11-03-170516,170516,1,0,0,120,5.0,0.5304506,1
2020-11-04-170516,170516,2,0,0,122,4.714285714285714,1.5138711,2
2020-11-05-170516,170516,1,0,0,123,6.7142857142857135,2.6467733,3
2020-11-06-170516,170516,0,0,0,123,7.2857142857142865,1.0464008,4
2020-11-07-170516,170516,0,0,0,123,9.714285714285714,0.91352177,5
2020-11-08-170516,170516,0,0,0,123,2.2857142857142856,0.11572499,6
2020-11-09-170516,170516,0,0,0,123,3.0,0.7519255,0
2020-11-10-170516,170516,1,0,0,124,4.142857142857143,0.67296946,1
2020-11-11-170516,170516,0,0,0,124,2.0,0.22202732,2
2020-11-12-170516,170516,0,0,0,124,3.0,1.0767416,3
2020-11-13-170516,170516,1,0,0,125,8.571428571428571,1.031964,4
2020-03-01-170517,170517,0,0,5,0,0.0,0.0022907057,6
2020-03-02-170517,170517,0,0,5,0,0.0,0.0016525299,0
2020-03-03-170517,170517,0,0,12,0,0.0,0.00093014777,1
2020-03-04-170517,170517,0,0,7,0,0.0,0.0009150695,2
2020-03-05-170517,170517,0,0,10,0,0.0,0.0006614808,3
2020-03-06-170517,170517,0,0,9,0,0.0,0.002511928,4
2020-03-07-170517,170517,0,0,9,0,0.0,0.001697962,5
2020-03-08-170517,170517,1,0,4,1,0.0,0.12428511,6
2020-03-09-170517,170517,0,0,16,1,0.2,0.021812927,0
2020-03-10-170517,170517,0,0,10,1,0.2,0.008729454,1
2020-03-11-170517,170517,0,0,11,1,0.0,0.00924884,2
2020-03-12-170517,170517,2,0,8,3,0.2,0.29578492,3
2020-03-13-170517,170517,1,0,6,4,0.2,0.19580102,4
2020-03-14-170517,170517,0,0,5,4,0.4,0.2631819,5
2020-03-15-170517,170517,5,0,8,9,0.0,0.40410176,6
2020-03-16-170517,170517,5,0,6,14,1.6,0.65727663,0
2020-03-17-170517,170517,12,0,5,26,1.4,1.3897625,1
2020-03-18-170517,170517,7,0,9,33,2.4,1.0030395,2
2020-03-19-170517,170517,10,0,6,43,2.2,1.5251148,3
2020-03-20-170517,170517,9,0,5,52,3.0,1.4129148,4
2020-03-21-170517,170517,9,0,5,61,1.0,0.7981923,5
2020-03-22-170517,170517,4,0,5,65,0.8,0.4103396,6
2020-03-23-170517,170517,16,0,3,81,2.8,2.4123054,0
2020-03-24-170517,170517,10,0,2,91,3.2,1.6969286,1
2020-03-25-170517,170517,11,0,4,102,3.2,1.5339736,2
2020-03-26-170517,170517,8,0,3,110,4.2,1.68527,3
2020-03-27-170517,170517,6,0,1,116,5.0,1.7450786,4
2020-03-28-170517,170517,5,0,2,121,2.2,0.5857018,5
2020-03-29-170517,170517,8,0,1,129,0.6,0.58900255,6
2020-03-30-170517,170517,6,0,6,135,3.2,1.0635825,0
2020-03-31-170517,170517,5,0,1,140,1.8,0.82924944,1
2020-04-01-170517,170517,9,0,3,149,3.2,1.5070267,2
2020-04-02-170517,170517,6,0,7,155,7.8,0.95549875,3
2020-04-03-170517,170517,5,0,3,160,1.8,0.8520265,4
2020-04-04-170517,170517,5,0,0,165,0.4,0.4686913,5
2020-04-05-170517,170517,5,1,2,170,1.6,0.4506931,6
2020-04-06-170517,170517,3,0,4,173,3.0,0.71163857,0
2020-04-07-170517,170517,2,0,2,175,2.6,0.9733333,1
2020-04-08-170517,170517,4,0,4,179,2.4,0.79178977,2
2020-04-09-170517,170517,3,0,2,182,2.8,0.43251547,3
2020-04-10-170517,170517,1,1,4,183,1.4,0.3119465,4
2020-04-11-170517,170517,2,0,1,185,1.4,0.28354082,5
2020-04-12-170517,170517,1,0,2,186,0.6,0.08768968,6
2020-04-13-170517,170517,6,0,1,192,1.8,0.8558026,0
2020-04-14-170517,170517,1,0,4,193,1.0,0.23357457,1
2020-04-15-170517,170517,3,0,2,196,1.6,0.48627564,2
2020-04-16-170517,170517,7,0,1,203,0.8,0.85503376,3
2020-04-17-170517,170517,3,0,0,206,1.0,0.4750972,4
2020-04-18-170517,170517,0,0,2,206,0.0,0.0017054211,5
2020-04-19-170517,170517,2,0,1,208,0.4,0.14106804,6
2020-04-20-170517,170517,4,0,2,212,0.8,0.6634938,0
2020-04-21-170517,170517,2,0,3,214,0.8,0.36961883,1
2020-04-22-170517,170517,4,0,5,218,1.0,0.57495546,2
2020-04-23-170517,170517,2,0,5,220,0.0,0.19578357,3
2020-04-24-170517,170517,4,0,0,224,0.4,0.4247721,4
2020-04-25-170517,170517,1,0,1,225,0.2,0.094682954,5
2020-04-26-170517,170517,2,0,1,227,1.2,0.20281634,6
2020-04-27-170517,170517,1,1,6,228,2.4,0.23770244,0
2020-04-28-170517,170517,4,0,2,232,0.4,0.6467316,1
2020-04-29-170517,170517,2,0,2,234,1.4,0.4426607,2
2020-04-30-170517,170517,1,0,1,235,0.8,0.191427,3
2020-05-01-170517,170517,0,0,5,235,0.8,0.035696592,4
2020-05-02-170517,170517,2,0,4,237,0.0,0.12964302,5
2020-05-03-170517,170517,1,0,1,238,0.2,0.09231116,6
2020-05-04-170517,170517,2,0,4,240,1.2,0.46667078,0
2020-05-05-170517,170517,3,0,1,243,0.6,0.6140041,1
2020-05-06-170517,170517,5,0,3,248,0.8,0.7421994,2
2020-05-07-170517,170517,5,0,2,253,1.4,0.82769126,3
2020-05-08-170517,170517,0,0,2,253,0.6,0.117703825,4
2020-05-09-170517,170517,1,1,0,254,0.6,0.10025865,5
2020-05-10-170517,170517,1,0,0,255,0.2,0.080372326,6
2020-05-11-170517,170517,6,3,3,261,1.2,1.1941135,0
2020-05-12-170517,170517,2,0,2,263,1.0,0.6654875,1
2020-05-13-170517,170517,2,0,0,265,1.0,0.36010763,2
2020-05-14-170517,170517,1,0,0,266,0.2,0.30239737,3
2020-05-15-170517,170517,5,0,1,271,0.8,0.751226,4
2020-05-16-170517,170517,4,0,0,275,0.0,0.28491744,5
2020-05-17-170517,170517,1,0,1,276,0.0,0.094418555,6
2020-05-18-170517,170517,4,0,1,280,0.6,0.49995756,0
2020-05-19-170517,170517,1,0,1,281,2.2,0.60370696,1
2020-05-20-170517,170517,3,0,0,284,0.4,0.4500464,2
2020-05-21-170517,170517,2,0,0,286,1.2,0.478903,3
2020-05-22-170517,170517,2,0,1,288,1.0,0.4188622,4
2020-05-23-170517,170517,0,1,0,288,0.2,0.0028963655,5
2020-05-24-170517,170517,0,0,0,288,0.0,0.0037607292,6
2020-05-25-170517,170517,3,0,0,291,0.6,0.45247215,0
2020-05-26-170517,170517,2,0,0,293,0.2,0.38494304,1
2020-05-27-170517,170517,0,3,1,293,0.8,0.08074683,2
2020-05-28-170517,170517,0,3,1,293,0.4,0.20019034,3
2020-05-29-170517,170517,1,0,2,294,0.4,0.3830385,4
2020-05-30-170517,170517,0,0,0,294,0.2,0.062371176,5
2020-05-31-170517,170517,1,0,0,295,0.0,0.11701757,6
2020-06-01-170517,170517,1,0,1,296,0.6,0.14232674,0
2020-06-02-170517,170517,1,0,0,297,0.2,0.19096717,1
2020-06-03-170517,170517,0,0,2,297,0.0,0.06590755,2
2020-06-04-170517,170517,0,0,0,297,0.4,0.068888485,3
2020-06-05-170517,170517,1,0,0,298,0.0,0.24742784,4
2020-06-06-170517,170517,0,0,0,298,0.0,0.02771208,5
2020-06-07-170517,170517,0,0,0,298,0.0,0.00031312194,6
2020-06-08-170517,170517,0,0,0,298,0.6,0.07403967,0
2020-06-09-170517,170517,0,0,0,298,0.2,0.056012228,1
2020-06-10-170517,170517,1,2,1,299,0.2,0.22408316,2
2020-06-11-170517,170517,1,0,1,300,0.2,0.078224756,3
2020-06-12-170517,170517,2,0,1,302,0.6,0.46287993,4
2020-06-13-170517,170517,0,0,1,302,0.0,0.026623974,5
2020-06-14-170517,170517,0,1,0,302,0.0,0.0009296965,6
2020-06-15-170517,170517,1,0,1,303,0.8,0.20201449,0
2020-06-16-170517,170517,0,0,1,303,1.0,0.12559988,1
2020-06-17-170517,170517,2,0,0,305,0.6,0.16476879,2
2020-06-18-170517,170517,0,0,1,305,0.4,0.30507368,3
2020-06-19-170517,170517,0,0,0,305,1.0,0.20733334,4
2020-06-20-170517,170517,0,0,1,305,0.0,0.013846943,5
2020-06-21-170517,170517,0,0,0,305,0.0,0.0061290357,6
2020-06-22-170517,170517,0,0,1,305,0.2,0.021929594,0
2020-06-23-170517,170517,0,0,2,305,0.0,0.035405826,1
2020-06-24-170517,170517,1,1,0,306,0.6,0.17013659,2
2020-06-25-170517,170517,1,0,1,307,0.2,0.23482653,3
2020-06-26-170517,170517,1,0,0,308,0.6,0.17993087,4
2020-06-27-170517,170517,1,0,0,309,0.0,0.13007692,5
2020-06-28-170517,170517,0,0,0,309,0.2,0.0031635517,6
2020-06-29-170517,170517,1,0,0,310,0.2,0.17838205,0
2020-06-30-170517,170517,1,0,1,311,0.0,0.058627356,1
2020-07-01-170517,170517,0,0,5,311,0.0,0.02601176,2
2020-07-02-170517,170517,1,0,1,312,0.0,0.22791106,3
2020-07-03-170517,170517,0,0,0,312,0.4,0.113305815,4
2020-07-04-170517,170517,1,0,0,313,0.0,0.005273205,5
2020-07-05-170517,170517,0,0,0,313,0.2,0.004824238,6
2020-07-06-170517,170517,1,0,0,314,0.2,0.24833293,0
2020-07-07-170517,170517,2,1,0,316,0.0,0.31617945,1
2020-07-08-170517,170517,0,0,0,316,0.0,0.012053714,2
2020-07-09-170517,170517,1,0,0,317,0.2,0.014665398,3
2020-07-10-170517,170517,0,0,1,317,0.8,0.20692942,4
2020-07-11-170517,170517,0,0,0,317,0.0,0.0035995278,5
2020-07-12-170517,170517,0,0,1,317,0.0,0.007787003,6
2020-07-13-170517,170517,0,0,1,317,0.2,0.015645219,0
2020-07-14-170517,170517,1,0,0,318,0.8,0.034512598,1
2020-07-15-170517,170517,5,0,1,323,0.4,0.030335674,2
2020-07-16-170517,170517,1,0,2,324,0.0,0.051385317,3
2020-07-17-170517,170517,0,0,3,324,0.2,0.02147268,4
2020-07-18-170517,170517,0,0,0,324,0.0,0.004076901,5
2020-07-19-170517,170517,0,0,0,324,0.0,0.011843858,6
2020-07-20-170517,170517,0,0,1,324,0.0,0.018689293,0
2020-07-21-170517,170517,0,0,1,324,0.0,0.10071321,1
2020-07-22-170517,170517,0,0,1,324,0.2,0.12251699,2
2020-07-23-170517,170517,0,0,3,324,0.6,0.33772498,3
2020-07-24-170517,170517,1,0,0,325,0.0,0.18889889,4
2020-07-25-170517,170517,0,0,0,325,0.0,0.01025895,5
2020-07-26-170517,170517,1,0,1,326,0.0,0.0021366759,6
2020-07-27-170517,170517,1,0,1,327,0.8,0.4265946,0
2020-07-28-170517,170517,0,0,1,327,0.2,0.11467313,1
2020-07-29-170517,170517,1,0,3,328,0.0,0.17448965,2
2020-07-30-170517,170517,2,0,2,330,0.6,0.30310026,3
2020-07-31-170517,170517,3,0,1,333,0.0,0.19809268,4
2020-08-01-170517,170517,0,0,2,333,0.0,0.014357324,5
2020-08-02-170517,170517,0,0,1,333,0.0,0.023060791,6
2020-08-03-170517,170517,1,0,6,334,0.2,0.22886012,0
2020-08-04-170517,170517,1,0,4,335,1.0,0.22217818,1
2020-08-05-170517,170517,1,0,0,336,2.4,0.53821105,2
2020-08-06-170517,170517,3,0,3,339,0.2,0.5842886,3
2020-08-07-170517,170517,0,0,6,339,0.8,0.37432295,4
2020-08-08-170517,170517,0,0,0,339,0.4,0.07472729,5
2020-08-09-170517,170517,1,0,2,340,0.4,0.35458234,6
2020-08-10-170517,170517,1,0,2,341,0.2,0.09775449,0
2020-08-11-170517,170517,1,0,3,342,1.2,0.3297185,1
2020-08-12-170517,170517,3,0,5,345,1.4,0.47319534,2
2020-08-13-170517,170517,2,0,9,347,2.0,0.30627823,3
2020-08-14-170517,170517,1,0,5,348,2.4,0.8666487,4
2020-08-15-170517,170517,2,0,3,350,0.2,0.1813843,5
2020-08-16-170517,170517,1,0,1,351,0.2,0.13334382,6
2020-08-17-170517,170517,6,0,0,357,0.8,0.73961693,0
2020-08-18-170517,170517,4,0,1,361,1.2,1.0104699,1
2020-08-19-170517,170517,0,0,2,361,1.2,1.1494086,2
2020-08-20-170517,170517,3,0,2,364,1.0,0.53872573,3
2020-08-21-170517,170517,6,0,5,370,0.8,1.217132,4
2020-08-22-170517,170517,0,0,0,370,0.2,0.22604205,5
2020-08-23-170517,170517,2,0,2,372,0.4,0.36734584,6
2020-08-24-170517,170517,2,0,6,374,0.8,0.70093375,0
2020-08-25-170517,170517,3,0,4,377,0.8,0.27925047,1
2020-08-26-170517,170517,5,0,4,382,0.6,0.725153,2
2020-08-27-170517,170517,9,0,5,391,0.4,0.2877914,3
2020-08-28-170517,170517,5,0,3,396,1.0,0.8886306,4
2020-08-29-170517,170517,3,1,3,399,0.0,0.28510678,5
2020-08-30-170517,170517,1,0,3,400,1.8,0.5400862,6
2020-08-31-170517,170517,0,0,10,400,0.2,0.19952652,0
2020-09-01-170517,170517,1,0,1,401,2.8,0.8234306,1
2020-09-02-170517,170517,2,0,4,403,0.0,0.38219643,2
2020-09-03-170517,170517,2,0,13,405,1.2,1.538162,3
2020-09-04-170517,170517,5,1,16,410,1.4,1.2752026,4
2020-09-05-170517,170517,0,0,2,410,0.2,0.5768649,5
2020-09-06-170517,170517,2,0,6,412,2.6,1.1567689,6
2020-09-07-170517,170517,6,0,5,418,0.6,1.0689913,0
2020-09-08-170517,170517,4,0,6,422,1.4,1.5202662,1
2020-09-09-170517,170517,4,0,9,426,1.2,1.2224782,2
2020-09-10-170517,170517,5,0,7,431,0.8,0.9497275,3
2020-09-11-170517,170517,3,0,4,434,0.8,1.200871,4
2020-09-12-170517,170517,3,0,2,437,1.0,0.58253855,5
2020-09-13-170517,170517,3,0,1,440,1.4,0.62791497,6
2020-09-14-170517,170517,10,0,3,450,3.6,1.6787305,0
2020-09-15-170517,170517,1,0,2,451,4.8,2.315012,1
2020-09-16-170517,170517,4,0,4,455,2.2,0.83648247,2
2020-09-17-170517,170517,13,0,7,468,2.6,1.0542381,3
2020-09-18-170517,170517,16,0,9,484,3.2,2.7707658,4
2020-09-19-170517,170517,2,1,2,486,4.0,0.40571728,5
2020-09-20-170517,170517,6,2,0,492,2.0,0.8616695,6
2020-09-21-170517,170517,5,0,3,497,2.0,1.0770994,0
2020-09-22-170517,170517,6,1,10,503,2.8,0.30015534,1
2020-09-23-170517,170517,9,1,4,512,3.2,0.59997004,2
2020-09-24-170517,170517,7,0,14,519,0.8,0.9739861,3
2020-09-25-170517,170517,4,0,12,523,2.8,0.45559132,4
2020-09-26-170517,170517,2,0,7,525,3.4,0.79347074,5
2020-09-27-170517,170517,1,0,1,526,2.2,0.5907784,6
2020-09-28-170517,170517,3,0,0,529,1.0,0.8727309,0
2020-09-29-170517,170517,2,0,0,531,1.6,0.41418624,1
2020-09-30-170517,170517,4,0,8,535,2.2,1.060774,2
2020-10-01-170517,170517,7,0,6,542,1.2,0.956961,3
2020-10-02-170517,170517,9,0,12,551,1.0,1.2865132,4
2020-10-03-170517,170517,2,1,3,553,1.4,0.8784805,5
2020-10-04-170517,170517,0,2,5,553,0.2,0.28345534,6
2020-10-05-170517,170517,3,0,6,556,1.4,0.87646073,0
2020-10-06-170517,170517,10,1,14,566,0.4,1.4048033,1
2020-10-07-170517,170517,4,0,3,570,1.4,1.0261693,2
2020-10-08-170517,170517,14,0,11,584,1.2,2.4220402,3
2020-10-09-170517,170517,12,0,29,596,2.0,0.6386707,4
2020-10-10-170517,170517,7,0,20,603,2.8,1.1369115,5
2020-10-11-170517,170517,1,0,6,604,1.0,0.2344283,6
2020-10-12-170517,170517,0,0,12,604,1.2,0.12116537,0
2020-10-13-170517,170517,0,0,14,604,2.4,0.5542828,1
2020-10-14-170517,170517,8,0,10,612,2.4,2.2125216,2
2020-10-15-170517,170517,6,0,14,618,1.8,1.0555818,3
2020-10-16-170517,170517,12,0,20,630,2.6,1.9886229,4
2020-10-17-170517,170517,3,0,13,633,1.4,0.67958313,5
2020-10-18-170517,170517,5,0,4,638,1.2,0.6376459,6
2020-10-19-170517,170517,6,0,2,644,1.8,1.2222365,0
2020-10-20-170517,170517,14,0,9,658,3.4,2.4631324,1
2020-10-21-170517,170517,3,0,10,661,2.0,0.85940444,2
2020-10-22-170517,170517,11,0,13,672,0.8,1.9498447,3
2020-10-23-170517,170517,29,0,13,701,1.8,3.0214968,4
2020-10-24-170517,170517,20,0,12,721,1.4,2.7947896,5
2020-10-25-170517,170517,6,0,2,727,0.8,0.7214445,6
2020-10-26-170517,170517,12,0,7,739,2.6,3.2337937,0
2020-10-27-170517,170517,14,0,5,753,4.4,2.4020815,1
2020-10-28-170517,170517,10,1,6,763,4.2,3.5929508,2
2020-10-29-170517,170517,14,0,5,777,2.6,3.4698095,3
2020-10-30-170517,170517,20,0,11,797,2.8,2.2306798,4
2020-10-31-170517,170517,13,0,0,810,2.4,1.9857419,5
2020-11-01-170517,170517,4,1,0,814,1.6,1.221018,6
2020-11-02-170517,170517,2,0,0,816,1.6,0.38784915,0
2020-11-03-170517,170517,9,1,0,825,2.8,2.3081336,1
2020-11-04-170517,170517,10,1,0,835,4.8,3.926622,2
2020-11-05-170517,170517,13,0,0,848,3.8,6.3929725,3
2020-11-06-170517,170517,13,0,0,861,9.2,2.8106701,4
2020-11-07-170517,170517,12,0,0,873,13.0,4.2768726,5
2020-11-08-170517,170517,2,1,0,875,2.0,0.41552308,6
2020-11-09-170517,170517,7,0,0,882,3.2,2.5446205,0
2020-11-10-170517,170517,5,0,0,887,3.6,2.0512497,1
2020-11-11-170517,170517,6,2,0,893,1.8,1.0093727,2
2020-11-12-170517,170517,5,0,0,898,4.0,2.3359993,3
2020-11-13-170517,170517,11,1,0,909,6.6,2.4357405,4
2020-03-01-170518,170518,0,0,0,0,0.0,0.00015047853,6
2020-03-02-170518,170518,0,0,0,0,0.0,4.5471097e-05,0
2020-03-03-170518,170518,0,0,0,0,0.0,3.466154e-05,1
2020-03-04-170518,170518,0,0,2,0,0.0,0.0003909293,2
2020-03-05-170518,170518,0,1,2,0,0.0,3.2291933e-07,3
2020-03-06-170518,170518,0,0,2,0,0.0,0.00044023868,4
2020-03-07-170518,170518,0,0,1,0,0.0,4.545643e-05,5
2020-03-08-170518,170518,0,0,2,0,0.0,0.025365582,6
2020-03-09-170518,170518,0,0,3,0,0.3333333333333333,0.042773902,0
2020-03-10-170518,170518,0,0,1,0,0.3333333333333333,0.009498012,1
2020-03-11-170518,170518,0,0,0,0,0.16666666666666666,0.0049751587,2
2020-03-12-170518,170518,0,0,2,0,0.16666666666666666,0.017759139,3
2020-03-13-170518,170518,0,0,4,0,0.3333333333333333,0.100219384,4
2020-03-14-170518,170518,0,0,0,0,0.16666666666666666,0.012414852,5
2020-03-15-170518,170518,0,0,3,0,0.8333333333333334,0.09219409,6
2020-03-16-170518,170518,0,0,0,0,1.5,0.32189593,0
2020-03-17-170518,170518,0,0,3,0,1.8333333333333333,0.25717545,1
2020-03-18-170518,170518,2,0,1,2,1.8333333333333333,0.56703806,2
2020-03-19-170518,170518,2,1,0,4,2.0,0.7193219,3
2020-03-20-170518,170518,2,0,0,6,4.666666666666667,0.99773306,4
2020-03-21-170518,170518,1,2,1,7,1.8333333333333333,0.52516454,5
2020-03-22-170518,170518,2,0,1,9,1.5,0.50087607,6
2020-03-23-170518,170518,3,0,0,12,4.833333333333333,1.2989858,0
2020-03-24-170518,170518,1,0,3,13,3.333333333333333,0.750517,1
2020-03-25-170518,170518,0,0,1,13,3.0,0.4872451,2
2020-03-26-170518,170518,2,0,0,15,4.333333333333333,1.0184613,3
2020-03-27-170518,170518,4,0,1,19,5.166666666666667,1.9844189,4
2020-03-28-170518,170518,0,0,0,19,1.5,0.22448936,5
2020-03-29-170518,170518,3,0,0,22,0.5,0.47496113,6
2020-03-30-170518,170518,0,0,0,22,3.0,0.8430232,0
2020-03-31-170518,170518,3,0,0,25,2.0,0.7097422,1
2020-04-01-170518,170518,1,0,0,26,3.333333333333333,0.7067662,2
2020-04-02-170518,170518,0,0,1,26,7.0,0.35941437,3
2020-04-03-170518,170518,0,0,0,26,2.1666666666666665,0.23309776,4
2020-04-04-170518,170518,1,0,0,27,1.0,0.32909223,5
2020-04-05-170518,170518,1,0,0,28,1.5,0.35544792,6
2020-04-06-170518,170518,0,0,0,28,2.6666666666666665,0.34411427,0
2020-04-07-170518,170518,3,0,2,31,2.5,0.8729089,1
2020-04-08-170518,170518,1,0,0,32,2.1666666666666665,0.55079174,2
2020-04-09-170518,170518,0,0,0,32,2.0,0.4838333,3
2020-04-10-170518,170518,1,0,0,33,1.0,0.39177513,4
2020-04-11-170518,170518,0,1,0,33,0.8333333333333334,0.19344983,5
2020-04-12-170518,170518,0,0,0,33,0.5,0.08347785,6
2020-04-13-170518,170518,0,0,0,33,2.1666666666666665,0.3817171,0
2020-04-14-170518,170518,0,0,0,33,1.0,0.11229967,1
2020-04-15-170518,170518,0,0,2,33,1.1666666666666667,0.17833023,2
2020-04-16-170518,170518,1,0,0,34,0.8333333333333334,0.31670383,3
2020-04-17-170518,170518,0,1,0,34,1.1666666666666667,0.69746035,4
2020-04-18-170518,170518,0,0,0,34,0.16666666666666666,0.0037035698,5
2020-04-19-170518,170518,0,0,0,34,0.3333333333333333,0.02068069,6
2020-04-20-170518,170518,0,0,1,34,0.6666666666666666,0.40083784,0
2020-04-21-170518,170518,2,0,0,36,0.6666666666666666,0.5126055,1
2020-04-22-170518,170518,0,0,1,36,1.0,0.14020845,2
2020-04-23-170518,170518,0,0,0,36,0.16666666666666666,0.0684119,3
2020-04-24-170518,170518,0,0,0,36,0.8333333333333334,0.16607748,4
2020-04-25-170518,170518,0,0,0,36,0.3333333333333333,0.10012714,5
2020-04-26-170518,170518,0,0,0,36,0.3333333333333333,0.058428515,6
2020-04-27-170518,170518,0,1,0,36,1.1666666666666667,0.12775178,0
2020-04-28-170518,170518,0,0,0,36,0.6666666666666666,0.22212099,1
2020-04-29-170518,170518,2,0,0,38,1.1666666666666667,0.47731945,2
2020-04-30-170518,170518,0,0,0,38,0.8333333333333334,0.082590014,3
2020-05-01-170518,170518,0,0,0,38,0.5,0.029660003,4
2020-05-02-170518,170518,0,0,0,38,0.16666666666666666,0.09894867,5
2020-05-03-170518,170518,0,0,0,38,0.0,0.0010146911,6
2020-05-04-170518,170518,1,0,0,39,0.8333333333333334,0.36813632,0
2020-05-05-170518,170518,0,0,0,39,0.16666666666666666,0.058174238,1
2020-05-06-170518,170518,1,0,1,40,1.3333333333333333,0.39286083,2
2020-05-07-170518,170518,0,0,0,40,1.5,0.26333436,3
2020-05-08-170518,170518,0,0,0,40,0.6666666666666666,0.19806303,4
2020-05-09-170518,170518,0,2,0,40,0.3333333333333333,0.0059655695,5
2020-05-10-170518,170518,0,0,0,40,0.3333333333333333,0.009557924,6
2020-05-11-170518,170518,0,0,0,40,1.0,0.08807006,0
2020-05-12-170518,170518,0,0,0,40,0.5,0.12419622,1
2020-05-13-170518,170518,0,0,1,40,0.6666666666666666,0.1574151,2
2020-05-14-170518,170518,0,0,0,40,0.3333333333333333,0.06887364,3
2020-05-15-170518,170518,0,0,0,40,0.5,0.21124616,4
2020-05-16-170518,170518,0,0,0,40,0.0,0.0034044292,5
2020-05-17-170518,170518,0,0,0,40,0.0,0.004722776,6
2020-05-18-170518,170518,0,0,0,40,1.0,0.101670444,0
2020-05-19-170518,170518,0,0,0,40,1.5,0.33892304,1
2020-05-20-170518,170518,1,0,0,41,0.0,0.28616497,2
2020-05-21-170518,170518,0,0,0,41,0.5,0.10686305,3
2020-05-22-170518,170518,0,0,0,41,0.8333333333333334,0.12286587,4
2020-05-23-170518,170518,0,0,0,41,0.0,0.005602117,5
2020-05-24-170518,170518,0,0,0,41,0.0,0.00016312186,6
2020-05-25-170518,170518,0,0,0,41,0.16666666666666666,0.016008487,0
2020-05-26-170518,170518,0,0,0,41,0.5,0.13400836,1
2020-05-27-170518,170518,1,1,0,42,0.16666666666666666,0.30763733,2
2020-05-28-170518,170518,0,0,0,42,0.6666666666666666,0.19716555,3
2020-05-29-170518,170518,0,0,0,42,0.3333333333333333,0.23445132,4
2020-05-30-170518,170518,0,4,0,42,0.16666666666666666,0.0627421,5
2020-05-31-170518,170518,0,0,0,42,0.16666666666666666,0.039307903,6
2020-06-01-170518,170518,0,0,1,42,0.6666666666666666,0.2181742,0
2020-06-02-170518,170518,0,0,0,42,0.3333333333333333,0.15457381,1
2020-06-03-170518,170518,0,0,0,42,0.16666666666666666,0.09837686,2
2020-06-04-170518,170518,0,0,0,42,0.0,0.094935775,3
2020-06-05-170518,170518,0,0,0,42,0.3333333333333333,0.2049953,4
2020-06-06-170518,170518,0,0,0,42,0.0,0.020111745,5
2020-06-07-170518,170518,0,0,0,42,0.0,8.1739796e-05,6
2020-06-08-170518,170518,0,0,0,42,0.16666666666666666,0.11612895,0
2020-06-09-170518,170518,0,0,0,42,0.3333333333333333,0.037135396,1
2020-06-10-170518,170518,0,0,0,42,0.16666666666666666,0.16154803,2
2020-06-11-170518,170518,0,0,0,42,0.0,0.15790421,3
2020-06-12-170518,170518,0,0,0,42,0.5,0.115045756,4
2020-06-13-170518,170518,0,0,0,42,0.16666666666666666,0.09288725,5
2020-06-14-170518,170518,0,0,0,42,0.16666666666666666,0.0058142254,6
2020-06-15-170518,170518,1,0,0,43,0.6666666666666666,0.30971834,0
2020-06-16-170518,170518,0,0,2,43,0.6666666666666666,0.056016527,1
2020-06-17-170518,170518,0,0,0,43,0.16666666666666666,0.02753216,2
2020-06-18-170518,170518,0,0,0,43,0.3333333333333333,0.069733754,3
2020-06-19-170518,170518,0,0,0,43,0.5,0.15766768,4
2020-06-20-170518,170518,0,0,0,43,0.0,0.029409807,5
2020-06-21-170518,170518,0,0,0,43,0.0,0.0074610235,6
2020-06-22-170518,170518,0,0,0,43,0.16666666666666666,0.0032528276,0
2020-06-23-170518,170518,0,0,0,43,0.0,0.023577046,1
2020-06-24-170518,170518,0,0,0,43,0.16666666666666666,0.05743428,2
2020-06-25-170518,170518,0,0,0,43,0.16666666666666666,0.08314704,3
2020-06-26-170518,170518,0,0,0,43,0.3333333333333333,0.21471578,4
2020-06-27-170518,170518,0,0,0,43,0.0,0.03522593,5
2020-06-28-170518,170518,0,0,0,43,0.0,0.00060911913,6
2020-06-29-170518,170518,0,0,0,43,0.3333333333333333,0.12331615,0
2020-06-30-170518,170518,2,0,0,45,0.0,0.6551656,1
2020-07-01-170518,170518,0,0,0,45,0.0,0.035496507,2
2020-07-02-170518,170518,0,0,0,45,0.0,0.045512732,3
2020-07-03-170518,170518,0,0,0,45,0.3333333333333333,0.20413949,4
2020-07-04-170518,170518,0,0,0,45,0.0,0.0019991908,5
2020-07-05-170518,170518,0,0,0,45,0.0,0.0019794365,6
2020-07-06-170518,170518,0,0,0,45,0.0,0.060147896,0
2020-07-07-170518,170518,0,0,0,45,0.0,0.008457415,1
2020-07-08-170518,170518,0,0,0,45,0.0,0.03679227,2
2020-07-09-170518,170518,0,0,0,45,0.0,0.004297173,3
2020-07-10-170518,170518,0,0,0,45,0.6666666666666666,0.24605802,4
2020-07-11-170518,170518,0,0,0,45,0.0,0.013221845,5
2020-07-12-170518,170518,0,0,0,45,0.0,0.0025577578,6
2020-07-13-170518,170518,0,0,0,45,0.0,0.002416504,0
2020-07-14-170518,170518,0,0,1,45,0.3333333333333333,0.12336621,1
2020-07-15-170518,170518,0,0,0,45,0.16666666666666666,0.12303077,2
2020-07-16-170518,170518,0,0,0,45,0.16666666666666666,0.14011239,3
2020-07-17-170518,170518,0,0,0,45,0.3333333333333333,0.013252727,4
2020-07-18-170518,170518,0,0,0,45,0.0,0.00049432076,5
2020-07-19-170518,170518,0,0,0,45,0.16666666666666666,0.060790367,6
2020-07-20-170518,170518,0,0,0,45,0.16666666666666666,0.08802871,0
2020-07-21-170518,170518,0,0,0,45,0.0,0.017320829,1
2020-07-22-170518,170518,0,0,1,45,0.16666666666666666,0.105588034,2
2020-07-23-170518,170518,0,0,0,45,0.5,0.20945515,3
2020-07-24-170518,170518,0,0,0,45,0.0,0.070388556,4
2020-07-25-170518,170518,0,0,0,45,0.0,0.0010176041,5
2020-07-26-170518,170518,0,0,0,45,0.0,0.0003752686,6
2020-07-27-170518,170518,0,0,0,45,0.6666666666666666,0.15564303,0
2020-07-28-170518,170518,1,0,1,46,0.3333333333333333,0.33362302,1
2020-07-29-170518,170518,0,0,0,46,0.0,0.042323977,2
2020-07-30-170518,170518,0,0,0,46,0.5,0.19335589,3
2020-07-31-170518,170518,0,0,1,46,0.0,0.0430572,4
2020-08-01-170518,170518,0,0,0,46,0.0,0.035964776,5
2020-08-02-170518,170518,0,0,1,46,0.16666666666666666,0.09613371,6
2020-08-03-170518,170518,0,0,0,46,0.16666666666666666,0.08065025,0
2020-08-04-170518,170518,0,0,0,46,0.6666666666666666,0.12416787,1
2020-08-05-170518,170518,1,0,0,47,2.0,0.5334885,2
2020-08-06-170518,170518,0,0,0,47,0.3333333333333333,0.4017308,3
2020-08-07-170518,170518,0,0,0,47,1.0,0.3584613,4
2020-08-08-170518,170518,0,0,0,47,0.3333333333333333,0.040917065,5
2020-08-09-170518,170518,0,0,0,47,0.0,0.018762661,6
2020-08-10-170518,170518,0,0,0,47,0.5,0.032678228,0
2020-08-11-170518,170518,1,0,0,48,1.0,0.11761117,1
2020-08-12-170518,170518,0,0,0,48,0.6666666666666666,0.22773948,2
2020-08-13-170518,170518,0,0,0,48,1.1666666666666667,0.07374503,3
2020-08-14-170518,170518,1,0,0,49,2.1666666666666665,0.54759043,4
2020-08-15-170518,170518,0,0,0,49,0.16666666666666666,0.08453234,5
2020-08-16-170518,170518,1,0,0,50,0.8333333333333334,0.4810845,6
2020-08-17-170518,170518,0,0,0,50,2.0,0.21243969,0
2020-08-18-170518,170518,0,0,1,50,1.0,0.14895844,1
2020-08-19-170518,170518,0,0,0,50,1.3333333333333333,0.6651821,2
2020-08-20-170518,170518,0,0,2,50,0.8333333333333334,0.3167158,3
2020-08-21-170518,170518,0,0,0,50,1.3333333333333333,0.8141321,4
2020-08-22-170518,170518,0,0,0,50,0.16666666666666666,0.29552224,5
2020-08-23-170518,170518,0,0,0,50,0.3333333333333333,0.15283896,6
2020-08-24-170518,170518,0,0,2,50,1.0,0.42323974,0
2020-08-25-170518,170518,0,0,0,50,0.8333333333333334,0.23605962,1
2020-08-26-170518,170518,0,0,4,50,0.8333333333333334,0.39640892,2
2020-08-27-170518,170518,0,0,0,50,0.5,0.6284021,3
2020-08-28-170518,170518,0,0,0,50,0.8333333333333334,0.15925251,4
2020-08-29-170518,170518,0,0,0,50,0.0,0.08690158,5
2020-08-30-170518,170518,0,0,0,50,1.5,0.12430424,6
2020-08-31-170518,170518,0,0,0,50,0.6666666666666666,0.10901872,0
2020-09-01-170518,170518,1,0,0,51,2.0,0.9585431,1
2020-09-02-170518,170518,0,0,0,51,0.16666666666666666,0.07902779,2
2020-09-03-170518,170518,2,0,0,53,0.16666666666666666,0.73561746,3
2020-09-04-170518,170518,0,0,0,53,1.3333333333333333,0.52116895,4
2020-09-05-170518,170518,0,0,0,53,0.5,0.5159944,5
2020-09-06-170518,170518,0,0,0,53,0.8333333333333334,0.27027407,6
2020-09-07-170518,170518,2,0,0,55,1.1666666666666667,0.47621685,0
2020-09-08-170518,170518,0,0,0,55,0.6666666666666666,0.27891126,1
2020-09-09-170518,170518,4,0,0,59,1.3333333333333333,1.6549988,2
2020-09-10-170518,170518,0,0,0,59,0.5,0.3253304,3
2020-09-11-170518,170518,0,0,0,59,0.3333333333333333,0.35265368,4
2020-09-12-170518,170518,0,0,0,59,1.1666666666666667,0.1683602,5
2020-09-13-170518,170518,0,0,0,59,2.6666666666666665,0.63869286,6
2020-09-14-170518,170518,0,0,0,59,3.333333333333333,0.40935647,0
2020-09-15-170518,170518,0,0,0,59,3.0,0.57941836,1
2020-09-16-170518,170518,0,0,1,59,0.8333333333333334,0.20200127,2
2020-09-17-170518,170518,0,0,0,59,0.6666666666666666,0.2584792,3
2020-09-18-170518,170518,0,0,2,59,2.0,0.4282779,4
2020-09-19-170518,170518,0,0,0,59,3.333333333333333,0.19036376,5
2020-09-20-170518,170518,0,0,0,59,1.1666666666666667,0.17016684,6
2020-09-21-170518,170518,0,0,0,59,1.5,0.37252983,0
2020-09-22-170518,170518,0,0,0,59,3.5,0.2490337,1
2020-09-23-170518,170518,0,0,0,59,2.5,0.38990337,2
2020-09-24-170518,170518,0,0,1,59,1.0,0.3487881,3
2020-09-25-170518,170518,0,0,1,59,1.1666666666666667,0.33050355,4
2020-09-26-170518,170518,0,0,0,59,2.0,0.48370245,5
2020-09-27-170518,170518,0,0,0,59,1.5,0.39709407,6
2020-09-28-170518,170518,0,0,0,59,0.6666666666666666,0.22795889,0
2020-09-29-170518,170518,0,0,0,59,0.5,0.063470095,1
2020-09-30-170518,170518,1,1,31,60,1.1666666666666667,0.49785233,2
2020-10-01-170518,170518,0,0,0,60,1.3333333333333333,0.43702504,3
2020-10-02-170518,170518,2,0,1,62,2.1666666666666665,0.969173,4
2020-10-03-170518,170518,0,0,0,62,1.0,0.22597149,5
2020-10-04-170518,170518,0,1,1,62,0.3333333333333333,0.26188236,6
2020-10-05-170518,170518,0,0,0,62,1.3333333333333333,0.37961394,0
2020-10-06-170518,170518,0,0,3,62,0.8333333333333334,0.3498613,1
2020-10-07-170518,170518,0,0,0,62,1.1666666666666667,0.3162121,2
2020-10-08-170518,170518,1,0,0,63,1.6666666666666667,0.49724957,3
2020-10-09-170518,170518,1,0,3,64,1.1666666666666667,0.3517367,4
2020-10-10-170518,170518,0,0,1,64,1.0,0.5082258,5
2020-10-11-170518,170518,0,0,0,64,2.1666666666666665,0.1310486,6
2020-10-12-170518,170518,0,0,0,64,1.3333333333333333,0.15299188,0
2020-10-13-170518,170518,0,0,0,64,2.833333333333333,0.36236992,1
2020-10-14-170518,170518,31,0,11,95,2.5,5.9543853,2
2020-10-15-170518,170518,0,0,1,95,1.8333333333333333,0.5596532,3
2020-10-16-170518,170518,1,0,0,96,2.5,0.6691067,4
2020-10-17-170518,170518,0,0,1,96,2.333333333333333,0.21422713,5
2020-10-18-170518,170518,1,1,1,97,2.333333333333333,0.34690335,6
2020-10-19-170518,170518,0,0,0,97,7.833333333333332,0.5809998,0
2020-10-20-170518,170518,3,0,0,100,4.166666666666667,0.951708,1
2020-10-21-170518,170518,0,0,2,100,10.5,0.63440806,2
2020-10-22-170518,170518,0,0,2,100,7.666666666666668,0.80986905,3
2020-10-23-170518,170518,3,0,0,103,6.333333333333332,0.8306748,4
2020-10-24-170518,170518,1,0,6,104,2.1666666666666665,0.5895544,5
2020-10-25-170518,170518,0,0,0,104,2.6666666666666665,0.36897734,6
2020-10-26-170518,170518,0,0,1,104,4.833333333333333,0.6919163,0
2020-10-27-170518,170518,0,0,0,104,5.333333333333333,0.39688087,1
2020-10-28-170518,170518,11,2,3,115,5.666666666666668,2.5151913,2
2020-10-29-170518,170518,1,1,1,116,2.833333333333333,0.6754855,3
2020-10-30-170518,170518,0,1,2,116,5.5,0.9976734,4
2020-10-31-170518,170518,1,0,0,117,2.833333333333333,0.3673271,5
2020-11-01-170518,170518,1,1,0,118,0.8333333333333334,0.5099721,6
2020-11-02-170518,170518,0,2,0,118,2.0,0.375683,0
2020-11-03-170518,170518,0,0,0,118,4.166666666666667,0.67219436,1
2020-11-04-170518,170518,2,0,0,120,7.0,2.050271,2
2020-11-05-170518,170518,2,0,0,122,4.166666666666667,1.2216058,3
2020-11-06-170518,170518,0,0,0,122,5.0,0.31324407,4
2020-11-07-170518,170518,6,0,0,128,9.333333333333334,2.995819,5
2020-11-08-170518,170518,0,0,0,128,2.1666666666666665,0.4235465,6
2020-11-09-170518,170518,1,0,0,129,3.1666666666666665,0.7292002,0
2020-11-10-170518,170518,0,0,0,129,3.6666666666666665,0.49016342,1
2020-11-11-170518,170518,3,0,0,132,2.5,0.67855805,2
2020-11-12-170518,170518,1,0,0,133,4.0,0.72337073,3
2020-11-13-170518,170518,2,0,0,135,3.8333333333333335,0.9238747,4
2020-03-01-170519,170519,0,0,1,0,0.0,1.5018925e-07,6
2020-03-02-170519,170519,0,0,1,0,0.0,3.2584476e-06,0
2020-03-03-170519,170519,0,0,1,0,0.0,4.6933224e-10,1
2020-03-04-170519,170519,0,0,0,0,0.0,1.489644e-05,2
2020-03-05-170519,170519,0,0,1,0,0.0,4.6857853e-08,3
2020-03-06-170519,170519,0,0,9,0,0.0,0.00019644303,4
2020-03-07-170519,170519,0,1,3,0,0.0,0.00013317066,5
2020-03-08-170519,170519,0,0,2,0,0.0,0.014567889,6
2020-03-09-170519,170519,0,0,6,0,0.16666666666666666,0.07333764,0
2020-03-10-170519,170519,0,0,2,0,0.0,0.00044290005,1
2020-03-11-170519,170519,0,0,2,0,0.16666666666666666,0.010084146,2
2020-03-12-170519,170519,0,0,3,0,0.0,0.027547041,3
2020-03-13-170519,170519,1,0,4,1,0.0,0.093562834,4
2020-03-14-170519,170519,0,0,2,1,0.0,0.011191323,5
2020-03-15-170519,170519,1,0,0,2,0.3333333333333333,0.066001564,6
2020-03-16-170519,170519,1,0,7,3,0.8333333333333334,0.23197746,0
2020-03-17-170519,170519,1,0,2,4,0.6666666666666666,0.15487777,1
2020-03-18-170519,170519,0,0,3,4,1.1666666666666667,0.28871453,2
2020-03-19-170519,170519,1,1,2,5,1.0,0.40393972,3
2020-03-20-170519,170519,9,0,1,14,0.8333333333333334,0.6772526,4
2020-03-21-170519,170519,3,0,1,17,1.1666666666666667,0.32847598,5
2020-03-22-170519,170519,2,0,0,19,1.0,0.25350666,6
2020-03-23-170519,170519,6,0,1,25,2.333333333333333,0.8687632,0
2020-03-24-170519,170519,2,0,2,27,1.5,0.43772942,1
2020-03-25-170519,170519,2,0,1,29,0.8333333333333334,0.30463353,2
2020-03-26-170519,170519,3,0,0,32,1.5,0.5649993,3
2020-03-27-170519,170519,4,0,0,36,2.833333333333333,1.0849773,4
2020-03-28-170519,170519,2,0,2,38,0.6666666666666666,0.19131488,5
2020-03-29-170519,170519,0,1,0,38,0.8333333333333334,0.26913738,6
2020-03-30-170519,170519,7,0,2,45,1.5,0.59211427,0
2020-03-31-170519,170519,2,0,0,47,1.6666666666666667,0.43021044,1
2020-04-01-170519,170519,3,1,1,50,1.6666666666666667,0.44592503,2
2020-04-02-170519,170519,2,0,0,52,0.6666666666666666,0.18028332,3
2020-04-03-170519,170519,1,0,2,53,1.3333333333333333,0.19255042,4
2020-04-04-170519,170519,1,0,0,54,1.1666666666666667,0.23780252,5
2020-04-05-170519,170519,0,1,0,54,0.8333333333333334,0.1968097,6
2020-04-06-170519,170519,1,0,0,55,1.0,0.20100498,0
2020-04-07-170519,170519,2,0,0,57,0.6666666666666666,0.437059,1
2020-04-08-170519,170519,1,0,0,58,1.1666666666666667,0.34969664,2
2020-04-09-170519,170519,0,0,0,58,2.1666666666666665,0.29628596,3
2020-04-10-170519,170519,0,0,0,58,4.333333333333333,0.566848,4
2020-04-11-170519,170519,2,0,1,60,0.3333333333333333,0.10867469,5
2020-04-12-170519,170519,0,0,0,60,0.8333333333333334,0.07187736,6
2020-04-13-170519,170519,2,0,0,62,1.5,0.409488,0
2020-04-14-170519,170519,0,0,1,62,0.8333333333333334,0.119641796,1
2020-04-15-170519,170519,1,0,0,63,0.8333333333333334,0.18804443,2
2020-04-16-170519,170519,0,0,0,63,1.1666666666666667,0.20904824,3
2020-04-17-170519,170519,2,0,0,65,2.833333333333333,0.5885505,4
2020-04-18-170519,170519,0,0,0,65,0.16666666666666666,0.0020021347,5
2020-04-19-170519,170519,0,0,0,65,0.5,0.03442109,6
2020-04-20-170519,170519,0,0,0,65,2.833333333333333,0.45329073,0
2020-04-21-170519,170519,0,0,0,65,0.6666666666666666,0.29099244,1
2020-04-22-170519,170519,0,0,1,65,0.6666666666666666,0.11404787,2
2020-04-23-170519,170519,0,0,0,65,0.6666666666666666,0.0880026,3
2020-04-24-170519,170519,0,0,1,65,0.8333333333333334,0.16411106,4
2020-04-25-170519,170519,1,0,0,66,1.1666666666666667,0.1453264,5
2020-04-26-170519,170519,0,0,0,66,0.6666666666666666,0.067719325,6
2020-04-27-170519,170519,0,0,0,66,0.3333333333333333,0.08697541,0
2020-04-28-170519,170519,1,0,0,67,0.3333333333333333,0.1260782,1
2020-04-29-170519,170519,0,0,1,67,1.1666666666666667,0.30131486,2
2020-04-30-170519,170519,0,0,0,67,0.16666666666666666,0.06612589,3
2020-05-01-170519,170519,0,0,1,67,0.0,0.020483583,4
2020-05-02-170519,170519,0,0,0,67,0.6666666666666666,0.1177983,5
2020-05-03-170519,170519,0,0,0,67,0.0,0.0008688179,6
2020-05-04-170519,170519,0,0,2,67,1.1666666666666667,0.27231604,0
2020-05-05-170519,170519,0,0,0,67,0.0,0.022098426,1
2020-05-06-170519,170519,1,0,0,68,0.3333333333333333,0.20247234,2
2020-05-07-170519,170519,0,0,0,68,0.8333333333333334,0.20365949,3
2020-05-08-170519,170519,1,0,0,69,1.1666666666666667,0.2342127,4
2020-05-09-170519,170519,0,0,0,69,0.16666666666666666,0.0076579275,5
2020-05-10-170519,170519,0,0,0,69,0.3333333333333333,0.031328462,6
2020-05-11-170519,170519,0,0,0,69,0.3333333333333333,0.06828058,0
2020-05-12-170519,170519,0,0,1,69,0.5,0.09177906,1
2020-05-13-170519,170519,1,2,0,70,0.16666666666666666,0.13221242,2
2020-05-14-170519,170519,0,3,1,70,0.16666666666666666,0.052103676,3
2020-05-15-170519,170519,1,1,1,71,0.3333333333333333,0.17760941,4
2020-05-16-170519,170519,0,0,0,71,0.0,0.0009916067,5
2020-05-17-170519,170519,0,0,0,71,0.0,0.011256298,6
2020-05-18-170519,170519,2,0,0,73,0.16666666666666666,0.0978758,0
2020-05-19-170519,170519,0,0,2,73,0.5,0.19343086,1
2020-05-20-170519,170519,0,0,0,73,0.6666666666666666,0.2227967,2
2020-05-21-170519,170519,0,0,0,73,0.6666666666666666,0.22018008,3
2020-05-22-170519,170519,0,0,2,73,0.0,0.08685455,4
2020-05-23-170519,170519,0,0,0,73,0.16666666666666666,0.026636202,5
2020-05-24-170519,170519,0,0,0,73,0.0,1.576445e-05,6
2020-05-25-170519,170519,0,0,1,73,0.0,0.0148200495,0
2020-05-26-170519,170519,1,0,0,74,0.3333333333333333,0.15293536,1
2020-05-27-170519,170519,0,1,1,74,0.5,0.20676401,2
2020-05-28-170519,170519,1,0,0,75,0.0,0.14082953,3
2020-05-29-170519,170519,1,0,0,76,0.3333333333333333,0.25332308,4
2020-05-30-170519,170519,0,0,1,76,0.0,0.020895375,5
2020-05-31-170519,170519,0,0,0,76,0.16666666666666666,0.050520655,6
2020-06-01-170519,170519,0,0,0,76,1.1666666666666667,0.19069,0
2020-06-02-170519,170519,2,0,0,78,0.3333333333333333,0.1799053,1
2020-06-03-170519,170519,0,0,0,78,0.3333333333333333,0.10558743,2
2020-06-04-170519,170519,0,0,0,78,0.5,0.13134372,3
2020-06-05-170519,170519,2,0,0,80,0.8333333333333334,0.25766423,4
2020-06-06-170519,170519,0,0,0,80,0.0,0.016289065,5
2020-06-07-170519,170519,0,0,0,80,0.0,5.2435685e-06,6
2020-06-08-170519,170519,1,0,0,81,0.3333333333333333,0.12619728,0
2020-06-09-170519,170519,0,0,0,81,0.3333333333333333,0.05804558,1
2020-06-10-170519,170519,1,0,0,82,2.6666666666666665,0.4113563,2
2020-06-11-170519,170519,0,0,0,82,1.0,0.20978928,3
2020-06-12-170519,170519,0,0,2,82,0.16666666666666666,0.07864029,4
2020-06-13-170519,170519,1,1,0,83,0.0,0.053484105,5
2020-06-14-170519,170519,0,1,0,83,0.16666666666666666,0.00250536,6
2020-06-15-170519,170519,0,0,1,83,0.6666666666666666,0.21821113,0
2020-06-16-170519,170519,0,0,0,83,0.0,0.018137787,1
2020-06-17-170519,170519,0,0,0,83,0.16666666666666666,0.039537564,2
2020-06-18-170519,170519,0,0,0,83,0.5,0.10396885,3
2020-06-19-170519,170519,0,0,1,83,0.16666666666666666,0.07884186,4
2020-06-20-170519,170519,0,0,0,83,0.3333333333333333,0.06788678,5
2020-06-21-170519,170519,0,0,0,83,0.0,0.01404544,6
2020-06-22-170519,170519,0,0,0,83,0.0,0.0035428654,0
2020-06-23-170519,170519,0,0,0,83,0.5,0.08054507,1
2020-06-24-170519,170519,0,0,0,83,0.16666666666666666,0.072557084,2
2020-06-25-170519,170519,0,0,0,83,0.16666666666666666,0.06542197,3
2020-06-26-170519,170519,2,0,1,85,0.3333333333333333,0.19495368,4
2020-06-27-170519,170519,0,0,0,85,0.16666666666666666,0.049255837,5
2020-06-28-170519,170519,0,0,0,85,0.0,3.381111e-07,6
2020-06-29-170519,170519,1,0,0,86,0.16666666666666666,0.1284633,0
2020-06-30-170519,170519,0,0,0,86,0.5,0.33247948,1
2020-07-01-170519,170519,0,0,0,86,0.3333333333333333,0.0743686,2
2020-07-02-170519,170519,0,0,0,86,0.5,0.10578783,3
2020-07-03-170519,170519,1,0,0,87,0.3333333333333333,0.22159787,4
2020-07-04-170519,170519,0,0,0,87,0.0,0.0012878487,5
2020-07-05-170519,170519,0,0,0,87,0.16666666666666666,0.003102519,6
2020-07-06-170519,170519,0,0,1,87,1.0,0.16528976,0
2020-07-07-170519,170519,0,0,0,87,0.0,0.008282431,1
2020-07-08-170519,170519,0,0,0,87,0.16666666666666666,0.052207146,2
2020-07-09-170519,170519,0,0,0,87,0.0,0.002495398,3
2020-07-10-170519,170519,1,0,0,88,0.3333333333333333,0.17060499,4
2020-07-11-170519,170519,0,0,0,88,0.3333333333333333,0.044057075,5
2020-07-12-170519,170519,0,0,0,88,0.0,0.0004605295,6
2020-07-13-170519,170519,0,0,1,88,0.0,0.0017703846,0
2020-07-14-170519,170519,0,0,1,88,0.3333333333333333,0.16283958,1
2020-07-15-170519,170519,0,0,0,88,1.1666666666666667,0.15980394,2
2020-07-16-170519,170519,0,0,0,88,1.0,0.23831974,3
2020-07-17-170519,170519,0,0,0,88,0.16666666666666666,0.016452983,4
2020-07-18-170519,170519,0,0,0,88,0.0,0.0017494055,5
2020-07-19-170519,170519,0,0,1,88,0.16666666666666666,0.05738276,6
2020-07-20-170519,170519,1,0,0,89,0.0,0.09012218,0
2020-07-21-170519,170519,0,0,0,89,0.0,0.011568114,1
2020-07-22-170519,170519,0,0,0,89,0.0,0.049472027,2
2020-07-23-170519,170519,0,0,1,89,0.0,0.114315435,3
2020-07-24-170519,170519,0,0,0,89,0.3333333333333333,0.115586124,4
2020-07-25-170519,170519,0,0,0,89,0.16666666666666666,0.0017992368,5
2020-07-26-170519,170519,0,0,0,89,0.0,0.00017695973,6
2020-07-27-170519,170519,1,0,1,90,0.3333333333333333,0.16076058,0
2020-07-28-170519,170519,1,0,1,91,0.5,0.2679088,1
2020-07-29-170519,170519,0,0,0,91,0.0,0.035449278,2
2020-07-30-170519,170519,0,0,2,91,0.16666666666666666,0.07149861,3
2020-07-31-170519,170519,0,0,0,91,0.8333333333333334,0.057688497,4
2020-08-01-170519,170519,0,0,0,91,0.16666666666666666,0.04593008,5
2020-08-02-170519,170519,1,0,1,92,0.0,0.077207655,6
2020-08-03-170519,170519,0,0,0,92,0.0,0.025861185,0
2020-08-04-170519,170519,0,0,0,92,0.0,0.058087632,1
2020-08-05-170519,170519,0,0,0,92,0.3333333333333333,0.32139084,2
2020-08-06-170519,170519,1,0,1,93,0.16666666666666666,0.24421172,3
2020-08-07-170519,170519,0,0,1,93,0.16666666666666666,0.12118289,4
2020-08-08-170519,170519,0,0,0,93,0.0,0.020708269,5
2020-08-09-170519,170519,0,0,0,93,0.16666666666666666,0.038425583,6
2020-08-10-170519,170519,1,0,4,94,0.5,0.09413535,0
2020-08-11-170519,170519,1,0,0,95,0.3333333333333333,0.105544485,1
2020-08-12-170519,170519,0,0,0,95,1.5,0.21211149,2
2020-08-13-170519,170519,2,0,2,97,0.5,0.0972313,3
2020-08-14-170519,170519,0,0,0,97,0.16666666666666666,0.22904721,4
2020-08-15-170519,170519,0,0,0,97,0.0,0.06712713,5
2020-08-16-170519,170519,1,0,0,98,0.5,0.36136135,6
2020-08-17-170519,170519,0,0,0,98,0.5,0.1841531,0
2020-08-18-170519,170519,0,0,3,98,0.8333333333333334,0.17205407,1
2020-08-19-170519,170519,0,0,0,98,0.8333333333333334,0.3278281,2
2020-08-20-170519,170519,1,0,0,99,0.3333333333333333,0.25065318,3
2020-08-21-170519,170519,1,0,2,100,2.5,0.71624386,4
2020-08-22-170519,170519,0,0,1,100,0.16666666666666666,0.17669952,5
2020-08-23-170519,170519,0,0,0,100,1.1666666666666667,0.18710144,6
2020-08-24-170519,170519,4,0,0,104,1.0,0.44778597,0
2020-08-25-170519,170519,0,0,0,104,2.1666666666666665,0.3701816,1
2020-08-26-170519,170519,0,0,5,104,2.333333333333333,0.4384424,2
2020-08-27-170519,170519,2,0,1,106,4.333333333333333,0.89405507,3
2020-08-28-170519,170519,0,0,1,106,1.3333333333333333,0.19097552,4
2020-08-29-170519,170519,0,0,1,106,1.0,0.1508684,5
2020-08-30-170519,170519,0,0,1,106,0.6666666666666666,0.085859634,6
2020-08-31-170519,170519,0,0,0,106,1.1666666666666667,0.14589618,0
2020-09-01-170519,170519,3,0,1,109,0.3333333333333333,0.49838707,1
2020-09-02-170519,170519,0,0,0,109,0.3333333333333333,0.09527055,2
2020-09-03-170519,170519,0,0,0,109,1.0,0.37914735,3
2020-09-04-170519,170519,2,0,1,111,1.0,0.50826865,4
2020-09-05-170519,170519,1,0,0,112,0.16666666666666666,0.39932558,5
2020-09-06-170519,170519,0,0,0,112,0.3333333333333333,0.18130428,6
2020-09-07-170519,170519,0,0,3,112,0.8333333333333334,0.2895608,0
2020-09-08-170519,170519,0,0,0,112,2.0,0.28104916,1
2020-09-09-170519,170519,5,0,0,117,2.0,0.9840733,2
2020-09-10-170519,170519,1,0,0,118,1.6666666666666667,0.33078465,3
2020-09-11-170519,170519,1,0,0,119,0.6666666666666666,0.32216677,4
2020-09-12-170519,170519,1,0,0,120,0.16666666666666666,0.13073047,5
2020-09-13-170519,170519,1,0,0,121,2.1666666666666665,0.46292278,6
2020-09-14-170519,170519,0,0,0,121,1.0,0.3537342,0
2020-09-15-170519,170519,1,0,0,122,2.5,0.48958325,1
2020-09-16-170519,170519,0,0,0,122,0.8333333333333334,0.25810313,2
2020-09-17-170519,170519,0,0,1,122,0.6666666666666666,0.22949158,3
2020-09-18-170519,170519,1,0,0,123,1.5,0.38909358,4
2020-09-19-170519,170519,0,0,0,123,0.6666666666666666,0.105788566,5
2020-09-20-170519,170519,0,0,0,123,1.0,0.20269756,6
2020-09-21-170519,170519,3,0,0,126,0.16666666666666666,0.22122747,0
2020-09-22-170519,170519,0,0,0,126,1.3333333333333333,0.13001089,1
2020-09-23-170519,170519,0,0,0,126,1.0,0.30241755,2
2020-09-24-170519,170519,0,0,1,126,1.0,0.2891121,3
2020-09-25-170519,170519,0,1,0,126,0.5,0.39673397,4
2020-09-26-170519,170519,0,0,1,126,1.3333333333333333,0.3752357,5
2020-09-27-170519,170519,0,0,0,126,0.5,0.1712232,6
2020-09-28-170519,170519,0,0,0,126,0.16666666666666666,0.13876309,0
2020-09-29-170519,170519,0,0,0,126,0.8333333333333334,0.22057588,1
2020-09-30-170519,170519,0,0,0,126,1.0,0.3090634,2
2020-10-01-170519,170519,1,0,0,127,1.8333333333333333,0.4795382,3
2020-10-02-170519,170519,0,0,0,127,2.6666666666666665,0.6503077,4
2020-10-03-170519,170519,0,0,0,127,0.16666666666666666,0.117942,5
2020-10-04-170519,170519,0,0,0,127,1.5,0.30742946,6
2020-10-05-170519,170519,0,0,0,127,1.6666666666666667,0.41844815,0
2020-10-06-170519,170519,0,0,1,127,1.3333333333333333,0.3888256,1
2020-10-07-170519,170519,0,0,2,127,1.5,0.3783945,2
2020-10-08-170519,170519,1,0,0,128,1.3333333333333333,0.49762076,3
2020-10-09-170519,170519,0,0,2,128,0.3333333333333333,0.27557352,4
2020-10-10-170519,170519,1,0,2,129,2.0,0.5793587,5
2020-10-11-170519,170519,0,0,2,129,0.5,0.05512158,6
2020-10-12-170519,170519,0,0,5,129,1.6666666666666667,0.1336341,0
2020-10-13-170519,170519,0,0,1,129,1.5,0.3127932,1
2020-10-14-170519,170519,0,0,4,129,6.0,3.5985093,2
2020-10-15-170519,170519,0,0,2,129,1.8333333333333333,0.4132649,3
2020-10-16-170519,170519,0,0,0,129,1.6666666666666667,0.7386169,4
2020-10-17-170519,170519,0,0,2,129,1.8333333333333333,0.19755936,5
2020-10-18-170519,170519,0,0,1,129,0.8333333333333334,0.22548348,6
2020-10-19-170519,170519,0,0,1,129,3.0,0.31393197,0
2020-10-20-170519,170519,1,0,0,130,1.8333333333333333,0.63540584,1
2020-10-21-170519,170519,2,0,5,132,3.8333333333333335,0.40313792,2
2020-10-22-170519,170519,0,0,0,132,2.333333333333333,0.3403441,3
2020-10-23-170519,170519,2,0,0,134,2.0,0.47332203,4
2020-10-24-170519,170519,2,0,0,136,0.3333333333333333,0.33800954,5
2020-10-25-170519,170519,2,0,5,138,1.5,0.33960795,6
2020-10-26-170519,170519,5,1,0,143,0.8333333333333334,0.52400327,0
2020-10-27-170519,170519,1,0,1,144,1.1666666666666667,0.30529302,1
2020-10-28-170519,170519,4,0,0,148,3.0,1.6441033,2
2020-10-29-170519,170519,2,0,0,150,1.6666666666666667,0.4218307,3
2020-10-30-170519,170519,0,0,2,150,0.8333333333333334,0.68365574,4
2020-10-31-170519,170519,2,0,0,152,0.8333333333333334,0.28790158,5
2020-11-01-170519,170519,1,1,0,153,1.0,0.31964105,6
2020-11-02-170519,170519,1,0,0,154,2.0,0.3331418,0
2020-11-03-170519,170519,0,0,0,154,1.6666666666666667,0.43630877,1
2020-11-04-170519,170519,5,0,0,159,3.333333333333333,1.2650336,2
2020-11-05-170519,170519,0,0,0,159,2.6666666666666665,0.8054284,3
2020-11-06-170519,170519,0,0,0,159,2.0,0.2697713,4
2020-11-07-170519,170519,0,0,0,159,1.3333333333333333,1.3741183,5
2020-11-08-170519,170519,5,0,0,164,0.8333333333333334,0.43222854,6
2020-11-09-170519,170519,0,0,0,164,1.3333333333333333,0.42980045,0
2020-11-10-170519,170519,1,1,0,165,3.333333333333333,0.5323546,1
2020-11-11-170519,170519,0,0,0,165,2.6666666666666665,0.5392231,2
2020-11-12-170519,170519,0,1,0,165,4.0,0.6454554,3
2020-11-13-170519,170519,2,0,0,167,1.6666666666666667,0.617874,4
2020-03-01-170520,170520,0,0,0,0,0.0,0.00075101317,6
2020-03-02-170520,170520,0,0,0,0,0.0,0.00052086485,0
2020-03-03-170520,170520,0,0,1,0,0.0,0.0012248323,1
2020-03-04-170520,170520,0,2,6,0,0.3333333333333333,0.000116105104,2
2020-03-05-170520,170520,0,0,3,0,0.0,0.0004995357,3
2020-03-06-170520,170520,0,0,4,0,0.0,0.002668058,4
2020-03-07-170520,170520,0,0,1,0,0.0,0.00028487755,5
2020-03-08-170520,170520,0,0,1,0,0.3333333333333333,0.052985787,6
2020-03-09-170520,170520,0,0,0,0,0.6666666666666666,0.020443797,0
2020-03-10-170520,170520,0,0,6,0,0.0,0.0044617145,1
2020-03-11-170520,170520,0,0,3,0,0.3333333333333333,0.0058436748,2
2020-03-12-170520,170520,0,0,4,0,1.3333333333333333,0.12987177,3
2020-03-13-170520,170520,0,0,1,0,1.3333333333333333,0.09752116,4
2020-03-14-170520,170520,0,0,4,0,0.6666666666666666,0.07364327,5
2020-03-15-170520,170520,0,0,1,0,1.6666666666666667,0.16345046,6
2020-03-16-170520,170520,0,0,8,0,7.333333333333332,0.29335982,0
2020-03-17-170520,170520,1,0,3,1,7.333333333333332,0.6942611,1
2020-03-18-170520,170520,6,0,4,7,8.666666666666666,0.5628586,2
2020-03-19-170520,170520,3,0,3,10,11.0,0.7688002,3
2020-03-20-170520,170520,4,0,1,14,13.333333333333336,0.6803264,4
2020-03-21-170520,170520,1,0,1,15,7.666666666666668,0.28002948,5
2020-03-22-170520,170520,1,0,2,16,4.333333333333333,0.18968011,6
2020-03-23-170520,170520,0,0,3,16,21.0,1.3606634,0
2020-03-24-170520,170520,6,0,1,22,18.33333333333333,0.8622551,1
2020-03-25-170520,170520,3,0,1,25,14.0,0.8199773,2
2020-03-26-170520,170520,4,0,3,29,14.0,0.9439573,3
2020-03-27-170520,170520,1,0,2,30,12.666666666666664,1.0286312,4
2020-03-28-170520,170520,4,0,3,34,7.0,0.2271426,5
2020-03-29-170520,170520,1,0,1,35,6.333333333333332,0.18734542,6
2020-03-30-170520,170520,8,0,1,43,11.666666666666664,0.54732126,0
2020-03-31-170520,170520,3,0,2,46,10.333333333333334,0.39444873,1
2020-04-01-170520,170520,4,0,2,50,9.666666666666666,0.64230496,2
2020-04-02-170520,170520,3,0,2,53,7.0,0.5371971,3
2020-04-03-170520,170520,1,0,4,54,7.0,0.3292465,4
2020-04-04-170520,170520,1,0,0,55,4.333333333333333,0.14833109,5
2020-04-05-170520,170520,2,0,0,57,6.333333333333332,0.2739883,6
2020-04-06-170520,170520,3,7,2,60,8.666666666666666,0.34183896,0
2020-04-07-170520,170520,1,0,2,61,6.0,0.4288213,1
2020-04-08-170520,170520,1,0,1,62,7.333333333333332,0.4158728,2
2020-04-09-170520,170520,3,0,0,65,7.333333333333332,0.27332407,3
2020-04-10-170520,170520,2,0,0,67,4.666666666666667,0.17367636,4
2020-04-11-170520,170520,3,0,1,70,4.0,0.15833716,5
2020-04-12-170520,170520,1,0,4,71,1.6666666666666667,0.029074632,6
2020-04-13-170520,170520,1,0,7,72,6.333333333333332,0.38796398,0
2020-04-14-170520,170520,2,0,0,74,3.6666666666666665,0.14623734,1
2020-04-15-170520,170520,2,0,1,76,6.0,0.23898725,2
2020-04-16-170520,170520,2,0,0,78,10.0,0.36143064,3
2020-04-17-170520,170520,4,0,1,82,4.666666666666667,0.25721577,4
2020-04-18-170520,170520,0,0,0,82,1.0,0.010668578,5
2020-04-19-170520,170520,0,0,1,82,1.6666666666666667,0.04783287,6
2020-04-20-170520,170520,2,0,0,84,5.666666666666668,0.35612878,0
2020-04-21-170520,170520,2,0,1,86,3.0,0.25560275,1
2020-04-22-170520,170520,1,0,0,87,8.666666666666666,0.33498344,2
2020-04-23-170520,170520,0,0,1,87,1.0,0.06234974,3
2020-04-24-170520,170520,0,0,2,87,4.0,0.2565908,4
2020-04-25-170520,170520,1,0,2,88,0.6666666666666666,0.033085767,5
2020-04-26-170520,170520,4,0,0,92,2.6666666666666665,0.10603168,6
2020-04-27-170520,170520,7,0,1,99,2.0,0.13072902,0
2020-04-28-170520,170520,0,0,1,99,4.333333333333333,0.3861835,1
2020-04-29-170520,170520,1,0,2,100,2.333333333333333,0.33025223,2
2020-04-30-170520,170520,0,0,1,100,3.6666666666666665,0.1363957,3
2020-05-01-170520,170520,1,0,2,101,4.0,0.025236448,4
2020-05-02-170520,170520,0,0,0,101,1.0,0.03732775,5
2020-05-03-170520,170520,1,0,0,102,1.0,0.027688771,6
2020-05-04-170520,170520,0,0,0,102,3.0,0.32244104,0
2020-05-05-170520,170520,1,0,2,103,4.333333333333333,0.32291287,1
2020-05-06-170520,170520,0,0,2,103,6.333333333333332,0.4010372,2
2020-05-07-170520,170520,1,0,3,104,4.333333333333333,0.54696524,3
2020-05-08-170520,170520,2,0,0,106,1.6666666666666667,0.13964188,4
2020-05-09-170520,170520,2,0,1,108,1.0,0.032497816,5
2020-05-10-170520,170520,0,0,0,108,1.0,0.028921667,6
2020-05-11-170520,170520,1,2,1,109,5.666666666666668,0.5132314,0
2020-05-12-170520,170520,1,0,0,110,3.333333333333333,0.37604007,1
2020-05-13-170520,170520,2,0,3,112,4.666666666666667,0.2448142,2
2020-05-14-170520,170520,1,0,0,113,2.6666666666666665,0.1673166,3
2020-05-15-170520,170520,2,0,1,115,3.0,0.490215,4
2020-05-16-170520,170520,0,0,0,115,1.6666666666666667,0.096308455,5
2020-05-17-170520,170520,0,1,0,115,0.6666666666666666,0.025896221,6
2020-05-18-170520,170520,0,0,1,115,3.333333333333333,0.2007317,0
2020-05-19-170520,170520,2,0,1,117,3.6666666666666665,0.6733532,1
2020-05-20-170520,170520,2,0,0,119,3.0,0.19794421,2
2020-05-21-170520,170520,3,0,2,122,2.6666666666666665,0.19567819,3
2020-05-22-170520,170520,0,0,0,122,5.0,0.2684238,4
2020-05-23-170520,170520,1,0,0,123,0.6666666666666666,0.0008013751,5
2020-05-24-170520,170520,0,2,0,123,0.0,0.00018159818,6
2020-05-25-170520,170520,1,1,1,124,1.6666666666666667,0.19881493,0
2020-05-26-170520,170520,0,0,0,124,2.6666666666666665,0.25160894,1
2020-05-27-170520,170520,3,0,1,127,2.0,0.08085364,2
2020-05-28-170520,170520,0,4,1,127,0.6666666666666666,0.19956753,3
2020-05-29-170520,170520,1,0,0,128,1.3333333333333333,0.30018413,4
2020-05-30-170520,170520,0,0,0,128,0.3333333333333333,0.07118516,5
2020-05-31-170520,170520,0,0,0,128,0.3333333333333333,0.050745737,6
2020-06-01-170520,170520,1,0,0,129,1.3333333333333333,0.18280964,0
2020-06-02-170520,170520,1,0,1,130,0.6666666666666666,0.09793795,1
2020-06-03-170520,170520,0,0,2,130,0.6666666666666666,0.05401095,2
2020-06-04-170520,170520,2,0,0,132,0.0,0.07321631,3
2020-06-05-170520,170520,0,0,2,132,1.0,0.1404497,4
2020-06-06-170520,170520,0,0,0,132,0.0,0.012667546,5
2020-06-07-170520,170520,0,0,0,132,0.3333333333333333,0.00088027207,6
2020-06-08-170520,170520,1,0,0,133,0.0,0.046152867,0
2020-06-09-170520,170520,0,0,0,133,0.3333333333333333,0.054811187,1
2020-06-10-170520,170520,1,0,1,134,1.6666666666666667,0.15936852,2
2020-06-11-170520,170520,1,0,0,135,1.0,0.13000867,3
2020-06-12-170520,170520,0,0,3,135,2.0,0.29159775,4
2020-06-13-170520,170520,0,0,0,135,0.3333333333333333,0.025804993,5
2020-06-14-170520,170520,0,1,1,135,0.0,0.0009380821,6
2020-06-15-170520,170520,0,1,0,135,0.3333333333333333,0.12876062,0
2020-06-16-170520,170520,1,0,0,136,1.6666666666666667,0.15440774,1
2020-06-17-170520,170520,2,0,0,138,1.6666666666666667,0.08632652,2
2020-06-18-170520,170520,0,0,0,138,0.3333333333333333,0.113605924,3
2020-06-19-170520,170520,2,0,1,140,1.6666666666666667,0.27815533,4
2020-06-20-170520,170520,0,0,0,140,0.3333333333333333,0.012110225,5
2020-06-21-170520,170520,0,0,1,140,0.3333333333333333,0.004925346,6
2020-06-22-170520,170520,0,0,0,140,1.0,0.013601753,0
2020-06-23-170520,170520,0,0,0,140,0.6666666666666666,0.02729531,1
2020-06-24-170520,170520,1,0,0,141,1.0,0.10645485,2
2020-06-25-170520,170520,0,0,1,141,1.3333333333333333,0.20598345,3
2020-06-26-170520,170520,3,0,1,144,0.6666666666666666,0.080232784,4
2020-06-27-170520,170520,0,1,0,144,1.0,0.04364849,5
2020-06-28-170520,170520,1,0,0,145,0.0,0.002979338,6
2020-06-29-170520,170520,0,0,1,145,0.3333333333333333,0.0883371,0
2020-06-30-170520,170520,0,0,1,145,1.0,0.08594937,1
2020-07-01-170520,170520,0,0,1,145,0.3333333333333333,0.02017323,2
2020-07-02-170520,170520,0,0,0,145,0.3333333333333333,0.10147872,3
2020-07-03-170520,170520,1,0,0,146,0.3333333333333333,0.16880138,4
2020-07-04-170520,170520,0,0,0,146,0.3333333333333333,0.0037837727,5
2020-07-05-170520,170520,1,0,0,147,0.0,0.005152799,6
2020-07-06-170520,170520,0,0,0,147,0.6666666666666666,0.108178325,0
2020-07-07-170520,170520,0,0,0,147,1.3333333333333333,0.13815454,1
2020-07-08-170520,170520,0,0,0,147,0.3333333333333333,0.015659483,2
2020-07-09-170520,170520,1,0,0,148,0.3333333333333333,0.007478601,3
2020-07-10-170520,170520,1,0,0,149,1.0,0.2867251,4
2020-07-11-170520,170520,0,0,0,149,0.0,0.003748636,5
2020-07-12-170520,170520,0,0,0,149,0.0,0.0048138527,6
2020-07-13-170520,170520,1,0,0,150,0.0,0.0136969425,0
2020-07-14-170520,170520,1,0,0,151,1.0,0.042441122,1
2020-07-15-170520,170520,1,0,0,152,3.333333333333333,0.03905306,2
2020-07-16-170520,170520,0,0,0,152,0.6666666666666666,0.044155046,3
2020-07-17-170520,170520,0,0,0,152,0.3333333333333333,0.017082147,4
2020-07-18-170520,170520,0,0,0,152,0.3333333333333333,0.0020036113,5
2020-07-19-170520,170520,0,0,0,152,0.0,0.011017633,6
2020-07-20-170520,170520,0,0,0,152,0.0,0.026358616,0
2020-07-21-170520,170520,0,0,1,152,0.0,0.03661617,1
2020-07-22-170520,170520,0,0,0,152,0.3333333333333333,0.15739349,2
2020-07-23-170520,170520,0,0,0,152,1.0,0.4396732,3
2020-07-24-170520,170520,0,0,0,152,1.0,0.098469466,4
2020-07-25-170520,170520,0,0,0,152,0.0,0.006591105,5
2020-07-26-170520,170520,0,0,1,152,0.3333333333333333,0.0017469794,6
2020-07-27-170520,170520,0,0,0,152,0.3333333333333333,0.17921641,0
2020-07-28-170520,170520,0,0,0,152,0.0,0.074581504,1
2020-07-29-170520,170520,0,0,2,152,1.3333333333333333,0.08387728,2
2020-07-30-170520,170520,0,0,1,152,1.6666666666666667,0.38872755,3
2020-07-31-170520,170520,0,0,0,152,2.333333333333333,0.09759303,4
2020-08-01-170520,170520,0,0,0,152,0.0,0.011897903,5
2020-08-02-170520,170520,0,0,0,152,0.3333333333333333,0.012202026,6
2020-08-03-170520,170520,0,0,1,152,0.6666666666666666,0.15627305,0
2020-08-04-170520,170520,1,0,1,153,1.3333333333333333,0.25028422,1
2020-08-05-170520,170520,0,0,0,153,1.6666666666666667,0.34179622,2
2020-08-06-170520,170520,0,0,2,153,2.0,0.3207369,3
2020-08-07-170520,170520,0,0,0,153,2.333333333333333,0.4252113,4
2020-08-08-170520,170520,0,0,0,153,0.0,0.026133783,5
2020-08-09-170520,170520,1,0,2,154,1.3333333333333333,0.083895646,6
2020-08-10-170520,170520,0,0,0,154,1.3333333333333333,0.037795365,0
2020-08-11-170520,170520,0,0,1,154,1.0,0.20937131,1
2020-08-12-170520,170520,2,0,1,156,3.0,0.3182783,2
2020-08-13-170520,170520,1,0,2,157,1.6666666666666667,0.11584617,3
2020-08-14-170520,170520,0,0,0,157,3.6666666666666665,0.6073832,4
2020-08-15-170520,170520,0,0,0,157,0.6666666666666666,0.07949109,5
2020-08-16-170520,170520,0,0,0,157,0.3333333333333333,0.103708886,6
2020-08-17-170520,170520,1,0,1,158,3.333333333333333,0.30078298,0
2020-08-18-170520,170520,1,0,7,159,3.333333333333333,0.39898965,1
2020-08-19-170520,170520,0,0,0,159,4.666666666666667,0.92647374,2
2020-08-20-170520,170520,2,0,2,161,1.6666666666666667,0.23191385,3
2020-08-21-170520,170520,0,0,1,161,5.333333333333333,0.66542685,4
2020-08-22-170520,170520,0,0,0,161,2.333333333333333,0.16372864,5
2020-08-23-170520,170520,2,0,6,163,0.6666666666666666,0.12956214,6
2020-08-24-170520,170520,0,0,0,163,3.6666666666666665,0.3544179,0
2020-08-25-170520,170520,1,0,2,164,2.0,0.16885445,1
2020-08-26-170520,170520,1,0,2,165,4.0,0.39205453,2
2020-08-27-170520,170520,2,0,2,167,5.333333333333333,0.19835226,3
2020-08-28-170520,170520,0,0,2,167,4.333333333333333,0.36886165,4
2020-08-29-170520,170520,0,0,1,167,4.0,0.11305785,5
2020-08-30-170520,170520,0,0,5,167,1.0,0.21520534,6
2020-08-31-170520,170520,1,0,1,168,1.6666666666666667,0.087778375,0
2020-09-01-170520,170520,7,0,9,175,3.0,0.73445517,1
2020-09-02-170520,170520,0,0,3,175,1.6666666666666667,0.1424016,2
2020-09-03-170520,170520,2,0,3,177,5.0,0.7530863,3
2020-09-04-170520,170520,1,0,3,178,5.333333333333333,0.75796914,4
2020-09-05-170520,170520,0,0,2,178,3.6666666666666665,0.31794986,5
2020-09-06-170520,170520,6,0,2,184,2.6666666666666665,0.33909643,6
2020-09-07-170520,170520,0,0,4,184,7.0,0.49980876,0
2020-09-08-170520,170520,2,0,1,186,5.666666666666668,0.71177554,1
2020-09-09-170520,170520,2,0,4,188,3.6666666666666665,0.84766114,2
2020-09-10-170520,170520,2,0,1,190,4.0,0.7558066,3
2020-09-11-170520,170520,2,0,0,192,5.0,0.5735838,4
2020-09-12-170520,170520,1,0,4,193,4.0,0.2722129,5
2020-09-13-170520,170520,5,0,5,198,2.333333333333333,0.26430482,6
2020-09-14-170520,170520,1,0,0,199,9.0,1.0303553,0
2020-09-15-170520,170520,9,0,2,208,3.6666666666666665,1.0373231,1
2020-09-16-170520,170520,3,0,6,211,5.0,0.47392786,2
2020-09-17-170520,170520,3,0,3,214,8.333333333333334,0.4957729,3
2020-09-18-170520,170520,3,0,2,217,11.333333333333336,1.3120036,4
2020-09-19-170520,170520,2,1,0,219,3.333333333333333,0.1744609,5
2020-09-20-170520,170520,2,0,0,221,8.666666666666666,0.38641712,6
2020-09-21-170520,170520,4,0,0,225,7.0,0.5586818,0
2020-09-22-170520,170520,1,0,0,226,6.0,0.3444136,1
2020-09-23-170520,170520,4,1,0,230,7.666666666666668,0.48248097,2
2020-09-24-170520,170520,1,0,1,231,8.333333333333334,0.60475445,3
2020-09-25-170520,170520,0,0,2,231,5.666666666666668,0.28665045,4
2020-09-26-170520,170520,4,0,11,235,4.0,0.5302798,5
2020-09-27-170520,170520,5,0,4,240,4.666666666666667,0.34786153,6
2020-09-28-170520,170520,0,0,4,240,4.333333333333333,0.5788682,0
2020-09-29-170520,170520,2,0,6,242,1.3333333333333333,0.22400272,1
2020-09-30-170520,170520,6,0,3,248,5.333333333333333,0.7078052,2
2020-10-01-170520,170520,3,0,3,251,6.666666666666668,0.6399718,3
2020-10-02-170520,170520,2,0,6,253,10.0,0.9256647,4
2020-10-03-170520,170520,0,0,6,253,7.0,0.3902371,5
2020-10-04-170520,170520,0,0,2,253,2.333333333333333,0.14984994,6
2020-10-05-170520,170520,0,0,6,253,5.666666666666668,0.586503,0
2020-10-06-170520,170520,0,0,4,253,11.0,0.6928592,1
2020-10-07-170520,170520,0,0,3,253,6.666666666666668,0.58163685,2
2020-10-08-170520,170520,1,0,1,254,13.333333333333336,1.143734,3
2020-10-09-170520,170520,2,0,2,256,16.666666666666668,0.37351504,4
2020-10-10-170520,170520,11,0,0,267,6.333333333333332,0.4113028,5
2020-10-11-170520,170520,4,0,0,271,0.6666666666666666,0.05610491,6
2020-10-12-170520,170520,4,0,3,275,6.333333333333332,0.10510205,0
2020-10-13-170520,170520,6,0,0,281,6.0,0.45992434,1
2020-10-14-170520,170520,3,0,1,284,10.333333333333334,1.7645271,2
2020-10-15-170520,170520,3,0,4,287,11.666666666666664,0.7624387,3
2020-10-16-170520,170520,6,0,2,293,13.666666666666664,0.94522816,4
2020-10-17-170520,170520,6,0,2,299,8.666666666666666,0.25438133,5
2020-10-18-170520,170520,2,0,4,301,3.6666666666666665,0.21075796,6
2020-10-19-170520,170520,6,0,6,307,5.666666666666668,0.6136953,0
2020-10-20-170520,170520,4,0,3,311,9.333333333333334,1.4242733,1
2020-10-21-170520,170520,3,0,0,314,3.6666666666666665,0.41619766,2
2020-10-22-170520,170520,1,0,3,315,9.666666666666666,1.0137575,3
2020-10-23-170520,170520,2,0,13,317,18.666666666666668,1.2179413,4
2020-10-24-170520,170520,0,0,8,317,11.666666666666664,0.9227522,5
2020-10-25-170520,170520,0,0,7,317,5.333333333333333,0.30172464,6
2020-10-26-170520,170520,3,0,5,320,6.666666666666668,1.3175442,0
2020-10-27-170520,170520,0,0,1,320,13.666666666666664,1.0933532,1
2020-10-28-170520,170520,1,0,0,321,8.333333333333334,2.036674,2
2020-10-29-170520,170520,4,0,6,325,7.666666666666668,1.4049268,3
2020-10-30-170520,170520,2,0,10,327,14.333333333333336,1.3914558,4
2020-10-31-170520,170520,2,0,0,329,6.666666666666668,0.70073026,5
2020-11-01-170520,170520,4,0,0,333,2.6666666666666665,0.29491317,6
2020-11-02-170520,170520,6,0,0,339,7.333333333333332,0.22314203,0
2020-11-03-170520,170520,3,0,0,342,7.0,1.3499528,1
2020-11-04-170520,170520,0,0,0,342,7.666666666666668,1.9957625,2
2020-11-05-170520,170520,3,0,0,345,14.0,3.2775722,3
2020-11-06-170520,170520,13,0,0,358,12.333333333333336,1.0744874,4
2020-11-07-170520,170520,8,0,0,366,23.33333333333333,3.9936302,5
2020-11-08-170520,170520,7,0,0,373,3.6666666666666665,0.17381632,6
2020-11-09-170520,170520,5,1,0,378,8.666666666666666,1.5535625,0
2020-11-10-170520,170520,1,0,0,379,7.0,1.0515115,1
2020-11-11-170520,170520,0,1,0,379,5.333333333333333,0.617843,2
2020-11-12-170520,170520,6,0,0,385,13.0,1.3112785,3
2020-11-13-170520,170520,10,0,0,395,15.0,1.7752798,4
2020-03-01-170601,170601,0,0,2,0,0.16666666666666666,0.11868371,6
2020-03-02-170601,170601,0,0,3,0,0.16666666666666666,0.2690914,0
2020-03-03-170601,170601,0,0,4,0,0.3333333333333333,0.116618864,1
2020-03-04-170601,170601,0,1,6,0,0.16666666666666666,0.08886073,2
2020-03-05-170601,170601,0,0,10,0,0.0,0.042759057,3
2020-03-06-170601,170601,0,0,14,0,0.0,0.04529586,4
2020-03-07-170601,170601,0,0,12,0,0.0,0.0021453493,5
2020-03-08-170601,170601,0,0,14,0,0.0,0.014708289,6
2020-03-09-170601,170601,0,0,20,0,0.16666666666666666,0.09626281,0
2020-03-10-170601,170601,0,0,17,0,0.5,0.2574981,1
2020-03-11-170601,170601,0,0,25,0,0.3333333333333333,0.13210611,2
2020-03-12-170601,170601,0,0,19,0,0.5,0.4304809,3
2020-03-13-170601,170601,0,0,35,0,1.3333333333333333,0.80975705,4
2020-03-14-170601,170601,1,0,2,1,2.1666666666666665,1.1410476,5
2020-03-15-170601,170601,2,0,5,3,3.6666666666666665,1.4961098,6
2020-03-16-170601,170601,3,0,27,6,6.833333333333332,4.6121163,0
2020-03-17-170601,170601,4,0,18,10,7.166666666666668,4.7248554,1
2020-03-18-170601,170601,6,0,21,16,7.333333333333332,5.3846235,2
2020-03-19-170601,170601,10,0,8,26,7.5,6.573724,3
2020-03-20-170601,170601,14,0,9,40,8.0,7.325233,4
2020-03-21-170601,170601,12,1,2,52,4.0,3.9498165,5
2020-03-22-170601,170601,14,0,4,66,4.666666666666667,3.7886353,6
2020-03-23-170601,170601,20,0,14,86,17.5,12.377612,0
2020-03-24-170601,170601,17,0,4,103,12.333333333333336,9.239456,1
2020-03-25-170601,170601,25,0,8,128,13.833333333333336,12.946326,2
2020-03-26-170601,170601,19,0,3,147,11.166666666666664,10.792787,3
2020-03-27-170601,170601,35,0,1,182,9.833333333333334,13.664444,4
2020-03-28-170601,170601,2,0,3,184,2.6666666666666665,1.0965415,5
2020-03-29-170601,170601,5,0,0,189,4.0,2.1954591,6
2020-03-30-170601,170601,27,0,6,216,11.333333333333336,12.305685,0
2020-03-31-170601,170601,18,0,9,234,7.333333333333332,8.541814,1
2020-04-01-170601,170601,21,0,16,255,7.833333333333332,9.156498,2
2020-04-02-170601,170601,8,0,8,263,4.5,4.2873454,3
2020-04-03-170601,170601,9,0,7,272,7.0,5.020804,4
2020-04-04-170601,170601,2,0,7,274,1.3333333333333333,1.1405702,5
2020-04-05-170601,170601,4,0,3,278,3.333333333333333,1.5342344,6
2020-04-06-170601,170601,14,0,5,292,6.5,6.1892204,0
2020-04-07-170601,170601,4,0,6,296,4.5,2.790589,1
2020-04-08-170601,170601,8,0,10,304,4.833333333333333,4.2085733,2
2020-04-09-170601,170601,3,0,2,307,2.5,1.543549,3
2020-04-10-170601,170601,1,0,6,308,1.8333333333333333,0.9551537,4
2020-04-11-170601,170601,3,0,3,311,1.6666666666666667,1.1957822,5
2020-04-12-170601,170601,0,0,0,311,0.8333333333333334,0.536363,6
2020-04-13-170601,170601,6,0,7,317,7.333333333333332,4.0135756,0
2020-04-14-170601,170601,9,0,8,326,4.333333333333333,5.2286134,1
2020-04-15-170601,170601,16,0,11,342,4.666666666666667,6.453938,2
2020-04-16-170601,170601,8,0,6,350,3.6666666666666665,3.8178792,3
2020-04-17-170601,170601,7,0,2,357,3.333333333333333,4.2447853,4
2020-04-18-170601,170601,7,0,6,364,3.333333333333333,2.5244434,5
2020-04-19-170601,170601,3,0,0,367,1.3333333333333333,1.1518945,6
2020-04-20-170601,170601,5,1,27,372,3.5,3.0816307,0
2020-04-21-170601,170601,6,0,6,378,3.8333333333333335,4.3532887,1
2020-04-22-170601,170601,10,0,60,388,4.666666666666667,4.9628754,2
2020-04-23-170601,170601,2,0,11,390,1.0,1.0191464,3
2020-04-24-170601,170601,6,0,6,396,2.0,2.7939365,4
2020-04-25-170601,170601,3,0,1,399,2.0,1.1930834,5
2020-04-26-170601,170601,0,0,1,399,2.5,0.7311291,6
2020-04-27-170601,170601,7,0,4,406,4.666666666666667,4.1583123,0
2020-04-28-170601,170601,8,0,2,414,2.333333333333333,3.2871814,1
2020-04-29-170601,170601,11,2,1,425,2.1666666666666665,4.3815947,2
2020-04-30-170601,170601,6,0,3,431,1.5,2.4717674,3
2020-05-01-170601,170601,2,0,2,433,2.1666666666666665,1.2811849,4
2020-05-02-170601,170601,6,0,0,439,0.8333333333333334,2.3667412,5
2020-05-03-170601,170601,0,0,1,439,0.6666666666666666,0.14541732,6
2020-05-04-170601,170601,27,0,2,466,3.8333333333333335,10.032906,0
2020-05-05-170601,170601,6,0,4,472,3.1666666666666665,3.244547,1
2020-05-06-170601,170601,60,0,2,532,1.6666666666666667,19.688738,2
2020-05-07-170601,170601,11,0,1,543,3.0,6.040479,3
2020-05-08-170601,170601,6,0,3,549,3.1666666666666665,3.7840142,4
2020-05-09-170601,170601,1,1,0,550,0.6666666666666666,0.46996042,5
2020-05-10-170601,170601,1,0,2,551,0.0,0.27553865,6
2020-05-11-170601,170601,4,0,0,555,4.5,3.245441,0
2020-05-12-170601,170601,2,1,0,557,2.833333333333333,1.8414522,1
2020-05-13-170601,170601,1,1,1,558,2.333333333333333,1.501851,2
2020-05-14-170601,170601,3,2,2,561,2.1666666666666665,2.095891,3
2020-05-15-170601,170601,2,0,0,563,1.8333333333333333,1.48583,4
2020-05-16-170601,170601,0,1,0,563,0.0,0.011895488,5
2020-05-17-170601,170601,1,0,0,564,0.0,0.26917124,6
2020-05-18-170601,170601,2,0,3,566,3.1666666666666665,1.8154345,0
2020-05-19-170601,170601,4,0,5,570,1.8333333333333333,2.210885,1
2020-05-20-170601,170601,2,0,1,572,1.6666666666666667,1.0402421,2
2020-05-21-170601,170601,1,0,0,573,1.1666666666666667,1.1550454,3
2020-05-22-170601,170601,3,0,2,576,1.8333333333333333,1.9695758,4
2020-05-23-170601,170601,0,0,2,576,0.5,0.22008519,5
2020-05-24-170601,170601,2,0,0,578,0.0,0.6832191,6
2020-05-25-170601,170601,0,0,0,578,0.8333333333333334,0.72133183,0
2020-05-26-170601,170601,0,0,0,578,1.0,0.6442832,1
2020-05-27-170601,170601,1,0,0,579,1.5,1.208494,2
2020-05-28-170601,170601,2,4,0,581,2.1666666666666665,1.6666255,3
2020-05-29-170601,170601,0,1,0,581,1.8333333333333333,0.89102626,4
2020-05-30-170601,170601,0,0,0,581,0.0,0.034268778,5
2020-05-31-170601,170601,0,0,0,581,0.16666666666666666,0.0144869285,6
2020-06-01-170601,170601,3,0,0,584,1.8333333333333333,2.3762174,0
2020-06-02-170601,170601,5,0,2,589,0.5,2.2185297,1
2020-06-03-170601,170601,1,0,0,590,1.0,0.809068,2
2020-06-04-170601,170601,0,0,0,590,1.5,0.7793372,3
2020-06-05-170601,170601,2,1,0,592,2.833333333333333,2.596643,4
2020-06-06-170601,170601,2,0,0,594,0.0,0.77194977,5
2020-06-07-170601,170601,0,0,0,594,0.16666666666666666,0.1370781,6
2020-06-08-170601,170601,0,0,0,594,0.5,0.4436137,0
2020-06-09-170601,170601,0,0,1,594,0.8333333333333334,0.49897608,1
2020-06-10-170601,170601,0,0,1,594,0.6666666666666666,0.5508079,2
2020-06-11-170601,170601,0,0,0,594,0.8333333333333334,0.33753276,3
2020-06-12-170601,170601,0,0,0,594,0.6666666666666666,0.31344792,4
2020-06-13-170601,170601,0,0,0,594,0.16666666666666666,0.14377901,5
2020-06-14-170601,170601,0,0,0,594,0.16666666666666666,0.13813038,6
2020-06-15-170601,170601,0,0,1,594,0.3333333333333333,0.15044077,0
2020-06-16-170601,170601,2,0,0,596,0.6666666666666666,1.2446529,1
2020-06-17-170601,170601,0,1,0,596,1.0,0.7602108,2
2020-06-18-170601,170601,0,0,1,596,1.5,1.0599222,3
2020-06-19-170601,170601,0,0,0,596,2.0,1.21461,4
2020-06-20-170601,170601,0,0,0,596,0.0,0.0021917785,5
2020-06-21-170601,170601,0,0,0,596,0.16666666666666666,0.019712046,6
2020-06-22-170601,170601,0,0,0,596,1.5,0.5848808,0
2020-06-23-170601,170601,1,0,0,597,1.5,1.1739591,1
2020-06-24-170601,170601,1,1,0,598,0.3333333333333333,0.5784055,2
2020-06-25-170601,170601,0,0,0,598,0.8333333333333334,0.3377778,3
2020-06-26-170601,170601,0,0,0,598,0.16666666666666666,0.16705017,4
2020-06-27-170601,170601,0,0,0,598,0.0,0.06162946,5
2020-06-28-170601,170601,0,0,1,598,0.0,0.024500562,6
2020-06-29-170601,170601,1,0,0,599,0.6666666666666666,0.8099766,0
2020-06-30-170601,170601,0,0,0,599,0.8333333333333334,0.28342503,1
2020-07-01-170601,170601,0,0,0,599,0.3333333333333333,0.12174541,2
2020-07-02-170601,170601,1,0,0,600,0.3333333333333333,0.49164483,3
2020-07-03-170601,170601,0,0,0,600,0.16666666666666666,0.19184372,4
2020-07-04-170601,170601,0,0,1,600,0.16666666666666666,0.023961814,5
2020-07-05-170601,170601,0,0,0,600,0.0,0.01752452,6
2020-07-06-170601,170601,0,0,0,600,0.3333333333333333,0.1829695,0
2020-07-07-170601,170601,0,1,1,600,0.6666666666666666,0.11831802,1
2020-07-08-170601,170601,0,0,1,600,0.3333333333333333,0.21244675,2
2020-07-09-170601,170601,0,0,0,600,0.6666666666666666,0.30500868,3
2020-07-10-170601,170601,0,0,0,600,0.16666666666666666,0.11083025,4
2020-07-11-170601,170601,0,0,0,600,0.16666666666666666,0.1835819,5
2020-07-12-170601,170601,1,0,0,601,0.3333333333333333,0.57315165,6
2020-07-13-170601,170601,0,0,0,601,0.6666666666666666,0.6556081,0
2020-07-14-170601,170601,0,0,0,601,1.0,0.5647522,1
2020-07-15-170601,170601,0,0,0,601,0.3333333333333333,0.044733107,2
2020-07-16-170601,170601,0,0,0,601,0.6666666666666666,0.43452594,3
2020-07-17-170601,170601,0,0,1,601,0.5,0.16098161,4
2020-07-18-170601,170601,1,0,0,602,0.0,0.42133075,5
2020-07-19-170601,170601,0,0,2,602,0.0,0.00649031,6
2020-07-20-170601,170601,0,0,0,602,0.3333333333333333,0.07199246,0
2020-07-21-170601,170601,1,1,2,603,0.16666666666666666,0.49927476,1
2020-07-22-170601,170601,1,0,2,604,0.8333333333333334,0.68432546,2
2020-07-23-170601,170601,0,0,1,604,0.5,0.21361963,3
2020-07-24-170601,170601,0,0,2,604,0.16666666666666666,0.05698421,4
2020-07-25-170601,170601,0,0,4,604,0.3333333333333333,0.024622947,5
2020-07-26-170601,170601,0,0,4,604,0.3333333333333333,0.047780953,6
2020-07-27-170601,170601,0,0,3,604,0.5,0.1385924,0
2020-07-28-170601,170601,0,0,1,604,1.0,0.62023294,1
2020-07-29-170601,170601,0,0,2,604,1.3333333333333333,0.6954438,2
2020-07-30-170601,170601,0,0,6,604,1.0,0.51092815,3
2020-07-31-170601,170601,1,0,7,605,1.3333333333333333,0.44594273,4
2020-08-01-170601,170601,0,0,0,605,0.6666666666666666,0.52948207,5
2020-08-02-170601,170601,2,0,2,607,1.1666666666666667,1.2633095,6
2020-08-03-170601,170601,0,0,2,607,0.5,0.45476967,0
2020-08-04-170601,170601,2,0,2,609,1.3333333333333333,1.5954297,1
2020-08-05-170601,170601,2,0,4,611,1.8333333333333333,2.0293941,2
2020-08-06-170601,170601,1,0,6,612,2.5,3.0837114,3
2020-08-07-170601,170601,2,0,9,614,2.5,2.4463115,4
2020-08-08-170601,170601,4,0,0,618,0.8333333333333334,2.649604,5
2020-08-09-170601,170601,4,0,2,622,0.0,1.2425334,6
2020-08-10-170601,170601,3,0,4,625,1.6666666666666667,2.294125,0
2020-08-11-170601,170601,1,0,5,626,2.6666666666666665,3.3033504,1
2020-08-12-170601,170601,2,0,7,628,3.5,6.5174437,2
2020-08-13-170601,170601,6,0,2,634,3.5,5.2173185,3
2020-08-14-170601,170601,7,0,6,641,2.333333333333333,4.958241,4
2020-08-15-170601,170601,0,0,1,641,1.1666666666666667,0.9318145,5
2020-08-16-170601,170601,2,0,2,643,1.5,1.7662483,6
2020-08-17-170601,170601,2,0,7,645,2.833333333333333,2.9488924,0
2020-08-18-170601,170601,2,0,4,647,3.0,2.7240067,1
2020-08-19-170601,170601,4,1,1,651,3.0,4.1171885,2
2020-08-20-170601,170601,6,0,3,657,4.5,6.873851,3
2020-08-21-170601,170601,9,0,1,666,3.6666666666666665,6.3402886,4
2020-08-22-170601,170601,0,0,4,666,0.6666666666666666,1.2798468,5
2020-08-23-170601,170601,2,0,9,668,1.1666666666666667,1.4913794,6
2020-08-24-170601,170601,4,0,4,672,3.8333333333333335,5.1929603,0
2020-08-25-170601,170601,5,0,2,677,5.5,6.0492706,1
2020-08-26-170601,170601,7,0,1,684,5.5,6.0830197,2
2020-08-27-170601,170601,2,0,7,686,4.833333333333333,5.38234,3
2020-08-28-170601,170601,6,0,0,692,4.166666666666667,4.958978,4
2020-08-29-170601,170601,1,0,8,693,3.0,2.6153328,5
2020-08-30-170601,170601,2,0,1,695,2.0,2.1187444,6
2020-08-31-170601,170601,7,0,8,702,5.166666666666667,6.772422,0
2020-09-01-170601,170601,4,0,3,706,6.333333333333332,6.69764,1
2020-09-02-170601,170601,1,0,5,707,5.833333333333332,3.7234566,2
2020-09-03-170601,170601,3,1,0,710,5.833333333333332,6.03657,3
2020-09-04-170601,170601,1,0,7,711,6.166666666666668,5.252639,4
2020-09-05-170601,170601,4,0,8,715,4.833333333333333,3.5572758,5
2020-09-06-170601,170601,9,0,3,724,3.6666666666666665,6.797568,6
2020-09-07-170601,170601,4,0,2,728,7.5,6.6663136,0
2020-09-08-170601,170601,2,0,0,730,3.1666666666666665,2.899436,1
2020-09-09-170601,170601,1,0,5,731,3.6666666666666665,2.5092337,2
2020-09-10-170601,170601,7,0,5,738,5.0,4.9017878,3
2020-09-11-170601,170601,0,0,4,738,7.666666666666668,4.339729,4
2020-09-12-170601,170601,8,0,6,746,2.1666666666666665,5.170393,5
2020-09-13-170601,170601,1,0,2,747,3.0,3.381187,6
2020-09-14-170601,170601,8,0,6,755,9.833333333333334,8.086862,0
2020-09-15-170601,170601,3,1,0,758,5.666666666666668,3.8624718,1
2020-09-16-170601,170601,5,0,4,763,4.166666666666667,5.5957522,2
2020-09-17-170601,170601,0,0,3,763,5.666666666666668,6.0274787,3
2020-09-18-170601,170601,7,0,5,770,17.166666666666668,9.603783,4
2020-09-19-170601,170601,8,0,1,778,6.0,8.495728,5
2020-09-20-170601,170601,3,0,0,781,6.0,4.611133,6
2020-09-21-170601,170601,2,0,6,783,11.166666666666664,7.3519382,0
2020-09-22-170601,170601,0,0,3,783,8.666666666666666,6.0125313,1
2020-09-23-170601,170601,5,0,4,788,8.5,7.5977144,2
2020-09-24-170601,170601,5,0,1,793,11.0,10.164983,3
2020-09-25-170601,170601,4,0,10,797,8.666666666666666,8.968762,4
2020-09-26-170601,170601,6,0,6,803,2.333333333333333,3.7622693,5
2020-09-27-170601,170601,2,0,4,805,2.1666666666666665,2.370154,6
2020-09-28-170601,170601,6,0,2,811,7.0,6.6398253,0
2020-09-29-170601,170601,0,0,3,811,6.666666666666668,5.0473266,1
2020-09-30-170601,170601,4,2,7,815,7.666666666666668,6.400489,2
2020-10-01-170601,170601,3,0,1,818,6.166666666666668,5.943203,3
2020-10-02-170601,170601,5,0,5,823,6.0,5.3141837,4
2020-10-03-170601,170601,1,1,3,824,1.5,1.5748907,5
2020-10-04-170601,170601,0,0,1,824,4.166666666666667,2.3681455,6
2020-10-05-170601,170601,6,1,6,830,6.333333333333332,7.2981753,0
2020-10-06-170601,170601,3,1,2,833,5.333333333333333,6.3002424,1
2020-10-07-170601,170601,4,0,9,837,4.166666666666667,6.457358,2
2020-10-08-170601,170601,1,1,5,838,5.166666666666667,3.9708393,3
2020-10-09-170601,170601,10,2,2,848,6.333333333333332,6.857991,4
2020-10-10-170601,170601,6,0,1,854,3.6666666666666665,3.9210815,5
2020-10-11-170601,170601,4,0,3,858,4.5,4.2607956,6
2020-10-12-170601,170601,2,0,0,860,4.333333333333333,2.436607,0
2020-10-13-170601,170601,3,0,3,863,6.166666666666668,6.284913,1
2020-10-14-170601,170601,7,0,2,870,6.166666666666668,7.2272396,2
2020-10-15-170601,170601,1,0,2,871,10.333333333333334,6.279692,3
2020-10-16-170601,170601,5,0,5,876,12.333333333333336,10.395219,4
2020-10-17-170601,170601,3,0,2,879,3.0,3.1214063,5
2020-10-18-170601,170601,1,0,3,880,4.833333333333333,2.7243912,6
2020-10-19-170601,170601,6,0,3,886,12.666666666666664,10.063736,0
2020-10-20-170601,170601,2,2,3,888,11.666666666666664,8.005722,1
2020-10-21-170601,170601,9,0,5,897,9.5,10.840463,2
2020-10-22-170601,170601,5,0,7,902,11.833333333333336,13.121739,3
2020-10-23-170601,170601,2,1,11,904,11.0,9.488175,4
2020-10-24-170601,170601,1,0,1,905,4.166666666666667,3.444115,5
2020-10-25-170601,170601,3,0,8,908,4.5,4.0619764,6
2020-10-26-170601,170601,0,0,12,908,10.0,7.0156746,0
2020-10-27-170601,170601,3,0,3,911,7.833333333333332,7.2898517,1
2020-10-28-170601,170601,2,0,8,913,8.0,8.039615,2
2020-10-29-170601,170601,2,0,3,915,7.0,11.633319,3
2020-10-30-170601,170601,5,0,6,920,8.833333333333334,8.293943,4
2020-10-31-170601,170601,2,0,0,922,2.333333333333333,2.1278238,5
2020-11-01-170601,170601,3,0,0,925,3.0,2.8030598,6
2020-11-02-170601,170601,3,0,0,928,4.5,2.9476326,0
2020-11-03-170601,170601,3,1,0,931,9.0,7.950039,1
2020-11-04-170601,170601,5,0,0,936,11.166666666666664,9.611454,2
2020-11-05-170601,170601,7,1,0,943,6.0,7.449029,3
2020-11-06-170601,170601,11,1,0,954,7.333333333333332,9.530656,4
2020-11-07-170601,170601,1,0,0,955,2.6666666666666665,2.0652983,5
2020-11-08-170601,170601,8,1,0,963,2.1666666666666665,4.145227,6
2020-11-09-170601,170601,12,0,0,975,8.0,9.153787,0
2020-11-10-170601,170601,3,0,0,978,6.5,5.8092127,1
2020-11-11-170601,170601,8,1,0,986,4.833333333333333,7.0767636,2
2020-11-12-170601,170601,3,0,0,989,8.0,6.754874,3
2020-11-13-170601,170601,6,1,0,995,6.0,6.1390505,4
2020-03-01-170602,170602,0,0,0,0,0.0,0.00016836754,6
2020-03-02-170602,170602,0,0,0,0,0.0,0.00020690849,0
2020-03-03-170602,170602,0,0,1,0,0.0,0.00057127554,1
2020-03-04-170602,170602,0,2,1,0,0.0,0.00034418722,2
2020-03-05-170602,170602,0,0,1,0,0.0,0.0010710564,3
2020-03-06-170602,170602,0,0,1,0,0.0,0.000920841,4
2020-03-07-170602,170602,0,0,0,0,0.0,0.0013564504,5
2020-03-08-170602,170602,0,0,0,0,0.0,0.0001971333,6
2020-03-09-170602,170602,0,0,1,0,0.0,0.0017609645,0
2020-03-10-170602,170602,0,0,2,0,0.0,0.0014376466,1
2020-03-11-170602,170602,0,0,1,0,0.0,0.0036508632,2
2020-03-12-170602,170602,0,0,2,0,0.5,0.10954037,3
2020-03-13-170602,170602,1,0,0,1,1.0,0.2122997,4
2020-03-14-170602,170602,0,0,0,1,0.0,0.0055566505,5
2020-03-15-170602,170602,0,0,0,1,1.0,0.059691355,6
2020-03-16-170602,170602,0,0,1,1,0.5,0.100780286,0
2020-03-17-170602,170602,1,0,0,2,2.5,0.36162618,1
2020-03-18-170602,170602,1,0,1,3,4.0,0.23186666,2
2020-03-19-170602,170602,1,1,2,4,2.5,0.4066074,3
2020-03-20-170602,170602,1,0,0,5,0.0,0.06343892,4
2020-03-21-170602,170602,0,0,0,5,0.5,0.034503512,5
2020-03-22-170602,170602,0,0,1,5,0.0,0.01951192,6
2020-03-23-170602,170602,1,0,1,6,1.5,0.28175554,0
2020-03-24-170602,170602,2,0,0,8,0.5,0.15367176,1
2020-03-25-170602,170602,1,0,0,9,0.5,0.15250719,2
2020-03-26-170602,170602,2,0,0,11,0.0,0.048688952,3
2020-03-27-170602,170602,0,0,0,11,1.5,0.18786934,4
2020-03-28-170602,170602,0,0,0,11,1.0,0.03380477,5
2020-03-29-170602,170602,0,0,0,11,0.5,0.023576971,6
2020-03-30-170602,170602,1,0,0,12,3.0,0.3426185,0
2020-03-31-170602,170602,0,0,0,12,1.5,0.14531457,1
2020-04-01-170602,170602,1,0,0,13,0.5,0.05488593,2
2020-04-02-170602,170602,2,0,0,15,0.5,0.20188315,3
2020-04-03-170602,170602,0,0,0,15,2.0,0.17931326,4
2020-04-04-170602,170602,0,0,0,15,0.0,0.009088037,5
2020-04-05-170602,170602,1,0,0,16,0.5,0.048262138,6
2020-04-06-170602,170602,1,0,0,17,1.5,0.13659632,0
2020-04-07-170602,170602,0,0,0,17,1.0,0.13552327,1
2020-04-08-170602,170602,0,1,0,17,0.0,0.010963806,2
2020-04-09-170602,170602,0,0,0,17,0.5,0.045835808,3
2020-04-10-170602,170602,0,1,0,17,1.0,0.08042334,4
2020-04-11-170602,170602,0,0,0,17,0.0,0.006924375,5
2020-04-12-170602,170602,0,0,0,17,0.5,0.036862187,6
2020-04-13-170602,170602,0,0,0,17,0.0,0.064259015,0
2020-04-14-170602,170602,0,0,0,17,1.0,0.14536771,1
2020-04-15-170602,170602,0,0,0,17,1.0,0.14646202,2
2020-04-16-170602,170602,0,0,0,17,0.5,0.040904533,3
2020-04-17-170602,170602,0,0,0,17,0.0,0.007968033,4
2020-04-18-170602,170602,0,0,0,17,0.5,0.027313372,5
2020-04-19-170602,170602,0,0,0,17,0.5,0.01608109,6
2020-04-20-170602,170602,0,0,0,17,2.0,0.35536638,0
2020-04-21-170602,170602,0,0,0,17,0.5,0.066865824,1
2020-04-22-170602,170602,0,0,2,17,0.0,0.010425689,2
2020-04-23-170602,170602,0,0,1,17,0.5,0.066779,3
2020-04-24-170602,170602,0,0,0,17,0.0,0.035398692,4
2020-04-25-170602,170602,0,0,0,17,0.0,0.0009438314,5
2020-04-26-170602,170602,0,0,0,17,0.0,0.00080146675,6
2020-04-27-170602,170602,0,0,0,17,0.0,0.10145517,0
2020-04-28-170602,170602,0,0,0,17,2.0,0.30395117,1
2020-04-29-170602,170602,0,0,0,17,1.5,0.1535242,2
2020-04-30-170602,170602,0,0,0,17,0.0,0.008302732,3
2020-05-01-170602,170602,0,0,0,17,0.0,0.0043478743,4
2020-05-02-170602,170602,0,0,0,17,0.5,0.08776849,5
2020-05-03-170602,170602,0,0,0,17,0.0,0.0010147709,6
2020-05-04-170602,170602,0,0,0,17,0.5,0.11337966,0
2020-05-05-170602,170602,0,0,2,17,0.0,0.13246153,1
2020-05-06-170602,170602,2,0,0,19,0.5,0.6451743,2
2020-05-07-170602,170602,1,0,0,20,0.5,0.10835911,3
2020-05-08-170602,170602,0,2,0,20,0.0,0.07583861,4
2020-05-09-170602,170602,0,0,0,20,0.0,0.005166974,5
2020-05-10-170602,170602,0,0,0,20,0.0,0.00095970574,6
2020-05-11-170602,170602,0,0,0,20,0.0,0.02052734,0
2020-05-12-170602,170602,0,0,0,20,0.5,0.10698535,1
2020-05-13-170602,170602,0,0,0,20,1.0,0.11788808,2
2020-05-14-170602,170602,0,0,0,20,0.5,0.08418576,3
2020-05-15-170602,170602,0,0,0,20,0.0,0.008414612,4
2020-05-16-170602,170602,0,0,0,20,0.0,0.00094958954,5
2020-05-17-170602,170602,0,0,0,20,0.0,0.0008912738,6
2020-05-18-170602,170602,0,0,0,20,0.0,0.026807075,0
2020-05-19-170602,170602,2,0,0,22,0.0,0.068857566,1
2020-05-20-170602,170602,0,0,3,22,0.5,0.09134566,2
2020-05-21-170602,170602,0,0,0,22,0.0,0.0276496,3
2020-05-22-170602,170602,0,0,2,22,0.0,0.006431988,4
2020-05-23-170602,170602,0,0,0,22,0.0,0.0011275392,5
2020-05-24-170602,170602,0,0,0,22,0.0,0.0014355483,6
2020-05-25-170602,170602,0,0,0,22,0.0,0.0065833773,0
2020-05-26-170602,170602,0,0,0,22,0.0,0.0058778482,1
2020-05-27-170602,170602,0,1,0,22,1.0,0.202128,2
2020-05-28-170602,170602,0,0,0,22,0.0,0.012964778,3
2020-05-29-170602,170602,0,0,0,22,0.5,0.09733999,4
2020-05-30-170602,170602,0,0,0,22,0.0,0.00059888297,5
2020-05-31-170602,170602,0,0,0,22,0.0,8.326421e-05,6
2020-06-01-170602,170602,0,0,0,22,0.0,0.03413711,0
2020-06-02-170602,170602,0,0,0,22,0.0,0.01728596,1
2020-06-03-170602,170602,3,1,0,25,0.5,0.18343045,2
2020-06-04-170602,170602,0,0,0,25,0.0,0.017146515,3
2020-06-05-170602,170602,2,0,0,27,0.5,0.10836976,4
2020-06-06-170602,170602,0,1,0,27,0.0,0.00061678124,5
2020-06-07-170602,170602,0,0,0,27,0.0,0.004603264,6
2020-06-08-170602,170602,0,0,0,27,0.0,0.0025358265,0
2020-06-09-170602,170602,0,0,0,27,0.0,0.0020387906,1
2020-06-10-170602,170602,0,0,0,27,0.0,0.016321337,2
2020-06-11-170602,170602,0,0,0,27,0.0,0.009743963,3
2020-06-12-170602,170602,0,0,0,27,0.0,0.020087088,4
2020-06-13-170602,170602,0,0,0,27,0.0,0.0013978779,5
2020-06-14-170602,170602,0,0,0,27,0.0,0.00015691246,6
2020-06-15-170602,170602,0,0,0,27,0.0,0.0011023177,0
2020-06-16-170602,170602,0,1,0,27,0.0,0.0033031057,1
2020-06-17-170602,170602,0,0,0,27,0.0,0.009832497,2
2020-06-18-170602,170602,0,0,0,27,0.0,0.022192284,3
2020-06-19-170602,170602,0,0,0,27,0.0,0.011119973,4
2020-06-20-170602,170602,0,0,0,27,0.0,0.01895804,5
2020-06-21-170602,170602,0,0,0,27,0.0,0.00010721354,6
2020-06-22-170602,170602,0,0,0,27,0.5,0.03392895,0
2020-06-23-170602,170602,0,0,0,27,0.0,0.013472878,1
2020-06-24-170602,170602,0,2,0,27,0.0,0.01937915,2
2020-06-25-170602,170602,0,0,0,27,0.5,0.10577049,3
2020-06-26-170602,170602,0,0,0,27,0.0,0.0037873539,4
2020-06-27-170602,170602,0,0,0,27,0.0,0.0008690659,5
2020-06-28-170602,170602,0,0,0,27,0.0,0.0026729987,6
2020-06-29-170602,170602,0,0,0,27,0.0,0.008081736,0
2020-06-30-170602,170602,0,0,0,27,0.0,0.0023114113,1
2020-07-01-170602,170602,0,0,0,27,0.0,0.001006841,2
2020-07-02-170602,170602,0,0,0,27,0.0,0.017259387,3
2020-07-03-170602,170602,0,0,0,27,0.0,0.010217538,4
2020-07-04-170602,170602,0,0,0,27,0.0,8.219776e-05,5
2020-07-05-170602,170602,0,0,0,27,0.0,0.008770199,6
2020-07-06-170602,170602,0,0,0,27,0.0,0.00060772203,0
2020-07-07-170602,170602,0,0,0,27,0.0,0.0020087187,1
2020-07-08-170602,170602,0,0,0,27,0.0,0.00010916857,2
2020-07-09-170602,170602,0,0,0,27,0.0,0.0011793996,3
2020-07-10-170602,170602,0,0,0,27,0.0,0.0014339514,4
2020-07-11-170602,170602,0,0,0,27,0.0,0.00024177213,5
2020-07-12-170602,170602,0,0,0,27,0.0,0.0068947272,6
2020-07-13-170602,170602,0,0,0,27,0.0,0.014768994,0
2020-07-14-170602,170602,0,0,0,27,0.0,0.010132075,1
2020-07-15-170602,170602,0,0,0,27,0.0,0.00048859674,2
2020-07-16-170602,170602,0,0,0,27,0.5,0.0993587,3
2020-07-17-170602,170602,0,0,0,27,0.0,0.0014347853,4
2020-07-18-170602,170602,0,0,0,27,0.0,0.0025153826,5
2020-07-19-170602,170602,0,0,0,27,0.0,0.00053691736,6
2020-07-20-170602,170602,0,0,0,27,0.0,0.00021234846,0
2020-07-21-170602,170602,0,0,1,27,0.0,0.0029124557,1
2020-07-22-170602,170602,0,0,0,27,0.0,0.0036551552,2
2020-07-23-170602,170602,0,0,0,27,0.0,0.006078016,3
2020-07-24-170602,170602,0,0,0,27,0.0,0.0038679289,4
2020-07-25-170602,170602,0,0,0,27,0.0,0.001793528,5
2020-07-26-170602,170602,0,0,2,27,0.0,0.0003213879,6
2020-07-27-170602,170602,0,0,0,27,0.0,0.00016515327,0
2020-07-28-170602,170602,0,0,1,27,0.0,0.010048115,1
2020-07-29-170602,170602,0,0,1,27,0.5,0.10910519,2
2020-07-30-170602,170602,0,0,0,27,0.0,0.004763378,3
2020-07-31-170602,170602,0,0,1,27,0.0,0.01405298,4
2020-08-01-170602,170602,0,0,1,27,0.0,0.011982495,5
2020-08-02-170602,170602,0,0,2,27,0.0,0.0043601305,6
2020-08-03-170602,170602,0,0,2,27,0.0,0.0036744284,0
2020-08-04-170602,170602,1,0,3,28,0.0,0.042278606,1
2020-08-05-170602,170602,0,0,1,28,0.0,0.0071399244,2
2020-08-06-170602,170602,0,0,1,28,0.5,0.1455836,3
2020-08-07-170602,170602,0,0,1,28,1.0,0.24226604,4
2020-08-08-170602,170602,0,0,0,28,1.0,0.14128421,5
2020-08-09-170602,170602,2,0,1,30,0.5,0.14492425,6
2020-08-10-170602,170602,0,0,2,30,0.0,0.1585603,0
2020-08-11-170602,170602,1,0,1,31,0.0,0.10131791,1
2020-08-12-170602,170602,1,0,0,32,1.0,0.22075635,2
2020-08-13-170602,170602,0,0,1,32,2.0,0.5539082,3
2020-08-14-170602,170602,1,0,1,33,1.0,0.2725759,4
2020-08-15-170602,170602,1,0,2,34,0.5,0.08255818,5
2020-08-16-170602,170602,2,0,0,36,1.5,0.24996248,6
2020-08-17-170602,170602,2,0,0,38,2.0,0.23075637,0
2020-08-18-170602,170602,3,0,0,41,1.0,0.47604084,1
2020-08-19-170602,170602,1,0,0,42,0.0,0.18830527,2
2020-08-20-170602,170602,1,0,5,43,0.5,0.1934525,3
2020-08-21-170602,170602,1,0,0,44,1.5,0.31873986,4
2020-08-22-170602,170602,0,0,2,44,0.5,0.15766543,5
2020-08-23-170602,170602,1,0,0,45,1.5,0.1573996,6
2020-08-24-170602,170602,2,0,1,47,2.0,0.19239825,0
2020-08-25-170602,170602,1,0,0,48,2.5,0.5740419,1
2020-08-26-170602,170602,0,0,0,48,1.0,0.5411302,2
2020-08-27-170602,170602,1,0,2,49,1.0,0.21212368,3
2020-08-28-170602,170602,1,0,0,50,1.0,0.4982161,4
2020-08-29-170602,170602,2,1,0,52,6.0,0.60457563,5
2020-08-30-170602,170602,0,0,0,52,0.5,0.04561896,6
2020-08-31-170602,170602,0,0,0,52,4.5,0.26791662,0
2020-09-01-170602,170602,0,0,0,52,7.5,0.77890724,1
2020-09-02-170602,170602,0,0,0,52,6.5,0.7101674,2
2020-09-03-170602,170602,5,0,0,57,4.5,0.56569403,3
2020-09-04-170602,170602,0,0,0,57,0.0,0.07589001,4
2020-09-05-170602,170602,2,0,0,59,4.0,0.1710888,5
2020-09-06-170602,170602,0,0,0,59,2.5,0.1818263,6
2020-09-07-170602,170602,1,0,0,60,5.0,0.2358504,0
2020-09-08-170602,170602,0,0,0,60,0.0,0.08405767,1
2020-09-09-170602,170602,0,0,1,60,0.5,0.11676448,2
2020-09-10-170602,170602,2,0,2,62,0.5,0.18150726,3
2020-09-11-170602,170602,0,0,1,62,1.5,0.06442559,4
2020-09-12-170602,170602,0,0,0,62,1.5,0.14154981,5
2020-09-13-170602,170602,0,0,0,62,0.5,0.15690659,6
2020-09-14-170602,170602,0,0,1,62,1.5,0.113803655,0
2020-09-15-170602,170602,0,0,0,62,0.0,0.019363588,1
2020-09-16-170602,170602,0,0,0,62,0.0,0.027753176,2
2020-09-17-170602,170602,0,0,1,62,1.0,0.19812827,3
2020-09-18-170602,170602,0,0,0,62,0.5,0.16813111,4
2020-09-19-170602,170602,0,1,0,62,0.5,0.1054591,5
2020-09-20-170602,170602,0,0,1,62,0.5,0.12793249,6
2020-09-21-170602,170602,0,0,0,62,1.0,0.044308502,0
2020-09-22-170602,170602,0,1,0,62,0.5,0.25747466,1
2020-09-23-170602,170602,1,0,0,63,0.5,0.34014374,2
2020-09-24-170602,170602,2,0,1,65,0.0,0.35299116,3
2020-09-25-170602,170602,1,0,0,66,0.5,0.39328307,4
2020-09-26-170602,170602,0,0,0,66,0.5,0.13100743,5
2020-09-27-170602,170602,0,0,1,66,0.5,0.13519661,6
2020-09-28-170602,170602,1,0,0,67,0.0,0.022588067,0
2020-09-29-170602,170602,0,0,0,67,1.5,0.2980184,1
2020-09-30-170602,170602,0,0,0,67,2.5,0.45724523,2
2020-10-01-170602,170602,1,0,2,68,2.5,0.57924235,3
2020-10-02-170602,170602,0,0,1,68,1.5,0.13283964,4
2020-10-03-170602,170602,0,0,1,68,0.0,0.08131004,5
2020-10-04-170602,170602,1,2,2,69,0.5,0.108615495,6
2020-10-05-170602,170602,0,0,3,69,0.5,0.051883876,0
2020-10-06-170602,170602,0,0,2,69,0.0,0.119455434,1
2020-10-07-170602,170602,0,0,1,69,0.5,0.27768815,2
2020-10-08-170602,170602,1,0,3,70,0.0,0.07859281,3
2020-10-09-170602,170602,0,0,2,70,1.5,0.2548012,4
2020-10-10-170602,170602,0,0,0,70,0.0,0.08027903,5
2020-10-11-170602,170602,1,0,2,71,0.0,0.05488248,6
2020-10-12-170602,170602,0,0,6,71,0.0,0.013638906,0
2020-10-13-170602,170602,0,0,7,71,2.0,0.3738211,1
2020-10-14-170602,170602,0,0,6,71,1.0,0.26944068,2
2020-10-15-170602,170602,2,0,7,73,1.0,0.2589076,3
2020-10-16-170602,170602,1,0,0,74,1.0,0.25913167,4
2020-10-17-170602,170602,1,0,3,75,0.5,0.106220305,5
2020-10-18-170602,170602,2,1,0,77,1.5,0.17354068,6
2020-10-19-170602,170602,3,0,0,80,2.5,0.2346587,0
2020-10-20-170602,170602,2,0,1,82,0.5,0.27183068,1
2020-10-21-170602,170602,1,0,0,83,0.5,0.22529088,2
2020-10-22-170602,170602,3,0,4,86,2.5,0.4281317,3
2020-10-23-170602,170602,2,0,2,88,0.5,0.8026007,4
2020-10-24-170602,170602,0,0,0,88,1.0,0.17661406,5
2020-10-25-170602,170602,2,0,0,90,0.0,0.17004251,6
2020-10-26-170602,170602,6,0,1,96,0.5,0.18038185,0
2020-10-27-170602,170602,7,0,0,103,0.5,0.35632408,1
2020-10-28-170602,170602,6,1,0,109,1.0,0.39532298,2
2020-10-29-170602,170602,7,0,0,116,1.0,0.49257237,3
2020-10-30-170602,170602,0,0,1,116,1.0,0.36877337,4
2020-10-31-170602,170602,3,0,0,119,0.0,0.17629486,5
2020-11-01-170602,170602,0,0,0,119,0.0,0.042531993,6
2020-11-02-170602,170602,0,0,0,119,0.0,0.018593337,0
2020-11-03-170602,170602,1,0,0,120,1.0,0.21211062,1
2020-11-04-170602,170602,0,1,0,120,0.5,0.23088011,2
2020-11-05-170602,170602,4,0,0,124,1.0,0.3622103,3
2020-11-06-170602,170602,2,1,0,126,2.0,0.520129,4
2020-11-07-170602,170602,0,0,0,126,0.0,0.041173764,5
2020-11-08-170602,170602,0,1,0,126,0.5,0.108748525,6
2020-11-09-170602,170602,1,0,0,127,0.0,0.07323781,0
2020-11-10-170602,170602,0,1,0,127,0.0,0.051008817,1
2020-11-11-170602,170602,0,0,0,127,0.0,0.23975839,2
2020-11-12-170602,170602,0,1,0,127,0.0,0.13676801,3
2020-11-13-170602,170602,1,2,0,128,0.0,0.19796507,4
2020-03-01-170603,170603,0,0,1,0,0.0,0.0011166511,6
2020-03-02-170603,170603,0,0,6,0,0.25,0.32975662,0
2020-03-03-170603,170603,0,0,5,0,0.0,0.00907406,1
2020-03-04-170603,170603,0,0,7,0,0.0,0.009048177,2
2020-03-05-170603,170603,0,0,8,0,0.0,0.09576777,3
2020-03-06-170603,170603,0,0,10,0,0.0,0.1018386,4
2020-03-07-170603,170603,0,0,2,0,0.0,0.0006078126,5
2020-03-08-170603,170603,0,0,4,0,0.0,0.0027499008,6
2020-03-09-170603,170603,0,0,24,0,0.0,0.0124394195,0
2020-03-10-170603,170603,0,0,12,0,0.0,0.027718602,1
2020-03-11-170603,170603,0,0,10,0,0.0,0.120332435,2
2020-03-12-170603,170603,0,0,11,0,0.5,0.36565027,3
2020-03-13-170603,170603,2,0,22,2,0.75,1.7321877,4
2020-03-14-170603,170603,0,0,7,2,0.25,0.32020894,5
2020-03-15-170603,170603,1,0,8,3,0.5,0.579292,6
2020-03-16-170603,170603,6,0,16,9,0.5,2.9288847,0
2020-03-17-170603,170603,5,1,13,14,1.75,3.2794383,1
2020-03-18-170603,170603,7,0,15,21,2.0,4.444184,2
2020-03-19-170603,170603,8,0,12,29,3.25,5.2728972,3
2020-03-20-170603,170603,10,0,12,39,3.0,5.275344,4
2020-03-21-170603,170603,2,0,9,41,0.75,0.85468477,5
2020-03-22-170603,170603,4,0,3,45,1.25,1.3577538,6
2020-03-23-170603,170603,24,0,19,69,4.25,9.717603,0
2020-03-24-170603,170603,12,0,24,81,2.5,5.6348624,1
2020-03-25-170603,170603,10,0,9,91,3.5,6.157645,2
2020-03-26-170603,170603,11,0,23,102,4.5,6.637228,3
2020-03-27-170603,170603,22,0,5,124,3.75,11.173293,4
2020-03-28-170603,170603,7,0,3,131,0.25,2.2476554,5
2020-03-29-170603,170603,8,0,7,139,2.0,2.2031846,6
2020-03-30-170603,170603,16,0,12,155,2.75,6.867653,0
2020-03-31-170603,170603,13,0,14,168,3.25,6.324975,1
2020-04-01-170603,170603,15,0,7,183,1.5,6.4675274,2
2020-04-02-170603,170603,12,0,6,195,2.25,5.074289,3
2020-04-03-170603,170603,12,0,9,207,1.25,5.7000403,4
2020-04-04-170603,170603,9,0,2,216,0.5,3.125282,5
2020-04-05-170603,170603,3,0,0,219,1.25,1.0161712,6
2020-04-06-170603,170603,19,0,7,238,2.0,7.295987,0
2020-04-07-170603,170603,24,0,5,262,1.25,9.797019,1
2020-04-08-170603,170603,9,0,4,271,1.75,4.435863,2
2020-04-09-170603,170603,23,1,7,294,3.0,6.174928,3
2020-04-10-170603,170603,5,0,6,299,1.25,1.6323942,4
2020-04-11-170603,170603,3,1,1,302,0.5,1.1122818,5
2020-04-12-170603,170603,7,0,0,309,0.0,1.9443076,6
2020-04-13-170603,170603,12,0,7,321,1.75,5.5442815,0
2020-04-14-170603,170603,14,0,6,335,1.25,6.4418063,1
2020-04-15-170603,170603,7,0,5,342,5.25,4.163277,2
2020-04-16-170603,170603,6,0,6,348,1.25,2.9144404,3
2020-04-17-170603,170603,9,0,3,357,3.0,3.8238063,4
2020-04-18-170603,170603,2,0,1,359,0.5,0.95696574,5
2020-04-19-170603,170603,0,0,0,359,0.5,0.11030331,6
2020-04-20-170603,170603,7,0,7,366,1.5,4.733645,0
2020-04-21-170603,170603,5,1,4,371,1.75,3.4886181,1
2020-04-22-170603,170603,4,0,82,375,0.75,2.2321928,2
2020-04-23-170603,170603,7,0,25,382,0.0,2.25724,3
2020-04-24-170603,170603,6,0,8,388,0.5,2.2941356,4
2020-04-25-170603,170603,1,0,0,389,0.25,0.12880684,5
2020-04-26-170603,170603,0,0,0,389,0.25,0.060843725,6
2020-04-27-170603,170603,7,1,11,396,1.25,3.401067,0
2020-04-28-170603,170603,6,0,8,402,1.0,2.9789488,1
2020-04-29-170603,170603,5,0,10,407,1.5,2.293877,2
2020-04-30-170603,170603,6,0,7,413,0.25,2.757621,3
2020-05-01-170603,170603,3,0,1,416,0.25,1.0104108,4
2020-05-02-170603,170603,1,0,0,417,0.25,0.7712221,5
2020-05-03-170603,170603,0,0,0,417,0.5,0.21069947,6
2020-05-04-170603,170603,7,0,0,424,1.5,4.6804795,0
2020-05-05-170603,170603,4,0,1,428,1.25,2.6567132,1
2020-05-06-170603,170603,82,0,0,510,1.5,39.81924,2
2020-05-07-170603,170603,25,0,4,535,2.0,11.844211,3
2020-05-08-170603,170603,8,0,2,543,2.0,5.2252245,4
2020-05-09-170603,170603,0,0,0,543,0.0,0.03966943,5
2020-05-10-170603,170603,0,0,0,543,0.25,0.023289364,6
2020-05-11-170603,170603,11,2,1,554,0.75,5.3874693,0
2020-05-12-170603,170603,8,0,0,562,0.5,3.7866366,1
2020-05-13-170603,170603,10,0,0,572,1.0,5.1333756,2
2020-05-14-170603,170603,7,1,1,579,1.0,3.5627556,3
2020-05-15-170603,170603,1,0,4,580,0.0,0.55568093,4
2020-05-16-170603,170603,0,0,1,580,0.0,0.005154759,5
2020-05-17-170603,170603,0,0,0,580,0.0,0.015464908,6
2020-05-18-170603,170603,0,0,3,580,0.5,0.32894933,0
2020-05-19-170603,170603,1,0,2,581,0.75,1.1806871,1
2020-05-20-170603,170603,0,0,3,581,0.75,0.64374745,2
2020-05-21-170603,170603,4,0,2,585,1.25,2.643121,3
2020-05-22-170603,170603,2,0,1,587,1.0,1.5755363,4
2020-05-23-170603,170603,0,0,0,587,0.75,0.13386515,5
2020-05-24-170603,170603,0,0,0,587,0.0,0.17554845,6
2020-05-25-170603,170603,1,0,1,588,0.25,0.8050182,0
2020-05-26-170603,170603,0,0,3,588,1.25,0.39074722,1
2020-05-27-170603,170603,0,0,0,588,1.0,0.7178263,2
2020-05-28-170603,170603,1,0,3,589,0.75,1.064491,3
2020-05-29-170603,170603,4,0,0,593,1.0,3.240952,4
2020-05-30-170603,170603,1,0,0,594,0.0,0.5979352,5
2020-05-31-170603,170603,0,0,0,594,0.0,0.0006433686,6
2020-06-01-170603,170603,3,0,0,597,1.0,2.521077,0
2020-06-02-170603,170603,2,0,0,599,0.0,1.4490511,1
2020-06-03-170603,170603,3,0,3,602,0.75,2.0409133,2
2020-06-04-170603,170603,2,0,0,604,0.75,1.6970116,3
2020-06-05-170603,170603,1,0,0,605,0.75,1.3477634,4
2020-06-06-170603,170603,0,0,0,605,0.25,0.075155295,5
2020-06-07-170603,170603,0,0,0,605,0.0,0.008875815,6
2020-06-08-170603,170603,1,0,1,606,0.5,0.7301393,0
2020-06-09-170603,170603,3,0,0,609,0.5,2.2622635,1
2020-06-10-170603,170603,0,0,0,609,0.25,0.32663554,2
2020-06-11-170603,170603,3,0,0,612,0.75,2.1371238,3
2020-06-12-170603,170603,0,0,0,612,0.25,0.1889501,4
2020-06-13-170603,170603,0,0,2,612,0.25,0.1297615,5
2020-06-14-170603,170603,0,0,0,612,0.25,0.11966657,6
2020-06-15-170603,170603,0,0,0,612,0.0,0.11650339,0
2020-06-16-170603,170603,0,0,0,612,0.25,0.26575652,1
2020-06-17-170603,170603,3,0,0,615,0.5,1.4799571,2
2020-06-18-170603,170603,0,1,1,615,0.75,0.52837145,3
2020-06-19-170603,170603,0,0,1,615,0.75,0.48072293,4
2020-06-20-170603,170603,0,0,0,615,0.0,2.4388457e-05,5
2020-06-21-170603,170603,0,0,0,615,0.0,0.0015387555,6
2020-06-22-170603,170603,1,0,1,616,1.0,1.2067643,0
2020-06-23-170603,170603,0,0,0,616,0.0,0.20730531,1
2020-06-24-170603,170603,0,0,0,616,0.5,0.9190238,2
2020-06-25-170603,170603,0,0,0,616,0.0,0.02866197,3
2020-06-26-170603,170603,0,1,0,616,0.25,0.08280637,4
2020-06-27-170603,170603,2,0,0,618,0.0,1.4156635,5
2020-06-28-170603,170603,0,0,0,618,0.0,0.020094149,6
2020-06-29-170603,170603,0,0,0,618,0.0,0.09180736,0
2020-06-30-170603,170603,0,0,0,618,0.25,0.19877206,1
2020-07-01-170603,170603,0,0,0,618,0.25,0.014061052,2
2020-07-02-170603,170603,1,0,1,619,0.25,0.854564,3
2020-07-03-170603,170603,1,0,3,620,0.0,0.74805915,4
2020-07-04-170603,170603,0,0,0,620,0.25,0.0011852669,5
2020-07-05-170603,170603,0,0,0,620,0.0,0.012486088,6
2020-07-06-170603,170603,1,0,0,621,0.75,0.9817391,0
2020-07-07-170603,170603,0,0,0,621,0.0,0.018525679,1
2020-07-08-170603,170603,0,0,1,621,0.0,0.013811916,2
2020-07-09-170603,170603,0,0,0,621,0.0,0.018921448,3
2020-07-10-170603,170603,0,0,2,621,0.0,0.017248422,4
2020-07-11-170603,170603,0,0,0,621,0.25,0.15768585,5
2020-07-12-170603,170603,0,0,1,621,0.25,0.24940014,6
2020-07-13-170603,170603,0,0,0,621,0.75,0.38100526,0
2020-07-14-170603,170603,0,0,3,621,0.75,0.54185784,1
2020-07-15-170603,170603,0,0,1,621,0.25,0.0068685245,2
2020-07-16-170603,170603,1,0,2,622,0.0,0.77144057,3
2020-07-17-170603,170603,3,0,1,625,0.0,1.5333012,4
2020-07-18-170603,170603,0,0,2,625,0.0,0.03945719,5
2020-07-19-170603,170603,0,0,1,625,0.0,0.0013034025,6
2020-07-20-170603,170603,0,0,3,625,0.25,0.13106905,0
2020-07-21-170603,170603,0,0,1,625,0.25,0.24002396,1
2020-07-22-170603,170603,1,0,0,626,0.5,0.96011615,2
2020-07-23-170603,170603,0,0,3,626,1.0,1.276419,3
2020-07-24-170603,170603,2,0,4,628,0.0,0.78168,4
2020-07-25-170603,170603,0,0,0,628,0.0,0.0088904975,5
2020-07-26-170603,170603,1,0,0,629,0.0,0.6757766,6
2020-07-27-170603,170603,0,0,5,629,0.0,0.020600596,0
2020-07-28-170603,170603,3,1,1,632,1.5,2.8238041,1
2020-07-29-170603,170603,1,0,0,633,1.25,0.78123474,2
2020-07-30-170603,170603,2,0,6,635,0.5,0.22902232,3
2020-07-31-170603,170603,1,0,1,636,0.0,0.20650849,4
2020-08-01-170603,170603,2,0,1,638,0.0,2.0352097,5
2020-08-02-170603,170603,1,0,0,639,0.75,1.045024,6
2020-08-03-170603,170603,3,1,6,642,0.25,1.7126764,0
2020-08-04-170603,170603,1,0,3,643,0.25,1.1971207,1
2020-08-05-170603,170603,0,0,1,643,0.25,0.40555447,2
2020-08-06-170603,170603,3,0,8,646,4.5,6.4713407,3
2020-08-07-170603,170603,4,0,14,650,0.25,3.7222302,4
2020-08-08-170603,170603,0,1,0,650,0.25,0.4270456,5
2020-08-09-170603,170603,0,0,0,650,0.0,0.11240431,6
2020-08-10-170603,170603,5,0,0,655,1.5,4.49987,0
2020-08-11-170603,170603,1,0,3,656,1.25,1.5387832,1
2020-08-12-170603,170603,0,0,0,656,1.5,1.2945577,2
2020-08-13-170603,170603,6,1,1,662,2.0,5.455513,3
2020-08-14-170603,170603,1,1,0,663,1.0,1.8322154,4
2020-08-15-170603,170603,1,0,3,664,2.0,1.7940097,5
2020-08-16-170603,170603,0,0,1,664,0.75,0.65790343,6
2020-08-17-170603,170603,6,0,4,670,1.75,6.099639,0
2020-08-18-170603,170603,3,0,2,673,1.0,5.2407956,1
2020-08-19-170603,170603,1,0,3,674,2.75,7.32287,2
2020-08-20-170603,170603,8,0,1,682,3.0,10.57764,3
2020-08-21-170603,170603,14,1,4,696,2.5,11.09504,4
2020-08-22-170603,170603,0,0,1,696,0.75,0.3456487,5
2020-08-23-170603,170603,0,0,0,696,0.5,0.18779403,6
2020-08-24-170603,170603,0,0,0,696,1.75,1.6150527,0
2020-08-25-170603,170603,3,0,1,699,3.0,3.7146828,1
2020-08-26-170603,170603,0,0,9,699,1.0,0.91970193,2
2020-08-27-170603,170603,1,0,1,700,3.0,3.134181,3
2020-08-28-170603,170603,0,0,3,700,2.0,2.5673664,4
2020-08-29-170603,170603,3,0,6,703,1.75,3.1860695,5
2020-08-30-170603,170603,1,0,0,704,0.75,1.0782168,6
2020-08-31-170603,170603,4,0,10,708,1.0,3.540762,0
2020-09-01-170603,170603,2,0,5,710,1.25,2.9651349,1
2020-09-02-170603,170603,3,0,8,713,1.75,3.527982,2
2020-09-03-170603,170603,1,0,12,714,2.75,2.7241402,3
2020-09-04-170603,170603,4,0,11,718,5.75,4.49376,4
2020-09-05-170603,170603,1,0,5,719,0.25,0.9752609,5
2020-09-06-170603,170603,0,0,5,719,1.75,1.6339792,6
2020-09-07-170603,170603,0,0,4,719,2.5,2.1323254,0
2020-09-08-170603,170603,1,1,12,720,1.25,0.8995779,1
2020-09-09-170603,170603,9,0,4,729,1.0,4.2401237,2
2020-09-10-170603,170603,1,0,15,730,2.0,2.2689316,3
2020-09-11-170603,170603,3,0,8,733,1.5,2.7899516,4
2020-09-12-170603,170603,6,0,3,739,1.25,4.1340013,5
2020-09-13-170603,170603,0,0,1,739,1.0,0.62892103,6
2020-09-14-170603,170603,10,0,8,749,5.0,8.0831175,0
2020-09-15-170603,170603,5,0,3,754,1.25,4.4289904,1
2020-09-16-170603,170603,8,1,9,762,1.75,5.7756534,2
2020-09-17-170603,170603,12,0,12,774,3.5,8.441749,3
2020-09-18-170603,170603,11,0,7,785,8.75,6.8729525,4
2020-09-19-170603,170603,5,0,2,790,2.5,5.1369386,5
2020-09-20-170603,170603,5,1,3,795,1.5,2.4330812,6
2020-09-21-170603,170603,4,0,3,799,7.75,5.9511003,0
2020-09-22-170603,170603,12,0,2,811,7.75,10.718209,1
2020-09-23-170603,170603,4,0,17,815,5.25,4.781592,2
2020-09-24-170603,170603,15,0,12,830,9.0,13.392346,3
2020-09-25-170603,170603,8,1,11,838,13.5,10.768821,4
2020-09-26-170603,170603,3,0,0,841,7.0,5.1080475,5
2020-09-27-170603,170603,1,0,4,842,0.5,1.1969864,6
2020-09-28-170603,170603,8,1,2,850,5.5,8.913948,0
2020-09-29-170603,170603,3,0,3,853,5.0,5.983236,1
2020-09-30-170603,170603,9,0,2,862,5.0,5.5198607,2
2020-10-01-170603,170603,12,0,9,874,3.5,12.406564,3
2020-10-02-170603,170603,7,1,2,881,5.25,6.046655,4
2020-10-03-170603,170603,2,0,2,883,1.0,1.9127661,5
2020-10-04-170603,170603,3,0,4,886,4.25,3.2851021,6
2020-10-05-170603,170603,3,0,12,889,5.75,6.997663,0
2020-10-06-170603,170603,2,2,4,891,3.75,4.750572,1
2020-10-07-170603,170603,17,0,8,908,0.75,13.641931,2
2020-10-08-170603,170603,12,0,2,920,3.25,8.627421,3
2020-10-09-170603,170603,11,2,10,931,5.25,9.62274,4
2020-10-10-170603,170603,0,0,5,931,2.75,1.6556325,5
2020-10-11-170603,170603,4,0,5,935,3.75,4.914491,6
2020-10-12-170603,170603,2,0,5,937,2.0,2.2763314,0
2020-10-13-170603,170603,3,0,16,940,5.0,5.230017,1
2020-10-14-170603,170603,2,0,8,942,2.5,3.452187,2
2020-10-15-170603,170603,9,0,5,951,3.5,6.8097844,3
2020-10-16-170603,170603,2,0,16,953,10.0,5.397214,4
2020-10-17-170603,170603,2,0,3,955,1.25,3.3809862,5
2020-10-18-170603,170603,4,0,4,959,2.25,3.2207875,6
2020-10-19-170603,170603,12,1,11,971,4.5,12.3510895,0
2020-10-20-170603,170603,4,1,6,975,5.5,7.097137,1
2020-10-21-170603,170603,8,0,13,983,3.25,7.4607415,2
2020-10-22-170603,170603,2,0,8,985,7.75,7.0677977,3
2020-10-23-170603,170603,10,0,8,995,6.0,10.410363,4
2020-10-24-170603,170603,5,1,3,1000,2.75,4.495908,5
2020-10-25-170603,170603,5,0,4,1005,2.25,4.488093,6
2020-10-26-170603,170603,5,1,5,1010,3.75,6.26618,0
2020-10-27-170603,170603,16,1,6,1026,3.75,14.756298,1
2020-10-28-170603,170603,8,0,19,1034,6.25,9.907028,2
2020-10-29-170603,170603,5,1,13,1039,4.0,10.414813,3
2020-10-30-170603,170603,16,0,28,1055,5.75,10.861166,4
2020-10-31-170603,170603,3,1,0,1058,1.25,2.978638,5
2020-11-01-170603,170603,4,0,0,1062,1.75,3.5247416,6
2020-11-02-170603,170603,11,0,0,1073,3.0,7.7125506,0
2020-11-03-170603,170603,6,0,0,1079,4.5,7.9931254,1
2020-11-04-170603,170603,13,0,0,1092,5.0,11.262348,2
2020-11-05-170603,170603,8,0,0,1100,2.25,6.2017875,3
2020-11-06-170603,170603,8,3,0,1108,4.0,7.9245305,4
2020-11-07-170603,170603,3,1,0,1111,2.0,2.8986723,5
2020-11-08-170603,170603,4,0,0,1115,0.5,3.4141586,6
2020-11-09-170603,170603,5,0,0,1120,1.25,4.7068596,0
2020-11-10-170603,170603,6,1,0,1126,3.0,6.0428815,1
2020-11-11-170603,170603,19,1,0,1145,3.75,15.133864,2
2020-11-12-170603,170603,13,0,0,1158,4.5,11.758106,3
2020-11-13-170603,170603,28,1,0,1186,2.75,18.678856,4
2020-03-01-170604,170604,0,0,1,0,0.0,0.0040745973,6
2020-03-02-170604,170604,0,0,1,0,0.0,0.008607088,0
2020-03-03-170604,170604,0,0,0,0,0.0,0.012804862,1
2020-03-04-170604,170604,0,1,1,0,0.0,0.011968741,2
2020-03-05-170604,170604,0,0,1,0,0.0,0.003366764,3
2020-03-06-170604,170604,0,0,3,0,0.0,0.005557687,4
2020-03-07-170604,170604,0,0,1,0,0.0,0.0037640943,5
2020-03-08-170604,170604,0,0,1,0,0.16666666666666666,0.019093078,6
2020-03-09-170604,170604,0,0,3,0,0.0,0.018662976,0
2020-03-10-170604,170604,0,0,3,0,0.0,0.03969539,1
2020-03-11-170604,170604,1,0,5,1,0.3333333333333333,0.124575436,2
2020-03-12-170604,170604,0,0,4,1,0.0,0.049298722,3
2020-03-13-170604,170604,0,0,2,1,0.8333333333333334,0.14051813,4
2020-03-14-170604,170604,0,0,0,1,0.5,0.13665341,5
2020-03-15-170604,170604,1,0,2,2,2.333333333333333,0.4993918,6
2020-03-16-170604,170604,1,0,2,3,3.0,0.72259635,0
2020-03-17-170604,170604,0,0,2,3,4.333333333333333,1.0624254,1
2020-03-18-170604,170604,1,0,1,4,3.6666666666666665,0.88713354,2
2020-03-19-170604,170604,1,0,0,5,6.5,1.339228,3
2020-03-20-170604,170604,3,2,1,8,5.666666666666668,1.4751651,4
2020-03-21-170604,170604,1,3,0,9,2.1666666666666665,0.4328558,5
2020-03-22-170604,170604,1,0,0,10,3.5,0.48474064,6
2020-03-23-170604,170604,3,0,0,13,11.333333333333336,2.8534317,0
2020-03-24-170604,170604,3,0,0,16,7.333333333333332,1.848806,1
2020-03-25-170604,170604,5,0,2,21,9.0,2.8155649,2
2020-03-26-170604,170604,4,0,1,25,6.333333333333332,1.9473305,3
2020-03-27-170604,170604,2,0,0,27,8.5,2.1465492,4
2020-03-28-170604,170604,0,0,1,27,1.1666666666666667,0.33024475,5
2020-03-29-170604,170604,2,0,0,29,2.1666666666666665,0.5284588,6
2020-03-30-170604,170604,2,0,0,31,5.666666666666668,2.0724075,0
2020-03-31-170604,170604,2,0,0,33,5.833333333333332,1.4538369,1
2020-04-01-170604,170604,1,0,0,34,7.333333333333332,1.3095853,2
2020-04-02-170604,170604,0,1,1,34,2.6666666666666665,0.8167054,3
2020-04-03-170604,170604,1,0,0,35,4.5,1.250243,4
2020-04-04-170604,170604,0,0,0,35,1.0,0.17993408,5
2020-04-05-170604,170604,0,0,0,35,1.0,0.23569351,6
2020-04-06-170604,170604,0,1,0,35,8.0,2.3796387,0
2020-04-07-170604,170604,0,0,0,35,8.666666666666666,1.423981,1
2020-04-08-170604,170604,2,0,0,37,3.8333333333333335,0.7460549,2
2020-04-09-170604,170604,1,0,0,38,1.1666666666666667,0.4297692,3
2020-04-10-170604,170604,0,1,0,38,3.6666666666666665,1.0822588,4
2020-04-11-170604,170604,1,0,0,39,1.8333333333333333,0.37559578,5
2020-04-12-170604,170604,0,0,0,39,3.5,0.36280504,6
2020-04-13-170604,170604,0,0,1,39,3.8333333333333335,1.2009959,0
2020-04-14-170604,170604,0,0,0,39,8.166666666666666,1.4201539,1
2020-04-15-170604,170604,0,0,0,39,3.6666666666666665,0.9804337,2
2020-04-16-170604,170604,1,0,0,40,3.333333333333333,0.46436507,3
2020-04-17-170604,170604,0,0,0,40,4.833333333333333,0.7876915,4
2020-04-18-170604,170604,0,0,0,40,1.8333333333333333,0.37288243,5
2020-04-19-170604,170604,0,0,0,40,0.5,0.07076177,6
2020-04-20-170604,170604,0,0,0,40,3.1666666666666665,0.6399264,0
2020-04-21-170604,170604,0,0,0,40,7.833333333333332,2.0914767,1
2020-04-22-170604,170604,0,1,0,40,5.5,0.84858495,2
2020-04-23-170604,170604,0,0,1,40,1.0,0.26249576,3
2020-04-24-170604,170604,0,0,2,40,3.1666666666666665,0.7254828,4
2020-04-25-170604,170604,0,0,1,40,1.1666666666666667,0.26927537,5
2020-04-26-170604,170604,0,0,0,40,0.16666666666666666,0.0800878,6
2020-04-27-170604,170604,1,1,0,41,2.5,0.67294794,0
2020-04-28-170604,170604,0,0,0,41,1.8333333333333333,0.4607005,1
2020-04-29-170604,170604,0,0,0,41,2.833333333333333,0.67396164,2
2020-04-30-170604,170604,0,0,0,41,2.6666666666666665,0.56324476,3
2020-05-01-170604,170604,0,0,0,41,2.0,0.2879415,4
2020-05-02-170604,170604,0,0,0,41,0.5,0.08676753,5
2020-05-03-170604,170604,0,0,0,41,0.8333333333333334,0.0651865,6
2020-05-04-170604,170604,0,0,0,41,3.8333333333333335,0.87470394,0
2020-05-05-170604,170604,0,0,0,41,3.6666666666666665,0.43973967,1
2020-05-06-170604,170604,0,0,0,41,1.1666666666666667,0.58336633,2
2020-05-07-170604,170604,1,0,0,42,3.333333333333333,1.7962794,3
2020-05-08-170604,170604,2,0,0,44,4.0,0.83203673,4
2020-05-09-170604,170604,1,0,0,45,1.0,0.2226605,5
2020-05-10-170604,170604,0,0,0,45,0.3333333333333333,0.026574647,6
2020-05-11-170604,170604,0,1,0,45,2.5,0.5939728,0
2020-05-12-170604,170604,0,6,0,45,5.0,0.8775703,1
2020-05-13-170604,170604,0,0,0,45,3.8333333333333335,0.46481195,2
2020-05-14-170604,170604,0,0,0,45,0.6666666666666666,0.2370106,3
2020-05-15-170604,170604,0,1,0,45,2.833333333333333,0.41468817,4
2020-05-16-170604,170604,0,1,0,45,0.16666666666666666,0.020388497,5
2020-05-17-170604,170604,0,0,0,45,0.0,0.0022377737,6
2020-05-18-170604,170604,0,0,0,45,0.8333333333333334,0.32297736,0
2020-05-19-170604,170604,0,0,0,45,1.6666666666666667,0.24864885,1
2020-05-20-170604,170604,0,0,2,45,0.6666666666666666,0.39456204,2
2020-05-21-170604,170604,0,0,0,45,1.3333333333333333,0.33753783,3
2020-05-22-170604,170604,0,0,1,45,1.1666666666666667,0.3075045,4
2020-05-23-170604,170604,0,0,0,45,0.16666666666666666,0.117092565,5
2020-05-24-170604,170604,0,0,0,45,0.0,0.008382194,6
2020-05-25-170604,170604,0,0,0,45,2.1666666666666665,0.41805527,0
2020-05-26-170604,170604,0,0,0,45,0.6666666666666666,0.12624127,1
2020-05-27-170604,170604,0,0,0,45,0.3333333333333333,0.1389825,2
2020-05-28-170604,170604,0,2,0,45,0.8333333333333334,0.2839762,3
2020-05-29-170604,170604,0,0,1,45,0.8333333333333334,0.1964623,4
2020-05-30-170604,170604,0,0,0,45,0.0,0.024833232,5
2020-05-31-170604,170604,0,0,0,45,0.0,0.0012925802,6
2020-06-01-170604,170604,0,0,0,45,1.0,0.26014367,0
2020-06-02-170604,170604,0,0,0,45,0.5,0.22501034,1
2020-06-03-170604,170604,2,0,0,47,0.5,0.29162714,2
2020-06-04-170604,170604,0,0,0,47,0.6666666666666666,0.32139382,3
2020-06-05-170604,170604,1,0,0,48,0.3333333333333333,0.40964216,4
2020-06-06-170604,170604,0,0,0,48,0.0,0.012194463,5
2020-06-07-170604,170604,0,0,0,48,0.0,0.024884645,6
2020-06-08-170604,170604,0,0,0,48,0.5,0.09906777,0
2020-06-09-170604,170604,0,0,0,48,0.3333333333333333,0.094183914,1
2020-06-10-170604,170604,0,0,0,48,0.3333333333333333,0.04701384,2
2020-06-11-170604,170604,0,0,0,48,1.1666666666666667,0.1250701,3
2020-06-12-170604,170604,1,0,0,49,0.5,0.2795776,4
2020-06-13-170604,170604,0,0,0,49,0.0,0.0011944845,5
2020-06-14-170604,170604,0,0,0,49,0.0,0.0007461247,6
2020-06-15-170604,170604,0,0,0,49,0.0,0.025288388,0
2020-06-16-170604,170604,0,1,0,49,0.5,0.13304217,1
2020-06-17-170604,170604,0,0,0,49,0.16666666666666666,0.07415522,2
2020-06-18-170604,170604,0,0,0,49,0.3333333333333333,0.10268521,3
2020-06-19-170604,170604,0,0,0,49,0.6666666666666666,0.24789067,4
2020-06-20-170604,170604,0,0,0,49,0.16666666666666666,0.0034997677,5
2020-06-21-170604,170604,0,0,0,49,0.0,0.002190473,6
2020-06-22-170604,170604,0,0,0,49,0.3333333333333333,0.11096938,0
2020-06-23-170604,170604,0,0,0,49,0.3333333333333333,0.12295157,1
2020-06-24-170604,170604,0,0,0,49,0.3333333333333333,0.1323437,2
2020-06-25-170604,170604,0,0,0,49,0.3333333333333333,0.06916753,3
2020-06-26-170604,170604,0,0,0,49,0.8333333333333334,0.11063789,4
2020-06-27-170604,170604,0,0,0,49,0.16666666666666666,0.02288783,5
2020-06-28-170604,170604,0,0,0,49,0.16666666666666666,0.11445286,6
2020-06-29-170604,170604,0,0,0,49,0.3333333333333333,0.08793654,0
2020-06-30-170604,170604,0,0,0,49,0.16666666666666666,0.14749177,1
2020-07-01-170604,170604,0,0,0,49,0.16666666666666666,0.03735656,2
2020-07-02-170604,170604,0,0,0,49,0.16666666666666666,0.016514627,3
2020-07-03-170604,170604,0,1,0,49,0.5,0.08537447,4
2020-07-04-170604,170604,0,0,0,49,0.16666666666666666,0.012809815,5
2020-07-05-170604,170604,0,0,0,49,0.16666666666666666,0.09843563,6
2020-07-06-170604,170604,0,0,0,49,0.0,0.01897908,0
2020-07-07-170604,170604,0,0,0,49,0.0,0.012178949,1
2020-07-08-170604,170604,0,0,0,49,0.0,0.010355484,2
2020-07-09-170604,170604,0,0,0,49,0.0,0.030358953,3
2020-07-10-170604,170604,0,0,0,49,0.3333333333333333,0.03519211,4
2020-07-11-170604,170604,0,0,0,49,0.0,0.0013289433,5
2020-07-12-170604,170604,0,0,0,49,0.0,0.028199458,6
2020-07-13-170604,170604,0,0,0,49,0.5,0.090042405,0
2020-07-14-170604,170604,0,0,0,49,0.5,0.06379445,1
2020-07-15-170604,170604,0,0,0,49,0.0,0.004517265,2
2020-07-16-170604,170604,0,0,0,49,0.16666666666666666,0.053962015,3
2020-07-17-170604,170604,0,0,0,49,0.16666666666666666,0.017270863,4
2020-07-18-170604,170604,0,0,0,49,0.16666666666666666,0.009399088,5
2020-07-19-170604,170604,0,0,0,49,0.0,0.0011528487,6
2020-07-20-170604,170604,0,0,0,49,0.3333333333333333,0.03249787,0
2020-07-21-170604,170604,0,0,0,49,0.0,0.021668999,1
2020-07-22-170604,170604,0,0,0,49,0.8333333333333334,0.07848619,2
2020-07-23-170604,170604,0,0,0,49,0.0,0.007615878,3
2020-07-24-170604,170604,0,0,0,49,0.0,0.009891428,4
2020-07-25-170604,170604,0,0,0,49,0.0,0.002832701,5
2020-07-26-170604,170604,0,0,0,49,0.0,0.0030944292,6
2020-07-27-170604,170604,0,0,0,49,0.3333333333333333,0.05799812,0
2020-07-28-170604,170604,0,0,2,49,0.16666666666666666,0.05040108,1
2020-07-29-170604,170604,0,0,0,49,0.16666666666666666,0.047810752,2
2020-07-30-170604,170604,0,0,0,49,0.3333333333333333,0.4020205,3
2020-07-31-170604,170604,0,0,0,49,0.16666666666666666,0.08551056,4
2020-08-01-170604,170604,0,0,0,49,0.3333333333333333,0.11446662,5
2020-08-02-170604,170604,0,0,1,49,0.3333333333333333,0.11712961,6
2020-08-03-170604,170604,0,0,1,49,1.5,0.5033249,0
2020-08-04-170604,170604,0,0,1,49,0.3333333333333333,0.1554583,1
2020-08-05-170604,170604,0,0,0,49,1.0,0.3679032,2
2020-08-06-170604,170604,0,0,3,49,0.8333333333333334,0.4002663,3
2020-08-07-170604,170604,0,1,0,49,1.0,0.7441762,4
2020-08-08-170604,170604,0,0,0,49,0.5,0.18578517,5
2020-08-09-170604,170604,0,0,0,49,0.0,0.047996514,6
2020-08-10-170604,170604,0,0,0,49,2.333333333333333,0.724237,0
2020-08-11-170604,170604,2,0,1,51,0.5,0.60923475,1
2020-08-12-170604,170604,0,0,2,51,0.6666666666666666,0.34072778,2
2020-08-13-170604,170604,0,0,0,51,1.0,0.4183275,3
2020-08-14-170604,170604,0,0,0,51,0.5,0.28508645,4
2020-08-15-170604,170604,0,0,1,51,0.3333333333333333,0.078703895,5
2020-08-16-170604,170604,1,0,0,52,0.5,0.2815866,6
2020-08-17-170604,170604,1,0,1,53,0.8333333333333334,0.4566495,0
2020-08-18-170604,170604,1,0,1,54,1.6666666666666667,0.61706734,1
2020-08-19-170604,170604,0,0,1,54,0.8333333333333334,0.35151294,2
2020-08-20-170604,170604,3,0,0,57,1.6666666666666667,0.7672178,3
2020-08-21-170604,170604,0,0,2,57,1.0,0.47183046,4
2020-08-22-170604,170604,0,0,1,57,0.5,0.1479707,5
2020-08-23-170604,170604,0,0,0,57,2.6666666666666665,0.3315512,6
2020-08-24-170604,170604,0,0,1,57,3.0,0.9634038,0
2020-08-25-170604,170604,1,0,0,58,1.5,0.5380921,1
2020-08-26-170604,170604,2,0,0,60,2.5,0.9460884,2
2020-08-27-170604,170604,0,0,0,60,1.3333333333333333,0.75161415,3
2020-08-28-170604,170604,0,0,1,60,2.1666666666666665,1.0274509,4
2020-08-29-170604,170604,1,0,0,61,0.3333333333333333,0.35131857,5
2020-08-30-170604,170604,0,0,0,61,0.5,0.12503484,6
2020-08-31-170604,170604,1,0,2,62,1.6666666666666667,1.4001131,0
2020-09-01-170604,170604,1,0,0,63,0.8333333333333334,0.81234473,1
2020-09-02-170604,170604,1,0,0,64,0.8333333333333334,0.5533321,2
2020-09-03-170604,170604,0,0,0,64,2.0,0.6481222,3
2020-09-04-170604,170604,2,0,1,66,4.333333333333333,0.96348226,4
2020-09-05-170604,170604,1,0,0,67,0.3333333333333333,0.34171078,5
2020-09-06-170604,170604,0,0,0,67,0.0,0.32913086,6
2020-09-07-170604,170604,1,0,0,68,3.0,0.8374242,0
2020-09-08-170604,170604,0,0,1,68,1.6666666666666667,0.4032863,1
2020-09-09-170604,170604,0,0,0,68,1.0,0.28044,2
2020-09-10-170604,170604,0,0,0,68,1.1666666666666667,0.6185609,3
2020-09-11-170604,170604,1,0,1,69,2.1666666666666665,1.3452072,4
2020-09-12-170604,170604,0,0,0,69,1.3333333333333333,0.31062418,5
2020-09-13-170604,170604,0,0,0,69,1.6666666666666667,0.31170386,6
2020-09-14-170604,170604,2,0,0,71,3.0,1.0651511,0
2020-09-15-170604,170604,0,0,1,71,1.6666666666666667,0.6845371,1
2020-09-16-170604,170604,0,0,2,71,0.6666666666666666,0.90404284,2
2020-09-17-170604,170604,0,0,0,71,2.1666666666666665,0.4742917,3
2020-09-18-170604,170604,1,0,1,72,4.0,1.3264073,4
2020-09-19-170604,170604,0,0,4,72,2.6666666666666665,0.44583067,5
2020-09-20-170604,170604,0,0,0,72,2.0,0.5772014,6
2020-09-21-170604,170604,0,0,1,72,7.166666666666668,0.926506,0
2020-09-22-170604,170604,1,0,0,73,5.0,0.96736324,1
2020-09-23-170604,170604,0,0,2,73,5.333333333333333,1.1145834,2
2020-09-24-170604,170604,0,0,0,73,4.833333333333333,1.1264716,3
2020-09-25-170604,170604,1,1,1,74,5.166666666666667,0.8885047,4
2020-09-26-170604,170604,0,0,1,74,2.1666666666666665,0.470897,5
2020-09-27-170604,170604,0,0,0,74,1.1666666666666667,0.3396732,6
2020-09-28-170604,170604,0,0,0,74,3.6666666666666665,0.71266073,0
2020-09-29-170604,170604,1,0,0,75,2.1666666666666665,0.8859931,1
2020-09-30-170604,170604,2,0,0,77,2.833333333333333,1.1669971,2
2020-10-01-170604,170604,0,1,1,77,2.6666666666666665,0.6228488,3
2020-10-02-170604,170604,1,0,5,78,3.0,0.73426723,4
2020-10-03-170604,170604,4,0,2,82,2.833333333333333,0.632198,5
2020-10-04-170604,170604,0,0,0,82,1.3333333333333333,0.25474766,6
2020-10-05-170604,170604,1,0,1,83,11.333333333333336,1.8530759,0
2020-10-06-170604,170604,0,0,9,83,3.333333333333333,0.9579945,1
2020-10-07-170604,170604,2,1,5,85,4.166666666666667,1.958035,2
2020-10-08-170604,170604,0,0,2,85,4.166666666666667,0.900041,3
2020-10-09-170604,170604,1,0,2,86,3.1666666666666665,1.3122487,4
2020-10-10-170604,170604,1,0,1,87,1.6666666666666667,0.42482537,5
2020-10-11-170604,170604,0,0,1,87,1.3333333333333333,0.3240711,6
2020-10-12-170604,170604,0,0,3,87,1.0,0.46904933,0
2020-10-13-170604,170604,0,0,1,87,2.5,1.0036279,1
2020-10-14-170604,170604,0,0,0,87,2.6666666666666665,0.68870544,2
2020-10-15-170604,170604,1,0,0,88,3.5,1.1967901,3
2020-10-16-170604,170604,5,0,5,93,4.666666666666667,1.9712998,4
2020-10-17-170604,170604,2,0,2,95,1.3333333333333333,0.61245555,5
2020-10-18-170604,170604,0,0,2,95,1.6666666666666667,0.5380384,6
2020-10-19-170604,170604,1,0,1,96,4.166666666666667,1.0156785,0
2020-10-20-170604,170604,9,0,2,105,4.333333333333333,1.5533316,1
2020-10-21-170604,170604,5,0,1,110,10.166666666666666,1.988285,2
2020-10-22-170604,170604,2,0,1,112,10.0,1.6142893,3
2020-10-23-170604,170604,2,0,0,114,7.0,1.4946808,4
2020-10-24-170604,170604,1,0,0,115,2.0,0.43157345,5
2020-10-25-170604,170604,1,0,0,116,3.0,0.79779536,6
2020-10-26-170604,170604,3,0,0,119,4.0,1.244155,0
2020-10-27-170604,170604,1,0,4,120,5.666666666666668,1.21229,1
2020-10-28-170604,170604,0,0,0,120,6.333333333333332,1.1927984,2
2020-10-29-170604,170604,0,0,0,120,5.166666666666667,1.3918837,3
2020-10-30-170604,170604,5,0,1,125,7.5,1.4280846,4
2020-10-31-170604,170604,2,0,0,127,2.0,0.5013996,5
2020-11-01-170604,170604,2,0,0,129,2.333333333333333,0.6311984,6
2020-11-02-170604,170604,1,0,0,130,1.0,0.35123044,0
2020-11-03-170604,170604,2,0,0,132,6.0,1.4023309,1
2020-11-04-170604,170604,1,0,0,133,3.6666666666666665,1.0246192,2
2020-11-05-170604,170604,1,1,0,134,5.833333333333332,1.2619865,3
2020-11-06-170604,170604,0,0,0,134,4.666666666666667,1.0298806,4
2020-11-07-170604,170604,0,0,0,134,1.6666666666666667,0.22770725,5
2020-11-08-170604,170604,0,0,0,134,2.333333333333333,0.3212451,6
2020-11-09-170604,170604,0,0,0,134,4.0,0.9395775,0
2020-11-10-170604,170604,4,0,0,138,2.333333333333333,0.7398472,1
2020-11-11-170604,170604,0,0,0,138,5.833333333333332,0.7304698,2
2020-11-12-170604,170604,0,0,0,138,2.0,0.71178627,3
2020-11-13-170604,170604,1,0,0,139,3.8333333333333335,0.5709402,4
2020-03-01-170605,170605,0,0,0,0,0.16666666666666666,0.05169203,6
2020-03-02-170605,170605,0,0,1,0,0.0,0.0005959759,0
2020-03-03-170605,170605,0,0,1,0,0.0,0.0032156238,1
2020-03-04-170605,170605,0,0,0,0,0.0,0.003390143,2
2020-03-05-170605,170605,0,0,0,0,0.0,0.0013856435,3
2020-03-06-170605,170605,0,0,0,0,0.0,0.0011545061,4
2020-03-07-170605,170605,0,0,0,0,0.0,0.0002619806,5
2020-03-08-170605,170605,0,0,0,0,0.0,0.0011458829,6
2020-03-09-170605,170605,0,0,1,0,0.0,0.0027180784,0
2020-03-10-170605,170605,0,0,0,0,0.0,0.007741698,1
2020-03-11-170605,170605,0,0,1,0,0.16666666666666666,0.032017525,2
2020-03-12-170605,170605,0,0,1,0,0.16666666666666666,0.0892161,3
2020-03-13-170605,170605,0,0,2,0,0.3333333333333333,0.06219205,4
2020-03-14-170605,170605,0,0,1,0,0.3333333333333333,0.14052996,5
2020-03-15-170605,170605,0,0,0,0,0.0,0.06026038,6
2020-03-16-170605,170605,1,0,0,1,2.1666666666666665,0.55028635,0
2020-03-17-170605,170605,1,0,0,2,1.8333333333333333,0.44390634,1
2020-03-18-170605,170605,0,0,0,2,1.1666666666666667,0.39859298,2
2020-03-19-170605,170605,0,0,0,2,1.5,0.31339502,3
2020-03-20-170605,170605,0,0,3,2,2.5,0.5958951,4
2020-03-21-170605,170605,0,0,0,2,1.5,0.24333102,5
2020-03-22-170605,170605,0,0,0,2,1.0,0.1988016,6
2020-03-23-170605,170605,1,0,1,3,8.166666666666666,1.1982834,0
2020-03-24-170605,170605,0,0,1,3,3.0,0.71552515,1
2020-03-25-170605,170605,1,0,2,4,3.8333333333333335,1.1021335,2
2020-03-26-170605,170605,1,0,0,5,3.6666666666666665,0.81522363,3
2020-03-27-170605,170605,2,0,0,7,5.166666666666667,1.0354285,4
2020-03-28-170605,170605,1,0,1,8,1.5,0.19367209,5
2020-03-29-170605,170605,0,0,0,8,0.8333333333333334,0.15949737,6
2020-03-30-170605,170605,0,0,1,8,8.666666666666666,1.13311,0
2020-03-31-170605,170605,0,0,0,8,2.833333333333333,0.6328797,1
2020-04-01-170605,170605,0,0,1,8,3.333333333333333,0.76224154,2
2020-04-02-170605,170605,0,0,1,8,2.1666666666666665,0.39965633,3
2020-04-03-170605,170605,3,0,0,11,2.5,0.6293632,4
2020-04-04-170605,170605,0,0,0,11,1.1666666666666667,0.12444179,5
2020-04-05-170605,170605,0,0,0,11,0.6666666666666666,0.13082732,6
2020-04-06-170605,170605,1,1,0,12,4.166666666666667,0.64152974,0
2020-04-07-170605,170605,1,0,0,13,1.6666666666666667,0.29095092,1
2020-04-08-170605,170605,2,0,0,15,1.8333333333333333,0.35155818,2
2020-04-09-170605,170605,0,0,0,15,0.3333333333333333,0.13319395,3
2020-04-10-170605,170605,0,1,1,15,1.8333333333333333,0.2339938,4
2020-04-11-170605,170605,1,0,0,16,0.6666666666666666,0.15042572,5
2020-04-12-170605,170605,0,0,0,16,0.8333333333333334,0.04369219,6
2020-04-13-170605,170605,1,0,0,17,2.333333333333333,0.4867824,0
2020-04-14-170605,170605,0,0,1,17,1.1666666666666667,0.4206631,1
2020-04-15-170605,170605,1,0,0,18,1.5,0.46402183,2
2020-04-16-170605,170605,1,0,0,19,1.1666666666666667,0.36696827,3
2020-04-17-170605,170605,0,0,0,19,1.8333333333333333,0.4576655,4
2020-04-18-170605,170605,0,0,0,19,0.16666666666666666,0.080794185,5
2020-04-19-170605,170605,0,0,0,19,0.5,0.11836324,6
2020-04-20-170605,170605,0,0,0,19,0.6666666666666666,0.24367727,0
2020-04-21-170605,170605,0,0,0,19,2.5,0.5020561,1
2020-04-22-170605,170605,0,0,0,19,0.6666666666666666,0.32418963,2
2020-04-23-170605,170605,0,0,0,19,0.5,0.0841811,3
2020-04-24-170605,170605,1,0,0,20,2.1666666666666665,0.33065996,4
2020-04-25-170605,170605,0,0,0,20,0.3333333333333333,0.06495717,5
2020-04-26-170605,170605,0,0,0,20,0.3333333333333333,0.03878246,6
2020-04-27-170605,170605,0,0,0,20,1.0,0.19417098,0
2020-04-28-170605,170605,1,0,0,21,1.3333333333333333,0.30552697,1
2020-04-29-170605,170605,0,0,0,21,1.3333333333333333,0.31279206,2
2020-04-30-170605,170605,0,0,0,21,0.6666666666666666,0.23724627,3
2020-05-01-170605,170605,0,0,0,21,0.3333333333333333,0.083921954,4
2020-05-02-170605,170605,0,0,0,21,0.3333333333333333,0.1242233,5
2020-05-03-170605,170605,0,0,0,21,0.0,0.0073226006,6
2020-05-04-170605,170605,0,0,0,21,0.5,0.47202593,0
2020-05-05-170605,170605,0,0,0,21,0.5,0.2207641,1
2020-05-06-170605,170605,0,0,0,21,0.5,0.9434074,2
2020-05-07-170605,170605,0,0,0,21,2.1666666666666665,0.6170688,3
2020-05-08-170605,170605,0,0,0,21,1.0,0.3160955,4
2020-05-09-170605,170605,0,2,0,21,0.16666666666666666,0.07399912,5
2020-05-10-170605,170605,0,0,0,21,0.0,0.009551659,6
2020-05-11-170605,170605,0,1,2,21,1.0,0.22957908,0
2020-05-12-170605,170605,0,0,0,21,0.3333333333333333,0.15232518,1
2020-05-13-170605,170605,0,4,1,21,0.5,0.10810774,2
2020-05-14-170605,170605,0,3,0,21,0.6666666666666666,0.11785672,3
2020-05-15-170605,170605,0,0,0,21,1.0,0.21933027,4
2020-05-16-170605,170605,0,0,0,21,0.0,0.0010299631,5
2020-05-17-170605,170605,0,0,0,21,0.0,0.009446399,6
2020-05-18-170605,170605,0,0,0,21,1.1666666666666667,0.22586234,0
2020-05-19-170605,170605,0,0,0,21,0.3333333333333333,0.119586036,1
2020-05-20-170605,170605,0,0,0,21,1.0,0.1193468,2
2020-05-21-170605,170605,0,0,0,21,0.3333333333333333,0.067058146,3
2020-05-22-170605,170605,0,0,0,21,0.6666666666666666,0.2595567,4
2020-05-23-170605,170605,0,0,0,21,0.16666666666666666,0.032462038,5
2020-05-24-170605,170605,0,0,0,21,0.0,0.017415388,6
2020-05-25-170605,170605,2,0,0,23,1.0,0.2732815,0
2020-05-26-170605,170605,0,0,1,23,0.5,0.07071496,1
2020-05-27-170605,170605,1,2,0,24,0.3333333333333333,0.087740414,2
2020-05-28-170605,170605,0,0,0,24,1.5,0.3273204,3
2020-05-29-170605,170605,0,1,0,24,0.6666666666666666,0.069615774,4
2020-05-30-170605,170605,0,0,0,24,0.0,0.0028954414,5
2020-05-31-170605,170605,0,0,0,24,0.0,0.0033940745,6
2020-06-01-170605,170605,0,0,0,24,0.16666666666666666,0.08876102,0
2020-06-02-170605,170605,0,0,1,24,0.8333333333333334,0.23564197,1
2020-06-03-170605,170605,0,0,0,24,1.0,0.16022305,2
2020-06-04-170605,170605,0,0,1,24,0.5,0.08465227,3
2020-06-05-170605,170605,0,0,0,24,0.6666666666666666,0.26612437,4
2020-06-06-170605,170605,0,0,0,24,0.0,0.026255984,5
2020-06-07-170605,170605,0,0,0,24,0.0,0.002137293,6
2020-06-08-170605,170605,0,0,0,24,0.5,0.100197986,0
2020-06-09-170605,170605,1,0,0,25,0.3333333333333333,0.06838315,1
2020-06-10-170605,170605,0,0,0,25,0.3333333333333333,0.094013065,2
2020-06-11-170605,170605,0,0,0,25,0.16666666666666666,0.026761636,3
2020-06-12-170605,170605,0,0,0,25,0.3333333333333333,0.07052484,4
2020-06-13-170605,170605,0,0,0,25,0.0,0.00083136826,5
2020-06-14-170605,170605,0,0,0,25,0.0,0.0011442553,6
2020-06-15-170605,170605,0,1,0,25,0.0,0.010828037,0
2020-06-16-170605,170605,1,0,0,26,0.0,0.08037135,1
2020-06-17-170605,170605,0,0,0,26,0.16666666666666666,0.09320923,2
2020-06-18-170605,170605,1,0,0,27,0.5,0.19844224,3
2020-06-19-170605,170605,0,0,0,27,1.0,0.297423,4
2020-06-20-170605,170605,0,0,0,27,0.0,0.0023197976,5
2020-06-21-170605,170605,0,0,0,27,0.0,0.0036872863,6
2020-06-22-170605,170605,0,0,0,27,0.3333333333333333,0.11607007,0
2020-06-23-170605,170605,0,0,0,27,0.5,0.23488604,1
2020-06-24-170605,170605,0,0,0,27,0.16666666666666666,0.067457564,2
2020-06-25-170605,170605,0,0,0,27,0.3333333333333333,0.09704804,3
2020-06-26-170605,170605,0,0,0,27,0.16666666666666666,0.031949718,4
2020-06-27-170605,170605,0,0,0,27,0.0,0.016471324,5
2020-06-28-170605,170605,0,0,0,27,0.16666666666666666,0.041632116,6
2020-06-29-170605,170605,0,0,0,27,0.0,0.03032043,0
2020-06-30-170605,170605,0,0,0,27,0.16666666666666666,0.04790609,1
2020-07-01-170605,170605,0,0,0,27,0.0,0.00892966,2
2020-07-02-170605,170605,0,0,0,27,0.16666666666666666,0.030127276,3
2020-07-03-170605,170605,0,0,0,27,0.0,0.016249755,4
2020-07-04-170605,170605,0,0,0,27,0.0,0.021800691,5
2020-07-05-170605,170605,0,0,0,27,0.3333333333333333,0.03385434,6
2020-07-06-170605,170605,0,0,0,27,0.0,0.0073540844,0
2020-07-07-170605,170605,0,0,0,27,0.0,0.016513716,1
2020-07-08-170605,170605,0,0,0,27,0.16666666666666666,0.09129004,2
2020-07-09-170605,170605,0,1,0,27,0.16666666666666666,0.09180721,3
2020-07-10-170605,170605,0,0,0,27,0.0,0.020949572,4
2020-07-11-170605,170605,0,0,0,27,0.3333333333333333,0.019910282,5
2020-07-12-170605,170605,0,0,0,27,0.0,0.017103093,6
2020-07-13-170605,170605,0,0,0,27,0.16666666666666666,0.08904791,0
2020-07-14-170605,170605,0,0,0,27,0.16666666666666666,0.033064783,1
2020-07-15-170605,170605,0,0,0,27,0.3333333333333333,0.012944643,2
2020-07-16-170605,170605,0,0,0,27,0.8333333333333334,0.16734657,3
2020-07-17-170605,170605,0,0,1,27,0.0,0.022201443,4
2020-07-18-170605,170605,0,0,0,27,0.0,0.017049892,5
2020-07-19-170605,170605,0,0,0,27,0.5,0.030968811,6
2020-07-20-170605,170605,0,0,0,27,0.3333333333333333,0.02333112,0
2020-07-21-170605,170605,0,0,0,27,0.3333333333333333,0.045236755,1
2020-07-22-170605,170605,0,0,0,27,0.0,0.034268264,2
2020-07-23-170605,170605,0,0,0,27,0.16666666666666666,0.0177136,3
2020-07-24-170605,170605,0,0,0,27,0.3333333333333333,0.021516478,4
2020-07-25-170605,170605,0,0,0,27,0.0,0.0038734206,5
2020-07-26-170605,170605,0,0,0,27,0.16666666666666666,0.0142016215,6
2020-07-27-170605,170605,0,0,1,27,0.3333333333333333,0.03308737,0
2020-07-28-170605,170605,0,0,0,27,0.0,0.017234357,1
2020-07-29-170605,170605,0,0,0,27,0.0,0.02376367,2
2020-07-30-170605,170605,0,0,3,27,0.5,0.20425391,3
2020-07-31-170605,170605,1,0,2,28,0.16666666666666666,0.06403419,4
2020-08-01-170605,170605,0,0,0,28,0.0,0.020661157,5
2020-08-02-170605,170605,0,0,2,28,0.0,0.05715041,6
2020-08-03-170605,170605,0,0,0,28,0.6666666666666666,0.14653243,0
2020-08-04-170605,170605,0,0,0,28,0.5,0.2289673,1
2020-08-05-170605,170605,0,0,0,28,0.5,0.15566562,2
2020-08-06-170605,170605,0,0,0,28,0.3333333333333333,0.10421201,3
2020-08-07-170605,170605,0,1,0,28,1.1666666666666667,0.30940405,4
2020-08-08-170605,170605,0,0,0,28,0.0,0.101192944,5
2020-08-09-170605,170605,0,0,0,28,0.0,0.047668915,6
2020-08-10-170605,170605,1,0,2,29,0.3333333333333333,0.2278624,0
2020-08-11-170605,170605,0,0,0,29,0.5,0.31296098,1
2020-08-12-170605,170605,0,0,0,29,0.3333333333333333,0.39359915,2
2020-08-13-170605,170605,3,0,0,32,0.6666666666666666,0.43376845,3
2020-08-14-170605,170605,2,0,2,34,1.5,0.81386006,4
2020-08-15-170605,170605,0,0,0,34,0.16666666666666666,0.034332767,5
2020-08-16-170605,170605,2,0,0,36,0.3333333333333333,0.2601062,6
2020-08-17-170605,170605,0,0,0,36,0.8333333333333334,0.23560373,0
2020-08-18-170605,170605,0,0,0,36,0.6666666666666666,0.3084667,1
2020-08-19-170605,170605,0,0,1,36,2.0,0.38481417,2
2020-08-20-170605,170605,0,0,1,36,1.1666666666666667,0.54192275,3
2020-08-21-170605,170605,0,0,0,36,1.1666666666666667,0.43919697,4
2020-08-22-170605,170605,0,0,0,36,0.16666666666666666,0.263502,5
2020-08-23-170605,170605,0,0,0,36,0.6666666666666666,0.2227537,6
2020-08-24-170605,170605,2,0,1,38,3.333333333333333,0.78863615,0
2020-08-25-170605,170605,0,0,0,38,3.333333333333333,0.98843586,1
2020-08-26-170605,170605,0,0,1,38,3.1666666666666665,1.1496866,2
2020-08-27-170605,170605,0,0,0,38,3.333333333333333,1.3163161,3
2020-08-28-170605,170605,2,0,2,40,2.1666666666666665,0.88470304,4
2020-08-29-170605,170605,0,0,1,40,0.8333333333333334,0.4813516,5
2020-08-30-170605,170605,0,0,0,40,1.6666666666666667,0.4969397,6
2020-08-31-170605,170605,0,0,1,40,3.8333333333333335,1.3921579,0
2020-09-01-170605,170605,0,0,0,40,3.0,0.9813032,1
2020-09-02-170605,170605,1,0,0,41,1.8333333333333333,0.53321147,2
2020-09-03-170605,170605,1,0,1,42,1.6666666666666667,0.78162783,3
2020-09-04-170605,170605,0,0,1,42,2.5,0.6816163,4
2020-09-05-170605,170605,0,0,0,42,3.1666666666666665,0.62314713,5
2020-09-06-170605,170605,0,0,0,42,2.1666666666666665,1.3240738,6
2020-09-07-170605,170605,1,0,0,43,4.5,1.0120996,0
2020-09-08-170605,170605,0,0,0,43,1.6666666666666667,0.31536368,1
2020-09-09-170605,170605,1,0,1,44,1.0,0.26372725,2
2020-09-10-170605,170605,0,0,1,44,2.5,0.7008197,3
2020-09-11-170605,170605,2,0,0,46,5.0,1.0276111,4
2020-09-12-170605,170605,1,0,0,47,2.6666666666666665,0.71755373,5
2020-09-13-170605,170605,0,0,0,47,3.1666666666666665,1.006118,6
2020-09-14-170605,170605,1,0,0,48,4.5,0.6526346,0
2020-09-15-170605,170605,0,0,0,48,5.833333333333332,0.7967998,1
2020-09-16-170605,170605,0,0,4,48,3.6666666666666665,1.3996592,2
2020-09-17-170605,170605,1,0,0,49,3.0,0.9194323,3
2020-09-18-170605,170605,1,0,1,50,13.333333333333336,1.0818608,4
2020-09-19-170605,170605,0,0,0,50,6.333333333333332,1.7317239,5
2020-09-20-170605,170605,0,0,2,50,4.166666666666667,1.1134539,6
2020-09-21-170605,170605,0,0,0,50,2.333333333333333,0.8995603,0
2020-09-22-170605,170605,0,0,0,50,1.8333333333333333,0.4827414,1
2020-09-23-170605,170605,1,0,0,51,5.333333333333333,0.89636254,2
2020-09-24-170605,170605,1,0,0,52,4.833333333333333,0.91924405,3
2020-09-25-170605,170605,0,0,1,52,3.333333333333333,0.54512346,4
2020-09-26-170605,170605,0,0,1,52,3.1666666666666665,0.24624099,5
2020-09-27-170605,170605,0,0,0,52,1.3333333333333333,0.39662495,6
2020-09-28-170605,170605,0,0,0,52,2.1666666666666665,0.45575872,0
2020-09-29-170605,170605,0,0,1,52,1.8333333333333333,0.27701053,1
2020-09-30-170605,170605,4,0,0,56,3.8333333333333335,1.0987732,2
2020-10-01-170605,170605,0,0,3,56,2.6666666666666665,0.68341833,3
2020-10-02-170605,170605,1,0,5,57,2.0,0.4519899,4
2020-10-03-170605,170605,0,0,4,57,1.6666666666666667,0.25973743,5
2020-10-04-170605,170605,2,0,1,59,1.3333333333333333,0.2653034,6
2020-10-05-170605,170605,0,0,1,59,1.5,0.64714074,0
2020-10-06-170605,170605,0,0,1,59,3.333333333333333,0.40769428,1
2020-10-07-170605,170605,0,0,3,59,4.0,1.2237196,2
2020-10-08-170605,170605,0,0,3,59,3.0,0.72988594,3
2020-10-09-170605,170605,1,0,0,60,4.0,0.87184143,4
2020-10-10-170605,170605,1,0,2,61,1.0,0.37270248,5
2020-10-11-170605,170605,0,0,1,61,0.3333333333333333,0.1896978,6
2020-10-12-170605,170605,0,0,3,61,0.8333333333333334,0.32702726,0
2020-10-13-170605,170605,1,0,2,62,3.0,0.724698,1
2020-10-14-170605,170605,0,0,0,62,1.8333333333333333,0.6477115,2
2020-10-15-170605,170605,3,0,1,65,3.333333333333333,1.0937207,3
2020-10-16-170605,170605,5,0,6,70,3.8333333333333335,1.3854052,4
2020-10-17-170605,170605,4,0,3,74,1.1666666666666667,0.5046835,5
2020-10-18-170605,170605,1,0,0,75,1.8333333333333333,0.53090256,6
2020-10-19-170605,170605,1,1,2,76,3.8333333333333335,1.6848968,0
2020-10-20-170605,170605,1,0,0,77,2.6666666666666665,0.87223476,1
2020-10-21-170605,170605,3,0,2,80,3.0,1.1941438,2
2020-10-22-170605,170605,3,0,5,83,4.166666666666667,1.5312802,3
2020-10-23-170605,170605,0,0,1,83,4.666666666666667,1.7630367,4
2020-10-24-170605,170605,2,0,0,85,1.3333333333333333,0.48033953,5
2020-10-25-170605,170605,1,0,0,86,0.6666666666666666,0.2589882,6
2020-10-26-170605,170605,3,0,0,89,9.166666666666666,1.6257019,0
2020-10-27-170605,170605,2,0,1,91,3.6666666666666665,1.0259547,1
2020-10-28-170605,170605,0,0,1,91,2.6666666666666665,0.73500717,2
2020-10-29-170605,170605,1,0,0,92,4.333333333333333,1.5062373,3
2020-10-30-170605,170605,6,0,4,98,4.166666666666667,1.2079461,4
2020-10-31-170605,170605,3,0,0,101,4.833333333333333,0.6535918,5
2020-11-01-170605,170605,0,0,0,101,2.6666666666666665,0.36316574,6
2020-11-02-170605,170605,2,0,0,103,4.333333333333333,0.42677295,0
2020-11-03-170605,170605,0,0,0,103,5.166666666666667,1.1501001,1
2020-11-04-170605,170605,2,0,0,105,5.166666666666667,1.7900174,2
2020-11-05-170605,170605,5,0,0,110,4.5,1.0426632,3
2020-11-06-170605,170605,1,0,0,111,3.8333333333333335,1.5495872,4
2020-11-07-170605,170605,0,0,0,111,2.5,0.21234997,5
2020-11-08-170605,170605,0,0,0,111,1.1666666666666667,0.34538728,6
2020-11-09-170605,170605,0,0,0,111,4.666666666666667,1.4522964,0
2020-11-10-170605,170605,1,0,0,112,4.0,0.89356667,1
2020-11-11-170605,170605,1,1,0,113,2.6666666666666665,0.6961228,2
2020-11-12-170605,170605,0,3,0,113,5.333333333333333,1.1111801,3
2020-11-13-170605,170605,4,0,0,117,2.6666666666666665,0.9272866,4
2020-03-01-170606,170606,0,0,4,0,0.0,0.0019444263,6
2020-03-02-170606,170606,0,0,20,0,0.0,0.10021297,0
2020-03-03-170606,170606,0,0,11,0,0.0,0.005139397,1
2020-03-04-170606,170606,0,0,15,0,0.0,0.0038747233,2
2020-03-05-170606,170606,0,0,14,0,0.14285714285714285,0.12495939,3
2020-03-06-170606,170606,0,0,20,0,0.14285714285714285,0.12652735,4
2020-03-07-170606,170606,0,0,5,0,0.0,0.002693457,5
2020-03-08-170606,170606,0,0,4,0,0.0,0.0008951775,6
2020-03-09-170606,170606,0,0,24,0,0.0,0.00572692,0
2020-03-10-170606,170606,0,0,23,0,0.0,0.017476778,1
2020-03-11-170606,170606,0,0,25,0,0.14285714285714285,0.12448745,2
2020-03-12-170606,170606,0,0,16,0,0.0,0.13045934,3
2020-03-13-170606,170606,0,0,13,0,0.0,0.2163649,4
2020-03-14-170606,170606,1,0,11,1,0.42857142857142855,0.5858162,5
2020-03-15-170606,170606,4,0,7,5,0.42857142857142855,1.1533026,6
2020-03-16-170606,170606,20,0,13,25,0.5714285714285714,5.888939,0
2020-03-17-170606,170606,11,0,12,36,1.0,3.6876953,1
2020-03-18-170606,170606,15,1,7,51,0.5714285714285714,4.781256,2
2020-03-19-170606,170606,14,0,7,65,0.5714285714285714,4.57771,3
2020-03-20-170606,170606,20,0,12,85,0.0,6.2869062,4
2020-03-21-170606,170606,5,0,3,90,0.14285714285714285,1.3430885,5
2020-03-22-170606,170606,4,1,5,94,0.14285714285714285,1.0350356,6
2020-03-23-170606,170606,24,0,13,118,1.0,7.9987903,0
2020-03-24-170606,170606,23,0,17,141,0.5714285714285714,6.874496,1
2020-03-25-170606,170606,25,0,8,166,1.0,7.334683,2
2020-03-26-170606,170606,16,0,3,182,1.2857142857142858,5.7084374,3
2020-03-27-170606,170606,13,0,4,195,0.8571428571428571,4.251866,4
2020-03-28-170606,170606,11,0,9,206,0.14285714285714285,2.5427911,5
2020-03-29-170606,170606,7,0,5,213,0.2857142857142857,1.6061997,6
2020-03-30-170606,170606,13,0,19,226,1.0,4.003411,0
2020-03-31-170606,170606,12,0,2,238,0.8571428571428571,3.4556334,1
2020-04-01-170606,170606,7,0,10,245,0.7142857142857143,2.427385,2
2020-04-02-170606,170606,7,0,2,252,4.285714285714286,2.786957,3
2020-04-03-170606,170606,12,0,4,264,1.5714285714285714,4.1966457,4
2020-04-04-170606,170606,3,0,7,267,0.7142857142857143,0.9129823,5
2020-04-05-170606,170606,5,0,4,272,0.7142857142857143,1.153064,6
2020-04-06-170606,170606,13,0,6,285,1.0,3.6944754,0
2020-04-07-170606,170606,17,0,5,302,0.7142857142857143,5.340015,1
2020-04-08-170606,170606,8,0,4,310,0.42857142857142855,1.9374006,2
2020-04-09-170606,170606,3,0,6,313,0.0,0.7927286,3
2020-04-10-170606,170606,4,0,1,317,0.2857142857142857,0.92702174,4
2020-04-11-170606,170606,9,0,2,326,0.14285714285714285,2.0777133,5
2020-04-12-170606,170606,5,0,1,331,0.14285714285714285,1.1663225,6
2020-04-13-170606,170606,19,1,7,350,1.4285714285714286,5.951444,0
2020-04-14-170606,170606,2,0,2,352,0.5714285714285714,1.0170119,1
2020-04-15-170606,170606,10,1,3,362,0.5714285714285714,3.5928447,2
2020-04-16-170606,170606,2,0,3,364,0.2857142857142857,0.82831544,3
2020-04-17-170606,170606,4,0,2,368,0.0,1.0401036,4
2020-04-18-170606,170606,7,0,1,375,0.2857142857142857,2.0161326,5
2020-04-19-170606,170606,4,0,1,379,0.5714285714285714,0.9916576,6
2020-04-20-170606,170606,6,0,11,385,2.8571428571428568,2.8400407,0
2020-04-21-170606,170606,5,0,7,390,0.2857142857142857,2.2019162,1
2020-04-22-170606,170606,4,0,5,394,0.0,1.3258618,2
2020-04-23-170606,170606,6,1,3,400,0.0,1.3367909,3
2020-04-24-170606,170606,1,0,2,401,0.42857142857142855,0.46195635,4
2020-04-25-170606,170606,2,0,8,403,0.0,0.57042384,5
2020-04-26-170606,170606,1,0,2,404,0.14285714285714285,0.23487513,6
2020-04-27-170606,170606,7,0,4,411,0.14285714285714285,2.2891347,0
2020-04-28-170606,170606,2,0,3,413,0.42857142857142855,1.0928469,1
2020-04-29-170606,170606,3,1,4,416,0.0,1.0460464,2
2020-04-30-170606,170606,3,0,0,419,0.14285714285714285,1.1289198,3
2020-05-01-170606,170606,2,0,2,421,0.14285714285714285,0.5326589,4
2020-05-02-170606,170606,1,0,1,422,0.42857142857142855,0.47883004,5
2020-05-03-170606,170606,1,0,1,423,0.0,0.35935658,6
2020-05-04-170606,170606,11,0,15,434,0.42857142857142855,3.5481174,0
2020-05-05-170606,170606,7,0,2,441,0.7142857142857143,2.5580218,1
2020-05-06-170606,170606,5,0,1,446,0.5714285714285714,2.780061,2
2020-05-07-170606,170606,3,0,3,449,0.2857142857142857,1.7374091,3
2020-05-08-170606,170606,2,0,4,451,0.0,0.9059457,4
2020-05-09-170606,170606,8,0,1,459,0.14285714285714285,2.3401353,5
2020-05-10-170606,170606,2,0,1,461,0.0,0.5145959,6
2020-05-11-170606,170606,4,0,4,465,0.5714285714285714,1.6853684,0
2020-05-12-170606,170606,3,0,0,468,0.2857142857142857,1.5613426,1
2020-05-13-170606,170606,4,2,0,472,0.14285714285714285,2.180257,2
2020-05-14-170606,170606,0,1,3,472,0.0,0.12379644,3
2020-05-15-170606,170606,2,0,3,474,0.2857142857142857,0.86989826,4
2020-05-16-170606,170606,1,0,1,475,0.14285714285714285,0.38255417,5
2020-05-17-170606,170606,1,0,0,476,0.0,0.28731084,6
2020-05-18-170606,170606,15,0,2,491,1.1428571428571428,6.005081,0
2020-05-19-170606,170606,2,0,1,493,0.0,1.1709818,1
2020-05-20-170606,170606,1,0,0,494,0.0,0.4564845,2
2020-05-21-170606,170606,3,0,5,497,0.14285714285714285,0.83773834,3
2020-05-22-170606,170606,4,0,2,501,0.0,1.203364,4
2020-05-23-170606,170606,1,0,0,502,0.0,0.3467762,5
2020-05-24-170606,170606,1,0,0,503,0.14285714285714285,0.36092037,6
2020-05-25-170606,170606,4,0,1,507,0.0,1.7565904,0
2020-05-26-170606,170606,0,0,0,507,0.0,0.49221027,1
2020-05-27-170606,170606,0,1,0,507,0.42857142857142855,0.5621644,2
2020-05-28-170606,170606,3,0,3,510,0.42857142857142855,1.7140074,3
2020-05-29-170606,170606,3,1,0,513,0.0,1.5495467,4
2020-05-30-170606,170606,1,0,1,514,0.0,0.006756263,5
2020-05-31-170606,170606,0,0,0,514,0.0,0.00015547339,6
2020-06-01-170606,170606,2,0,0,516,0.0,0.913509,0
2020-06-02-170606,170606,1,0,0,517,0.14285714285714285,0.53053397,1
2020-06-03-170606,170606,0,0,0,517,0.0,0.22963347,2
2020-06-04-170606,170606,5,0,0,522,0.42857142857142855,2.380169,3
2020-06-05-170606,170606,2,0,2,524,0.14285714285714285,1.1037272,4
2020-06-06-170606,170606,0,0,0,524,0.0,0.0057151527,5
2020-06-07-170606,170606,0,0,0,524,0.0,0.029680172,6
2020-06-08-170606,170606,1,0,0,525,0.0,0.44700864,0
2020-06-09-170606,170606,0,0,1,525,0.0,0.1259511,1
2020-06-10-170606,170606,0,0,0,525,0.0,0.14382437,2
2020-06-11-170606,170606,3,0,1,528,0.14285714285714285,1.360425,3
2020-06-12-170606,170606,0,0,1,528,0.0,0.033574507,4
2020-06-13-170606,170606,1,0,0,529,0.0,0.42035455,5
2020-06-14-170606,170606,0,0,2,529,0.0,0.013704452,6
2020-06-15-170606,170606,0,0,0,529,0.2857142857142857,0.1083556,0
2020-06-16-170606,170606,0,0,0,529,0.0,0.036767498,1
2020-06-17-170606,170606,0,2,0,529,0.0,0.09010632,2
2020-06-18-170606,170606,0,0,1,529,0.0,0.16195852,3
2020-06-19-170606,170606,2,0,0,531,0.2857142857142857,1.1969533,4
2020-06-20-170606,170606,0,0,0,531,0.0,0.00097340153,5
2020-06-21-170606,170606,0,0,1,531,0.0,0.0008428524,6
2020-06-22-170606,170606,0,0,0,531,0.0,0.36071822,0
2020-06-23-170606,170606,1,0,1,532,0.14285714285714285,0.64317834,1
2020-06-24-170606,170606,0,0,0,532,0.14285714285714285,0.12805869,2
2020-06-25-170606,170606,1,1,0,533,0.0,0.96248543,3
2020-06-26-170606,170606,1,0,0,534,0.0,0.51432145,4
2020-06-27-170606,170606,0,0,0,534,0.0,0.01859482,5
2020-06-28-170606,170606,2,0,0,536,0.0,0.8311166,6
2020-06-29-170606,170606,0,0,1,536,0.0,0.11899896,0
2020-06-30-170606,170606,0,0,0,536,0.0,0.10085451,1
2020-07-01-170606,170606,0,0,0,536,0.0,0.008307143,2
2020-07-02-170606,170606,1,0,1,537,0.0,0.48239565,3
2020-07-03-170606,170606,0,0,0,537,0.0,0.07069785,4
2020-07-04-170606,170606,0,0,0,537,0.0,0.0012517307,5
2020-07-05-170606,170606,1,0,0,538,0.14285714285714285,0.50582576,6
2020-07-06-170606,170606,0,0,0,538,0.0,0.043409828,0
2020-07-07-170606,170606,1,0,1,539,0.0,0.4584354,1
2020-07-08-170606,170606,0,0,0,539,0.0,0.002600919,2
2020-07-09-170606,170606,0,0,0,539,0.0,0.010036279,3
2020-07-10-170606,170606,0,0,2,539,0.0,0.015259144,4
2020-07-11-170606,170606,0,0,1,539,0.0,0.02045934,5
2020-07-12-170606,170606,0,0,0,539,0.0,0.13180315,6
2020-07-13-170606,170606,1,0,0,540,0.0,0.51186836,0
2020-07-14-170606,170606,0,0,1,540,0.14285714285714285,0.30108073,1
2020-07-15-170606,170606,0,0,0,540,0.0,0.0021832858,2
2020-07-16-170606,170606,1,0,1,541,0.2857142857142857,0.6589678,3
2020-07-17-170606,170606,0,0,0,541,0.0,0.019889485,4
2020-07-18-170606,170606,0,0,1,541,0.0,0.0049387426,5
2020-07-19-170606,170606,0,0,0,541,0.0,0.0005474968,6
2020-07-20-170606,170606,0,0,2,541,0.0,0.018365093,0
2020-07-21-170606,170606,1,0,0,542,0.0,0.60327816,1
2020-07-22-170606,170606,0,0,0,542,0.0,0.12715341,2
2020-07-23-170606,170606,0,0,0,542,0.8571428571428571,0.40423942,3
2020-07-24-170606,170606,2,0,2,544,0.0,1.0674305,4
2020-07-25-170606,170606,1,0,1,545,0.0,0.49679714,5
2020-07-26-170606,170606,0,0,0,545,0.14285714285714285,0.043795474,6
2020-07-27-170606,170606,0,0,0,545,0.14285714285714285,0.0057967342,0
2020-07-28-170606,170606,1,0,11,546,0.0,0.5880769,1
2020-07-29-170606,170606,0,0,2,546,0.2857142857142857,0.20538896,2
2020-07-30-170606,170606,1,0,4,547,0.42857142857142855,0.12427259,3
2020-07-31-170606,170606,0,0,8,547,0.2857142857142857,0.26430184,4
2020-08-01-170606,170606,1,0,2,548,0.5714285714285714,1.0945611,5
2020-08-02-170606,170606,0,0,0,548,0.0,0.053851184,6
2020-08-03-170606,170606,2,0,4,550,0.0,0.5817622,0
2020-08-04-170606,170606,0,0,6,550,0.14285714285714285,0.23486388,1
2020-08-05-170606,170606,0,0,7,550,0.14285714285714285,0.11612942,2
2020-08-06-170606,170606,0,0,7,550,0.14285714285714285,0.41238603,3
2020-08-07-170606,170606,2,0,6,552,0.8571428571428571,3.5774138,4
2020-08-08-170606,170606,1,0,2,553,0.2857142857142857,0.22444086,5
2020-08-09-170606,170606,0,0,0,553,0.0,0.0449574,6
2020-08-10-170606,170606,0,0,6,553,0.7142857142857143,0.63737756,0
2020-08-11-170606,170606,11,0,1,564,0.7142857142857143,4.1326065,1
2020-08-12-170606,170606,2,0,3,566,0.14285714285714285,2.7662532,2
2020-08-13-170606,170606,4,0,8,570,0.0,6.054378,3
2020-08-14-170606,170606,8,0,1,578,0.2857142857142857,4.995817,4
2020-08-15-170606,170606,2,0,1,580,1.1428571428571428,1.8626473,5
2020-08-16-170606,170606,0,0,3,580,0.5714285714285714,0.37122503,6
2020-08-17-170606,170606,4,0,2,584,0.42857142857142855,2.9026845,0
2020-08-18-170606,170606,6,0,4,590,0.7142857142857143,3.9289305,1
2020-08-19-170606,170606,7,0,3,597,0.5714285714285714,4.1373463,2
2020-08-20-170606,170606,7,0,2,604,0.7142857142857143,3.9947305,3
2020-08-21-170606,170606,6,0,7,610,0.8571428571428571,2.5395303,4
2020-08-22-170606,170606,2,0,0,612,0.14285714285714285,1.1768621,5
2020-08-23-170606,170606,0,0,0,612,0.0,0.06436053,6
2020-08-24-170606,170606,6,0,0,618,0.5714285714285714,3.2393124,0
2020-08-25-170606,170606,1,0,0,619,0.14285714285714285,1.5338217,1
2020-08-26-170606,170606,3,0,4,622,0.5714285714285714,2.0097253,2
2020-08-27-170606,170606,8,0,12,630,0.42857142857142855,4.768861,3
2020-08-28-170606,170606,1,0,2,631,0.7142857142857143,2.0015593,4
2020-08-29-170606,170606,1,0,0,632,1.5714285714285714,1.6522332,5
2020-08-30-170606,170606,3,0,2,635,0.5714285714285714,1.0606666,6
2020-08-31-170606,170606,2,1,10,637,0.8571428571428571,1.6152269,0
2020-09-01-170606,170606,4,0,3,641,2.4285714285714284,3.1737814,1
2020-09-02-170606,170606,3,0,0,644,1.8571428571428568,2.7435954,2
2020-09-03-170606,170606,2,0,5,646,1.5714285714285714,2.1161735,3
2020-09-04-170606,170606,7,0,1,653,0.14285714285714285,2.7423556,4
2020-09-05-170606,170606,0,0,2,653,1.1428571428571428,0.350925,5
2020-09-06-170606,170606,0,0,2,653,0.8571428571428571,0.54347503,6
2020-09-07-170606,170606,0,0,3,653,1.8571428571428568,1.1493775,0
2020-09-08-170606,170606,0,0,3,653,0.8571428571428571,1.2578589,1
2020-09-09-170606,170606,4,0,0,657,0.2857142857142857,1.6518638,2
2020-09-10-170606,170606,12,0,4,669,0.42857142857142855,6.3219557,3
2020-09-11-170606,170606,2,0,1,671,0.5714285714285714,0.517636,4
2020-09-12-170606,170606,0,0,4,671,0.42857142857142855,0.37984434,5
2020-09-13-170606,170606,2,1,0,673,0.14285714285714285,0.54321,6
2020-09-14-170606,170606,10,0,2,683,0.8571428571428571,0.91705596,0
2020-09-15-170606,170606,3,0,2,686,0.2857142857142857,1.6356577,1
2020-09-16-170606,170606,0,0,3,686,0.2857142857142857,0.42872316,2
2020-09-17-170606,170606,5,0,6,691,0.42857142857142855,2.8178413,3
2020-09-18-170606,170606,1,0,3,692,1.8571428571428568,1.9514457,4
2020-09-19-170606,170606,2,0,3,694,0.5714285714285714,1.2664734,5
2020-09-20-170606,170606,2,1,0,696,0.42857142857142855,0.5511922,6
2020-09-21-170606,170606,3,0,3,699,0.42857142857142855,2.0944338,0
2020-09-22-170606,170606,3,0,0,702,0.42857142857142855,2.1104455,1
2020-09-23-170606,170606,0,0,5,702,0.7142857142857143,0.7228646,2
2020-09-24-170606,170606,4,1,2,706,0.8571428571428571,2.777331,3
2020-09-25-170606,170606,1,1,4,707,0.8571428571428571,1.1848073,4
2020-09-26-170606,170606,4,0,2,711,0.42857142857142855,2.2376194,5
2020-09-27-170606,170606,0,0,3,711,0.2857142857142857,0.2027614,6
2020-09-28-170606,170606,2,0,3,713,0.14285714285714285,1.3928015,0
2020-09-29-170606,170606,2,0,2,715,0.7142857142857143,1.3671823,1
2020-09-30-170606,170606,3,0,5,718,0.7142857142857143,2.0427334,2
2020-10-01-170606,170606,6,0,0,724,0.8571428571428571,3.554002,3
2020-10-02-170606,170606,3,0,7,727,0.42857142857142855,1.4497099,4
2020-10-03-170606,170606,3,0,4,730,0.0,1.315961,5
2020-10-04-170606,170606,0,0,0,730,0.5714285714285714,0.4963307,6
2020-10-05-170606,170606,3,1,8,733,0.42857142857142855,2.2009232,0
2020-10-06-170606,170606,0,0,3,733,1.4285714285714286,0.8381939,1
2020-10-07-170606,170606,5,1,5,738,1.1428571428571428,4.2057834,2
2020-10-08-170606,170606,2,1,3,740,0.0,3.130289,3
2020-10-09-170606,170606,4,0,10,744,1.0,2.5462556,4
2020-10-10-170606,170606,2,0,0,746,0.0,1.687056,5
2020-10-11-170606,170606,3,0,0,749,0.2857142857142857,1.5287739,6
2020-10-12-170606,170606,3,0,12,752,0.0,1.3717924,0
2020-10-13-170606,170606,2,0,8,754,0.42857142857142855,2.2258549,1
2020-10-14-170606,170606,5,0,8,759,0.42857142857142855,3.6472108,2
2020-10-15-170606,170606,0,0,4,759,0.2857142857142857,2.0358186,3
2020-10-16-170606,170606,7,0,5,766,0.8571428571428571,4.3636537,4
2020-10-17-170606,170606,4,0,11,770,0.14285714285714285,1.9968134,5
2020-10-18-170606,170606,0,0,5,770,0.8571428571428571,0.4609839,6
2020-10-19-170606,170606,8,0,4,778,0.8571428571428571,4.607705,0
2020-10-20-170606,170606,3,0,8,781,0.5714285714285714,2.6829357,1
2020-10-21-170606,170606,5,0,13,786,0.42857142857142855,2.4644322,2
2020-10-22-170606,170606,3,1,7,789,1.4285714285714286,2.6486447,3
2020-10-23-170606,170606,10,0,14,799,0.7142857142857143,6.0165315,4
2020-10-24-170606,170606,0,2,3,799,0.42857142857142855,0.40426323,5
2020-10-25-170606,170606,0,0,9,799,0.42857142857142855,0.71608627,6
2020-10-26-170606,170606,12,0,12,811,0.2857142857142857,5.9390283,0
2020-10-27-170606,170606,8,2,3,819,0.7142857142857143,5.195949,1
2020-10-28-170606,170606,8,1,5,827,1.7142857142857142,6.793673,2
2020-10-29-170606,170606,4,0,8,831,0.2857142857142857,4.0793867,3
2020-10-30-170606,170606,5,0,14,836,1.1428571428571428,5.2963657,4
2020-10-31-170606,170606,11,2,0,847,0.42857142857142855,5.0156307,5
2020-11-01-170606,170606,5,1,0,852,1.0,2.673272,6
2020-11-02-170606,170606,4,0,0,856,0.14285714285714285,1.9069165,0
2020-11-03-170606,170606,8,1,0,864,1.2857142857142858,5.5846257,1
2020-11-04-170606,170606,13,0,0,877,1.5714285714285714,7.6140966,2
2020-11-05-170606,170606,7,0,0,884,0.42857142857142855,3.0487473,3
2020-11-06-170606,170606,14,4,0,898,1.5714285714285714,7.741821,4
2020-11-07-170606,170606,3,1,0,901,0.7142857142857143,2.0491989,5
2020-11-08-170606,170606,9,0,0,910,0.2857142857142857,3.0281472,6
2020-11-09-170606,170606,12,1,0,922,0.7142857142857143,7.269899,0
2020-11-10-170606,170606,3,1,0,925,1.0,2.8431153,1
2020-11-11-170606,170606,5,4,0,930,1.8571428571428568,3.510407,2
2020-11-12-170606,170606,8,1,0,938,0.7142857142857143,5.902098,3
2020-11-13-170606,170606,14,2,0,952,0.8571428571428571,4.287143,4
2020-03-01-170607,170607,0,0,12,0,0.0,0.012441902,6
2020-03-02-170607,170607,1,0,16,1,0.16666666666666666,0.044609986,0
2020-03-03-170607,170607,1,0,18,2,0.0,0.093058206,1
2020-03-04-170607,170607,0,0,23,2,0.0,0.09336509,2
2020-03-05-170607,170607,1,0,30,3,0.0,0.02049027,3
2020-03-06-170607,170607,1,0,32,4,0.3333333333333333,0.021912847,4
2020-03-07-170607,170607,0,0,16,4,0.0,0.007327877,5
2020-03-08-170607,170607,0,0,15,4,0.16666666666666666,0.034992106,6
2020-03-09-170607,170607,0,0,57,4,0.6666666666666666,0.095084265,0
2020-03-10-170607,170607,0,0,30,4,0.3333333333333333,0.2507844,1
2020-03-11-170607,170607,4,0,32,8,1.5,0.206755,2
2020-03-12-170607,170607,2,0,33,10,1.0,0.10331842,3
2020-03-13-170607,170607,5,0,34,15,2.333333333333333,0.48278227,4
2020-03-14-170607,170607,6,0,12,21,2.1666666666666665,0.38611278,5
2020-03-15-170607,170607,12,0,13,33,7.166666666666668,0.727925,6
2020-03-16-170607,170607,16,0,25,49,11.5,1.6955606,0
2020-03-17-170607,170607,18,0,18,67,16.0,2.04805,1
2020-03-18-170607,170607,23,0,19,90,13.666666666666664,1.6485237,2
2020-03-19-170607,170607,30,0,9,120,15.333333333333336,2.1898592,3
2020-03-20-170607,170607,32,0,19,152,19.666666666666668,2.196795,4
2020-03-21-170607,170607,16,0,4,168,5.333333333333333,0.5172389,5
2020-03-22-170607,170607,15,0,3,183,8.166666666666666,0.5001034,6
2020-03-23-170607,170607,57,0,19,240,25.5,4.0169673,0
2020-03-24-170607,170607,30,0,5,270,23.66666666666667,2.7580788,1
2020-03-25-170607,170607,32,0,10,302,25.5,3.2551584,2
2020-03-26-170607,170607,33,0,9,335,24.33333333333333,2.8475516,3
2020-03-27-170607,170607,34,0,10,369,23.66666666666667,2.897852,4
2020-03-28-170607,170607,12,0,2,381,8.333333333333334,0.34805876,5
2020-03-29-170607,170607,13,0,5,394,7.0,0.48008096,6
2020-03-30-170607,170607,25,0,10,419,17.166666666666668,2.6572042,0
2020-03-31-170607,170607,18,0,8,437,13.333333333333336,1.6514288,1
2020-04-01-170607,170607,19,0,6,456,16.5,1.8869117,2
2020-04-02-170607,170607,9,0,8,465,8.333333333333334,0.9830431,3
2020-04-03-170607,170607,19,0,8,484,12.333333333333336,1.2207776,4
2020-04-04-170607,170607,4,0,2,488,3.6666666666666665,0.24997629,5
2020-04-05-170607,170607,3,0,1,491,3.8333333333333335,0.18353297,6
2020-04-06-170607,170607,19,0,20,510,12.166666666666664,1.6858891,0
2020-04-07-170607,170607,5,0,4,515,14.0,1.4232421,1
2020-04-08-170607,170607,10,0,3,525,7.0,1.1041129,2
2020-04-09-170607,170607,9,2,1,534,4.166666666666667,0.41020113,3
2020-04-10-170607,170607,10,0,4,544,6.166666666666668,0.41530958,4
2020-04-11-170607,170607,2,0,1,546,2.333333333333333,0.2249964,5
2020-04-12-170607,170607,5,0,0,551,5.333333333333333,0.32860324,6
2020-04-13-170607,170607,10,0,6,561,8.0,1.2190317,0
2020-04-14-170607,170607,8,0,4,569,11.333333333333336,1.9158926,1
2020-04-15-170607,170607,6,0,2,575,4.333333333333333,1.0807191,2
2020-04-16-170607,170607,8,0,7,583,10.333333333333334,0.70695907,3
2020-04-17-170607,170607,8,0,0,591,9.166666666666666,0.96435815,4
2020-04-18-170607,170607,2,0,4,593,3.1666666666666665,0.6765483,5
2020-04-19-170607,170607,1,0,0,594,0.5,0.12228594,6
2020-04-20-170607,170607,20,0,13,614,4.666666666666667,0.8821509,0
2020-04-21-170607,170607,4,0,7,618,9.833333333333334,1.6910487,1
2020-04-22-170607,170607,3,0,7,621,9.0,1.593286,2
2020-04-23-170607,170607,1,0,4,622,1.1666666666666667,0.2710749,3
2020-04-24-170607,170607,4,0,15,626,5.833333333333332,0.7849024,4
2020-04-25-170607,170607,1,0,2,627,2.1666666666666665,0.36474377,5
2020-04-26-170607,170607,0,0,1,627,0.3333333333333333,0.31789094,6
2020-04-27-170607,170607,6,0,11,633,5.333333333333333,1.1994604,0
2020-04-28-170607,170607,4,0,12,637,4.0,0.63777393,1
2020-04-29-170607,170607,2,0,5,639,7.0,0.94627833,2
2020-04-30-170607,170607,7,0,4,646,4.5,0.6186572,3
2020-05-01-170607,170607,0,0,5,646,3.333333333333333,0.4887464,4
2020-05-02-170607,170607,4,0,1,650,1.3333333333333333,0.22692753,5
2020-05-03-170607,170607,0,0,0,650,0.8333333333333334,0.07060318,6
2020-05-04-170607,170607,13,0,6,663,4.0,1.9241011,0
2020-05-05-170607,170607,7,0,1,670,4.833333333333333,0.7872118,1
2020-05-06-170607,170607,7,0,8,677,5.166666666666667,2.0713983,2
2020-05-07-170607,170607,4,0,4,681,4.0,1.6878108,3
2020-05-08-170607,170607,15,0,5,696,5.5,0.9577938,4
2020-05-09-170607,170607,2,0,0,698,1.3333333333333333,0.14618008,5
2020-05-10-170607,170607,1,0,0,699,0.5,0.029696817,6
2020-05-11-170607,170607,11,1,4,710,7.333333333333332,1.2699026,0
2020-05-12-170607,170607,12,6,3,722,10.333333333333334,1.3299448,1
2020-05-13-170607,170607,5,0,2,727,5.5,0.9297626,2
2020-05-14-170607,170607,4,0,1,731,3.0,0.4558398,3
2020-05-15-170607,170607,5,0,4,736,6.166666666666668,0.7115958,4
2020-05-16-170607,170607,1,0,0,737,0.6666666666666666,0.024970397,5
2020-05-17-170607,170607,0,0,0,737,0.16666666666666666,0.016407475,6
2020-05-18-170607,170607,6,1,3,743,1.3333333333333333,0.7357718,0
2020-05-19-170607,170607,1,0,1,744,2.833333333333333,0.61224544,1
2020-05-20-170607,170607,8,0,3,752,1.8333333333333333,0.49691805,2
2020-05-21-170607,170607,4,0,2,756,2.833333333333333,0.3663399,3
2020-05-22-170607,170607,5,0,2,761,3.0,0.41937065,4
2020-05-23-170607,170607,0,0,0,761,0.0,0.06102443,5
2020-05-24-170607,170607,0,0,0,761,0.16666666666666666,0.03772829,6
2020-05-25-170607,170607,4,0,0,765,2.5,0.5857119,0
2020-05-26-170607,170607,3,0,1,768,2.1666666666666665,0.35992262,1
2020-05-27-170607,170607,2,0,2,770,1.6666666666666667,0.44655374,2
2020-05-28-170607,170607,1,0,2,771,1.6666666666666667,0.52423316,3
2020-05-29-170607,170607,4,0,0,775,3.0,0.5547203,4
2020-05-30-170607,170607,0,1,0,775,0.8333333333333334,0.03500864,5
2020-05-31-170607,170607,0,0,0,775,0.16666666666666666,0.006770108,6
2020-06-01-170607,170607,3,0,1,778,2.5,0.8639228,0
2020-06-02-170607,170607,1,0,1,779,1.5,0.3681935,1
2020-06-03-170607,170607,3,0,2,782,1.8333333333333333,0.24438916,2
2020-06-04-170607,170607,2,0,1,784,1.6666666666666667,0.54928964,3
2020-06-05-170607,170607,2,1,3,786,0.8333333333333334,1.1382916,4
2020-06-06-170607,170607,0,0,0,786,0.0,0.059497807,5
2020-06-07-170607,170607,0,0,0,786,0.16666666666666666,0.073927425,6
2020-06-08-170607,170607,0,0,4,786,1.5,0.29545873,0
2020-06-09-170607,170607,1,0,2,787,1.6666666666666667,0.23953553,1
2020-06-10-170607,170607,2,0,1,789,1.3333333333333333,0.18312997,2
2020-06-11-170607,170607,2,0,0,791,3.333333333333333,0.3105895,3
2020-06-12-170607,170607,0,0,3,791,0.16666666666666666,0.15596586,4
2020-06-13-170607,170607,0,1,0,791,0.16666666666666666,0.012786821,5
2020-06-14-170607,170607,0,0,0,791,0.0,0.012904573,6
2020-06-15-170607,170607,1,1,2,792,1.3333333333333333,0.1092661,0
2020-06-16-170607,170607,1,0,0,793,3.6666666666666665,0.40430823,1
2020-06-17-170607,170607,2,1,1,795,2.333333333333333,0.32390735,2
2020-06-18-170607,170607,1,0,0,796,1.8333333333333333,0.34559587,3
2020-06-19-170607,170607,3,0,1,799,1.5,0.5446488,4
2020-06-20-170607,170607,0,0,0,799,0.0,0.0018478615,5
2020-06-21-170607,170607,0,0,0,799,0.0,0.010115286,6
2020-06-22-170607,170607,4,0,0,803,1.0,0.33872652,0
2020-06-23-170607,170607,2,0,0,805,1.5,0.4733405,1
2020-06-24-170607,170607,1,1,0,806,0.3333333333333333,0.15363328,2
2020-06-25-170607,170607,0,0,0,806,0.6666666666666666,0.17864284,3
2020-06-26-170607,170607,3,0,1,809,2.6666666666666665,0.2813731,4
2020-06-27-170607,170607,0,0,0,809,0.16666666666666666,0.050122187,5
2020-06-28-170607,170607,0,0,0,809,0.0,0.052994717,6
2020-06-29-170607,170607,2,0,1,811,1.3333333333333333,0.25228375,0
2020-06-30-170607,170607,0,0,0,811,0.5,0.22571023,1
2020-07-01-170607,170607,1,0,1,812,2.0,0.13766614,2
2020-07-02-170607,170607,0,0,1,812,0.5,0.080501474,3
2020-07-03-170607,170607,1,0,0,813,1.5,0.22896184,4
2020-07-04-170607,170607,0,0,0,813,0.0,0.008651329,5
2020-07-05-170607,170607,0,0,0,813,0.0,0.050514866,6
2020-07-06-170607,170607,0,0,1,813,0.16666666666666666,0.10352185,0
2020-07-07-170607,170607,0,1,1,813,0.8333333333333334,0.06818093,1
2020-07-08-170607,170607,0,0,0,813,0.3333333333333333,0.017024515,2
2020-07-09-170607,170607,0,0,1,813,0.6666666666666666,0.12665682,3
2020-07-10-170607,170607,1,0,0,814,0.3333333333333333,0.09012103,4
2020-07-11-170607,170607,0,0,0,814,0.0,0.012334768,5
2020-07-12-170607,170607,0,0,0,814,0.16666666666666666,0.09715019,6
2020-07-13-170607,170607,1,0,0,815,0.5,0.1759611,0
2020-07-14-170607,170607,0,0,2,815,0.16666666666666666,0.19108711,1
2020-07-15-170607,170607,1,0,0,816,0.5,0.01883985,2
2020-07-16-170607,170607,1,0,0,817,1.3333333333333333,0.10413508,3
2020-07-17-170607,170607,0,0,2,817,0.3333333333333333,0.055346496,4
2020-07-18-170607,170607,0,0,0,817,0.0,0.03838975,5
2020-07-19-170607,170607,0,0,1,817,0.0,0.0031814228,6
2020-07-20-170607,170607,1,0,2,818,1.3333333333333333,0.08894315,0
2020-07-21-170607,170607,1,0,4,819,3.1666666666666665,0.06785377,1
2020-07-22-170607,170607,0,0,5,819,1.1666666666666667,0.267046,2
2020-07-23-170607,170607,1,0,2,820,1.0,0.033136312,3
2020-07-24-170607,170607,0,1,4,820,0.5,0.036386646,4
2020-07-25-170607,170607,0,0,2,820,0.16666666666666666,0.015708957,5
2020-07-26-170607,170607,0,0,0,820,0.5,0.019479658,6
2020-07-27-170607,170607,0,0,8,820,0.8333333333333334,0.11020207,0
2020-07-28-170607,170607,2,0,2,822,0.3333333333333333,0.2150404,1
2020-07-29-170607,170607,0,0,4,822,1.0,0.109579265,2
2020-07-30-170607,170607,0,0,1,822,1.3333333333333333,0.37311572,3
2020-07-31-170607,170607,2,0,2,824,3.0,0.32349887,4
2020-08-01-170607,170607,0,0,3,824,0.5,0.37359425,5
2020-08-02-170607,170607,1,0,0,825,1.1666666666666667,0.30312607,6
2020-08-03-170607,170607,2,0,8,827,3.333333333333333,0.6562755,0
2020-08-04-170607,170607,4,0,2,831,1.6666666666666667,0.5652851,1
2020-08-05-170607,170607,5,0,3,836,2.5,0.8518906,2
2020-08-06-170607,170607,2,0,5,838,2.5,0.5917478,3
2020-08-07-170607,170607,4,0,2,842,3.6666666666666665,1.0452682,4
2020-08-08-170607,170607,2,0,0,844,1.6666666666666667,0.42881212,5
2020-08-09-170607,170607,0,0,0,844,0.8333333333333334,0.13290967,6
2020-08-10-170607,170607,8,0,10,852,3.6666666666666665,0.7444956,0
2020-08-11-170607,170607,2,0,5,854,3.333333333333333,0.7881252,1
2020-08-12-170607,170607,4,0,9,858,4.666666666666667,1.2201892,2
2020-08-13-170607,170607,1,1,2,859,4.0,1.0489825,3
2020-08-14-170607,170607,2,0,11,861,3.0,0.8669394,4
2020-08-15-170607,170607,3,0,2,864,1.3333333333333333,0.2362826,5
2020-08-16-170607,170607,0,0,2,864,1.8333333333333333,0.41073477,6
2020-08-17-170607,170607,8,0,15,872,4.666666666666667,0.88087565,0
2020-08-18-170607,170607,2,0,4,874,4.333333333333333,1.2194828,1
2020-08-19-170607,170607,3,0,1,877,5.333333333333333,0.88148516,2
2020-08-20-170607,170607,5,0,5,882,6.666666666666668,1.5829307,3
2020-08-21-170607,170607,2,0,9,884,4.166666666666667,1.1475877,4
2020-08-22-170607,170607,0,0,2,884,1.0,0.26228344,5
2020-08-23-170607,170607,0,0,1,884,2.5,0.48067495,6
2020-08-24-170607,170607,10,0,5,894,9.166666666666666,1.7750456,0
2020-08-25-170607,170607,5,0,4,899,6.333333333333332,1.2524079,1
2020-08-26-170607,170607,9,0,5,908,9.833333333333334,1.7319511,2
2020-08-27-170607,170607,2,0,7,910,7.0,1.3046125,3
2020-08-28-170607,170607,11,0,13,921,6.833333333333332,1.4695185,4
2020-08-29-170607,170607,2,0,0,923,1.8333333333333333,0.6395355,5
2020-08-30-170607,170607,2,0,0,925,2.6666666666666665,0.2752274,6
2020-08-31-170607,170607,15,0,7,940,6.666666666666668,2.1124756,0
2020-09-01-170607,170607,4,0,4,944,4.0,1.9827713,1
2020-09-02-170607,170607,1,0,5,945,3.0,1.5010186,2
2020-09-03-170607,170607,5,0,3,950,5.833333333333332,2.2548785,3
2020-09-04-170607,170607,9,0,11,959,10.666666666666666,2.3181589,4
2020-09-05-170607,170607,2,0,3,961,3.6666666666666665,1.1291898,5
2020-09-06-170607,170607,1,0,5,962,2.333333333333333,0.80204827,6
2020-09-07-170607,170607,5,0,6,967,7.5,2.4078526,0
2020-09-08-170607,170607,4,0,11,971,1.3333333333333333,0.9385575,1
2020-09-09-170607,170607,5,0,4,976,5.333333333333333,1.149303,2
2020-09-10-170607,170607,7,0,9,983,4.833333333333333,1.4092346,3
2020-09-11-170607,170607,13,0,3,996,9.666666666666666,2.570904,4
2020-09-12-170607,170607,0,0,3,996,1.8333333333333333,0.76485455,5
2020-09-13-170607,170607,0,0,5,996,1.3333333333333333,0.45576158,6
2020-09-14-170607,170607,7,0,2,1003,13.5,2.8376637,0
2020-09-15-170607,170607,4,0,6,1007,6.666666666666668,1.5580449,1
2020-09-16-170607,170607,5,0,6,1012,7.166666666666668,1.731181,2
2020-09-17-170607,170607,3,0,9,1015,8.333333333333334,1.5494655,3
2020-09-18-170607,170607,11,2,8,1026,12.833333333333336,3.181558,4
2020-09-19-170607,170607,3,0,2,1029,2.5,0.88825095,5
2020-09-20-170607,170607,5,2,6,1034,1.8333333333333333,0.9470404,6
2020-09-21-170607,170607,6,0,14,1040,11.5,2.8063195,0
2020-09-22-170607,170607,11,2,18,1051,14.666666666666664,2.3233056,1
2020-09-23-170607,170607,4,1,18,1055,13.333333333333336,2.5817513,2
2020-09-24-170607,170607,9,0,15,1064,9.5,2.3961508,3
2020-09-25-170607,170607,3,0,21,1067,9.833333333333334,2.4003954,4
2020-09-26-170607,170607,3,0,14,1070,2.0,1.104506,5
2020-09-27-170607,170607,5,0,11,1075,0.6666666666666666,0.62971133,6
2020-09-28-170607,170607,2,0,9,1077,5.5,2.076567,0
2020-09-29-170607,170607,6,0,26,1083,5.333333333333333,1.8235631,1
2020-09-30-170607,170607,6,1,18,1089,7.333333333333332,1.8097069,2
2020-10-01-170607,170607,9,0,23,1098,6.0,1.4609308,3
2020-10-02-170607,170607,8,0,28,1106,5.333333333333333,1.7505072,4
2020-10-03-170607,170607,2,1,12,1108,3.0,0.77704954,5
2020-10-04-170607,170607,6,0,28,1114,1.6666666666666667,0.6144848,6
2020-10-05-170607,170607,14,0,42,1128,14.833333333333336,5.399713,0
2020-10-06-170607,170607,18,1,53,1146,6.5,2.2759817,1
2020-10-07-170607,170607,18,0,36,1164,9.0,3.6727245,2
2020-10-08-170607,170607,15,1,44,1179,8.833333333333334,2.4172664,3
2020-10-09-170607,170607,21,3,54,1200,11.333333333333336,2.2084923,4
2020-10-10-170607,170607,14,0,10,1214,2.833333333333333,0.6499114,5
2020-10-11-170607,170607,11,0,45,1225,3.333333333333333,0.9491246,6
2020-10-12-170607,170607,9,0,32,1234,3.1666666666666665,0.8858248,0
2020-10-13-170607,170607,26,0,47,1260,10.666666666666666,2.5959847,1
2020-10-14-170607,170607,18,0,22,1278,9.833333333333334,2.7014425,2
2020-10-15-170607,170607,23,0,19,1301,8.333333333333334,3.4683254,3
2020-10-16-170607,170607,28,0,35,1329,14.666666666666664,4.7668285,4
2020-10-17-170607,170607,12,0,10,1341,2.0,0.5729906,5
2020-10-18-170607,170607,28,0,8,1369,5.166666666666667,0.56246316,6
2020-10-19-170607,170607,42,0,4,1411,12.666666666666664,3.1620097,0
2020-10-20-170607,170607,53,0,18,1464,13.166666666666664,2.963078,1
2020-10-21-170607,170607,36,2,24,1500,17.333333333333332,3.7595654,2
2020-10-22-170607,170607,44,0,15,1544,16.166666666666668,4.394871,3
2020-10-23-170607,170607,54,0,11,1598,18.666666666666668,3.530041,4
2020-10-24-170607,170607,10,1,3,1608,3.5,0.84239584,5
2020-10-25-170607,170607,45,0,6,1653,4.666666666666667,0.9933421,6
2020-10-26-170607,170607,32,0,20,1685,19.5,3.4779122,0
2020-10-27-170607,170607,47,0,11,1732,14.166666666666664,3.4509919,1
2020-10-28-170607,170607,22,0,22,1754,14.833333333333336,3.6515288,2
2020-10-29-170607,170607,19,0,15,1773,11.833333333333336,3.5898447,3
2020-10-30-170607,170607,35,0,11,1808,18.83333333333333,3.4057276,4
2020-10-31-170607,170607,10,0,0,1818,4.666666666666667,0.59358424,5
2020-11-01-170607,170607,8,0,0,1826,5.333333333333333,0.79604405,6
2020-11-02-170607,170607,4,0,0,1830,2.6666666666666665,0.87483674,0
2020-11-03-170607,170607,18,2,0,1848,17.333333333333332,3.8017058,1
2020-11-04-170607,170607,24,0,0,1872,14.166666666666664,3.1700132,2
2020-11-05-170607,170607,15,0,0,1887,9.5,3.0277953,3
2020-11-06-170607,170607,11,3,0,1898,10.666666666666666,2.8422818,4
2020-11-07-170607,170607,3,0,0,1901,3.0,0.6397426,5
2020-11-08-170607,170607,6,1,0,1907,3.333333333333333,0.80600727,6
2020-11-09-170607,170607,20,1,0,1927,13.166666666666664,3.5673084,0
2020-11-10-170607,170607,11,0,0,1938,7.666666666666668,1.8105495,1
2020-11-11-170607,170607,22,1,0,1960,7.5,2.3432176,2
2020-11-12-170607,170607,15,0,0,1975,6.666666666666668,2.058088,3
2020-11-13-170607,170607,11,0,0,1986,5.666666666666668,1.8012522,4
2020-03-01-170608,170608,0,0,0,0,0.0,8.478347e-05,6
2020-03-02-170608,170608,0,0,0,0,0.0,0.016864242,0
2020-03-03-170608,170608,0,0,1,0,0.0,0.006452008,1
2020-03-04-170608,170608,0,0,1,0,0.0,0.005485295,2
2020-03-05-170608,170608,0,0,2,0,0.2,0.056407154,3
2020-03-06-170608,170608,0,0,0,0,0.2,0.05662966,4
2020-03-07-170608,170608,0,0,0,0,0.0,0.00038097874,5
2020-03-08-170608,170608,0,0,0,0,0.0,0.00050846726,6
2020-03-09-170608,170608,0,0,3,0,0.0,0.0052263206,0
2020-03-10-170608,170608,0,0,3,0,0.0,0.020048354,1
2020-03-11-170608,170608,0,0,2,0,0.2,0.07398967,2
2020-03-12-170608,170608,0,0,6,0,0.2,0.062326495,3
2020-03-13-170608,170608,0,0,3,0,0.4,0.15124403,4
2020-03-14-170608,170608,0,0,0,0,0.6,0.15875252,5
2020-03-15-170608,170608,0,0,2,0,1.4,0.14565733,6
2020-03-16-170608,170608,0,0,3,0,4.6,0.35969085,0
2020-03-17-170608,170608,1,0,2,1,3.6,0.6057226,1
2020-03-18-170608,170608,1,0,3,2,4.8,0.7079486,2
2020-03-19-170608,170608,2,0,25,4,3.8,0.59990764,3
2020-03-20-170608,170608,0,0,7,4,4.2,0.42559537,4
2020-03-21-170608,170608,0,0,4,4,1.2,0.110337704,5
2020-03-22-170608,170608,0,0,2,4,0.8,0.12871581,6
2020-03-23-170608,170608,3,0,0,7,6.0,0.9336078,0
2020-03-24-170608,170608,3,1,2,10,5.2,0.6830006,1
2020-03-25-170608,170608,2,0,2,12,6.0,0.8769428,2
2020-03-26-170608,170608,6,0,0,18,3.8,0.9560555,3
2020-03-27-170608,170608,3,0,1,21,3.4,0.5797094,4
2020-03-28-170608,170608,0,0,1,21,2.6,0.15051189,5
2020-03-29-170608,170608,2,0,0,23,1.6,0.16624139,6
2020-03-30-170608,170608,3,0,2,26,4.0,0.6353545,0
2020-03-31-170608,170608,2,0,0,28,3.2,0.5255112,1
2020-04-01-170608,170608,3,0,2,31,2.0,0.37573776,2
2020-04-02-170608,170608,25,0,1,56,2.4,1.3989127,3
2020-04-03-170608,170608,7,0,0,63,3.6,0.5646836,4
2020-04-04-170608,170608,4,0,0,67,0.8,0.22298548,5
2020-04-05-170608,170608,2,0,0,69,1.2,0.13404064,6
2020-04-06-170608,170608,0,0,18,69,3.6,0.41894275,0
2020-04-07-170608,170608,2,0,0,71,4.2,0.45662695,1
2020-04-08-170608,170608,2,0,0,73,1.6,0.2292317,2
2020-04-09-170608,170608,0,0,0,73,0.8,0.07110388,3
2020-04-10-170608,170608,1,1,3,74,1.2,0.12768055,4
2020-04-11-170608,170608,1,0,0,75,1.8,0.055797324,5
2020-04-12-170608,170608,0,0,0,75,1.2,0.0657815,6
2020-04-13-170608,170608,2,0,0,77,5.2,0.70526767,0
2020-04-14-170608,170608,0,1,2,77,1.6,0.3863903,1
2020-04-15-170608,170608,2,0,0,79,2.6,0.3696017,2
2020-04-16-170608,170608,1,0,0,80,0.8,0.2116895,3
2020-04-17-170608,170608,0,0,1,80,0.8,0.11032036,4
2020-04-18-170608,170608,0,0,0,80,1.8,0.1627932,5
2020-04-19-170608,170608,0,0,0,80,1.0,0.053704087,6
2020-04-20-170608,170608,18,0,2,98,2.2,0.979762,0
2020-04-21-170608,170608,0,0,3,98,1.2,0.22712748,1
2020-04-22-170608,170608,0,0,0,98,0.8,0.15289545,2
2020-04-23-170608,170608,0,0,0,98,1.4,0.09262163,3
2020-04-24-170608,170608,3,0,0,101,0.2,0.19764806,4
2020-04-25-170608,170608,0,0,1,101,0.4,0.046792045,5
2020-04-26-170608,170608,0,0,0,101,0.2,0.039242346,6
2020-04-27-170608,170608,0,0,0,101,1.4,0.19468722,0
2020-04-28-170608,170608,2,0,2,103,1.8,0.5032082,1
2020-04-29-170608,170608,0,0,0,103,1.2,0.19465436,2
2020-04-30-170608,170608,0,0,0,103,0.8,0.14641616,3
2020-05-01-170608,170608,1,0,0,104,0.4,0.060494557,4
2020-05-02-170608,170608,0,0,0,104,0.8,0.14880742,5
2020-05-03-170608,170608,0,1,0,104,0.2,0.04133955,6
2020-05-04-170608,170608,2,0,2,106,2.4,0.42827758,0
2020-05-05-170608,170608,3,1,0,109,1.6,0.38986185,1
2020-05-06-170608,170608,0,0,0,109,1.6,0.50620013,2
2020-05-07-170608,170608,0,0,0,109,0.8,0.31343967,3
2020-05-08-170608,170608,0,0,0,109,0.4,0.11061103,4
2020-05-09-170608,170608,1,0,0,110,1.6,0.09878,5
2020-05-10-170608,170608,0,0,0,110,0.4,0.012690176,6
2020-05-11-170608,170608,0,5,0,110,1.0,0.24274808,0
2020-05-12-170608,170608,2,1,0,112,0.8,0.23680952,1
2020-05-13-170608,170608,0,0,0,112,1.2,0.18210344,2
2020-05-14-170608,170608,0,0,0,112,0.2,0.08086472,3
2020-05-15-170608,170608,0,0,0,112,0.4,0.059301168,4
2020-05-16-170608,170608,0,1,0,112,0.2,0.009730711,5
2020-05-17-170608,170608,0,0,0,112,0.2,0.007919739,6
2020-05-18-170608,170608,2,0,0,114,3.0,0.3504625,0
2020-05-19-170608,170608,0,0,1,114,0.4,0.10068376,1
2020-05-20-170608,170608,0,0,0,114,0.6,0.14988676,2
2020-05-21-170608,170608,0,0,1,114,0.6,0.075989336,3
2020-05-22-170608,170608,0,0,0,114,0.8,0.087606065,4
2020-05-23-170608,170608,0,0,0,114,0.2,0.016455822,5
2020-05-24-170608,170608,0,0,0,114,0.4,0.045792576,6
2020-05-25-170608,170608,0,0,0,114,0.8,0.10794879,0
2020-05-26-170608,170608,0,0,0,114,0.0,0.06450601,1
2020-05-27-170608,170608,0,1,0,114,0.4,0.21648662,2
2020-05-28-170608,170608,0,0,0,114,0.6,0.15857454,3
2020-05-29-170608,170608,0,0,0,114,0.8,0.20593476,4
2020-05-30-170608,170608,0,0,0,114,0.2,0.0011563603,5
2020-05-31-170608,170608,0,0,0,114,0.0,0.00022518908,6
2020-06-01-170608,170608,0,0,1,114,0.4,0.13637948,0
2020-06-02-170608,170608,1,0,0,115,0.4,0.18008268,1
2020-06-03-170608,170608,0,0,0,115,0.2,0.123752624,2
2020-06-04-170608,170608,1,0,0,116,1.2,0.2580172,3
2020-06-05-170608,170608,0,4,0,116,0.6,0.17048381,4
2020-06-06-170608,170608,0,0,0,116,0.0,0.007134257,5
2020-06-07-170608,170608,0,0,0,116,0.2,0.06320651,6
2020-06-08-170608,170608,0,0,0,116,0.2,0.031535245,0
2020-06-09-170608,170608,0,0,0,116,0.0,0.03958256,1
2020-06-10-170608,170608,0,0,0,116,0.0,0.08044691,2
2020-06-11-170608,170608,0,0,0,116,0.8,0.10957237,3
2020-06-12-170608,170608,0,0,0,116,0.0,0.029395385,4
2020-06-13-170608,170608,0,0,0,116,0.2,0.017859353,5
2020-06-14-170608,170608,0,0,0,116,0.0,0.0036984738,6
2020-06-15-170608,170608,1,0,0,117,0.2,0.059329506,0
2020-06-16-170608,170608,0,0,0,117,0.0,0.028202368,1
2020-06-17-170608,170608,0,0,0,117,0.2,0.08627102,2
2020-06-18-170608,170608,0,0,0,117,0.2,0.13008739,3
2020-06-19-170608,170608,0,0,0,117,0.6,0.12318823,4
2020-06-20-170608,170608,0,0,0,117,0.0,3.6446494e-05,5
2020-06-21-170608,170608,0,0,0,117,0.0,0.0008923089,6
2020-06-22-170608,170608,0,0,0,117,0.2,0.17205578,0
2020-06-23-170608,170608,0,0,0,117,0.6,0.1796373,1
2020-06-24-170608,170608,0,0,0,117,0.0,0.023859473,2
2020-06-25-170608,170608,0,1,0,117,0.4,0.094209015,3
2020-06-26-170608,170608,0,0,0,117,0.2,0.023939261,4
2020-06-27-170608,170608,0,0,0,117,0.0,0.0021119744,5
2020-06-28-170608,170608,0,0,0,117,0.4,0.030061439,6
2020-06-29-170608,170608,0,0,0,117,0.4,0.16257592,0
2020-06-30-170608,170608,0,0,0,117,0.0,0.042915676,1
2020-07-01-170608,170608,0,0,0,117,0.0,0.0079252,2
2020-07-02-170608,170608,0,0,2,117,0.2,0.024194334,3
2020-07-03-170608,170608,0,0,0,117,0.2,0.07770977,4
2020-07-04-170608,170608,0,0,0,117,0.0,0.00054355856,5
2020-07-05-170608,170608,0,0,0,117,0.2,0.028568322,6
2020-07-06-170608,170608,0,0,0,117,0.0,0.012541616,0
2020-07-07-170608,170608,0,0,0,117,0.2,0.020089805,1
2020-07-08-170608,170608,0,0,0,117,0.0,0.0007475186,2
2020-07-09-170608,170608,0,0,0,117,0.0,0.008584068,3
2020-07-10-170608,170608,0,0,0,117,0.0,0.007333422,4
2020-07-11-170608,170608,0,0,0,117,0.0,0.0041138767,5
2020-07-12-170608,170608,0,0,0,117,0.2,0.0873484,6
2020-07-13-170608,170608,0,0,0,117,0.2,0.0580362,0
2020-07-14-170608,170608,0,0,0,117,0.2,0.122287944,1
2020-07-15-170608,170608,0,0,0,117,0.0,0.0012470139,2
2020-07-16-170608,170608,2,0,0,119,0.4,0.20308344,3
2020-07-17-170608,170608,0,0,2,119,0.0,0.0024618413,4
2020-07-18-170608,170608,0,0,1,119,0.0,0.005561438,5
2020-07-19-170608,170608,0,0,0,119,0.0,0.0009469504,6
2020-07-20-170608,170608,0,0,0,119,0.0,0.0036699,0
2020-07-21-170608,170608,0,0,0,119,0.2,0.048016954,1
2020-07-22-170608,170608,0,0,0,119,0.0,0.04119867,2
2020-07-23-170608,170608,0,0,0,119,0.0,0.06505892,3
2020-07-24-170608,170608,0,0,2,119,0.4,0.034029488,4
2020-07-25-170608,170608,0,0,0,119,0.2,0.015373942,5
2020-07-26-170608,170608,0,0,0,119,0.0,0.012546202,6
2020-07-27-170608,170608,0,0,3,119,0.0,0.0037013716,0
2020-07-28-170608,170608,0,0,1,119,0.4,0.100604825,1
2020-07-29-170608,170608,0,0,0,119,0.2,0.10580724,2
2020-07-30-170608,170608,0,0,0,119,0.2,0.05728407,3
2020-07-31-170608,170608,2,0,0,121,0.0,0.15966763,4
2020-08-01-170608,170608,1,0,0,122,0.8,0.28365666,5
2020-08-02-170608,170608,0,0,1,122,0.0,0.02834046,6
2020-08-03-170608,170608,0,0,0,122,0.4,0.049471512,0
2020-08-04-170608,170608,0,0,2,122,0.2,0.11571914,1
2020-08-05-170608,170608,0,0,0,122,0.0,0.06403518,2
2020-08-06-170608,170608,0,1,1,122,0.2,0.13940127,3
2020-08-07-170608,170608,2,0,0,124,1.4,0.56628716,4
2020-08-08-170608,170608,0,0,0,124,0.6,0.12616822,5
2020-08-09-170608,170608,0,0,0,124,0.2,0.0664654,6
2020-08-10-170608,170608,3,0,2,127,0.2,0.6194241,0
2020-08-11-170608,170608,1,0,0,128,2.2,0.41785544,1
2020-08-12-170608,170608,0,0,0,128,0.8,0.29229838,2
2020-08-13-170608,170608,0,0,0,128,1.6,0.53333473,3
2020-08-14-170608,170608,0,0,0,128,2.0,0.35741055,4
2020-08-15-170608,170608,0,0,0,128,0.6,0.12425866,5
2020-08-16-170608,170608,1,0,1,129,0.6,0.18517105,6
2020-08-17-170608,170608,0,0,0,129,2.0,0.5371319,0
2020-08-18-170608,170608,2,0,1,131,1.6,0.55821204,1
2020-08-19-170608,170608,0,0,0,131,1.4,0.2907496,2
2020-08-20-170608,170608,1,0,2,132,1.8,0.45166695,3
2020-08-21-170608,170608,0,0,0,132,1.8,0.35526127,4
2020-08-22-170608,170608,0,0,0,132,0.8,0.17804307,5
2020-08-23-170608,170608,0,0,0,132,0.6,0.067793995,6
2020-08-24-170608,170608,2,0,0,134,2.4,0.41084725,0
2020-08-25-170608,170608,0,0,4,134,1.6,0.5538782,1
2020-08-26-170608,170608,0,0,0,134,1.2,0.45492196,2
2020-08-27-170608,170608,0,1,1,134,2.2,0.37581766,3
2020-08-28-170608,170608,0,0,1,134,0.8,0.42885715,4
2020-08-29-170608,170608,0,0,0,134,2.8,0.44688252,5
2020-08-30-170608,170608,1,0,0,135,0.8,0.13248868,6
2020-08-31-170608,170608,0,0,0,135,2.2,0.38815254,0
2020-09-01-170608,170608,1,0,0,136,4.4,0.7708141,1
2020-09-02-170608,170608,0,0,1,136,3.4,0.46861076,2
2020-09-03-170608,170608,2,0,0,138,2.2,0.58630955,3
2020-09-04-170608,170608,0,0,0,138,1.4,0.33815014,4
2020-09-05-170608,170608,0,0,0,138,1.6,0.19129835,5
2020-09-06-170608,170608,0,0,0,138,1.0,0.16029912,6
2020-09-07-170608,170608,0,0,2,138,2.0,0.3656368,0
2020-09-08-170608,170608,4,0,0,142,0.2,0.44230112,1
2020-09-09-170608,170608,0,0,1,142,1.2,0.21066743,2
2020-09-10-170608,170608,1,0,1,143,2.8,0.5401029,3
2020-09-11-170608,170608,1,0,3,144,1.0,0.31773776,4
2020-09-12-170608,170608,0,0,1,144,0.6,0.124799155,5
2020-09-13-170608,170608,0,0,1,144,0.8,0.13536796,6
2020-09-14-170608,170608,0,0,1,144,2.6,0.33293948,0
2020-09-15-170608,170608,0,0,1,144,0.6,0.15732354,1
2020-09-16-170608,170608,1,0,2,145,0.0,0.17036667,2
2020-09-17-170608,170608,0,0,1,145,1.6,0.30208352,3
2020-09-18-170608,170608,0,0,1,145,0.6,0.5575827,4
2020-09-19-170608,170608,0,0,0,145,0.6,0.13942735,5
2020-09-20-170608,170608,0,0,0,145,0.6,0.12249242,6
2020-09-21-170608,170608,2,0,0,147,1.8,0.58533657,0
2020-09-22-170608,170608,0,0,7,147,1.8,0.8905799,1
2020-09-23-170608,170608,1,0,3,148,0.4,0.3747646,2
2020-09-24-170608,170608,1,0,0,149,1.0,0.666898,3
2020-09-25-170608,170608,3,0,2,152,0.8,0.37492687,4
2020-09-26-170608,170608,1,0,0,153,1.2,0.34099254,5
2020-09-27-170608,170608,1,0,0,154,0.2,0.14877212,6
2020-09-28-170608,170608,1,0,0,155,0.4,0.20511161,0
2020-09-29-170608,170608,1,0,0,156,1.4,0.5816031,1
2020-09-30-170608,170608,2,0,0,158,1.6,0.544217,2
2020-10-01-170608,170608,1,0,1,159,2.8,0.75098044,3
2020-10-02-170608,170608,1,0,0,160,1.4,0.31384993,4
2020-10-03-170608,170608,0,0,0,160,0.6,0.12071425,5
2020-10-04-170608,170608,0,0,1,160,0.6,0.23759992,6
2020-10-05-170608,170608,0,1,0,160,1.4,0.5275736,0
2020-10-06-170608,170608,7,0,1,167,0.6,0.65642226,1
2020-10-07-170608,170608,3,0,1,170,2.2,0.91613597,2
2020-10-08-170608,170608,0,0,4,170,0.4,0.249573,3
2020-10-09-170608,170608,2,0,1,172,1.8,0.59777254,4
2020-10-10-170608,170608,0,0,1,172,0.4,0.15813763,5
2020-10-11-170608,170608,0,0,2,172,0.6,0.16354997,6
2020-10-12-170608,170608,0,0,0,172,0.6,0.15404887,0
2020-10-13-170608,170608,0,0,1,172,2.0,0.6456266,1
2020-10-14-170608,170608,0,0,5,172,2.6,0.6097936,2
2020-10-15-170608,170608,1,0,0,173,0.4,0.44353744,3
2020-10-16-170608,170608,0,0,2,173,3.2,0.8084403,4
2020-10-17-170608,170608,0,0,0,173,1.2,0.22159505,5
2020-10-18-170608,170608,1,0,0,174,0.8,0.18516359,6
2020-10-19-170608,170608,0,0,0,174,4.2,1.0282031,0
2020-10-20-170608,170608,1,0,0,175,1.6,0.76958585,1
2020-10-21-170608,170608,1,0,3,176,1.4,0.43103224,2
2020-10-22-170608,170608,4,0,0,180,2.0,0.9222091,3
2020-10-23-170608,170608,1,0,3,181,3.4,1.0174316,4
2020-10-24-170608,170608,1,0,1,182,0.4,0.30473882,5
2020-10-25-170608,170608,2,1,0,184,0.2,0.38176906,6
2020-10-26-170608,170608,0,0,3,184,3.8,0.6571542,0
2020-10-27-170608,170608,1,0,0,185,3.2,0.8740719,1
2020-10-28-170608,170608,5,0,0,190,2.4,0.8817819,2
2020-10-29-170608,170608,0,0,0,190,3.2,1.0859752,3
2020-10-30-170608,170608,2,1,0,192,2.0,0.94128823,4
2020-10-31-170608,170608,0,0,0,192,2.2,0.27364036,5
2020-11-01-170608,170608,0,0,0,192,1.2,0.25927,6
2020-11-02-170608,170608,0,0,0,192,1.2,0.32046026,0
2020-11-03-170608,170608,0,1,0,192,2.2,0.5168428,1
2020-11-04-170608,170608,3,0,0,195,3.4,0.8950604,2
2020-11-05-170608,170608,0,0,0,195,2.2,0.36501735,3
2020-11-06-170608,170608,3,0,0,198,4.4,0.8349127,4
2020-11-07-170608,170608,1,0,0,199,0.6,0.27587745,5
2020-11-08-170608,170608,0,0,0,199,2.0,0.21372029,6
2020-11-09-170608,170608,3,0,0,202,2.6,0.7125476,0
2020-11-10-170608,170608,0,0,0,202,1.4,0.48089218,1
2020-11-11-170608,170608,0,1,0,202,1.8,0.5527478,2
2020-11-12-170608,170608,0,0,0,202,1.6,0.42073715,3
2020-11-13-170608,170608,0,0,0,202,2.8,0.26736325,4
2020-03-01-170609,170609,0,0,0,0,0.0,3.3577446e-05,6
2020-03-02-170609,170609,0,0,0,0,0.0,0.0008958056,0
2020-03-03-170609,170609,0,0,1,0,0.0,0.00015826598,1
2020-03-04-170609,170609,0,0,1,0,0.0,0.00034102978,2
2020-03-05-170609,170609,0,0,0,0,0.0,0.002658327,3
2020-03-06-170609,170609,0,0,0,0,0.0,0.0024004758,4
2020-03-07-170609,170609,0,1,0,0,0.0,5.013969e-08,5
2020-03-08-170609,170609,0,0,0,0,0.0,0.00022555163,6
2020-03-09-170609,170609,0,0,1,0,0.0,0.00038399172,0
2020-03-10-170609,170609,0,0,0,0,0.0,0.00037574215,1
2020-03-11-170609,170609,0,0,0,0,0.0,0.0016198282,2
2020-03-12-170609,170609,0,0,0,0,0.0,0.0020567775,3
2020-03-13-170609,170609,0,0,0,0,0.0,0.0036708685,4
2020-03-14-170609,170609,0,0,1,0,0.3333333333333333,0.021376597,5
2020-03-15-170609,170609,0,0,0,0,1.3333333333333333,0.040332284,6
2020-03-16-170609,170609,0,0,1,0,6.666666666666668,0.21790028,0
2020-03-17-170609,170609,1,0,0,1,4.0,0.15779868,1
2020-03-18-170609,170609,1,0,0,2,5.0,0.19185343,2
2020-03-19-170609,170609,0,0,0,2,4.666666666666667,0.17640148,3
2020-03-20-170609,170609,0,1,1,2,6.666666666666668,0.20730947,4
2020-03-21-170609,170609,0,0,0,2,1.6666666666666667,0.04849864,5
2020-03-22-170609,170609,0,0,0,2,1.3333333333333333,0.028426316,6
2020-03-23-170609,170609,1,0,1,3,8.666666666666666,0.31251028,0
2020-03-24-170609,170609,0,0,0,3,7.666666666666668,0.22437616,1
2020-03-25-170609,170609,0,0,0,3,8.333333333333334,0.24735107,2
2020-03-26-170609,170609,0,0,0,3,5.333333333333333,0.20436548,3
2020-03-27-170609,170609,0,0,0,3,4.333333333333333,0.15135854,4
2020-03-28-170609,170609,1,0,0,4,3.6666666666666665,0.09141088,5
2020-03-29-170609,170609,0,0,0,4,2.333333333333333,0.057206362,6
2020-03-30-170609,170609,1,0,0,5,4.333333333333333,0.13871552,0
2020-03-31-170609,170609,0,0,0,5,4.333333333333333,0.17097373,1
2020-04-01-170609,170609,0,0,0,5,2.333333333333333,0.079317376,2
2020-04-02-170609,170609,0,1,0,5,2.333333333333333,0.09547268,3
2020-04-03-170609,170609,1,0,0,6,4.0,0.19598924,4
2020-04-04-170609,170609,0,0,0,6,1.0,0.026441688,5
2020-04-05-170609,170609,0,0,2,6,1.6666666666666667,0.033194434,6
2020-04-06-170609,170609,1,0,1,7,5.666666666666668,0.27798307,0
2020-04-07-170609,170609,0,1,0,7,5.666666666666668,0.2030009,1
2020-04-08-170609,170609,0,0,0,7,3.0,0.07880967,2
2020-04-09-170609,170609,0,0,0,7,1.0,0.023016343,3
2020-04-10-170609,170609,0,0,0,7,1.6666666666666667,0.044578575,4
2020-04-11-170609,170609,0,0,0,7,3.0,0.06377584,5
2020-04-12-170609,170609,0,0,0,7,1.6666666666666667,0.035999384,6
2020-04-13-170609,170609,0,1,1,7,6.666666666666668,0.21905032,0
2020-04-14-170609,170609,0,0,1,7,0.6666666666666666,0.030723283,1
2020-04-15-170609,170609,0,0,0,7,3.333333333333333,0.117355295,2
2020-04-16-170609,170609,0,0,0,7,1.0,0.054823432,3
2020-04-17-170609,170609,0,0,0,7,1.3333333333333333,0.04071409,4
2020-04-18-170609,170609,0,0,0,7,2.6666666666666665,0.08828938,5
2020-04-19-170609,170609,2,0,0,9,1.3333333333333333,0.0672897,6
2020-04-20-170609,170609,1,0,0,10,2.0,0.12302059,0
2020-04-21-170609,170609,0,0,0,10,2.0,0.081224464,1
2020-04-22-170609,170609,0,0,1,10,1.3333333333333333,0.051039185,2
2020-04-23-170609,170609,0,0,0,10,2.0,0.047558445,3
2020-04-24-170609,170609,0,0,0,10,0.3333333333333333,0.017285418,4
2020-04-25-170609,170609,0,0,0,10,0.6666666666666666,0.016201431,5
2020-04-26-170609,170609,0,0,0,10,0.3333333333333333,0.0084357355,6
2020-04-27-170609,170609,1,0,0,11,2.333333333333333,0.10607999,0
2020-04-28-170609,170609,1,0,0,12,0.6666666666666666,0.059191667,1
2020-04-29-170609,170609,0,0,0,12,1.0,0.06389518,2
2020-04-30-170609,170609,0,0,0,12,1.0,0.040829506,3
2020-05-01-170609,170609,0,0,2,12,0.6666666666666666,0.021520019,4
2020-05-02-170609,170609,0,0,0,12,0.3333333333333333,0.015585093,5
2020-05-03-170609,170609,0,0,0,12,0.3333333333333333,0.010763604,6
2020-05-04-170609,170609,0,0,4,12,4.0,0.1748876,0
2020-05-05-170609,170609,0,0,0,12,2.6666666666666665,0.13041767,1
2020-05-06-170609,170609,1,0,0,13,2.333333333333333,0.13880375,2
2020-05-07-170609,170609,0,0,0,13,1.3333333333333333,0.09744241,3
2020-05-08-170609,170609,0,0,0,13,0.6666666666666666,0.03015596,4
2020-05-09-170609,170609,0,0,0,13,2.6666666666666665,0.08374727,5
2020-05-10-170609,170609,0,0,0,13,0.6666666666666666,0.020513987,6
2020-05-11-170609,170609,0,0,0,13,2.333333333333333,0.10076355,0
2020-05-12-170609,170609,0,0,0,13,1.0,0.06688542,1
2020-05-13-170609,170609,0,0,0,13,1.6666666666666667,0.14612974,2
2020-05-14-170609,170609,0,0,1,13,0.0,0.0021404272,3
2020-05-15-170609,170609,2,0,0,15,0.6666666666666666,0.08670949,4
2020-05-16-170609,170609,0,0,0,15,0.6666666666666666,0.0465495,5
2020-05-17-170609,170609,0,0,0,15,0.3333333333333333,0.011162215,6
2020-05-18-170609,170609,4,0,0,19,5.666666666666668,0.32212135,0
2020-05-19-170609,170609,0,0,0,19,0.6666666666666666,0.05321203,1
2020-05-20-170609,170609,0,0,0,19,0.3333333333333333,0.01646584,2
2020-05-21-170609,170609,0,0,0,19,1.0,0.033612482,3
2020-05-22-170609,170609,0,0,0,19,1.3333333333333333,0.05644763,4
2020-05-23-170609,170609,0,0,0,19,0.3333333333333333,0.013584992,5
2020-05-24-170609,170609,0,0,0,19,0.3333333333333333,0.015344523,6
2020-05-25-170609,170609,0,0,0,19,1.3333333333333333,0.081353895,0
2020-05-26-170609,170609,0,0,0,19,0.0,0.018926859,1
2020-05-27-170609,170609,0,0,0,19,1.0,0.01516536,2
2020-05-28-170609,170609,1,0,0,20,1.6666666666666667,0.14260852,3
2020-05-29-170609,170609,0,0,0,20,1.0,0.060195934,4
2020-05-30-170609,170609,0,0,0,20,0.3333333333333333,8.831481e-05,5
2020-05-31-170609,170609,0,0,0,20,0.0,2.0923102e-05,6
2020-06-01-170609,170609,0,0,0,20,0.6666666666666666,0.03943383,0
2020-06-02-170609,170609,0,1,0,20,0.3333333333333333,0.023119489,1
2020-06-03-170609,170609,0,0,0,20,0.0,0.0031413825,2
2020-06-04-170609,170609,0,0,0,20,1.6666666666666667,0.09946782,3
2020-06-05-170609,170609,0,0,1,20,0.6666666666666666,0.047031514,4
2020-06-06-170609,170609,0,0,0,20,0.0,9.6982025e-05,5
2020-06-07-170609,170609,0,0,0,20,0.0,0.0001421323,6
2020-06-08-170609,170609,0,1,0,20,0.3333333333333333,0.020543473,0
2020-06-09-170609,170609,0,0,0,20,0.0,0.000546459,1
2020-06-10-170609,170609,0,0,0,20,0.0,0.002446833,2
2020-06-11-170609,170609,0,0,0,20,1.0,0.06101998,3
2020-06-12-170609,170609,0,0,0,20,0.0,0.0009228471,4
2020-06-13-170609,170609,0,3,0,20,0.3333333333333333,0.017397169,5
2020-06-14-170609,170609,0,0,0,20,0.0,5.6285953e-05,6
2020-06-15-170609,170609,0,0,0,20,0.0,0.0012507036,0
2020-06-16-170609,170609,0,0,0,20,0.0,0.0011071168,1
2020-06-17-170609,170609,0,0,0,20,0.0,0.0016072963,2
2020-06-18-170609,170609,0,0,0,20,0.0,0.0021479763,3
2020-06-19-170609,170609,1,0,0,21,0.6666666666666666,0.08533722,4
2020-06-20-170609,170609,0,0,0,21,0.0,4.6645617e-08,5
2020-06-21-170609,170609,0,0,0,21,0.0,4.41426e-05,6
2020-06-22-170609,170609,0,0,0,21,0.0,0.004398818,0
2020-06-23-170609,170609,0,0,0,21,0.3333333333333333,0.023620572,1
2020-06-24-170609,170609,0,0,0,21,0.3333333333333333,0.005298317,2
2020-06-25-170609,170609,0,0,0,21,0.3333333333333333,0.044899058,3
2020-06-26-170609,170609,0,0,0,21,0.3333333333333333,0.0244545,4
2020-06-27-170609,170609,0,0,0,21,0.0,0.0010436353,5
2020-06-28-170609,170609,0,0,0,21,0.6666666666666666,0.031920593,6
2020-06-29-170609,170609,0,0,0,21,0.0,0.0012627281,0
2020-06-30-170609,170609,0,0,1,21,0.0,0.0008531281,1
2020-07-01-170609,170609,0,0,0,21,0.0,0.00077821355,2
2020-07-02-170609,170609,0,0,0,21,0.3333333333333333,0.021608653,3
2020-07-03-170609,170609,0,0,0,21,0.0,0.0018724059,4
2020-07-04-170609,170609,0,0,0,21,0.0,2.1484567e-08,5
2020-07-05-170609,170609,0,0,0,21,0.6666666666666666,0.023402726,6
2020-07-06-170609,170609,0,0,0,21,0.0,0.0005482165,0
2020-07-07-170609,170609,0,0,0,21,0.3333333333333333,0.022859074,1
2020-07-08-170609,170609,0,0,0,21,0.0,0.00011514721,2
2020-07-09-170609,170609,0,1,0,21,0.0,0.00041359942,3
2020-07-10-170609,170609,0,0,0,21,0.0,0.0009481522,4
2020-07-11-170609,170609,0,0,0,21,0.0,0.00033480514,5
2020-07-12-170609,170609,0,0,0,21,0.0,0.0023812584,6
2020-07-13-170609,170609,0,0,0,21,0.3333333333333333,0.022253599,0
2020-07-14-170609,170609,1,0,0,22,0.0,0.0366696,1
2020-07-15-170609,170609,0,0,1,22,0.0,0.00027917325,2
2020-07-16-170609,170609,0,0,1,22,0.3333333333333333,0.026430313,3
2020-07-17-170609,170609,0,0,0,22,0.0,0.00045895824,4
2020-07-18-170609,170609,0,2,0,22,0.0,0.00016015218,5
2020-07-19-170609,170609,0,0,0,22,0.0,1.0563921e-08,6
2020-07-20-170609,170609,0,0,0,22,0.0,0.00055027666,0
2020-07-21-170609,170609,0,0,0,22,0.3333333333333333,0.025320696,1
2020-07-22-170609,170609,0,0,0,22,0.0,0.0013297203,2
2020-07-23-170609,170609,0,0,0,22,1.0,0.05388477,3
2020-07-24-170609,170609,0,0,0,22,0.6666666666666666,0.047913335,4
2020-07-25-170609,170609,0,0,0,22,0.3333333333333333,0.025067665,5
2020-07-26-170609,170609,0,0,0,22,0.0,0.0024884932,6
2020-07-27-170609,170609,0,0,1,22,0.3333333333333333,0.0004731152,0
2020-07-28-170609,170609,0,0,1,22,0.3333333333333333,0.025813507,1
2020-07-29-170609,170609,1,0,0,23,0.0,0.0034819404,2
2020-07-30-170609,170609,1,0,0,24,1.0,0.0026702345,3
2020-07-31-170609,170609,0,0,0,24,0.0,0.009102392,4
2020-08-01-170609,170609,0,0,0,24,0.3333333333333333,0.04083023,5
2020-08-02-170609,170609,0,0,0,24,0.0,0.004421008,6
2020-08-03-170609,170609,0,0,1,24,0.6666666666666666,0.031493764,0
2020-08-04-170609,170609,0,0,1,24,0.0,0.007762923,1
2020-08-05-170609,170609,0,0,4,24,0.0,0.005554759,2
2020-08-06-170609,170609,0,0,2,24,0.3333333333333333,0.07773606,3
2020-08-07-170609,170609,0,0,0,24,1.3333333333333333,0.2261431,4
2020-08-08-170609,170609,0,0,0,24,0.3333333333333333,0.010916775,5
2020-08-09-170609,170609,0,0,0,24,0.0,0.002403943,6
2020-08-10-170609,170609,1,0,0,25,0.0,0.0555224,0
2020-08-11-170609,170609,1,0,0,26,4.0,0.24076526,1
2020-08-12-170609,170609,0,0,1,26,0.6666666666666666,0.14322144,2
2020-08-13-170609,170609,0,0,0,26,1.3333333333333333,0.35141495,3
2020-08-14-170609,170609,0,0,0,26,2.6666666666666665,0.26417524,4
2020-08-15-170609,170609,0,0,0,26,2.0,0.3193503,5
2020-08-16-170609,170609,0,0,0,26,0.3333333333333333,0.010396074,6
2020-08-17-170609,170609,1,0,0,27,1.3333333333333333,0.16980302,0
2020-08-18-170609,170609,1,0,1,28,2.333333333333333,0.22902028,1
2020-08-19-170609,170609,4,0,1,32,2.333333333333333,0.3154929,2
2020-08-20-170609,170609,2,0,0,34,2.333333333333333,0.27248693,3
2020-08-21-170609,170609,0,0,0,34,2.333333333333333,0.112293914,4
2020-08-22-170609,170609,0,0,0,34,0.6666666666666666,0.055465695,5
2020-08-23-170609,170609,0,0,0,34,0.0,0.0041440683,6
2020-08-24-170609,170609,0,0,0,34,2.0,0.13930161,0
2020-08-25-170609,170609,0,0,0,34,0.3333333333333333,0.11260576,1
2020-08-26-170609,170609,1,0,0,35,1.3333333333333333,0.12808,2
2020-08-27-170609,170609,0,0,1,35,3.0,0.26330668,3
2020-08-28-170609,170609,0,0,0,35,1.0,0.09097068,4
2020-08-29-170609,170609,0,0,0,35,0.3333333333333333,0.059500948,5
2020-08-30-170609,170609,0,0,0,35,1.3333333333333333,0.041131854,6
2020-08-31-170609,170609,0,0,1,35,0.6666666666666666,0.0583339,0
2020-09-01-170609,170609,1,0,2,36,1.6666666666666667,0.22361471,1
2020-09-02-170609,170609,1,0,0,37,1.3333333333333333,0.15025029,2
2020-09-03-170609,170609,0,0,1,37,1.0,0.10097227,3
2020-09-04-170609,170609,0,0,0,37,2.333333333333333,0.110956654,4
2020-09-05-170609,170609,0,0,2,37,0.0,0.019242145,5
2020-09-06-170609,170609,0,0,0,37,0.0,0.054726303,6
2020-09-07-170609,170609,0,0,0,37,0.6666666666666666,0.079803556,0
2020-09-08-170609,170609,0,0,0,37,0.3333333333333333,0.09275272,1
2020-09-09-170609,170609,0,0,1,37,1.3333333333333333,0.06676992,2
2020-09-10-170609,170609,1,0,0,38,4.0,0.29908842,3
2020-09-11-170609,170609,0,0,0,38,0.6666666666666666,0.015736511,4
2020-09-12-170609,170609,0,0,0,38,0.0,0.014193801,5
2020-09-13-170609,170609,0,0,0,38,0.6666666666666666,0.020890009,6
2020-09-14-170609,170609,1,0,0,39,4.0,0.09985884,0
2020-09-15-170609,170609,2,0,1,41,1.0,0.0925113,1
2020-09-16-170609,170609,0,0,1,41,0.3333333333333333,0.048567634,2
2020-09-17-170609,170609,1,0,1,42,1.6666666666666667,0.15142664,3
2020-09-18-170609,170609,0,0,0,42,0.3333333333333333,0.057402954,4
2020-09-19-170609,170609,2,0,0,44,0.6666666666666666,0.09895334,5
2020-09-20-170609,170609,0,0,0,44,1.3333333333333333,0.016522145,6
2020-09-21-170609,170609,0,0,0,44,1.0,0.074349806,0
2020-09-22-170609,170609,0,0,0,44,1.0,0.064781085,1
2020-09-23-170609,170609,1,0,0,45,0.0,0.018820792,2
2020-09-24-170609,170609,0,0,0,45,1.3333333333333333,0.111873075,3
2020-09-25-170609,170609,0,0,0,45,0.6666666666666666,0.043122858,4
2020-09-26-170609,170609,0,0,0,45,1.3333333333333333,0.095886745,5
2020-09-27-170609,170609,0,0,2,45,0.0,0.0049881623,6
2020-09-28-170609,170609,0,0,0,45,0.6666666666666666,0.05008058,0
2020-09-29-170609,170609,1,0,0,46,1.0,0.09574149,1
2020-09-30-170609,170609,1,0,0,47,1.0,0.07568311,2
2020-10-01-170609,170609,1,0,0,48,2.0,0.16550758,3
2020-10-02-170609,170609,0,0,2,48,1.3333333333333333,0.06351134,4
2020-10-03-170609,170609,0,0,0,48,1.0,0.06681659,5
2020-10-04-170609,170609,0,0,0,48,0.0,0.007915704,6
2020-10-05-170609,170609,0,0,1,48,1.6666666666666667,0.12813972,0
2020-10-06-170609,170609,0,0,0,48,0.3333333333333333,0.00771063,1
2020-10-07-170609,170609,0,0,0,48,1.6666666666666667,0.20410356,2
2020-10-08-170609,170609,0,0,0,48,0.6666666666666666,0.13522217,3
2020-10-09-170609,170609,0,2,0,48,2.0,0.106152005,4
2020-10-10-170609,170609,0,0,0,48,0.6666666666666666,0.067070745,5
2020-10-11-170609,170609,2,0,0,50,1.0,0.1717788,6
2020-10-12-170609,170609,0,0,0,50,1.0,0.048829522,0
2020-10-13-170609,170609,0,0,1,50,0.6666666666666666,0.07998482,1
2020-10-14-170609,170609,0,0,5,50,2.0,0.17042997,2
2020-10-15-170609,170609,0,0,0,50,0.0,0.0741288,3
2020-10-16-170609,170609,2,0,0,52,2.333333333333333,0.21943061,4
2020-10-17-170609,170609,0,0,3,52,1.3333333333333333,0.07169592,5
2020-10-18-170609,170609,0,0,6,52,0.0,0.014230107,6
2020-10-19-170609,170609,1,0,0,53,3.0,0.2064639,0
2020-10-20-170609,170609,0,0,1,53,1.3333333333333333,0.17949519,1
2020-10-21-170609,170609,0,0,1,53,2.0,0.09682426,2
2020-10-22-170609,170609,0,0,0,53,1.0,0.09350653,3
2020-10-23-170609,170609,0,0,0,53,3.6666666666666665,0.24648906,4
2020-10-24-170609,170609,0,0,0,53,0.0,0.0086017605,5
2020-10-25-170609,170609,0,0,0,53,0.0,0.01819371,6
2020-10-26-170609,170609,0,0,0,53,4.333333333333333,0.28499374,0
2020-10-27-170609,170609,1,0,0,54,2.6666666666666665,0.24256763,1
2020-10-28-170609,170609,5,1,0,59,3.0,0.423529,2
2020-10-29-170609,170609,0,0,0,59,1.3333333333333333,0.20379752,3
2020-10-30-170609,170609,0,0,0,59,1.6666666666666667,0.2497142,4
2020-10-31-170609,170609,3,0,0,62,3.6666666666666665,0.34094793,5
2020-11-01-170609,170609,6,1,0,68,1.6666666666666667,0.29259667,6
2020-11-02-170609,170609,0,0,0,68,1.3333333333333333,0.07187921,0
2020-11-03-170609,170609,1,0,0,69,4.333333333333333,0.38988903,1
2020-11-04-170609,170609,1,0,0,70,4.666666666666667,0.33976665,2
2020-11-05-170609,170609,0,0,0,70,2.333333333333333,0.14125396,3
2020-11-06-170609,170609,0,0,0,70,6.333333333333332,0.39293686,4
2020-11-07-170609,170609,0,0,0,70,2.333333333333333,0.12387114,5
2020-11-08-170609,170609,0,0,0,70,3.333333333333333,0.11443432,6
2020-11-09-170609,170609,0,0,0,70,4.333333333333333,0.30356395,0
2020-11-10-170609,170609,0,0,0,70,1.6666666666666667,0.10563109,1
2020-11-11-170609,170609,0,0,0,70,4.666666666666667,0.14033851,2
2020-11-12-170609,170609,0,0,0,70,4.333333333333333,0.2621453,3
2020-11-13-170609,170609,0,0,0,70,6.666666666666668,0.20959899,4
2020-03-01-170610,170610,0,0,0,0,0.0,1.9082806e-08,6
2020-03-02-170610,170610,0,0,0,0,0.0,0.0015306897,0
2020-03-03-170610,170610,0,1,1,0,0.0,0.00050816714,1
2020-03-04-170610,170610,0,1,0,0,0.0,0.00038422897,2
2020-03-05-170610,170610,0,0,0,0,0.0,0.009273141,3
2020-03-06-170610,170610,0,0,0,0,0.0,0.009736289,4
2020-03-07-170610,170610,0,0,0,0,0.0,0.00026499384,5
2020-03-08-170610,170610,0,0,0,0,0.0,8.95436e-05,6
2020-03-09-170610,170610,0,1,1,0,0.0,0.00071845396,0
2020-03-10-170610,170610,0,0,0,0,0.0,0.0015652067,1
2020-03-11-170610,170610,0,0,0,0,0.0,0.01498606,2
2020-03-12-170610,170610,0,0,0,0,0.0,0.018457867,3
2020-03-13-170610,170610,0,0,0,0,0.0,0.031724162,4
2020-03-14-170610,170610,0,0,0,0,0.3333333333333333,0.039683707,5
2020-03-15-170610,170610,0,0,0,0,1.6666666666666667,0.06267298,6
2020-03-16-170610,170610,0,0,0,0,6.666666666666668,0.2732192,0
2020-03-17-170610,170610,1,0,0,1,4.333333333333333,0.2623281,1
2020-03-18-170610,170610,0,0,0,1,5.333333333333333,0.30359876,2
2020-03-19-170610,170610,0,0,0,1,5.0,0.2867404,3
2020-03-20-170610,170610,0,0,0,1,6.666666666666668,0.25989985,4
2020-03-21-170610,170610,0,0,0,1,2.0,0.0730603,5
2020-03-22-170610,170610,0,0,0,1,1.3333333333333333,0.04393598,6
2020-03-23-170610,170610,1,0,0,2,8.666666666666666,0.47743857,0
2020-03-24-170610,170610,0,0,0,2,7.666666666666668,0.35984233,1
2020-03-25-170610,170610,0,0,1,2,8.666666666666666,0.39225614,2
2020-03-26-170610,170610,0,0,0,2,5.333333333333333,0.29467222,3
2020-03-27-170610,170610,0,0,0,2,5.0,0.27342552,4
2020-03-28-170610,170610,0,0,0,2,4.0,0.09585529,5
2020-03-29-170610,170610,0,0,0,2,2.333333333333333,0.06620276,6
2020-03-30-170610,170610,0,0,1,2,5.0,0.24799675,0
2020-03-31-170610,170610,0,0,0,2,4.0,0.17961702,1
2020-04-01-170610,170610,0,0,0,2,2.333333333333333,0.13668862,2
2020-04-02-170610,170610,0,0,0,2,2.6666666666666665,0.29013336,3
2020-04-03-170610,170610,0,0,0,2,4.333333333333333,0.24510442,4
2020-04-04-170610,170610,0,0,0,2,1.0,0.065977,5
2020-04-05-170610,170610,0,0,0,2,1.6666666666666667,0.049171336,6
2020-04-06-170610,170610,0,0,0,2,4.666666666666667,0.1795184,0
2020-04-07-170610,170610,0,0,1,2,5.666666666666668,0.27913424,1
2020-04-08-170610,170610,1,0,0,3,2.6666666666666665,0.11557125,2
2020-04-09-170610,170610,0,0,0,3,1.0,0.034410857,3
2020-04-10-170610,170610,0,0,0,3,1.3333333333333333,0.0398285,4
2020-04-11-170610,170610,0,0,0,3,3.0,0.07691108,5
2020-04-12-170610,170610,0,0,0,3,1.6666666666666667,0.040418744,6
2020-04-13-170610,170610,1,0,0,4,6.333333333333332,0.27621716,0
2020-04-14-170610,170610,0,1,0,4,0.6666666666666666,0.08137001,1
2020-04-15-170610,170610,0,0,0,4,3.333333333333333,0.18825227,2
2020-04-16-170610,170610,0,0,0,4,0.6666666666666666,0.06539681,3
2020-04-17-170610,170610,0,0,0,4,1.3333333333333333,0.053448644,4
2020-04-18-170610,170610,0,0,0,4,2.6666666666666665,0.103729926,5
2020-04-19-170610,170610,0,0,0,4,2.333333333333333,0.065112926,6
2020-04-20-170610,170610,0,0,0,4,2.6666666666666665,0.22926736,0
2020-04-21-170610,170610,1,0,1,5,2.0,0.1360841,1
2020-04-22-170610,170610,0,0,1,5,1.3333333333333333,0.064110614,2
2020-04-23-170610,170610,0,0,0,5,2.0,0.050362095,3
2020-04-24-170610,170610,0,0,0,5,0.3333333333333333,0.03895085,4
2020-04-25-170610,170610,0,0,0,5,0.6666666666666666,0.024238884,5
2020-04-26-170610,170610,0,0,0,5,0.3333333333333333,0.0085305525,6
2020-04-27-170610,170610,0,2,2,5,2.6666666666666665,0.11996022,0
2020-04-28-170610,170610,0,0,0,5,1.0,0.1077368,1
2020-04-29-170610,170610,0,0,0,5,1.0,0.08139342,2
2020-04-30-170610,170610,0,0,0,5,1.0,0.053629816,3
2020-05-01-170610,170610,0,0,0,5,0.6666666666666666,0.022695001,4
2020-05-02-170610,170610,0,0,0,5,0.3333333333333333,0.0340525,5
2020-05-03-170610,170610,0,0,0,5,0.3333333333333333,0.010384219,6
2020-05-04-170610,170610,0,0,1,5,3.6666666666666665,0.17580034,0
2020-05-05-170610,170610,1,0,0,6,2.333333333333333,0.1822459,1
2020-05-06-170610,170610,1,0,0,7,2.0,0.20262253,2
2020-05-07-170610,170610,0,0,0,7,1.0,0.109026395,3
2020-05-08-170610,170610,0,0,0,7,0.6666666666666666,0.042253282,4
2020-05-09-170610,170610,0,3,0,7,2.6666666666666665,0.10689742,5
2020-05-10-170610,170610,0,2,0,7,0.6666666666666666,0.014399978,6
2020-05-11-170610,170610,2,3,0,9,1.3333333333333333,0.114043854,0
2020-05-12-170610,170610,0,0,0,9,1.0,0.10604889,1
2020-05-13-170610,170610,0,0,3,9,1.3333333333333333,0.12378535,2
2020-05-14-170610,170610,0,0,1,9,0.0,0.013696884,3
2020-05-15-170610,170610,0,0,0,9,1.3333333333333333,0.044417314,4
2020-05-16-170610,170610,0,0,0,9,0.3333333333333333,0.020688862,5
2020-05-17-170610,170610,0,0,0,9,0.3333333333333333,0.009797346,6
2020-05-18-170610,170610,1,0,0,10,6.333333333333332,0.30407563,0
2020-05-19-170610,170610,0,0,0,10,0.6666666666666666,0.062476918,1
2020-05-20-170610,170610,0,0,0,10,0.3333333333333333,0.044219647,2
2020-05-21-170610,170610,0,0,0,10,1.0,0.04551521,3
2020-05-22-170610,170610,0,0,0,10,1.3333333333333333,0.06327629,4
2020-05-23-170610,170610,0,0,0,10,0.3333333333333333,0.015320065,5
2020-05-24-170610,170610,0,0,0,10,0.3333333333333333,0.01888142,6
2020-05-25-170610,170610,0,0,0,10,1.3333333333333333,0.083616585,0
2020-05-26-170610,170610,0,0,0,10,0.0,0.02544243,1
2020-05-27-170610,170610,3,0,0,13,0.0,0.09094618,2
2020-05-28-170610,170610,1,0,0,14,1.3333333333333333,0.101214245,3
2020-05-29-170610,170610,0,0,0,14,1.0,0.078994684,4
2020-05-30-170610,170610,0,0,0,14,0.3333333333333333,0.00014745732,5
2020-05-31-170610,170610,0,0,0,14,0.0,4.214772e-06,6
2020-06-01-170610,170610,0,1,0,14,0.6666666666666666,0.0469945,0
2020-06-02-170610,170610,0,0,0,14,0.3333333333333333,0.036423095,1
2020-06-03-170610,170610,0,0,0,14,0.0,0.03660371,2
2020-06-04-170610,170610,0,0,0,14,1.6666666666666667,0.12188444,3
2020-06-05-170610,170610,0,0,0,14,1.0,0.08072599,4
2020-06-06-170610,170610,0,0,0,14,0.0,0.0006181665,5
2020-06-07-170610,170610,0,0,0,14,0.0,0.006329377,6
2020-06-08-170610,170610,0,0,0,14,0.3333333333333333,0.021305827,0
2020-06-09-170610,170610,0,0,0,14,0.0,0.0019848451,1
2020-06-10-170610,170610,0,0,1,14,0.0,0.009794983,2
2020-06-11-170610,170610,0,0,0,14,1.0,0.0786324,3
2020-06-12-170610,170610,0,0,0,14,0.0,0.0037607108,4
2020-06-13-170610,170610,0,0,0,14,0.3333333333333333,0.017711395,5
2020-06-14-170610,170610,0,0,0,14,0.0,0.0006205796,6
2020-06-15-170610,170610,0,0,0,14,0.0,0.015435965,0
2020-06-16-170610,170610,0,0,0,14,0.0,0.0033817946,1
2020-06-17-170610,170610,0,0,0,14,0.0,0.011332553,2
2020-06-18-170610,170610,0,0,0,14,0.0,0.014346107,3
2020-06-19-170610,170610,0,0,0,14,1.0,0.06212832,4
2020-06-20-170610,170610,0,0,0,14,0.0,0.00024652723,5
2020-06-21-170610,170610,0,0,1,14,0.0,0.0001895155,6
2020-06-22-170610,170610,0,0,0,14,0.0,0.017385824,0
2020-06-23-170610,170610,0,0,0,14,0.3333333333333333,0.045680664,1
2020-06-24-170610,170610,1,0,0,15,0.0,0.03086903,2
2020-06-25-170610,170610,0,0,0,15,0.3333333333333333,0.057983886,3
2020-06-26-170610,170610,0,0,0,15,0.3333333333333333,0.023910511,4
2020-06-27-170610,170610,0,0,0,15,0.0,0.00046622707,5
2020-06-28-170610,170610,0,0,0,15,0.6666666666666666,0.038096767,6
2020-06-29-170610,170610,0,0,0,15,0.0,0.016419373,0
2020-06-30-170610,170610,0,0,0,15,0.0,0.0025484036,1
2020-07-01-170610,170610,0,0,0,15,0.0,0.0010809156,2
2020-07-02-170610,170610,0,0,0,15,0.3333333333333333,0.024411637,3
2020-07-03-170610,170610,0,0,0,15,0.0,0.010781701,4
2020-07-04-170610,170610,0,0,0,15,0.0,8.306186e-05,5
2020-07-05-170610,170610,1,0,0,16,0.3333333333333333,0.03771284,6
2020-07-06-170610,170610,0,0,0,16,0.0,0.0018088982,0
2020-07-07-170610,170610,0,0,0,16,0.3333333333333333,0.02396551,1
2020-07-08-170610,170610,0,1,0,16,0.0,0.0002786866,2
2020-07-09-170610,170610,0,0,2,16,0.0,0.0010909364,3
2020-07-10-170610,170610,0,0,0,16,0.0,0.0018558655,4
2020-07-11-170610,170610,0,0,0,16,0.0,0.00057815335,5
2020-07-12-170610,170610,0,0,0,16,0.0,0.01060081,6
2020-07-13-170610,170610,0,0,1,16,0.3333333333333333,0.02774216,0
2020-07-14-170610,170610,0,0,0,16,0.3333333333333333,0.015245764,1
2020-07-15-170610,170610,0,0,0,16,0.0,8.3289364e-05,2
2020-07-16-170610,170610,0,0,1,16,0.3333333333333333,0.069507144,3
2020-07-17-170610,170610,0,0,0,16,0.0,0.0007166134,4
2020-07-18-170610,170610,0,0,0,16,0.0,0.00043947698,5
2020-07-19-170610,170610,0,0,0,16,0.0,5.583149e-05,6
2020-07-20-170610,170610,0,0,0,16,0.0,0.0008333325,0
2020-07-21-170610,170610,0,0,0,16,0.3333333333333333,0.0321568,1
2020-07-22-170610,170610,0,0,0,16,0.0,0.0035848254,2
2020-07-23-170610,170610,2,0,0,18,0.0,0.048369884,3
2020-07-24-170610,170610,0,0,1,18,0.6666666666666666,0.050131742,4
2020-07-25-170610,170610,0,0,0,18,0.3333333333333333,0.024760652,5
2020-07-26-170610,170610,0,0,0,18,0.0,0.0043707956,6
2020-07-27-170610,170610,1,0,0,19,0.0,0.000992517,0
2020-07-28-170610,170610,0,0,1,19,0.3333333333333333,0.03456853,1
2020-07-29-170610,170610,0,0,0,19,0.3333333333333333,0.024814926,2
2020-07-30-170610,170610,1,0,0,20,0.6666666666666666,0.0029608307,3
2020-07-31-170610,170610,0,0,0,20,0.0,0.034142714,4
2020-08-01-170610,170610,0,0,0,20,0.3333333333333333,0.08535729,5
2020-08-02-170610,170610,0,0,0,20,0.0,0.004418928,6
2020-08-03-170610,170610,0,1,0,20,0.6666666666666666,0.03207383,0
2020-08-04-170610,170610,0,0,1,20,0.0,0.021485787,1
2020-08-05-170610,170610,0,0,0,20,0.0,0.008257813,2
2020-08-06-170610,170610,0,0,0,20,0.0,0.036155272,3
2020-08-07-170610,170610,1,0,1,21,1.0,0.2746032,4
2020-08-08-170610,170610,0,0,0,21,0.6666666666666666,0.051844805,5
2020-08-09-170610,170610,0,0,0,21,0.0,0.022253493,6
2020-08-10-170610,170610,0,0,0,21,0.3333333333333333,0.11232772,0
2020-08-11-170610,170610,1,0,0,22,4.0,0.25909978,1
2020-08-12-170610,170610,0,0,1,22,1.0,0.16758218,2
2020-08-13-170610,170610,0,0,0,22,1.3333333333333333,0.377976,3
2020-08-14-170610,170610,0,0,1,22,2.6666666666666665,0.30255494,4
2020-08-15-170610,170610,0,0,0,22,1.0,0.1290014,5
2020-08-16-170610,170610,0,0,1,22,0.6666666666666666,0.08531304,6
2020-08-17-170610,170610,0,0,0,22,2.0,0.253013,0
2020-08-18-170610,170610,1,0,0,23,2.333333333333333,0.313709,1
2020-08-19-170610,170610,0,0,1,23,3.6666666666666665,0.22730282,2
2020-08-20-170610,170610,0,0,0,23,3.333333333333333,0.23836322,3
2020-08-21-170610,170610,1,0,0,24,2.333333333333333,0.20045687,4
2020-08-22-170610,170610,0,0,0,24,1.0,0.08214512,5
2020-08-23-170610,170610,0,0,0,24,0.0,0.021405097,6
2020-08-24-170610,170610,0,0,0,24,2.6666666666666665,0.27047756,0
2020-08-25-170610,170610,0,0,0,24,0.6666666666666666,0.179094,1
2020-08-26-170610,170610,1,0,0,25,1.6666666666666667,0.3426309,2
2020-08-27-170610,170610,0,0,0,25,3.0,0.30159417,3
2020-08-28-170610,170610,1,0,0,26,1.0,0.35339355,4
2020-08-29-170610,170610,0,0,0,26,4.0,0.363019,5
2020-08-30-170610,170610,1,0,0,27,1.3333333333333333,0.113541715,6
2020-08-31-170610,170610,0,0,1,27,2.6666666666666665,0.24105422,0
2020-09-01-170610,170610,0,0,0,27,5.333333333333333,0.40199614,1
2020-09-02-170610,170610,1,0,0,28,5.0,0.41980946,2
2020-09-03-170610,170610,0,0,0,28,3.0,0.28233302,3
2020-09-04-170610,170610,0,0,0,28,2.333333333333333,0.15450938,4
2020-09-05-170610,170610,0,0,0,28,2.6666666666666665,0.101439446,5
2020-09-06-170610,170610,0,0,2,28,1.6666666666666667,0.13114044,6
2020-09-07-170610,170610,0,0,0,28,3.333333333333333,0.24126403,0
2020-09-08-170610,170610,0,0,0,28,0.0,0.110154666,1
2020-09-09-170610,170610,0,0,0,28,1.6666666666666667,0.10696156,2
2020-09-10-170610,170610,0,0,0,28,4.333333333333333,0.38065732,3
2020-09-11-170610,170610,0,0,1,28,1.3333333333333333,0.035089213,4
2020-09-12-170610,170610,0,0,0,28,1.0,0.086460516,5
2020-09-13-170610,170610,0,0,0,28,1.0,0.04995899,6
2020-09-14-170610,170610,1,0,0,29,4.333333333333333,0.12993464,0
2020-09-15-170610,170610,0,0,0,29,1.6666666666666667,0.087067686,1
2020-09-16-170610,170610,0,0,0,29,0.0,0.023117008,2
2020-09-17-170610,170610,0,0,0,29,2.6666666666666665,0.19082715,3
2020-09-18-170610,170610,0,0,1,29,0.3333333333333333,0.12986653,4
2020-09-19-170610,170610,0,0,0,29,1.6666666666666667,0.057545245,5
2020-09-20-170610,170610,2,0,0,31,1.0,0.042947214,6
2020-09-21-170610,170610,0,0,0,31,1.0,0.13450205,0
2020-09-22-170610,170610,0,0,1,31,1.3333333333333333,0.16485341,1
2020-09-23-170610,170610,0,0,0,31,0.6666666666666666,0.0801161,2
2020-09-24-170610,170610,0,0,0,31,1.3333333333333333,0.16279644,3
2020-09-25-170610,170610,1,0,2,32,0.3333333333333333,0.08546289,4
2020-09-26-170610,170610,0,0,0,32,1.6666666666666667,0.122417144,5
2020-09-27-170610,170610,0,0,0,32,0.0,0.031160364,6
2020-09-28-170610,170610,0,0,0,32,0.6666666666666666,0.07461342,0
2020-09-29-170610,170610,0,0,0,32,1.0,0.121130414,1
2020-09-30-170610,170610,0,0,1,32,1.6666666666666667,0.21543166,2
2020-10-01-170610,170610,0,0,0,32,2.6666666666666665,0.2653808,3
2020-10-02-170610,170610,1,0,0,33,1.0,0.12453646,4
2020-10-03-170610,170610,0,0,0,33,1.0,0.07315832,5
2020-10-04-170610,170610,0,0,0,33,0.0,0.03314075,6
2020-10-05-170610,170610,0,0,1,33,1.0,0.13374433,0
2020-10-06-170610,170610,1,0,0,34,0.0,0.0813744,1
2020-10-07-170610,170610,0,0,1,34,1.6666666666666667,0.38569114,2
2020-10-08-170610,170610,0,0,0,34,0.6666666666666666,0.16876487,3
2020-10-09-170610,170610,2,1,1,36,1.3333333333333333,0.19726889,4
2020-10-10-170610,170610,0,0,0,36,0.6666666666666666,0.12802647,5
2020-10-11-170610,170610,0,0,0,36,1.6666666666666667,0.07643936,6
2020-10-12-170610,170610,0,0,0,36,1.0,0.07568689,0
2020-10-13-170610,170610,0,0,0,36,1.6666666666666667,0.24545705,1
2020-10-14-170610,170610,1,0,0,37,2.0,0.25488582,2
2020-10-15-170610,170610,0,0,0,37,0.0,0.18239316,3
2020-10-16-170610,170610,0,0,0,37,3.0,0.2685026,4
2020-10-17-170610,170610,0,0,0,37,1.3333333333333333,0.105462745,5
2020-10-18-170610,170610,0,0,0,37,1.0,0.08234892,6
2020-10-19-170610,170610,1,0,0,38,3.6666666666666665,0.37773645,0
2020-10-20-170610,170610,0,0,1,38,1.3333333333333333,0.17542283,1
2020-10-21-170610,170610,1,0,1,39,1.6666666666666667,0.18321101,2
2020-10-22-170610,170610,0,0,0,39,2.6666666666666665,0.25721097,3
2020-10-23-170610,170610,1,0,2,40,3.333333333333333,0.40059355,4
2020-10-24-170610,170610,0,0,2,40,0.0,0.06439414,5
2020-10-25-170610,170610,0,0,1,40,0.0,0.06624855,6
2020-10-26-170610,170610,0,0,1,40,4.333333333333333,0.3412043,0
2020-10-27-170610,170610,0,0,2,40,3.0,0.32836342,1
2020-10-28-170610,170610,0,0,9,40,4.666666666666667,0.6422904,2
2020-10-29-170610,170610,0,0,5,40,1.3333333333333333,0.2812073,3
2020-10-30-170610,170610,0,0,4,40,1.6666666666666667,0.37628084,4
2020-10-31-170610,170610,0,0,0,40,4.666666666666667,0.29236257,5
2020-11-01-170610,170610,0,0,0,40,3.6666666666666665,0.14456505,6
2020-11-02-170610,170610,0,0,0,40,1.3333333333333333,0.087159395,0
2020-11-03-170610,170610,1,0,0,41,3.333333333333333,0.5589866,1
2020-11-04-170610,170610,1,0,0,42,4.666666666666667,0.47290266,2
2020-11-05-170610,170610,0,0,0,42,2.6666666666666665,0.24753496,3
2020-11-06-170610,170610,2,0,0,44,5.0,0.48314804,4
2020-11-07-170610,170610,2,0,0,46,1.0,0.16938622,5
2020-11-08-170610,170610,1,1,0,47,3.0,0.15804355,6
2020-11-09-170610,170610,1,0,0,48,4.0,0.41019306,0
2020-11-10-170610,170610,2,0,0,50,1.0,0.20246504,1
2020-11-11-170610,170610,9,0,0,59,1.6666666666666667,0.34947506,2
2020-11-12-170610,170610,5,0,0,64,2.6666666666666665,0.38810462,3
2020-11-13-170610,170610,4,0,0,68,4.666666666666667,0.30541256,4
2020-03-01-170611,170611,0,0,12,0,0.25,0.020481395,6
2020-03-02-170611,170611,0,0,16,0,0.25,0.05016293,0
2020-03-03-170611,170611,0,0,25,0,0.0,0.12982936,1
2020-03-04-170611,170611,0,0,22,0,0.0,0.11785112,2
2020-03-05-170611,170611,0,0,21,0,0.0,0.018905135,3
2020-03-06-170611,170611,0,0,32,0,0.75,0.02443393,4
2020-03-07-170611,170611,0,0,12,0,0.0,0.012784485,5
2020-03-08-170611,170611,0,0,9,0,0.25,0.08563368,6
2020-03-09-170611,170611,0,0,31,0,1.0,0.13508263,0
2020-03-10-170611,170611,1,0,47,1,0.5,0.3438951,1
2020-03-11-170611,170611,3,0,36,4,1.75,0.3251472,2
2020-03-12-170611,170611,1,0,44,5,0.75,0.11171405,3
2020-03-13-170611,170611,6,0,31,11,3.25,0.74180967,4
2020-03-14-170611,170611,4,0,5,15,2.75,0.599732,5
2020-03-15-170611,170611,12,0,11,27,11.25,1.2296542,6
2020-03-16-170611,170611,16,0,29,43,19.25,2.6708765,0
2020-03-17-170611,170611,25,0,20,68,21.25,3.11214,1
2020-03-18-170611,170611,22,0,18,90,24.0,2.389734,2
2020-03-19-170611,170611,21,0,15,111,22.5,3.3702397,3
2020-03-20-170611,170611,32,0,17,143,24.75,3.3034062,4
2020-03-21-170611,170611,12,0,8,155,11.75,0.88094884,5
2020-03-22-170611,170611,9,0,4,164,14.5,0.9200301,6
2020-03-23-170611,170611,31,0,25,195,37.25,6.142668,0
2020-03-24-170611,170611,47,0,10,242,33.75,4.592394,1
2020-03-25-170611,170611,36,0,18,278,37.0,5.1197376,2
2020-03-26-170611,170611,44,0,8,322,27.5,4.182107,3
2020-03-27-170611,170611,31,0,12,353,31.5,4.5122905,4
2020-03-28-170611,170611,5,0,2,358,7.0,0.63373286,5
2020-03-29-170611,170611,11,0,5,369,8.0,0.79322016,6
2020-03-30-170611,170611,29,0,14,398,22.25,3.9031444,0
2020-03-31-170611,170611,20,0,11,418,20.25,2.6185129,1
2020-04-01-170611,170611,18,0,9,436,21.25,3.2219434,2
2020-04-02-170611,170611,15,0,10,451,10.0,1.4005053,3
2020-04-03-170611,170611,17,0,9,468,14.5,2.2165053,4
2020-04-04-170611,170611,8,0,8,476,5.0,0.44129476,5
2020-04-05-170611,170611,4,0,2,480,6.0,0.40677306,6
2020-04-06-170611,170611,25,1,27,505,17.75,3.0520992,0
2020-04-07-170611,170611,10,0,13,515,18.25,2.981566,1
2020-04-08-170611,170611,18,0,4,533,14.75,1.9019505,2
2020-04-09-170611,170611,8,0,4,541,5.25,0.5990539,3
2020-04-10-170611,170611,12,1,1,553,9.25,0.76569635,4
2020-04-11-170611,170611,2,0,3,555,4.0,0.5218544,5
2020-04-12-170611,170611,5,0,4,560,7.5,0.7794099,6
2020-04-13-170611,170611,14,0,16,574,10.75,2.143706,0
2020-04-14-170611,170611,11,0,2,585,17.75,3.4181767,1
2020-04-15-170611,170611,9,0,4,594,5.25,1.7177794,2
2020-04-16-170611,170611,10,0,6,604,6.0,1.0625657,3
2020-04-17-170611,170611,9,0,1,613,8.5,1.7230998,4
2020-04-18-170611,170611,8,0,9,621,4.0,0.9462664,5
2020-04-19-170611,170611,2,0,0,623,2.5,0.19198264,6
2020-04-20-170611,170611,27,1,5,650,9.0,1.476877,0
2020-04-21-170611,170611,13,0,3,663,13.5,2.970122,1
2020-04-22-170611,170611,4,0,8,667,11.5,2.5637941,2
2020-04-23-170611,170611,4,0,3,671,2.25,0.38994,3
2020-04-24-170611,170611,1,0,6,672,7.5,1.2617304,4
2020-04-25-170611,170611,3,0,1,675,3.25,0.5343267,5
2020-04-26-170611,170611,4,0,0,679,0.25,0.38438612,6
2020-04-27-170611,170611,16,0,5,695,6.5,1.7587619,0
2020-04-28-170611,170611,2,0,11,697,5.75,1.0018395,1
2020-04-29-170611,170611,4,0,6,701,9.0,1.4659201,2
2020-04-30-170611,170611,6,0,5,707,5.5,1.1002431,3
2020-05-01-170611,170611,1,0,9,708,4.5,0.7304505,4
2020-05-02-170611,170611,9,0,1,717,3.0,0.3217095,5
2020-05-03-170611,170611,0,0,0,717,1.5,0.145103,6
2020-05-04-170611,170611,5,0,6,722,6.25,2.5954695,0
2020-05-05-170611,170611,3,0,2,725,6.5,1.1342458,1
2020-05-06-170611,170611,8,0,7,733,4.75,2.3985827,2
2020-05-07-170611,170611,3,0,6,736,7.0,2.3903577,3
2020-05-08-170611,170611,6,0,7,742,9.25,1.7171317,4
2020-05-09-170611,170611,1,0,0,743,1.75,0.32868433,5
2020-05-10-170611,170611,0,0,0,743,0.75,0.055011883,6
2020-05-11-170611,170611,5,1,7,748,8.75,2.0629482,0
2020-05-12-170611,170611,11,0,6,759,14.75,2.5032728,1
2020-05-13-170611,170611,6,0,7,765,9.0,1.6038088,2
2020-05-14-170611,170611,5,0,1,770,4.25,0.6666159,3
2020-05-15-170611,170611,9,0,4,779,8.0,1.4480841,4
2020-05-16-170611,170611,1,0,1,780,0.75,0.062305175,5
2020-05-17-170611,170611,0,0,0,780,0.25,0.015655769,6
2020-05-18-170611,170611,6,0,8,786,3.5,1.0541984,0
2020-05-19-170611,170611,2,0,8,788,3.75,0.993071,1
2020-05-20-170611,170611,7,0,4,795,2.5,0.77728283,2
2020-05-21-170611,170611,6,0,8,801,4.25,0.63009465,3
2020-05-22-170611,170611,7,0,8,808,4.0,0.78472215,4
2020-05-23-170611,170611,0,0,0,808,0.25,0.09380185,5
2020-05-24-170611,170611,0,1,0,808,0.25,0.03884364,6
2020-05-25-170611,170611,7,0,5,815,4.5,1.175753,0
2020-05-26-170611,170611,6,0,7,821,2.5,0.52655435,1
2020-05-27-170611,170611,7,0,4,828,2.0,0.6884015,2
2020-05-28-170611,170611,1,0,3,829,1.75,0.86197,3
2020-05-29-170611,170611,4,0,1,833,2.0,0.92415124,4
2020-05-30-170611,170611,1,0,0,834,0.75,0.08478202,5
2020-05-31-170611,170611,0,0,0,834,0.0,0.01635448,6
2020-06-01-170611,170611,8,0,2,842,5.25,1.3335704,0
2020-06-02-170611,170611,8,0,1,850,2.5,0.44432366,1
2020-06-03-170611,170611,4,0,2,854,4.25,0.3756485,2
2020-06-04-170611,170611,8,0,1,862,3.0,0.8775221,3
2020-06-05-170611,170611,8,0,4,870,0.75,1.5310582,4
2020-06-06-170611,170611,0,0,0,870,0.0,0.078494616,5
2020-06-07-170611,170611,0,1,0,870,0.25,0.09070078,6
2020-06-08-170611,170611,5,1,6,875,1.75,0.43896094,0
2020-06-09-170611,170611,7,0,1,882,2.0,0.4215549,1
2020-06-10-170611,170611,4,0,1,886,1.5,0.26373896,2
2020-06-11-170611,170611,3,0,1,889,2.0,0.54396725,3
2020-06-12-170611,170611,1,0,0,890,0.25,0.24826746,4
2020-06-13-170611,170611,0,0,0,890,0.25,0.017087802,5
2020-06-14-170611,170611,0,0,0,890,0.0,0.019378072,6
2020-06-15-170611,170611,2,0,3,892,2.25,0.15364309,0
2020-06-16-170611,170611,1,1,0,893,1.75,0.65023136,1
2020-06-17-170611,170611,2,0,1,895,2.0,0.4145675,2
2020-06-18-170611,170611,1,0,0,896,2.5,0.48987848,3
2020-06-19-170611,170611,4,0,0,900,2.0,0.88881457,4
2020-06-20-170611,170611,0,1,0,900,0.0,0.0014466635,5
2020-06-21-170611,170611,0,0,0,900,0.0,0.02573188,6
2020-06-22-170611,170611,6,0,0,906,1.5,0.5268937,0
2020-06-23-170611,170611,1,0,2,907,0.5,0.6493207,1
2020-06-24-170611,170611,1,0,0,908,0.75,0.22707225,2
2020-06-25-170611,170611,1,0,1,909,0.5,0.25879842,3
2020-06-26-170611,170611,0,1,0,909,3.0,0.65539086,4
2020-06-27-170611,170611,0,0,0,909,0.25,0.10470691,5
2020-06-28-170611,170611,0,1,0,909,0.0,0.09242933,6
2020-06-29-170611,170611,3,1,1,912,1.0,0.36688888,0
2020-06-30-170611,170611,0,1,1,912,0.25,0.33498865,1
2020-07-01-170611,170611,1,0,0,913,0.75,0.21439295,2
2020-07-02-170611,170611,0,0,1,913,0.75,0.10522261,3
2020-07-03-170611,170611,0,0,1,913,1.75,0.43294552,4
2020-07-04-170611,170611,0,0,0,913,0.0,0.018447895,5
2020-07-05-170611,170611,0,0,0,913,0.0,0.07291692,6
2020-07-06-170611,170611,0,0,2,913,0.5,0.13120404,0
2020-07-07-170611,170611,2,0,2,915,0.25,0.12498524,1
2020-07-08-170611,170611,0,0,1,915,0.25,0.024161855,2
2020-07-09-170611,170611,1,0,3,916,0.5,0.19480506,3
2020-07-10-170611,170611,0,0,6,916,0.75,0.11663035,4
2020-07-11-170611,170611,0,0,0,916,0.0,0.019978845,5
2020-07-12-170611,170611,0,0,0,916,0.0,0.11466665,6
2020-07-13-170611,170611,1,0,5,917,0.0,0.21616715,0
2020-07-14-170611,170611,1,0,2,918,0.0,0.2674008,1
2020-07-15-170611,170611,0,0,3,918,1.0,0.03634404,2
2020-07-16-170611,170611,1,0,2,919,0.75,0.14061065,3
2020-07-17-170611,170611,1,0,7,920,0.25,0.08881226,4
2020-07-18-170611,170611,0,0,2,920,0.0,0.047767777,5
2020-07-19-170611,170611,0,0,0,920,0.0,0.0025392084,6
2020-07-20-170611,170611,2,0,2,922,1.5,0.17832378,0
2020-07-21-170611,170611,2,0,0,924,0.5,0.08737234,1
2020-07-22-170611,170611,1,0,10,925,1.75,0.43504137,2
2020-07-23-170611,170611,3,0,7,928,0.5,0.04207698,3
2020-07-24-170611,170611,6,1,7,934,0.75,0.046137374,4
2020-07-25-170611,170611,0,0,3,934,0.0,0.0281344,5
2020-07-26-170611,170611,0,0,4,934,0.0,0.033138145,6
2020-07-27-170611,170611,5,0,6,939,0.75,0.20913422,0
2020-07-28-170611,170611,2,1,3,941,0.75,0.32304814,1
2020-07-29-170611,170611,3,0,6,944,0.5,0.1611949,2
2020-07-30-170611,170611,2,0,6,946,1.0,0.58285266,3
2020-07-31-170611,170611,7,0,9,953,1.75,0.4477121,4
2020-08-01-170611,170611,2,0,7,955,0.5,0.4985716,5
2020-08-02-170611,170611,0,0,2,955,2.0,0.4494176,6
2020-08-03-170611,170611,2,0,10,957,4.0,1.0944695,0
2020-08-04-170611,170611,0,0,1,957,1.75,0.80857265,1
2020-08-05-170611,170611,10,0,10,967,4.25,1.3981059,2
2020-08-06-170611,170611,7,0,10,974,2.25,0.95323235,3
2020-08-07-170611,170611,7,0,3,981,4.25,1.4487514,4
2020-08-08-170611,170611,3,0,2,984,1.25,0.62999874,5
2020-08-09-170611,170611,4,0,2,988,1.0,0.15263492,6
2020-08-10-170611,170611,6,0,4,994,3.0,0.9140663,0
2020-08-11-170611,170611,3,0,18,997,4.5,0.9849525,1
2020-08-12-170611,170611,6,0,12,1003,3.5,1.6088219,2
2020-08-13-170611,170611,6,0,12,1009,7.0,1.6906979,3
2020-08-14-170611,170611,9,0,23,1018,2.5,1.1753273,4
2020-08-15-170611,170611,7,0,4,1025,2.0,0.3065562,5
2020-08-16-170611,170611,2,0,2,1027,2.0,0.6263978,6
2020-08-17-170611,170611,10,0,10,1037,3.75,1.249048,0
2020-08-18-170611,170611,1,0,7,1038,4.75,1.759793,1
2020-08-19-170611,170611,10,0,4,1048,3.5,1.1513736,2
2020-08-20-170611,170611,10,1,6,1058,4.5,2.3682775,3
2020-08-21-170611,170611,3,0,16,1061,6.5,1.5560366,4
2020-08-22-170611,170611,2,0,5,1063,1.0,0.4137438,5
2020-08-23-170611,170611,2,0,1,1065,4.5,0.92814744,6
2020-08-24-170611,170611,4,0,5,1069,9.5,2.9012814,0
2020-08-25-170611,170611,18,0,13,1087,9.25,1.7838488,1
2020-08-26-170611,170611,12,0,4,1099,8.5,2.3820646,2
2020-08-27-170611,170611,12,0,5,1111,6.25,2.1950712,3
2020-08-28-170611,170611,23,0,14,1134,9.25,2.1967394,4
2020-08-29-170611,170611,4,0,6,1138,2.5,0.8844307,5
2020-08-30-170611,170611,2,0,9,1140,2.25,0.4802694,6
2020-08-31-170611,170611,10,0,12,1150,9.75,3.1618667,0
2020-09-01-170611,170611,7,0,10,1157,5.5,2.8309367,1
2020-09-02-170611,170611,4,0,10,1161,5.0,2.1421869,2
2020-09-03-170611,170611,6,0,6,1167,7.25,3.3282826,3
2020-09-04-170611,170611,16,0,8,1183,14.25,3.6666377,4
2020-09-05-170611,170611,5,0,3,1188,4.25,1.5096754,5
2020-09-06-170611,170611,1,0,7,1189,4.25,1.0856758,6
2020-09-07-170611,170611,5,0,17,1194,12.0,3.6468954,0
2020-09-08-170611,170611,13,0,14,1207,1.5,1.0882391,1
2020-09-09-170611,170611,4,0,9,1211,4.25,1.803623,2
2020-09-10-170611,170611,5,0,15,1216,6.75,2.0201333,3
2020-09-11-170611,170611,14,0,13,1230,16.25,4.083771,4
2020-09-12-170611,170611,6,0,3,1236,3.5,1.2233155,5
2020-09-13-170611,170611,9,0,7,1245,3.25,0.75699776,6
2020-09-14-170611,170611,12,0,12,1257,15.5,4.335115,0
2020-09-15-170611,170611,10,0,9,1267,9.75,2.3698,1
2020-09-16-170611,170611,10,0,5,1277,7.75,2.5394094,2
2020-09-17-170611,170611,6,0,5,1283,9.25,2.0708776,3
2020-09-18-170611,170611,8,0,10,1291,11.0,4.587025,4
2020-09-19-170611,170611,3,2,0,1294,3.0,1.6400388,5
2020-09-20-170611,170611,7,0,6,1301,3.25,1.3925905,6
2020-09-21-170611,170611,17,0,10,1318,13.5,4.1648927,0
2020-09-22-170611,170611,14,1,4,1332,12.0,3.705277,1
2020-09-23-170611,170611,9,2,10,1341,10.5,3.9868686,2
2020-09-24-170611,170611,15,0,9,1356,8.5,3.4919708,3
2020-09-25-170611,170611,13,1,7,1369,10.0,3.445031,4
2020-09-26-170611,170611,3,0,7,1372,2.5,1.8012776,5
2020-09-27-170611,170611,7,1,5,1379,0.75,0.92250425,6
2020-09-28-170611,170611,12,0,3,1391,7.25,3.3692257,0
2020-09-29-170611,170611,9,0,18,1400,7.25,2.4195638,1
2020-09-30-170611,170611,5,0,10,1405,8.25,2.5738242,2
2020-10-01-170611,170611,5,0,11,1410,4.25,1.9587318,3
2020-10-02-170611,170611,10,0,16,1420,6.0,2.602113,4
2020-10-03-170611,170611,0,0,6,1420,4.5,1.2752095,5
2020-10-04-170611,170611,6,1,13,1426,2.25,0.9849022,6
2020-10-05-170611,170611,10,0,13,1436,21.25,9.806813,0
2020-10-06-170611,170611,4,0,12,1440,9.75,3.37393,1
2020-10-07-170611,170611,10,0,12,1450,11.0,5.5524116,2
2020-10-08-170611,170611,9,0,13,1459,8.25,3.880382,3
2020-10-09-170611,170611,7,0,15,1466,12.25,3.3248844,4
2020-10-10-170611,170611,7,0,4,1473,4.0,1.079189,5
2020-10-11-170611,170611,5,0,0,1478,5.25,1.6353486,6
2020-10-12-170611,170611,3,0,22,1481,3.75,1.3050711,0
2020-10-13-170611,170611,18,0,17,1499,11.0,3.7585876,1
2020-10-14-170611,170611,10,0,14,1509,9.5,3.6737835,2
2020-10-15-170611,170611,11,0,13,1520,8.0,5.5217166,3
2020-10-16-170611,170611,16,0,17,1536,15.5,7.4941483,4
2020-10-17-170611,170611,6,0,0,1542,3.75,0.83337766,5
2020-10-18-170611,170611,13,0,3,1555,2.5,0.86768013,6
2020-10-19-170611,170611,13,0,4,1568,10.75,4.5807843,0
2020-10-20-170611,170611,12,0,16,1580,11.25,4.255232,1
2020-10-21-170611,170611,12,0,18,1592,15.75,6.0623403,2
2020-10-22-170611,170611,13,0,6,1605,17.25,6.4542584,3
2020-10-23-170611,170611,15,1,21,1620,22.5,5.868365,4
2020-10-24-170611,170611,4,0,4,1624,3.25,1.3614944,5
2020-10-25-170611,170611,0,1,5,1624,9.75,1.5301911,6
2020-10-26-170611,170611,22,1,18,1646,18.5,4.9560523,0
2020-10-27-170611,170611,17,0,10,1663,14.0,5.676512,1
2020-10-28-170611,170611,14,1,12,1677,16.5,5.935158,2
2020-10-29-170611,170611,13,1,9,1690,14.25,5.328595,3
2020-10-30-170611,170611,17,0,2,1707,20.5,5.3290644,4
2020-10-31-170611,170611,0,1,0,1707,3.0,1.1099327,5
2020-11-01-170611,170611,3,2,0,1710,6.5,1.4152057,6
2020-11-02-170611,170611,4,0,0,1714,3.75,1.2631346,0
2020-11-03-170611,170611,16,0,0,1730,19.5,5.924269,1
2020-11-04-170611,170611,18,2,0,1748,12.75,4.499788,2
2020-11-05-170611,170611,6,0,0,1754,12.0,4.8817887,3
2020-11-06-170611,170611,21,3,0,1775,12.0,3.9137516,4
2020-11-07-170611,170611,4,1,0,1779,2.5,0.9435837,5
2020-11-08-170611,170611,5,0,0,1784,5.0,1.089819,6
2020-11-09-170611,170611,18,0,0,1802,12.0,5.0787673,0
2020-11-10-170611,170611,10,0,0,1812,7.75,2.535431,1
2020-11-11-170611,170611,12,2,0,1824,8.75,3.6764226,2
2020-11-12-170611,170611,9,3,0,1833,6.75,2.9668207,3
2020-11-13-170611,170611,2,0,0,1835,9.75,2.743055,4
2020-03-01-170612,170612,1,0,18,1,0.0,0.023579024,6
2020-03-02-170612,170612,0,0,43,1,0.0,0.043844383,0
2020-03-03-170612,170612,0,0,28,1,0.0,0.15488955,1
2020-03-04-170612,170612,0,0,49,1,0.2,0.15118274,2
2020-03-05-170612,170612,0,0,39,1,0.0,0.015107599,3
2020-03-06-170612,170612,1,0,37,2,0.0,0.01929995,4
2020-03-07-170612,170612,0,1,29,2,0.0,0.008929718,5
2020-03-08-170612,170612,0,0,26,2,0.2,0.07435842,6
2020-03-09-170612,170612,2,0,50,4,0.4,0.1542987,0
2020-03-10-170612,170612,1,0,54,5,0.4,0.450491,1
2020-03-11-170612,170612,0,0,37,5,2.2,0.30447578,2
2020-03-12-170612,170612,2,0,41,7,1.4,0.09422512,3
2020-03-13-170612,170612,3,0,44,10,4.0,0.8709765,4
2020-03-14-170612,170612,4,0,7,14,3.2,0.82140243,5
2020-03-15-170612,170612,18,0,9,32,8.8,1.5987682,6
2020-03-16-170612,170612,43,0,41,75,16.8,3.3532715,0
2020-03-17-170612,170612,28,0,34,103,20.4,3.8189144,1
2020-03-18-170612,170612,49,0,25,152,21.8,3.076368,2
2020-03-19-170612,170612,39,0,19,191,20.4,3.8637872,3
2020-03-20-170612,170612,37,0,21,228,26.2,4.125406,4
2020-03-21-170612,170612,29,0,9,257,9.0,1.2874106,5
2020-03-22-170612,170612,26,0,12,283,11.0,1.3321344,6
2020-03-23-170612,170612,50,0,24,333,38.2,7.92175,0
2020-03-24-170612,170612,54,0,13,387,35.4,5.8178773,1
2020-03-25-170612,170612,37,0,25,424,34.0,6.4581065,2
2020-03-26-170612,170612,41,0,9,465,27.8,5.160142,3
2020-03-27-170612,170612,44,0,15,509,26.0,5.6178474,4
2020-03-28-170612,170612,7,0,6,516,6.8,1.0209848,5
2020-03-29-170612,170612,9,0,4,525,8.4,1.1881033,6
2020-03-30-170612,170612,41,0,17,566,23.0,5.0520067,0
2020-03-31-170612,170612,34,0,15,600,18.4,3.1261559,1
2020-04-01-170612,170612,25,0,7,625,20.0,4.149398,2
2020-04-02-170612,170612,19,0,6,644,10.0,1.8141255,3
2020-04-03-170612,170612,21,0,7,665,15.8,2.6751003,4
2020-04-04-170612,170612,9,0,2,674,5.2,0.56776994,5
2020-04-05-170612,170612,12,0,8,686,6.2,0.6616235,6
2020-04-06-170612,170612,24,0,17,710,24.6,3.4457104,0
2020-04-07-170612,170612,13,0,13,723,18.2,3.1372678,1
2020-04-08-170612,170612,25,0,10,748,13.2,2.33494,2
2020-04-09-170612,170612,9,0,5,757,4.8,0.87699354,3
2020-04-10-170612,170612,15,0,6,772,7.4,0.94252336,4
2020-04-11-170612,170612,6,0,3,778,4.8,0.60824454,5
2020-04-12-170612,170612,4,0,0,782,7.6,0.89668256,6
2020-04-13-170612,170612,17,0,8,799,15.8,2.6986651,0
2020-04-14-170612,170612,15,0,8,814,17.2,3.6602156,1
2020-04-15-170612,170612,7,0,7,821,8.8,2.040249,2
2020-04-16-170612,170612,6,0,6,827,7.6,1.2936047,3
2020-04-17-170612,170612,7,0,2,834,10.0,1.8521593,4
2020-04-18-170612,170612,2,0,7,836,5.2,1.4262878,5
2020-04-19-170612,170612,8,0,1,844,1.0,0.2818565,6
2020-04-20-170612,170612,17,0,8,861,12.0,1.5850421,0
2020-04-21-170612,170612,13,0,9,874,11.2,2.9873319,1
2020-04-22-170612,170612,10,0,4,884,10.2,3.0033805,2
2020-04-23-170612,170612,5,0,16,889,1.8,0.53213364,3
2020-04-24-170612,170612,6,0,18,895,5.2,1.4234344,4
2020-04-25-170612,170612,3,0,1,898,3.2,0.7728891,5
2020-04-26-170612,170612,0,0,0,898,1.8,0.7549019,6
2020-04-27-170612,170612,8,0,9,906,10.4,2.2724175,0
2020-04-28-170612,170612,8,0,17,914,4.6,1.1419241,1
2020-04-29-170612,170612,7,0,13,921,7.6,1.7247541,2
2020-04-30-170612,170612,6,0,9,927,5.2,1.0957472,3
2020-05-01-170612,170612,2,0,6,929,3.8,1.1277008,4
2020-05-02-170612,170612,7,0,1,936,3.0,0.4685265,5
2020-05-03-170612,170612,1,0,1,937,1.4,0.19423708,6
2020-05-04-170612,170612,8,0,8,945,7.0,3.183308,0
2020-05-05-170612,170612,9,0,7,954,6.8,1.3698651,1
2020-05-06-170612,170612,4,0,5,958,4.2,2.4980567,2
2020-05-07-170612,170612,16,0,6,974,4.8,2.6265683,3
2020-05-08-170612,170612,18,0,7,992,8.2,1.7368461,4
2020-05-09-170612,170612,1,0,1,993,1.8,0.34860432,5
2020-05-10-170612,170612,0,0,1,993,0.8,0.059711292,6
2020-05-11-170612,170612,9,5,6,1002,8.2,2.3453805,0
2020-05-12-170612,170612,17,0,4,1019,21.8,2.6161346,1
2020-05-13-170612,170612,13,0,5,1032,7.0,1.7502811,2
2020-05-14-170612,170612,9,0,2,1041,4.0,0.8137943,3
2020-05-15-170612,170612,6,0,2,1047,8.6,1.4596789,4
2020-05-16-170612,170612,1,0,0,1048,0.8,0.057252932,5
2020-05-17-170612,170612,1,0,0,1049,0.0,0.020655889,6
2020-05-18-170612,170612,8,0,10,1057,3.2,1.2859999,0
2020-05-19-170612,170612,7,0,4,1064,3.6,1.0676429,1
2020-05-20-170612,170612,5,0,8,1069,3.6,0.8128279,2
2020-05-21-170612,170612,6,0,7,1075,3.0,0.55090135,3
2020-05-22-170612,170612,7,0,1,1082,5.0,0.7571565,4
2020-05-23-170612,170612,1,0,0,1083,0.2,0.11197527,5
2020-05-24-170612,170612,1,0,0,1084,0.0,0.052425653,6
2020-05-25-170612,170612,6,0,2,1090,3.8,1.0582161,0
2020-05-26-170612,170612,4,0,2,1094,3.0,0.60583144,1
2020-05-27-170612,170612,5,0,3,1099,3.4,0.7587275,2
2020-05-28-170612,170612,2,2,1,1101,2.0,0.9668087,3
2020-05-29-170612,170612,2,0,0,1103,2.8,0.98754203,4
2020-05-30-170612,170612,0,0,0,1103,0.8,0.07416702,5
2020-05-31-170612,170612,0,0,0,1103,0.2,0.029819312,6
2020-06-01-170612,170612,10,0,5,1113,4.2,1.430012,0
2020-06-02-170612,170612,4,0,2,1117,2.2,0.50344217,1
2020-06-03-170612,170612,8,0,2,1125,3.0,0.3315641,2
2020-06-04-170612,170612,7,0,6,1132,4.0,0.9180041,3
2020-06-05-170612,170612,1,0,3,1133,2.2,1.8760107,4
2020-06-06-170612,170612,0,0,0,1133,0.2,0.096916966,5
2020-06-07-170612,170612,0,0,0,1133,0.2,0.11121827,6
2020-06-08-170612,170612,2,0,3,1135,2.2,0.46090466,0
2020-06-09-170612,170612,2,0,0,1137,3.6,0.43851438,1
2020-06-10-170612,170612,3,0,1,1140,1.4,0.31455472,2
2020-06-11-170612,170612,1,0,0,1141,2.8,0.5382265,3
2020-06-12-170612,170612,0,0,3,1141,1.0,0.2555508,4
2020-06-13-170612,170612,0,0,0,1141,0.2,0.014187155,5
2020-06-14-170612,170612,0,0,0,1141,0.0,0.016942251,6
2020-06-15-170612,170612,5,0,2,1146,1.6,0.19064805,0
2020-06-16-170612,170612,2,0,0,1148,1.6,0.6936255,1
2020-06-17-170612,170612,2,0,0,1150,1.4,0.48830292,2
2020-06-18-170612,170612,6,0,1,1156,1.2,0.5502121,3
2020-06-19-170612,170612,3,0,1,1159,3.4,0.9905319,4
2020-06-20-170612,170612,0,0,0,1159,0.0,0.0016809073,5
2020-06-21-170612,170612,0,0,0,1159,0.2,0.03511781,6
2020-06-22-170612,170612,3,0,2,1162,3.2,0.5655172,0
2020-06-23-170612,170612,0,0,1,1162,1.4,0.7728973,1
2020-06-24-170612,170612,1,1,0,1163,1.2,0.23075035,2
2020-06-25-170612,170612,0,0,0,1163,1.4,0.3167565,3
2020-06-26-170612,170612,3,0,2,1166,2.0,0.5571597,4
2020-06-27-170612,170612,0,0,0,1166,0.2,0.09241151,5
2020-06-28-170612,170612,0,0,0,1166,0.0,0.06573934,6
2020-06-29-170612,170612,2,0,0,1168,1.2,0.36220393,0
2020-06-30-170612,170612,0,0,0,1168,0.8,0.39268893,1
2020-07-01-170612,170612,0,0,4,1168,1.0,0.22938278,2
2020-07-02-170612,170612,1,0,2,1169,0.8,0.11203244,3
2020-07-03-170612,170612,1,0,0,1170,1.6,0.3893112,4
2020-07-04-170612,170612,0,0,0,1170,0.0,0.018268745,5
2020-07-05-170612,170612,0,0,0,1170,0.0,0.055679735,6
2020-07-06-170612,170612,2,0,1,1172,0.2,0.14894976,0
2020-07-07-170612,170612,1,0,0,1173,1.2,0.17527868,1
2020-07-08-170612,170612,0,0,1,1173,0.2,0.0249037,2
2020-07-09-170612,170612,0,0,0,1173,1.4,0.24408372,3
2020-07-10-170612,170612,2,0,1,1175,1.0,0.14687397,4
2020-07-11-170612,170612,0,0,0,1175,0.0,0.011999644,5
2020-07-12-170612,170612,0,0,0,1175,0.0,0.113274455,6
2020-07-13-170612,170612,0,0,1,1175,0.4,0.21587051,0
2020-07-14-170612,170612,0,0,1,1175,0.8,0.30154967,1
2020-07-15-170612,170612,4,0,0,1179,0.4,0.047942344,2
2020-07-16-170612,170612,2,0,1,1181,0.6,0.1545863,3
2020-07-17-170612,170612,0,1,3,1181,0.8,0.10285545,4
2020-07-18-170612,170612,0,0,0,1181,0.0,0.051423028,5
2020-07-19-170612,170612,0,0,2,1181,0.0,0.0040949346,6
2020-07-20-170612,170612,1,0,2,1182,1.6,0.18268235,0
2020-07-21-170612,170612,0,0,3,1182,0.8,0.093608044,1
2020-07-22-170612,170612,1,0,9,1183,2.0,0.4456499,2
2020-07-23-170612,170612,0,0,3,1183,0.6,0.042156607,3
2020-07-24-170612,170612,1,0,10,1184,1.6,0.059304006,4
2020-07-25-170612,170612,0,0,1,1184,0.4,0.039748587,5
2020-07-26-170612,170612,0,0,3,1184,0.2,0.044055976,6
2020-07-27-170612,170612,1,0,1,1185,1.8,0.21561961,0
2020-07-28-170612,170612,1,0,6,1186,1.8,0.2800732,1
2020-07-29-170612,170612,0,0,5,1186,1.0,0.17566669,2
2020-07-30-170612,170612,1,0,22,1187,1.4,0.5675726,3
2020-07-31-170612,170612,3,0,3,1190,2.6,0.5874281,4
2020-08-01-170612,170612,0,0,5,1190,1.4,0.5650061,5
2020-08-02-170612,170612,2,0,2,1192,1.8,0.57891166,6
2020-08-03-170612,170612,2,0,7,1194,3.4,1.0246091,0
2020-08-04-170612,170612,3,0,9,1197,1.2,0.9103241,1
2020-08-05-170612,170612,9,0,5,1206,5.6,1.5122906,2
2020-08-06-170612,170612,3,0,4,1209,3.6,0.9682139,3
2020-08-07-170612,170612,10,0,19,1219,4.0,1.5192266,4
2020-08-08-170612,170612,1,0,0,1220,1.6,0.70915186,5
2020-08-09-170612,170612,3,0,5,1223,1.0,0.1536983,6
2020-08-10-170612,170612,1,0,15,1224,3.6,0.93494797,0
2020-08-11-170612,170612,6,0,16,1230,2.6,1.0672309,1
2020-08-12-170612,170612,5,0,14,1235,2.8,1.8239442,2
2020-08-13-170612,170612,22,0,10,1257,4.4,1.7320299,3
2020-08-14-170612,170612,3,0,24,1260,4.2,1.2284464,4
2020-08-15-170612,170612,5,0,4,1265,2.6,0.3566168,5
2020-08-16-170612,170612,2,0,0,1267,2.2,0.6588316,6
2020-08-17-170612,170612,7,0,26,1274,7.2,1.2466123,0
2020-08-18-170612,170612,9,0,14,1283,3.0,1.8937914,1
2020-08-19-170612,170612,5,0,13,1288,7.2,1.2759708,2
2020-08-20-170612,170612,4,0,11,1292,8.0,2.4354258,3
2020-08-21-170612,170612,19,0,25,1311,3.4,1.6169477,4
2020-08-22-170612,170612,0,0,8,1311,1.8,0.43212247,5
2020-08-23-170612,170612,5,0,6,1316,3.4,0.9139701,6
2020-08-24-170612,170612,15,0,29,1331,7.6,2.874741,0
2020-08-25-170612,170612,16,0,1,1347,8.4,1.885295,1
2020-08-26-170612,170612,14,0,8,1361,9.6,2.4705667,2
2020-08-27-170612,170612,10,0,19,1371,5.8,2.0746071,3
2020-08-28-170612,170612,24,0,37,1395,10.0,2.1537538,4
2020-08-29-170612,170612,4,0,7,1399,2.8,1.058871,5
2020-08-30-170612,170612,0,0,8,1399,2.6,0.4876356,6
2020-08-31-170612,170612,26,0,36,1425,6.8,3.3955474,0
2020-09-01-170612,170612,14,0,14,1439,5.6,3.2252486,1
2020-09-02-170612,170612,13,0,9,1452,4.4,2.4595304,2
2020-09-03-170612,170612,11,0,14,1463,7.4,3.568711,3
2020-09-04-170612,170612,25,0,12,1488,12.2,3.6186042,4
2020-09-05-170612,170612,8,0,0,1496,4.0,1.9408816,5
2020-09-06-170612,170612,6,0,4,1502,3.4,1.3236834,6
2020-09-07-170612,170612,29,0,25,1531,7.0,4.0478086,0
2020-09-08-170612,170612,1,0,12,1532,4.2,1.4652402,1
2020-09-09-170612,170612,8,0,7,1540,4.6,2.1970952,2
2020-09-10-170612,170612,19,0,13,1559,4.2,2.1761482,3
2020-09-11-170612,170612,37,0,11,1596,10.6,4.3732595,4
2020-09-12-170612,170612,7,0,4,1603,3.8,1.2686604,5
2020-09-13-170612,170612,8,0,2,1611,4.0,0.71525556,6
2020-09-14-170612,170612,36,1,13,1647,10.0,4.642547,0
2020-09-15-170612,170612,14,0,16,1661,5.8,2.4443603,1
2020-09-16-170612,170612,9,0,16,1670,5.0,2.5987365,2
2020-09-17-170612,170612,14,0,4,1684,5.2,2.089142,3
2020-09-18-170612,170612,12,0,12,1696,8.0,4.5961027,4
2020-09-19-170612,170612,0,1,2,1696,3.4,1.523366,5
2020-09-20-170612,170612,4,0,2,1700,4.0,1.5407565,6
2020-09-21-170612,170612,25,0,18,1725,9.8,4.325233,0
2020-09-22-170612,170612,12,1,18,1737,11.8,3.542482,1
2020-09-23-170612,170612,7,1,10,1744,7.8,3.8793077,2
2020-09-24-170612,170612,13,0,9,1757,8.8,3.3878431,3
2020-09-25-170612,170612,11,0,20,1768,9.2,3.3374312,4
2020-09-26-170612,170612,4,0,8,1772,2.4,1.8939284,5
2020-09-27-170612,170612,2,0,9,1774,1.8,1.0104674,6
2020-09-28-170612,170612,13,0,6,1787,8.0,3.1488492,0
2020-09-29-170612,170612,16,0,19,1803,4.8,2.5359933,1
2020-09-30-170612,170612,16,0,13,1819,5.4,2.6263509,2
2020-10-01-170612,170612,4,0,11,1823,4.6,1.9347277,3
2020-10-02-170612,170612,12,0,27,1835,5.2,2.6573148,4
2020-10-03-170612,170612,2,1,5,1837,1.4,1.2258904,5
2020-10-04-170612,170612,2,0,1,1839,3.4,0.99375683,6
2020-10-05-170612,170612,18,0,13,1857,17.0,8.6620035,0
2020-10-06-170612,170612,18,1,10,1875,8.4,3.5953739,1
2020-10-07-170612,170612,10,1,16,1885,9.6,5.216831,2
2020-10-08-170612,170612,9,1,17,1894,9.0,3.8723462,3
2020-10-09-170612,170612,20,4,33,1914,9.6,3.1667645,4
2020-10-10-170612,170612,8,0,2,1922,3.6,1.1324592,5
2020-10-11-170612,170612,9,0,21,1931,5.0,1.8888612,6
2020-10-12-170612,170612,6,0,18,1937,4.2,1.4099586,0
2020-10-13-170612,170612,19,0,21,1956,9.0,3.7760446,1
2020-10-14-170612,170612,13,0,24,1969,9.4,3.6344292,2
2020-10-15-170612,170612,11,0,18,1980,13.2,5.985631,3
2020-10-16-170612,170612,27,0,22,2007,12.4,6.836702,4
2020-10-17-170612,170612,5,0,3,2012,3.8,1.0593084,5
2020-10-18-170612,170612,1,1,6,2013,6.6,1.1071858,6
2020-10-19-170612,170612,13,0,4,2026,20.2,4.808103,0
2020-10-20-170612,170612,10,0,20,2036,16.8,4.262026,1
2020-10-21-170612,170612,16,1,23,2052,16.0,6.2213793,2
2020-10-22-170612,170612,17,0,21,2069,15.0,6.5626383,3
2020-10-23-170612,170612,33,0,23,2102,18.2,5.9755044,4
2020-10-24-170612,170612,2,1,3,2104,3.4,1.4784031,5
2020-10-25-170612,170612,21,1,7,2125,5.8,1.5696534,6
2020-10-26-170612,170612,18,1,20,2143,17.4,4.9948606,0
2020-10-27-170612,170612,21,0,15,2164,15.0,5.415614,1
2020-10-28-170612,170612,24,2,13,2188,12.8,5.656641,2
2020-10-29-170612,170612,18,1,13,2206,11.8,5.0600014,3
2020-10-30-170612,170612,22,2,24,2228,20.0,5.178043,4
2020-10-31-170612,170612,3,2,0,2231,2.8,1.0271649,5
2020-11-01-170612,170612,6,2,0,2237,6.4,1.467413,6
2020-11-02-170612,170612,4,0,0,2241,5.0,1.2144734,0
2020-11-03-170612,170612,20,1,0,2261,19.2,5.6504087,1
2020-11-04-170612,170612,23,2,0,2284,13.0,4.4696856,2
2020-11-05-170612,170612,21,1,0,2305,9.0,4.6723905,3
2020-11-06-170612,170612,23,2,0,2328,10.6,3.7654757,4
2020-11-07-170612,170612,3,0,0,2331,4.4,0.9962584,5
2020-11-08-170612,170612,7,0,0,2338,4.8,1.1236202,6
2020-11-09-170612,170612,20,1,0,2358,14.2,4.898227,0
2020-11-10-170612,170612,15,2,0,2373,8.8,2.5079608,1
2020-11-11-170612,170612,13,1,0,2386,9.6,3.4495704,2
2020-11-12-170612,170612,13,3,0,2399,6.6,2.9582028,3
2020-11-13-170612,170612,24,3,0,2423,5.8,2.6893916,4
2020-03-01-170613,170613,0,0,2,0,0.0,0.009866881,6
2020-03-02-170613,170613,0,0,2,0,0.2,0.94546324,0
2020-03-03-170613,170613,0,0,6,0,0.2,0.05548444,1
2020-03-04-170613,170613,0,0,7,0,0.0,0.03118454,2
2020-03-05-170613,170613,0,1,10,0,0.0,0.1454976,3
2020-03-06-170613,170613,0,0,3,0,0.0,0.1503853,4
2020-03-07-170613,170613,0,0,1,0,0.0,0.0016328734,5
2020-03-08-170613,170613,0,0,0,0,0.0,0.0021540995,6
2020-03-09-170613,170613,0,0,7,0,0.0,0.033200648,0
2020-03-10-170613,170613,0,0,3,0,0.0,0.08525407,1
2020-03-11-170613,170613,0,0,8,0,0.0,0.1565455,2
2020-03-12-170613,170613,1,0,10,1,0.2,0.89354414,3
2020-03-13-170613,170613,1,0,6,2,0.8,1.1865442,4
2020-03-14-170613,170613,0,0,0,2,0.4,0.5917081,5
2020-03-15-170613,170613,2,0,4,4,0.8,0.5745934,6
2020-03-16-170613,170613,2,0,8,6,1.8,2.6503289,0
2020-03-17-170613,170613,6,0,9,12,2.0,4.9068775,1
2020-03-18-170613,170613,7,0,5,19,3.0,6.1932306,2
2020-03-19-170613,170613,10,0,4,29,4.6,7.7746954,3
2020-03-20-170613,170613,3,0,3,32,6.4,5.565378,4
2020-03-21-170613,170613,1,0,0,33,3.2,1.2871168,5
2020-03-22-170613,170613,0,0,2,33,5.2,1.4071448,6
2020-03-23-170613,170613,7,0,0,40,11.6,9.188299,0
2020-03-24-170613,170613,3,0,2,43,6.8,5.967982,1
2020-03-25-170613,170613,8,0,2,51,8.2,9.984493,2
2020-03-26-170613,170613,10,0,1,61,7.8,10.0434675,3
2020-03-27-170613,170613,6,0,0,67,13.4,9.243864,4
2020-03-28-170613,170613,0,0,1,67,2.0,0.4852623,5
2020-03-29-170613,170613,4,0,0,71,3.6,2.1494248,6
2020-03-30-170613,170613,8,0,1,79,9.4,8.411686,0
2020-03-31-170613,170613,9,0,3,88,7.2,7.9078865,1
2020-04-01-170613,170613,5,0,3,93,7.2,6.3689528,2
2020-04-02-170613,170613,4,0,2,97,5.0,4.4905367,3
2020-04-03-170613,170613,3,0,3,100,5.0,4.168789,4
2020-04-04-170613,170613,0,0,1,100,2.6,0.66911685,5
2020-04-05-170613,170613,2,1,1,102,1.6,1.0076956,6
2020-04-06-170613,170613,0,0,2,102,9.0,3.7370365,0
2020-04-07-170613,170613,2,0,3,104,6.6,3.3982148,1
2020-04-08-170613,170613,2,0,1,106,4.6,3.3438632,2
2020-04-09-170613,170613,1,1,0,107,7.4,1.3681062,3
2020-04-10-170613,170613,0,1,0,107,2.2,0.6118755,4
2020-04-11-170613,170613,1,0,0,108,1.4,0.7425541,5
2020-04-12-170613,170613,0,0,1,108,1.4,0.2590401,6
2020-04-13-170613,170613,1,0,3,109,5.2,3.2702558,0
2020-04-14-170613,170613,3,0,1,112,5.0,4.2430058,1
2020-04-15-170613,170613,3,0,0,115,8.2,5.2278376,2
2020-04-16-170613,170613,2,0,0,117,3.6,2.6762424,3
2020-04-17-170613,170613,3,0,0,120,5.0,3.5037484,4
2020-04-18-170613,170613,1,0,1,121,2.2,1.1292667,5
2020-04-19-170613,170613,1,0,0,122,1.0,0.66684693,6
2020-04-20-170613,170613,2,1,3,124,3.2,2.35728,0
2020-04-21-170613,170613,3,0,2,127,3.4,4.227327,1
2020-04-22-170613,170613,1,0,2,128,3.4,2.6209931,2
2020-04-23-170613,170613,0,0,2,128,1.8,0.66686976,3
2020-04-24-170613,170613,0,0,6,128,2.4,1.111076,4
2020-04-25-170613,170613,0,0,0,128,1.0,0.41017655,5
2020-04-26-170613,170613,1,0,0,129,0.0,0.42730117,6
2020-04-27-170613,170613,3,0,2,132,3.4,3.2038128,0
2020-04-28-170613,170613,1,0,0,133,3.4,2.440293,1
2020-04-29-170613,170613,0,0,1,133,4.6,2.157975,2
2020-04-30-170613,170613,0,0,3,133,2.6,1.553472,3
2020-05-01-170613,170613,0,0,0,133,1.2,0.3936616,4
2020-05-02-170613,170613,1,0,0,134,1.4,1.1912615,5
2020-05-03-170613,170613,0,0,0,134,0.4,0.19618557,6
2020-05-04-170613,170613,3,0,2,137,7.4,6.169399,0
2020-05-05-170613,170613,2,0,3,139,2.6,2.7968411,1
2020-05-06-170613,170613,2,0,1,141,29.4,14.008048,2
2020-05-07-170613,170613,2,0,3,143,8.8,5.767328,3
2020-05-08-170613,170613,6,0,2,149,3.2,4.88489,4
2020-05-09-170613,170613,0,0,1,149,0.2,0.13489407,5
2020-05-10-170613,170613,0,0,0,149,0.4,0.09074015,6
2020-05-11-170613,170613,2,1,0,151,3.0,2.8339705,0
2020-05-12-170613,170613,0,12,1,151,2.6,1.2038918,1
2020-05-13-170613,170613,1,1,1,152,3.0,1.9638702,2
2020-05-14-170613,170613,3,0,0,155,2.4,2.7950964,3
2020-05-15-170613,170613,0,0,1,155,0.6,0.49780896,4
2020-05-16-170613,170613,0,0,0,155,0.0,0.0047118315,5
2020-05-17-170613,170613,0,0,0,155,0.2,0.0766218,6
2020-05-18-170613,170613,2,0,4,157,1.0,1.2649274,0
2020-05-19-170613,170613,3,0,0,160,1.0,2.3363802,1
2020-05-20-170613,170613,1,0,0,161,1.4,0.56057316,2
2020-05-21-170613,170613,3,0,1,164,2.0,2.251879,3
2020-05-22-170613,170613,2,0,1,166,1.8,1.9941024,4
2020-05-23-170613,170613,1,0,0,167,0.4,0.49145514,5
2020-05-24-170613,170613,0,0,0,167,0.4,0.63644654,6
2020-05-25-170613,170613,0,0,0,167,0.6,0.4095851,0
2020-05-26-170613,170613,1,0,1,168,0.8,0.9418721,1
2020-05-27-170613,170613,1,0,1,169,0.8,1.8653238,2
2020-05-28-170613,170613,0,0,0,169,1.4,0.96214205,3
2020-05-29-170613,170613,1,0,1,170,1.4,1.576346,4
2020-05-30-170613,170613,0,0,1,170,0.2,0.06648179,5
2020-05-31-170613,170613,0,0,1,170,0.0,0.0014027597,6
2020-06-01-170613,170613,4,0,0,174,1.2,2.6503043,0
2020-06-02-170613,170613,0,0,1,174,1.6,1.0448338,1
2020-06-03-170613,170613,0,0,1,174,1.4,0.8309678,2
2020-06-04-170613,170613,1,0,2,175,0.8,1.2434185,3
2020-06-05-170613,170613,1,0,1,176,1.0,2.2457922,4
2020-06-06-170613,170613,0,0,0,176,0.6,0.2693597,5
2020-06-07-170613,170613,0,0,0,176,0.0,0.055755902,6
2020-06-08-170613,170613,0,0,0,176,0.6,0.26699042,0
2020-06-09-170613,170613,1,0,0,177,0.8,1.1178948,1
2020-06-10-170613,170613,1,0,0,178,0.0,0.8536725,2
2020-06-11-170613,170613,0,0,0,178,0.6,0.58126235,3
2020-06-12-170613,170613,1,0,0,179,0.0,0.63123214,4
2020-06-13-170613,170613,1,1,0,180,0.0,0.48078126,5
2020-06-14-170613,170613,1,0,0,181,0.0,0.4416617,6
2020-06-15-170613,170613,0,0,0,181,0.0,0.15693867,0
2020-06-16-170613,170613,1,0,0,182,0.4,1.134648,1
2020-06-17-170613,170613,1,0,0,183,0.8,1.0294679,2
2020-06-18-170613,170613,2,0,0,185,0.2,1.5074358,3
2020-06-19-170613,170613,1,0,0,186,0.2,0.95609576,4
2020-06-20-170613,170613,0,0,0,186,0.0,0.0010162754,5
2020-06-21-170613,170613,0,0,0,186,0.0,0.0027177285,6
2020-06-22-170613,170613,0,0,0,186,1.0,0.8924751,0
2020-06-23-170613,170613,0,0,0,186,0.2,0.5023842,1
2020-06-24-170613,170613,0,0,0,186,0.6,0.38386393,2
2020-06-25-170613,170613,0,1,0,186,0.0,0.081094354,3
2020-06-26-170613,170613,0,0,0,186,0.2,0.087265685,4
2020-06-27-170613,170613,0,0,1,186,0.4,0.15874887,5
2020-06-28-170613,170613,0,0,0,186,0.0,0.015918277,6
2020-06-29-170613,170613,0,0,2,186,0.8,0.42509374,0
2020-06-30-170613,170613,0,0,1,186,0.2,0.26079795,1
2020-07-01-170613,170613,0,0,0,186,0.2,0.037755184,2
2020-07-02-170613,170613,0,0,0,186,0.6,0.31400886,3
2020-07-03-170613,170613,0,0,0,186,0.2,0.16368663,4
2020-07-04-170613,170613,0,0,0,186,0.2,0.0025617324,5
2020-07-05-170613,170613,0,0,0,186,0.0,0.009571758,6
2020-07-06-170613,170613,0,0,0,186,0.4,0.29568544,0
2020-07-07-170613,170613,0,0,0,186,0.0,0.03812909,1
2020-07-08-170613,170613,0,0,1,186,0.2,0.057175558,2
2020-07-09-170613,170613,0,0,0,186,0.0,0.055636752,3
2020-07-10-170613,170613,0,0,0,186,0.0,0.035047006,4
2020-07-11-170613,170613,1,0,0,187,0.0,0.50572354,5
2020-07-12-170613,170613,0,1,0,187,0.6,0.39780182,6
2020-07-13-170613,170613,2,0,0,189,0.2,1.187894,0
2020-07-14-170613,170613,1,0,0,190,0.4,1.0368963,1
2020-07-15-170613,170613,0,0,2,190,0.2,0.034223072,2
2020-07-16-170613,170613,0,0,0,190,0.2,0.16198456,3
2020-07-17-170613,170613,0,0,0,190,0.8,0.26493645,4
2020-07-18-170613,170613,0,0,0,190,0.2,0.1454274,5
2020-07-19-170613,170613,0,0,0,190,0.0,4.302175e-05,6
2020-07-20-170613,170613,0,0,0,190,0.0,0.061942548,0
2020-07-21-170613,170613,0,0,0,190,0.4,0.37744886,1
2020-07-22-170613,170613,1,0,0,191,0.8,0.5626817,2
2020-07-23-170613,170613,0,0,5,191,0.6,0.48998293,3
2020-07-24-170613,170613,0,0,0,191,0.4,0.11610085,4
2020-07-25-170613,170613,0,0,1,191,0.0,0.00961264,5
2020-07-26-170613,170613,0,0,0,191,0.2,0.09662503,6
2020-07-27-170613,170613,0,0,0,191,0.2,0.07421297,0
2020-07-28-170613,170613,0,0,2,191,2.4,0.9082754,1
2020-07-29-170613,170613,2,0,4,193,1.2,1.7482911,2
2020-07-30-170613,170613,0,0,1,193,0.8,0.2982367,3
2020-07-31-170613,170613,0,0,1,193,0.4,0.27188492,4
2020-08-01-170613,170613,0,0,3,193,0.4,0.68521523,5
2020-08-02-170613,170613,0,0,2,193,1.0,0.68914753,6
2020-08-03-170613,170613,0,0,4,193,0.6,0.38293517,0
2020-08-04-170613,170613,0,0,2,193,0.8,0.88354856,1
2020-08-05-170613,170613,0,0,5,193,0.6,0.90907615,2
2020-08-06-170613,170613,5,0,8,198,3.8,5.3829036,3
2020-08-07-170613,170613,0,0,7,198,2.0,1.7107147,4
2020-08-08-170613,170613,1,0,1,199,0.8,1.4981955,5
2020-08-09-170613,170613,0,0,0,199,0.8,0.45490557,6
2020-08-10-170613,170613,0,0,4,199,2.6,1.6672142,0
2020-08-11-170613,170613,2,0,6,201,2.0,3.739029,1
2020-08-12-170613,170613,4,0,2,205,1.0,4.211022,2
2020-08-13-170613,170613,1,0,3,206,3.8,4.7839913,3
2020-08-14-170613,170613,1,0,3,207,2.2,2.517367,4
2020-08-15-170613,170613,3,0,4,210,1.2,1.9402523,5
2020-08-16-170613,170613,2,0,1,212,0.6,1.4370368,6
2020-08-17-170613,170613,4,0,0,216,2.2,3.3781536,0
2020-08-18-170613,170613,2,0,2,218,1.4,2.4688432,1
2020-08-19-170613,170613,5,0,5,223,2.2,5.444524,2
2020-08-20-170613,170613,8,0,8,231,3.4,7.277546,3
2020-08-21-170613,170613,7,0,4,238,5.4,7.432135,4
2020-08-22-170613,170613,1,0,0,239,0.4,0.5913082,5
2020-08-23-170613,170613,0,1,4,239,0.8,0.57706827,6
2020-08-24-170613,170613,4,0,6,243,1.6,4.0168524,0
2020-08-25-170613,170613,6,0,3,249,3.0,5.460459,1
2020-08-26-170613,170613,2,0,3,251,1.6,2.899117,2
2020-08-27-170613,170613,3,0,4,254,2.2,4.2977657,3
2020-08-28-170613,170613,3,0,4,257,2.0,2.934364,4
2020-08-29-170613,170613,4,0,4,261,1.4,2.74701,5
2020-08-30-170613,170613,1,0,2,262,1.0,1.0249901,6
2020-08-31-170613,170613,0,0,11,262,3.4,2.6438274,0
2020-09-01-170613,170613,2,0,4,264,2.0,3.9358764,1
2020-09-02-170613,170613,5,0,3,269,1.2,4.789112,2
2020-09-03-170613,170613,8,0,9,277,1.6,5.7384567,3
2020-09-04-170613,170613,4,0,14,281,4.6,4.7106256,4
2020-09-05-170613,170613,0,0,8,281,1.2,1.1417117,5
2020-09-06-170613,170613,4,0,3,285,2.4,3.4657962,6
2020-09-07-170613,170613,6,1,12,291,0.8,5.65377,0
2020-09-08-170613,170613,3,0,21,294,1.2,2.4963727,1
2020-09-09-170613,170613,3,0,20,297,2.8,2.9126146,2
2020-09-10-170613,170613,4,0,28,301,2.4,4.915485,3
2020-09-11-170613,170613,4,0,25,305,1.2,3.6426666,4
2020-09-12-170613,170613,4,0,4,309,2.8,3.8578942,5
2020-09-13-170613,170613,2,0,1,311,0.2,1.5031753,6
2020-09-14-170613,170613,11,0,20,322,4.4,8.194017,0
2020-09-15-170613,170613,4,0,17,326,2.0,3.514724,1
2020-09-16-170613,170613,3,0,19,329,2.8,3.523468,2
2020-09-17-170613,170613,9,0,13,338,2.6,8.634049,3
2020-09-18-170613,170613,14,0,19,352,4.2,12.408238,4
2020-09-19-170613,170613,8,0,3,360,2.6,5.4971066,5
2020-09-20-170613,170613,3,0,16,363,1.6,2.3374271,6
2020-09-21-170613,170613,12,0,18,375,1.8,8.373679,0
2020-09-22-170613,170613,21,0,15,396,4.2,13.440788,1
2020-09-23-170613,170613,20,0,3,416,2.4,11.2272625,2
2020-09-24-170613,170613,28,1,6,444,5.4,18.728868,3
2020-09-25-170613,170613,25,1,14,469,2.8,15.559603,4
2020-09-26-170613,170613,4,0,8,473,1.8,3.1973093,5
2020-09-27-170613,170613,1,0,8,474,0.8,1.880991,6
2020-09-28-170613,170613,20,0,6,494,4.0,12.354664,0
2020-09-29-170613,170613,17,0,12,511,0.8,10.688519,1
2020-09-30-170613,170613,19,0,9,530,3.0,10.009434,2
2020-10-01-170613,170613,13,0,11,543,3.2,10.4060135,3
2020-10-02-170613,170613,19,0,31,562,2.8,10.569684,4
2020-10-03-170613,170613,3,0,4,565,0.6,1.5722606,5
2020-10-04-170613,170613,16,0,5,581,0.8,4.6507664,6
2020-10-05-170613,170613,18,1,14,599,3.2,10.900301,0
2020-10-06-170613,170613,15,0,18,614,1.0,11.471467,1
2020-10-07-170613,170613,3,1,9,617,4.4,5.458329,2
2020-10-08-170613,170613,6,1,27,623,4.8,5.3334217,3
2020-10-09-170613,170613,14,0,20,637,5.6,8.155164,4
2020-10-10-170613,170613,8,0,10,645,2.6,4.780665,5
2020-10-11-170613,170613,8,0,7,653,3.2,5.3466153,6
2020-10-12-170613,170613,6,0,10,659,2.0,3.014318,0
2020-10-13-170613,170613,12,0,12,671,3.2,8.583772,1
2020-10-14-170613,170613,9,0,23,680,2.0,7.922926,2
2020-10-15-170613,170613,11,0,14,691,2.6,7.2738643,3
2020-10-16-170613,170613,31,0,15,722,2.4,12.562327,4
2020-10-17-170613,170613,4,0,4,726,1.2,2.731787,5
2020-10-18-170613,170613,5,0,4,731,1.8,2.4788535,6
2020-10-19-170613,170613,14,0,7,745,5.0,12.162846,0
2020-10-20-170613,170613,18,0,12,763,2.0,13.937255,1
2020-10-21-170613,170613,9,0,18,772,4.4,11.38631,2
2020-10-22-170613,170613,27,0,8,799,2.2,17.1903,3
2020-10-23-170613,170613,20,0,11,819,3.4,11.470935,4
2020-10-24-170613,170613,10,0,6,829,1.4,5.1514535,5
2020-10-25-170613,170613,7,0,2,836,2.0,4.00501,6
2020-10-26-170613,170613,10,1,4,846,1.2,6.581938,0
2020-10-27-170613,170613,12,0,11,858,5.8,9.805911,1
2020-10-28-170613,170613,23,2,9,881,2.6,15.602501,2
2020-10-29-170613,170613,14,0,13,895,1.8,17.344398,3
2020-10-30-170613,170613,15,0,8,910,6.0,9.995545,4
2020-10-31-170613,170613,4,1,0,914,1.2,2.490512,5
2020-11-01-170613,170613,4,0,0,918,2.0,2.9894633,6
2020-11-02-170613,170613,7,0,0,925,3.8,3.6647928,0
2020-11-03-170613,170613,12,0,0,937,3.2,10.214089,1
2020-11-04-170613,170613,18,0,0,955,3.8,12.432786,2
2020-11-05-170613,170613,8,0,0,963,3.0,7.144767,3
2020-11-06-170613,170613,11,0,0,974,5.4,9.459229,4
2020-11-07-170613,170613,6,2,0,980,1.0,3.0982246,5
2020-11-08-170613,170613,2,0,0,982,2.6,2.0252495,6
2020-11-09-170613,170613,4,0,0,986,3.4,5.740155,0
2020-11-10-170613,170613,11,0,0,997,2.0,7.20929,1
2020-11-11-170613,170613,9,0,0,1006,6.2,8.593384,2
2020-11-12-170613,170613,13,0,0,1019,4.2,10.146616,3
2020-11-13-170613,170613,8,0,0,1027,7.4,7.0196233,4
2020-03-01-170614,170614,0,0,6,0,0.16666666666666666,0.005410941,6
2020-03-02-170614,170614,0,0,24,0,0.0,0.012147821,0
2020-03-03-170614,170614,0,1,23,0,0.3333333333333333,0.044743918,1
2020-03-04-170614,170614,0,0,34,0,0.16666666666666666,0.04451681,2
2020-03-05-170614,170614,0,0,24,0,0.0,0.004235471,3
2020-03-06-170614,170614,0,0,34,0,0.16666666666666666,0.005068368,4
2020-03-07-170614,170614,0,0,7,0,0.0,0.0020200715,5
2020-03-08-170614,170614,0,0,9,0,0.0,0.017937891,6
2020-03-09-170614,170614,0,0,44,0,1.1666666666666667,0.044728477,0
2020-03-10-170614,170614,0,0,34,0,0.6666666666666666,0.13952541,1
2020-03-11-170614,170614,1,0,40,1,1.0,0.07518392,2
2020-03-12-170614,170614,5,0,24,6,1.0,0.024023319,3
2020-03-13-170614,170614,5,0,25,11,2.833333333333333,0.23985517,4
2020-03-14-170614,170614,3,0,6,14,3.333333333333333,0.25222078,5
2020-03-15-170614,170614,6,0,6,20,7.333333333333332,0.4764481,6
2020-03-16-170614,170614,24,0,27,44,16.166666666666668,0.96894383,0
2020-03-17-170614,170614,23,0,17,67,15.833333333333336,1.070849,1
2020-03-18-170614,170614,34,0,12,101,23.33333333333333,0.8895494,2
2020-03-19-170614,170614,24,0,8,125,17.333333333333332,1.1171296,3
2020-03-20-170614,170614,34,0,8,159,18.83333333333333,1.1886984,4
2020-03-21-170614,170614,7,0,8,166,11.666666666666664,0.40281737,5
2020-03-22-170614,170614,9,0,3,175,11.5,0.39430258,6
2020-03-23-170614,170614,44,0,44,219,28.5,2.3146753,0
2020-03-24-170614,170614,34,0,9,253,26.5,1.7227324,1
2020-03-25-170614,170614,40,0,9,293,24.83333333333333,1.8993838,2
2020-03-26-170614,170614,24,0,2,317,24.0,1.5086535,3
2020-03-27-170614,170614,25,0,6,342,20.33333333333333,1.6373938,4
2020-03-28-170614,170614,6,0,6,348,6.666666666666668,0.30501422,5
2020-03-29-170614,170614,6,0,6,354,6.0,0.35821712,6
2020-03-30-170614,170614,27,1,15,381,20.5,1.4913974,0
2020-03-31-170614,170614,17,0,13,398,16.833333333333332,0.90721476,1
2020-04-01-170614,170614,12,0,8,410,14.166666666666664,1.1847792,2
2020-04-02-170614,170614,8,0,3,418,9.666666666666666,0.5138108,3
2020-04-03-170614,170614,8,0,13,426,11.666666666666664,0.7782814,4
2020-04-04-170614,170614,8,0,3,434,3.1666666666666665,0.16581054,5
2020-04-05-170614,170614,3,0,1,437,6.166666666666668,0.20566228,6
2020-04-06-170614,170614,44,1,5,481,12.5,0.96679455,0
2020-04-07-170614,170614,9,0,6,490,9.0,0.8827207,1
2020-04-08-170614,170614,9,0,7,499,9.0,0.6522616,2
2020-04-09-170614,170614,2,1,1,501,4.166666666666667,0.2617356,3
2020-04-10-170614,170614,6,0,4,507,5.833333333333332,0.26372716,4
2020-04-11-170614,170614,6,0,2,513,4.0,0.16741714,5
2020-04-12-170614,170614,6,0,2,519,2.6666666666666665,0.2429868,6
2020-04-13-170614,170614,15,0,14,534,12.166666666666664,0.76669484,0
2020-04-14-170614,170614,13,0,4,547,7.0,1.0082457,1
2020-04-15-170614,170614,8,0,10,555,5.333333333333333,0.58547777,2
2020-04-16-170614,170614,3,0,0,558,7.166666666666668,0.3713237,3
2020-04-17-170614,170614,13,0,3,571,5.666666666666668,0.5155994,4
2020-04-18-170614,170614,3,0,1,574,2.333333333333333,0.43127728,5
2020-04-19-170614,170614,1,0,2,575,1.8333333333333333,0.08267315,6
2020-04-20-170614,170614,5,0,11,580,7.333333333333332,0.44302028,0
2020-04-21-170614,170614,6,0,8,586,4.833333333333333,0.820957,1
2020-04-22-170614,170614,7,0,5,593,6.666666666666668,0.83910453,2
2020-04-23-170614,170614,1,0,7,594,1.3333333333333333,0.16003928,3
2020-04-24-170614,170614,4,0,8,598,4.166666666666667,0.3799748,4
2020-04-25-170614,170614,2,0,1,600,1.8333333333333333,0.2284273,5
2020-04-26-170614,170614,2,0,1,602,1.0,0.2319116,6
2020-04-27-170614,170614,14,0,8,616,6.0,0.6607673,0
2020-04-28-170614,170614,4,0,51,620,4.166666666666667,0.31773734,1
2020-04-29-170614,170614,10,0,4,630,4.666666666666667,0.46795428,2
2020-04-30-170614,170614,0,0,5,630,4.5,0.29794312,3
2020-05-01-170614,170614,3,0,6,633,1.1666666666666667,0.35713613,4
2020-05-02-170614,170614,1,0,1,634,2.0,0.13777976,5
2020-05-03-170614,170614,2,0,0,636,1.1666666666666667,0.05689849,6
2020-05-04-170614,170614,11,0,1,647,3.8333333333333335,0.92187035,0
2020-05-05-170614,170614,8,0,5,655,6.666666666666668,0.3894128,1
2020-05-06-170614,170614,5,0,6,660,3.8333333333333335,0.7145837,2
2020-05-07-170614,170614,7,0,3,667,4.333333333333333,0.7168491,3
2020-05-08-170614,170614,8,0,7,675,7.333333333333332,0.46763846,4
2020-05-09-170614,170614,1,0,0,676,1.3333333333333333,0.09171999,5
2020-05-10-170614,170614,1,0,0,677,0.3333333333333333,0.016483126,6
2020-05-11-170614,170614,8,0,1,685,6.333333333333332,0.6631416,0
2020-05-12-170614,170614,51,0,4,736,9.166666666666666,0.7112328,1
2020-05-13-170614,170614,4,0,4,740,5.333333333333333,0.47388008,2
2020-05-14-170614,170614,5,1,2,745,4.0,0.22632034,3
2020-05-15-170614,170614,6,0,3,751,5.5,0.3881458,4
2020-05-16-170614,170614,1,0,0,752,0.8333333333333334,0.014195291,5
2020-05-17-170614,170614,0,0,0,752,0.16666666666666666,0.006284201,6
2020-05-18-170614,170614,1,0,4,753,2.833333333333333,0.35725012,0
2020-05-19-170614,170614,5,0,2,758,3.1666666666666665,0.28842133,1
2020-05-20-170614,170614,6,0,2,764,1.5,0.22479996,2
2020-05-21-170614,170614,3,0,4,767,2.833333333333333,0.13261577,3
2020-05-22-170614,170614,7,0,2,774,3.333333333333333,0.19436276,4
2020-05-23-170614,170614,0,0,1,774,0.3333333333333333,0.03031316,5
2020-05-24-170614,170614,0,0,0,774,0.16666666666666666,0.015572366,6
2020-05-25-170614,170614,1,0,3,775,1.8333333333333333,0.26096165,0
2020-05-26-170614,170614,4,0,3,779,1.5,0.1670432,1
2020-05-27-170614,170614,4,1,2,783,2.6666666666666665,0.21173128,2
2020-05-28-170614,170614,2,5,1,785,2.5,0.26841047,3
2020-05-29-170614,170614,3,0,0,788,2.5,0.27548528,4
2020-05-30-170614,170614,0,0,0,788,0.6666666666666666,0.017468596,5
2020-05-31-170614,170614,0,0,0,788,0.16666666666666666,0.008685026,6
2020-06-01-170614,170614,4,0,2,792,3.0,0.38107738,0
2020-06-02-170614,170614,2,0,1,794,1.1666666666666667,0.14079805,1
2020-06-03-170614,170614,2,0,0,796,3.1666666666666665,0.08287577,2
2020-06-04-170614,170614,4,0,1,800,3.333333333333333,0.243214,3
2020-06-05-170614,170614,2,0,4,802,1.0,0.5543479,4
2020-06-06-170614,170614,1,0,0,803,0.0,0.026025942,5
2020-06-07-170614,170614,0,0,0,803,0.16666666666666666,0.035219017,6
2020-06-08-170614,170614,3,0,4,806,1.1666666666666667,0.1208767,0
2020-06-09-170614,170614,3,0,2,809,2.1666666666666665,0.122148104,1
2020-06-10-170614,170614,2,0,1,811,1.5,0.09239007,2
2020-06-11-170614,170614,1,0,2,812,2.0,0.14270878,3
2020-06-12-170614,170614,0,0,2,812,0.6666666666666666,0.06777242,4
2020-06-13-170614,170614,0,0,0,812,0.3333333333333333,0.0034714253,5
2020-06-14-170614,170614,0,0,0,812,0.0,0.004587345,6
2020-06-15-170614,170614,2,0,1,814,2.833333333333333,0.0547257,0
2020-06-16-170614,170614,1,0,1,815,1.5,0.18679613,1
2020-06-17-170614,170614,0,0,2,815,1.8333333333333333,0.14099325,2
2020-06-18-170614,170614,1,0,0,816,2.6666666666666665,0.15609814,3
2020-06-19-170614,170614,4,0,3,820,2.0,0.27492666,4
2020-06-20-170614,170614,0,0,0,820,0.0,0.00081189803,5
2020-06-21-170614,170614,0,0,0,820,0.16666666666666666,0.010185503,6
2020-06-22-170614,170614,4,0,1,824,1.5,0.155778,0
2020-06-23-170614,170614,2,0,0,826,1.5,0.22449882,1
2020-06-24-170614,170614,1,0,0,827,1.5,0.062070977,2
2020-06-25-170614,170614,2,0,2,829,1.1666666666666667,0.092302546,3
2020-06-26-170614,170614,2,0,4,831,2.0,0.13216554,4
2020-06-27-170614,170614,0,0,0,831,0.0,0.022992482,5
2020-06-28-170614,170614,0,0,0,831,0.0,0.017085074,6
2020-06-29-170614,170614,1,0,1,832,0.8333333333333334,0.10180526,0
2020-06-30-170614,170614,1,0,1,833,1.0,0.11137737,1
2020-07-01-170614,170614,2,0,1,835,0.5,0.06432289,2
2020-07-02-170614,170614,0,0,0,835,1.3333333333333333,0.031856988,3
2020-07-03-170614,170614,3,1,0,838,0.6666666666666666,0.09806901,4
2020-07-04-170614,170614,0,0,0,838,0.0,0.004913411,5
2020-07-05-170614,170614,0,0,0,838,0.0,0.013996174,6
2020-07-06-170614,170614,1,0,0,839,0.6666666666666666,0.044725478,0
2020-07-07-170614,170614,0,0,2,839,1.5,0.05122806,1
2020-07-08-170614,170614,0,1,2,839,0.3333333333333333,0.007204862,2
2020-07-09-170614,170614,2,0,0,841,0.8333333333333334,0.07029165,3
2020-07-10-170614,170614,4,0,1,845,0.5,0.041125815,4
2020-07-11-170614,170614,0,0,0,845,0.16666666666666666,0.0031514992,5
2020-07-12-170614,170614,0,0,0,845,0.16666666666666666,0.033869103,6
2020-07-13-170614,170614,1,0,0,846,0.3333333333333333,0.058816258,0
2020-07-14-170614,170614,1,0,2,847,0.8333333333333334,0.08881331,1
2020-07-15-170614,170614,1,0,0,848,1.0,0.013177576,2
2020-07-16-170614,170614,0,0,2,848,1.1666666666666667,0.04253445,3
2020-07-17-170614,170614,0,0,3,848,0.8333333333333334,0.029691268,4
2020-07-18-170614,170614,0,0,2,848,0.0,0.01500467,5
2020-07-19-170614,170614,0,0,1,848,0.0,0.0018657375,6
2020-07-20-170614,170614,0,0,2,848,1.0,0.04923492,0
2020-07-21-170614,170614,2,0,1,850,0.3333333333333333,0.026801491,1
2020-07-22-170614,170614,2,0,4,852,0.6666666666666666,0.11929766,2
2020-07-23-170614,170614,0,0,2,852,0.6666666666666666,0.0126505755,3
2020-07-24-170614,170614,1,1,4,853,0.5,0.01696664,4
2020-07-25-170614,170614,0,0,0,853,0.3333333333333333,0.011615027,5
2020-07-26-170614,170614,0,1,0,853,0.6666666666666666,0.013111329,6
2020-07-27-170614,170614,0,0,0,853,0.6666666666666666,0.05628464,0
2020-07-28-170614,170614,2,0,1,855,1.0,0.078666955,1
2020-07-29-170614,170614,0,0,1,855,0.8333333333333334,0.051759385,2
2020-07-30-170614,170614,2,0,2,857,0.8333333333333334,0.15422317,3
2020-07-31-170614,170614,3,2,5,860,2.333333333333333,0.17414823,4
2020-08-01-170614,170614,2,0,2,862,0.16666666666666666,0.16294335,5
2020-08-02-170614,170614,1,0,4,863,1.3333333333333333,0.17181872,6
2020-08-03-170614,170614,2,0,11,865,2.6666666666666665,0.26111698,0
2020-08-04-170614,170614,1,0,2,866,1.6666666666666667,0.26182052,1
2020-08-05-170614,170614,4,0,16,870,4.333333333333333,0.41823316,2
2020-08-06-170614,170614,2,0,17,872,3.333333333333333,0.2520751,3
2020-08-07-170614,170614,4,0,7,876,5.833333333333332,0.41061825,4
2020-08-08-170614,170614,0,0,2,876,0.8333333333333334,0.21001709,5
2020-08-09-170614,170614,0,0,1,876,0.8333333333333334,0.04618665,6
2020-08-10-170614,170614,0,0,9,876,2.6666666666666665,0.25113985,0
2020-08-11-170614,170614,1,0,3,877,3.8333333333333335,0.30369356,1
2020-08-12-170614,170614,1,0,9,878,3.333333333333333,0.52386504,2
2020-08-13-170614,170614,2,0,2,880,8.166666666666666,0.47971717,3
2020-08-14-170614,170614,5,0,10,885,4.166666666666667,0.34111515,4
2020-08-15-170614,170614,2,0,4,887,2.0,0.10333961,5
2020-08-16-170614,170614,4,0,4,891,1.1666666666666667,0.1828833,6
2020-08-17-170614,170614,11,1,9,902,6.666666666666668,0.32550415,0
2020-08-18-170614,170614,2,0,4,904,4.666666666666667,0.52592695,1
2020-08-19-170614,170614,16,0,3,920,4.0,0.35283813,2
2020-08-20-170614,170614,17,0,6,937,4.333333333333333,0.66092366,3
2020-08-21-170614,170614,7,0,13,944,6.0,0.45245692,4
2020-08-22-170614,170614,2,0,1,946,0.6666666666666666,0.117719464,5
2020-08-23-170614,170614,1,0,5,947,1.6666666666666667,0.2388111,6
2020-08-24-170614,170614,9,0,7,956,6.666666666666668,0.75660604,0
2020-08-25-170614,170614,3,2,4,959,7.666666666666668,0.5241705,1
2020-08-26-170614,170614,9,0,6,968,8.166666666666666,0.6584158,2
2020-08-27-170614,170614,2,1,3,970,6.833333333333332,0.5373479,3
2020-08-28-170614,170614,10,0,10,980,9.833333333333334,0.58460027,4
2020-08-29-170614,170614,4,0,6,984,2.6666666666666665,0.30916798,5
2020-08-30-170614,170614,4,0,5,988,1.3333333333333333,0.1334365,6
2020-08-31-170614,170614,9,0,6,997,10.5,0.93007034,0
2020-09-01-170614,170614,4,0,1,1001,7.666666666666668,0.90859723,1
2020-09-02-170614,170614,3,0,1,1004,6.666666666666668,0.71153426,2
2020-09-03-170614,170614,6,0,3,1010,7.166666666666668,0.9677912,3
2020-09-04-170614,170614,13,0,6,1023,8.833333333333334,0.97143877,4
2020-09-05-170614,170614,1,0,6,1024,4.333333333333333,0.5758222,5
2020-09-06-170614,170614,5,0,1,1029,3.1666666666666665,0.3844132,6
2020-09-07-170614,170614,7,1,6,1036,11.166666666666664,1.1378669,0
2020-09-08-170614,170614,4,0,5,1040,1.3333333333333333,0.44501045,1
2020-09-09-170614,170614,6,0,2,1046,5.666666666666668,0.61404306,2
2020-09-10-170614,170614,3,1,7,1049,7.0,0.6161995,3
2020-09-11-170614,170614,10,0,5,1059,12.666666666666664,1.2370523,4
2020-09-12-170614,170614,6,1,2,1065,2.0,0.35043597,5
2020-09-13-170614,170614,5,0,0,1070,2.6666666666666665,0.20156154,6
2020-09-14-170614,170614,6,1,3,1076,13.666666666666664,1.255029,0
2020-09-15-170614,170614,1,0,6,1077,7.0,0.6759763,1
2020-09-16-170614,170614,1,1,2,1078,5.333333333333333,0.7011588,2
2020-09-17-170614,170614,3,0,3,1081,5.333333333333333,0.5758525,3
2020-09-18-170614,170614,6,0,3,1087,6.666666666666668,1.2801651,4
2020-09-19-170614,170614,6,1,0,1093,0.6666666666666666,0.41321957,5
2020-09-20-170614,170614,1,0,4,1094,3.5,0.42759678,6
2020-09-21-170614,170614,6,0,5,1100,10.833333333333336,1.1810449,0
2020-09-22-170614,170614,5,1,14,1105,7.5,0.9157243,1
2020-09-23-170614,170614,2,2,8,1107,5.333333333333333,1.011175,2
2020-09-24-170614,170614,7,0,7,1114,7.666666666666668,0.867464,3
2020-09-25-170614,170614,5,1,4,1119,5.5,0.88591826,4
2020-09-26-170614,170614,2,0,1,1121,1.1666666666666667,0.5330455,5
2020-09-27-170614,170614,0,0,1,1121,1.3333333333333333,0.28868443,6
2020-09-28-170614,170614,3,0,6,1124,5.666666666666668,0.79181385,0
2020-09-29-170614,170614,6,0,3,1130,5.833333333333332,0.7108987,1
2020-09-30-170614,170614,2,0,11,1132,6.833333333333332,0.6982269,2
2020-10-01-170614,170614,3,0,4,1135,4.5,0.519644,3
2020-10-02-170614,170614,3,0,10,1138,4.666666666666667,0.71677434,4
2020-10-03-170614,170614,0,0,0,1138,1.8333333333333333,0.3266703,5
2020-10-04-170614,170614,4,0,2,1142,2.0,0.2681372,6
2020-10-05-170614,170614,5,0,37,1147,8.5,2.1854377,0
2020-10-06-170614,170614,14,1,17,1161,8.833333333333334,0.94209754,1
2020-10-07-170614,170614,8,0,17,1169,6.5,1.3356345,2
2020-10-08-170614,170614,7,1,14,1176,6.833333333333332,1.0308436,3
2020-10-09-170614,170614,4,4,16,1180,12.166666666666664,0.82491446,4
2020-10-10-170614,170614,1,0,1,1181,3.5,0.32014155,5
2020-10-11-170614,170614,1,0,0,1182,5.0,0.53140056,6
2020-10-12-170614,170614,6,0,9,1188,3.5,0.3999547,0
2020-10-13-170614,170614,3,0,17,1191,12.0,1.0467284,1
2020-10-14-170614,170614,11,0,9,1202,9.833333333333334,1.0019666,2
2020-10-15-170614,170614,4,0,11,1206,13.833333333333336,1.6072584,3
2020-10-16-170614,170614,10,0,16,1216,16.0,1.826949,4
2020-10-17-170614,170614,0,0,2,1216,3.0,0.32138065,5
2020-10-18-170614,170614,2,0,3,1218,4.333333333333333,0.32772356,6
2020-10-19-170614,170614,37,0,3,1255,14.833333333333336,1.2915194,0
2020-10-20-170614,170614,17,0,20,1272,15.166666666666664,1.1667447,1
2020-10-21-170614,170614,17,0,11,1289,15.166666666666664,1.6512058,2
2020-10-22-170614,170614,14,0,12,1303,15.833333333333336,1.7927309,3
2020-10-23-170614,170614,16,1,7,1319,20.0,1.6322083,4
2020-10-24-170614,170614,1,1,8,1320,2.6666666666666665,0.4327666,5
2020-10-25-170614,170614,0,1,4,1320,8.0,0.4574704,6
2020-10-26-170614,170614,9,0,20,1329,19.33333333333333,1.341526,0
2020-10-27-170614,170614,17,0,10,1346,14.166666666666664,1.402588,1
2020-10-28-170614,170614,9,1,6,1355,15.0,1.5299166,2
2020-10-29-170614,170614,11,0,2,1366,11.333333333333336,1.3484342,3
2020-10-30-170614,170614,16,0,7,1382,18.5,1.3644717,4
2020-10-31-170614,170614,2,0,0,1384,4.833333333333333,0.2598517,5
2020-11-01-170614,170614,3,1,0,1387,6.0,0.40307036,6
2020-11-02-170614,170614,3,0,0,1390,3.1666666666666665,0.3497007,0
2020-11-03-170614,170614,20,0,0,1410,17.666666666666668,1.5241755,1
2020-11-04-170614,170614,11,0,0,1421,14.333333333333336,1.2271488,2
2020-11-05-170614,170614,12,0,0,1433,10.833333333333336,1.2694762,3
2020-11-06-170614,170614,7,1,0,1440,12.0,1.0218034,4
2020-11-07-170614,170614,8,0,0,1448,2.6666666666666665,0.2854481,5
2020-11-08-170614,170614,4,0,0,1452,4.0,0.29471046,6
2020-11-09-170614,170614,20,0,0,1472,11.166666666666664,1.2411597,0
2020-11-10-170614,170614,10,1,0,1482,9.833333333333334,0.6831428,1
2020-11-11-170614,170614,6,2,0,1488,8.666666666666666,0.9159755,2
2020-11-12-170614,170614,2,2,0,1490,11.166666666666664,0.8259502,3
2020-11-13-170614,170614,7,0,0,1497,10.166666666666666,0.73198664,4
2020-03-01-170615,170615,0,0,1,0,0.0,0.000109130124,6
2020-03-02-170615,170615,0,0,3,0,0.0,0.079239175,0
2020-03-03-170615,170615,0,0,2,0,0.0,0.0011758046,1
2020-03-04-170615,170615,0,0,1,0,0.0,0.0013054813,2
2020-03-05-170615,170615,0,0,1,0,0.3333333333333333,0.04463472,3
2020-03-06-170615,170615,0,0,0,0,0.3333333333333333,0.04850992,4
2020-03-07-170615,170615,0,0,0,0,0.0,9.5587355e-05,5
2020-03-08-170615,170615,0,0,1,0,0.0,0.0002023632,6
2020-03-09-170615,170615,0,0,0,0,0.0,0.001035599,0
2020-03-10-170615,170615,0,0,0,0,0.0,0.0042518484,1
2020-03-11-170615,170615,0,0,2,0,0.3333333333333333,0.04815244,2
2020-03-12-170615,170615,0,0,0,0,0.0,0.07688951,3
2020-03-13-170615,170615,0,0,1,0,0.0,0.09756894,4
2020-03-14-170615,170615,1,0,0,1,1.0,0.1206144,5
2020-03-15-170615,170615,1,0,0,2,1.6666666666666667,0.08275868,6
2020-03-16-170615,170615,3,0,1,5,7.0,0.1734206,0
2020-03-17-170615,170615,2,0,2,7,4.0,0.20367552,1
2020-03-18-170615,170615,1,1,0,8,5.333333333333333,0.32280686,2
2020-03-19-170615,170615,1,0,0,9,4.666666666666667,0.26726443,3
2020-03-20-170615,170615,0,0,1,9,7.0,0.44173604,4
2020-03-21-170615,170615,0,0,0,9,1.6666666666666667,0.07714804,5
2020-03-22-170615,170615,1,0,3,10,1.6666666666666667,0.13332123,6
2020-03-23-170615,170615,0,0,0,10,8.0,0.68255943,0
2020-03-24-170615,170615,0,0,1,10,8.666666666666666,0.4227079,1
2020-03-25-170615,170615,2,0,0,12,9.333333333333334,0.5119244,2
2020-03-26-170615,170615,0,0,0,12,6.333333333333332,0.65950185,3
2020-03-27-170615,170615,1,0,0,13,4.333333333333333,0.4961634,4
2020-03-28-170615,170615,0,0,0,13,3.6666666666666665,0.081237376,5
2020-03-29-170615,170615,0,0,1,13,2.333333333333333,0.12367966,6
2020-03-30-170615,170615,1,0,0,14,4.666666666666667,0.24686587,0
2020-03-31-170615,170615,2,0,1,16,4.333333333333333,0.24620531,1
2020-04-01-170615,170615,0,0,1,16,3.333333333333333,0.20257244,2
2020-04-02-170615,170615,0,0,0,16,4.0,0.35267884,3
2020-04-03-170615,170615,1,0,0,17,4.666666666666667,0.23366167,4
2020-04-04-170615,170615,0,0,0,17,1.3333333333333333,0.115278736,5
2020-04-05-170615,170615,3,0,1,20,2.333333333333333,0.06206181,6
2020-04-06-170615,170615,0,0,0,20,5.666666666666668,0.24052504,0
2020-04-07-170615,170615,1,0,0,21,6.333333333333332,0.25076747,1
2020-04-08-170615,170615,0,1,0,21,3.0,0.1687067,2
2020-04-09-170615,170615,0,0,0,21,1.0,0.091627784,3
2020-04-10-170615,170615,0,0,0,21,1.3333333333333333,0.15765527,4
2020-04-11-170615,170615,0,0,0,21,3.0,0.035481326,5
2020-04-12-170615,170615,1,0,1,22,1.6666666666666667,0.03220235,6
2020-04-13-170615,170615,0,0,0,22,8.666666666666666,0.31271097,0
2020-04-14-170615,170615,1,0,0,23,1.6666666666666667,0.1984734,1
2020-04-15-170615,170615,1,0,0,24,3.6666666666666665,0.22647072,2
2020-04-16-170615,170615,0,0,0,24,0.6666666666666666,0.088820785,3
2020-04-17-170615,170615,0,0,0,24,1.3333333333333333,0.13681717,4
2020-04-18-170615,170615,0,0,1,24,2.333333333333333,0.08788311,5
2020-04-19-170615,170615,1,0,0,25,1.3333333333333333,0.022703625,6
2020-04-20-170615,170615,0,0,0,25,2.333333333333333,0.2191133,0
2020-04-21-170615,170615,0,0,0,25,1.6666666666666667,0.18748076,1
2020-04-22-170615,170615,0,0,0,25,1.3333333333333333,0.09943332,2
2020-04-23-170615,170615,0,0,1,25,2.0,0.077261776,3
2020-04-24-170615,170615,0,0,0,25,1.0,0.07111098,4
2020-04-25-170615,170615,0,0,0,25,0.6666666666666666,0.04628647,5
2020-04-26-170615,170615,1,0,0,26,0.3333333333333333,0.018369181,6
2020-04-27-170615,170615,0,0,1,26,2.333333333333333,0.115636855,0
2020-04-28-170615,170615,0,0,0,26,0.6666666666666666,0.20708324,1
2020-04-29-170615,170615,0,0,0,26,1.0,0.064168744,2
2020-04-30-170615,170615,0,0,0,26,1.3333333333333333,0.15433344,3
2020-05-01-170615,170615,0,0,0,26,0.6666666666666666,0.03294853,4
2020-05-02-170615,170615,1,0,0,27,1.0,0.07477928,5
2020-05-03-170615,170615,0,0,0,27,0.3333333333333333,0.07441313,6
2020-05-04-170615,170615,0,0,0,27,3.6666666666666665,0.32016286,0
2020-05-05-170615,170615,0,0,0,27,2.6666666666666665,0.21527772,1
2020-05-06-170615,170615,0,0,0,27,2.0,0.75125366,2
2020-05-07-170615,170615,1,0,1,28,1.0,0.48498026,3
2020-05-08-170615,170615,0,0,0,28,0.6666666666666666,0.17942269,4
2020-05-09-170615,170615,0,1,0,28,2.6666666666666665,0.031980593,5
2020-05-10-170615,170615,0,1,0,28,0.6666666666666666,0.0052483124,6
2020-05-11-170615,170615,1,4,0,29,1.6666666666666667,0.12593107,0
2020-05-12-170615,170615,0,2,0,29,1.0,0.094043955,1
2020-05-13-170615,170615,0,0,0,29,1.3333333333333333,0.19369267,2
2020-05-14-170615,170615,0,1,0,29,0.0,0.079389304,3
2020-05-15-170615,170615,0,0,0,29,0.6666666666666666,0.019687064,4
2020-05-16-170615,170615,0,1,0,29,0.3333333333333333,0.0030188302,5
2020-05-17-170615,170615,0,0,0,29,0.3333333333333333,0.0031506196,6
2020-05-18-170615,170615,0,0,0,29,5.0,0.110304445,0
2020-05-19-170615,170615,0,0,0,29,0.6666666666666666,0.063382916,1
2020-05-20-170615,170615,0,0,0,29,0.3333333333333333,0.032165024,2
2020-05-21-170615,170615,1,0,1,30,1.0,0.064114995,3
2020-05-22-170615,170615,0,0,0,30,1.3333333333333333,0.115280606,4
2020-05-23-170615,170615,0,0,0,30,0.3333333333333333,0.015112836,5
2020-05-24-170615,170615,0,0,0,30,0.6666666666666666,0.04347763,6
2020-05-25-170615,170615,0,0,0,30,1.3333333333333333,0.09480688,0
2020-05-26-170615,170615,0,0,0,30,0.0,0.07883353,1
2020-05-27-170615,170615,0,0,0,30,0.0,0.15934029,2
2020-05-28-170615,170615,0,1,0,30,1.0,0.16653773,3
2020-05-29-170615,170615,0,0,0,30,1.0,0.2222263,4
2020-05-30-170615,170615,0,0,0,30,0.3333333333333333,0.005446149,5
2020-05-31-170615,170615,0,0,0,30,0.0,6.3337764e-05,6
2020-06-01-170615,170615,0,0,0,30,0.6666666666666666,0.07682544,0
2020-06-02-170615,170615,0,0,0,30,0.3333333333333333,0.04437818,1
2020-06-03-170615,170615,0,0,0,30,0.0,0.12583917,2
2020-06-04-170615,170615,1,0,0,31,2.0,0.1649554,3
2020-06-05-170615,170615,0,1,0,31,0.6666666666666666,0.12570857,4
2020-06-06-170615,170615,0,0,0,31,0.0,0.0031140952,5
2020-06-07-170615,170615,0,0,0,31,0.0,0.011214046,6
2020-06-08-170615,170615,0,0,0,31,0.3333333333333333,0.016852131,0
2020-06-09-170615,170615,0,0,0,31,0.0,0.09828963,1
2020-06-10-170615,170615,0,0,0,31,0.0,0.056888297,2
2020-06-11-170615,170615,0,0,0,31,2.333333333333333,0.09989199,3
2020-06-12-170615,170615,0,0,0,31,0.0,0.0149569595,4
2020-06-13-170615,170615,0,4,0,31,0.3333333333333333,0.015652915,5
2020-06-14-170615,170615,0,0,0,31,0.0,0.010542266,6
2020-06-15-170615,170615,0,0,0,31,0.3333333333333333,0.0428708,0
2020-06-16-170615,170615,0,1,0,31,0.0,0.01942081,1
2020-06-17-170615,170615,0,0,0,31,0.0,0.04209588,2
2020-06-18-170615,170615,0,0,0,31,0.0,0.08896298,3
2020-06-19-170615,170615,0,0,0,31,1.3333333333333333,0.086213574,4
2020-06-20-170615,170615,0,0,0,31,0.0,2.05666e-06,5
2020-06-21-170615,170615,0,0,0,31,0.0,0.00022749825,6
2020-06-22-170615,170615,0,0,0,31,0.0,0.25433064,0
2020-06-23-170615,170615,0,0,0,31,0.6666666666666666,0.0744042,1
2020-06-24-170615,170615,0,0,0,31,0.0,0.013653577,2
2020-06-25-170615,170615,0,0,0,31,0.3333333333333333,0.015475439,3
2020-06-26-170615,170615,0,0,0,31,0.3333333333333333,0.0070783617,4
2020-06-27-170615,170615,0,0,0,31,0.0,0.015621348,5
2020-06-28-170615,170615,0,0,0,31,0.6666666666666666,0.009637653,6
2020-06-29-170615,170615,0,0,0,31,0.0,0.032109004,0
2020-06-30-170615,170615,0,0,0,31,0.0,0.070684604,1
2020-07-01-170615,170615,0,0,0,31,0.0,0.0015633092,2
2020-07-02-170615,170615,0,0,0,31,0.3333333333333333,0.014444961,3
2020-07-03-170615,170615,0,0,0,31,0.0,0.020495351,4
2020-07-04-170615,170615,0,0,0,31,0.0,0.00022382312,5
2020-07-05-170615,170615,0,0,0,31,0.3333333333333333,0.009070758,6
2020-07-06-170615,170615,0,0,0,31,1.0,0.031793173,0
2020-07-07-170615,170615,0,0,0,31,0.3333333333333333,0.007317763,1
2020-07-08-170615,170615,0,0,0,31,0.0,0.0005911909,2
2020-07-09-170615,170615,0,0,3,31,0.0,0.0019921882,3
2020-07-10-170615,170615,0,0,0,31,0.0,0.0021921003,4
2020-07-11-170615,170615,0,0,0,31,0.0,0.015219127,5
2020-07-12-170615,170615,0,0,1,31,0.0,0.07970538,6
2020-07-13-170615,170615,0,0,0,31,0.3333333333333333,0.03778013,0
2020-07-14-170615,170615,0,0,0,31,0.3333333333333333,0.10996284,1
2020-07-15-170615,170615,0,0,1,31,0.0,0.00016653664,2
2020-07-16-170615,170615,0,0,0,31,0.3333333333333333,0.039308224,3
2020-07-17-170615,170615,0,0,0,31,0.0,0.014490942,4
2020-07-18-170615,170615,0,0,0,31,0.0,0.001896451,5
2020-07-19-170615,170615,0,0,0,31,0.0,0.00031822556,6
2020-07-20-170615,170615,0,0,0,31,0.3333333333333333,0.010883532,0
2020-07-21-170615,170615,0,0,0,31,0.3333333333333333,0.07434455,1
2020-07-22-170615,170615,0,0,1,31,0.0,0.08764414,2
2020-07-23-170615,170615,3,0,0,34,1.0,0.071386136,3
2020-07-24-170615,170615,0,0,0,34,0.6666666666666666,0.025532896,4
2020-07-25-170615,170615,0,0,1,34,0.3333333333333333,0.00777476,5
2020-07-26-170615,170615,1,0,0,35,0.0,0.017683543,6
2020-07-27-170615,170615,0,0,0,35,0.0,0.0005788715,0
2020-07-28-170615,170615,0,0,2,35,0.3333333333333333,0.046303943,1
2020-07-29-170615,170615,1,0,0,36,0.0,0.11891938,2
2020-07-30-170615,170615,0,0,0,36,0.3333333333333333,0.08211275,3
2020-07-31-170615,170615,0,0,2,36,0.0,0.084694624,4
2020-08-01-170615,170615,0,0,3,36,1.3333333333333333,0.20971273,5
2020-08-02-170615,170615,0,0,0,36,0.3333333333333333,0.029754262,6
2020-08-03-170615,170615,0,0,0,36,1.0,0.039884526,0
2020-08-04-170615,170615,0,0,1,36,0.6666666666666666,0.09843554,1
2020-08-05-170615,170615,1,0,0,37,0.3333333333333333,0.04070665,2
2020-08-06-170615,170615,0,0,1,37,0.0,0.13602158,3
2020-08-07-170615,170615,0,0,4,37,1.0,0.21635431,4
2020-08-08-170615,170615,1,0,0,38,0.3333333333333333,0.05193704,5
2020-08-09-170615,170615,0,0,0,38,0.0,0.008351572,6
2020-08-10-170615,170615,0,0,0,38,1.0,0.12675789,0
2020-08-11-170615,170615,2,0,0,40,4.0,0.27622628,1
2020-08-12-170615,170615,0,0,1,40,0.6666666666666666,0.14143474,2
2020-08-13-170615,170615,0,0,0,40,2.0,0.33047387,3
2020-08-14-170615,170615,2,0,1,42,3.0,0.15110135,4
2020-08-15-170615,170615,3,0,0,45,0.6666666666666666,0.16603324,5
2020-08-16-170615,170615,0,0,1,45,0.0,0.13211466,6
2020-08-17-170615,170615,0,0,0,45,1.6666666666666667,0.23990671,0
2020-08-18-170615,170615,1,0,0,46,2.0,0.21075208,1
2020-08-19-170615,170615,0,0,0,46,2.333333333333333,0.40562436,2
2020-08-20-170615,170615,1,0,1,47,2.6666666666666665,0.3575309,3
2020-08-21-170615,170615,4,0,1,51,2.0,0.41330218,4
2020-08-22-170615,170615,0,0,0,51,0.6666666666666666,0.044858925,5
2020-08-23-170615,170615,0,0,1,51,0.3333333333333333,0.013879254,6
2020-08-24-170615,170615,0,0,1,51,2.0,0.23284136,0
2020-08-25-170615,170615,0,0,0,51,0.3333333333333333,0.3671946,1
2020-08-26-170615,170615,1,0,0,52,1.3333333333333333,0.10948649,2
2020-08-27-170615,170615,0,0,0,52,3.6666666666666665,0.31834146,3
2020-08-28-170615,170615,1,0,1,53,0.6666666666666666,0.12120036,4
2020-08-29-170615,170615,0,0,0,53,0.3333333333333333,0.2955808,5
2020-08-30-170615,170615,1,0,0,54,1.3333333333333333,0.069704324,6
2020-08-31-170615,170615,0,0,1,54,0.6666666666666666,0.1566313,0
2020-09-01-170615,170615,0,0,0,54,2.333333333333333,0.40172237,1
2020-09-02-170615,170615,0,0,0,54,1.0,0.2442976,2
2020-09-03-170615,170615,1,0,0,55,1.0,0.3260033,3
2020-09-04-170615,170615,1,0,13,56,3.333333333333333,0.25533646,4
2020-09-05-170615,170615,0,0,1,56,0.0,0.053299546,5
2020-09-06-170615,170615,1,0,0,57,0.0,0.11728667,6
2020-09-07-170615,170615,1,0,1,58,1.3333333333333333,0.21997423,0
2020-09-08-170615,170615,0,0,2,58,0.3333333333333333,0.18814018,1
2020-09-09-170615,170615,0,0,1,58,1.6666666666666667,0.15662718,2
2020-09-10-170615,170615,0,0,5,58,4.333333333333333,0.47551566,3
2020-09-11-170615,170615,1,0,1,59,0.6666666666666666,0.25962242,4
2020-09-12-170615,170615,0,0,1,59,0.3333333333333333,0.13961127,5
2020-09-13-170615,170615,0,0,1,59,1.3333333333333333,0.07561799,6
2020-09-14-170615,170615,1,0,0,60,5.0,0.24330038,0
2020-09-15-170615,170615,0,0,2,60,1.3333333333333333,0.14042275,1
2020-09-16-170615,170615,0,0,1,60,1.3333333333333333,0.13407741,2
2020-09-17-170615,170615,0,0,2,60,3.333333333333333,0.31028637,3
2020-09-18-170615,170615,13,0,0,73,7.0,0.51502013,4
2020-09-19-170615,170615,1,1,0,74,1.3333333333333333,0.20172195,5
2020-09-20-170615,170615,0,0,2,74,1.6666666666666667,0.09444087,6
2020-09-21-170615,170615,1,0,0,75,7.0,0.44447485,0
2020-09-22-170615,170615,2,0,0,77,2.6666666666666665,0.65006745,1
2020-09-23-170615,170615,1,0,0,78,0.3333333333333333,0.36632022,2
2020-09-24-170615,170615,5,0,0,83,3.0,0.68682534,3
2020-09-25-170615,170615,1,0,2,84,10.0,0.4589428,4
2020-09-26-170615,170615,1,0,0,85,9.333333333333334,0.35046914,5
2020-09-27-170615,170615,1,0,0,86,0.3333333333333333,0.08373628,6
2020-09-28-170615,170615,0,0,0,86,1.0,0.29457602,0
2020-09-29-170615,170615,2,0,0,88,1.6666666666666667,0.33390215,1
2020-09-30-170615,170615,1,0,1,89,1.3333333333333333,0.32682705,2
2020-10-01-170615,170615,2,0,1,91,2.6666666666666665,0.399404,3
2020-10-02-170615,170615,0,0,2,91,1.6666666666666667,0.24920689,4
2020-10-03-170615,170615,0,0,0,91,1.3333333333333333,0.08119723,5
2020-10-04-170615,170615,2,1,1,93,0.6666666666666666,0.2898941,6
2020-10-05-170615,170615,0,0,1,93,1.6666666666666667,0.32788017,0
2020-10-06-170615,170615,0,0,1,93,0.6666666666666666,0.39318696,1
2020-10-07-170615,170615,0,1,1,93,3.333333333333333,0.4565977,2
2020-10-08-170615,170615,0,0,0,93,0.6666666666666666,0.23927596,3
2020-10-09-170615,170615,2,0,0,95,2.333333333333333,0.3780543,4
2020-10-10-170615,170615,0,0,2,95,0.6666666666666666,0.2169386,5
2020-10-11-170615,170615,0,0,0,95,1.3333333333333333,0.27336013,6
2020-10-12-170615,170615,0,0,0,95,1.0,0.17353736,0
2020-10-13-170615,170615,0,0,1,95,0.6666666666666666,0.3295628,1
2020-10-14-170615,170615,1,0,0,96,1.6666666666666667,0.30230126,2
2020-10-15-170615,170615,1,0,2,97,0.0,0.29108062,3
2020-10-16-170615,170615,2,0,5,99,4.333333333333333,0.5393365,4
2020-10-17-170615,170615,0,0,0,99,1.6666666666666667,0.21926154,5
2020-10-18-170615,170615,1,0,1,100,0.6666666666666666,0.13575508,6
2020-10-19-170615,170615,1,0,0,101,3.0,0.6631439,0
2020-10-20-170615,170615,1,0,1,102,1.0,0.60496676,1
2020-10-21-170615,170615,1,0,4,103,1.6666666666666667,0.33826667,2
2020-10-22-170615,170615,0,0,0,103,1.3333333333333333,0.5120574,3
2020-10-23-170615,170615,0,0,0,103,4.333333333333333,0.48190284,4
2020-10-24-170615,170615,2,0,0,105,0.0,0.17838907,5
2020-10-25-170615,170615,0,0,1,105,0.3333333333333333,0.2154558,6
2020-10-26-170615,170615,0,0,0,105,5.333333333333333,0.3498363,0
2020-10-27-170615,170615,1,0,1,106,3.333333333333333,0.4730218,1
2020-10-28-170615,170615,0,0,0,106,2.6666666666666665,0.42831862,2
2020-10-29-170615,170615,2,0,0,108,1.3333333333333333,0.60952914,3
2020-10-30-170615,170615,5,0,0,113,2.333333333333333,0.58608294,4
2020-10-31-170615,170615,0,0,0,113,3.6666666666666665,0.20146595,5
2020-11-01-170615,170615,1,0,0,114,1.6666666666666667,0.27864245,6
2020-11-02-170615,170615,0,0,0,114,1.6666666666666667,0.3800914,0
2020-11-03-170615,170615,1,0,0,115,3.333333333333333,0.35820276,1
2020-11-04-170615,170615,4,0,0,119,5.333333333333333,0.5787224,2
2020-11-05-170615,170615,0,0,0,119,3.333333333333333,0.21384703,3
2020-11-06-170615,170615,0,0,0,119,5.333333333333333,0.41926366,4
2020-11-07-170615,170615,0,0,0,119,1.3333333333333333,0.16952756,5
2020-11-08-170615,170615,1,0,0,120,3.0,0.07876457,6
2020-11-09-170615,170615,0,0,0,120,4.666666666666667,0.26353645,0
2020-11-10-170615,170615,1,0,0,121,2.333333333333333,0.38236865,1
2020-11-11-170615,170615,0,0,0,121,3.6666666666666665,0.5096021,2
2020-11-12-170615,170615,0,0,0,121,2.6666666666666665,0.32186985,3
2020-11-13-170615,170615,0,0,0,121,5.0,0.27171755,4
2020-03-01-170616,170616,0,0,0,0,0.0,0.00033673775,6
2020-03-02-170616,170616,0,0,0,0,0.0,0.005150375,0
2020-03-03-170616,170616,0,0,2,0,0.16666666666666666,0.010921293,1
2020-03-04-170616,170616,0,1,3,0,0.0,0.009678381,2
2020-03-05-170616,170616,0,0,1,0,0.0,0.007605403,3
2020-03-06-170616,170616,0,0,1,0,0.0,0.008837209,4
2020-03-07-170616,170616,0,0,0,0,0.0,0.0027908406,5
2020-03-08-170616,170616,0,0,0,0,0.16666666666666666,0.0039894846,6
2020-03-09-170616,170616,0,0,0,0,0.0,0.012536652,0
2020-03-10-170616,170616,0,0,0,0,0.3333333333333333,0.031457014,1
2020-03-11-170616,170616,0,0,2,0,0.3333333333333333,0.069087476,2
2020-03-12-170616,170616,0,0,2,0,0.16666666666666666,0.12161498,3
2020-03-13-170616,170616,0,0,1,0,1.1666666666666667,0.2900215,4
2020-03-14-170616,170616,0,0,0,0,1.3333333333333333,0.08256039,5
2020-03-15-170616,170616,0,0,1,0,4.5,0.2385934,6
2020-03-16-170616,170616,0,0,0,0,5.666666666666668,0.32713115,0
2020-03-17-170616,170616,2,0,0,2,7.5,0.73775935,1
2020-03-18-170616,170616,3,0,2,5,5.833333333333332,0.89524394,2
2020-03-19-170616,170616,1,0,0,6,8.666666666666666,0.7540432,3
2020-03-20-170616,170616,1,0,0,7,8.166666666666666,0.5190633,4
2020-03-21-170616,170616,0,0,0,7,2.5,0.16314551,5
2020-03-22-170616,170616,0,0,0,7,3.0,0.22386196,6
2020-03-23-170616,170616,0,0,0,7,16.333333333333332,1.1190536,0
2020-03-24-170616,170616,0,0,0,7,11.5,0.75958836,1
2020-03-25-170616,170616,2,0,0,9,13.0,1.0237131,2
2020-03-26-170616,170616,2,0,0,11,10.5,0.8624267,3
2020-03-27-170616,170616,1,0,0,12,10.333333333333334,0.7715587,4
2020-03-28-170616,170616,0,0,0,12,1.8333333333333333,0.15445058,5
2020-03-29-170616,170616,1,0,0,13,3.5,0.25668418,6
2020-03-30-170616,170616,0,0,1,13,10.0,0.941863,0
2020-03-31-170616,170616,0,0,0,13,7.166666666666668,0.5150657,1
2020-04-01-170616,170616,2,0,0,15,8.166666666666666,0.49183193,2
2020-04-02-170616,170616,0,0,1,15,3.1666666666666665,0.45005384,3
2020-04-03-170616,170616,0,0,0,15,6.0,0.4595879,4
2020-04-04-170616,170616,0,0,0,15,1.3333333333333333,0.072669625,5
2020-04-05-170616,170616,0,1,0,15,1.0,0.08936857,6
2020-04-06-170616,170616,0,0,2,15,7.333333333333332,0.52921027,0
2020-04-07-170616,170616,0,0,0,15,8.666666666666666,0.40370375,1
2020-04-08-170616,170616,0,0,0,15,5.0,0.25064808,2
2020-04-09-170616,170616,0,2,0,15,2.6666666666666665,0.16748351,3
2020-04-10-170616,170616,0,0,0,15,3.333333333333333,0.2052608,4
2020-04-11-170616,170616,0,1,0,15,1.3333333333333333,0.07102915,5
2020-04-12-170616,170616,0,0,0,15,3.6666666666666665,0.09662542,6
2020-04-13-170616,170616,1,0,0,16,3.8333333333333335,0.35406366,0
2020-04-14-170616,170616,0,0,0,16,9.166666666666666,0.48110488,1
2020-04-15-170616,170616,0,0,1,16,2.833333333333333,0.30136722,2
2020-04-16-170616,170616,1,0,0,17,3.5,0.30503812,3
2020-04-17-170616,170616,0,0,0,17,3.5,0.17393711,4
2020-04-18-170616,170616,0,0,0,17,3.6666666666666665,0.1506668,5
2020-04-19-170616,170616,0,0,0,17,0.8333333333333334,0.037199683,6
2020-04-20-170616,170616,2,0,1,19,3.8333333333333335,0.7160703,0
2020-04-21-170616,170616,0,0,0,19,7.0,0.3341718,1
2020-04-22-170616,170616,0,0,0,19,6.5,0.28460658,2
2020-04-23-170616,170616,0,0,0,19,1.8333333333333333,0.13259824,3
2020-04-24-170616,170616,0,0,0,19,2.833333333333333,0.16769913,4
2020-04-25-170616,170616,0,0,0,19,1.6666666666666667,0.077555574,5
2020-04-26-170616,170616,0,0,0,19,2.0,0.059092253,6
2020-04-27-170616,170616,0,0,0,19,4.666666666666667,0.31797758,0
2020-04-28-170616,170616,0,1,0,19,2.6666666666666665,0.45922673,1
2020-04-29-170616,170616,1,0,0,20,3.5,0.37118134,2
2020-04-30-170616,170616,0,0,0,20,2.0,0.10130895,3
2020-05-01-170616,170616,0,0,0,20,3.5,0.105301835,4
2020-05-02-170616,170616,0,0,0,20,1.1666666666666667,0.13700393,5
2020-05-03-170616,170616,0,0,0,20,0.6666666666666666,0.01952668,6
2020-05-04-170616,170616,1,0,0,21,4.5,0.53348726,0
2020-05-05-170616,170616,0,1,0,21,3.1666666666666665,0.22910047,1
2020-05-06-170616,170616,0,0,0,21,1.3333333333333333,0.6925825,2
2020-05-07-170616,170616,0,0,1,21,2.333333333333333,0.47789386,3
2020-05-08-170616,170616,0,0,0,21,4.166666666666667,0.27568147,4
2020-05-09-170616,170616,0,0,0,21,0.8333333333333334,0.08113578,5
2020-05-10-170616,170616,0,1,0,21,0.3333333333333333,0.007000889,6
2020-05-11-170616,170616,0,4,0,21,4.666666666666667,0.26147395,0
2020-05-12-170616,170616,0,5,0,21,5.5,0.3517265,1
2020-05-13-170616,170616,0,0,0,21,4.166666666666667,0.2431031,2
2020-05-14-170616,170616,0,0,0,21,1.0,0.14802815,3
2020-05-15-170616,170616,0,0,0,21,2.6666666666666665,0.099032044,4
2020-05-16-170616,170616,0,0,0,21,0.16666666666666666,0.004756469,5
2020-05-17-170616,170616,0,0,0,21,0.0,0.002832277,6
2020-05-18-170616,170616,0,0,0,21,1.8333333333333333,0.14277141,0
2020-05-19-170616,170616,0,1,0,21,1.5,0.12008838,1
2020-05-20-170616,170616,0,0,0,21,1.5,0.17926905,2
2020-05-21-170616,170616,1,0,0,22,0.8333333333333334,0.17114872,3
2020-05-22-170616,170616,0,0,0,22,1.1666666666666667,0.04979177,4
2020-05-23-170616,170616,0,0,0,22,0.16666666666666666,0.015102361,5
2020-05-24-170616,170616,0,0,0,22,0.0,0.013252459,6
2020-05-25-170616,170616,0,0,0,22,1.6666666666666667,0.09272579,0
2020-05-26-170616,170616,0,0,0,22,0.8333333333333334,0.0630639,1
2020-05-27-170616,170616,0,1,0,22,1.1666666666666667,0.2853295,2
2020-05-28-170616,170616,0,0,0,22,0.8333333333333334,0.08756595,3
2020-05-29-170616,170616,0,0,1,22,1.5,0.180981,4
2020-05-30-170616,170616,0,0,0,22,0.0,0.005501634,5
2020-05-31-170616,170616,0,0,0,22,0.0,0.00086828315,6
2020-06-01-170616,170616,0,0,0,22,2.0,0.1886623,0
2020-06-02-170616,170616,0,1,0,22,0.3333333333333333,0.09308235,1
2020-06-03-170616,170616,0,0,0,22,0.6666666666666666,0.28485334,2
2020-06-04-170616,170616,0,0,0,22,1.0,0.11099859,3
2020-06-05-170616,170616,0,0,0,22,2.1666666666666665,0.27134582,4
2020-06-06-170616,170616,0,1,0,22,0.0,0.010334911,5
2020-06-07-170616,170616,0,1,0,22,0.3333333333333333,0.043898493,6
2020-06-08-170616,170616,0,0,0,22,0.6666666666666666,0.041451592,0
2020-06-09-170616,170616,0,0,0,22,0.5,0.03452919,1
2020-06-10-170616,170616,0,0,0,22,0.6666666666666666,0.052810438,2
2020-06-11-170616,170616,0,0,0,22,1.0,0.055493344,3
2020-06-12-170616,170616,1,0,0,23,0.3333333333333333,0.14686382,4
2020-06-13-170616,170616,0,0,0,23,0.0,0.0010295009,5
2020-06-14-170616,170616,0,0,0,23,0.0,0.00046108066,6
2020-06-15-170616,170616,0,0,0,23,0.16666666666666666,0.020351134,0
2020-06-16-170616,170616,0,0,0,23,0.8333333333333334,0.056680415,1
2020-06-17-170616,170616,0,0,0,23,0.6666666666666666,0.0747979,2
2020-06-18-170616,170616,0,0,0,23,0.8333333333333334,0.08236262,3
2020-06-19-170616,170616,0,0,0,23,0.8333333333333334,0.085978195,4
2020-06-20-170616,170616,0,0,0,23,0.16666666666666666,0.014063384,5
2020-06-21-170616,170616,0,0,0,23,0.0,0.0007702229,6
2020-06-22-170616,170616,0,0,0,23,0.8333333333333334,0.11096093,0
2020-06-23-170616,170616,0,0,0,23,1.0,0.09846747,1
2020-06-24-170616,170616,0,1,0,23,0.16666666666666666,0.034092367,2
2020-06-25-170616,170616,0,1,0,23,0.3333333333333333,0.12521857,3
2020-06-26-170616,170616,0,1,0,23,0.6666666666666666,0.03104379,4
2020-06-27-170616,170616,0,0,0,23,0.16666666666666666,0.0059609395,5
2020-06-28-170616,170616,0,0,0,23,0.0,0.012254606,6
2020-06-29-170616,170616,0,0,1,23,0.8333333333333334,0.10801872,0
2020-06-30-170616,170616,0,0,0,23,0.3333333333333333,0.042558394,1
2020-07-01-170616,170616,0,0,0,23,0.3333333333333333,0.019454857,2
2020-07-02-170616,170616,0,0,0,23,0.16666666666666666,0.017681599,3
2020-07-03-170616,170616,0,0,0,23,0.6666666666666666,0.055119786,4
2020-07-04-170616,170616,0,0,0,23,0.0,0.0014630418,5
2020-07-05-170616,170616,0,0,0,23,0.0,0.012381316,6
2020-07-06-170616,170616,0,0,0,23,0.16666666666666666,0.017242864,0
2020-07-07-170616,170616,0,0,0,23,0.0,0.0072226617,1
2020-07-08-170616,170616,0,0,0,23,0.0,0.0017017842,2
2020-07-09-170616,170616,0,0,0,23,0.16666666666666666,0.019013677,3
2020-07-10-170616,170616,0,0,0,23,0.16666666666666666,0.01846147,4
2020-07-11-170616,170616,0,0,0,23,0.0,0.0005060991,5
2020-07-12-170616,170616,0,1,0,23,0.16666666666666666,0.046046223,6
2020-07-13-170616,170616,1,0,0,24,0.16666666666666666,0.12262103,0
2020-07-14-170616,170616,0,0,0,24,0.3333333333333333,0.0660413,1
2020-07-15-170616,170616,0,0,0,24,0.0,0.0013805572,2
2020-07-16-170616,170616,0,0,0,24,0.16666666666666666,0.16245802,3
2020-07-17-170616,170616,0,0,0,24,0.0,0.0048636594,4
2020-07-18-170616,170616,0,0,0,24,0.0,0.0071970318,5
2020-07-19-170616,170616,0,0,0,24,0.0,7.273861e-05,6
2020-07-20-170616,170616,0,0,0,24,0.3333333333333333,0.008443211,0
2020-07-21-170616,170616,0,0,0,24,0.0,0.013801074,1
2020-07-22-170616,170616,0,0,0,24,0.8333333333333334,0.037988544,2
2020-07-23-170616,170616,0,0,1,24,0.16666666666666666,0.0060076998,3
2020-07-24-170616,170616,0,0,1,24,0.0,0.005700479,4
2020-07-25-170616,170616,0,0,0,24,0.0,0.002090236,5
2020-07-26-170616,170616,0,0,0,24,0.16666666666666666,0.0018712276,6
2020-07-27-170616,170616,0,0,11,24,0.16666666666666666,0.014587512,0
2020-07-28-170616,170616,0,0,2,24,0.3333333333333333,0.0527132,1
2020-07-29-170616,170616,0,0,0,24,0.3333333333333333,0.13141024,2
2020-07-30-170616,170616,0,0,0,24,0.3333333333333333,0.08485018,3
2020-07-31-170616,170616,0,0,0,24,1.3333333333333333,0.07646988,4
2020-08-01-170616,170616,0,1,0,24,0.8333333333333334,0.10689947,5
2020-08-02-170616,170616,0,0,0,24,0.6666666666666666,0.059132036,6
2020-08-03-170616,170616,0,0,0,24,1.1666666666666667,0.11030597,0
2020-08-04-170616,170616,0,0,1,24,1.0,0.10949081,1
2020-08-05-170616,170616,0,0,0,24,1.5,0.12804122,2
2020-08-06-170616,170616,1,0,1,25,1.0,0.3290304,3
2020-08-07-170616,170616,1,0,1,26,1.5,0.55517286,4
2020-08-08-170616,170616,0,0,0,26,1.1666666666666667,0.2080983,5
2020-08-09-170616,170616,0,0,0,26,0.16666666666666666,0.13047723,6
2020-08-10-170616,170616,11,0,0,37,0.8333333333333334,1.1796443,0
2020-08-11-170616,170616,2,0,1,39,1.0,0.55464935,1
2020-08-12-170616,170616,0,0,2,39,2.5,0.33175698,2
2020-08-13-170616,170616,0,0,0,39,1.8333333333333333,0.65621704,3
2020-08-14-170616,170616,0,0,3,39,1.1666666666666667,0.36707813,4
2020-08-15-170616,170616,0,0,0,39,0.3333333333333333,0.07158375,5
2020-08-16-170616,170616,0,0,0,39,1.3333333333333333,0.30220282,6
2020-08-17-170616,170616,0,0,0,39,2.333333333333333,0.5882772,0
2020-08-18-170616,170616,1,0,1,40,3.5,0.89183,1
2020-08-19-170616,170616,0,0,0,40,1.3333333333333333,0.26345935,2
2020-08-20-170616,170616,1,0,0,41,3.0,0.49868232,3
2020-08-21-170616,170616,1,0,1,42,2.0,0.47500545,4
2020-08-22-170616,170616,0,0,0,42,0.8333333333333334,0.2234415,5
2020-08-23-170616,170616,0,1,0,42,3.5,0.21626662,6
2020-08-24-170616,170616,0,0,0,42,3.6666666666666665,0.5653783,0
2020-08-25-170616,170616,1,0,0,43,2.833333333333333,0.84927696,1
2020-08-26-170616,170616,2,0,0,45,3.5,0.78763384,2
2020-08-27-170616,170616,0,0,0,45,2.0,0.33478117,3
2020-08-28-170616,170616,3,0,1,48,1.8333333333333333,0.7179996,4
2020-08-29-170616,170616,0,0,0,48,1.6666666666666667,0.5683147,5
2020-08-30-170616,170616,0,0,0,48,0.6666666666666666,0.058186945,6
2020-08-31-170616,170616,0,0,1,48,3.0,0.7037852,0
2020-09-01-170616,170616,1,0,0,49,3.0,0.9931435,1
2020-09-02-170616,170616,0,0,0,49,3.6666666666666665,0.6660111,2
2020-09-03-170616,170616,0,0,0,49,4.0,0.6314056,3
2020-09-04-170616,170616,1,0,1,50,6.166666666666668,0.49622715,4
2020-09-05-170616,170616,0,0,0,50,2.6666666666666665,0.29182458,5
2020-09-06-170616,170616,0,0,3,50,0.8333333333333334,0.20862453,6
2020-09-07-170616,170616,0,0,1,50,6.333333333333332,0.664166,0
2020-09-08-170616,170616,0,0,2,50,1.8333333333333333,0.29709765,1
2020-09-09-170616,170616,0,0,3,50,2.1666666666666665,0.20311671,2
2020-09-10-170616,170616,0,0,2,50,1.5,0.33881304,3
2020-09-11-170616,170616,1,0,2,51,4.666666666666667,0.49559495,4
2020-09-12-170616,170616,0,0,0,51,1.6666666666666667,0.18693018,5
2020-09-13-170616,170616,0,0,1,51,1.6666666666666667,0.19367403,6
2020-09-14-170616,170616,1,0,0,52,7.5,0.61017686,0
2020-09-15-170616,170616,0,0,3,52,4.0,0.18260463,1
2020-09-16-170616,170616,0,0,0,52,2.5,0.26768667,2
2020-09-17-170616,170616,0,0,0,52,4.833333333333333,0.29176417,3
2020-09-18-170616,170616,1,0,1,53,6.166666666666668,0.5801252,4
2020-09-19-170616,170616,0,0,1,53,2.1666666666666665,0.16060908,5
2020-09-20-170616,170616,3,0,0,56,1.8333333333333333,0.4566584,6
2020-09-21-170616,170616,1,0,0,57,7.333333333333332,0.5789899,0
2020-09-22-170616,170616,2,0,4,59,6.5,0.8560223,1
2020-09-23-170616,170616,3,0,3,62,6.166666666666668,0.68938535,2
2020-09-24-170616,170616,2,0,0,64,6.5,0.75082636,3
2020-09-25-170616,170616,2,0,1,66,7.5,0.76464456,4
2020-09-26-170616,170616,0,0,2,66,2.6666666666666665,0.3354625,5
2020-09-27-170616,170616,1,0,0,67,1.0,0.25903672,6
2020-09-28-170616,170616,0,0,1,67,3.6666666666666665,0.2488929,0
2020-09-29-170616,170616,3,0,1,70,4.5,0.7548564,1
2020-09-30-170616,170616,0,0,1,70,4.166666666666667,0.7679598,2
2020-10-01-170616,170616,0,1,0,70,4.333333333333333,0.67837137,3
2020-10-02-170616,170616,1,0,0,71,3.8333333333333335,0.41460678,4
2020-10-03-170616,170616,1,0,0,72,2.333333333333333,0.34339708,5
2020-10-04-170616,170616,0,0,0,72,1.3333333333333333,0.13056004,6
2020-10-05-170616,170616,0,0,1,72,12.5,0.61162317,0
2020-10-06-170616,170616,4,0,2,76,3.0,0.65064675,1
2020-10-07-170616,170616,3,0,0,79,4.5,1.2286762,2
2020-10-08-170616,170616,0,0,1,79,3.5,0.2728205,3
2020-10-09-170616,170616,1,1,0,80,3.333333333333333,0.653092,4
2020-10-10-170616,170616,2,0,0,82,0.6666666666666666,0.23433575,5
2020-10-11-170616,170616,0,0,8,82,2.0,0.14771435,6
2020-10-12-170616,170616,1,0,3,83,2.0,0.20848824,0
2020-10-13-170616,170616,1,0,0,84,3.1666666666666665,0.71883667,1
2020-10-14-170616,170616,1,0,1,85,5.0,0.57430327,2
2020-10-15-170616,170616,0,0,2,85,3.6666666666666665,0.56526595,3
2020-10-16-170616,170616,0,0,3,85,8.166666666666666,0.9892803,4
2020-10-17-170616,170616,0,0,1,85,1.8333333333333333,0.37842083,5
2020-10-18-170616,170616,0,0,0,85,2.5,0.20719469,6
2020-10-19-170616,170616,1,0,1,86,5.666666666666668,0.7037034,0
2020-10-20-170616,170616,2,0,0,88,6.5,0.99079174,1
2020-10-21-170616,170616,0,0,0,88,8.166666666666666,0.9623175,2
2020-10-22-170616,170616,1,0,1,89,7.0,0.91733027,3
2020-10-23-170616,170616,0,0,0,89,7.5,1.0494661,4
2020-10-24-170616,170616,0,0,0,89,3.1666666666666665,0.35792345,5
2020-10-25-170616,170616,8,0,2,97,2.333333333333333,0.8850754,6
2020-10-26-170616,170616,3,2,2,100,6.166666666666668,0.7525278,0
2020-10-27-170616,170616,0,0,0,100,6.0,0.8497243,1
2020-10-28-170616,170616,1,0,0,101,6.5,0.7955787,2
2020-10-29-170616,170616,2,0,0,103,6.166666666666668,1.1425228,3
2020-10-30-170616,170616,3,0,0,106,8.166666666666666,0.99839073,4
2020-10-31-170616,170616,1,1,0,107,1.1666666666666667,0.26661825,5
2020-11-01-170616,170616,0,0,0,107,2.333333333333333,0.23708254,6
2020-11-02-170616,170616,1,0,0,108,1.6666666666666667,0.22345339,0
2020-11-03-170616,170616,0,0,0,108,7.5,0.5770769,1
2020-11-04-170616,170616,0,0,0,108,5.166666666666667,0.56502104,2
2020-11-05-170616,170616,1,0,0,109,5.5,0.59753805,3
2020-11-06-170616,170616,0,1,0,109,5.333333333333333,0.8202792,4
2020-11-07-170616,170616,0,0,0,109,1.5,0.11223578,5
2020-11-08-170616,170616,2,0,0,111,2.333333333333333,0.260086,6
2020-11-09-170616,170616,2,0,0,113,6.333333333333332,0.6190389,0
2020-11-10-170616,170616,0,0,0,113,2.833333333333333,0.37894917,1
2020-11-11-170616,170616,0,1,0,113,6.0,0.29883003,2
2020-11-12-170616,170616,0,0,0,113,3.333333333333333,0.23229629,3
2020-11-13-170616,170616,0,0,0,113,4.333333333333333,0.2816808,4
2020-03-01-170617,170617,0,0,0,0,0.0,0.0005182385,6
2020-03-02-170617,170617,1,0,0,1,0.0,0.18823406,0
2020-03-03-170617,170617,0,0,1,1,0.14285714285714285,0.010342197,1
2020-03-04-170617,170617,0,0,1,1,0.0,0.011232034,2
2020-03-05-170617,170617,0,0,2,1,0.14285714285714285,0.18442337,3
2020-03-06-170617,170617,0,2,8,1,0.14285714285714285,0.18410419,4
2020-03-07-170617,170617,0,0,2,1,0.0,0.0010273501,5
2020-03-08-170617,170617,0,0,4,1,0.0,0.0013773367,6
2020-03-09-170617,170617,0,1,9,1,0.0,0.008720788,0
2020-03-10-170617,170617,0,0,5,1,0.2857142857142857,0.035252463,1
2020-03-11-170617,170617,0,0,3,1,0.14285714285714285,0.17051437,2
2020-03-12-170617,170617,1,0,8,2,0.14285714285714285,0.21474442,3
2020-03-13-170617,170617,1,0,6,3,1.0,0.29518065,4
2020-03-14-170617,170617,1,0,1,4,1.1428571428571428,0.42765352,5
2020-03-15-170617,170617,0,0,2,4,2.4285714285714284,0.34698403,6
2020-03-16-170617,170617,0,0,1,4,4.0,0.9021252,0
2020-03-17-170617,170617,1,0,1,5,5.142857142857143,1.1103013,1
2020-03-18-170617,170617,1,0,0,6,5.285714285714286,1.3691616,2
2020-03-19-170617,170617,2,0,0,8,6.7142857142857135,1.4820606,3
2020-03-20-170617,170617,8,0,0,16,6.857142857142858,1.4016,4
2020-03-21-170617,170617,2,0,1,18,3.1428571428571432,0.3334694,5
2020-03-22-170617,170617,4,0,0,22,3.2857142857142856,0.5209023,6
2020-03-23-170617,170617,9,0,1,31,13.285714285714285,2.429398,0
2020-03-24-170617,170617,5,0,0,36,9.142857142857142,1.6133808,1
2020-03-25-170617,170617,3,0,1,39,11.428571428571427,2.134563,2
2020-03-26-170617,170617,8,0,0,47,10.142857142857142,2.4973989,3
2020-03-27-170617,170617,6,0,3,53,12.0,1.9943671,4
2020-03-28-170617,170617,1,0,0,54,2.0,0.31737235,5
2020-03-29-170617,170617,2,0,0,56,3.4285714285714284,0.551012,6
2020-03-30-170617,170617,1,0,0,57,11.571428571428573,1.609763,0
2020-03-31-170617,170617,1,0,0,58,7.142857142857142,1.4193406,1
2020-04-01-170617,170617,0,0,1,58,8.0,1.273767,2
2020-04-02-170617,170617,0,0,0,58,5.285714285714286,1.1323943,3
2020-04-03-170617,170617,0,0,1,58,4.857142857142857,0.96166164,4
2020-04-04-170617,170617,1,0,1,59,2.142857142857143,0.39106894,5
2020-04-05-170617,170617,0,0,0,59,1.7142857142857142,0.26967126,6
2020-04-06-170617,170617,1,0,0,60,7.0,1.0256356,0
2020-04-07-170617,170617,0,0,2,60,5.0,0.9337304,1
2020-04-08-170617,170617,1,0,2,61,4.0,0.7069817,2
2020-04-09-170617,170617,0,0,0,61,4.857142857142857,0.4945784,3
2020-04-10-170617,170617,3,0,0,64,1.5714285714285714,0.43414506,4
2020-04-11-170617,170617,0,0,1,64,1.0,0.1839053,5
2020-04-12-170617,170617,0,0,0,64,1.1428571428571428,0.17393546,6
2020-04-13-170617,170617,0,1,0,64,4.857142857142857,1.3372086,0
2020-04-14-170617,170617,0,0,2,64,5.428571428571429,1.123741,1
2020-04-15-170617,170617,1,0,0,65,4.714285714285714,0.93574697,2
2020-04-16-170617,170617,0,0,1,65,2.8571428571428568,0.4175066,3
2020-04-17-170617,170617,1,0,0,66,3.4285714285714284,0.64237297,4
2020-04-18-170617,170617,1,0,0,67,3.2857142857142856,0.35948086,5
2020-04-19-170617,170617,0,0,2,67,1.0,0.11894585,6
2020-04-20-170617,170617,0,0,2,67,3.0,0.63976914,0
2020-04-21-170617,170617,2,0,1,69,3.4285714285714284,0.8296457,1
2020-04-22-170617,170617,2,0,3,71,3.8571428571428568,0.5446734,2
2020-04-23-170617,170617,0,0,6,71,2.0,0.2925847,3
2020-04-24-170617,170617,0,0,1,71,2.571428571428572,0.3434149,4
2020-04-25-170617,170617,1,0,0,72,1.2857142857142858,0.15209143,5
2020-04-26-170617,170617,0,0,0,72,1.7142857142857142,0.14280018,6
2020-04-27-170617,170617,0,0,0,72,4.571428571428571,0.6504,0
2020-04-28-170617,170617,2,0,0,74,2.7142857142857144,0.6907564,1
2020-04-29-170617,170617,0,0,2,74,3.0,0.35382137,2
2020-04-30-170617,170617,1,0,0,75,2.0,0.58636886,3
2020-05-01-170617,170617,0,0,0,75,2.142857142857143,0.20515986,4
2020-05-02-170617,170617,0,0,0,75,1.8571428571428568,0.44853488,5
2020-05-03-170617,170617,2,0,0,77,0.14285714285714285,0.17463098,6
2020-05-04-170617,170617,2,0,0,79,7.2857142857142865,1.1321437,0
2020-05-05-170617,170617,1,0,0,80,2.7142857142857144,0.79556006,1
2020-05-06-170617,170617,3,0,0,83,21.0,3.714863,2
2020-05-07-170617,170617,6,0,0,89,5.857142857142858,1.8423803,3
2020-05-08-170617,170617,1,0,1,90,3.1428571428571432,0.82305706,4
2020-05-09-170617,170617,0,0,0,90,0.14285714285714285,0.085736305,5
2020-05-10-170617,170617,0,0,0,90,0.14285714285714285,0.024683883,6
2020-05-11-170617,170617,0,2,1,90,5.0,0.8019664,0
2020-05-12-170617,170617,0,1,1,90,2.4285714285714284,0.3714093,1
2020-05-13-170617,170617,2,0,2,92,2.4285714285714284,0.6332696,2
2020-05-14-170617,170617,0,0,2,92,2.4285714285714284,0.4550247,3
2020-05-15-170617,170617,0,0,3,92,1.0,0.13355543,4
2020-05-16-170617,170617,0,0,0,92,0.0,0.008379434,5
2020-05-17-170617,170617,0,1,0,92,0.14285714285714285,0.017152205,6
2020-05-18-170617,170617,0,0,0,92,1.7142857142857142,0.35954085,0
2020-05-19-170617,170617,0,0,0,92,1.5714285714285714,0.37231866,1
2020-05-20-170617,170617,0,0,2,92,1.2857142857142858,0.1833129,2
2020-05-21-170617,170617,0,0,1,92,1.1428571428571428,0.40938598,3
2020-05-22-170617,170617,1,0,1,93,1.1428571428571428,0.37362215,4
2020-05-23-170617,170617,0,0,0,93,0.2857142857142857,0.0804789,5
2020-05-24-170617,170617,0,0,0,93,0.42857142857142855,0.20243444,6
2020-05-25-170617,170617,1,0,0,94,0.2857142857142857,0.21917044,0
2020-05-26-170617,170617,1,0,1,95,0.5714285714285714,0.23639321,1
2020-05-27-170617,170617,2,1,0,97,0.7142857142857143,0.39646235,2
2020-05-28-170617,170617,2,0,0,99,0.8571428571428571,0.3741393,3
2020-05-29-170617,170617,3,0,0,102,1.2857142857142858,0.6519509,4
2020-05-30-170617,170617,0,0,0,102,0.14285714285714285,0.036731273,5
2020-05-31-170617,170617,0,1,0,102,0.0,0.0005227594,6
2020-06-01-170617,170617,0,0,0,102,2.2857142857142856,0.47158903,0
2020-06-02-170617,170617,0,0,0,102,1.2857142857142858,0.21384826,1
2020-06-03-170617,170617,2,0,0,104,0.5714285714285714,0.324863,2
2020-06-04-170617,170617,1,0,1,105,1.1428571428571428,0.5458159,3
2020-06-05-170617,170617,1,0,0,106,2.2857142857142856,0.55218863,4
2020-06-06-170617,170617,0,7,0,106,0.2857142857142857,0.0387763,5
2020-06-07-170617,170617,0,0,0,106,0.2857142857142857,0.047004554,6
2020-06-08-170617,170617,0,0,4,106,0.42857142857142855,0.08155662,0
2020-06-09-170617,170617,1,0,0,107,0.7142857142857143,0.32008314,1
2020-06-10-170617,170617,0,0,0,107,0.42857142857142855,0.28763282,2
2020-06-11-170617,170617,0,0,0,107,1.1428571428571428,0.41251704,3
2020-06-12-170617,170617,0,0,0,107,0.14285714285714285,0.080934405,4
2020-06-13-170617,170617,0,3,0,107,0.14285714285714285,0.07737826,5
2020-06-14-170617,170617,0,0,0,107,0.14285714285714285,0.061828356,6
2020-06-15-170617,170617,0,0,0,107,0.2857142857142857,0.17167354,0
2020-06-16-170617,170617,0,0,1,107,0.7142857142857143,0.16754071,1
2020-06-17-170617,170617,0,1,1,107,1.1428571428571428,0.24181986,2
2020-06-18-170617,170617,1,0,0,108,0.7142857142857143,0.3338965,3
2020-06-19-170617,170617,0,0,0,108,0.8571428571428571,0.36013427,4
2020-06-20-170617,170617,0,0,1,108,0.0,9.6943535e-05,5
2020-06-21-170617,170617,0,0,0,108,0.0,0.0010053627,6
2020-06-22-170617,170617,4,0,0,112,0.42857142857142855,0.5367426,0
2020-06-23-170617,170617,0,0,0,112,1.0,0.33020902,1
2020-06-24-170617,170617,0,1,0,112,0.14285714285714285,0.06789033,2
2020-06-25-170617,170617,0,1,0,112,0.14285714285714285,0.045629892,3
2020-06-26-170617,170617,0,0,0,112,0.0,0.02060701,4
2020-06-27-170617,170617,0,0,0,112,0.2857142857142857,0.08494614,5
2020-06-28-170617,170617,0,0,1,112,0.0,0.026368959,6
2020-06-29-170617,170617,0,0,1,112,0.5714285714285714,0.13856088,0
2020-06-30-170617,170617,1,0,1,113,0.2857142857142857,0.14636797,1
2020-07-01-170617,170617,1,0,1,114,0.14285714285714285,0.016224885,2
2020-07-02-170617,170617,0,0,0,114,0.2857142857142857,0.07367834,3
2020-07-03-170617,170617,0,0,0,114,0.2857142857142857,0.09478475,4
2020-07-04-170617,170617,1,0,0,115,0.0,0.0007347794,5
2020-07-05-170617,170617,0,0,0,115,0.0,0.014760417,6
2020-07-06-170617,170617,0,0,0,115,0.7142857142857143,0.15007007,0
2020-07-07-170617,170617,0,0,1,115,0.0,0.017052462,1
2020-07-08-170617,170617,0,0,1,115,0.0,0.0035229654,2
2020-07-09-170617,170617,0,1,0,115,0.14285714285714285,0.016546493,3
2020-07-10-170617,170617,0,0,0,115,0.14285714285714285,0.018118063,4
2020-07-11-170617,170617,0,0,0,115,0.14285714285714285,0.08056617,5
2020-07-12-170617,170617,1,0,0,116,0.2857142857142857,0.23220043,6
2020-07-13-170617,170617,1,0,0,117,0.42857142857142855,0.20994599,0
2020-07-14-170617,170617,1,0,0,118,0.5714285714285714,0.3369719,1
2020-07-15-170617,170617,1,0,1,119,0.0,0.0014597725,2
2020-07-16-170617,170617,0,0,2,119,0.14285714285714285,0.102093376,3
2020-07-17-170617,170617,0,0,0,119,0.42857142857142855,0.08578283,4
2020-07-18-170617,170617,0,0,0,119,0.14285714285714285,0.019248229,5
2020-07-19-170617,170617,0,0,0,119,0.0,0.00013650816,6
2020-07-20-170617,170617,0,0,0,119,0.14285714285714285,0.044898376,0
2020-07-21-170617,170617,1,0,0,120,0.14285714285714285,0.16986804,1
2020-07-22-170617,170617,1,0,0,121,0.5714285714285714,0.21333836,2
2020-07-23-170617,170617,0,0,1,121,0.5714285714285714,0.33112925,3
2020-07-24-170617,170617,0,0,0,121,0.2857142857142857,0.07527908,4
2020-07-25-170617,170617,0,0,0,121,0.0,0.017303182,5
2020-07-26-170617,170617,0,0,0,121,0.2857142857142857,0.09923401,6
2020-07-27-170617,170617,0,0,1,121,0.0,0.0047320426,0
2020-07-28-170617,170617,0,0,1,121,0.5714285714285714,0.2057003,1
2020-07-29-170617,170617,1,0,1,122,0.5714285714285714,0.4065293,2
2020-07-30-170617,170617,2,0,1,124,0.5714285714285714,0.19531778,3
2020-07-31-170617,170617,0,0,0,124,1.2857142857142858,0.27725607,4
2020-08-01-170617,170617,0,0,1,124,1.1428571428571428,0.8737671,5
2020-08-02-170617,170617,0,0,1,124,0.8571428571428571,0.17615348,6
2020-08-03-170617,170617,0,0,0,124,0.8571428571428571,0.19900872,0
2020-08-04-170617,170617,0,0,1,124,1.2857142857142858,0.42028987,1
2020-08-05-170617,170617,0,0,2,124,1.0,0.24717097,2
2020-08-06-170617,170617,1,0,1,125,1.7142857142857142,0.81616586,3
2020-08-07-170617,170617,0,0,1,125,2.142857142857143,0.8281956,4
2020-08-08-170617,170617,0,0,0,125,1.1428571428571428,0.3189483,5
2020-08-09-170617,170617,0,0,0,125,0.5714285714285714,0.06870313,6
2020-08-10-170617,170617,1,0,1,126,2.0,0.5449157,0
2020-08-11-170617,170617,1,0,3,127,1.2857142857142858,0.93353015,1
2020-08-12-170617,170617,1,0,1,128,2.4285714285714284,0.6872892,2
2020-08-13-170617,170617,1,0,2,129,2.7142857142857144,1.0821793,3
2020-08-14-170617,170617,0,0,0,129,1.8571428571428568,0.56999016,4
2020-08-15-170617,170617,1,0,2,130,0.5714285714285714,0.54337424,5
2020-08-16-170617,170617,1,0,0,131,1.0,0.41220102,6
2020-08-17-170617,170617,0,0,1,131,2.7142857142857144,1.0247141,0
2020-08-18-170617,170617,1,0,2,132,2.2857142857142856,0.8904601,1
2020-08-19-170617,170617,2,0,1,134,2.142857142857143,1.4193705,2
2020-08-20-170617,170617,1,0,2,135,4.714285714285714,1.7154245,3
2020-08-21-170617,170617,1,0,1,136,5.285714285714286,1.8656992,4
2020-08-22-170617,170617,0,0,0,136,0.42857142857142855,0.14474429,5
2020-08-23-170617,170617,0,0,0,136,1.0,0.08106082,6
2020-08-24-170617,170617,1,0,0,137,2.142857142857143,0.834202,0
2020-08-25-170617,170617,3,0,2,140,2.7142857142857144,1.1440467,1
2020-08-26-170617,170617,1,0,0,141,2.4285714285714284,0.53628194,2
2020-08-27-170617,170617,2,0,4,143,2.142857142857143,1.0525941,3
2020-08-28-170617,170617,0,0,2,143,2.2857142857142856,0.5633198,4
2020-08-29-170617,170617,2,0,0,145,2.0,0.9701451,5
2020-08-30-170617,170617,0,0,0,145,0.8571428571428571,0.2676115,6
2020-08-31-170617,170617,1,0,0,146,3.0,0.6504094,0
2020-09-01-170617,170617,2,0,0,148,3.1428571428571432,1.4384816,1
2020-09-02-170617,170617,1,0,0,149,3.4285714285714284,1.0019388,2
2020-09-03-170617,170617,2,0,0,151,3.2857142857142856,1.2364846,3
2020-09-04-170617,170617,1,0,0,152,4.0,1.0599661,4
2020-09-05-170617,170617,0,0,0,152,2.571428571428572,0.32662964,5
2020-09-06-170617,170617,0,0,0,152,2.571428571428572,0.67627585,6
2020-09-07-170617,170617,0,0,1,152,5.142857142857143,1.2425988,0
2020-09-08-170617,170617,2,0,3,154,2.2857142857142856,0.6891102,1
2020-09-09-170617,170617,0,0,1,154,3.2857142857142856,0.76926297,2
2020-09-10-170617,170617,4,0,3,158,2.571428571428572,1.5551927,3
2020-09-11-170617,170617,2,0,1,160,3.1428571428571432,1.0298543,4
2020-09-12-170617,170617,0,0,0,160,3.0,0.8592392,5
2020-09-13-170617,170617,0,0,0,160,1.1428571428571428,0.350337,6
2020-09-14-170617,170617,0,0,0,160,8.857142857142858,1.5790888,0
2020-09-15-170617,170617,0,0,0,160,4.142857142857143,0.7689409,1
2020-09-16-170617,170617,0,0,0,160,4.714285714285714,0.74371046,2
2020-09-17-170617,170617,0,0,0,160,6.0,1.7118624,3
2020-09-18-170617,170617,0,0,0,160,9.714285714285714,2.781743,4
2020-09-19-170617,170617,0,0,0,160,3.4285714285714284,1.0880721,5
2020-09-20-170617,170617,0,0,1,160,3.0,0.52541673,6
2020-09-21-170617,170617,1,0,0,161,9.857142857142858,2.0135887,0
2020-09-22-170617,170617,3,0,0,164,7.0,3.075838,1
2020-09-23-170617,170617,1,0,0,165,6.0,1.9420613,2
2020-09-24-170617,170617,3,0,1,168,10.285714285714286,3.5613687,3
2020-09-25-170617,170617,1,0,1,169,11.857142857142858,2.9368224,4
2020-09-26-170617,170617,0,0,1,169,6.571428571428571,1.473328,5
2020-09-27-170617,170617,0,0,0,169,1.2857142857142858,0.47847116,6
2020-09-28-170617,170617,0,0,1,169,5.571428571428571,1.8460248,0
2020-09-29-170617,170617,0,0,1,169,6.0,1.9444441,1
2020-09-30-170617,170617,0,0,1,169,5.571428571428571,1.6543875,2
2020-10-01-170617,170617,0,0,0,169,5.857142857142858,2.019927,3
2020-10-02-170617,170617,0,0,2,169,6.142857142857142,1.5443859,4
2020-10-03-170617,170617,0,1,1,169,1.5714285714285714,0.4028026,5
2020-10-04-170617,170617,1,0,0,170,3.2857142857142856,1.3102523,6
2020-10-05-170617,170617,0,0,4,170,5.285714285714286,1.9107795,0
2020-10-06-170617,170617,0,0,4,170,4.714285714285714,2.0171335,1
2020-10-07-170617,170617,0,0,1,170,5.0,1.7685956,2
2020-10-08-170617,170617,1,0,2,171,3.571428571428572,1.1044086,3
2020-10-09-170617,170617,1,2,2,172,6.0,1.747246,4
2020-10-10-170617,170617,1,0,0,173,2.142857142857143,1.0572859,5
2020-10-11-170617,170617,0,0,1,173,3.1428571428571432,1.3776248,6
2020-10-12-170617,170617,1,0,1,174,2.4285714285714284,0.70839965,0
2020-10-13-170617,170617,1,0,0,175,4.428571428571429,1.5719928,1
2020-10-14-170617,170617,1,0,0,176,5.571428571428571,1.5134183,2
2020-10-15-170617,170617,0,0,2,176,4.0,1.5037727,3
2020-10-16-170617,170617,2,0,3,178,9.571428571428571,2.5638814,4
2020-10-17-170617,170617,1,0,1,179,2.2857142857142856,0.89102054,5
2020-10-18-170617,170617,0,0,2,179,2.7142857142857144,0.7391859,6
2020-10-19-170617,170617,4,0,4,183,6.7142857142857135,2.6262164,0
2020-10-20-170617,170617,4,0,0,187,5.7142857142857135,2.559307,1
2020-10-21-170617,170617,1,0,1,188,6.857142857142858,2.1216986,2
2020-10-22-170617,170617,2,0,0,190,7.857142857142858,2.6922407,3
2020-10-23-170617,170617,2,0,2,192,6.428571428571429,2.336515,4
2020-10-24-170617,170617,0,0,0,192,3.4285714285714284,1.0684916,5
2020-10-25-170617,170617,1,0,0,193,3.0,1.0180358,6
2020-10-26-170617,170617,1,0,0,194,5.428571428571429,1.5071061,0
2020-10-27-170617,170617,0,0,1,194,6.428571428571429,2.1892915,1
2020-10-28-170617,170617,0,0,2,194,6.2857142857142865,2.5952184,2
2020-10-29-170617,170617,2,0,1,196,5.285714285714286,3.1705792,3
2020-10-30-170617,170617,3,0,0,199,6.857142857142858,2.4844096,4
2020-10-31-170617,170617,1,0,0,200,1.2857142857142858,0.7842251,5
2020-11-01-170617,170617,2,1,0,202,2.142857142857143,1.0197812,6
2020-11-02-170617,170617,4,0,0,206,3.7142857142857135,1.6768342,0
2020-11-03-170617,170617,0,0,0,206,5.571428571428571,1.9802047,1
2020-11-04-170617,170617,1,0,0,207,7.142857142857142,2.5734499,2
2020-11-05-170617,170617,0,0,0,207,5.428571428571429,1.2606511,3
2020-11-06-170617,170617,2,0,0,209,5.7142857142857135,1.9287676,4
2020-11-07-170617,170617,0,0,0,209,2.2857142857142856,0.8194384,5
2020-11-08-170617,170617,0,0,0,209,2.4285714285714284,0.46130303,6
2020-11-09-170617,170617,0,0,0,209,5.7142857142857135,1.2249982,0
2020-11-10-170617,170617,1,0,0,210,4.0,1.7667676,1
2020-11-11-170617,170617,2,0,0,212,6.428571428571429,2.388826,2
2020-11-12-170617,170617,1,0,0,213,5.7142857142857135,1.8386297,3
2020-11-13-170617,170617,0,0,0,213,7.0,1.5442404,4
2020-03-01-170618,170618,0,0,1,0,0.0,0.00041871564,6
2020-03-02-170618,170618,0,0,0,0,0.0,0.0015079651,0
2020-03-03-170618,170618,0,0,1,0,0.0,0.0008356847,1
2020-03-04-170618,170618,0,0,0,0,0.0,0.0007277855,2
2020-03-05-170618,170618,0,0,1,0,0.0,0.008432784,3
2020-03-06-170618,170618,0,0,0,0,0.0,0.008132486,4
2020-03-07-170618,170618,0,0,1,0,0.0,0.00039570185,5
2020-03-08-170618,170618,0,0,0,0,0.0,0.0003415948,6
2020-03-09-170618,170618,0,0,1,0,0.0,0.0013512559,0
2020-03-10-170618,170618,0,0,0,0,0.0,0.0034544067,1
2020-03-11-170618,170618,0,0,1,0,0.0,0.012643348,2
2020-03-12-170618,170618,0,0,0,0,0.2,0.13901694,3
2020-03-13-170618,170618,0,0,2,0,0.6,0.28717223,4
2020-03-14-170618,170618,0,0,0,0,0.2,0.033053108,5
2020-03-15-170618,170618,1,0,0,1,1.0,0.11786542,6
2020-03-16-170618,170618,0,0,1,1,4.2,0.3212139,0
2020-03-17-170618,170618,1,0,0,2,3.6,0.64767927,1
2020-03-18-170618,170618,0,0,0,2,5.0,0.7735046,2
2020-03-19-170618,170618,1,0,1,3,4.2,0.73085874,3
2020-03-20-170618,170618,0,0,0,3,4.2,0.25638625,4
2020-03-21-170618,170618,1,0,0,4,1.0,0.09094078,5
2020-03-22-170618,170618,0,0,0,4,0.8,0.053355165,6
2020-03-23-170618,170618,1,0,0,5,6.2,0.65480536,0
2020-03-24-170618,170618,0,0,0,5,5.8,0.4712639,1
2020-03-25-170618,170618,1,0,0,6,5.6,0.44526976,2
2020-03-26-170618,170618,0,1,0,6,4.8,0.3121969,3
2020-03-27-170618,170618,2,0,0,8,3.4,0.42224932,4
2020-03-28-170618,170618,0,0,0,8,2.6,0.14622483,5
2020-03-29-170618,170618,0,0,0,8,2.0,0.1015655,6
2020-03-30-170618,170618,1,0,0,9,4.4,0.5961621,0
2020-03-31-170618,170618,0,0,0,9,3.4,0.3276184,1
2020-04-01-170618,170618,0,0,0,9,2.4,0.13603705,2
2020-04-02-170618,170618,1,0,0,10,6.8,0.50496846,3
2020-04-03-170618,170618,0,0,0,10,4.6,0.4129582,4
2020-04-04-170618,170618,0,0,1,10,1.4,0.058821782,5
2020-04-05-170618,170618,0,0,1,10,1.8,0.09132146,6
2020-04-06-170618,170618,0,0,1,10,3.4,0.30331278,0
2020-04-07-170618,170618,0,0,1,10,4.2,0.36447883,1
2020-04-08-170618,170618,0,0,0,10,2.2,0.10221344,2
2020-04-09-170618,170618,0,0,0,10,0.8,0.07459184,3
2020-04-10-170618,170618,0,1,0,10,1.4,0.13508384,4
2020-04-11-170618,170618,0,0,0,10,2.0,0.05776388,5
2020-04-12-170618,170618,0,0,0,10,1.2,0.08173199,6
2020-04-13-170618,170618,0,0,0,10,4.4,0.27158582,0
2020-04-14-170618,170618,0,0,0,10,0.8,0.25192904,1
2020-04-15-170618,170618,0,0,0,10,2.8,0.32252136,2
2020-04-16-170618,170618,0,0,0,10,0.8,0.14413624,3
2020-04-17-170618,170618,0,0,0,10,0.8,0.047473878,4
2020-04-18-170618,170618,1,0,0,11,1.4,0.1351891,5
2020-04-19-170618,170618,1,0,0,12,0.8,0.08221085,6
2020-04-20-170618,170618,1,0,0,13,5.4,0.61672634,0
2020-04-21-170618,170618,1,0,0,14,1.2,0.17185506,1
2020-04-22-170618,170618,0,0,0,14,0.8,0.056685284,2
2020-04-23-170618,170618,0,0,0,14,1.4,0.11131288,3
2020-04-24-170618,170618,0,0,0,14,0.8,0.050474964,4
2020-04-25-170618,170618,0,0,0,14,0.4,0.018066097,5
2020-04-26-170618,170618,0,0,0,14,0.2,0.0067862505,6
2020-04-27-170618,170618,0,0,0,14,1.4,0.1714527,0
2020-04-28-170618,170618,0,0,0,14,1.6,0.5077455,1
2020-04-29-170618,170618,0,0,0,14,1.2,0.26050198,2
2020-04-30-170618,170618,0,0,0,14,0.6,0.046566986,3
2020-05-01-170618,170618,0,0,0,14,0.6,0.022432862,4
2020-05-02-170618,170618,0,0,0,14,0.4,0.10607801,5
2020-05-03-170618,170618,0,0,0,14,0.2,0.00925858,6
2020-05-04-170618,170618,0,0,0,14,2.8,0.26804754,0
2020-05-05-170618,170618,0,1,0,14,2.2,0.16111417,1
2020-05-06-170618,170618,0,0,0,14,1.8,1.1029358,2
2020-05-07-170618,170618,0,0,0,14,1.0,0.20397411,3
2020-05-08-170618,170618,0,0,0,14,0.4,0.039992657,4
2020-05-09-170618,170618,0,0,0,14,1.8,0.082165636,5
2020-05-10-170618,170618,0,1,0,14,0.4,0.0115266945,6
2020-05-11-170618,170618,0,1,0,14,1.2,0.12500477,0
2020-05-12-170618,170618,0,2,0,14,1.2,0.19088843,1
2020-05-13-170618,170618,0,1,0,14,1.2,0.20491648,2
2020-05-14-170618,170618,0,0,0,14,0.2,0.11473197,3
2020-05-15-170618,170618,0,0,0,14,0.4,0.03700651,4
2020-05-16-170618,170618,0,0,0,14,0.2,0.015147904,5
2020-05-17-170618,170618,0,0,0,14,0.2,0.00818083,6
2020-05-18-170618,170618,0,1,0,14,3.6,0.26383528,0
2020-05-19-170618,170618,0,0,0,14,0.8,0.13410813,1
2020-05-20-170618,170618,0,0,0,14,0.4,0.14792779,2
2020-05-21-170618,170618,0,0,0,14,0.6,0.061420675,3
2020-05-22-170618,170618,0,0,1,14,0.8,0.050603844,4
2020-05-23-170618,170618,0,0,0,14,0.2,0.012368145,5
2020-05-24-170618,170618,0,0,0,14,0.2,0.014996591,6
2020-05-25-170618,170618,0,0,0,14,0.8,0.07059218,0
2020-05-26-170618,170618,0,0,0,14,0.0,0.02268642,1
2020-05-27-170618,170618,0,0,0,14,1.0,0.3394824,2
2020-05-28-170618,170618,0,3,0,14,0.8,0.090192564,3
2020-05-29-170618,170618,0,1,0,14,0.8,0.18813387,4
2020-05-30-170618,170618,0,0,0,14,0.2,0.000641833,5
2020-05-31-170618,170618,0,0,0,14,0.0,0.00011372223,6
2020-06-01-170618,170618,0,0,0,14,0.4,0.11537099,0
2020-06-02-170618,170618,0,0,0,14,0.4,0.052857723,1
2020-06-03-170618,170618,0,0,0,14,0.8,0.25523642,2
2020-06-04-170618,170618,0,0,0,14,1.2,0.10340504,3
2020-06-05-170618,170618,1,1,0,15,0.8,0.21826407,4
2020-06-06-170618,170618,0,3,0,15,0.0,0.0009167358,5
2020-06-07-170618,170618,0,0,0,15,0.0,0.011834866,6
2020-06-08-170618,170618,0,0,0,15,0.2,0.02012198,0
2020-06-09-170618,170618,0,0,0,15,0.0,0.0035007063,1
2020-06-10-170618,170618,0,0,0,15,0.0,0.010983754,2
2020-06-11-170618,170618,0,0,0,15,0.6,0.06597698,3
2020-06-12-170618,170618,0,0,0,15,0.0,0.027798345,4
2020-06-13-170618,170618,0,0,0,15,0.2,0.014537733,5
2020-06-14-170618,170618,0,0,0,15,0.0,0.00047073816,6
2020-06-15-170618,170618,0,0,0,15,0.2,0.01275388,0
2020-06-16-170618,170618,0,0,0,15,0.0,0.0050795395,1
2020-06-17-170618,170618,0,0,0,15,0.0,0.020785563,2
2020-06-18-170618,170618,0,0,0,15,0.0,0.02244597,3
2020-06-19-170618,170618,0,0,0,15,0.4,0.053693827,4
2020-06-20-170618,170618,0,0,0,15,0.0,0.0008563349,5
2020-06-21-170618,170618,0,0,0,15,0.0,0.00023181515,6
2020-06-22-170618,170618,0,0,0,15,0.2,0.095658384,0
2020-06-23-170618,170618,0,0,0,15,0.2,0.047381,1
2020-06-24-170618,170618,0,0,0,15,0.2,0.03522659,2
2020-06-25-170618,170618,0,1,0,15,0.4,0.1620971,3
2020-06-26-170618,170618,0,0,0,15,0.2,0.021839526,4
2020-06-27-170618,170618,0,0,0,15,0.0,0.001106596,5
2020-06-28-170618,170618,0,0,0,15,0.4,0.029610898,6
2020-06-29-170618,170618,0,0,0,15,0.0,0.03075381,0
2020-06-30-170618,170618,0,0,0,15,0.0,0.004646172,1
2020-07-01-170618,170618,0,0,0,15,0.0,0.0019269255,2
2020-07-02-170618,170618,0,0,0,15,0.2,0.021143202,3
2020-07-03-170618,170618,0,0,0,15,0.0,0.022218784,4
2020-07-04-170618,170618,0,0,0,15,0.0,0.00021727821,5
2020-07-05-170618,170618,0,0,0,15,0.4,0.041118316,6
2020-07-06-170618,170618,0,0,0,15,0.0,0.0026849203,0
2020-07-07-170618,170618,0,0,0,15,0.2,0.019524585,1
2020-07-08-170618,170618,0,0,0,15,0.0,0.0002534615,2
2020-07-09-170618,170618,0,0,0,15,0.0,0.0015161418,3
2020-07-10-170618,170618,0,0,0,15,0.0,0.002966774,4
2020-07-11-170618,170618,0,0,0,15,0.0,0.00048689047,5
2020-07-12-170618,170618,0,0,0,15,0.0,0.019300701,6
2020-07-13-170618,170618,0,0,0,15,0.2,0.054718733,0
2020-07-14-170618,170618,0,0,0,15,0.0,0.023966998,1
2020-07-15-170618,170618,0,0,0,15,0.0,0.0004424001,2
2020-07-16-170618,170618,0,0,0,15,0.8,0.18848652,3
2020-07-17-170618,170618,0,0,0,15,0.0,0.002082928,4
2020-07-18-170618,170618,0,0,0,15,0.0,0.0007115662,5
2020-07-19-170618,170618,0,0,0,15,0.0,4.198641e-05,6
2020-07-20-170618,170618,0,0,0,15,0.0,0.0010686041,0
2020-07-21-170618,170618,0,0,0,15,0.2,0.025670776,1
2020-07-22-170618,170618,0,0,0,15,0.0,0.005028348,2
2020-07-23-170618,170618,0,0,0,15,0.4,0.044213872,3
2020-07-24-170618,170618,0,0,1,15,0.4,0.04112593,4
2020-07-25-170618,170618,0,0,1,15,0.2,0.019896902,5
2020-07-26-170618,170618,0,0,0,15,0.0,0.0033395032,6
2020-07-27-170618,170618,0,0,0,15,0.2,0.0010544695,0
2020-07-28-170618,170618,0,0,0,15,0.2,0.038599137,1
2020-07-29-170618,170618,0,0,1,15,0.2,0.14779738,2
2020-07-30-170618,170618,0,0,0,15,0.4,0.004943123,3
2020-07-31-170618,170618,0,0,0,15,0.4,0.0396797,4
2020-08-01-170618,170618,0,0,1,15,0.4,0.0752467,5
2020-08-02-170618,170618,0,0,2,15,0.0,0.0052661193,6
2020-08-03-170618,170618,0,0,1,15,0.4,0.029936083,0
2020-08-04-170618,170618,0,0,0,15,0.2,0.07693286,1
2020-08-05-170618,170618,0,0,0,15,0.0,0.015416859,2
2020-08-06-170618,170618,0,0,1,15,0.2,0.21494013,3
2020-08-07-170618,170618,1,0,1,16,1.2,0.5005669,4
2020-08-08-170618,170618,1,0,1,17,0.4,0.23091252,5
2020-08-09-170618,170618,0,0,0,17,0.6,0.22856402,6
2020-08-10-170618,170618,0,0,2,17,0.6,0.4671807,0
2020-08-11-170618,170618,0,0,1,17,2.8,0.31472552,1
2020-08-12-170618,170618,1,0,1,18,0.8,0.40614146,2
2020-08-13-170618,170618,0,0,1,18,1.6,0.9020994,3
2020-08-14-170618,170618,0,0,2,18,2.2,0.56379855,4
2020-08-15-170618,170618,1,0,11,19,0.6,0.21846925,5
2020-08-16-170618,170618,2,0,1,21,0.8,0.3757997,6
2020-08-17-170618,170618,1,0,6,22,1.8,0.73793375,0
2020-08-18-170618,170618,0,0,11,22,2.8,0.75522107,1
2020-08-19-170618,170618,0,0,11,22,1.6,0.3409941,2
2020-08-20-170618,170618,1,0,7,23,1.8,0.4429605,3
2020-08-21-170618,170618,1,0,0,24,2.0,0.5051914,4
2020-08-22-170618,170618,1,0,8,25,0.4,0.21030642,5
2020-08-23-170618,170618,0,0,5,25,0.8,0.16578114,6
2020-08-24-170618,170618,2,0,10,27,2.4,0.653864,0
2020-08-25-170618,170618,1,0,0,28,1.2,0.7713412,1
2020-08-26-170618,170618,1,0,1,29,1.0,0.99858516,2
2020-08-27-170618,170618,1,0,0,30,2.0,0.50556546,3
2020-08-28-170618,170618,2,0,2,32,0.6,1.014189,4
2020-08-29-170618,170618,11,0,3,43,0.8,1.2020137,5
2020-08-30-170618,170618,1,0,1,44,1.0,0.15428251,6
2020-08-31-170618,170618,6,0,2,50,1.0,0.8225915,0
2020-09-01-170618,170618,11,0,0,61,1.8,1.46949,1
2020-09-02-170618,170618,11,0,0,72,1.2,1.2733591,2
2020-09-03-170618,170618,7,0,2,79,2.2,0.97658575,3
2020-09-04-170618,170618,0,0,0,79,1.4,0.16513558,4
2020-09-05-170618,170618,8,0,1,87,0.4,0.31860813,5
2020-09-06-170618,170618,5,0,1,92,0.0,0.41033584,6
2020-09-07-170618,170618,10,0,0,102,0.2,0.74298126,0
2020-09-08-170618,170618,0,0,1,102,0.8,0.122117594,1
2020-09-09-170618,170618,1,0,1,103,0.8,0.20407046,2
2020-09-10-170618,170618,0,0,0,103,3.2,0.47915873,3
2020-09-11-170618,170618,2,0,0,105,0.8,0.06260672,4
2020-09-12-170618,170618,3,0,1,108,0.0,0.26519582,5
2020-09-13-170618,170618,1,1,0,109,0.4,0.12294714,6
2020-09-14-170618,170618,2,0,0,111,2.4,0.3672765,0
2020-09-15-170618,170618,0,0,0,111,0.6,0.07777466,1
2020-09-16-170618,170618,0,0,1,111,0.2,0.039043527,2
2020-09-17-170618,170618,2,0,1,113,1.0,0.36422202,3
2020-09-18-170618,170618,0,1,0,113,0.4,0.24948253,4
2020-09-19-170618,170618,1,0,0,114,0.4,0.047182765,5
2020-09-20-170618,170618,1,0,0,115,0.8,0.14288948,6
2020-09-21-170618,170618,0,0,0,115,1.4,0.19743143,0
2020-09-22-170618,170618,1,0,0,116,0.6,0.42948997,1
2020-09-23-170618,170618,1,1,0,117,0.4,0.32577282,2
2020-09-24-170618,170618,0,0,0,117,1.4,0.34869257,3
2020-09-25-170618,170618,0,0,0,117,1.4,0.3496794,4
2020-09-26-170618,170618,1,0,0,118,1.0,0.21226577,5
2020-09-27-170618,170618,0,0,0,118,0.4,0.16518193,6
2020-09-28-170618,170618,0,0,0,118,0.8,0.104562886,0
2020-09-29-170618,170618,0,0,3,118,1.2,0.44169235,1
2020-09-30-170618,170618,1,0,1,119,1.8,0.7371268,2
2020-10-01-170618,170618,1,0,0,120,2.4,0.8780081,3
2020-10-02-170618,170618,0,0,0,120,1.6,0.28433374,4
2020-10-03-170618,170618,0,0,0,120,0.6,0.09262687,5
2020-10-04-170618,170618,0,0,3,120,0.4,0.13627344,6
2020-10-05-170618,170618,0,2,2,120,0.8,0.21577115,0
2020-10-06-170618,170618,0,1,1,120,1.6,0.21115884,1
2020-10-07-170618,170618,0,0,0,120,1.8,0.5977183,2
2020-10-08-170618,170618,0,0,5,120,0.6,0.19025104,3
2020-10-09-170618,170618,0,2,0,120,2.2,0.42946383,4
2020-10-10-170618,170618,0,0,0,120,0.4,0.20316555,5
2020-10-11-170618,170618,0,0,0,120,0.8,0.114007816,6
2020-10-12-170618,170618,0,0,1,120,0.6,0.083001256,0
2020-10-13-170618,170618,3,0,0,123,0.6,0.7666591,1
2020-10-14-170618,170618,1,0,1,124,1.4,0.57589203,2
2020-10-15-170618,170618,0,0,0,124,1.0,0.48789537,3
2020-10-16-170618,170618,0,0,0,124,2.0,0.49609953,4
2020-10-17-170618,170618,0,0,0,124,1.2,0.2170966,5
2020-10-18-170618,170618,3,0,0,127,0.6,0.36676404,6
2020-10-19-170618,170618,2,0,0,129,3.0,0.828539,0
2020-10-20-170618,170618,1,0,1,130,1.2,0.43662828,1
2020-10-21-170618,170618,0,0,0,130,1.8,0.4234937,2
2020-10-22-170618,170618,5,0,1,135,2.0,0.77132183,3
2020-10-23-170618,170618,0,0,1,135,3.0,1.3442402,4
2020-10-24-170618,170618,0,0,0,135,0.6,0.22424296,5
2020-10-25-170618,170618,0,0,0,135,0.8,0.28276274,6
2020-10-26-170618,170618,1,0,0,136,3.6,0.6698456,0
2020-10-27-170618,170618,0,0,0,136,3.4,0.7135839,1
2020-10-28-170618,170618,1,1,0,137,4.0,0.9577636,2
2020-10-29-170618,170618,0,0,0,137,2.6,0.8196554,3
2020-10-30-170618,170618,0,0,0,137,1.8,0.6977504,4
2020-10-31-170618,170618,0,0,0,137,2.8,0.46108362,5
2020-11-01-170618,170618,0,0,0,137,1.0,0.14040317,6
2020-11-02-170618,170618,0,1,0,137,0.8,0.102768585,0
2020-11-03-170618,170618,1,0,0,138,2.2,0.6192455,1
2020-11-04-170618,170618,0,0,0,138,3.6,0.56659836,2
2020-11-05-170618,170618,1,0,0,139,2.4,0.56972057,3
2020-11-06-170618,170618,1,0,0,140,4.8,0.9571881,4
2020-11-07-170618,170618,0,1,0,140,1.2,0.16019653,5
2020-11-08-170618,170618,0,1,0,140,2.2,0.24482617,6
2020-11-09-170618,170618,0,0,0,140,3.4,0.44813395,0
2020-11-10-170618,170618,0,0,0,140,1.0,0.17190208,1
2020-11-11-170618,170618,0,0,0,140,2.8,0.41940367,2
2020-11-12-170618,170618,0,0,0,140,2.6,0.40457478,3
2020-11-13-170618,170618,0,0,0,140,3.8,0.36850083,4
2020-03-01-170619,170619,0,0,0,0,0.0,0.0030340506,6
2020-03-02-170619,170619,0,0,1,0,0.16666666666666666,0.06953587,0
2020-03-03-170619,170619,0,1,1,0,0.16666666666666666,0.025690783,1
2020-03-04-170619,170619,0,0,0,0,0.0,0.024370722,2
2020-03-05-170619,170619,0,0,0,0,0.16666666666666666,0.05111338,3
2020-03-06-170619,170619,0,0,1,0,0.16666666666666666,0.052878745,4
2020-03-07-170619,170619,0,0,0,0,0.0,0.00097611547,5
2020-03-08-170619,170619,0,0,0,0,0.0,0.0024413054,6
2020-03-09-170619,170619,0,0,3,0,0.0,0.02371631,0
2020-03-10-170619,170619,0,0,1,0,0.3333333333333333,0.07291736,1
2020-03-11-170619,170619,0,0,2,0,0.16666666666666666,0.079917654,2
2020-03-12-170619,170619,0,0,0,0,0.3333333333333333,0.10961359,3
2020-03-13-170619,170619,0,0,1,0,1.1666666666666667,0.2683364,4
2020-03-14-170619,170619,0,0,0,0,1.3333333333333333,0.28501838,5
2020-03-15-170619,170619,0,0,0,0,2.1666666666666665,0.37130833,6
2020-03-16-170619,170619,1,0,0,1,2.833333333333333,0.7005426,0
2020-03-17-170619,170619,1,0,0,2,4.666666666666667,1.0748281,1
2020-03-18-170619,170619,0,0,0,2,5.0,1.27372,2
2020-03-19-170619,170619,0,0,0,2,4.666666666666667,1.2722241,3
2020-03-20-170619,170619,1,0,0,3,4.666666666666667,1.1875237,4
2020-03-21-170619,170619,0,4,0,3,1.5,0.42489377,5
2020-03-22-170619,170619,0,0,0,3,1.3333333333333333,0.4637233,6
2020-03-23-170619,170619,3,0,0,6,8.833333333333334,2.207536,0
2020-03-24-170619,170619,1,0,0,7,6.333333333333332,1.624118,1
2020-03-25-170619,170619,2,0,0,9,6.833333333333332,2.0981617,2
2020-03-26-170619,170619,0,0,0,9,7.833333333333332,2.1173358,3
2020-03-27-170619,170619,1,0,0,10,5.166666666666667,1.7193757,4
2020-03-28-170619,170619,0,0,0,10,1.3333333333333333,0.2523204,5
2020-03-29-170619,170619,0,0,0,10,2.1666666666666665,0.4275676,6
2020-03-30-170619,170619,0,0,0,10,6.5,1.868558,0
2020-03-31-170619,170619,0,0,1,10,2.6666666666666665,1.2062012,1
2020-04-01-170619,170619,0,0,0,10,3.333333333333333,1.234374,2
2020-04-02-170619,170619,0,0,1,10,6.166666666666668,1.4022161,3
2020-04-03-170619,170619,0,0,0,10,3.5,0.8718493,4
2020-04-04-170619,170619,0,0,1,10,1.5,0.27900606,5
2020-04-05-170619,170619,0,0,0,10,0.6666666666666666,0.21867351,6
2020-04-06-170619,170619,0,1,1,10,3.0,0.98382485,0
2020-04-07-170619,170619,0,0,0,10,1.5,0.5891217,1
2020-04-08-170619,170619,0,0,0,10,1.8333333333333333,0.60494864,2
2020-04-09-170619,170619,0,1,0,10,1.3333333333333333,0.25430468,3
2020-04-10-170619,170619,0,0,0,10,1.8333333333333333,0.2884514,4
2020-04-11-170619,170619,0,0,0,10,0.16666666666666666,0.12265794,5
2020-04-12-170619,170619,0,0,0,10,0.3333333333333333,0.095882,6
2020-04-13-170619,170619,0,0,0,10,3.0,0.9584653,0
2020-04-14-170619,170619,1,0,3,11,2.1666666666666665,0.923232,1
2020-04-15-170619,170619,0,0,0,11,2.0,0.86319005,2
2020-04-16-170619,170619,1,0,0,12,1.0,0.5164541,3
2020-04-17-170619,170619,0,0,0,12,1.0,0.44380343,4
2020-04-18-170619,170619,1,0,0,13,2.1666666666666665,0.4599648,5
2020-04-19-170619,170619,0,0,0,13,0.5,0.13560322,6
2020-04-20-170619,170619,1,1,0,14,4.666666666666667,0.9996317,0
2020-04-21-170619,170619,0,0,0,14,2.0,0.63794595,1
2020-04-22-170619,170619,0,0,1,14,2.333333333333333,0.60079384,2
2020-04-23-170619,170619,0,0,0,14,1.0,0.2118382,3
2020-04-24-170619,170619,0,1,0,14,1.1666666666666667,0.384991,4
2020-04-25-170619,170619,0,0,0,14,1.0,0.19131699,5
2020-04-26-170619,170619,0,0,0,14,1.8333333333333333,0.17850822,6
2020-04-27-170619,170619,0,0,1,14,2.5,0.59943974,0
2020-04-28-170619,170619,3,0,0,17,1.5,0.7376073,1
2020-04-29-170619,170619,0,0,0,17,1.5,0.57406294,2
2020-04-30-170619,170619,0,0,0,17,0.5,0.35090637,3
2020-05-01-170619,170619,0,0,0,17,1.8333333333333333,0.2348374,4
2020-05-02-170619,170619,0,0,0,17,1.0,0.33353272,5
2020-05-03-170619,170619,0,0,0,17,0.5,0.08792752,6
2020-05-04-170619,170619,0,0,0,17,3.333333333333333,1.3318838,0
2020-05-05-170619,170619,0,0,0,17,1.8333333333333333,0.629283,1
2020-05-06-170619,170619,1,0,1,18,1.0,2.1856055,2
2020-05-07-170619,170619,0,0,0,18,1.6666666666666667,0.99411386,3
2020-05-08-170619,170619,0,0,0,18,0.5,0.47370046,4
2020-05-09-170619,170619,0,0,0,18,0.16666666666666666,0.09747892,5
2020-05-10-170619,170619,0,0,0,18,0.0,0.025706567,6
2020-05-11-170619,170619,1,1,0,19,2.6666666666666665,0.6245307,0
2020-05-12-170619,170619,0,3,0,19,1.6666666666666667,0.3998251,1
2020-05-13-170619,170619,0,0,0,19,1.5,0.35621497,2
2020-05-14-170619,170619,0,0,0,19,0.8333333333333334,0.2752346,3
2020-05-15-170619,170619,0,0,0,19,0.6666666666666666,0.20539895,4
2020-05-16-170619,170619,0,0,0,19,0.0,0.0056536957,5
2020-05-17-170619,170619,0,0,0,19,0.0,0.023397533,6
2020-05-18-170619,170619,0,0,0,19,1.6666666666666667,0.40945244,0
2020-05-19-170619,170619,0,0,1,19,0.5,0.30061895,1
2020-05-20-170619,170619,1,0,0,20,1.0,0.28400144,2
2020-05-21-170619,170619,0,0,0,20,0.16666666666666666,0.17818029,3
2020-05-22-170619,170619,0,0,0,20,0.3333333333333333,0.23527615,4
2020-05-23-170619,170619,0,0,0,20,0.16666666666666666,0.041430473,5
2020-05-24-170619,170619,0,0,1,20,0.16666666666666666,0.104564026,6
2020-05-25-170619,170619,0,0,0,20,0.3333333333333333,0.15567473,0
2020-05-26-170619,170619,0,0,0,20,0.6666666666666666,0.16334747,1
2020-05-27-170619,170619,0,0,0,20,1.1666666666666667,0.3519913,2
2020-05-28-170619,170619,0,0,0,20,0.8333333333333334,0.30937067,3
2020-05-29-170619,170619,0,0,0,20,1.3333333333333333,0.37398702,4
2020-05-30-170619,170619,0,1,0,20,0.0,0.0046285843,5
2020-05-31-170619,170619,0,0,0,20,0.0,0.0015422615,6
2020-06-01-170619,170619,0,0,0,20,1.0,0.3884506,0
2020-06-02-170619,170619,1,0,0,21,0.3333333333333333,0.32686692,1
2020-06-03-170619,170619,0,0,1,21,0.5,0.20771337,2
2020-06-04-170619,170619,0,0,1,21,1.1666666666666667,0.31881976,3
2020-06-05-170619,170619,0,0,0,21,2.1666666666666665,0.5740384,4
2020-06-06-170619,170619,0,2,0,21,0.0,0.062308088,5
2020-06-07-170619,170619,1,1,0,22,0.16666666666666666,0.1051306,6
2020-06-08-170619,170619,0,0,0,22,0.3333333333333333,0.06838593,0
2020-06-09-170619,170619,0,0,1,22,0.3333333333333333,0.119147725,1
2020-06-10-170619,170619,0,0,0,22,0.3333333333333333,0.14417866,2
2020-06-11-170619,170619,0,0,0,22,0.3333333333333333,0.13847896,3
2020-06-12-170619,170619,0,0,0,22,0.16666666666666666,0.08253643,4
2020-06-13-170619,170619,0,0,0,22,0.0,0.03288335,5
2020-06-14-170619,170619,0,0,0,22,0.0,0.027813328,6
2020-06-15-170619,170619,0,1,2,22,0.5,0.07970622,0
2020-06-16-170619,170619,0,0,0,22,0.3333333333333333,0.15650778,1
2020-06-17-170619,170619,1,0,0,23,0.5,0.20087378,2
2020-06-18-170619,170619,1,0,0,24,0.5,0.27800098,3
2020-06-19-170619,170619,0,0,1,24,0.6666666666666666,0.21880111,4
2020-06-20-170619,170619,0,0,0,24,0.0,0.0017688962,5
2020-06-21-170619,170619,0,0,0,24,0.0,0.0024350425,6
2020-06-22-170619,170619,0,0,0,24,1.1666666666666667,0.29829952,0
2020-06-23-170619,170619,1,0,0,25,0.8333333333333334,0.29713726,1
2020-06-24-170619,170619,0,0,0,25,0.0,0.054031126,2
2020-06-25-170619,170619,0,0,0,25,0.3333333333333333,0.10024353,3
2020-06-26-170619,170619,0,0,0,25,0.0,0.03362801,4
2020-06-27-170619,170619,0,0,0,25,0.0,0.007126486,5
2020-06-28-170619,170619,0,0,1,25,0.0,0.017169956,6
2020-06-29-170619,170619,2,0,0,27,0.16666666666666666,0.25635406,0
2020-06-30-170619,170619,0,0,1,27,0.5,0.11013134,1
2020-07-01-170619,170619,0,0,0,27,0.3333333333333333,0.03215735,2
2020-07-02-170619,170619,0,0,0,27,0.0,0.049290605,3
2020-07-03-170619,170619,1,0,0,28,0.0,0.1089763,4
2020-07-04-170619,170619,0,0,0,28,0.16666666666666666,0.0012983697,5
2020-07-05-170619,170619,0,0,0,28,0.0,0.01726835,6
2020-07-06-170619,170619,0,0,0,28,0.16666666666666666,0.044041913,0
2020-07-07-170619,170619,0,0,0,28,0.0,0.020309452,1
2020-07-08-170619,170619,0,0,0,28,0.0,0.006063235,2
2020-07-09-170619,170619,0,1,0,28,0.16666666666666666,0.038990993,3
2020-07-10-170619,170619,0,0,0,28,0.16666666666666666,0.03177815,4
2020-07-11-170619,170619,0,0,0,28,0.0,0.029539516,5
2020-07-12-170619,170619,1,0,0,29,0.16666666666666666,0.1834098,6
2020-07-13-170619,170619,0,0,0,29,0.5,0.12615705,0
2020-07-14-170619,170619,1,0,1,30,0.3333333333333333,0.21994783,1
2020-07-15-170619,170619,0,0,0,30,0.16666666666666666,0.0030977656,2
2020-07-16-170619,170619,0,0,0,30,0.5,0.15690711,3
2020-07-17-170619,170619,0,0,0,30,0.0,0.012584008,4
2020-07-18-170619,170619,0,0,0,30,0.0,0.038559586,5
2020-07-19-170619,170619,0,0,0,30,0.0,0.0012091309,6
2020-07-20-170619,170619,0,0,0,30,0.0,0.012512141,0
2020-07-21-170619,170619,0,0,0,30,0.16666666666666666,0.08953834,1
2020-07-22-170619,170619,0,0,0,30,0.3333333333333333,0.12692557,2
2020-07-23-170619,170619,0,0,0,30,0.16666666666666666,0.051290844,3
2020-07-24-170619,170619,0,0,2,30,0.0,0.023619229,4
2020-07-25-170619,170619,0,0,0,30,0.0,0.009801249,5
2020-07-26-170619,170619,0,0,0,30,0.16666666666666666,0.011928751,6
2020-07-27-170619,170619,0,0,0,30,0.0,0.012859698,0
2020-07-28-170619,170619,1,0,0,31,0.0,0.1334306,1
2020-07-29-170619,170619,0,0,0,31,0.5,0.17942898,2
2020-07-30-170619,170619,0,0,0,31,0.6666666666666666,0.13429561,3
2020-07-31-170619,170619,0,0,0,31,1.5,0.19324131,4
2020-08-01-170619,170619,0,0,0,31,1.1666666666666667,0.34980923,5
2020-08-02-170619,170619,0,0,0,31,0.3333333333333333,0.14557731,6
2020-08-03-170619,170619,0,0,1,31,0.3333333333333333,0.10810522,0
2020-08-04-170619,170619,0,0,0,31,0.8333333333333334,0.25936595,1
2020-08-05-170619,170619,0,0,0,31,0.6666666666666666,0.27282813,2
2020-08-06-170619,170619,0,0,1,31,1.0,0.4047384,3
2020-08-07-170619,170619,2,0,0,33,1.8333333333333333,0.73901635,4
2020-08-08-170619,170619,0,0,1,33,0.6666666666666666,0.35584557,5
2020-08-09-170619,170619,0,0,0,33,0.16666666666666666,0.15750256,6
2020-08-10-170619,170619,0,0,2,33,3.1666666666666665,0.74193037,0
2020-08-11-170619,170619,0,0,2,33,1.3333333333333333,0.65124977,1
2020-08-12-170619,170619,0,0,1,33,2.1666666666666665,0.79211664,2
2020-08-13-170619,170619,0,0,0,33,1.5,0.8107497,3
2020-08-14-170619,170619,0,0,1,33,0.8333333333333334,0.5647392,4
2020-08-15-170619,170619,0,0,1,33,0.16666666666666666,0.20262256,5
2020-08-16-170619,170619,0,0,0,33,1.0,0.34490266,6
2020-08-17-170619,170619,1,0,0,34,1.5,0.71995336,0
2020-08-18-170619,170619,0,0,0,34,2.5,0.7560539,1
2020-08-19-170619,170619,0,0,1,34,1.1666666666666667,0.64960253,2
2020-08-20-170619,170619,1,0,0,35,2.0,0.9340169,3
2020-08-21-170619,170619,0,0,0,35,1.8333333333333333,0.92094547,4
2020-08-22-170619,170619,1,0,0,36,0.16666666666666666,0.25040826,5
2020-08-23-170619,170619,0,0,0,36,1.1666666666666667,0.18271121,6
2020-08-24-170619,170619,2,0,0,38,1.6666666666666667,0.83691883,0
2020-08-25-170619,170619,2,0,0,40,1.8333333333333333,1.0394807,1
2020-08-26-170619,170619,1,0,0,41,1.6666666666666667,0.8526716,2
2020-08-27-170619,170619,0,0,0,41,1.6666666666666667,0.6629159,3
2020-08-28-170619,170619,1,0,0,42,1.3333333333333333,0.7295863,4
2020-08-29-170619,170619,1,0,0,43,1.3333333333333333,0.6837031,5
2020-08-30-170619,170619,0,0,1,43,0.3333333333333333,0.18725091,6
2020-08-31-170619,170619,0,0,0,43,2.333333333333333,0.8490337,0
2020-09-01-170619,170619,0,0,0,43,3.6666666666666665,1.2635411,1
2020-09-02-170619,170619,1,0,0,44,2.833333333333333,0.83317906,2
2020-09-03-170619,170619,0,0,1,44,2.6666666666666665,1.1102257,3
2020-09-04-170619,170619,0,0,1,44,3.0,0.82191765,4
2020-09-05-170619,170619,0,0,0,44,2.1666666666666665,0.54769933,5
2020-09-06-170619,170619,0,0,0,44,0.8333333333333334,0.62135404,6
2020-09-07-170619,170619,0,0,4,44,3.6666666666666665,0.9597168,0
2020-09-08-170619,170619,0,0,5,44,2.6666666666666665,0.6907282,1
2020-09-09-170619,170619,0,0,0,44,1.6666666666666667,0.45325217,2
2020-09-10-170619,170619,0,0,1,44,2.0,0.88441026,3
2020-09-11-170619,170619,0,0,1,44,3.333333333333333,0.91425663,4
2020-09-12-170619,170619,0,0,1,44,0.3333333333333333,0.5554607,5
2020-09-13-170619,170619,1,0,0,45,0.3333333333333333,0.33803442,6
2020-09-14-170619,170619,0,0,0,45,5.0,1.1240562,0
2020-09-15-170619,170619,0,0,2,45,2.6666666666666665,0.491871,1
2020-09-16-170619,170619,0,0,0,45,2.333333333333333,0.5360419,2
2020-09-17-170619,170619,1,0,2,46,2.5,0.8193947,3
2020-09-18-170619,170619,1,0,0,47,2.833333333333333,1.5144033,4
2020-09-19-170619,170619,0,0,0,47,0.16666666666666666,0.63974345,5
2020-09-20-170619,170619,0,0,0,47,1.6666666666666667,0.48018828,6
2020-09-21-170619,170619,4,0,2,51,5.833333333333332,1.3294871,0
2020-09-22-170619,170619,5,0,1,56,1.8333333333333333,1.559452,1
2020-09-23-170619,170619,0,0,0,56,3.0,1.2435405,2
2020-09-24-170619,170619,1,0,0,57,4.0,1.5500556,3
2020-09-25-170619,170619,1,0,1,58,4.0,1.2432652,4
2020-09-26-170619,170619,1,0,0,59,1.5,0.7151866,5
2020-09-27-170619,170619,0,0,0,59,1.1666666666666667,0.38038757,6
2020-09-28-170619,170619,0,0,0,59,0.8333333333333334,0.8127831,0
2020-09-29-170619,170619,2,0,4,61,4.0,1.0451133,1
2020-09-30-170619,170619,0,0,6,61,2.0,1.0275671,2
2020-10-01-170619,170619,2,0,0,63,2.5,1.1088089,3
2020-10-02-170619,170619,0,0,5,63,2.6666666666666665,0.7726508,4
2020-10-03-170619,170619,0,0,0,63,0.8333333333333334,0.31429577,5
2020-10-04-170619,170619,0,0,0,63,1.0,0.59664005,6
2020-10-05-170619,170619,2,0,7,65,1.3333333333333333,1.1818625,0
2020-10-06-170619,170619,1,0,4,66,3.8333333333333335,1.3055056,1
2020-10-07-170619,170619,0,1,1,66,3.0,1.2988716,2
2020-10-08-170619,170619,0,0,1,66,1.1666666666666667,0.61931896,3
2020-10-09-170619,170619,1,0,3,67,1.8333333333333333,1.0788789,4
2020-10-10-170619,170619,0,0,0,67,0.6666666666666666,0.5246052,5
2020-10-11-170619,170619,0,0,0,67,0.8333333333333334,0.6032517,6
2020-10-12-170619,170619,0,0,6,67,1.5,0.43767476,0
2020-10-13-170619,170619,4,0,5,71,2.0,1.2243844,1
2020-10-14-170619,170619,6,0,2,77,3.0,1.2452394,2
2020-10-15-170619,170619,0,0,10,77,1.6666666666666667,0.96035236,3
2020-10-16-170619,170619,5,0,2,82,4.0,1.6202438,4
2020-10-17-170619,170619,0,0,0,82,1.5,0.48641118,5
2020-10-18-170619,170619,0,0,1,82,1.5,0.42402327,6
2020-10-19-170619,170619,7,0,1,89,2.6666666666666665,1.595162,0
2020-10-20-170619,170619,4,0,0,93,3.1666666666666665,1.5393696,1
2020-10-21-170619,170619,1,0,1,94,4.0,1.4311297,2
2020-10-22-170619,170619,1,0,0,95,4.5,1.8584303,3
2020-10-23-170619,170619,3,0,2,98,2.333333333333333,1.5939339,4
2020-10-24-170619,170619,0,0,0,98,1.8333333333333333,0.6338709,5
2020-10-25-170619,170619,0,0,0,98,2.833333333333333,0.8038064,6
2020-10-26-170619,170619,6,0,0,104,2.833333333333333,1.2581434,0
2020-10-27-170619,170619,5,0,0,109,1.8333333333333333,1.4054734,1
2020-10-28-170619,170619,2,0,0,111,2.6666666666666665,1.474271,2
2020-10-29-170619,170619,10,0,0,121,2.0,2.1994102,3
2020-10-30-170619,170619,2,0,0,123,3.1666666666666665,1.4586868,4
2020-10-31-170619,170619,0,0,0,123,0.3333333333333333,0.37618124,5
2020-11-01-170619,170619,1,0,0,124,0.8333333333333334,0.5391,6
2020-11-02-170619,170619,1,0,0,125,1.5,0.6858866,0
2020-11-03-170619,170619,0,0,0,125,3.0,1.08869,1
2020-11-04-170619,170619,1,0,0,126,2.833333333333333,1.5136057,2
2020-11-05-170619,170619,0,0,0,126,2.6666666666666665,1.0438029,3
2020-11-06-170619,170619,2,1,0,128,2.6666666666666665,1.3957283,4
2020-11-07-170619,170619,0,0,0,128,1.0,0.439869,5
2020-11-08-170619,170619,0,0,0,128,1.0,0.45479992,6
2020-11-09-170619,170619,0,0,0,128,3.8333333333333335,1.2266006,0
2020-11-10-170619,170619,0,0,0,128,1.5,0.9556328,1
2020-11-11-170619,170619,0,0,0,128,1.5,1.1367365,2
2020-11-12-170619,170619,0,0,0,128,2.0,0.8380097,3
2020-11-13-170619,170619,0,0,0,128,1.0,0.6761282,4
2020-03-01-170620,170620,0,0,0,0,0.0,0.00017311846,6
2020-03-02-170620,170620,0,0,0,0,0.25,0.06805444,0
2020-03-03-170620,170620,0,0,0,0,0.0,0.0014811109,1
2020-03-04-170620,170620,0,0,0,0,0.0,0.0017673342,2
2020-03-05-170620,170620,0,0,0,0,0.25,0.0414553,3
2020-03-06-170620,170620,0,0,1,0,0.25,0.04310613,4
2020-03-07-170620,170620,0,0,0,0,0.0,0.00026138042,5
2020-03-08-170620,170620,0,0,1,0,0.0,0.00020709752,6
2020-03-09-170620,170620,0,0,0,0,0.0,0.0012315682,0
2020-03-10-170620,170620,0,0,2,0,0.0,0.0053826803,1
2020-03-11-170620,170620,0,0,1,0,0.25,0.04388407,2
2020-03-12-170620,170620,0,0,0,0,0.25,0.07937081,3
2020-03-13-170620,170620,0,0,0,0,0.75,0.14120288,4
2020-03-14-170620,170620,0,0,0,0,1.0,0.10883161,5
2020-03-15-170620,170620,0,0,0,0,0.75,0.101044774,6
2020-03-16-170620,170620,0,0,0,0,2.5,0.2925502,0
2020-03-17-170620,170620,0,0,0,0,2.25,0.36192194,1
2020-03-18-170620,170620,0,0,1,0,2.5,0.4909033,2
2020-03-19-170620,170620,0,0,1,0,2.75,0.5219739,3
2020-03-20-170620,170620,1,0,0,1,4.5,0.58816,4
2020-03-21-170620,170620,0,0,0,1,1.0,0.10843222,5
2020-03-22-170620,170620,1,0,2,2,2.25,0.16495655,6
2020-03-23-170620,170620,0,2,2,2,8.25,0.9491957,0
2020-03-24-170620,170620,2,0,0,4,4.5,0.6210694,1
2020-03-25-170620,170620,1,0,1,5,4.25,0.7127838,2
2020-03-26-170620,170620,0,0,0,5,5.5,0.86422,3
2020-03-27-170620,170620,0,0,0,5,7.25,0.903446,4
2020-03-28-170620,170620,0,0,0,5,2.0,0.17198175,5
2020-03-29-170620,170620,0,0,0,5,2.5,0.22803825,6
2020-03-30-170620,170620,0,0,0,5,4.75,0.5457899,0
2020-03-31-170620,170620,0,0,0,5,4.25,0.5461644,1
2020-04-01-170620,170620,1,0,0,6,4.25,0.50306857,2
2020-04-02-170620,170620,1,0,0,7,4.0,0.4338458,3
2020-04-03-170620,170620,0,0,0,7,3.75,0.3876919,4
2020-04-04-170620,170620,0,0,0,7,2.75,0.22285728,5
2020-04-05-170620,170620,2,0,0,9,1.5,0.09864324,6
2020-04-06-170620,170620,2,0,1,11,5.5,0.5467418,0
2020-04-07-170620,170620,0,0,0,11,6.75,0.58578825,1
2020-04-08-170620,170620,1,0,0,12,2.5,0.34087557,2
2020-04-09-170620,170620,0,0,0,12,5.75,0.39526257,3
2020-04-10-170620,170620,0,0,2,12,2.0,0.19108857,4
2020-04-11-170620,170620,0,0,0,12,0.75,0.08069754,5
2020-04-12-170620,170620,0,0,0,12,2.0,0.11600231,6
2020-04-13-170620,170620,0,0,0,12,4.75,0.48889303,0
2020-04-14-170620,170620,0,0,0,12,4.5,0.44272912,1
2020-04-15-170620,170620,0,0,0,12,2.5,0.37859023,2
2020-04-16-170620,170620,0,0,0,12,1.5,0.19851097,3
2020-04-17-170620,170620,0,0,0,12,2.5,0.29788452,4
2020-04-18-170620,170620,0,0,0,12,0.75,0.1077608,5
2020-04-19-170620,170620,0,0,0,12,0.25,0.02566654,6
2020-04-20-170620,170620,1,0,0,13,1.75,0.28528446,0
2020-04-21-170620,170620,0,0,0,13,1.75,0.3361171,1
2020-04-22-170620,170620,0,0,0,13,1.5,0.20143788,2
2020-04-23-170620,170620,0,0,0,13,1.75,0.15722431,3
2020-04-24-170620,170620,2,0,0,15,1.5,0.15884851,4
2020-04-25-170620,170620,0,0,0,15,0.5,0.038028058,5
2020-04-26-170620,170620,0,0,0,15,0.25,0.01950439,6
2020-04-27-170620,170620,0,0,1,15,1.75,0.24209298,0
2020-04-28-170620,170620,0,0,0,15,2.0,0.25892264,1
2020-04-29-170620,170620,0,0,0,15,1.25,0.16694611,2
2020-04-30-170620,170620,0,0,0,15,2.0,0.26273328,3
2020-05-01-170620,170620,0,0,0,15,0.75,0.07461969,4
2020-05-02-170620,170620,0,0,0,15,1.0,0.11902748,5
2020-05-03-170620,170620,0,0,0,15,0.5,0.070615456,6
2020-05-04-170620,170620,0,0,0,15,2.25,0.4434666,0
2020-05-05-170620,170620,0,0,0,15,1.5,0.2684452,1
2020-05-06-170620,170620,0,0,0,15,21.5,2.2889683,2
2020-05-07-170620,170620,0,0,0,15,8.0,0.887327,3
2020-05-08-170620,170620,0,0,0,15,2.25,0.4362267,4
2020-05-09-170620,170620,0,1,0,15,0.0,0.015058486,5
2020-05-10-170620,170620,0,0,0,15,0.0,0.0052638296,6
2020-05-11-170620,170620,1,4,0,16,3.0,0.36963367,0
2020-05-12-170620,170620,0,2,0,16,2.0,0.20277151,1
2020-05-13-170620,170620,0,0,0,16,3.0,0.32867345,2
2020-05-14-170620,170620,0,0,0,16,1.75,0.27209687,3
2020-05-15-170620,170620,0,0,0,16,0.25,0.0481993,4
2020-05-16-170620,170620,0,0,0,16,0.0,0.002014742,5
2020-05-17-170620,170620,0,0,0,16,0.0,0.003181966,6
2020-05-18-170620,170620,0,0,0,16,0.0,0.0737423,0
2020-05-19-170620,170620,0,0,0,16,0.25,0.123280674,1
2020-05-20-170620,170620,0,0,0,16,0.0,0.060026567,2
2020-05-21-170620,170620,0,0,0,16,1.25,0.20205513,3
2020-05-22-170620,170620,0,0,0,16,0.75,0.1621678,4
2020-05-23-170620,170620,0,0,0,16,0.0,0.020808456,5
2020-05-24-170620,170620,0,0,0,16,0.25,0.047084454,6
2020-05-25-170620,170620,0,0,0,16,0.5,0.09137057,0
2020-05-26-170620,170620,0,0,0,16,0.25,0.07298212,1
2020-05-27-170620,170620,0,0,0,16,0.5,0.14587408,2
2020-05-28-170620,170620,0,7,3,16,0.75,0.1543322,3
2020-05-29-170620,170620,0,0,0,16,1.75,0.3336,4
2020-05-30-170620,170620,0,0,0,16,0.25,0.034262765,5
2020-05-31-170620,170620,0,0,0,16,0.0,0.0001271382,6
2020-06-01-170620,170620,0,0,0,16,0.75,0.1932712,0
2020-06-02-170620,170620,0,0,0,16,0.5,0.09313285,1
2020-06-03-170620,170620,0,0,0,16,1.25,0.18463369,2
2020-06-04-170620,170620,0,0,0,16,1.25,0.19963805,3
2020-06-05-170620,170620,0,0,1,16,0.5,0.16853665,4
2020-06-06-170620,170620,0,1,0,16,0.0,0.008369703,5
2020-06-07-170620,170620,0,0,0,16,0.0,0.004890045,6
2020-06-08-170620,170620,0,0,0,16,0.25,0.042935092,0
2020-06-09-170620,170620,0,0,0,16,1.0,0.17402494,1
2020-06-10-170620,170620,0,0,0,16,0.0,0.07895365,2
2020-06-11-170620,170620,3,0,0,19,1.0,0.18571557,3
2020-06-12-170620,170620,0,0,0,19,0.0,0.02936449,4
2020-06-13-170620,170620,0,0,0,19,0.0,0.023499435,5
2020-06-14-170620,170620,0,1,0,19,0.0,0.020776065,6
2020-06-15-170620,170620,0,0,0,19,0.25,0.04200867,0
2020-06-16-170620,170620,0,0,0,19,0.0,0.04236531,1
2020-06-17-170620,170620,0,0,0,19,0.75,0.101683974,2
2020-06-18-170620,170620,0,0,0,19,0.25,0.10047073,3
2020-06-19-170620,170620,1,0,0,20,0.25,0.09933853,4
2020-06-20-170620,170620,0,0,0,20,0.0,1.3217112e-05,5
2020-06-21-170620,170620,0,0,0,20,0.0,0.0002889329,6
2020-06-22-170620,170620,0,0,3,20,1.25,0.20889333,0
2020-06-23-170620,170620,0,0,0,20,0.25,0.0643233,1
2020-06-24-170620,170620,0,0,0,20,0.0,0.046157297,2
2020-06-25-170620,170620,0,0,0,20,0.0,0.007162789,3
2020-06-26-170620,170620,0,0,0,20,0.0,0.006806313,4
2020-06-27-170620,170620,0,0,0,20,0.5,0.08532878,5
2020-06-28-170620,170620,0,0,0,20,0.0,0.0060964604,6
2020-06-29-170620,170620,0,0,0,20,0.0,0.019563515,0
2020-06-30-170620,170620,0,0,1,20,0.25,0.053249475,1
2020-07-01-170620,170620,0,0,0,20,0.25,0.0023441222,2
2020-07-02-170620,170620,0,0,0,20,0.25,0.04534032,3
2020-07-03-170620,170620,0,0,0,20,0.25,0.04450007,4
2020-07-04-170620,170620,0,0,0,20,0.25,0.00014699835,5
2020-07-05-170620,170620,0,0,0,20,0.0,0.0037886545,6
2020-07-06-170620,170620,3,0,1,23,0.25,0.08327163,0
2020-07-07-170620,170620,0,0,0,23,0.0,0.003921955,1
2020-07-08-170620,170620,0,0,0,23,0.0,0.0011451002,2
2020-07-09-170620,170620,0,0,3,23,0.0,0.0023632732,3
2020-07-10-170620,170620,0,0,0,23,0.0,0.0031999822,4
2020-07-11-170620,170620,0,0,0,23,0.0,0.026545137,5
2020-07-12-170620,170620,0,0,0,23,0.25,0.07320317,6
2020-07-13-170620,170620,0,0,0,23,0.25,0.06299864,0
2020-07-14-170620,170620,1,0,0,24,0.25,0.11252027,1
2020-07-15-170620,170620,0,0,0,24,0.25,0.0006965917,2
2020-07-16-170620,170620,0,0,0,24,0.25,0.047166508,3
2020-07-17-170620,170620,0,0,0,24,0.75,0.08405156,4
2020-07-18-170620,170620,0,0,0,24,0.0,0.004644348,5
2020-07-19-170620,170620,0,0,1,24,0.0,4.2551446e-06,6
2020-07-20-170620,170620,1,0,1,25,0.0,0.021918898,0
2020-07-21-170620,170620,0,0,1,25,0.25,0.06656379,1
2020-07-22-170620,170620,0,0,1,25,0.5,0.1058346,2
2020-07-23-170620,170620,3,0,0,28,0.75,0.12688668,3
2020-07-24-170620,170620,0,0,0,28,0.5,0.04791969,4
2020-07-25-170620,170620,0,0,0,28,0.0,0.0033985204,5
2020-07-26-170620,170620,0,0,0,28,0.5,0.051844418,6
2020-07-27-170620,170620,0,0,2,28,0.0,0.001604966,0
2020-07-28-170620,170620,0,0,1,28,0.75,0.15001224,1
2020-07-29-170620,170620,0,0,0,28,0.75,0.14655942,2
2020-07-30-170620,170620,0,0,2,28,1.0,0.06766145,3
2020-07-31-170620,170620,0,0,1,28,0.25,0.06452786,4
2020-08-01-170620,170620,0,0,0,28,1.25,0.27416733,5
2020-08-02-170620,170620,1,0,0,29,0.25,0.08623506,6
2020-08-03-170620,170620,1,0,0,30,0.75,0.12007211,0
2020-08-04-170620,170620,1,0,0,31,0.5,0.14238478,1
2020-08-05-170620,170620,1,0,0,32,0.25,0.07032799,2
2020-08-06-170620,170620,0,0,1,32,1.0,0.45323166,3
2020-08-07-170620,170620,0,0,0,32,1.25,0.32824004,4
2020-08-08-170620,170620,0,0,0,32,0.25,0.07862992,5
2020-08-09-170620,170620,0,0,1,32,0.0,0.012796741,6
2020-08-10-170620,170620,2,0,0,34,1.75,0.30767933,0
2020-08-11-170620,170620,1,0,0,35,1.0,0.28866795,1
2020-08-12-170620,170620,0,0,1,35,0.25,0.19227278,2
2020-08-13-170620,170620,2,1,2,37,1.75,0.50403714,3
2020-08-14-170620,170620,1,0,1,38,0.75,0.19989105,4
2020-08-15-170620,170620,0,0,0,38,1.25,0.2315995,5
2020-08-16-170620,170620,0,0,1,38,0.25,0.15067911,6
2020-08-17-170620,170620,0,0,0,38,1.75,0.5186618,0
2020-08-18-170620,170620,0,0,0,38,1.25,0.44276616,1
2020-08-19-170620,170620,0,0,0,38,0.75,0.7008569,2
2020-08-20-170620,170620,1,0,1,39,2.5,0.85771656,3
2020-08-21-170620,170620,0,0,3,39,4.75,0.9768094,4
2020-08-22-170620,170620,0,0,0,39,0.0,0.035478026,5
2020-08-23-170620,170620,1,0,0,40,0.0,0.019056076,6
2020-08-24-170620,170620,0,0,4,40,0.25,0.24875662,0
2020-08-25-170620,170620,0,0,0,40,1.5,0.44357255,1
2020-08-26-170620,170620,1,0,0,41,0.5,0.13746947,2
2020-08-27-170620,170620,2,0,0,43,1.0,0.4551776,3
2020-08-28-170620,170620,1,0,0,44,0.25,0.24027179,4
2020-08-29-170620,170620,0,0,1,44,1.25,0.408922,5
2020-08-30-170620,170620,1,0,2,45,0.5,0.11128312,6
2020-08-31-170620,170620,0,0,5,45,1.25,0.27971137,0
2020-09-01-170620,170620,0,0,1,45,1.75,0.45374343,1
2020-09-02-170620,170620,0,0,4,45,1.0,0.3800016,2
2020-09-03-170620,170620,1,0,5,46,1.0,0.41974097,3
2020-09-04-170620,170620,3,0,20,49,1.5,0.4685084,4
2020-09-05-170620,170620,0,0,2,49,0.25,0.09729166,5
2020-09-06-170620,170620,0,0,3,49,0.25,0.20478302,6
2020-09-07-170620,170620,4,0,18,53,0.25,0.3920642,0
2020-09-08-170620,170620,0,0,5,53,1.0,0.18638799,1
2020-09-09-170620,170620,0,0,0,53,2.5,0.3536179,2
2020-09-10-170620,170620,0,0,5,53,1.5,0.484688,3
2020-09-11-170620,170620,0,0,28,53,1.5,0.3598501,4
2020-09-12-170620,170620,1,0,24,54,1.5,0.3761876,5
2020-09-13-170620,170620,2,0,1,56,0.0,0.09914382,6
2020-09-14-170620,170620,5,0,1,61,2.75,0.67621183,0
2020-09-15-170620,170620,1,0,3,62,1.25,0.3591601,1
2020-09-16-170620,170620,4,0,1,66,2.0,0.43023375,2
2020-09-17-170620,170620,5,0,1,71,3.0,0.7598857,3
2020-09-18-170620,170620,20,0,1,91,6.0,0.9385661,4
2020-09-19-170620,170620,2,0,1,93,1.5,0.45677105,5
2020-09-20-170620,170620,3,0,0,96,1.25,0.21515979,6
2020-09-21-170620,170620,18,0,1,114,1.5,0.78131986,0
2020-09-22-170620,170620,5,0,0,119,4.25,1.0910602,1
2020-09-23-170620,170620,0,0,0,119,1.75,0.59722877,2
2020-09-24-170620,170620,5,0,0,124,5.75,1.3644881,3
2020-09-25-170620,170620,28,0,2,152,2.75,1.0707223,4
2020-09-26-170620,170620,24,0,0,176,1.0,0.654003,5
2020-09-27-170620,170620,1,0,1,177,0.5,0.15180817,6
2020-09-28-170620,170620,1,0,0,178,2.0,0.8000338,0
2020-09-29-170620,170620,3,0,0,181,1.25,0.6915099,1
2020-09-30-170620,170620,1,0,0,182,2.5,0.61158305,2
2020-10-01-170620,170620,1,0,0,183,3.75,0.9016974,3
2020-10-02-170620,170620,1,0,4,184,2.0,0.5796281,4
2020-10-03-170620,170620,1,0,0,185,0.5,0.17759924,5
2020-10-04-170620,170620,0,1,1,185,2.0,0.4476529,6
2020-10-05-170620,170620,1,0,0,186,1.0,0.675154,0
2020-10-06-170620,170620,0,0,0,186,1.0,0.66285104,1
2020-10-07-170620,170620,0,0,0,186,5.5,0.91571957,2
2020-10-08-170620,170620,0,0,0,186,3.25,0.5582661,3
2020-10-09-170620,170620,2,0,0,188,3.75,0.77947134,4
2020-10-10-170620,170620,0,0,0,188,0.25,0.32489678,5
2020-10-11-170620,170620,1,0,0,189,1.0,0.5497703,6
2020-10-12-170620,170620,0,0,4,189,0.75,0.2926808,0
2020-10-13-170620,170620,0,0,0,189,1.0,0.5692964,1
2020-10-14-170620,170620,0,0,0,189,1.0,0.47487262,2
2020-10-15-170620,170620,0,0,0,189,2.5,0.58970994,3
2020-10-16-170620,170620,4,0,1,193,2.0,0.8622238,4
2020-10-17-170620,170620,0,0,0,193,1.0,0.35368127,5
2020-10-18-170620,170620,1,0,0,194,1.5,0.31880206,6
2020-10-19-170620,170620,0,0,0,194,4.5,1.1431465,0
2020-10-20-170620,170620,0,0,1,194,2.25,0.9411679,1
2020-10-21-170620,170620,0,0,1,194,2.5,0.7278687,2
2020-10-22-170620,170620,0,0,1,194,1.25,0.87030596,3
2020-10-23-170620,170620,0,0,0,194,3.75,0.9264265,4
2020-10-24-170620,170620,0,0,1,194,1.75,0.41003692,5
2020-10-25-170620,170620,0,0,0,194,1.75,0.43700936,6
2020-10-26-170620,170620,4,0,1,198,1.5,0.56884617,0
2020-10-27-170620,170620,0,0,0,198,4.75,0.96847135,1
2020-10-28-170620,170620,0,0,2,198,2.0,0.9079893,2
2020-10-29-170620,170620,0,1,0,198,2.25,1.1017702,3
2020-10-30-170620,170620,1,0,1,199,6.25,1.0404762,4
2020-10-31-170620,170620,0,0,0,199,1.0,0.2979505,5
2020-11-01-170620,170620,0,1,0,199,1.75,0.42303544,6
2020-11-02-170620,170620,0,0,0,199,4.0,0.81287116,0
2020-11-03-170620,170620,1,0,0,200,2.0,0.6956587,1
2020-11-04-170620,170620,1,0,0,201,5.0,0.9828941,2
2020-11-05-170620,170620,1,0,0,202,2.5,0.5231537,3
2020-11-06-170620,170620,0,0,0,202,3.0,0.74647576,4
2020-11-07-170620,170620,1,0,0,203,0.75,0.2877815,5
2020-11-08-170620,170620,0,0,0,203,1.25,0.22765747,6
2020-11-09-170620,170620,1,0,0,204,1.5,0.39823824,0
2020-11-10-170620,170620,0,0,0,204,3.0,0.59994936,1
2020-11-11-170620,170620,2,0,0,206,6.25,1.1069173,2
2020-11-12-170620,170620,0,0,0,206,3.5,0.8756926,3
2020-11-13-170620,170620,1,0,0,207,7.0,1.0142117,4
2020-03-01-170621,170621,0,0,0,0,0.0,0.0071800556,6
2020-03-02-170621,170621,0,0,0,0,0.0,0.012397883,0
2020-03-03-170621,170621,0,0,2,0,0.0,0.008264979,1
2020-03-04-170621,170621,0,0,1,0,0.0,0.007999107,2
2020-03-05-170621,170621,0,0,2,0,0.0,0.0009099934,3
2020-03-06-170621,170621,0,0,2,0,0.0,0.0038834247,4
2020-03-07-170621,170621,0,0,1,0,0.0,0.006526431,5
2020-03-08-170621,170621,0,0,0,0,0.16666666666666666,0.028324803,6
2020-03-09-170621,170621,0,0,5,0,0.0,0.020338433,0
2020-03-10-170621,170621,0,0,2,0,0.0,0.021288658,1
2020-03-11-170621,170621,0,0,7,0,0.6666666666666666,0.1628845,2
2020-03-12-170621,170621,0,0,2,0,0.0,0.058032326,3
2020-03-13-170621,170621,0,0,4,0,0.8333333333333334,0.16978477,4
2020-03-14-170621,170621,0,0,1,0,0.5,0.1470642,5
2020-03-15-170621,170621,0,0,0,0,2.5,0.62664527,6
2020-03-16-170621,170621,0,0,5,0,4.166666666666667,0.96870273,0
2020-03-17-170621,170621,2,0,3,2,4.333333333333333,1.387817,1
2020-03-18-170621,170621,1,0,1,3,3.1666666666666665,1.0415868,2
2020-03-19-170621,170621,2,0,4,5,6.0,1.8241752,3
2020-03-20-170621,170621,2,0,2,7,6.666666666666668,2.067644,4
2020-03-21-170621,170621,1,0,0,8,2.333333333333333,0.61056817,5
2020-03-22-170621,170621,0,0,1,8,3.333333333333333,0.61182404,6
2020-03-23-170621,170621,5,0,14,13,14.333333333333336,4.0442624,0
2020-03-24-170621,170621,2,0,2,15,8.5,2.5658185,1
2020-03-25-170621,170621,7,0,1,22,8.833333333333334,3.9480727,2
2020-03-26-170621,170621,2,0,0,24,7.5,2.5103364,3
2020-03-27-170621,170621,4,0,6,28,11.0,3.1708207,4
2020-03-28-170621,170621,1,0,1,29,1.8333333333333333,0.48918837,5
2020-03-29-170621,170621,0,0,0,29,2.333333333333333,0.6491789,6
2020-03-30-170621,170621,5,0,6,34,9.666666666666666,2.9137032,0
2020-03-31-170621,170621,3,0,2,37,6.0,2.1944177,1
2020-04-01-170621,170621,1,0,6,38,7.166666666666668,1.8110778,2
2020-04-02-170621,170621,4,0,0,42,2.833333333333333,1.3005475,3
2020-04-03-170621,170621,2,0,2,44,5.166666666666667,1.8623441,4
2020-04-04-170621,170621,0,0,1,44,1.1666666666666667,0.26379412,5
2020-04-05-170621,170621,1,0,0,45,0.8333333333333334,0.36938605,6
2020-04-06-170621,170621,14,0,1,59,5.5,3.9249563,0
2020-04-07-170621,170621,2,0,10,61,8.666666666666666,2.2260094,1
2020-04-08-170621,170621,1,0,0,62,4.5,1.0518992,2
2020-04-09-170621,170621,0,1,1,62,1.3333333333333333,0.6073807,3
2020-04-10-170621,170621,6,0,3,68,3.333333333333333,1.8594719,4
2020-04-11-170621,170621,1,0,1,69,1.5,0.5969114,5
2020-04-12-170621,170621,0,0,0,69,3.5,0.5576115,6
2020-04-13-170621,170621,6,0,1,75,2.6666666666666665,1.8994309,0
2020-04-14-170621,170621,2,0,1,77,7.833333333333332,2.1179445,1
2020-04-15-170621,170621,6,0,2,83,2.833333333333333,1.6525525,2
2020-04-16-170621,170621,0,0,2,83,2.833333333333333,0.6173714,3
2020-04-17-170621,170621,2,0,0,85,4.666666666666667,1.2951657,4
2020-04-18-170621,170621,1,0,0,86,1.5,0.5124909,5
2020-04-19-170621,170621,0,0,0,86,0.3333333333333333,0.103753574,6
2020-04-20-170621,170621,1,0,1,87,2.5,0.7815134,0
2020-04-21-170621,170621,10,0,1,97,5.666666666666668,3.516701,1
2020-04-22-170621,170621,0,0,1,97,5.333333333333333,1.151978,2
2020-04-23-170621,170621,1,0,9,98,0.6666666666666666,0.3747507,3
2020-04-24-170621,170621,3,0,1,101,2.6666666666666665,1.2359701,4
2020-04-25-170621,170621,1,0,0,102,0.8333333333333334,0.38419932,5
2020-04-26-170621,170621,0,0,0,102,0.3333333333333333,0.062032312,6
2020-04-27-170621,170621,1,0,2,103,2.5,0.8930266,0
2020-04-28-170621,170621,1,0,1,104,2.1666666666666665,0.6304121,1
2020-04-29-170621,170621,2,0,0,106,2.5,0.95961356,2
2020-04-30-170621,170621,2,0,1,108,2.333333333333333,0.98416644,3
2020-05-01-170621,170621,0,0,1,108,2.1666666666666665,0.39530814,4
2020-05-02-170621,170621,0,0,0,108,0.16666666666666666,0.080193624,5
2020-05-03-170621,170621,0,0,0,108,0.6666666666666666,0.11869961,6
2020-05-04-170621,170621,1,0,1,109,2.833333333333333,1.1219366,0
2020-05-05-170621,170621,1,0,0,110,1.6666666666666667,0.70747554,1
2020-05-06-170621,170621,1,0,2,111,0.6666666666666666,0.795486,2
2020-05-07-170621,170621,9,0,1,120,2.1666666666666665,2.8735259,3
2020-05-08-170621,170621,1,0,0,121,3.1666666666666665,1.1891116,4
2020-05-09-170621,170621,0,0,1,121,1.0,0.29669863,5
2020-05-10-170621,170621,0,0,0,121,0.3333333333333333,0.03694869,6
2020-05-11-170621,170621,2,0,1,123,2.333333333333333,0.7827768,0
2020-05-12-170621,170621,1,10,0,124,4.666666666666667,1.2904477,1
2020-05-13-170621,170621,0,0,0,124,3.333333333333333,0.67999715,2
2020-05-14-170621,170621,1,1,1,125,0.5,0.33938628,3
2020-05-15-170621,170621,1,0,1,126,2.333333333333333,0.6527636,4
2020-05-16-170621,170621,0,3,0,126,0.16666666666666666,0.030357802,5
2020-05-17-170621,170621,0,0,0,126,0.0,0.0006606987,6
2020-05-18-170621,170621,1,0,0,127,1.0,0.48395833,0
2020-05-19-170621,170621,0,0,1,127,1.5,0.40014842,1
2020-05-20-170621,170621,2,0,1,129,1.0,0.6442265,2
2020-05-21-170621,170621,1,0,2,130,0.8333333333333334,0.50143737,3
2020-05-22-170621,170621,0,0,1,130,1.1666666666666667,0.54727095,4
2020-05-23-170621,170621,1,0,0,131,0.0,0.2028073,5
2020-05-24-170621,170621,0,0,0,131,0.0,0.0043169027,6
2020-05-25-170621,170621,1,0,0,132,2.1666666666666665,0.70908743,0
2020-05-26-170621,170621,0,0,0,132,0.6666666666666666,0.1828051,1
2020-05-27-170621,170621,0,1,0,132,0.5,0.136003,2
2020-05-28-170621,170621,1,3,0,133,0.8333333333333334,0.47630745,3
2020-05-29-170621,170621,1,0,1,134,0.8333333333333334,0.22897248,4
2020-05-30-170621,170621,0,0,0,134,0.0,0.03591676,5
2020-05-31-170621,170621,0,0,0,134,0.0,0.0016143537,6
2020-06-01-170621,170621,0,1,0,134,1.0,0.28489128,0
2020-06-02-170621,170621,1,0,0,135,0.6666666666666666,0.3821604,1
2020-06-03-170621,170621,1,0,0,136,1.0,0.30680242,2
2020-06-04-170621,170621,2,0,0,138,0.3333333333333333,0.50316685,3
2020-06-05-170621,170621,1,0,1,139,0.3333333333333333,0.4581425,4
2020-06-06-170621,170621,0,0,0,139,0.0,0.013746685,5
2020-06-07-170621,170621,0,0,0,139,0.0,0.0038885977,6
2020-06-08-170621,170621,0,0,0,139,0.5,0.14980364,0
2020-06-09-170621,170621,0,0,0,139,0.8333333333333334,0.12589681,1
2020-06-10-170621,170621,0,0,1,139,0.16666666666666666,0.04879639,2
2020-06-11-170621,170621,0,0,0,139,1.0,0.18905823,3
2020-06-12-170621,170621,1,0,0,140,0.3333333333333333,0.3507596,4
2020-06-13-170621,170621,0,0,0,140,0.0,0.0015586652,5
2020-06-14-170621,170621,0,1,1,140,0.0,0.00080848706,6
2020-06-15-170621,170621,0,0,0,140,0.0,0.024799516,0
2020-06-16-170621,170621,0,0,1,140,0.6666666666666666,0.1556602,1
2020-06-17-170621,170621,0,2,0,140,0.16666666666666666,0.06773916,2
2020-06-18-170621,170621,0,0,0,140,0.3333333333333333,0.10175333,3
2020-06-19-170621,170621,1,0,0,141,0.3333333333333333,0.38050085,4
2020-06-20-170621,170621,0,0,0,141,0.0,0.0013884776,5
2020-06-21-170621,170621,0,0,1,141,0.0,0.0026631905,6
2020-06-22-170621,170621,0,0,0,141,0.5,0.11770683,0
2020-06-23-170621,170621,0,0,0,141,0.3333333333333333,0.135914,1
2020-06-24-170621,170621,1,0,0,142,0.0,0.22925945,2
2020-06-25-170621,170621,0,1,0,142,0.3333333333333333,0.099191844,3
2020-06-26-170621,170621,0,0,0,142,0.6666666666666666,0.15887152,4
2020-06-27-170621,170621,0,0,0,142,0.16666666666666666,0.032307953,5
2020-06-28-170621,170621,1,0,0,143,0.0,0.22226205,6
2020-06-29-170621,170621,0,0,0,143,0.3333333333333333,0.09059953,0
2020-06-30-170621,170621,1,0,0,144,0.0,0.22959688,1
2020-07-01-170621,170621,0,0,0,144,0.16666666666666666,0.038894422,2
2020-07-02-170621,170621,0,0,0,144,0.0,0.016843922,3
2020-07-03-170621,170621,0,0,0,144,0.5,0.10160267,4
2020-07-04-170621,170621,0,0,0,144,0.16666666666666666,0.04115554,5
2020-07-05-170621,170621,1,0,0,145,0.0,0.17864808,6
2020-07-06-170621,170621,0,0,0,145,0.0,0.018088082,0
2020-07-07-170621,170621,0,0,0,145,0.0,0.013988494,1
2020-07-08-170621,170621,0,0,0,145,0.0,0.017143091,2
2020-07-09-170621,170621,0,0,0,145,0.0,0.031093651,3
2020-07-10-170621,170621,0,0,0,145,0.3333333333333333,0.08987678,4
2020-07-11-170621,170621,0,0,0,145,0.0,0.0021626628,5
2020-07-12-170621,170621,0,0,0,145,0.0,0.011411568,6
2020-07-13-170621,170621,0,0,0,145,0.3333333333333333,0.097069256,0
2020-07-14-170621,170621,0,0,0,145,0.5,0.106628746,1
2020-07-15-170621,170621,0,0,0,145,0.0,0.008172968,2
2020-07-16-170621,170621,0,0,0,145,0.3333333333333333,0.07911125,3
2020-07-17-170621,170621,0,0,0,145,0.16666666666666666,0.04681321,4
2020-07-18-170621,170621,0,0,0,145,0.0,0.013532323,5
2020-07-19-170621,170621,0,0,0,145,0.0,0.0024648912,6
2020-07-20-170621,170621,0,0,3,145,0.3333333333333333,0.049051646,0
2020-07-21-170621,170621,0,0,0,145,0.16666666666666666,0.026417453,1
2020-07-22-170621,170621,0,0,1,145,0.6666666666666666,0.09846648,2
2020-07-23-170621,170621,0,0,2,145,0.0,0.013808697,3
2020-07-24-170621,170621,0,0,4,145,0.0,0.022518303,4
2020-07-25-170621,170621,0,0,0,145,0.0,0.0032124396,5
2020-07-26-170621,170621,0,0,0,145,0.0,0.0032696945,6
2020-07-27-170621,170621,0,0,1,145,0.5,0.11035992,0
2020-07-28-170621,170621,0,0,1,145,0.16666666666666666,0.050149705,1
2020-07-29-170621,170621,0,0,0,145,0.16666666666666666,0.064624704,2
2020-07-30-170621,170621,0,0,1,145,0.16666666666666666,0.69211006,3
2020-07-31-170621,170621,0,0,1,145,0.3333333333333333,0.09721602,4
2020-08-01-170621,170621,0,0,0,145,0.3333333333333333,0.099193506,5
2020-08-02-170621,170621,0,0,0,145,0.3333333333333333,0.13730326,6
2020-08-03-170621,170621,3,0,1,148,1.1666666666666667,0.8120626,0
2020-08-04-170621,170621,0,0,0,148,0.3333333333333333,0.1798118,1
2020-08-05-170621,170621,1,0,2,149,0.8333333333333334,0.5044839,2
2020-08-06-170621,170621,2,1,1,151,0.3333333333333333,0.4582933,3
2020-08-07-170621,170621,4,1,1,155,0.16666666666666666,1.0226009,4
2020-08-08-170621,170621,0,0,0,155,0.5,0.19220144,5
2020-08-09-170621,170621,0,1,0,155,0.0,0.044222675,6
2020-08-10-170621,170621,1,0,4,156,0.5,0.40866864,0
2020-08-11-170621,170621,1,0,0,157,0.3333333333333333,0.49595174,1
2020-08-12-170621,170621,0,0,2,157,0.6666666666666666,0.38625473,2
2020-08-13-170621,170621,1,0,3,158,1.1666666666666667,0.50622827,3
2020-08-14-170621,170621,1,0,4,159,0.6666666666666666,0.34212464,4
2020-08-15-170621,170621,0,0,0,159,0.3333333333333333,0.0981366,5
2020-08-16-170621,170621,0,0,0,159,1.0,0.2718526,6
2020-08-17-170621,170621,1,0,5,160,0.6666666666666666,0.4864317,0
2020-08-18-170621,170621,0,0,1,160,1.0,0.5043048,1
2020-08-19-170621,170621,2,0,1,162,0.3333333333333333,0.47066334,2
2020-08-20-170621,170621,1,0,0,163,2.0,0.933799,3
2020-08-21-170621,170621,1,0,4,164,0.5,0.5703285,4
2020-08-22-170621,170621,0,0,0,164,0.3333333333333333,0.15586337,5
2020-08-23-170621,170621,0,0,0,164,2.6666666666666665,0.44628364,6
2020-08-24-170621,170621,4,0,2,168,2.6666666666666665,1.3503816,0
2020-08-25-170621,170621,0,0,1,168,1.6666666666666667,0.5882112,1
2020-08-26-170621,170621,2,0,0,170,2.0,1.1810465,2
2020-08-27-170621,170621,3,0,2,173,1.1666666666666667,1.1895545,3
2020-08-28-170621,170621,4,1,1,177,1.3333333333333333,1.4265978,4
2020-08-29-170621,170621,0,0,0,177,0.5,0.33937773,5
2020-08-30-170621,170621,0,0,2,177,0.8333333333333334,0.19769824,6
2020-08-31-170621,170621,5,0,2,182,1.5,2.0923393,0
2020-09-01-170621,170621,1,0,2,183,1.3333333333333333,0.8076123,1
2020-09-02-170621,170621,1,0,2,184,0.8333333333333334,0.6434024,2
2020-09-03-170621,170621,0,0,0,184,2.5,0.75457007,3
2020-09-04-170621,170621,4,0,2,188,3.5,1.1448822,4
2020-09-05-170621,170621,0,0,0,188,1.0,0.29885995,5
2020-09-06-170621,170621,0,0,0,188,0.16666666666666666,0.46693182,6
2020-09-07-170621,170621,2,0,1,190,1.5,0.94894236,0
2020-09-08-170621,170621,1,0,0,191,0.3333333333333333,0.4841327,1
2020-09-09-170621,170621,0,0,3,191,0.8333333333333334,0.29505372,2
2020-09-10-170621,170621,2,0,2,193,0.8333333333333334,0.8954606,3
2020-09-11-170621,170621,1,0,0,194,2.833333333333333,1.8674937,4
2020-09-12-170621,170621,0,0,1,194,1.5,0.4330866,5
2020-09-13-170621,170621,2,0,1,196,0.0,0.4743866,6
2020-09-14-170621,170621,2,0,2,198,3.333333333333333,1.3218238,0
2020-09-15-170621,170621,2,0,4,200,3.8333333333333335,1.0558532,1
2020-09-16-170621,170621,2,0,4,202,1.1666666666666667,1.3665094,2
2020-09-17-170621,170621,0,0,2,202,2.333333333333333,0.72392094,3
2020-09-18-170621,170621,2,0,2,204,2.833333333333333,1.9365499,4
2020-09-19-170621,170621,0,0,1,204,1.6666666666666667,0.784208,5
2020-09-20-170621,170621,0,0,1,204,1.0,0.64898217,6
2020-09-21-170621,170621,1,0,1,205,1.5,1.1737279,0
2020-09-22-170621,170621,0,0,3,205,4.5,0.8940726,1
2020-09-23-170621,170621,3,0,2,208,3.333333333333333,1.3601975,2
2020-09-24-170621,170621,2,0,5,210,2.1666666666666665,1.4042884,3
2020-09-25-170621,170621,0,0,5,210,3.1666666666666665,0.9481634,4
2020-09-26-170621,170621,1,0,2,211,2.0,0.5836275,5
2020-09-27-170621,170621,1,0,0,212,0.0,0.44301233,6
2020-09-28-170621,170621,2,0,0,214,2.833333333333333,1.0648111,0
2020-09-29-170621,170621,4,0,5,218,0.6666666666666666,1.0317636,1
2020-09-30-170621,170621,4,0,0,222,2.833333333333333,1.6254417,2
2020-10-01-170621,170621,2,0,2,224,1.0,0.84415096,3
2020-10-02-170621,170621,2,0,3,226,2.0,0.93213147,4
2020-10-03-170621,170621,1,0,1,227,1.6666666666666667,0.7446469,5
2020-10-04-170621,170621,1,0,1,228,1.5,0.4015396,6
2020-10-05-170621,170621,1,0,1,229,10.166666666666666,2.6703017,0
2020-10-06-170621,170621,3,3,1,232,1.6666666666666667,1.1822711,1
2020-10-07-170621,170621,2,0,2,234,3.6666666666666665,2.2696278,2
2020-10-08-170621,170621,5,0,1,239,3.0,1.3984603,3
2020-10-09-170621,170621,5,1,2,244,2.833333333333333,1.9419959,4
2020-10-10-170621,170621,2,0,0,246,1.1666666666666667,0.6227169,5
2020-10-11-170621,170621,0,0,0,246,1.3333333333333333,0.43264177,6
2020-10-12-170621,170621,0,0,2,246,0.6666666666666666,0.6557848,0
2020-10-13-170621,170621,5,0,0,251,1.6666666666666667,1.3554556,1
2020-10-14-170621,170621,0,0,2,251,2.5,0.8710736,2
2020-10-15-170621,170621,2,0,2,253,3.6666666666666665,1.7601348,3
2020-10-16-170621,170621,3,0,2,256,6.333333333333332,2.7855022,4
2020-10-17-170621,170621,1,0,0,257,2.1666666666666665,0.7482359,5
2020-10-18-170621,170621,1,0,2,258,1.6666666666666667,0.86264044,6
2020-10-19-170621,170621,1,0,0,259,3.8333333333333335,1.4362475,0
2020-10-20-170621,170621,1,0,3,260,5.166666666666667,1.9151489,1
2020-10-21-170621,170621,2,0,0,262,5.666666666666668,2.67233,2
2020-10-22-170621,170621,1,0,3,263,4.5,2.2742531,3
2020-10-23-170621,170621,2,0,1,265,6.666666666666668,2.1694646,4
2020-10-24-170621,170621,0,0,0,265,2.333333333333333,0.5472973,5
2020-10-25-170621,170621,0,0,0,265,2.0,0.51622844,6
2020-10-26-170621,170621,2,0,0,267,5.166666666666667,1.5878764,0
2020-10-27-170621,170621,0,0,0,267,6.333333333333332,1.7971263,1
2020-10-28-170621,170621,2,0,1,269,4.5,1.656502,2
2020-10-29-170621,170621,2,0,2,271,4.5,1.903262,3
2020-10-30-170621,170621,2,0,0,273,7.666666666666668,2.0555167,4
2020-10-31-170621,170621,0,0,0,273,3.5,0.7600942,5
2020-11-01-170621,170621,2,0,0,275,2.1666666666666665,0.9225319,6
2020-11-02-170621,170621,0,0,0,275,1.8333333333333333,0.4175927,0
2020-11-03-170621,170621,3,1,0,278,5.833333333333332,2.0875032,1
2020-11-04-170621,170621,0,1,0,278,3.0,1.4527804,2
2020-11-05-170621,170621,3,1,0,281,5.166666666666667,1.9233173,3
2020-11-06-170621,170621,1,1,0,282,2.6666666666666665,1.5282891,4
2020-11-07-170621,170621,0,2,0,282,2.1666666666666665,0.37895066,5
2020-11-08-170621,170621,0,0,0,282,1.8333333333333333,0.3862196,6
2020-11-09-170621,170621,0,0,0,282,3.5,1.1319445,0
2020-11-10-170621,170621,0,0,0,282,2.5,0.9618709,1
2020-11-11-170621,170621,1,1,0,283,3.6666666666666665,1.045359,2
2020-11-12-170621,170621,2,0,0,285,1.3333333333333333,1.0938236,3
2020-11-13-170621,170621,0,0,0,285,3.333333333333333,0.80512094,4
2020-03-01-170622,170622,0,0,14,0,0.08333333333333333,0.02659339,6
2020-03-02-170622,170622,0,0,16,0,0.16666666666666666,0.03783065,0
2020-03-03-170622,170622,0,1,21,0,0.16666666666666666,0.13150474,1
2020-03-04-170622,170622,0,0,9,0,0.08333333333333333,0.1265549,2
2020-03-05-170622,170622,0,0,27,0,0.08333333333333333,0.017233571,3
2020-03-06-170622,170622,0,0,26,0,0.3333333333333333,0.017497968,4
2020-03-07-170622,170622,0,1,6,0,0.0,0.007656416,5
2020-03-08-170622,170622,1,0,13,1,0.0,0.10159642,6
2020-03-09-170622,170622,0,0,49,1,0.3333333333333333,0.13388696,0
2020-03-10-170622,170622,0,0,36,1,0.5,0.42616448,1
2020-03-11-170622,170622,1,0,37,2,1.1666666666666667,0.48429185,2
2020-03-12-170622,170622,0,0,30,2,0.75,0.11967184,3
2020-03-13-170622,170622,1,0,37,3,2.1666666666666665,0.8720686,4
2020-03-14-170622,170622,3,0,4,6,2.583333333333333,0.90820706,5
2020-03-15-170622,170622,14,0,10,20,6.833333333333332,2.4927027,6
2020-03-16-170622,170622,16,0,22,36,12.333333333333336,4.553337,0
2020-03-17-170622,170622,21,0,28,57,12.833333333333336,5.8386307,1
2020-03-18-170622,170622,9,0,35,66,13.75,4.3543367,2
2020-03-19-170622,170622,27,0,10,93,13.333333333333336,6.5177016,3
2020-03-20-170622,170622,26,0,22,119,17.166666666666668,7.0408144,4
2020-03-21-170622,170622,6,0,5,125,7.666666666666668,2.21837,5
2020-03-22-170622,170622,13,0,4,138,7.166666666666668,2.1424558,6
2020-03-23-170622,170622,49,0,28,187,25.5,13.980409,0
2020-03-24-170622,170622,36,0,47,223,21.83333333333333,9.445118,1
2020-03-25-170622,170622,37,0,20,260,21.75,12.420229,2
2020-03-26-170622,170622,30,0,6,290,19.58333333333333,8.745804,3
2020-03-27-170622,170622,37,0,12,327,20.5,9.953912,4
2020-03-28-170622,170622,4,0,7,331,6.083333333333332,1.5213869,5
2020-03-29-170622,170622,10,0,20,341,6.333333333333332,2.0165467,6
2020-03-30-170622,170622,22,0,14,363,18.916666666666668,9.473746,0
2020-03-31-170622,170622,28,0,44,391,11.083333333333336,6.208239,1
2020-04-01-170622,170622,35,0,9,426,11.583333333333336,6.447966,2
2020-04-02-170622,170622,10,0,9,436,8.333333333333334,3.977817,3
2020-04-03-170622,170622,22,0,16,458,10.916666666666664,5.288109,4
2020-04-04-170622,170622,5,0,9,463,3.1666666666666665,0.90035677,5
2020-04-05-170622,170622,4,0,1,467,4.166666666666667,1.1969384,6
2020-04-06-170622,170622,28,0,12,495,11.666666666666664,8.721866,0
2020-04-07-170622,170622,47,0,31,542,6.333333333333332,5.87125,1
2020-04-08-170622,170622,20,0,27,562,7.416666666666668,3.6737583,2
2020-04-09-170622,170622,6,4,4,568,4.5,1.7760664,3
2020-04-10-170622,170622,12,0,11,580,5.833333333333332,3.4647849,4
2020-04-11-170622,170622,7,0,4,587,1.75,1.3888798,5
2020-04-12-170622,170622,20,0,1,607,2.1666666666666665,1.5716431,6
2020-04-13-170622,170622,14,0,9,621,9.0,5.3427243,0
2020-04-14-170622,170622,44,0,8,665,5.5,6.9234657,1
2020-04-15-170622,170622,9,0,13,674,5.583333333333332,4.4631925,2
2020-04-16-170622,170622,9,0,11,683,6.166666666666668,2.1957047,3
2020-04-17-170622,170622,16,0,11,699,5.833333333333332,3.6386263,4
2020-04-18-170622,170622,9,0,1,708,3.083333333333333,2.0646424,5
2020-04-19-170622,170622,1,0,2,709,1.3333333333333333,0.39507207,6
2020-04-20-170622,170622,12,0,12,721,7.833333333333332,3.0022447,0
2020-04-21-170622,170622,31,0,4,752,5.916666666666668,8.152459,1
2020-04-22-170622,170622,27,0,3,779,4.333333333333333,4.654735,2
2020-04-23-170622,170622,4,0,9,783,1.5833333333333333,1.0844007,3
2020-04-24-170622,170622,11,0,14,794,3.25,3.2236438,4
2020-04-25-170622,170622,4,0,4,798,2.0,1.2951906,5
2020-04-26-170622,170622,1,0,2,799,1.5,0.7228145,6
2020-04-27-170622,170622,9,0,10,808,5.833333333333332,3.5753565,0
2020-04-28-170622,170622,8,1,24,816,2.9166666666666665,2.0320702,1
2020-04-29-170622,170622,13,0,16,829,3.6666666666666665,3.1353636,2
2020-04-30-170622,170622,11,0,1,840,2.833333333333333,2.5640514,3
2020-05-01-170622,170622,11,1,12,851,1.9166666666666667,1.6607,4
2020-05-02-170622,170622,1,0,1,852,2.1666666666666665,0.56969815,5
2020-05-03-170622,170622,2,0,0,854,0.3333333333333333,0.2755498,6
2020-05-04-170622,170622,12,0,3,866,4.583333333333333,4.8605533,0
2020-05-05-170622,170622,4,0,6,870,3.583333333333333,2.1726785,1
2020-05-06-170622,170622,3,0,2,873,3.1666666666666665,4.3410716,2
2020-05-07-170622,170622,9,0,5,882,4.083333333333333,7.021449,3
2020-05-08-170622,170622,14,0,6,896,5.25,3.5218842,4
2020-05-09-170622,170622,4,0,0,900,1.0,0.7536437,5
2020-05-10-170622,170622,2,0,0,902,0.08333333333333333,0.1223016,6
2020-05-11-170622,170622,10,0,9,912,6.083333333333332,3.5407321,0
2020-05-12-170622,170622,24,4,2,936,6.166666666666668,4.511965,1
2020-05-13-170622,170622,16,0,2,952,3.9166666666666665,2.7047136,2
2020-05-14-170622,170622,1,0,2,953,3.583333333333333,1.2802883,3
2020-05-15-170622,170622,12,1,4,965,3.4166666666666665,2.5276532,4
2020-05-16-170622,170622,1,0,0,966,0.25,0.10265218,5
2020-05-17-170622,170622,0,0,0,966,0.16666666666666666,0.029938256,6
2020-05-18-170622,170622,3,0,6,969,3.333333333333333,1.8527553,0
2020-05-19-170622,170622,6,0,0,975,2.333333333333333,1.5295143,1
2020-05-20-170622,170622,2,0,1,977,3.083333333333333,1.6588845,2
2020-05-21-170622,170622,5,0,2,982,2.4166666666666665,1.2224967,3
2020-05-22-170622,170622,6,0,0,988,2.333333333333333,1.5762762,4
2020-05-23-170622,170622,0,0,0,988,0.3333333333333333,0.41905797,5
2020-05-24-170622,170622,0,0,0,988,0.16666666666666666,0.07333059,6
2020-05-25-170622,170622,9,0,2,997,1.8333333333333333,1.9245836,0
2020-05-26-170622,170622,2,0,2,999,2.1666666666666665,0.75726837,1
2020-05-27-170622,170622,2,0,1,1001,1.9166666666666667,0.9221522,2
2020-05-28-170622,170622,2,1,5,1003,1.75,1.4977041,3
2020-05-29-170622,170622,4,0,1,1007,2.4166666666666665,1.2759404,4
2020-05-30-170622,170622,0,0,0,1007,0.16666666666666666,0.12564898,5
2020-05-31-170622,170622,0,0,0,1007,0.16666666666666666,0.029902786,6
2020-06-01-170622,170622,6,0,0,1013,2.75,1.8063648,0
2020-06-02-170622,170622,0,0,3,1013,2.0,0.92350394,1
2020-06-03-170622,170622,1,0,0,1014,2.333333333333333,0.83778584,2
2020-06-04-170622,170622,2,0,1,1016,2.4166666666666665,1.6125281,3
2020-06-05-170622,170622,0,1,2,1016,2.4166666666666665,2.3829334,4
2020-06-06-170622,170622,0,3,0,1016,0.0,0.1082901,5
2020-06-07-170622,170622,0,0,0,1016,0.08333333333333333,0.10150936,6
2020-06-08-170622,170622,2,0,2,1018,1.25,0.6006007,0
2020-06-09-170622,170622,2,0,1,1020,1.4166666666666667,0.59652334,1
2020-06-10-170622,170622,1,0,0,1021,1.25,0.31782025,2
2020-06-11-170622,170622,5,0,0,1026,1.9166666666666667,0.6818067,3
2020-06-12-170622,170622,1,0,4,1027,0.5833333333333334,0.81728977,4
2020-06-13-170622,170622,0,0,1,1027,0.0,0.009248139,5
2020-06-14-170622,170622,0,0,0,1027,0.0,0.01264673,6
2020-06-15-170622,170622,0,0,2,1027,1.1666666666666667,0.19768275,0
2020-06-16-170622,170622,3,0,0,1030,1.8333333333333333,0.8804988,1
2020-06-17-170622,170622,0,0,1,1030,1.6666666666666667,0.5262671,2
2020-06-18-170622,170622,1,0,0,1031,1.6666666666666667,0.62868637,3
2020-06-19-170622,170622,2,0,3,1033,1.9166666666666667,1.3820665,4
2020-06-20-170622,170622,0,0,0,1033,0.0,0.004429643,5
2020-06-21-170622,170622,0,0,0,1033,0.08333333333333333,0.03706444,6
2020-06-22-170622,170622,2,0,0,1035,1.75,0.67809373,0
2020-06-23-170622,170622,1,0,0,1036,1.3333333333333333,0.88307685,1
2020-06-24-170622,170622,0,0,0,1036,0.5,0.50765723,2
2020-06-25-170622,170622,0,1,0,1036,0.6666666666666666,0.3571915,3
2020-06-26-170622,170622,4,0,0,1040,1.1666666666666667,0.77446115,4
2020-06-27-170622,170622,1,1,0,1041,0.0,0.13368744,5
2020-06-28-170622,170622,0,0,0,1041,0.08333333333333333,0.32960746,6
2020-06-29-170622,170622,2,0,0,1043,1.1666666666666667,0.4597323,0
2020-06-30-170622,170622,0,1,0,1043,0.5833333333333334,0.6634192,1
2020-07-01-170622,170622,1,0,0,1044,1.0,0.27384597,2
2020-07-02-170622,170622,0,0,0,1044,0.3333333333333333,0.13541447,3
2020-07-03-170622,170622,3,0,0,1047,0.6666666666666666,0.53750354,4
2020-07-04-170622,170622,0,0,0,1047,0.0,0.03993,5
2020-07-05-170622,170622,0,0,0,1047,0.08333333333333333,0.32084098,6
2020-07-06-170622,170622,0,0,2,1047,0.3333333333333333,0.14236093,0
2020-07-07-170622,170622,0,0,0,1047,0.75,0.19289865,1
2020-07-08-170622,170622,0,0,4,1047,0.08333333333333333,0.033570886,2
2020-07-09-170622,170622,0,0,0,1047,0.5,0.25886708,3
2020-07-10-170622,170622,0,0,0,1047,0.4166666666666667,0.16564302,4
2020-07-11-170622,170622,0,0,0,1047,0.0,0.017476244,5
2020-07-12-170622,170622,0,0,0,1047,0.0,0.12720774,6
2020-07-13-170622,170622,0,0,1,1047,0.4166666666666667,0.28218704,0
2020-07-14-170622,170622,0,0,1,1047,0.4166666666666667,0.3278204,1
2020-07-15-170622,170622,0,0,0,1047,0.6666666666666666,0.05185394,2
2020-07-16-170622,170622,0,0,0,1047,1.0,0.1983315,3
2020-07-17-170622,170622,0,0,1,1047,0.3333333333333333,0.1187774,4
2020-07-18-170622,170622,0,0,2,1047,0.0,0.06460443,5
2020-07-19-170622,170622,0,0,2,1047,0.0,0.0075664357,6
2020-07-20-170622,170622,2,1,5,1049,0.8333333333333334,0.2612294,0
2020-07-21-170622,170622,0,1,2,1049,1.9166666666666667,0.13184415,1
2020-07-22-170622,170622,4,0,5,1053,0.4166666666666667,0.57955575,2
2020-07-23-170622,170622,0,2,2,1053,0.8333333333333334,0.051041257,3
2020-07-24-170622,170622,0,0,0,1053,0.8333333333333334,0.070405714,4
2020-07-25-170622,170622,0,0,3,1053,0.25,0.044492945,5
2020-07-26-170622,170622,0,0,0,1053,0.16666666666666666,0.04653358,6
2020-07-27-170622,170622,1,1,2,1054,1.0,0.31220168,0
2020-07-28-170622,170622,1,1,0,1055,0.6666666666666666,0.33856028,1
2020-07-29-170622,170622,0,0,3,1055,0.9166666666666666,0.19517182,2
2020-07-30-170622,170622,0,0,3,1055,1.0,1.3920249,3
2020-07-31-170622,170622,1,1,2,1056,2.75,0.5821856,4
2020-08-01-170622,170622,2,0,2,1058,0.5833333333333334,0.6343295,5
2020-08-02-170622,170622,2,0,3,1060,1.1666666666666667,0.6949956,6
2020-08-03-170622,170622,5,0,2,1065,1.5,2.0410728,0
2020-08-04-170622,170622,2,0,5,1067,1.5,1.1040777,1
2020-08-05-170622,170622,5,0,2,1072,3.4166666666666665,2.1430779,2
2020-08-06-170622,170622,2,0,5,1074,2.4166666666666665,1.4871033,3
2020-08-07-170622,170622,0,0,2,1074,4.0,2.645862,4
2020-08-08-170622,170622,3,0,2,1077,1.1666666666666667,0.8845745,5
2020-08-09-170622,170622,0,0,13,1077,0.8333333333333334,0.19788358,6
2020-08-10-170622,170622,2,0,13,1079,3.8333333333333335,1.5866734,0
2020-08-11-170622,170622,0,0,7,1079,2.6666666666666665,1.6083375,1
2020-08-12-170622,170622,3,0,10,1082,3.75,2.0297625,2
2020-08-13-170622,170622,3,0,5,1085,5.0,2.1092355,3
2020-08-14-170622,170622,2,0,4,1087,2.5,1.4876624,4
2020-08-15-170622,170622,2,1,2,1089,1.75,0.49668702,5
2020-08-16-170622,170622,3,0,3,1092,1.25,0.9792456,6
2020-08-17-170622,170622,2,0,3,1094,4.583333333333333,1.8195829,0
2020-08-18-170622,170622,5,0,2,1099,3.4166666666666665,2.3638315,1
2020-08-19-170622,170622,2,0,3,1101,4.166666666666667,1.6920599,2
2020-08-20-170622,170622,5,0,12,1106,5.5,3.43257,3
2020-08-21-170622,170622,2,0,19,1108,3.8333333333333335,2.072253,4
2020-08-22-170622,170622,2,0,2,1110,0.5,0.5699468,5
2020-08-23-170622,170622,13,0,0,1123,1.1666666666666667,1.4503291,6
2020-08-24-170622,170622,13,0,6,1136,6.333333333333332,4.5489445,0
2020-08-25-170622,170622,7,0,0,1143,6.166666666666668,2.5231888,1
2020-08-26-170622,170622,10,0,3,1153,7.666666666666668,3.8622012,2
2020-08-27-170622,170622,5,0,2,1158,4.583333333333333,3.3513148,3
2020-08-28-170622,170622,4,0,10,1162,8.25,3.9224315,4
2020-08-29-170622,170622,2,0,6,1164,2.25,1.266841,5
2020-08-30-170622,170622,3,0,0,1167,1.5,0.7085581,6
2020-08-31-170622,170622,3,0,14,1170,8.583333333333334,5.890149,0
2020-09-01-170622,170622,2,2,7,1172,5.25,3.7341647,1
2020-09-02-170622,170622,3,0,2,1175,4.5,3.0870187,2
2020-09-03-170622,170622,12,0,11,1187,4.416666666666667,4.1608934,3
2020-09-04-170622,170622,19,0,14,1206,8.916666666666666,4.7138553,4
2020-09-05-170622,170622,2,0,6,1208,4.25,2.196917,5
2020-09-06-170622,170622,0,0,1,1208,1.75,1.4656222,6
2020-09-07-170622,170622,6,1,9,1214,7.333333333333332,4.7690277,0
2020-09-08-170622,170622,0,0,24,1214,3.0,1.7873334,1
2020-09-09-170622,170622,3,0,17,1217,4.166666666666667,2.1289477,2
2020-09-10-170622,170622,2,0,10,1219,5.5,2.7827868,3
2020-09-11-170622,170622,10,0,18,1229,10.0,6.2088165,4
2020-09-12-170622,170622,6,0,5,1235,1.75,1.5889851,5
2020-09-13-170622,170622,0,1,0,1235,2.1666666666666665,1.0687991,6
2020-09-14-170622,170622,14,0,13,1249,12.666666666666664,6.060595,0
2020-09-15-170622,170622,7,0,2,1256,7.5,3.6477044,1
2020-09-16-170622,170622,2,0,10,1258,6.583333333333332,3.9015694,2
2020-09-17-170622,170622,11,0,5,1269,6.333333333333332,2.499255,3
2020-09-18-170622,170622,14,0,8,1283,8.833333333333334,6.5409737,4
2020-09-19-170622,170622,6,1,3,1289,1.1666666666666667,1.9961005,5
2020-09-20-170622,170622,1,0,4,1290,3.083333333333333,1.8830255,6
2020-09-21-170622,170622,9,0,58,1299,11.833333333333336,4.9364057,0
2020-09-22-170622,170622,24,2,6,1323,9.75,4.4479923,1
2020-09-23-170622,170622,17,0,18,1340,8.166666666666666,5.9339967,2
2020-09-24-170622,170622,10,0,13,1350,8.416666666666666,4.52653,3
2020-09-25-170622,170622,18,0,11,1368,7.25,4.4359775,4
2020-09-26-170622,170622,5,0,2,1373,2.25,2.2263157,5
2020-09-27-170622,170622,0,0,7,1373,2.0,1.3754666,6
2020-09-28-170622,170622,13,0,3,1386,4.666666666666667,4.1965337,0
2020-09-29-170622,170622,2,0,5,1388,6.916666666666668,3.5083442,1
2020-09-30-170622,170622,10,1,8,1398,6.083333333333332,4.2572803,2
2020-10-01-170622,170622,5,0,12,1403,5.166666666666667,2.78228,3
2020-10-02-170622,170622,8,0,18,1411,5.666666666666668,3.44914,4
2020-10-03-170622,170622,3,0,2,1414,2.25,2.2047424,5
2020-10-04-170622,170622,4,0,8,1418,2.1666666666666665,1.228771,6
2020-10-05-170622,170622,58,0,14,1476,6.5,11.741548,0
2020-10-06-170622,170622,6,1,10,1482,6.416666666666668,4.57142,1
2020-10-07-170622,170622,18,0,21,1500,6.666666666666668,7.832741,2
2020-10-08-170622,170622,13,1,19,1513,6.416666666666668,5.002147,3
2020-10-09-170622,170622,11,0,29,1524,9.083333333333334,5.199234,4
2020-10-10-170622,170622,2,0,7,1526,4.166666666666667,1.7291844,5
2020-10-11-170622,170622,7,0,8,1533,4.083333333333333,2.0694778,6
2020-10-12-170622,170622,3,0,12,1536,3.25,2.099086,0
2020-10-13-170622,170622,5,0,21,1541,10.083333333333334,5.2247524,1
2020-10-14-170622,170622,8,0,22,1549,7.25,4.2695274,2
2020-10-15-170622,170622,12,0,18,1561,9.25,7.3697195,3
2020-10-16-170622,170622,18,0,28,1579,12.0,9.598105,4
2020-10-17-170622,170622,2,1,5,1581,3.1666666666666665,1.9851193,5
2020-10-18-170622,170622,8,0,8,1589,5.833333333333332,2.2020245,6
2020-10-19-170622,170622,14,0,5,1603,11.666666666666664,6.6279078,0
2020-10-20-170622,170622,10,0,24,1613,13.25,6.026883,1
2020-10-21-170622,170622,21,1,11,1634,12.083333333333336,8.141867,2
2020-10-22-170622,170622,19,1,14,1653,11.25,9.834944,3
2020-10-23-170622,170622,29,0,9,1682,14.583333333333336,9.068628,4
2020-10-24-170622,170622,7,0,3,1689,2.5,2.3061297,5
2020-10-25-170622,170622,8,5,8,1697,8.333333333333334,2.6556182,6
2020-10-26-170622,170622,12,0,19,1709,12.5,6.8182116,0
2020-10-27-170622,170622,21,1,7,1730,11.5,7.4525647,1
2020-10-28-170622,170622,22,0,18,1752,9.166666666666666,8.153747,2
2020-10-29-170622,170622,18,0,6,1770,7.583333333333332,7.0758343,3
2020-10-30-170622,170622,28,0,10,1798,12.166666666666664,7.7370005,4
2020-10-31-170622,170622,5,1,0,1803,2.1666666666666665,1.853691,5
2020-11-01-170622,170622,8,2,0,1811,3.1666666666666665,2.7439437,6
2020-11-02-170622,170622,5,0,0,1816,2.25,1.6859682,0
2020-11-03-170622,170622,24,0,0,1840,10.583333333333334,8.241143,1
2020-11-04-170622,170622,11,0,0,1851,11.416666666666664,5.93822,2
2020-11-05-170622,170622,14,0,0,1865,7.833333333333332,6.7448993,3
2020-11-06-170622,170622,9,1,0,1874,8.083333333333334,4.890686,4
2020-11-07-170622,170622,3,1,0,1877,2.1666666666666665,1.2991909,5
2020-11-08-170622,170622,8,0,0,1885,2.333333333333333,1.8211244,6
2020-11-09-170622,170622,19,0,0,1904,9.833333333333334,6.611134,0
2020-11-10-170622,170622,7,2,0,1911,6.25,3.7383907,1
2020-11-11-170622,170622,18,0,0,1929,6.166666666666668,4.7664533,2
2020-11-12-170622,170622,6,0,0,1935,6.5,4.360206,3
2020-11-13-170622,170622,10,0,0,1945,5.583333333333332,3.5319922,4
2020-03-01-170623,170623,0,0,11,0,0.0,0.022927912,6
2020-03-02-170623,170623,0,0,15,0,0.125,0.10232694,0
2020-03-03-170623,170623,1,0,19,1,0.25,0.14638017,1
2020-03-04-170623,170623,0,1,16,1,0.125,0.1406957,2
2020-03-05-170623,170623,0,0,19,1,0.0,0.041837223,3
2020-03-06-170623,170623,0,0,19,1,0.0,0.0422756,4
2020-03-07-170623,170623,0,0,7,1,0.0,0.0064121988,5
2020-03-08-170623,170623,0,0,4,1,0.125,0.03425094,6
2020-03-09-170623,170623,0,1,39,1,0.125,0.15787597,0
2020-03-10-170623,170623,2,0,28,3,0.25,0.46633402,1
2020-03-11-170623,170623,0,0,32,3,0.5,0.22291742,2
2020-03-12-170623,170623,0,0,28,3,0.375,0.15950133,3
2020-03-13-170623,170623,4,0,20,7,1.0,0.8708036,4
2020-03-14-170623,170623,5,0,5,12,2.625,1.0915735,5
2020-03-15-170623,170623,11,0,7,23,4.5,1.7808336,6
2020-03-16-170623,170623,15,0,29,38,7.75,3.8323834,0
2020-03-17-170623,170623,19,0,9,57,10.0,4.5118833,1
2020-03-18-170623,170623,16,0,12,73,7.625,4.188207,2
2020-03-19-170623,170623,19,0,8,92,9.875,4.968257,3
2020-03-20-170623,170623,19,0,8,111,13.375,5.214979,4
2020-03-21-170623,170623,7,0,3,118,5.75,2.0849838,5
2020-03-22-170623,170623,4,0,1,122,7.125,1.8623947,6
2020-03-23-170623,170623,39,0,12,161,21.75,9.318009,0
2020-03-24-170623,170623,28,0,3,189,16.0,6.887328,1
2020-03-25-170623,170623,32,0,8,221,17.875,8.350146,2
2020-03-26-170623,170623,28,1,7,249,13.875,7.3757224,3
2020-03-27-170623,170623,20,0,5,269,17.625,7.0618663,4
2020-03-28-170623,170623,5,0,0,274,4.0,1.1512309,5
2020-03-29-170623,170623,7,1,1,281,5.0,1.5811263,6
2020-03-30-170623,170623,29,0,8,310,15.0,7.4814167,0
2020-03-31-170623,170623,9,0,8,319,11.125,4.343892,1
2020-04-01-170623,170623,12,0,6,331,12.125,5.535506,2
2020-04-02-170623,170623,8,0,3,339,6.125,2.6853905,3
2020-04-03-170623,170623,8,0,5,347,9.625,3.1425538,4
2020-04-04-170623,170623,3,0,12,350,1.75,0.7561937,5
2020-04-05-170623,170623,1,0,3,351,3.75,0.8027581,6
2020-04-06-170623,170623,12,0,5,363,10.125,4.123232,0
2020-04-07-170623,170623,3,0,10,366,9.5,2.5865448,1
2020-04-08-170623,170623,8,0,12,374,5.625,2.5858924,2
2020-04-09-170623,170623,7,0,5,381,2.875,1.1605546,3
2020-04-10-170623,170623,5,0,4,386,3.375,1.0534495,4
2020-04-11-170623,170623,0,0,5,386,2.75,0.60278654,5
2020-04-12-170623,170623,1,0,11,387,3.25,0.6268476,6
2020-04-13-170623,170623,8,0,15,395,8.375,3.13886,0
2020-04-14-170623,170623,8,0,1,403,8.375,4.1299057,1
2020-04-15-170623,170623,6,0,5,409,6.625,2.8293698,2
2020-04-16-170623,170623,3,0,1,412,6.375,1.763546,3
2020-04-17-170623,170623,5,0,10,417,5.5,2.273328,4
2020-04-18-170623,170623,12,0,3,429,3.375,2.0473254,5
2020-04-19-170623,170623,3,0,1,432,0.625,0.5085213,6
2020-04-20-170623,170623,5,0,14,437,5.125,2.1502666,0
2020-04-21-170623,170623,10,1,6,447,6.375,3.2229822,1
2020-04-22-170623,170623,12,0,1,459,7.25,3.50894,2
2020-04-23-170623,170623,5,0,3,464,1.25,0.80825037,3
2020-04-24-170623,170623,4,0,2,468,3.125,1.6784042,4
2020-04-25-170623,170623,5,0,0,473,1.75,1.0377079,5
2020-04-26-170623,170623,11,0,0,484,0.625,0.98906446,6
2020-04-27-170623,170623,15,0,16,499,4.375,3.1826372,0
2020-04-28-170623,170623,1,0,7,500,4.375,1.7101845,1
2020-04-29-170623,170623,5,0,5,505,4.875,2.3876562,2
2020-04-30-170623,170623,1,0,4,506,3.75,1.395166,3
2020-05-01-170623,170623,10,0,4,516,1.875,1.3795557,4
2020-05-02-170623,170623,3,1,0,519,1.125,0.901473,5
2020-05-03-170623,170623,1,0,0,520,0.875,0.22741246,6
2020-05-04-170623,170623,14,0,8,534,6.625,4.953883,0
2020-05-05-170623,170623,6,0,3,540,2.75,1.8894794,1
2020-05-06-170623,170623,1,0,5,541,9.125,6.9673967,2
2020-05-07-170623,170623,3,0,0,544,4.0,3.7476065,3
2020-05-08-170623,170623,2,0,1,546,5.0,1.9772888,4
2020-05-09-170623,170623,0,0,1,546,1.5,0.31979835,5
2020-05-10-170623,170623,0,2,0,546,0.5,0.099328116,6
2020-05-11-170623,170623,16,0,1,562,3.875,2.9221618,0
2020-05-12-170623,170623,7,0,3,569,5.25,2.2601287,1
2020-05-13-170623,170623,5,0,3,574,4.0,1.6087614,2
2020-05-14-170623,170623,4,1,3,578,1.875,1.1193299,3
2020-05-15-170623,170623,4,0,4,582,3.25,1.295588,4
2020-05-16-170623,170623,0,0,0,582,0.25,0.030184122,5
2020-05-17-170623,170623,0,0,0,582,0.25,0.075487114,6
2020-05-18-170623,170623,8,0,6,590,1.375,1.4904261,0
2020-05-19-170623,170623,3,0,1,593,3.125,1.2828641,1
2020-05-20-170623,170623,5,0,0,598,1.0,0.93925947,2
2020-05-21-170623,170623,0,0,4,598,1.875,0.5376531,3
2020-05-22-170623,170623,1,0,12,599,2.125,0.83517617,4
2020-05-23-170623,170623,1,0,0,600,0.125,0.15086058,5
2020-05-24-170623,170623,0,1,1,600,0.375,0.21069671,6
2020-05-25-170623,170623,1,0,2,601,1.375,0.7516727,0
2020-05-26-170623,170623,3,0,1,604,0.875,0.6449937,1
2020-05-27-170623,170623,3,1,2,607,1.125,0.8870155,2
2020-05-28-170623,170623,3,0,1,610,2.0,1.1110463,3
2020-05-29-170623,170623,4,0,0,614,2.25,1.0784168,4
2020-05-30-170623,170623,0,0,0,614,0.0,0.04533933,5
2020-05-31-170623,170623,0,0,0,614,0.125,0.023281032,6
2020-06-01-170623,170623,6,0,1,620,1.625,1.6397916,0
2020-06-02-170623,170623,1,0,2,621,0.75,0.90311295,1
2020-06-03-170623,170623,0,0,3,621,1.375,0.46496022,2
2020-06-04-170623,170623,4,0,2,625,0.875,0.9853743,3
2020-06-05-170623,170623,12,0,3,637,0.875,2.241504,4
2020-06-06-170623,170623,0,0,0,637,0.25,0.23605117,5
2020-06-07-170623,170623,1,0,0,638,0.125,0.20203434,6
2020-06-08-170623,170623,2,0,2,640,0.75,0.4462186,0
2020-06-09-170623,170623,1,0,4,641,1.375,0.43439785,1
2020-06-10-170623,170623,2,0,0,643,0.5,0.4143903,2
2020-06-11-170623,170623,1,0,1,644,2.375,0.4530489,3
2020-06-12-170623,170623,0,0,0,644,0.625,0.26143593,4
2020-06-13-170623,170623,0,0,0,644,0.0,0.039665993,5
2020-06-14-170623,170623,0,0,0,644,0.0,0.03750436,6
2020-06-15-170623,170623,1,0,1,645,0.875,0.2360395,0
2020-06-16-170623,170623,2,0,2,647,1.375,0.76588,1
2020-06-17-170623,170623,3,0,1,650,1.0,0.69302374,2
2020-06-18-170623,170623,2,0,0,652,1.625,0.7179274,3
2020-06-19-170623,170623,3,0,0,655,1.125,0.9525742,4
2020-06-20-170623,170623,0,0,0,655,0.0,0.0046591437,5
2020-06-21-170623,170623,0,0,0,655,0.125,0.030026803,6
2020-06-22-170623,170623,2,0,1,657,1.5,0.6616085,0
2020-06-23-170623,170623,4,0,0,661,1.25,0.9803233,1
2020-06-24-170623,170623,0,0,0,661,0.75,0.28002018,2
2020-06-25-170623,170623,1,3,1,662,0.875,0.31131613,3
2020-06-26-170623,170623,0,0,1,662,1.0,0.30434933,4
2020-06-27-170623,170623,0,0,0,662,0.125,0.05309713,5
2020-06-28-170623,170623,0,0,0,662,0.0,0.035919446,6
2020-06-29-170623,170623,1,0,1,663,1.375,0.56635386,0
2020-06-30-170623,170623,2,1,1,665,0.625,0.4509649,1
2020-07-01-170623,170623,1,0,0,666,1.0,0.20860435,2
2020-07-02-170623,170623,0,0,0,666,0.875,0.19066715,3
2020-07-03-170623,170623,0,0,0,666,0.75,0.30054352,4
2020-07-04-170623,170623,0,0,0,666,0.125,0.017547583,5
2020-07-05-170623,170623,0,0,0,666,0.0,0.032248057,6
2020-07-06-170623,170623,1,0,0,667,0.25,0.18555096,0
2020-07-07-170623,170623,0,0,0,667,0.625,0.15162708,1
2020-07-08-170623,170623,0,0,1,667,0.125,0.0363917,2
2020-07-09-170623,170623,1,0,1,668,0.5,0.2501675,3
2020-07-10-170623,170623,1,0,0,669,0.125,0.1662852,4
2020-07-11-170623,170623,0,0,0,669,0.0,0.04233099,5
2020-07-12-170623,170623,0,0,1,669,0.375,0.30210274,6
2020-07-13-170623,170623,1,0,0,670,0.375,0.34163272,0
2020-07-14-170623,170623,1,0,0,671,0.875,0.4512859,1
2020-07-15-170623,170623,0,0,1,671,0.25,0.03376416,2
2020-07-16-170623,170623,0,0,2,671,0.75,0.1943482,3
2020-07-17-170623,170623,0,0,7,671,0.625,0.089187786,4
2020-07-18-170623,170623,0,0,3,671,0.125,0.1250453,5
2020-07-19-170623,170623,0,0,2,671,0.0,0.0031785,6
2020-07-20-170623,170623,0,0,2,671,0.625,0.12911694,0
2020-07-21-170623,170623,0,0,4,671,2.5,0.20922609,1
2020-07-22-170623,170623,1,0,4,672,0.875,0.48863366,2
2020-07-23-170623,170623,1,1,3,673,0.625,0.04995192,3
2020-07-24-170623,170623,0,0,6,673,0.125,0.051701907,4
2020-07-25-170623,170623,0,0,3,673,0.25,0.036136534,5
2020-07-26-170623,170623,1,1,0,674,0.125,0.037885964,6
2020-07-27-170623,170623,0,0,3,674,0.75,0.15255396,0
2020-07-28-170623,170623,0,1,4,674,0.625,0.27663013,1
2020-07-29-170623,170623,1,0,11,675,0.75,0.26633352,2
2020-07-30-170623,170623,2,0,4,677,0.75,0.5602377,3
2020-07-31-170623,170623,7,0,3,684,1.25,0.6536157,4
2020-08-01-170623,170623,3,0,0,687,0.375,0.7055983,5
2020-08-02-170623,170623,2,0,3,689,1.25,0.70781684,6
2020-08-03-170623,170623,2,0,5,691,1.25,0.7486709,0
2020-08-04-170623,170623,4,0,9,695,1.625,0.96191967,1
2020-08-05-170623,170623,4,0,5,699,2.75,1.4627862,2
2020-08-06-170623,170623,3,0,9,702,2.0,1.1598169,3
2020-08-07-170623,170623,6,0,7,708,2.625,1.9149504,4
2020-08-08-170623,170623,3,0,1,711,1.375,1.2155554,5
2020-08-09-170623,170623,0,0,4,711,0.625,0.380666,6
2020-08-10-170623,170623,3,0,5,714,3.625,1.4094665,0
2020-08-11-170623,170623,4,0,3,718,0.875,1.6177808,1
2020-08-12-170623,170623,11,0,6,729,2.25,2.908946,2
2020-08-13-170623,170623,4,0,6,733,3.5,2.1240993,3
2020-08-14-170623,170623,3,1,5,736,3.0,1.7941034,4
2020-08-15-170623,170623,0,0,5,736,1.0,0.4188058,5
2020-08-16-170623,170623,3,0,1,739,1.375,0.85058284,6
2020-08-17-170623,170623,5,0,10,744,4.125,1.5871242,0
2020-08-18-170623,170623,9,0,11,753,2.75,2.2526126,1
2020-08-19-170623,170623,5,0,14,758,3.375,1.8391434,2
2020-08-20-170623,170623,9,0,10,767,5.125,3.0988374,3
2020-08-21-170623,170623,7,0,16,774,3.0,2.7389922,4
2020-08-22-170623,170623,1,0,13,775,0.625,0.6006174,5
2020-08-23-170623,170623,4,0,5,779,2.375,0.79247344,6
2020-08-24-170623,170623,5,0,22,784,6.5,3.1743262,0
2020-08-25-170623,170623,3,0,9,787,5.375,2.586395,1
2020-08-26-170623,170623,6,0,9,793,8.125,2.995301,2
2020-08-27-170623,170623,6,0,5,799,3.25,2.248724,3
2020-08-28-170623,170623,5,0,15,804,4.5,2.4958696,4
2020-08-29-170623,170623,5,0,2,809,2.125,1.5259039,5
2020-08-30-170623,170623,1,0,2,810,1.25,0.61608154,6
2020-08-31-170623,170623,10,0,28,820,5.375,3.696112,0
2020-09-01-170623,170623,11,0,16,831,3.25,3.9315934,1
2020-09-02-170623,170623,14,0,13,845,3.25,2.6665828,2
2020-09-03-170623,170623,10,0,15,855,4.5,3.8857524,3
2020-09-04-170623,170623,16,0,15,871,6.125,3.606732,4
2020-09-05-170623,170623,13,0,1,884,3.125,2.3911228,5
2020-09-06-170623,170623,5,1,7,889,1.625,2.2833726,6
2020-09-07-170623,170623,22,0,29,911,3.875,4.2887864,0
2020-09-08-170623,170623,9,0,6,920,0.75,2.0478032,1
2020-09-09-170623,170623,9,1,12,929,2.5,2.0032208,2
2020-09-10-170623,170623,5,0,18,934,3.875,2.563135,3
2020-09-11-170623,170623,15,0,16,949,4.5,4.2596655,4
2020-09-12-170623,170623,2,0,8,951,2.25,2.0103192,5
2020-09-13-170623,170623,2,0,4,953,0.625,1.0074917,6
2020-09-14-170623,170623,28,0,4,981,8.0,5.0530324,0
2020-09-15-170623,170623,16,0,17,997,2.5,2.609628,1
2020-09-16-170623,170623,13,0,6,1010,3.0,2.81556,2
2020-09-17-170623,170623,15,0,9,1025,3.625,2.740281,3
2020-09-18-170623,170623,15,1,10,1040,5.375,5.4749355,4
2020-09-19-170623,170623,1,0,4,1041,2.0,2.5468376,5
2020-09-20-170623,170623,7,2,2,1048,2.125,1.9574975,6
2020-09-21-170623,170623,29,0,6,1077,6.375,4.949885,0
2020-09-22-170623,170623,6,1,10,1083,8.5,3.8118832,1
2020-09-23-170623,170623,12,1,6,1095,5.875,4.141306,2
2020-09-24-170623,170623,18,1,6,1113,5.375,4.3844495,3
2020-09-25-170623,170623,16,0,3,1129,5.75,4.3751917,4
2020-09-26-170623,170623,8,0,1,1137,1.75,2.5628965,5
2020-09-27-170623,170623,4,0,5,1141,0.625,1.291438,6
2020-09-28-170623,170623,4,0,7,1145,4.5,3.083431,0
2020-09-29-170623,170623,17,0,9,1162,2.75,3.2266958,1
2020-09-30-170623,170623,6,0,15,1168,4.375,3.0846,2
2020-10-01-170623,170623,9,1,7,1177,3.125,2.5587,3
2020-10-02-170623,170623,10,1,18,1187,3.375,2.949068,4
2020-10-03-170623,170623,4,1,6,1191,1.25,1.3734266,5
2020-10-04-170623,170623,2,2,7,1193,1.625,1.218928,6
2020-10-05-170623,170623,6,1,7,1199,11.125,5.771197,0
2020-10-06-170623,170623,10,2,12,1209,4.25,4.276676,1
2020-10-07-170623,170623,6,1,21,1215,6.125,4.761273,2
2020-10-08-170623,170623,6,0,19,1221,4.875,3.3886812,3
2020-10-09-170623,170623,3,2,7,1224,7.625,3.6114445,4
2020-10-10-170623,170623,1,0,8,1225,2.25,1.6721929,5
2020-10-11-170623,170623,5,0,5,1230,3.125,2.1538236,6
2020-10-12-170623,170623,7,0,13,1237,1.875,1.645597,0
2020-10-13-170623,170623,9,0,7,1246,6.0,4.413961,1
2020-10-14-170623,170623,15,0,9,1261,5.875,4.4114103,2
2020-10-15-170623,170623,7,0,6,1268,7.875,5.3772635,3
2020-10-16-170623,170623,18,0,8,1286,7.75,7.058243,4
2020-10-17-170623,170623,6,0,0,1292,1.25,2.0151365,5
2020-10-18-170623,170623,7,0,3,1299,2.625,1.721016,6
2020-10-19-170623,170623,7,0,3,1306,9.875,5.700057,0
2020-10-20-170623,170623,12,0,16,1318,8.25,5.50304,1
2020-10-21-170623,170623,21,0,10,1339,7.5,6.964159,2
2020-10-22-170623,170623,19,0,12,1358,6.625,8.072765,3
2020-10-23-170623,170623,7,0,6,1365,10.0,6.26727,4
2020-10-24-170623,170623,8,0,5,1373,1.25,2.017998,5
2020-10-25-170623,170623,5,0,3,1378,4.5,2.4190984,6
2020-10-26-170623,170623,13,1,17,1391,7.375,5.40823,0
2020-10-27-170623,170623,7,0,4,1398,8.125,4.9554653,1
2020-10-28-170623,170623,9,1,3,1407,7.125,5.6471243,2
2020-10-29-170623,170623,6,0,11,1413,6.875,6.3040667,3
2020-10-30-170623,170623,8,0,6,1421,10.0,4.8549404,4
2020-10-31-170623,170623,0,1,0,1421,2.375,1.1197544,5
2020-11-01-170623,170623,3,1,0,1424,3.625,1.7026658,6
2020-11-02-170623,170623,3,0,0,1427,3.0,1.7523735,0
2020-11-03-170623,170623,16,0,0,1443,7.875,5.518595,1
2020-11-04-170623,170623,10,0,0,1453,6.875,5.181626,2
2020-11-05-170623,170623,12,0,0,1465,6.125,5.0476265,3
2020-11-06-170623,170623,6,2,0,1471,6.5,4.432017,4
2020-11-07-170623,170623,5,0,0,1476,1.25,1.3096595,5
2020-11-08-170623,170623,3,1,0,1479,3.25,1.7431037,6
2020-11-09-170623,170623,17,0,0,1496,7.125,5.438668,0
2020-11-10-170623,170623,4,1,0,1500,4.5,2.9721172,1
2020-11-11-170623,170623,3,1,0,1503,6.25,3.7656927,2
2020-11-12-170623,170623,11,0,0,1514,5.875,3.282217,3
2020-11-13-170623,170623,6,0,0,1520,5.5,2.8016937,4
2020-03-01-170624,170624,1,0,0,1,0.0,0.35018092,6
2020-03-02-170624,170624,0,0,8,1,0.0,0.021116178,0
2020-03-03-170624,170624,0,0,5,1,0.1111111111111111,0.03293696,1
2020-03-04-170624,170624,0,0,3,1,0.1111111111111111,0.026563896,2
2020-03-05-170624,170624,0,0,0,1,0.0,0.006507918,3
2020-03-06-170624,170624,0,0,4,1,0.0,0.00471672,4
2020-03-07-170624,170624,0,0,3,1,0.0,0.0012404496,5
2020-03-08-170624,170624,0,0,3,1,0.0,0.0051958375,6
2020-03-09-170624,170624,0,0,10,1,0.1111111111111111,0.026511349,0
2020-03-10-170624,170624,0,0,6,1,0.1111111111111111,0.06400637,1
2020-03-11-170624,170624,0,0,8,1,0.2222222222222222,0.06936073,2
2020-03-12-170624,170624,1,0,7,2,0.0,0.5800176,3
2020-03-13-170624,170624,0,0,6,2,0.5555555555555556,0.254229,4
2020-03-14-170624,170624,2,0,2,4,0.6666666666666666,0.9354856,5
2020-03-15-170624,170624,0,0,2,4,1.2222222222222223,0.40618354,6
2020-03-16-170624,170624,8,0,13,12,2.888888888888889,3.705062,0
2020-03-17-170624,170624,5,1,9,17,2.333333333333333,2.797443,1
2020-03-18-170624,170624,3,0,10,20,3.2222222222222223,2.3866138,2
2020-03-19-170624,170624,0,0,3,20,3.111111111111111,1.9569318,3
2020-03-20-170624,170624,4,1,7,24,4.111111111111111,3.6549041,4
2020-03-21-170624,170624,3,0,2,27,3.111111111111111,1.9153454,5
2020-03-22-170624,170624,3,0,2,30,3.4444444444444446,1.7609012,6
2020-03-23-170624,170624,10,0,5,40,10.0,6.917599,0
2020-03-24-170624,170624,6,0,2,46,6.777777777777778,4.707999,1
2020-03-25-170624,170624,8,0,4,54,7.777777777777778,6.8927674,2
2020-03-26-170624,170624,7,0,1,61,5.111111111111111,5.380289,3
2020-03-27-170624,170624,6,0,0,67,8.888888888888891,6.60875,4
2020-03-28-170624,170624,2,1,2,69,2.4444444444444446,0.9436617,5
2020-03-29-170624,170624,2,0,0,71,2.4444444444444446,1.0918584,6
2020-03-30-170624,170624,13,0,3,84,8.888888888888891,7.2865033,0
2020-03-31-170624,170624,9,0,3,93,4.666666666666667,4.872444,1
2020-04-01-170624,170624,10,0,1,103,5.5555555555555545,5.213851,2
2020-04-02-170624,170624,3,0,4,106,3.4444444444444446,2.1921115,3
2020-04-03-170624,170624,7,0,5,113,4.4444444444444455,3.5381858,4
2020-04-04-170624,170624,2,0,0,115,0.7777777777777778,0.8854604,5
2020-04-05-170624,170624,2,0,2,117,2.2222222222222223,0.8304914,6
2020-04-06-170624,170624,5,1,2,122,5.0,3.4447994,0
2020-04-07-170624,170624,2,2,4,124,3.2222222222222223,1.4210241,1
2020-04-08-170624,170624,4,0,3,128,3.0,2.4114585,2
2020-04-09-170624,170624,1,0,1,129,1.2222222222222223,0.90558296,3
2020-04-10-170624,170624,0,0,3,129,2.4444444444444446,0.7001971,4
2020-04-11-170624,170624,2,0,1,131,1.2222222222222223,0.91409135,5
2020-04-12-170624,170624,0,0,1,131,0.8888888888888888,0.19193582,6
2020-04-13-170624,170624,3,0,0,134,4.777777777777779,2.1870022,0
2020-04-14-170624,170624,3,0,3,137,2.4444444444444446,2.5005498,1
2020-04-15-170624,170624,1,0,2,138,5.777777777777778,2.5199602,2
2020-04-16-170624,170624,4,0,2,142,3.333333333333333,2.4358363,3
2020-04-17-170624,170624,5,0,1,147,1.8888888888888888,2.8071113,4
2020-04-18-170624,170624,0,0,1,147,1.4444444444444444,0.71698415,5
2020-04-19-170624,170624,2,0,0,149,0.6666666666666666,1.0773468,6
2020-04-20-170624,170624,2,0,0,151,2.0,1.5858641,0
2020-04-21-170624,170624,4,0,1,155,1.1111111111111112,2.5311816,1
2020-04-22-170624,170624,3,1,0,158,2.2222222222222223,2.3555048,2
2020-04-23-170624,170624,1,0,2,159,0.2222222222222222,0.51617885,3
2020-04-24-170624,170624,3,0,1,162,1.7777777777777777,1.9498686,4
2020-04-25-170624,170624,1,0,1,163,0.8888888888888888,0.37373108,5
2020-04-26-170624,170624,1,0,0,164,0.3333333333333333,0.37812006,6
2020-04-27-170624,170624,0,0,1,164,2.333333333333333,1.2580588,0
2020-04-28-170624,170624,3,1,0,167,2.333333333333333,1.9336855,1
2020-04-29-170624,170624,2,0,0,169,2.333333333333333,2.124406,2
2020-04-30-170624,170624,2,0,0,171,1.4444444444444444,1.4414898,3
2020-05-01-170624,170624,1,0,2,172,0.5555555555555556,0.60051274,4
2020-05-02-170624,170624,1,0,0,173,0.7777777777777778,1.0800608,5
2020-05-03-170624,170624,0,0,0,173,0.1111111111111111,0.027713735,6
2020-05-04-170624,170624,0,0,1,173,3.6666666666666665,3.526243,0
2020-05-05-170624,170624,1,0,0,174,1.6666666666666667,1.3659036,1
2020-05-06-170624,170624,0,0,0,174,7.333333333333332,7.190098,2
2020-05-07-170624,170624,2,0,0,176,2.0,2.803829,3
2020-05-08-170624,170624,1,0,2,177,1.7777777777777777,1.5615687,4
2020-05-09-170624,170624,1,1,0,178,0.4444444444444444,0.45671257,5
2020-05-10-170624,170624,0,0,0,178,0.1111111111111111,0.095104694,6
2020-05-11-170624,170624,1,0,2,179,1.8888888888888888,1.3297421,0
2020-05-12-170624,170624,0,1,0,179,1.6666666666666667,0.6688012,1
2020-05-13-170624,170624,0,0,0,179,1.0,0.4433835,2
2020-05-14-170624,170624,0,0,2,179,1.2222222222222223,0.6668829,3
2020-05-15-170624,170624,2,0,0,181,1.1111111111111112,1.2427005,4
2020-05-16-170624,170624,0,0,0,181,0.0,0.0068466854,5
2020-05-17-170624,170624,0,0,0,181,0.1111111111111111,0.087188534,6
2020-05-18-170624,170624,1,0,0,182,1.8888888888888888,1.1542456,0
2020-05-19-170624,170624,0,0,1,182,1.0,0.74070144,1
2020-05-20-170624,170624,0,0,1,182,0.8888888888888888,0.44111276,2
2020-05-21-170624,170624,0,0,0,182,0.5555555555555556,0.32836437,3
2020-05-22-170624,170624,2,0,2,184,1.0,1.4750656,4
2020-05-23-170624,170624,0,0,0,184,0.1111111111111111,0.06699828,5
2020-05-24-170624,170624,0,0,0,184,0.2222222222222222,0.20123617,6
2020-05-25-170624,170624,2,0,1,186,0.6666666666666666,1.222515,0
2020-05-26-170624,170624,0,0,0,186,0.5555555555555556,0.25717577,1
2020-05-27-170624,170624,0,0,1,186,0.8888888888888888,0.44233406,2
2020-05-28-170624,170624,2,0,0,188,1.0,1.5623024,3
2020-05-29-170624,170624,0,0,0,188,0.4444444444444444,0.2543338,4
2020-05-30-170624,170624,0,0,0,188,0.0,0.0068281633,5
2020-05-31-170624,170624,0,0,0,188,0.1111111111111111,0.007752615,6
2020-06-01-170624,170624,0,0,0,188,0.4444444444444444,0.6773735,0
2020-06-02-170624,170624,1,0,0,189,1.0,1.2963353,1
2020-06-03-170624,170624,1,0,1,190,0.7777777777777778,0.74190503,2
2020-06-04-170624,170624,0,0,2,190,0.3333333333333333,0.22004823,3
2020-06-05-170624,170624,2,0,3,192,0.5555555555555556,1.5983547,4
2020-06-06-170624,170624,0,0,0,192,0.2222222222222222,0.28905997,5
2020-06-07-170624,170624,0,0,0,192,0.0,0.022990245,6
2020-06-08-170624,170624,1,0,0,193,0.0,0.5442017,0
2020-06-09-170624,170624,0,0,2,193,0.6666666666666666,0.22573604,1
2020-06-10-170624,170624,1,0,0,194,0.1111111111111111,0.50945413,2
2020-06-11-170624,170624,0,0,1,194,0.4444444444444444,0.08403655,3
2020-06-12-170624,170624,0,0,0,194,0.4444444444444444,0.16366668,4
2020-06-13-170624,170624,0,0,0,194,0.0,0.019483354,5
2020-06-14-170624,170624,0,0,0,194,0.0,0.017388511,6
2020-06-15-170624,170624,0,0,0,194,0.1111111111111111,0.048333675,0
2020-06-16-170624,170624,0,0,0,194,0.5555555555555556,0.47892758,1
2020-06-17-170624,170624,1,0,0,195,0.1111111111111111,0.544925,2
2020-06-18-170624,170624,2,0,0,197,0.5555555555555556,1.1547471,3
2020-06-19-170624,170624,3,0,0,200,0.8888888888888888,1.6134565,4
2020-06-20-170624,170624,0,0,0,200,0.0,0.0052484134,5
2020-06-21-170624,170624,0,0,0,200,0.1111111111111111,0.012478274,6
2020-06-22-170624,170624,0,0,0,200,0.4444444444444444,0.5634466,0
2020-06-23-170624,170624,2,0,0,202,0.6666666666666666,1.2168019,1
2020-06-24-170624,170624,0,0,1,202,0.4444444444444444,0.2686713,2
2020-06-25-170624,170624,1,0,1,203,0.3333333333333333,0.55594236,3
2020-06-26-170624,170624,0,0,0,203,0.1111111111111111,0.08969354,4
2020-06-27-170624,170624,0,0,0,203,0.1111111111111111,0.041307885,5
2020-06-28-170624,170624,0,0,0,203,0.1111111111111111,0.06985263,6
2020-06-29-170624,170624,0,0,0,203,0.4444444444444444,0.27465755,0
2020-06-30-170624,170624,0,0,0,203,0.2222222222222222,0.10047765,1
2020-07-01-170624,170624,0,0,0,203,0.0,0.046379037,2
2020-07-02-170624,170624,0,0,2,203,0.3333333333333333,0.2031715,3
2020-07-03-170624,170624,0,0,0,203,0.1111111111111111,0.055591963,4
2020-07-04-170624,170624,0,0,0,203,0.0,0.04846061,5
2020-07-05-170624,170624,0,0,0,203,0.1111111111111111,0.055685878,6
2020-07-06-170624,170624,0,0,0,203,0.2222222222222222,0.046947766,0
2020-07-07-170624,170624,0,0,0,203,0.4444444444444444,0.062156416,1
2020-07-08-170624,170624,1,1,0,204,0.2222222222222222,0.5907967,2
2020-07-09-170624,170624,1,0,0,205,0.2222222222222222,0.52898383,3
2020-07-10-170624,170624,0,0,0,205,0.0,0.060015544,4
2020-07-11-170624,170624,0,0,0,205,0.2222222222222222,0.08074812,5
2020-07-12-170624,170624,0,0,0,205,0.2222222222222222,0.1869019,6
2020-07-13-170624,170624,0,0,0,205,0.1111111111111111,0.54187346,0
2020-07-14-170624,170624,0,0,0,205,0.3333333333333333,0.13548732,1
2020-07-15-170624,170624,0,0,0,205,0.2222222222222222,0.05049156,2
2020-07-16-170624,170624,2,0,1,207,0.2222222222222222,1.0045518,3
2020-07-17-170624,170624,0,0,0,207,0.3333333333333333,0.088343315,4
2020-07-18-170624,170624,0,0,0,207,0.1111111111111111,0.16917516,5
2020-07-19-170624,170624,0,0,0,207,0.3333333333333333,0.069317445,6
2020-07-20-170624,170624,0,0,0,207,0.3333333333333333,0.06788364,0
2020-07-21-170624,170624,0,0,2,207,0.3333333333333333,0.24042018,1
2020-07-22-170624,170624,0,0,0,207,0.3333333333333333,0.23548222,2
2020-07-23-170624,170624,0,0,0,207,0.3333333333333333,0.10897975,3
2020-07-24-170624,170624,0,0,1,207,0.1111111111111111,0.039358586,4
2020-07-25-170624,170624,0,0,0,207,0.2222222222222222,0.012200908,5
2020-07-26-170624,170624,0,0,0,207,0.2222222222222222,0.042468507,6
2020-07-27-170624,170624,0,0,1,207,0.4444444444444444,0.10372439,0
2020-07-28-170624,170624,0,0,1,207,0.6666666666666666,0.17359461,1
2020-07-29-170624,170624,0,0,2,207,0.4444444444444444,0.1320319,2
2020-07-30-170624,170624,1,0,2,208,0.1111111111111111,0.7044792,3
2020-07-31-170624,170624,0,0,7,208,0.4444444444444444,0.2555138,4
2020-08-01-170624,170624,0,0,1,208,0.1111111111111111,0.1074082,5
2020-08-02-170624,170624,0,0,2,208,0.7777777777777778,0.40838748,6
2020-08-03-170624,170624,0,0,1,208,0.2222222222222222,0.28583944,0
2020-08-04-170624,170624,2,0,2,210,0.5555555555555556,1.4341643,1
2020-08-05-170624,170624,0,0,2,210,1.1111111111111112,0.82719475,2
2020-08-06-170624,170624,0,0,4,210,0.7777777777777778,0.7246878,3
2020-08-07-170624,170624,1,0,4,211,1.1111111111111112,1.4105535,4
2020-08-08-170624,170624,0,0,1,211,0.5555555555555556,0.92161226,5
2020-08-09-170624,170624,0,0,1,211,0.4444444444444444,0.48190045,6
2020-08-10-170624,170624,1,0,6,212,1.1111111111111112,1.3418947,0
2020-08-11-170624,170624,1,0,11,213,1.1111111111111112,1.8779044,1
2020-08-12-170624,170624,2,0,14,215,0.5555555555555556,3.0366776,2
2020-08-13-170624,170624,2,0,14,217,2.4444444444444446,2.8588147,3
2020-08-14-170624,170624,7,0,8,224,1.3333333333333333,5.208402,4
2020-08-15-170624,170624,1,0,3,225,0.2222222222222222,0.17723995,5
2020-08-16-170624,170624,2,0,7,227,0.5555555555555556,1.5183426,6
2020-08-17-170624,170624,1,0,10,228,1.1111111111111112,1.2828861,0
2020-08-18-170624,170624,2,0,11,230,0.6666666666666666,1.7973924,1
2020-08-19-170624,170624,2,0,5,232,1.1111111111111112,2.1832836,2
2020-08-20-170624,170624,4,0,5,236,1.4444444444444444,3.5831416,3
2020-08-21-170624,170624,4,0,10,240,1.3333333333333333,2.8591049,4
2020-08-22-170624,170624,1,0,9,241,0.2222222222222222,1.6600078,5
2020-08-23-170624,170624,1,0,10,242,0.6666666666666666,1.3709925,6
2020-08-24-170624,170624,6,0,11,248,2.4444444444444446,4.263713,0
2020-08-25-170624,170624,11,0,2,259,3.2222222222222223,6.1373377,1
2020-08-26-170624,170624,14,0,2,273,2.0,6.3970857,2
2020-08-27-170624,170624,14,0,9,287,1.2222222222222223,8.375585,3
2020-08-28-170624,170624,8,0,19,295,2.2222222222222223,4.7709527,4
2020-08-29-170624,170624,3,0,6,298,1.0,2.651661,5
2020-08-30-170624,170624,7,0,12,305,0.7777777777777778,3.034945,6
2020-08-31-170624,170624,10,0,8,315,2.333333333333333,7.4688463,0
2020-09-01-170624,170624,11,0,7,326,2.2222222222222223,6.2730584,1
2020-09-02-170624,170624,5,1,4,331,1.8888888888888888,2.9335036,2
2020-09-03-170624,170624,5,0,6,336,1.7777777777777777,5.1611404,3
2020-09-04-170624,170624,10,0,68,346,1.3333333333333333,4.169397,4
2020-09-05-170624,170624,9,0,27,355,1.6666666666666667,3.3987696,5
2020-09-06-170624,170624,10,0,20,365,1.4444444444444444,8.66089,6
2020-09-07-170624,170624,11,0,10,376,1.3333333333333333,6.3628373,0
2020-09-08-170624,170624,2,0,5,378,0.7777777777777778,1.9489115,1
2020-09-09-170624,170624,2,0,9,380,1.1111111111111112,1.5521777,2
2020-09-10-170624,170624,9,0,8,389,1.8888888888888888,4.0876236,3
2020-09-11-170624,170624,19,0,2,408,1.5555555555555556,4.985898,4
2020-09-12-170624,170624,6,0,0,414,1.3333333333333333,4.585057,5
2020-09-13-170624,170624,12,0,6,426,0.3333333333333333,6.122846,6
2020-09-14-170624,170624,8,0,4,434,2.555555555555556,3.5956833,0
2020-09-15-170624,170624,7,0,1,441,3.0,3.738066,1
2020-09-16-170624,170624,4,0,12,445,2.2222222222222223,8.320424,2
2020-09-17-170624,170624,6,0,6,451,0.7777777777777778,6.1768684,3
2020-09-18-170624,170624,68,0,3,519,1.7777777777777777,6.8894315,4
2020-09-19-170624,170624,27,0,1,546,1.2222222222222223,12.789835,5
2020-09-20-170624,170624,20,1,3,566,1.2222222222222223,7.7282877,6
2020-09-21-170624,170624,10,0,5,576,2.0,5.5572076,0
2020-09-22-170624,170624,5,1,2,581,2.2222222222222223,2.8134494,1
2020-09-23-170624,170624,9,1,11,590,2.2222222222222223,5.564961,2
2020-09-24-170624,170624,8,0,6,598,2.2222222222222223,5.639247,3
2020-09-25-170624,170624,2,0,4,600,1.5555555555555556,3.4467163,4
2020-09-26-170624,170624,0,1,2,600,0.8888888888888888,1.251723,5
2020-09-27-170624,170624,6,0,1,606,0.4444444444444444,2.5070503,6
2020-09-28-170624,170624,4,4,3,610,2.4444444444444446,2.8144772,0
2020-09-29-170624,170624,1,3,5,611,0.7777777777777778,1.3236924,1
2020-09-30-170624,170624,12,1,7,623,2.0,6.1249137,2
2020-10-01-170624,170624,6,0,10,629,1.4444444444444444,4.0319586,3
2020-10-02-170624,170624,3,0,12,632,1.6666666666666667,2.5704107,4
2020-10-03-170624,170624,1,0,3,633,0.3333333333333333,1.2361153,5
2020-10-04-170624,170624,3,0,7,636,0.6666666666666666,1.4846817,6
2020-10-05-170624,170624,5,1,20,641,1.7777777777777777,3.8945315,0
2020-10-06-170624,170624,2,1,6,643,0.8888888888888888,2.2173967,1
2020-10-07-170624,170624,11,0,10,654,1.1111111111111112,6.6828513,2
2020-10-08-170624,170624,6,0,15,660,1.7777777777777777,3.6717737,3
2020-10-09-170624,170624,4,1,17,664,3.4444444444444446,4.587398,4
2020-10-10-170624,170624,2,0,5,666,2.0,2.0153344,5
2020-10-11-170624,170624,1,0,2,667,1.8888888888888888,1.4394706,6
2020-10-12-170624,170624,3,0,21,670,1.5555555555555556,1.6197007,0
2020-10-13-170624,170624,5,0,10,675,2.4444444444444446,3.666962,1
2020-10-14-170624,170624,7,0,5,682,1.4444444444444444,4.21217,2
2020-10-15-170624,170624,10,0,14,692,5.0,5.859761,3
2020-10-16-170624,170624,12,0,8,704,2.888888888888889,8.26957,4
2020-10-17-170624,170624,3,0,5,707,1.6666666666666667,2.3815513,5
2020-10-18-170624,170624,7,0,2,714,1.3333333333333333,3.0680168,6
2020-10-19-170624,170624,20,0,6,734,4.222222222222221,9.975366,0
2020-10-20-170624,170624,6,0,12,740,3.888888888888889,4.739004,1
2020-10-21-170624,170624,10,0,21,750,4.222222222222221,7.2260284,2
2020-10-22-170624,170624,15,0,8,765,2.2222222222222223,9.088579,3
2020-10-23-170624,170624,17,0,16,782,3.111111111111111,11.083334,4
2020-10-24-170624,170624,5,0,2,787,0.6666666666666666,2.9335055,5
2020-10-25-170624,170624,2,1,5,789,2.4444444444444446,1.7406596,6
2020-10-26-170624,170624,21,0,20,810,2.2222222222222223,9.921345,0
2020-10-27-170624,170624,10,1,12,820,3.333333333333333,5.9932947,1
2020-10-28-170624,170624,5,1,6,825,1.5555555555555556,4.0963016,2
2020-10-29-170624,170624,14,0,13,839,1.4444444444444444,8.696227,3
2020-10-30-170624,170624,8,3,13,847,4.0,6.350586,4
2020-10-31-170624,170624,5,0,0,852,1.2222222222222223,3.0725346,5
2020-11-01-170624,170624,2,0,0,854,1.4444444444444444,1.6238364,6
2020-11-02-170624,170624,6,0,0,860,1.5555555555555556,2.2880445,0
2020-11-03-170624,170624,12,1,0,872,2.555555555555556,7.0992107,1
2020-11-04-170624,170624,21,0,0,893,2.888888888888889,11.1467705,2
2020-11-05-170624,170624,8,2,0,901,3.2222222222222223,6.2517014,3
2020-11-06-170624,170624,16,1,0,917,2.7777777777777777,10.776661,4
2020-11-07-170624,170624,2,3,0,919,0.4444444444444444,1.1968119,5
2020-11-08-170624,170624,5,0,0,924,1.6666666666666667,2.8576744,6
2020-11-09-170624,170624,20,0,0,944,2.555555555555556,9.725559,0
2020-11-10-170624,170624,12,1,0,956,2.1111111111111107,5.9165645,1
2020-11-11-170624,170624,6,1,0,962,2.555555555555556,4.4792304,2
2020-11-12-170624,170624,13,1,0,975,2.6666666666666665,6.810918,3
2020-11-13-170624,170624,13,1,0,988,2.888888888888889,5.803894,4
2020-03-01-170625,170625,0,0,5,0,0.0,0.002682679,6
2020-03-02-170625,170625,0,0,17,0,0.6666666666666666,0.009979573,0
2020-03-03-170625,170625,0,0,13,0,0.3333333333333333,0.020277083,1
2020-03-04-170625,170625,0,0,13,0,0.0,0.02022985,2
2020-03-05-170625,170625,0,0,15,0,0.3333333333333333,0.004502016,3
2020-03-06-170625,170625,0,0,25,0,1.0,0.004839901,4
2020-03-07-170625,170625,0,1,6,0,0.0,0.0015516919,5
2020-03-08-170625,170625,0,0,7,0,0.3333333333333333,0.008274572,6
2020-03-09-170625,170625,0,0,16,0,0.3333333333333333,0.020757407,0
2020-03-10-170625,170625,0,0,25,0,0.3333333333333333,0.05377471,1
2020-03-11-170625,170625,1,0,15,1,2.333333333333333,0.046819467,2
2020-03-12-170625,170625,4,0,28,5,0.6666666666666666,0.022694642,3
2020-03-13-170625,170625,1,0,23,6,3.0,0.1069174,4
2020-03-14-170625,170625,0,0,16,6,4.0,0.085168645,5
2020-03-15-170625,170625,5,0,8,11,11.666666666666664,0.16248652,6
2020-03-16-170625,170625,17,0,19,28,12.666666666666664,0.37725046,0
2020-03-17-170625,170625,13,0,13,41,18.0,0.45722368,1
2020-03-18-170625,170625,13,0,17,54,14.0,0.3641447,2
2020-03-19-170625,170625,15,0,13,69,21.0,0.49386552,3
2020-03-20-170625,170625,25,0,20,94,23.0,0.49192718,4
2020-03-21-170625,170625,6,0,6,100,8.333333333333334,0.11425587,5
2020-03-22-170625,170625,7,0,5,107,12.0,0.11217307,6
2020-03-23-170625,170625,16,0,13,123,41.66666666666666,0.8976967,0
2020-03-24-170625,170625,25,0,14,148,27.66666666666667,0.61850715,1
2020-03-25-170625,170625,15,1,2,163,39.0,0.72917897,2
2020-03-26-170625,170625,28,0,4,191,24.66666666666667,0.6383579,3
2020-03-27-170625,170625,23,0,4,214,33.0,0.64844996,4
2020-03-28-170625,170625,16,0,1,230,7.333333333333332,0.07720243,5
2020-03-29-170625,170625,8,0,2,238,9.666666666666666,0.106999084,6
2020-03-30-170625,170625,19,0,9,257,17.333333333333332,0.58585304,0
2020-03-31-170625,170625,13,0,4,270,17.666666666666668,0.37465665,1
2020-04-01-170625,170625,17,0,6,287,21.33333333333333,0.42381793,2
2020-04-02-170625,170625,13,0,6,300,8.0,0.21829303,3
2020-04-03-170625,170625,20,0,12,320,15.333333333333336,0.27927375,4
2020-04-04-170625,170625,6,0,1,326,4.0,0.056657545,5
2020-04-05-170625,170625,5,0,0,331,3.333333333333333,0.04130082,6
2020-04-06-170625,170625,13,0,4,344,18.33333333333333,0.38627306,0
2020-04-07-170625,170625,14,0,7,358,19.33333333333333,0.33881688,1
2020-04-08-170625,170625,2,0,4,360,12.333333333333336,0.24938272,2
2020-04-09-170625,170625,4,0,0,364,6.333333333333332,0.08977187,3
2020-04-10-170625,170625,4,0,5,368,9.333333333333334,0.0960012,4
2020-04-11-170625,170625,1,0,1,369,3.333333333333333,0.053651012,5
2020-04-12-170625,170625,2,0,0,371,9.333333333333334,0.07867972,6
2020-04-13-170625,170625,9,0,2,380,10.0,0.27635705,0
2020-04-14-170625,170625,4,0,2,384,19.33333333333333,0.44232687,1
2020-04-15-170625,170625,6,0,1,390,6.333333333333332,0.24339235,2
2020-04-16-170625,170625,6,0,2,396,7.333333333333332,0.15871242,3
2020-04-17-170625,170625,12,0,4,408,9.666666666666666,0.22147766,4
2020-04-18-170625,170625,1,0,2,409,5.0,0.14863706,5
2020-04-19-170625,170625,0,1,0,409,1.0,0.026898414,6
2020-04-20-170625,170625,4,0,2,413,11.333333333333336,0.20234478,0
2020-04-21-170625,170625,7,0,4,420,13.666666666666664,0.39148304,1
2020-04-22-170625,170625,4,0,3,424,11.666666666666664,0.35918817,2
2020-04-23-170625,170625,0,0,6,424,1.6666666666666667,0.059945486,3
2020-04-24-170625,170625,5,0,3,429,7.666666666666668,0.17748678,4
2020-04-25-170625,170625,1,0,1,430,3.0,0.08036806,5
2020-04-26-170625,170625,0,0,0,430,0.3333333333333333,0.06610042,6
2020-04-27-170625,170625,2,0,10,432,6.666666666666668,0.26383096,0
2020-04-28-170625,170625,2,1,7,434,5.666666666666668,0.1451189,1
2020-04-29-170625,170625,1,0,5,435,8.333333333333334,0.21129061,2
2020-04-30-170625,170625,2,0,6,437,6.333333333333332,0.14340723,3
2020-05-01-170625,170625,4,0,5,441,4.666666666666667,0.10727378,4
2020-05-02-170625,170625,2,0,0,443,1.6666666666666667,0.04882562,5
2020-05-03-170625,170625,0,0,0,443,1.0,0.015971683,6
2020-05-04-170625,170625,2,0,1,445,9.0,0.42364618,0
2020-05-05-170625,170625,4,0,1,449,4.666666666666667,0.17459536,1
2020-05-06-170625,170625,3,0,4,452,6.666666666666668,0.46065757,2
2020-05-07-170625,170625,6,0,0,458,4.666666666666667,0.37807736,3
2020-05-08-170625,170625,3,0,3,461,10.0,0.22246917,4
2020-05-09-170625,170625,1,0,0,462,2.6666666666666665,0.03502924,5
2020-05-10-170625,170625,0,0,0,462,1.0,0.0068903267,6
2020-05-11-170625,170625,10,0,2,472,9.0,0.28523538,0
2020-05-12-170625,170625,7,0,4,479,13.333333333333336,0.30994165,1
2020-05-13-170625,170625,5,0,3,484,8.0,0.21261469,2
2020-05-14-170625,170625,6,0,2,490,2.6666666666666665,0.100802705,3
2020-05-15-170625,170625,5,0,2,495,6.666666666666668,0.16699459,4
2020-05-16-170625,170625,0,0,1,495,0.6666666666666666,0.006209648,5
2020-05-17-170625,170625,0,0,1,495,0.0,0.0035405548,6
2020-05-18-170625,170625,1,0,1,496,3.6666666666666665,0.1630697,0
2020-05-19-170625,170625,1,0,2,497,3.0,0.13854556,1
2020-05-20-170625,170625,4,0,0,501,3.6666666666666665,0.11228767,2
2020-05-21-170625,170625,0,0,2,501,5.0,0.08580074,3
2020-05-22-170625,170625,3,0,0,504,4.0,0.097628385,4
2020-05-23-170625,170625,0,0,0,504,0.0,0.0135229435,5
2020-05-24-170625,170625,0,0,0,504,0.0,0.008099049,6
2020-05-25-170625,170625,2,0,3,506,4.666666666666667,0.13817848,0
2020-05-26-170625,170625,4,0,0,510,2.333333333333333,0.07991887,1
2020-05-27-170625,170625,3,0,0,513,1.3333333333333333,0.100138314,2
2020-05-28-170625,170625,2,0,4,515,2.0,0.11730314,3
2020-05-29-170625,170625,2,0,0,517,3.333333333333333,0.12587512,4
2020-05-30-170625,170625,1,0,0,518,0.0,0.008509762,5
2020-05-31-170625,170625,1,0,0,519,0.0,0.0014751538,6
2020-06-01-170625,170625,1,0,1,520,4.0,0.19320586,0
2020-06-02-170625,170625,2,0,12,522,2.0,0.08014252,1
2020-06-03-170625,170625,0,0,5,522,2.333333333333333,0.0560845,2
2020-06-04-170625,170625,2,0,2,524,1.3333333333333333,0.12323824,3
2020-06-05-170625,170625,0,0,2,524,1.3333333333333333,0.24687643,4
2020-06-06-170625,170625,0,7,0,524,0.0,0.012825302,5
2020-06-07-170625,170625,0,0,0,524,0.0,0.01621997,6
2020-06-08-170625,170625,3,0,1,527,1.3333333333333333,0.06606729,0
2020-06-09-170625,170625,0,0,3,527,1.0,0.054497417,1
2020-06-10-170625,170625,0,0,0,527,1.6666666666666667,0.04030203,2
2020-06-11-170625,170625,4,0,1,531,2.6666666666666665,0.07117114,3
2020-06-12-170625,170625,0,0,4,531,0.3333333333333333,0.035695005,4
2020-06-13-170625,170625,0,0,0,531,0.0,0.0028717883,5
2020-06-14-170625,170625,0,1,0,531,0.0,0.0029961853,6
2020-06-15-170625,170625,1,0,3,532,0.6666666666666666,0.023867229,0
2020-06-16-170625,170625,12,2,0,544,1.3333333333333333,0.090524375,1
2020-06-17-170625,170625,5,0,2,549,1.3333333333333333,0.07048597,2
2020-06-18-170625,170625,2,0,0,551,1.3333333333333333,0.076073915,3
2020-06-19-170625,170625,2,0,2,553,2.0,0.12139589,4
2020-06-20-170625,170625,0,0,0,553,0.0,0.0003841341,5
2020-06-21-170625,170625,0,0,0,553,0.0,0.0022984531,6
2020-06-22-170625,170625,1,0,0,554,2.0,0.07659033,0
2020-06-23-170625,170625,3,0,2,557,1.3333333333333333,0.103451855,1
2020-06-24-170625,170625,0,0,0,557,0.3333333333333333,0.034332804,2
2020-06-25-170625,170625,1,1,1,558,0.3333333333333333,0.03902157,3
2020-06-26-170625,170625,4,0,0,562,3.0,0.06724187,4
2020-06-27-170625,170625,0,0,0,562,0.3333333333333333,0.011605214,5
2020-06-28-170625,170625,0,0,0,562,0.0,0.012686443,6
2020-06-29-170625,170625,3,0,0,565,1.3333333333333333,0.056215804,0
2020-06-30-170625,170625,0,0,1,565,0.0,0.049731437,1
2020-07-01-170625,170625,2,0,2,567,1.0,0.03070296,2
2020-07-02-170625,170625,0,0,2,567,0.0,0.017511198,3
2020-07-03-170625,170625,2,0,0,569,2.0,0.053123485,4
2020-07-04-170625,170625,0,0,0,569,0.0,0.002022293,5
2020-07-05-170625,170625,0,0,0,569,0.0,0.011684044,6
2020-07-06-170625,170625,0,0,2,569,0.0,0.022570634,0
2020-07-07-170625,170625,2,0,1,571,0.0,0.014465816,1
2020-07-08-170625,170625,0,0,1,571,0.0,0.003762338,2
2020-07-09-170625,170625,1,0,0,572,0.0,0.02763118,3
2020-07-10-170625,170625,0,0,0,572,0.3333333333333333,0.019342411,4
2020-07-11-170625,170625,0,0,1,572,0.0,0.0027043493,5
2020-07-12-170625,170625,0,0,0,572,0.0,0.021616183,6
2020-07-13-170625,170625,0,1,0,572,0.3333333333333333,0.038727026,0
2020-07-14-170625,170625,1,0,0,573,0.0,0.042033795,1
2020-07-15-170625,170625,2,0,0,575,0.3333333333333333,0.004143539,2
2020-07-16-170625,170625,2,0,3,577,0.6666666666666666,0.022723876,3
2020-07-17-170625,170625,0,0,6,577,0.0,0.012119068,4
2020-07-18-170625,170625,0,0,1,577,0.0,0.00838618,5
2020-07-19-170625,170625,0,0,0,577,0.0,0.00063309335,6
2020-07-20-170625,170625,2,0,2,579,1.3333333333333333,0.020601515,0
2020-07-21-170625,170625,1,0,1,580,1.0,0.014916432,1
2020-07-22-170625,170625,1,0,1,581,1.3333333333333333,0.05999105,2
2020-07-23-170625,170625,0,0,3,581,1.0,0.0072290455,3
2020-07-24-170625,170625,0,0,2,581,0.6666666666666666,0.007823366,4
2020-07-25-170625,170625,1,0,1,582,0.0,0.0033589462,5
2020-07-26-170625,170625,0,0,2,582,0.0,0.0043175602,6
2020-07-27-170625,170625,0,0,4,582,0.3333333333333333,0.02524516,0
2020-07-28-170625,170625,0,0,4,582,1.0,0.048853613,1
2020-07-29-170625,170625,0,0,6,582,0.6666666666666666,0.024055628,2
2020-07-30-170625,170625,3,0,9,585,0.3333333333333333,0.084334046,3
2020-07-31-170625,170625,6,0,4,591,1.6666666666666667,0.0695676,4
2020-08-01-170625,170625,1,0,2,592,0.6666666666666666,0.08125703,5
2020-08-02-170625,170625,0,0,2,592,2.0,0.066673905,6
2020-08-03-170625,170625,2,0,3,594,3.0,0.15011303,0
2020-08-04-170625,170625,1,0,9,595,2.0,0.124337524,1
2020-08-05-170625,170625,1,0,9,596,3.333333333333333,0.19106391,2
2020-08-06-170625,170625,3,0,8,599,1.6666666666666667,0.13087513,3
2020-08-07-170625,170625,2,0,2,601,2.333333333333333,0.23081806,4
2020-08-08-170625,170625,1,0,2,602,1.6666666666666667,0.093985915,5
2020-08-09-170625,170625,2,0,1,604,0.0,0.029343644,6
2020-08-10-170625,170625,4,0,9,608,4.333333333333333,0.16377167,0
2020-08-11-170625,170625,4,0,3,612,2.333333333333333,0.17196721,1
2020-08-12-170625,170625,6,0,7,618,3.6666666666666665,0.26685515,2
2020-08-13-170625,170625,9,0,10,627,2.333333333333333,0.23343311,3
2020-08-14-170625,170625,4,1,5,631,2.0,0.18981123,4
2020-08-15-170625,170625,2,0,1,633,2.0,0.051302012,5
2020-08-16-170625,170625,2,0,4,635,1.6666666666666667,0.09254285,6
2020-08-17-170625,170625,3,0,3,638,3.333333333333333,0.19601957,0
2020-08-18-170625,170625,9,0,5,647,3.0,0.26827854,1
2020-08-19-170625,170625,9,0,3,656,2.6666666666666665,0.19114727,2
2020-08-20-170625,170625,8,0,7,664,5.333333333333333,0.35219303,3
2020-08-21-170625,170625,2,0,9,666,2.0,0.24957918,4
2020-08-22-170625,170625,2,0,1,668,0.6666666666666666,0.057678904,5
2020-08-23-170625,170625,1,0,0,669,4.333333333333333,0.11140143,6
2020-08-24-170625,170625,9,1,10,678,9.0,0.40047494,0
2020-08-25-170625,170625,3,0,2,681,7.0,0.27631843,1
2020-08-26-170625,170625,7,0,15,688,7.333333333333332,0.38481584,2
2020-08-27-170625,170625,10,0,11,698,3.333333333333333,0.29527664,3
2020-08-28-170625,170625,5,1,15,703,6.666666666666668,0.32995594,4
2020-08-29-170625,170625,1,0,0,704,2.6666666666666665,0.13703792,5
2020-08-30-170625,170625,4,0,2,708,3.0,0.06269954,6
2020-08-31-170625,170625,3,0,27,711,8.0,0.47263455,0
2020-09-01-170625,170625,5,0,10,716,2.6666666666666665,0.43679217,1
2020-09-02-170625,170625,3,0,9,719,2.0,0.32764968,2
2020-09-03-170625,170625,7,0,16,726,6.0,0.50041974,3
2020-09-04-170625,170625,9,0,31,735,10.666666666666666,0.5217636,4
2020-09-05-170625,170625,1,0,3,736,2.0,0.24216107,5
2020-09-06-170625,170625,0,0,1,736,1.3333333333333333,0.17557083,6
2020-09-07-170625,170625,10,0,26,746,4.333333333333333,0.5330884,0
2020-09-08-170625,170625,2,0,31,748,2.333333333333333,0.20237644,1
2020-09-09-170625,170625,15,0,26,763,3.0,0.25216135,2
2020-09-10-170625,170625,11,0,22,774,4.0,0.31068927,3
2020-09-11-170625,170625,15,1,17,789,9.0,0.57309604,4
2020-09-12-170625,170625,0,0,5,789,2.333333333333333,0.16921435,5
2020-09-13-170625,170625,2,0,3,791,0.3333333333333333,0.103384696,6
2020-09-14-170625,170625,27,0,8,818,9.0,0.63254434,0
2020-09-15-170625,170625,10,0,7,828,7.666666666666668,0.34771863,1
2020-09-16-170625,170625,9,0,15,837,6.333333333333332,0.3858266,2
2020-09-17-170625,170625,16,0,13,853,7.666666666666668,0.34522897,3
2020-09-18-170625,170625,31,0,15,884,11.666666666666664,0.71076596,4
2020-09-19-170625,170625,3,1,1,887,4.333333333333333,0.20235263,5
2020-09-20-170625,170625,1,0,0,888,3.0,0.21080716,6
2020-09-21-170625,170625,26,0,11,914,10.333333333333334,0.627843,0
2020-09-22-170625,170625,31,1,5,945,14.666666666666664,0.527191,1
2020-09-23-170625,170625,26,0,7,971,11.666666666666664,0.5828666,2
2020-09-24-170625,170625,22,1,10,993,7.666666666666668,0.5345769,3
2020-09-25-170625,170625,17,0,12,1010,9.666666666666666,0.53245425,4
2020-09-26-170625,170625,5,0,4,1015,3.0,0.24194601,5
2020-09-27-170625,170625,3,0,3,1018,1.6666666666666667,0.1391219,6
2020-09-28-170625,170625,8,0,3,1026,5.0,0.46918303,0
2020-09-29-170625,170625,7,1,6,1033,5.333333333333333,0.40215385,1
2020-09-30-170625,170625,15,0,9,1048,6.666666666666668,0.40525338,2
2020-10-01-170625,170625,13,0,7,1061,6.666666666666668,0.3238518,3
2020-10-02-170625,170625,15,0,9,1076,6.0,0.39068696,4
2020-10-03-170625,170625,1,0,1,1077,5.0,0.17460878,5
2020-10-04-170625,170625,0,0,10,1077,4.333333333333333,0.13804771,6
2020-10-05-170625,170625,11,0,15,1088,25.0,1.2482871,0
2020-10-06-170625,170625,5,0,10,1093,8.666666666666666,0.5027734,1
2020-10-07-170625,170625,7,1,13,1100,14.666666666666664,0.83174884,2
2020-10-08-170625,170625,10,0,7,1110,10.333333333333334,0.54197264,3
2020-10-09-170625,170625,12,0,10,1122,12.666666666666664,0.49328354,4
2020-10-10-170625,170625,4,0,2,1126,6.666666666666668,0.14320177,5
2020-10-11-170625,170625,3,0,3,1129,7.333333333333332,0.20805964,6
2020-10-12-170625,170625,3,0,14,1132,4.666666666666667,0.19580592,0
2020-10-13-170625,170625,6,0,11,1138,13.333333333333336,0.5782213,1
2020-10-14-170625,170625,9,0,2,1147,10.0,0.5988378,2
2020-10-15-170625,170625,7,0,6,1154,13.0,0.7710517,3
2020-10-16-170625,170625,9,0,14,1163,18.666666666666668,1.076931,4
2020-10-17-170625,170625,1,0,0,1164,5.0,0.1234835,5
2020-10-18-170625,170625,10,0,1,1174,12.0,0.12304495,6
2020-10-19-170625,170625,15,0,0,1189,21.0,0.703731,0
2020-10-20-170625,170625,10,0,12,1199,24.33333333333333,0.6621267,1
2020-10-21-170625,170625,13,0,21,1212,22.66666666666667,0.8385133,2
2020-10-22-170625,170625,7,0,3,1219,25.0,0.98307246,3
2020-10-23-170625,170625,10,0,8,1229,33.0,0.79578656,4
2020-10-24-170625,170625,2,0,7,1231,6.0,0.1880886,5
2020-10-25-170625,170625,3,1,0,1234,18.0,0.22506839,6
2020-10-26-170625,170625,14,0,18,1248,19.666666666666668,0.77859634,0
2020-10-27-170625,170625,11,0,6,1259,24.33333333333333,0.78660274,1
2020-10-28-170625,170625,2,1,6,1261,18.33333333333333,0.82990927,2
2020-10-29-170625,170625,6,0,9,1267,15.666666666666664,0.809271,3
2020-10-30-170625,170625,14,1,7,1281,24.33333333333333,0.766205,4
2020-10-31-170625,170625,0,0,0,1281,5.333333333333333,0.13695437,5
2020-11-01-170625,170625,1,0,0,1282,5.666666666666668,0.18078992,6
2020-11-02-170625,170625,0,1,0,1282,3.0,0.19669123,0
2020-11-03-170625,170625,12,1,0,1294,17.333333333333332,0.8607567,1
2020-11-04-170625,170625,21,0,0,1315,14.666666666666664,0.7085156,2
2020-11-05-170625,170625,3,0,0,1318,12.333333333333336,0.6844363,3
2020-11-06-170625,170625,8,1,0,1326,8.666666666666666,0.63609874,4
2020-11-07-170625,170625,7,0,0,1333,2.0,0.14275372,5
2020-11-08-170625,170625,0,0,0,1333,4.666666666666667,0.1798871,6
2020-11-09-170625,170625,18,0,0,1351,13.666666666666664,0.7922156,0
2020-11-10-170625,170625,6,0,0,1357,7.0,0.4060388,1
2020-11-11-170625,170625,6,1,0,1363,13.666666666666664,0.53064436,2
2020-11-12-170625,170625,9,1,0,1372,7.666666666666668,0.46092343,3
2020-11-13-170625,170625,7,0,0,1379,8.0,0.40498698,4
2020-03-01-170626,170626,0,0,0,0,0.0,4.432809e-05,6
2020-03-02-170626,170626,0,0,0,0,0.0,0.0011890837,0
2020-03-03-170626,170626,0,0,0,0,0.0,0.00020885227,1
2020-03-04-170626,170626,0,0,0,0,0.0,0.0004501148,2
2020-03-05-170626,170626,0,2,0,0,0.0,0.003510021,3
2020-03-06-170626,170626,0,0,0,0,0.0,0.003169961,4
2020-03-07-170626,170626,0,0,0,0,0.0,5.971494e-09,5
2020-03-08-170626,170626,0,0,0,0,0.0,0.0002976902,6
2020-03-09-170626,170626,0,0,1,0,0.0,0.00050671754,0
2020-03-10-170626,170626,0,0,0,0,0.0,0.00049586006,1
2020-03-11-170626,170626,0,0,0,0,0.0,0.0021383294,2
2020-03-12-170626,170626,0,0,0,0,0.0,0.0027168507,3
2020-03-13-170626,170626,0,0,0,0,0.0,0.0048457053,4
2020-03-14-170626,170626,0,0,0,0,0.5,0.028214594,5
2020-03-15-170626,170626,0,0,0,0,2.0,0.053224333,6
2020-03-16-170626,170626,0,0,0,0,10.0,0.28754357,0
2020-03-17-170626,170626,0,0,1,0,6.0,0.20822302,1
2020-03-18-170626,170626,0,0,0,0,8.0,0.253171,2
2020-03-19-170626,170626,0,1,0,0,7.0,0.232775,3
2020-03-20-170626,170626,0,0,0,0,10.0,0.27359334,4
2020-03-21-170626,170626,0,0,0,0,2.5,0.063999735,5
2020-03-22-170626,170626,0,0,0,0,2.0,0.03751918,6
2020-03-23-170626,170626,1,0,4,1,12.5,0.41240954,0
2020-03-24-170626,170626,0,0,0,1,11.5,0.2960916,1
2020-03-25-170626,170626,0,0,0,1,12.5,0.32641417,2
2020-03-26-170626,170626,0,0,0,1,8.0,0.2697168,3
2020-03-27-170626,170626,0,0,1,1,6.5,0.19974594,4
2020-03-28-170626,170626,0,0,0,1,6.0,0.12063253,5
2020-03-29-170626,170626,0,2,0,1,3.5,0.07549815,6
2020-03-30-170626,170626,0,0,0,1,7.0,0.18304229,0
2020-03-31-170626,170626,1,0,0,2,6.0,0.225636,1
2020-04-01-170626,170626,0,0,0,2,3.5,0.1046695,2
2020-04-02-170626,170626,0,0,1,2,3.5,0.12596898,3
2020-04-03-170626,170626,0,0,0,2,6.5,0.2586369,4
2020-04-04-170626,170626,0,0,1,2,1.5,0.034892824,5
2020-04-05-170626,170626,0,0,0,2,2.5,0.043804906,6
2020-04-06-170626,170626,4,0,0,6,7.0,0.36687407,0
2020-04-07-170626,170626,0,1,0,6,8.5,0.26788443,1
2020-04-08-170626,170626,0,1,0,6,4.0,0.104003094,2
2020-04-09-170626,170626,0,0,0,6,1.5,0.030377042,3
2020-04-10-170626,170626,1,0,0,7,2.0,0.05884154,4
2020-04-11-170626,170626,0,0,0,7,4.5,0.084158815,5
2020-04-12-170626,170626,0,0,0,7,2.5,0.04750661,6
2020-04-13-170626,170626,0,0,0,7,9.5,0.2890729,0
2020-04-14-170626,170626,0,0,0,7,1.0,0.04054587,1
2020-04-15-170626,170626,0,0,0,7,5.0,0.15486471,2
2020-04-16-170626,170626,1,0,0,8,1.0,0.07235033,3
2020-04-17-170626,170626,0,0,0,8,2.0,0.053734835,4
2020-04-18-170626,170626,1,0,0,9,3.5,0.11651121,5
2020-04-19-170626,170626,0,0,0,9,3.0,0.088798575,6
2020-04-20-170626,170626,0,0,1,9,3.5,0.16233212,0
2020-04-21-170626,170626,0,0,0,9,2.5,0.107186586,1
2020-04-22-170626,170626,0,0,1,9,2.0,0.067356616,2
2020-04-23-170626,170626,0,0,1,9,3.0,0.06276451,3
2020-04-24-170626,170626,0,0,0,9,0.5,0.022810487,4
2020-04-25-170626,170626,0,0,0,9,1.0,0.021381652,5
2020-04-26-170626,170626,0,0,0,9,0.5,0.0111332275,6
2020-04-27-170626,170626,0,0,1,9,4.0,0.13998999,0
2020-04-28-170626,170626,0,0,0,9,1.5,0.07811587,1
2020-04-29-170626,170626,0,0,1,9,1.5,0.08431764,2
2020-04-30-170626,170626,0,0,0,9,1.5,0.05388899,3
2020-05-01-170626,170626,0,0,0,9,1.0,0.028400335,4
2020-05-02-170626,170626,0,0,1,9,0.5,0.02056747,5
2020-05-03-170626,170626,0,0,0,9,0.5,0.014210563,6
2020-05-04-170626,170626,1,0,1,10,5.5,0.23081112,0
2020-05-05-170626,170626,0,0,0,10,3.5,0.172106,1
2020-05-06-170626,170626,1,0,0,11,3.0,0.18321206,2
2020-05-07-170626,170626,1,0,0,12,1.5,0.12862442,3
2020-05-08-170626,170626,0,0,0,12,1.0,0.039805915,4
2020-05-09-170626,170626,0,0,0,12,4.0,0.11051082,5
2020-05-10-170626,170626,0,1,0,12,1.0,0.027072428,6
2020-05-11-170626,170626,1,0,0,13,2.0,0.13297497,0
2020-05-12-170626,170626,0,8,0,13,1.5,0.08826093,1
2020-05-13-170626,170626,1,0,0,14,2.0,0.19285668,2
2020-05-14-170626,170626,0,0,1,14,0.0,0.0028278911,3
2020-05-15-170626,170626,0,2,0,14,2.0,0.11443484,4
2020-05-16-170626,170626,1,0,0,15,0.5,0.06143392,5
2020-05-17-170626,170626,0,0,0,15,0.5,0.0147303725,6
2020-05-18-170626,170626,1,0,0,16,9.5,0.4250888,0
2020-05-19-170626,170626,0,1,0,16,1.0,0.07022182,1
2020-05-20-170626,170626,0,0,0,16,0.5,0.021724163,2
2020-05-21-170626,170626,0,0,0,16,1.5,0.04435726,3
2020-05-22-170626,170626,0,0,0,16,2.0,0.07449722,4
2020-05-23-170626,170626,0,0,0,16,0.5,0.017927669,5
2020-05-24-170626,170626,0,0,0,16,0.5,0.020251475,6
2020-05-25-170626,170626,0,0,0,16,2.0,0.10736344,0
2020-05-26-170626,170626,0,0,0,16,0.0,0.024981394,1
2020-05-27-170626,170626,0,0,0,16,0.0,0.020007767,2
2020-05-28-170626,170626,1,1,0,17,2.0,0.18821312,3
2020-05-29-170626,170626,0,0,0,17,1.5,0.07945004,4
2020-05-30-170626,170626,0,0,0,17,0.5,0.00011692744,5
2020-05-31-170626,170626,0,0,0,17,0.0,2.7619606e-05,6
2020-06-01-170626,170626,0,0,0,17,1.0,0.052041378,0
2020-06-02-170626,170626,0,0,0,17,0.5,0.030509092,1
2020-06-03-170626,170626,0,0,0,17,0.0,0.004148284,2
2020-06-04-170626,170626,0,0,0,17,2.5,0.13126746,3
2020-06-05-170626,170626,0,0,0,17,1.0,0.062065437,4
2020-06-06-170626,170626,0,0,0,17,0.0,0.00012804492,5
2020-06-07-170626,170626,0,0,0,17,0.0,0.00018698457,6
2020-06-08-170626,170626,0,0,0,17,0.5,0.02711057,0
2020-06-09-170626,170626,0,0,0,17,0.0,0.0007292864,1
2020-06-10-170626,170626,0,0,0,17,0.0,0.003231616,2
2020-06-11-170626,170626,0,0,0,17,1.5,0.08052653,3
2020-06-12-170626,170626,0,0,0,17,0.0,0.0012182953,4
2020-06-13-170626,170626,0,0,0,17,0.5,0.022958666,5
2020-06-14-170626,170626,0,1,0,17,0.0,7.495693e-05,6
2020-06-15-170626,170626,0,0,0,17,0.0,0.001650506,0
2020-06-16-170626,170626,0,0,0,17,0.0,0.0014617655,1
2020-06-17-170626,170626,0,0,0,17,0.0,0.0021219081,2
2020-06-18-170626,170626,0,0,0,17,0.0,0.0028390763,3
2020-06-19-170626,170626,0,1,0,17,1.5,0.11262488,4
2020-06-20-170626,170626,0,0,0,17,0.0,6.342784e-12,5
2020-06-21-170626,170626,0,0,0,17,0.0,5.8234535e-05,6
2020-06-22-170626,170626,0,0,0,17,0.0,0.0058246166,0
2020-06-23-170626,170626,0,0,0,17,0.5,0.031170644,1
2020-06-24-170626,170626,0,0,0,17,0.0,0.0069864425,2
2020-06-25-170626,170626,0,0,0,17,0.5,0.05924737,3
2020-06-26-170626,170626,0,1,0,17,0.5,0.032271177,4
2020-06-27-170626,170626,0,0,0,17,0.0,0.001378559,5
2020-06-28-170626,170626,0,0,0,17,1.0,0.042122047,6
2020-06-29-170626,170626,0,0,0,17,0.0,0.0016652672,0
2020-06-30-170626,170626,0,0,0,17,0.0,0.001131831,1
2020-07-01-170626,170626,0,0,0,17,0.0,0.0010269728,2
2020-07-02-170626,170626,0,0,0,17,0.5,0.028515466,3
2020-07-03-170626,170626,0,0,0,17,0.0,0.0024703245,4
2020-07-04-170626,170626,0,0,0,17,0.0,2.747778e-08,5
2020-07-05-170626,170626,0,0,0,17,0.5,0.03087974,6
2020-07-06-170626,170626,0,0,0,17,0.0,0.0007257072,0
2020-07-07-170626,170626,0,0,0,17,0.5,0.030165449,1
2020-07-08-170626,170626,0,0,0,17,0.0,0.00015195698,2
2020-07-09-170626,170626,0,2,1,17,0.0,0.0005457753,3
2020-07-10-170626,170626,0,0,0,17,0.0,0.001251129,4
2020-07-11-170626,170626,0,0,0,17,0.0,0.0004429649,5
2020-07-12-170626,170626,0,0,0,17,0.0,0.0031473357,6
2020-07-13-170626,170626,0,1,0,17,0.5,0.029367695,0
2020-07-14-170626,170626,0,0,0,17,0.5,0.04840458,1
2020-07-15-170626,170626,0,0,0,17,0.0,0.00036846113,2
2020-07-16-170626,170626,0,0,1,17,0.5,0.03487046,3
2020-07-17-170626,170626,0,0,0,17,0.0,0.00060669356,4
2020-07-18-170626,170626,0,0,0,17,0.0,0.00021140465,5
2020-07-19-170626,170626,0,0,0,17,0.0,3.122845e-08,6
2020-07-20-170626,170626,0,0,0,17,0.0,0.0007269894,0
2020-07-21-170626,170626,0,0,0,17,0.5,0.03341846,1
2020-07-22-170626,170626,0,0,0,17,0.0,0.0017620359,2
2020-07-23-170626,170626,1,0,1,18,0.0,0.07111406,3
2020-07-24-170626,170626,0,0,1,18,1.0,0.0632286,4
2020-07-25-170626,170626,0,0,0,18,0.5,0.03308032,5
2020-07-26-170626,170626,0,0,0,18,0.0,0.0032847442,6
2020-07-27-170626,170626,0,0,0,18,0.0,0.0006242435,0
2020-07-28-170626,170626,0,0,0,18,0.5,0.034065414,1
2020-07-29-170626,170626,0,0,0,18,0.5,0.004599727,2
2020-07-30-170626,170626,1,0,0,19,1.0,0.003531005,3
2020-07-31-170626,170626,0,0,0,19,0.0,0.01201272,4
2020-08-01-170626,170626,0,0,4,19,0.5,0.053886365,5
2020-08-02-170626,170626,0,0,1,19,0.0,0.005836354,6
2020-08-03-170626,170626,0,0,0,19,1.0,0.041562576,0
2020-08-04-170626,170626,0,1,0,19,0.0,0.010248838,1
2020-08-05-170626,170626,0,0,0,19,0.0,0.0073326654,2
2020-08-06-170626,170626,1,0,0,20,0.0,0.102602206,3
2020-08-07-170626,170626,1,0,0,21,1.0,0.29842713,4
2020-08-08-170626,170626,0,0,0,21,0.5,0.014399756,5
2020-08-09-170626,170626,0,0,0,21,0.0,0.003167943,6
2020-08-10-170626,170626,0,0,0,21,0.5,0.07326438,0
2020-08-11-170626,170626,0,0,0,21,6.0,0.3177356,1
2020-08-12-170626,170626,0,0,0,21,1.0,0.18900211,2
2020-08-13-170626,170626,0,0,1,21,2.0,0.46375296,3
2020-08-14-170626,170626,0,0,1,21,4.0,0.34861168,4
2020-08-15-170626,170626,4,0,0,25,1.0,0.42147985,5
2020-08-16-170626,170626,1,0,0,26,0.0,0.013711654,6
2020-08-17-170626,170626,0,0,0,26,2.5,0.22407304,0
2020-08-18-170626,170626,0,1,1,26,3.5,0.302214,1
2020-08-19-170626,170626,0,0,0,26,5.5,0.41638464,2
2020-08-20-170626,170626,0,0,1,26,4.5,0.35961413,3
2020-08-21-170626,170626,0,0,0,26,3.0,0.14819628,4
2020-08-22-170626,170626,0,0,0,26,1.0,0.0731904,5
2020-08-23-170626,170626,0,0,0,26,0.0,0.0054653874,6
2020-08-24-170626,170626,0,0,2,26,3.0,0.18381122,0
2020-08-25-170626,170626,0,0,1,26,0.5,0.14861135,1
2020-08-26-170626,170626,0,0,0,26,2.0,0.1689712,2
2020-08-27-170626,170626,1,0,0,27,4.0,0.34748033,3
2020-08-28-170626,170626,1,0,0,28,0.5,0.11999043,4
2020-08-29-170626,170626,0,0,0,28,0.5,0.07846796,5
2020-08-30-170626,170626,0,0,0,28,1.5,0.054265853,6
2020-08-31-170626,170626,0,0,1,28,1.0,0.07694572,0
2020-09-01-170626,170626,1,0,0,29,2.5,0.2950743,1
2020-09-02-170626,170626,0,0,1,29,2.0,0.19822511,2
2020-09-03-170626,170626,1,0,0,30,1.0,0.1332267,3
2020-09-04-170626,170626,0,0,0,30,3.5,0.14643016,4
2020-09-05-170626,170626,0,0,0,30,0.0,0.025375891,5
2020-09-06-170626,170626,0,0,0,30,0.0,0.072207645,6
2020-09-07-170626,170626,2,0,0,32,0.0,0.10528672,0
2020-09-08-170626,170626,1,0,0,33,0.0,0.122409284,1
2020-09-09-170626,170626,0,0,0,33,2.0,0.088112965,2
2020-09-10-170626,170626,0,0,0,33,6.5,0.39470103,3
2020-09-11-170626,170626,0,0,0,33,1.0,0.020783367,4
2020-09-12-170626,170626,0,0,0,33,0.0,0.018723054,5
2020-09-13-170626,170626,0,0,0,33,1.0,0.027565693,6
2020-09-14-170626,170626,1,0,0,34,5.5,0.13178581,0
2020-09-15-170626,170626,0,0,1,34,2.5,0.1220914,1
2020-09-16-170626,170626,1,0,0,35,0.0,0.06410738,2
2020-09-17-170626,170626,0,0,0,35,3.0,0.19983885,3
2020-09-18-170626,170626,0,0,0,35,0.5,0.07577244,4
2020-09-19-170626,170626,0,0,0,35,2.0,0.1306063,5
2020-09-20-170626,170626,0,0,0,35,1.0,0.021803755,6
2020-09-21-170626,170626,0,0,2,35,1.5,0.09813457,0
2020-09-22-170626,170626,0,0,0,35,1.5,0.0855139,1
2020-09-23-170626,170626,0,0,0,35,0.5,0.024850212,2
2020-09-24-170626,170626,0,0,0,35,2.0,0.1476711,3
2020-09-25-170626,170626,0,0,0,35,0.5,0.056929596,4
2020-09-26-170626,170626,0,0,0,35,2.0,0.12655579,5
2020-09-27-170626,170626,0,0,0,35,0.0,0.0065825204,6
2020-09-28-170626,170626,0,0,0,35,1.0,0.06610323,0
2020-09-29-170626,170626,1,0,0,36,1.5,0.1263611,1
2020-09-30-170626,170626,0,0,0,36,2.0,0.0998637,2
2020-10-01-170626,170626,0,0,0,36,3.5,0.21841273,3
2020-10-02-170626,170626,0,0,0,36,1.5,0.08381411,4
2020-10-03-170626,170626,0,0,0,36,1.5,0.0881769,5
2020-10-04-170626,170626,0,0,0,36,0.0,0.010463258,6
2020-10-05-170626,170626,2,1,0,38,1.5,0.16911876,0
2020-10-06-170626,170626,0,0,1,38,0.0,0.010188361,1
2020-10-07-170626,170626,0,0,0,38,2.5,0.2693306,2
2020-10-08-170626,170626,0,0,0,38,1.0,0.17845188,3
2020-10-09-170626,170626,0,0,0,38,2.0,0.1400876,4
2020-10-10-170626,170626,0,0,0,38,1.0,0.08850969,5
2020-10-11-170626,170626,0,0,0,38,2.5,0.2267269,6
2020-10-12-170626,170626,0,0,1,38,1.5,0.06444387,0
2020-10-13-170626,170626,0,0,0,38,1.0,0.10553454,1
2020-10-14-170626,170626,0,0,1,38,2.5,0.22490469,2
2020-10-15-170626,170626,0,0,0,38,0.0,0.09781757,3
2020-10-16-170626,170626,0,0,0,38,4.5,0.28959477,4
2020-10-17-170626,170626,0,0,0,38,2.0,0.09462067,5
2020-10-18-170626,170626,0,0,0,38,0.0,0.018771976,6
2020-10-19-170626,170626,0,0,0,38,4.5,0.27246514,0
2020-10-20-170626,170626,1,0,4,39,1.5,0.23691529,1
2020-10-21-170626,170626,0,0,0,39,2.5,0.12777478,2
2020-10-22-170626,170626,0,0,0,39,1.5,0.12339244,3
2020-10-23-170626,170626,0,0,3,39,5.0,0.32527035,4
2020-10-24-170626,170626,0,0,2,39,0.0,0.01135088,5
2020-10-25-170626,170626,0,0,0,39,0.0,0.024014337,6
2020-10-26-170626,170626,1,1,0,40,6.0,0.3760959,0
2020-10-27-170626,170626,0,0,0,40,4.5,0.32011214,1
2020-10-28-170626,170626,1,0,0,41,6.5,0.5588716,2
2020-10-29-170626,170626,0,0,0,41,2.0,0.268963,3
2020-10-30-170626,170626,0,1,2,41,2.5,0.32954264,4
2020-10-31-170626,170626,0,0,0,41,7.0,0.44994745,5
2020-11-01-170626,170626,0,0,0,41,5.5,0.38617432,6
2020-11-02-170626,170626,0,1,0,41,2.0,0.09488016,0
2020-11-03-170626,170626,4,0,0,45,4.5,0.51448756,1
2020-11-04-170626,170626,0,0,0,45,7.0,0.44837418,2
2020-11-05-170626,170626,0,0,0,45,3.5,0.1863905,3
2020-11-06-170626,170626,3,0,0,48,7.0,0.5185355,4
2020-11-07-170626,170626,2,0,0,50,1.5,0.16346408,5
2020-11-08-170626,170626,0,0,0,50,4.5,0.15100402,6
2020-11-09-170626,170626,0,0,0,50,6.0,0.4005814,0
2020-11-10-170626,170626,0,0,0,50,1.5,0.13939911,1
2020-11-11-170626,170626,0,0,0,50,2.5,0.18518166,2
2020-11-12-170626,170626,0,0,0,50,4.0,0.3459234,3
2020-11-13-170626,170626,2,0,0,52,7.0,0.2765863,4
2020-03-01-170627,170627,0,0,6,0,0.0,0.0066200667,6
2020-03-02-170627,170627,0,0,13,0,0.0,0.019555949,0
2020-03-03-170627,170627,2,1,21,2,0.16666666666666666,0.06915234,1
2020-03-04-170627,170627,0,0,18,2,0.16666666666666666,0.071752176,2
2020-03-05-170627,170627,0,1,14,2,0.0,0.008197263,3
2020-03-06-170627,170627,0,0,20,2,0.0,0.0070031025,4
2020-03-07-170627,170627,0,0,10,2,0.0,0.001917064,5
2020-03-08-170627,170627,0,0,10,2,0.0,0.018402684,6
2020-03-09-170627,170627,0,0,30,2,0.6666666666666666,0.07615799,0
2020-03-10-170627,170627,1,0,19,3,0.6666666666666666,0.22794285,1
2020-03-11-170627,170627,0,0,30,3,0.6666666666666666,0.096672036,2
2020-03-12-170627,170627,2,0,17,5,1.0,0.041467,3
2020-03-13-170627,170627,3,0,17,8,2.5,0.39092413,4
2020-03-14-170627,170627,7,0,8,15,3.333333333333333,0.37693474,5
2020-03-15-170627,170627,6,0,5,21,6.5,0.7599815,6
2020-03-16-170627,170627,13,0,29,34,13.5,1.6225704,0
2020-03-17-170627,170627,21,0,18,55,14.166666666666664,1.773889,1
2020-03-18-170627,170627,18,0,9,73,17.166666666666668,1.4913287,2
2020-03-19-170627,170627,14,0,9,87,14.833333333333336,1.846965,3
2020-03-20-170627,170627,20,0,10,107,17.833333333333332,1.9225622,4
2020-03-21-170627,170627,10,0,2,117,6.833333333333332,0.67335963,5
2020-03-22-170627,170627,10,0,2,127,6.333333333333332,0.57291746,6
2020-03-23-170627,170627,30,0,15,157,28.33333333333333,3.7559612,0
2020-03-24-170627,170627,19,0,4,176,23.0,2.6706703,1
2020-03-25-170627,170627,30,0,2,206,23.5,3.0460634,2
2020-03-26-170627,170627,17,1,3,223,22.0,2.540643,3
2020-03-27-170627,170627,17,0,4,240,18.83333333333333,2.6499124,4
2020-03-28-170627,170627,8,0,5,248,5.666666666666668,0.478095,5
2020-03-29-170627,170627,5,0,1,253,6.166666666666668,0.5477738,6
2020-03-30-170627,170627,29,0,10,282,18.83333333333333,2.5922017,0
2020-03-31-170627,170627,18,0,1,300,12.0,1.3991029,1
2020-04-01-170627,170627,9,0,5,309,11.666666666666664,1.7933646,2
2020-04-02-170627,170627,9,0,1,318,8.5,0.8419348,3
2020-04-03-170627,170627,10,0,1,328,9.833333333333334,1.1247952,4
2020-04-04-170627,170627,2,0,2,330,3.0,0.26018262,5
2020-04-05-170627,170627,2,0,0,332,4.5,0.28839263,6
2020-04-06-170627,170627,15,0,6,347,14.833333333333336,1.507916,0
2020-04-07-170627,170627,4,0,4,351,7.5,1.0677224,1
2020-04-08-170627,170627,2,0,5,353,6.5,1.0031488,2
2020-04-09-170627,170627,3,0,1,356,4.166666666666667,0.41275024,3
2020-04-10-170627,170627,4,0,2,360,4.5,0.3626153,4
2020-04-11-170627,170627,5,0,0,365,2.833333333333333,0.2150544,5
2020-04-12-170627,170627,1,0,2,366,2.6666666666666665,0.27368906,6
2020-04-13-170627,170627,10,0,6,376,11.5,1.1746671,0
2020-04-14-170627,170627,1,0,4,377,6.833333333333332,1.4205598,1
2020-04-15-170627,170627,5,0,3,382,6.333333333333332,0.9561434,2
2020-04-16-170627,170627,1,0,3,383,9.5,0.5785,3
2020-04-17-170627,170627,1,0,0,384,8.5,0.7854771,4
2020-04-18-170627,170627,2,0,1,386,4.333333333333333,0.7248876,5
2020-04-19-170627,170627,0,0,2,386,1.1666666666666667,0.14671804,6
2020-04-20-170627,170627,6,0,4,392,5.0,0.7086409,0
2020-04-21-170627,170627,4,0,1,396,5.0,1.263442,1
2020-04-22-170627,170627,5,0,2,401,7.5,1.3117751,2
2020-04-23-170627,170627,1,0,1,402,1.8333333333333333,0.2590836,3
2020-04-24-170627,170627,2,0,5,404,3.5,0.5849925,4
2020-04-25-170627,170627,0,0,3,404,2.333333333333333,0.3945293,5
2020-04-26-170627,170627,2,0,1,406,2.833333333333333,0.492445,6
2020-04-27-170627,170627,6,0,4,412,8.5,1.1580178,0
2020-04-28-170627,170627,4,0,2,416,3.1666666666666665,0.48482522,1
2020-04-29-170627,170627,3,0,5,419,5.5,0.79053277,2
2020-04-30-170627,170627,3,0,2,422,3.1666666666666665,0.44692737,3
2020-05-01-170627,170627,0,0,6,422,2.6666666666666665,0.577753,4
2020-05-02-170627,170627,1,0,1,423,0.8333333333333334,0.2653221,5
2020-05-03-170627,170627,2,0,0,425,0.8333333333333334,0.08392881,6
2020-05-04-170627,170627,4,0,0,429,6.0,1.6112761,0
2020-05-05-170627,170627,1,0,3,430,5.833333333333332,0.6698716,1
2020-05-06-170627,170627,2,0,0,432,3.6666666666666665,1.3768079,2
2020-05-07-170627,170627,1,0,3,433,3.1666666666666665,1.1335893,3
2020-05-08-170627,170627,5,0,3,438,5.333333333333333,0.6859965,4
2020-05-09-170627,170627,3,0,0,441,1.0,0.120196365,5
2020-05-10-170627,170627,1,0,0,442,0.16666666666666666,0.023280725,6
2020-05-11-170627,170627,4,0,1,446,7.166666666666668,1.11399,0
2020-05-12-170627,170627,2,0,1,448,14.166666666666664,1.0202471,1
2020-05-13-170627,170627,5,0,1,453,3.6666666666666665,0.6506771,2
2020-05-14-170627,170627,2,0,3,455,3.6666666666666665,0.39022148,3
2020-05-15-170627,170627,6,0,2,461,3.5,0.5736877,4
2020-05-16-170627,170627,1,0,0,462,0.5,0.01475164,5
2020-05-17-170627,170627,0,0,0,462,0.16666666666666666,0.012616768,6
2020-05-18-170627,170627,0,0,2,462,3.0,0.6172096,0
2020-05-19-170627,170627,3,1,0,465,4.0,0.43780708,1
2020-05-20-170627,170627,0,0,2,465,2.5,0.38620305,2
2020-05-21-170627,170627,3,0,0,468,2.5,0.18402396,3
2020-05-22-170627,170627,3,0,2,471,2.833333333333333,0.2613031,4
2020-05-23-170627,170627,0,0,0,471,0.3333333333333333,0.05966944,5
2020-05-24-170627,170627,0,0,0,471,0.16666666666666666,0.028678628,6
2020-05-25-170627,170627,1,0,3,472,0.6666666666666666,0.32159922,0
2020-05-26-170627,170627,1,0,3,473,1.8333333333333333,0.2517763,1
2020-05-27-170627,170627,1,0,1,474,2.6666666666666665,0.32826802,2
2020-05-28-170627,170627,3,0,3,477,2.833333333333333,0.38624272,3
2020-05-29-170627,170627,2,0,0,479,4.0,0.410729,4
2020-05-30-170627,170627,0,0,0,479,0.16666666666666666,0.01965921,5
2020-05-31-170627,170627,0,1,0,479,0.16666666666666666,0.010202372,6
2020-06-01-170627,170627,2,0,4,481,2.5,0.6085794,0
2020-06-02-170627,170627,0,0,2,481,0.8333333333333334,0.2243723,1
2020-06-03-170627,170627,2,0,3,483,1.3333333333333333,0.1248129,2
2020-06-04-170627,170627,0,0,4,483,3.1666666666666665,0.38234133,3
2020-06-05-170627,170627,2,1,1,485,3.0,0.8781468,4
2020-06-06-170627,170627,0,13,0,485,0.16666666666666666,0.042968255,5
2020-06-07-170627,170627,0,0,0,485,0.16666666666666666,0.061986066,6
2020-06-08-170627,170627,3,0,1,488,1.1666666666666667,0.18688713,0
2020-06-09-170627,170627,3,1,2,491,1.8333333333333333,0.17158753,1
2020-06-10-170627,170627,1,0,3,492,1.8333333333333333,0.15000527,2
2020-06-11-170627,170627,3,0,3,495,2.6666666666666665,0.18479715,3
2020-06-12-170627,170627,0,0,2,495,0.6666666666666666,0.09258436,4
2020-06-13-170627,170627,0,0,0,495,0.16666666666666666,0.0051939124,5
2020-06-14-170627,170627,0,1,0,495,0.0,0.0064055156,6
2020-06-15-170627,170627,4,0,3,499,1.6666666666666667,0.084738486,0
2020-06-16-170627,170627,2,0,0,501,1.5,0.28617156,1
2020-06-17-170627,170627,3,0,0,504,1.3333333333333333,0.23749447,2
2020-06-18-170627,170627,4,0,3,508,2.0,0.24415168,3
2020-06-19-170627,170627,1,0,0,509,2.333333333333333,0.38288078,4
2020-06-20-170627,170627,0,0,0,509,0.0,0.001113745,5
2020-06-21-170627,170627,0,0,0,509,0.16666666666666666,0.013158813,6
2020-06-22-170627,170627,1,0,1,510,2.0,0.20858125,0
2020-06-23-170627,170627,2,0,1,512,2.5,0.33303362,1
2020-06-24-170627,170627,3,0,0,515,0.6666666666666666,0.08247305,2
2020-06-25-170627,170627,3,3,1,518,1.1666666666666667,0.13224389,3
2020-06-26-170627,170627,2,0,0,520,1.1666666666666667,0.14681779,4
2020-06-27-170627,170627,0,0,0,520,0.0,0.024664126,5
2020-06-28-170627,170627,0,0,0,520,0.0,0.015347816,6
2020-06-29-170627,170627,3,0,0,523,0.8333333333333334,0.16079168,0
2020-06-30-170627,170627,0,0,3,523,1.6666666666666667,0.17851591,1
2020-07-01-170627,170627,0,0,0,523,1.8333333333333333,0.09422006,2
2020-07-02-170627,170627,3,0,1,526,0.5,0.048753895,3
2020-07-03-170627,170627,0,0,2,526,1.0,0.114702426,4
2020-07-04-170627,170627,0,0,0,526,0.0,0.00466403,5
2020-07-05-170627,170627,0,0,0,526,0.0,0.012503631,6
2020-07-06-170627,170627,1,0,0,527,0.6666666666666666,0.07111728,0
2020-07-07-170627,170627,1,0,2,528,1.1666666666666667,0.07607862,1
2020-07-08-170627,170627,0,0,0,528,0.3333333333333333,0.007770309,2
2020-07-09-170627,170627,1,0,2,529,1.0,0.104816936,3
2020-07-10-170627,170627,0,0,0,529,1.0,0.06526465,4
2020-07-11-170627,170627,0,0,0,529,0.16666666666666666,0.0055215475,5
2020-07-12-170627,170627,0,0,0,529,0.16666666666666666,0.053683102,6
2020-07-13-170627,170627,0,0,0,529,0.8333333333333334,0.10135371,0
2020-07-14-170627,170627,3,0,0,532,0.6666666666666666,0.13677065,1
2020-07-15-170627,170627,0,0,0,532,0.5,0.01843152,2
2020-07-16-170627,170627,1,0,1,533,1.1666666666666667,0.06437045,3
2020-07-17-170627,170627,2,0,2,535,0.5,0.042081274,4
2020-07-18-170627,170627,0,0,0,535,0.0,0.021966977,5
2020-07-19-170627,170627,0,0,0,535,0.0,0.001955975,6
2020-07-20-170627,170627,0,0,3,535,0.6666666666666666,0.06259242,0
2020-07-21-170627,170627,2,0,3,537,3.0,0.040129963,1
2020-07-22-170627,170627,0,0,4,537,0.6666666666666666,0.16421984,2
2020-07-23-170627,170627,2,0,4,539,1.0,0.012216999,3
2020-07-24-170627,170627,0,0,5,539,0.5,0.02004519,4
2020-07-25-170627,170627,0,0,0,539,0.3333333333333333,0.0146285165,5
2020-07-26-170627,170627,0,0,0,539,0.8333333333333334,0.016215539,6
2020-07-27-170627,170627,0,0,3,539,0.8333333333333334,0.06217093,0
2020-07-28-170627,170627,0,0,0,539,1.0,0.08934104,1
2020-07-29-170627,170627,0,0,3,539,1.5,0.06914407,2
2020-07-30-170627,170627,1,0,4,540,1.1666666666666667,0.19172923,3
2020-07-31-170627,170627,2,0,9,542,3.8333333333333335,0.23422642,4
2020-08-01-170627,170627,0,0,2,542,1.0,0.22047661,5
2020-08-02-170627,170627,0,0,2,542,1.5,0.22485882,6
2020-08-03-170627,170627,3,0,9,545,1.5,0.30732644,0
2020-08-04-170627,170627,3,0,6,548,2.0,0.3334098,1
2020-08-05-170627,170627,4,0,6,552,3.8333333333333335,0.54814893,2
2020-08-06-170627,170627,4,0,9,556,3.0,0.3865466,3
2020-08-07-170627,170627,5,0,2,561,5.333333333333333,0.58636236,4
2020-08-08-170627,170627,0,0,1,561,1.5,0.2961696,5
2020-08-09-170627,170627,0,0,3,561,0.3333333333333333,0.063678145,6
2020-08-10-170627,170627,3,0,7,564,2.333333333333333,0.39205804,0
2020-08-11-170627,170627,0,0,8,564,2.6666666666666665,0.44569156,1
2020-08-12-170627,170627,3,0,9,567,4.833333333333333,0.8324227,2
2020-08-13-170627,170627,4,0,8,571,5.333333333333333,0.6189803,3
2020-08-14-170627,170627,9,0,3,580,3.6666666666666665,0.4853709,4
2020-08-15-170627,170627,2,0,5,582,1.3333333333333333,0.12113057,5
2020-08-16-170627,170627,2,0,2,584,1.8333333333333333,0.23658581,6
2020-08-17-170627,170627,9,0,8,593,7.666666666666668,0.44797158,0
2020-08-18-170627,170627,6,0,3,599,4.0,0.7677229,1
2020-08-19-170627,170627,6,0,5,605,6.5,0.4997626,2
2020-08-20-170627,170627,9,0,8,614,8.166666666666666,0.9552028,3
2020-08-21-170627,170627,2,0,6,616,5.5,0.6761434,4
2020-08-22-170627,170627,1,0,3,617,0.6666666666666666,0.1588658,5
2020-08-23-170627,170627,3,0,0,620,1.1666666666666667,0.26697806,6
2020-08-24-170627,170627,7,0,10,627,7.5,1.0579337,0
2020-08-25-170627,170627,8,0,0,635,5.166666666666667,0.74798506,1
2020-08-26-170627,170627,9,0,8,644,9.833333333333334,0.9450045,2
2020-08-27-170627,170627,8,0,4,652,5.0,0.686628,3
2020-08-28-170627,170627,3,0,8,655,8.833333333333334,0.78871346,4
2020-08-29-170627,170627,5,0,1,660,3.0,0.44293988,5
2020-08-30-170627,170627,2,0,1,662,1.6666666666666667,0.15576793,6
2020-08-31-170627,170627,8,0,10,670,10.0,1.2043374,0
2020-09-01-170627,170627,3,0,3,673,7.166666666666668,1.3357868,1
2020-09-02-170627,170627,5,0,3,678,7.0,1.0444802,2
2020-09-03-170627,170627,8,0,6,686,6.333333333333332,1.4115046,3
2020-09-04-170627,170627,6,1,5,692,9.833333333333334,1.3288375,4
2020-09-05-170627,170627,3,0,2,695,5.5,0.8487808,5
2020-09-06-170627,170627,0,0,4,695,2.6666666666666665,0.56728655,6
2020-09-07-170627,170627,10,0,13,705,8.5,1.6039857,0
2020-09-08-170627,170627,0,0,4,705,3.0,0.67736965,1
2020-09-09-170627,170627,8,0,3,713,5.166666666666667,0.8437479,2
2020-09-10-170627,170627,4,0,7,717,5.0,0.85163814,3
2020-09-11-170627,170627,8,0,4,725,8.666666666666666,1.6780934,4
2020-09-12-170627,170627,1,0,0,726,2.333333333333333,0.48202428,5
2020-09-13-170627,170627,1,1,1,727,1.6666666666666667,0.24009754,6
2020-09-14-170627,170627,10,0,3,737,13.833333333333336,1.7805169,0
2020-09-15-170627,170627,3,0,3,740,6.333333333333332,0.9201401,1
2020-09-16-170627,170627,3,0,6,743,6.0,1.0601274,2
2020-09-17-170627,170627,6,0,2,749,5.833333333333332,0.8459774,3
2020-09-18-170627,170627,5,0,6,754,7.833333333333332,1.7719635,4
2020-09-19-170627,170627,2,0,4,756,1.1666666666666667,0.52121454,5
2020-09-20-170627,170627,4,0,3,760,2.6666666666666665,0.5768249,6
2020-09-21-170627,170627,13,0,9,773,11.0,1.8029073,0
2020-09-22-170627,170627,4,0,7,777,9.0,1.1810614,1
2020-09-23-170627,170627,3,1,11,780,7.166666666666668,1.3661866,2
2020-09-24-170627,170627,7,0,5,787,9.0,1.2765621,3
2020-09-25-170627,170627,4,0,7,791,7.5,1.3292072,4
2020-09-26-170627,170627,0,0,0,791,2.1666666666666665,0.79310256,5
2020-09-27-170627,170627,1,0,2,792,1.3333333333333333,0.41912523,6
2020-09-28-170627,170627,3,1,1,795,4.5,1.0697072,0
2020-09-29-170627,170627,3,0,9,798,7.333333333333332,1.0962615,1
2020-09-30-170627,170627,6,0,7,804,5.333333333333333,0.9435862,2
2020-10-01-170627,170627,2,0,5,806,6.0,0.7422796,3
2020-10-02-170627,170627,6,0,8,812,4.166666666666667,1.0342773,4
2020-10-03-170627,170627,4,0,0,816,1.0,0.4331372,5
2020-10-04-170627,170627,3,0,2,819,2.5,0.33619708,6
2020-10-05-170627,170627,9,1,7,828,6.166666666666668,2.659498,0
2020-10-06-170627,170627,7,0,5,835,7.833333333333332,1.3418353,1
2020-10-07-170627,170627,11,0,3,846,5.5,1.7684251,2
2020-10-08-170627,170627,5,0,7,851,7.166666666666668,1.3835071,3
2020-10-09-170627,170627,7,0,11,858,9.5,1.1449053,4
2020-10-10-170627,170627,0,0,0,858,2.333333333333333,0.41944543,5
2020-10-11-170627,170627,2,0,1,860,4.166666666666667,0.7104242,6
2020-10-12-170627,170627,1,0,9,861,4.166666666666667,0.59794205,0
2020-10-13-170627,170627,9,0,10,870,10.333333333333334,1.5923765,1
2020-10-14-170627,170627,7,0,5,877,10.666666666666666,1.6585764,2
2020-10-15-170627,170627,5,0,6,882,14.0,2.3225248,3
2020-10-16-170627,170627,8,0,10,890,15.833333333333336,2.6561537,4
2020-10-17-170627,170627,0,0,3,890,2.0,0.6013891,5
2020-10-18-170627,170627,2,0,4,892,5.333333333333333,0.5470391,6
2020-10-19-170627,170627,7,0,0,899,19.33333333333333,2.1026018,0
2020-10-20-170627,170627,5,0,11,904,16.5,2.094564,1
2020-10-21-170627,170627,3,0,6,907,17.5,2.6821215,2
2020-10-22-170627,170627,7,0,8,914,15.5,2.8994052,3
2020-10-23-170627,170627,11,1,8,925,16.833333333333332,2.4166832,4
2020-10-24-170627,170627,0,0,2,925,3.333333333333333,0.69701016,5
2020-10-25-170627,170627,1,0,4,926,4.166666666666667,0.7697658,6
2020-10-26-170627,170627,9,1,5,935,15.833333333333336,2.043126,0
2020-10-27-170627,170627,10,0,4,945,14.0,1.9933007,1
2020-10-28-170627,170627,5,2,8,950,14.166666666666664,2.1376965,2
2020-10-29-170627,170627,6,0,22,956,9.833333333333334,2.0485318,3
2020-10-30-170627,170627,10,0,16,966,15.5,1.9803555,4
2020-10-31-170627,170627,3,0,0,969,4.166666666666667,0.32726234,5
2020-11-01-170627,170627,4,1,0,973,4.166666666666667,0.5444723,6
2020-11-02-170627,170627,0,0,0,973,3.0,0.53207517,0
2020-11-03-170627,170627,11,0,0,984,16.666666666666668,2.191605,1
2020-11-04-170627,170627,6,1,0,990,14.0,1.852124,2
2020-11-05-170627,170627,8,0,0,998,11.0,1.8664943,3
2020-11-06-170627,170627,8,1,0,1006,9.666666666666666,1.4783375,4
2020-11-07-170627,170627,2,0,0,1008,3.5,0.45060512,5
2020-11-08-170627,170627,4,0,0,1012,2.833333333333333,0.45715863,6
2020-11-09-170627,170627,5,0,0,1017,14.0,2.1397092,0
2020-11-10-170627,170627,4,0,0,1021,9.666666666666666,1.0195276,1
2020-11-11-170627,170627,8,1,0,1029,7.0,1.2592267,2
2020-11-12-170627,170627,22,0,0,1051,7.333333333333332,1.1558299,3
2020-11-13-170627,170627,16,1,0,1067,6.0,1.0199413,4
2020-03-01-170628,170628,0,0,8,0,0.25,0.045303192,6
2020-03-02-170628,170628,0,0,16,0,0.0,0.038340166,0
2020-03-03-170628,170628,0,0,12,0,0.375,0.15529938,1
2020-03-04-170628,170628,1,0,16,1,0.0,0.15371104,2
2020-03-05-170628,170628,0,4,12,1,0.0,0.016780047,3
2020-03-06-170628,170628,0,0,14,1,0.125,0.017404815,4
2020-03-07-170628,170628,0,0,11,1,0.0,0.00643137,5
2020-03-08-170628,170628,0,0,13,1,0.125,0.05480847,6
2020-03-09-170628,170628,1,0,36,2,0.25,0.14195375,0
2020-03-10-170628,170628,1,0,32,3,0.5,0.4426258,1
2020-03-11-170628,170628,2,0,31,5,0.25,0.22247,2
2020-03-12-170628,170628,0,0,13,5,1.25,0.12787235,3
2020-03-13-170628,170628,2,0,20,7,2.125,0.8813362,4
2020-03-14-170628,170628,5,0,8,12,3.125,1.0519406,5
2020-03-15-170628,170628,8,0,8,20,7.125,1.8249975,6
2020-03-16-170628,170628,16,1,16,36,15.875,4.0920215,0
2020-03-17-170628,170628,12,0,15,48,15.375,4.4872546,1
2020-03-18-170628,170628,16,0,20,64,17.25,3.8409402,2
2020-03-19-170628,170628,12,0,11,76,16.75,4.6122327,3
2020-03-20-170628,170628,14,0,22,90,20.125,4.9649615,4
2020-03-21-170628,170628,11,0,2,101,9.375,2.009195,5
2020-03-22-170628,170628,13,0,15,114,9.875,1.9200801,6
2020-03-23-170628,170628,36,0,15,150,33.125,10.412272,0
2020-03-24-170628,170628,32,0,18,182,25.0,7.046699,1
2020-03-25-170628,170628,31,0,12,213,26.5,8.722802,2
2020-03-26-170628,170628,13,0,6,226,21.625,6.8183208,3
2020-03-27-170628,170628,20,0,3,246,24.875,7.491846,4
2020-03-28-170628,170628,8,0,7,254,4.75,1.2653363,5
2020-03-29-170628,170628,8,0,4,262,5.75,1.494194,6
2020-03-30-170628,170628,16,0,30,278,27.375,7.761093,0
2020-03-31-170628,170628,15,0,12,293,17.0,4.3165245,1
2020-04-01-170628,170628,20,0,17,313,16.0,5.4498653,2
2020-04-02-170628,170628,11,0,12,324,8.75,2.4502974,3
2020-04-03-170628,170628,22,0,6,346,10.875,3.4575183,4
2020-04-04-170628,170628,2,0,5,348,4.0,0.75378263,5
2020-04-05-170628,170628,15,0,1,363,3.625,0.90274626,6
2020-04-06-170628,170628,15,0,11,378,18.0,4.118805,0
2020-04-07-170628,170628,18,0,2,396,10.5,3.0989802,1
2020-04-08-170628,170628,12,0,9,408,9.75,2.7819362,2
2020-04-09-170628,170628,6,0,0,414,4.0,1.1271842,3
2020-04-10-170628,170628,3,0,5,417,6.0,1.1460005,4
2020-04-11-170628,170628,7,0,5,424,3.625,0.7303659,5
2020-04-12-170628,170628,4,0,2,428,4.125,0.9546152,6
2020-04-13-170628,170628,30,0,9,458,9.25,3.128189,0
2020-04-14-170628,170628,12,0,7,470,11.625,4.48836,1
2020-04-15-170628,170628,17,0,5,487,6.625,2.830088,2
2020-04-16-170628,170628,12,0,5,499,4.625,1.8378307,3
2020-04-17-170628,170628,6,0,2,505,7.125,2.5229828,4
2020-04-18-170628,170628,5,0,0,510,4.375,1.8791236,5
2020-04-19-170628,170628,1,0,1,511,2.25,0.46953195,6
2020-04-20-170628,170628,11,0,4,522,6.625,2.1712992,0
2020-04-21-170628,170628,2,0,9,524,9.25,3.3846085,1
2020-04-22-170628,170628,9,0,3,533,9.25,3.6352432,2
2020-04-23-170628,170628,0,0,3,533,2.375,0.7012119,3
2020-04-24-170628,170628,5,0,9,538,4.75,1.8211823,4
2020-04-25-170628,170628,5,0,3,543,2.25,1.0173903,5
2020-04-26-170628,170628,2,0,0,545,2.25,1.0291858,6
2020-04-27-170628,170628,9,0,8,554,7.75,3.024692,0
2020-04-28-170628,170628,7,0,9,561,4.75,1.6163315,1
2020-04-29-170628,170628,5,0,5,566,6.5,2.410419,2
2020-04-30-170628,170628,5,0,5,571,3.625,1.4804125,3
2020-05-01-170628,170628,2,0,5,573,3.75,1.4686567,4
2020-05-02-170628,170628,0,0,0,573,2.5,0.89921016,5
2020-05-03-170628,170628,1,0,0,574,1.0,0.1956138,6
2020-05-04-170628,170628,4,0,5,578,9.75,4.415932,0
2020-05-05-170628,170628,9,1,5,587,4.375,1.7973528,1
2020-05-06-170628,170628,3,0,1,590,9.375,5.6800694,2
2020-05-07-170628,170628,3,0,1,593,6.25,3.1562428,3
2020-05-08-170628,170628,9,0,3,602,6.875,2.0990615,4
2020-05-09-170628,170628,3,0,1,605,1.375,0.4031131,5
2020-05-10-170628,170628,0,0,0,605,0.625,0.106095195,6
2020-05-11-170628,170628,8,1,0,613,6.75,2.7879925,0
2020-05-12-170628,170628,9,0,1,622,13.0,2.6202998,1
2020-05-13-170628,170628,5,0,3,627,5.75,1.7594632,2
2020-05-14-170628,170628,5,0,5,632,3.25,1.0608256,3
2020-05-15-170628,170628,5,0,3,637,5.0,1.6397583,4
2020-05-16-170628,170628,0,0,0,637,0.5,0.048672833,5
2020-05-17-170628,170628,0,0,1,637,0.25,0.06070781,6
2020-05-18-170628,170628,5,0,1,642,3.125,1.5146282,0
2020-05-19-170628,170628,5,0,0,647,3.5,1.2338737,1
2020-05-20-170628,170628,1,0,3,648,2.75,0.9798373,2
2020-05-21-170628,170628,1,0,3,649,2.25,0.52780247,3
2020-05-22-170628,170628,3,0,1,652,3.625,0.9253814,4
2020-05-23-170628,170628,1,0,0,653,0.25,0.13415375,5
2020-05-24-170628,170628,0,0,0,653,0.375,0.14706498,6
2020-05-25-170628,170628,0,0,0,653,2.5,0.95881927,0
2020-05-26-170628,170628,1,0,2,654,1.875,0.6621855,1
2020-05-27-170628,170628,3,0,0,657,2.0,0.8251176,2
2020-05-28-170628,170628,5,1,4,662,2.125,1.2136782,3
2020-05-29-170628,170628,3,0,3,665,2.0,0.9976692,4
2020-05-30-170628,170628,0,0,0,665,0.0,0.06399484,5
2020-05-31-170628,170628,1,1,0,666,0.0,0.03624468,6
2020-06-01-170628,170628,1,0,1,667,3.875,1.5672256,0
2020-06-02-170628,170628,0,0,1,667,1.875,0.8826089,1
2020-06-03-170628,170628,3,0,1,670,2.125,0.4389326,2
2020-06-04-170628,170628,3,0,2,673,2.125,0.86834824,3
2020-06-05-170628,170628,1,0,5,674,2.625,2.1351676,4
2020-06-06-170628,170628,0,0,0,674,0.375,0.22388802,5
2020-06-07-170628,170628,0,0,1,674,0.125,0.12082912,6
2020-06-08-170628,170628,0,0,3,674,1.625,0.49558437,0
2020-06-09-170628,170628,2,0,3,676,1.5,0.47134224,1
2020-06-10-170628,170628,0,0,2,676,1.25,0.363791,2
2020-06-11-170628,170628,4,0,3,680,1.375,0.48660654,3
2020-06-12-170628,170628,3,0,1,683,0.125,0.3196319,4
2020-06-13-170628,170628,0,0,0,683,0.0,0.02082539,5
2020-06-14-170628,170628,0,2,0,683,0.0,0.011299953,6
2020-06-15-170628,170628,1,0,0,684,1.5,0.2038357,0
2020-06-16-170628,170628,1,0,2,685,1.5,0.81630373,1
2020-06-17-170628,170628,1,0,0,686,1.125,0.5635319,2
2020-06-18-170628,170628,2,0,2,688,2.0,0.669759,3
2020-06-19-170628,170628,5,0,1,693,2.0,1.1200527,4
2020-06-20-170628,170628,0,0,0,693,0.0,0.0026401198,5
2020-06-21-170628,170628,1,0,0,694,0.0,0.043626115,6
2020-06-22-170628,170628,3,0,0,697,1.5,0.60519654,0
2020-06-23-170628,170628,3,0,4,700,1.5,0.9923159,1
2020-06-24-170628,170628,2,0,0,702,0.75,0.2995755,2
2020-06-25-170628,170628,3,1,2,705,0.875,0.37970647,3
2020-06-26-170628,170628,1,1,0,706,1.375,0.46164176,4
2020-06-27-170628,170628,0,0,0,706,0.125,0.08429521,5
2020-06-28-170628,170628,0,0,0,706,0.0,0.042870965,6
2020-06-29-170628,170628,0,0,0,706,1.25,0.42789575,0
2020-06-30-170628,170628,2,0,2,708,0.375,0.4143143,1
2020-07-01-170628,170628,0,0,1,708,0.5,0.23221202,2
2020-07-02-170628,170628,2,0,2,710,0.625,0.17643395,3
2020-07-03-170628,170628,1,0,2,711,0.875,0.32339147,4
2020-07-04-170628,170628,0,0,0,711,0.0,0.04750179,5
2020-07-05-170628,170628,0,0,0,711,0.0,0.038012233,6
2020-07-06-170628,170628,0,0,2,711,0.625,0.1605988,0
2020-07-07-170628,170628,4,0,0,715,0.25,0.19452268,1
2020-07-08-170628,170628,0,0,1,715,0.125,0.06200666,2
2020-07-09-170628,170628,2,0,0,717,0.625,0.3039095,3
2020-07-10-170628,170628,0,0,1,717,0.875,0.15855093,4
2020-07-11-170628,170628,0,0,2,717,0.0,0.026826894,5
2020-07-12-170628,170628,0,0,1,717,0.125,0.15677826,6
2020-07-13-170628,170628,0,0,2,717,0.25,0.2863915,0
2020-07-14-170628,170628,2,0,3,719,0.625,0.33121943,1
2020-07-15-170628,170628,1,0,2,720,0.625,0.052594583,2
2020-07-16-170628,170628,2,0,1,722,0.625,0.24969001,3
2020-07-17-170628,170628,2,0,1,724,0.25,0.11647944,4
2020-07-18-170628,170628,0,0,1,724,0.125,0.125679,5
2020-07-19-170628,170628,0,0,5,724,0.0,0.0061421567,6
2020-07-20-170628,170628,2,0,1,726,0.375,0.18283515,0
2020-07-21-170628,170628,0,0,1,726,0.75,0.1790174,1
2020-07-22-170628,170628,1,0,6,727,1.125,0.47605088,2
2020-07-23-170628,170628,0,0,4,727,0.375,0.04137316,3
2020-07-24-170628,170628,1,1,5,728,0.25,0.061913185,4
2020-07-25-170628,170628,2,0,1,730,0.0,0.051316604,5
2020-07-26-170628,170628,1,0,0,731,0.125,0.047825135,6
2020-07-27-170628,170628,2,0,4,733,0.375,0.22028565,0
2020-07-28-170628,170628,3,0,2,736,0.5,0.2596983,1
2020-07-29-170628,170628,2,0,2,738,0.125,0.17446367,2
2020-07-30-170628,170628,1,0,11,739,0.875,0.58133864,3
2020-07-31-170628,170628,1,1,2,740,2.125,0.6138115,4
2020-08-01-170628,170628,1,0,2,741,0.875,0.6314152,5
2020-08-02-170628,170628,5,0,1,746,1.125,0.71072364,6
2020-08-03-170628,170628,1,0,7,747,1.875,0.90719646,0
2020-08-04-170628,170628,1,0,4,748,2.125,1.0921785,1
2020-08-05-170628,170628,6,0,4,754,3.5,1.5695603,2
2020-08-06-170628,170628,4,0,5,758,1.875,1.115391,3
2020-08-07-170628,170628,5,0,2,763,3.5,1.6829419,4
2020-08-08-170628,170628,1,0,1,764,1.375,1.1135589,5
2020-08-09-170628,170628,0,0,1,764,0.875,0.2987222,6
2020-08-10-170628,170628,4,0,6,768,1.625,1.159088,0
2020-08-11-170628,170628,2,0,9,770,1.625,1.3529353,1
2020-08-12-170628,170628,2,0,10,772,3.375,2.6113348,2
2020-08-13-170628,170628,11,0,3,783,5.375,2.1664453,3
2020-08-14-170628,170628,2,0,9,785,4.5,2.0102463,4
2020-08-15-170628,170628,2,0,4,787,1.5,0.35318926,5
2020-08-16-170628,170628,1,0,2,788,2.25,0.81538296,6
2020-08-17-170628,170628,7,0,8,795,4.75,1.4859942,0
2020-08-18-170628,170628,4,0,11,799,4.375,2.073638,1
2020-08-19-170628,170628,4,0,10,803,5.0,1.5886648,2
2020-08-20-170628,170628,5,0,8,808,6.875,3.052563,3
2020-08-21-170628,170628,2,0,4,810,6.25,2.259051,4
2020-08-22-170628,170628,1,0,7,811,0.875,0.63458776,5
2020-08-23-170628,170628,1,0,3,812,3.75,0.9972238,6
2020-08-24-170628,170628,6,0,6,818,7.375,3.2845225,0
2020-08-25-170628,170628,9,0,2,827,6.75,2.5568373,1
2020-08-26-170628,170628,10,0,5,837,8.625,3.194001,2
2020-08-27-170628,170628,3,0,8,840,5.875,2.794486,3
2020-08-28-170628,170628,9,0,5,849,7.5,2.8180656,4
2020-08-29-170628,170628,4,1,1,853,3.0,1.4701291,5
2020-08-30-170628,170628,2,0,2,855,2.625,0.8714679,6
2020-08-31-170628,170628,8,0,12,863,9.5,4.3110285,0
2020-09-01-170628,170628,11,0,5,874,6.5,4.125654,1
2020-09-02-170628,170628,10,0,4,884,5.5,2.685991,2
2020-09-03-170628,170628,8,2,3,892,7.125,3.8329709,3
2020-09-04-170628,170628,4,0,4,896,11.25,3.7700992,4
2020-09-05-170628,170628,7,0,0,903,5.375,2.9614117,5
2020-09-06-170628,170628,3,0,6,906,4.5,2.3730214,6
2020-09-07-170628,170628,6,0,13,912,11.25,4.6451254,0
2020-09-08-170628,170628,2,0,13,914,2.375,2.0128784,1
2020-09-09-170628,170628,5,0,7,919,4.625,1.8257023,2
2020-09-10-170628,170628,8,1,5,927,6.125,2.646767,3
2020-09-11-170628,170628,5,0,7,932,12.875,4.4352746,4
2020-09-12-170628,170628,1,0,2,933,4.75,2.2314298,5
2020-09-13-170628,170628,2,0,1,935,3.625,1.2959567,6
2020-09-14-170628,170628,12,0,9,947,13.75,5.195988,0
2020-09-15-170628,170628,5,0,4,952,8.25,3.0872655,1
2020-09-16-170628,170628,4,0,7,956,5.25,3.3161554,2
2020-09-17-170628,170628,3,0,8,959,7.125,2.7520318,3
2020-09-18-170628,170628,4,0,3,963,15.875,5.1652436,4
2020-09-19-170628,170628,0,0,1,963,6.25,3.4590695,5
2020-09-20-170628,170628,6,1,3,969,5.125,2.1396616,6
2020-09-21-170628,170628,13,0,6,982,11.75,4.822124,0
2020-09-22-170628,170628,13,0,5,995,7.125,3.2137427,1
2020-09-23-170628,170628,7,1,4,1002,7.125,4.061421,2
2020-09-24-170628,170628,5,1,8,1007,8.625,3.616279,3
2020-09-25-170628,170628,7,0,14,1014,7.5,3.9946623,4
2020-09-26-170628,170628,2,0,6,1016,3.125,2.4014323,5
2020-09-27-170628,170628,1,0,11,1017,1.875,1.2270097,6
2020-09-28-170628,170628,9,0,5,1026,5.875,3.1802661,0
2020-09-29-170628,170628,4,0,8,1030,5.625,2.7106476,1
2020-09-30-170628,170628,7,0,5,1037,7.0,3.1329203,2
2020-10-01-170628,170628,8,0,34,1045,4.125,2.2871523,3
2020-10-02-170628,170628,3,0,11,1048,5.875,2.9849885,4
2020-10-03-170628,170628,1,0,4,1049,2.0,1.47884,5
2020-10-04-170628,170628,3,2,9,1052,2.375,0.9890333,6
2020-10-05-170628,170628,6,1,28,1058,13.375,7.248459,0
2020-10-06-170628,170628,5,0,30,1063,7.5,3.5631964,1
2020-10-07-170628,170628,4,1,15,1067,8.625,4.9376364,2
2020-10-08-170628,170628,8,1,8,1075,6.0,3.646717,3
2020-10-09-170628,170628,14,1,19,1089,7.75,3.7456615,4
2020-10-10-170628,170628,6,0,2,1095,2.5,1.6867143,5
2020-10-11-170628,170628,11,0,12,1106,3.625,2.1338372,6
2020-10-12-170628,170628,5,0,15,1111,3.625,1.585777,0
2020-10-13-170628,170628,8,0,11,1119,7.0,4.350549,1
2020-10-14-170628,170628,5,0,10,1124,8.5,4.2232127,2
2020-10-15-170628,170628,34,0,6,1158,6.25,6.0443997,3
2020-10-16-170628,170628,11,0,17,1169,12.75,7.1302633,4
2020-10-17-170628,170628,4,0,4,1173,2.375,2.075253,5
2020-10-18-170628,170628,9,0,7,1182,3.5,1.7799032,6
2020-10-19-170628,170628,28,1,7,1210,13.0,6.1935163,0
2020-10-20-170628,170628,30,1,12,1240,7.875,5.229031,1
2020-10-21-170628,170628,15,0,17,1255,12.625,6.92828,2
2020-10-22-170628,170628,8,0,8,1263,12.125,8.025471,3
2020-10-23-170628,170628,19,2,6,1282,14.75,7.456892,4
2020-10-24-170628,170628,2,2,3,1284,3.0,2.202662,5
2020-10-25-170628,170628,12,0,2,1296,5.125,2.163601,6
2020-10-26-170628,170628,15,0,7,1311,10.25,5.6867547,0
2020-10-27-170628,170628,11,0,11,1322,11.5,5.745089,1
2020-10-28-170628,170628,10,1,9,1332,9.5,5.6337156,2
2020-10-29-170628,170628,6,1,10,1338,9.375,5.5588903,3
2020-10-30-170628,170628,17,1,8,1355,12.25,5.65816,4
2020-10-31-170628,170628,4,2,0,1359,2.75,1.3858111,5
2020-11-01-170628,170628,7,1,0,1366,3.75,1.6449891,6
2020-11-02-170628,170628,7,0,0,1373,3.0,1.6207806,0
2020-11-03-170628,170628,12,1,0,1385,13.875,6.3393517,1
2020-11-04-170628,170628,17,1,0,1402,10.875,5.3036118,2
2020-11-05-170628,170628,8,1,0,1410,10.875,5.3430915,3
2020-11-06-170628,170628,6,1,0,1416,10.125,4.458091,4
2020-11-07-170628,170628,3,0,0,1419,3.0,1.2706587,5
2020-11-08-170628,170628,2,1,0,1421,5.0,1.709174,6
2020-11-09-170628,170628,7,0,0,1428,14.375,6.0108843,0
2020-11-10-170628,170628,11,0,0,1439,7.0,2.958839,1
2020-11-11-170628,170628,9,5,0,1448,8.0,3.7011218,2
2020-11-12-170628,170628,10,0,0,1458,9.0,3.4082613,3
2020-11-13-170628,170628,8,0,0,1466,10.375,2.9797845,4
2020-03-01-170629,170629,0,0,3,0,0.0,0.0020156205,6
2020-03-02-170629,170629,0,0,8,0,0.0,0.0047648693,0
2020-03-03-170629,170629,0,0,5,0,0.5,0.01711244,1
2020-03-04-170629,170629,0,0,15,0,0.0,0.017018478,2
2020-03-05-170629,170629,0,0,8,0,0.0,0.0018405819,3
2020-03-06-170629,170629,0,0,9,0,0.0,0.002054207,4
2020-03-07-170629,170629,0,0,8,0,0.0,0.00093266834,5
2020-03-08-170629,170629,0,0,2,0,0.0,0.0063511464,6
2020-03-09-170629,170629,1,0,13,1,0.75,0.017660992,0
2020-03-10-170629,170629,0,0,8,1,0.5,0.054169293,1
2020-03-11-170629,170629,0,0,11,1,1.25,0.02766846,2
2020-03-12-170629,170629,0,0,18,1,2.25,0.01013421,3
2020-03-13-170629,170629,1,0,11,2,4.0,0.091178685,4
2020-03-14-170629,170629,1,0,2,3,3.25,0.09195898,5
2020-03-15-170629,170629,3,0,5,6,5.25,0.17608182,6
2020-03-16-170629,170629,8,0,5,14,13.5,0.36448053,0
2020-03-17-170629,170629,5,0,11,19,18.25,0.40017596,1
2020-03-18-170629,170629,15,0,4,34,23.5,0.33485377,2
2020-03-19-170629,170629,8,0,8,42,17.25,0.41884667,3
2020-03-20-170629,170629,9,0,4,51,21.75,0.4387839,4
2020-03-21-170629,170629,8,0,0,59,7.25,0.14952572,5
2020-03-22-170629,170629,2,0,2,61,9.25,0.13915284,6
2020-03-23-170629,170629,13,0,5,74,29.0,0.8535359,0
2020-03-24-170629,170629,8,0,5,82,24.75,0.6313983,1
2020-03-25-170629,170629,11,0,4,93,27.5,0.7008733,2
2020-03-26-170629,170629,18,0,1,111,24.0,0.563074,3
2020-03-27-170629,170629,11,0,2,122,18.0,0.6073136,4
2020-03-28-170629,170629,2,0,1,124,7.25,0.10869282,5
2020-03-29-170629,170629,5,0,1,129,5.0,0.12768584,6
2020-03-30-170629,170629,5,1,3,134,22.0,0.5685617,0
2020-03-31-170629,170629,11,0,0,145,14.5,0.32947952,1
2020-04-01-170629,170629,4,0,1,149,12.0,0.42853385,2
2020-04-02-170629,170629,8,0,1,157,7.0,0.1901704,3
2020-04-03-170629,170629,4,0,11,161,7.75,0.27767798,4
2020-04-04-170629,170629,0,0,2,161,4.0,0.060119342,5
2020-04-05-170629,170629,2,0,1,163,2.75,0.07121533,6
2020-04-06-170629,170629,5,0,4,168,18.75,0.35431546,0
2020-04-07-170629,170629,5,0,1,173,6.75,0.2995668,1
2020-04-08-170629,170629,4,0,3,177,5.5,0.23729251,2
2020-04-09-170629,170629,1,0,2,178,2.75,0.09583844,3
2020-04-10-170629,170629,2,0,2,180,5.25,0.09114457,4
2020-04-11-170629,170629,1,0,0,181,4.0,0.056740716,5
2020-04-12-170629,170629,1,0,1,182,3.25,0.08003691,6
2020-04-13-170629,170629,3,0,1,185,9.5,0.2767066,0
2020-04-14-170629,170629,0,0,0,185,7.0,0.36007902,1
2020-04-15-170629,170629,1,0,1,186,3.75,0.2179316,2
2020-04-16-170629,170629,1,1,4,187,6.75,0.13599686,3
2020-04-17-170629,170629,11,0,1,198,5.75,0.18900332,4
2020-04-18-170629,170629,2,0,0,200,2.0,0.15889068,5
2020-04-19-170629,170629,1,0,1,201,0.5,0.031018674,6
2020-04-20-170629,170629,4,0,2,205,4.25,0.16369902,0
2020-04-21-170629,170629,1,0,4,206,4.75,0.3018332,1
2020-04-22-170629,170629,3,0,0,209,6.25,0.30907127,2
2020-04-23-170629,170629,2,0,0,211,0.5,0.059087504,3
2020-04-24-170629,170629,2,0,2,213,4.0,0.13949217,4
2020-04-25-170629,170629,0,0,1,213,1.25,0.08506504,5
2020-04-26-170629,170629,1,0,0,214,1.25,0.09214036,6
2020-04-27-170629,170629,1,0,3,215,8.0,0.25301212,0
2020-04-28-170629,170629,0,0,5,215,3.5,0.11518836,1
2020-04-29-170629,170629,1,0,3,216,6.25,0.17714125,2
2020-04-30-170629,170629,4,0,4,220,3.0,0.10896737,3
2020-05-01-170629,170629,1,0,0,221,1.25,0.13070214,4
2020-05-02-170629,170629,0,0,0,221,1.5,0.054162618,5
2020-05-03-170629,170629,1,0,0,222,1.5,0.020386431,6
2020-05-04-170629,170629,2,0,3,224,5.0,0.35517025,0
2020-05-05-170629,170629,4,0,3,228,6.5,0.14858598,1
2020-05-06-170629,170629,0,0,1,228,5.25,0.28562325,2
2020-05-07-170629,170629,0,0,5,228,3.5,0.26854303,3
2020-05-08-170629,170629,2,0,0,230,5.75,0.16898003,4
2020-05-09-170629,170629,1,0,0,231,1.0,0.031372134,5
2020-05-10-170629,170629,0,0,0,231,0.75,0.005852536,6
2020-05-11-170629,170629,3,3,1,234,6.5,0.25206164,0
2020-05-12-170629,170629,5,5,0,239,18.75,0.25416315,1
2020-05-13-170629,170629,3,3,2,242,3.75,0.16914636,2
2020-05-14-170629,170629,4,0,4,246,2.75,0.08648807,3
2020-05-15-170629,170629,0,0,4,246,7.0,0.14048076,4
2020-05-16-170629,170629,0,0,0,246,1.25,0.004588525,5
2020-05-17-170629,170629,0,0,0,246,0.0,0.002538462,6
2020-05-18-170629,170629,3,1,1,249,0.5,0.136044,0
2020-05-19-170629,170629,3,0,1,252,2.25,0.1068511,1
2020-05-20-170629,170629,1,1,1,253,2.0,0.08649529,2
2020-05-21-170629,170629,5,0,5,258,2.0,0.047624398,3
2020-05-22-170629,170629,0,0,0,258,4.25,0.06955177,4
2020-05-23-170629,170629,0,0,0,258,0.0,0.012039689,5
2020-05-24-170629,170629,0,0,0,258,0.0,0.006162453,6
2020-05-25-170629,170629,1,0,1,259,1.25,0.0920119,0
2020-05-26-170629,170629,0,0,1,259,2.0,0.06224083,1
2020-05-27-170629,170629,2,0,2,261,2.5,0.079348676,2
2020-05-28-170629,170629,4,2,1,265,1.5,0.099155284,3
2020-05-29-170629,170629,4,0,1,269,2.25,0.10181204,4
2020-05-30-170629,170629,0,1,1,269,1.0,0.0059659034,5
2020-05-31-170629,170629,0,0,0,269,0.0,0.0028770345,6
2020-06-01-170629,170629,1,0,3,270,2.5,0.14506426,0
2020-06-02-170629,170629,1,0,0,271,1.0,0.054769516,1
2020-06-03-170629,170629,1,0,1,272,2.25,0.031124517,2
2020-06-04-170629,170629,5,0,2,277,2.25,0.09256162,3
2020-06-05-170629,170629,0,0,0,277,1.5,0.21332644,4
2020-06-06-170629,170629,0,0,0,277,0.25,0.010140041,5
2020-06-07-170629,170629,0,0,0,277,0.25,0.013691883,6
2020-06-08-170629,170629,1,0,1,278,1.75,0.045765106,0
2020-06-09-170629,170629,1,0,2,279,2.75,0.044868816,1
2020-06-10-170629,170629,2,0,1,281,1.5,0.03530841,2
2020-06-11-170629,170629,1,0,0,282,1.75,0.05141689,3
2020-06-12-170629,170629,1,0,1,283,0.0,0.024229312,4
2020-06-13-170629,170629,1,1,0,284,0.25,0.0013695124,5
2020-06-14-170629,170629,0,0,0,284,0.0,0.0016575125,6
2020-06-15-170629,170629,3,0,0,287,2.5,0.020663233,0
2020-06-16-170629,170629,0,0,3,287,1.75,0.0706104,1
2020-06-17-170629,170629,1,0,1,288,1.75,0.0552112,2
2020-06-18-170629,170629,2,0,0,290,1.75,0.05983737,3
2020-06-19-170629,170629,0,0,1,290,2.0,0.10153885,4
2020-06-20-170629,170629,0,0,0,290,0.0,0.00032816257,5
2020-06-21-170629,170629,0,0,0,290,0.0,0.003547338,6
2020-06-22-170629,170629,1,0,1,291,1.5,0.056090575,0
2020-06-23-170629,170629,2,0,0,293,1.5,0.08470856,1
2020-06-24-170629,170629,1,0,1,294,1.5,0.022983273,2
2020-06-25-170629,170629,0,1,0,294,1.5,0.034412492,3
2020-06-26-170629,170629,1,1,0,295,2.25,0.046497285,4
2020-06-27-170629,170629,0,1,1,295,0.0,0.008273273,5
2020-06-28-170629,170629,0,0,0,295,0.0,0.005751747,6
2020-06-29-170629,170629,0,0,0,295,1.0,0.039674968,0
2020-06-30-170629,170629,3,0,0,298,0.5,0.042506002,1
2020-07-01-170629,170629,1,0,0,299,1.0,0.024198206,2
2020-07-02-170629,170629,0,0,0,299,1.25,0.0125326095,3
2020-07-03-170629,170629,1,0,0,300,1.0,0.035039634,4
2020-07-04-170629,170629,0,0,0,300,0.0,0.0016586565,5
2020-07-05-170629,170629,0,0,0,300,0.0,0.004832708,6
2020-07-06-170629,170629,1,0,1,301,0.5,0.017397083,0
2020-07-07-170629,170629,0,0,0,301,1.0,0.019284176,1
2020-07-08-170629,170629,1,0,0,302,0.25,0.0026071134,2
2020-07-09-170629,170629,0,0,1,302,1.25,0.02635671,3
2020-07-10-170629,170629,0,0,0,302,1.25,0.015927523,4
2020-07-11-170629,170629,1,0,0,303,0.0,0.001550549,5
2020-07-12-170629,170629,0,0,0,303,0.25,0.013077062,6
2020-07-13-170629,170629,0,0,0,303,0.75,0.023620455,0
2020-07-14-170629,170629,0,0,1,303,1.0,0.03396039,1
2020-07-15-170629,170629,0,0,2,303,0.5,0.004777354,2
2020-07-16-170629,170629,0,0,0,303,0.75,0.01646127,3
2020-07-17-170629,170629,0,0,4,303,0.75,0.011188127,4
2020-07-18-170629,170629,0,0,0,303,0.0,0.005776355,5
2020-07-19-170629,170629,0,0,0,303,0.0,0.0007107395,6
2020-07-20-170629,170629,1,0,0,304,0.5,0.017493546,0
2020-07-21-170629,170629,0,0,1,304,1.0,0.010276756,1
2020-07-22-170629,170629,0,0,3,304,1.0,0.044312857,2
2020-07-23-170629,170629,1,0,3,305,0.75,0.0046240673,3
2020-07-24-170629,170629,0,0,4,305,0.5,0.006132023,4
2020-07-25-170629,170629,0,0,0,305,0.0,0.0041828617,5
2020-07-26-170629,170629,0,0,0,305,0.75,0.00459424,6
2020-07-27-170629,170629,0,0,0,305,0.25,0.01959803,0
2020-07-28-170629,170629,1,0,5,306,0.75,0.028716797,1
2020-07-29-170629,170629,2,0,2,308,0.25,0.019457325,2
2020-07-30-170629,170629,0,0,6,308,1.25,0.05613331,3
2020-07-31-170629,170629,4,0,5,312,2.25,0.064342186,4
2020-08-01-170629,170629,0,0,1,312,0.5,0.0614525,5
2020-08-02-170629,170629,0,0,0,312,0.5,0.061596535,6
2020-08-03-170629,170629,0,0,6,312,3.75,0.093334794,0
2020-08-04-170629,170629,1,0,2,313,1.5,0.09616138,1
2020-08-05-170629,170629,3,0,0,316,3.0,0.15227632,2
2020-08-06-170629,170629,3,0,0,319,3.0,0.09845442,3
2020-08-07-170629,170629,4,0,1,323,5.0,0.15578826,4
2020-08-08-170629,170629,0,0,0,323,0.75,0.079350546,5
2020-08-09-170629,170629,0,0,0,323,0.5,0.017453104,6
2020-08-10-170629,170629,0,0,2,323,2.75,0.0979432,0
2020-08-11-170629,170629,5,0,2,328,2.75,0.11702778,1
2020-08-12-170629,170629,2,0,2,330,3.0,0.20269562,2
2020-08-13-170629,170629,6,0,2,336,3.0,0.17869492,3
2020-08-14-170629,170629,5,0,6,341,5.0,0.13137428,4
2020-08-15-170629,170629,1,0,1,342,1.5,0.03773126,5
2020-08-16-170629,170629,0,0,0,342,2.0,0.066036955,6
2020-08-17-170629,170629,6,0,9,348,7.75,0.12250265,0
2020-08-18-170629,170629,2,0,6,350,3.75,0.20091458,1
2020-08-19-170629,170629,0,0,7,350,7.75,0.1356639,2
2020-08-20-170629,170629,0,0,4,350,8.5,0.25053322,3
2020-08-21-170629,170629,1,0,3,351,5.25,0.17850101,4
2020-08-22-170629,170629,0,0,0,351,1.25,0.044773582,5
2020-08-23-170629,170629,0,0,0,351,1.25,0.08299996,6
2020-08-24-170629,170629,2,0,0,353,6.5,0.28237575,0
2020-08-25-170629,170629,2,0,2,355,5.5,0.19915605,1
2020-08-26-170629,170629,2,0,3,357,8.0,0.24770215,2
2020-08-27-170629,170629,2,0,4,359,7.0,0.19885434,3
2020-08-28-170629,170629,6,0,7,365,7.5,0.2176798,4
2020-08-29-170629,170629,1,0,1,366,2.75,0.11901532,5
2020-08-30-170629,170629,0,0,0,366,2.5,0.047303468,6
2020-08-31-170629,170629,9,0,9,375,7.25,0.337354,0
2020-09-01-170629,170629,6,0,11,381,4.75,0.34170923,1
2020-09-02-170629,170629,7,0,6,388,3.25,0.27107435,2
2020-09-03-170629,170629,4,0,3,392,6.5,0.36473694,3
2020-09-04-170629,170629,3,0,8,395,8.5,0.36210757,4
2020-09-05-170629,170629,0,0,0,395,3.0,0.21882164,5
2020-09-06-170629,170629,0,0,1,395,3.75,0.1435983,6
2020-09-07-170629,170629,0,0,4,395,9.75,0.42467058,0
2020-09-08-170629,170629,2,0,9,397,1.75,0.16726428,1
2020-09-09-170629,170629,3,0,3,400,6.0,0.22578005,2
2020-09-10-170629,170629,4,0,10,404,3.5,0.2318423,3
2020-09-11-170629,170629,7,0,4,411,9.25,0.45873523,4
2020-09-12-170629,170629,1,0,0,412,2.25,0.13289951,5
2020-09-13-170629,170629,0,0,3,412,2.75,0.07342982,6
2020-09-14-170629,170629,9,0,2,421,7.75,0.46767345,0
2020-09-15-170629,170629,11,0,5,432,3.25,0.2519206,1
2020-09-16-170629,170629,6,0,5,438,3.5,0.26764426,2
2020-09-17-170629,170629,3,0,6,441,3.75,0.2180723,3
2020-09-18-170629,170629,8,0,4,449,5.5,0.4799999,4
2020-09-19-170629,170629,0,0,0,449,2.5,0.15309554,5
2020-09-20-170629,170629,1,1,3,450,2.75,0.15649375,6
2020-09-21-170629,170629,4,0,9,454,7.25,0.44762304,0
2020-09-22-170629,170629,9,1,5,463,4.0,0.3348892,1
2020-09-23-170629,170629,3,0,2,466,4.25,0.37401128,2
2020-09-24-170629,170629,10,0,3,476,6.25,0.33281773,3
2020-09-25-170629,170629,4,0,9,480,4.0,0.3451878,4
2020-09-26-170629,170629,0,0,1,480,0.75,0.20812266,5
2020-09-27-170629,170629,3,0,3,483,0.5,0.109071285,6
2020-09-28-170629,170629,2,0,0,485,3.25,0.29696748,0
2020-09-29-170629,170629,5,0,9,490,4.0,0.27472803,1
2020-09-30-170629,170629,5,0,8,495,3.75,0.25719923,2
2020-10-01-170629,170629,6,0,17,501,3.0,0.19863002,3
2020-10-02-170629,170629,4,0,12,505,3.0,0.27047616,4
2020-10-03-170629,170629,0,0,1,505,2.0,0.12257828,5
2020-10-04-170629,170629,3,0,2,508,2.0,0.09804652,6
2020-10-05-170629,170629,9,1,13,517,5.75,0.7920255,0
2020-10-06-170629,170629,5,1,6,522,9.75,0.35623333,1
2020-10-07-170629,170629,2,0,8,524,7.75,0.49243078,2
2020-10-08-170629,170629,3,0,14,527,7.0,0.3844936,3
2020-10-09-170629,170629,9,0,14,536,8.5,0.31450775,4
2020-10-10-170629,170629,1,0,1,537,1.75,0.120840885,5
2020-10-11-170629,170629,3,0,1,540,2.0,0.19782008,6
2020-10-12-170629,170629,0,0,11,540,4.0,0.15252183,0
2020-10-13-170629,170629,9,0,10,549,9.75,0.40256733,1
2020-10-14-170629,170629,8,0,12,557,11.0,0.39642042,2
2020-10-15-170629,170629,17,0,10,574,6.25,0.6033626,3
2020-10-16-170629,170629,12,0,13,586,14.0,0.7001486,4
2020-10-17-170629,170629,1,0,0,587,2.0,0.12909772,5
2020-10-18-170629,170629,2,0,1,589,4.0,0.1254361,6
2020-10-19-170629,170629,13,0,0,602,18.0,0.4988671,0
2020-10-20-170629,170629,6,0,18,608,15.5,0.46430224,1
2020-10-21-170629,170629,8,0,10,616,17.25,0.6431992,2
2020-10-22-170629,170629,14,0,7,630,17.5,0.69222003,3
2020-10-23-170629,170629,14,0,8,644,17.5,0.6149907,4
2020-10-24-170629,170629,1,0,1,645,3.0,0.16618417,5
2020-10-25-170629,170629,1,0,1,646,3.5,0.1754548,6
2020-10-26-170629,170629,11,0,7,657,20.25,0.5096748,0
2020-10-27-170629,170629,10,0,9,667,15.0,0.5211507,1
2020-10-28-170629,170629,12,0,7,679,13.25,0.57008255,2
2020-10-29-170629,170629,10,0,4,689,11.25,0.51518524,3
2020-10-30-170629,170629,13,0,3,702,18.75,0.51691854,4
2020-10-31-170629,170629,0,0,0,702,6.0,0.09418888,5
2020-11-01-170629,170629,1,0,0,703,6.25,0.14733265,6
2020-11-02-170629,170629,0,0,0,703,2.75,0.13393049,0
2020-11-03-170629,170629,18,1,0,721,19.0,0.57280314,1
2020-11-04-170629,170629,10,1,0,731,11.75,0.46878842,2
2020-11-05-170629,170629,7,0,0,738,10.25,0.48205513,3
2020-11-06-170629,170629,8,0,0,746,10.5,0.38795877,4
2020-11-07-170629,170629,1,0,0,747,4.25,0.10924071,5
2020-11-08-170629,170629,1,0,0,748,4.5,0.111797646,6
2020-11-09-170629,170629,7,0,0,755,13.25,0.49839202,0
2020-11-10-170629,170629,9,0,0,764,8.5,0.25856712,1
2020-11-11-170629,170629,7,0,0,771,7.25,0.34238258,2
2020-11-12-170629,170629,4,1,0,775,10.5,0.30943415,3
2020-11-13-170629,170629,3,0,0,778,8.25,0.27421796,4
2020-03-01-170630,170630,0,0,1,0,0.0,0.0009623561,6
2020-03-02-170630,170630,0,0,1,0,0.16666666666666666,0.2021277,0
2020-03-03-170630,170630,0,0,1,0,0.0,0.009998745,1
2020-03-04-170630,170630,0,0,1,0,0.0,0.01023446,2
2020-03-05-170630,170630,1,0,0,1,0.0,0.13707289,3
2020-03-06-170630,170630,1,0,0,2,0.0,0.14396414,4
2020-03-07-170630,170630,0,0,0,2,0.0,0.0006142368,5
2020-03-08-170630,170630,0,0,0,2,0.0,0.0012099473,6
2020-03-09-170630,170630,0,0,0,2,0.0,0.00891638,0
2020-03-10-170630,170630,0,0,1,2,0.0,0.031629976,1
2020-03-11-170630,170630,1,0,2,3,0.0,0.14429691,2
2020-03-12-170630,170630,0,0,3,3,0.16666666666666666,0.21023162,3
2020-03-13-170630,170630,0,0,0,3,0.16666666666666666,0.2958735,4
2020-03-14-170630,170630,2,0,0,5,0.5,0.38073584,5
2020-03-15-170630,170630,1,0,0,6,0.8333333333333334,0.30992717,6
2020-03-16-170630,170630,1,0,1,7,4.0,0.68332535,0
2020-03-17-170630,170630,1,1,1,8,2.6666666666666665,0.8571498,1
2020-03-18-170630,170630,1,0,2,9,3.0,1.168982,2
2020-03-19-170630,170630,0,0,4,9,3.1666666666666665,1.1119441,3
2020-03-20-170630,170630,0,0,2,9,5.0,1.3808372,4
2020-03-21-170630,170630,0,0,1,9,1.1666666666666667,0.3097569,5
2020-03-22-170630,170630,0,0,0,9,1.6666666666666667,0.46504864,6
2020-03-23-170630,170630,0,0,2,9,6.5,2.2735894,0
2020-03-24-170630,170630,1,0,2,10,5.666666666666668,1.489201,1
2020-03-25-170630,170630,2,0,0,12,5.833333333333332,1.8798592,2
2020-03-26-170630,170630,3,0,0,15,5.0,2.2366548,3
2020-03-27-170630,170630,0,0,0,15,4.0,1.7431331,4
2020-03-28-170630,170630,0,0,0,15,2.0,0.27479723,5
2020-03-29-170630,170630,0,0,0,15,1.8333333333333333,0.44791228,6
2020-03-30-170630,170630,1,0,7,16,3.0,1.2343819,0
2020-03-31-170630,170630,1,0,3,17,2.833333333333333,1.0503321,1
2020-04-01-170630,170630,2,0,1,19,1.8333333333333333,0.9460183,2
2020-04-02-170630,170630,4,0,0,23,5.5,1.1731539,3
2020-04-03-170630,170630,2,0,0,25,3.333333333333333,0.8318512,4
2020-04-04-170630,170630,1,0,0,26,1.3333333333333333,0.3588097,5
2020-04-05-170630,170630,0,0,0,26,2.0,0.22269553,6
2020-04-06-170630,170630,2,0,0,28,2.6666666666666665,0.8874862,0
2020-04-07-170630,170630,2,0,0,30,3.333333333333333,0.7979782,1
2020-04-08-170630,170630,0,0,0,30,2.0,0.60476506,2
2020-04-09-170630,170630,0,2,0,30,0.5,0.34401113,3
2020-04-10-170630,170630,0,0,0,30,1.3333333333333333,0.44573286,4
2020-04-11-170630,170630,0,0,0,30,1.6666666666666667,0.13613632,5
2020-04-12-170630,170630,0,0,0,30,1.0,0.12112422,6
2020-04-13-170630,170630,7,0,0,37,3.5,1.0884706,0
2020-04-14-170630,170630,3,0,0,40,0.6666666666666666,0.8313285,1
2020-04-15-170630,170630,1,1,0,41,2.333333333333333,0.8162464,2
2020-04-16-170630,170630,0,0,1,41,0.6666666666666666,0.3668527,3
2020-04-17-170630,170630,0,0,0,41,0.8333333333333334,0.50212663,4
2020-04-18-170630,170630,0,0,2,41,1.5,0.34155095,5
2020-04-19-170630,170630,0,0,0,41,0.8333333333333334,0.09874839,6
2020-04-20-170630,170630,0,1,0,41,4.333333333333333,0.72719413,0
2020-04-21-170630,170630,0,0,1,41,1.1666666666666667,0.67804354,1
2020-04-22-170630,170630,0,0,1,41,1.0,0.44226372,2
2020-04-23-170630,170630,0,0,0,41,1.0,0.25395736,3
2020-04-24-170630,170630,0,0,0,41,1.0,0.29146653,4
2020-04-25-170630,170630,0,0,0,41,0.5,0.16007604,5
2020-04-26-170630,170630,0,0,0,41,0.3333333333333333,0.10702805,6
2020-04-27-170630,170630,0,0,0,41,1.1666666666666667,0.49657315,0
2020-04-28-170630,170630,0,0,0,41,1.5,0.6808854,1
2020-04-29-170630,170630,0,1,0,41,0.5,0.31821817,2
2020-04-30-170630,170630,1,0,0,42,0.6666666666666666,0.49674207,3
2020-05-01-170630,170630,0,0,0,42,0.5,0.16026236,4
2020-05-02-170630,170630,2,0,0,44,0.3333333333333333,0.31660876,5
2020-05-03-170630,170630,0,0,0,44,0.5,0.19331825,6
2020-05-04-170630,170630,0,0,0,44,2.5,1.1254051,0
2020-05-05-170630,170630,1,0,0,45,1.8333333333333333,0.7101756,1
2020-05-06-170630,170630,1,0,0,46,1.5,2.7523282,2
2020-05-07-170630,170630,0,0,0,46,1.6666666666666667,1.5388207,3
2020-05-08-170630,170630,0,0,0,46,0.5,0.6304434,4
2020-05-09-170630,170630,0,0,0,46,1.5,0.09658371,5
2020-05-10-170630,170630,0,1,1,46,0.3333333333333333,0.02095286,6
2020-05-11-170630,170630,0,1,0,46,1.1666666666666667,0.56155896,0
2020-05-12-170630,170630,0,1,0,46,0.8333333333333334,0.33871475,1
2020-05-13-170630,170630,0,0,0,46,1.0,0.5749828,2
2020-05-14-170630,170630,0,0,0,46,0.0,0.3156763,3
2020-05-15-170630,170630,0,0,0,46,0.3333333333333333,0.111821644,4
2020-05-16-170630,170630,0,0,0,46,0.16666666666666666,0.008520352,5
2020-05-17-170630,170630,0,0,0,46,0.16666666666666666,0.014874776,6
2020-05-18-170630,170630,0,0,0,46,2.833333333333333,0.36580437,0
2020-05-19-170630,170630,0,0,0,46,0.3333333333333333,0.2713887,1
2020-05-20-170630,170630,0,0,0,46,0.3333333333333333,0.15916853,2
2020-05-21-170630,170630,0,0,1,46,0.6666666666666666,0.25690866,3
2020-05-22-170630,170630,0,0,0,46,0.8333333333333334,0.34835732,4
2020-05-23-170630,170630,0,0,0,46,0.16666666666666666,0.05650017,5
2020-05-24-170630,170630,1,0,0,47,0.16666666666666666,0.15143108,6
2020-05-25-170630,170630,0,0,0,47,0.8333333333333334,0.25303158,0
2020-05-26-170630,170630,0,0,0,47,0.16666666666666666,0.23286995,1
2020-05-27-170630,170630,0,0,0,47,0.3333333333333333,0.44600475,2
2020-05-28-170630,170630,0,0,1,47,0.8333333333333334,0.44988018,3
2020-05-29-170630,170630,0,0,0,47,1.0,0.6325465,4
2020-05-30-170630,170630,0,0,0,47,0.16666666666666666,0.020458955,5
2020-05-31-170630,170630,0,0,0,47,0.0,0.00055818714,6
2020-06-01-170630,170630,0,0,1,47,0.3333333333333333,0.33823672,0
2020-06-02-170630,170630,0,0,0,47,0.5,0.19856328,1
2020-06-03-170630,170630,0,0,0,47,0.3333333333333333,0.34193206,2
2020-06-04-170630,170630,1,0,0,48,1.3333333333333333,0.49426144,3
2020-06-05-170630,170630,0,0,1,48,0.5,0.4818255,4
2020-06-06-170630,170630,0,0,0,48,0.0,0.028832503,5
2020-06-07-170630,170630,0,0,0,48,0.16666666666666666,0.052163754,6
2020-06-08-170630,170630,0,0,0,48,0.16666666666666666,0.06482912,0
2020-06-09-170630,170630,0,1,1,48,0.16666666666666666,0.28105882,1
2020-06-10-170630,170630,0,0,0,48,0.0,0.20496011,2
2020-06-11-170630,170630,1,0,0,49,1.0,0.31201458,3
2020-06-12-170630,170630,0,0,0,49,0.0,0.06293295,4
2020-06-13-170630,170630,0,0,0,49,0.16666666666666666,0.05483357,5
2020-06-14-170630,170630,0,0,0,49,0.0,0.040963747,6
2020-06-15-170630,170630,1,0,0,50,0.16666666666666666,0.13633873,0
2020-06-16-170630,170630,0,0,0,50,0.0,0.11149607,1
2020-06-17-170630,170630,0,0,0,50,0.16666666666666666,0.17841066,2
2020-06-18-170630,170630,0,0,0,50,0.3333333333333333,0.29928878,3
2020-06-19-170630,170630,1,0,0,51,0.5,0.29004297,4
2020-06-20-170630,170630,0,0,0,51,0.0,8.8619934e-05,5
2020-06-21-170630,170630,0,0,0,51,0.0,0.0011554143,6
2020-06-22-170630,170630,0,0,0,51,0.6666666666666666,0.641472,0
2020-06-23-170630,170630,1,0,0,52,0.3333333333333333,0.27619162,1
2020-06-24-170630,170630,0,0,0,52,0.0,0.05260057,2
2020-06-25-170630,170630,0,2,0,52,0.16666666666666666,0.05565298,3
2020-06-26-170630,170630,0,0,0,52,0.16666666666666666,0.024212113,4
2020-06-27-170630,170630,0,0,0,52,0.0,0.051781837,5
2020-06-28-170630,170630,0,0,0,52,0.3333333333333333,0.026818883,6
2020-06-29-170630,170630,0,0,0,52,0.3333333333333333,0.1416817,0
2020-06-30-170630,170630,0,0,0,52,0.16666666666666666,0.18339926,1
2020-07-01-170630,170630,0,0,0,52,0.16666666666666666,0.013574778,2
2020-07-02-170630,170630,0,0,0,52,0.16666666666666666,0.054775115,3
2020-07-03-170630,170630,0,0,0,52,0.16666666666666666,0.08175392,4
2020-07-04-170630,170630,0,0,0,52,0.16666666666666666,0.00083667843,5
2020-07-05-170630,170630,0,0,0,52,0.16666666666666666,0.022630297,6
2020-07-06-170630,170630,0,0,0,52,0.5,0.1048919,0
2020-07-07-170630,170630,0,0,0,52,0.16666666666666666,0.021064283,1
2020-07-08-170630,170630,0,0,0,52,0.0,0.0032343469,2
2020-07-09-170630,170630,0,0,0,52,0.0,0.01576823,3
2020-07-10-170630,170630,0,0,0,52,0.0,0.015051761,4
2020-07-11-170630,170630,0,0,0,52,0.0,0.05453661,5
2020-07-12-170630,170630,0,1,0,52,0.3333333333333333,0.23673308,6
2020-07-13-170630,170630,0,0,0,52,0.3333333333333333,0.14623398,0
2020-07-14-170630,170630,0,0,0,52,0.5,0.32415932,1
2020-07-15-170630,170630,0,0,0,52,0.16666666666666666,0.0012901148,2
2020-07-16-170630,170630,0,0,0,52,0.5,0.12039308,3
2020-07-17-170630,170630,0,0,0,52,0.0,0.05118909,4
2020-07-18-170630,170630,0,0,3,52,0.0,0.016436642,5
2020-07-19-170630,170630,0,1,0,52,0.0,0.00081414415,6
2020-07-20-170630,170630,0,0,0,52,0.16666666666666666,0.03361303,0
2020-07-21-170630,170630,0,0,1,52,0.3333333333333333,0.19211075,1
2020-07-22-170630,170630,0,0,0,52,0.16666666666666666,0.23463275,2
2020-07-23-170630,170630,0,0,0,52,1.0,0.22366583,3
2020-07-24-170630,170630,0,0,1,52,0.3333333333333333,0.06890603,4
2020-07-25-170630,170630,0,0,0,52,0.16666666666666666,0.019888116,5
2020-07-26-170630,170630,0,0,0,52,0.16666666666666666,0.06009715,6
2020-07-27-170630,170630,0,0,1,52,0.0,0.004821146,0
2020-07-28-170630,170630,0,0,0,52,0.3333333333333333,0.16136019,1
2020-07-29-170630,170630,0,0,0,52,0.3333333333333333,0.3489276,2
2020-07-30-170630,170630,0,0,0,52,0.5,0.2211227,3
2020-07-31-170630,170630,0,0,0,52,0.3333333333333333,0.25793555,4
2020-08-01-170630,170630,3,0,0,55,0.3333333333333333,0.6677651,5
2020-08-02-170630,170630,0,0,0,55,0.16666666666666666,0.12911332,6
2020-08-03-170630,170630,0,0,1,55,0.5,0.14460723,0
2020-08-04-170630,170630,1,0,0,56,0.16666666666666666,0.33558258,1
2020-08-05-170630,170630,0,0,0,56,0.3333333333333333,0.19300574,2
2020-08-06-170630,170630,0,0,0,56,0.16666666666666666,0.5361168,3
2020-08-07-170630,170630,1,1,0,57,1.0,0.73408127,4
2020-08-08-170630,170630,0,0,0,57,0.3333333333333333,0.24554527,5
2020-08-09-170630,170630,0,0,0,57,0.0,0.061958555,6
2020-08-10-170630,170630,1,0,0,58,1.0,0.48944816,0
2020-08-11-170630,170630,0,0,0,58,2.6666666666666665,0.8527906,1
2020-08-12-170630,170630,0,0,0,58,0.5,0.587059,2
2020-08-13-170630,170630,0,0,1,58,1.1666666666666667,1.0120317,3
2020-08-14-170630,170630,0,1,0,58,1.8333333333333333,0.5210876,4
2020-08-15-170630,170630,0,0,0,58,1.0,0.47417775,5
2020-08-16-170630,170630,0,0,0,58,0.3333333333333333,0.4039538,6
2020-08-17-170630,170630,1,0,0,59,0.8333333333333334,0.8238666,0
2020-08-18-170630,170630,0,0,3,59,1.6666666666666667,0.73898256,1
2020-08-19-170630,170630,0,0,0,59,1.5,1.2147839,2
2020-08-20-170630,170630,0,0,0,59,2.0,1.268579,3
2020-08-21-170630,170630,0,0,0,59,1.8333333333333333,1.4033978,4
2020-08-22-170630,170630,0,0,0,59,0.5,0.16118215,5
2020-08-23-170630,170630,0,0,0,59,0.16666666666666666,0.07951489,6
2020-08-24-170630,170630,0,0,0,59,1.8333333333333333,0.78833383,0
2020-08-25-170630,170630,0,0,1,59,1.0,1.1348794,1
2020-08-26-170630,170630,0,0,1,59,1.1666666666666667,0.49198875,2
2020-08-27-170630,170630,1,0,1,60,2.0,0.96362996,3
2020-08-28-170630,170630,0,0,0,60,0.6666666666666666,0.49585453,4
2020-08-29-170630,170630,0,0,0,60,0.6666666666666666,0.8985851,5
2020-08-30-170630,170630,0,0,0,60,1.0,0.22934894,6
2020-08-31-170630,170630,0,0,0,60,0.5,0.6070265,0
2020-09-01-170630,170630,3,0,0,63,1.1666666666666667,1.3182403,1
2020-09-02-170630,170630,0,0,0,63,0.8333333333333334,0.84899306,2
2020-09-03-170630,170630,0,0,0,63,1.3333333333333333,1.1106132,3
2020-09-04-170630,170630,0,0,0,63,2.0,0.8914077,4
2020-09-05-170630,170630,0,0,0,63,0.0,0.2888031,5
2020-09-06-170630,170630,0,0,0,63,0.16666666666666666,0.5118545,6
2020-09-07-170630,170630,0,0,0,63,0.8333333333333334,0.90515214,0
2020-09-08-170630,170630,1,0,0,64,1.0,0.6445113,1
2020-09-09-170630,170630,1,0,1,65,0.6666666666666666,0.5698524,2
2020-09-10-170630,170630,1,0,0,66,2.833333333333333,1.4158797,3
2020-09-11-170630,170630,0,0,1,66,1.0,0.91050583,4
2020-09-12-170630,170630,0,0,0,66,0.16666666666666666,0.58850014,5
2020-09-13-170630,170630,0,0,0,66,0.8333333333333334,0.2911584,6
2020-09-14-170630,170630,0,0,0,66,2.6666666666666665,1.0757518,0
2020-09-15-170630,170630,0,0,0,66,0.6666666666666666,0.55228245,1
2020-09-16-170630,170630,0,0,0,66,0.8333333333333334,0.54243624,2
2020-09-17-170630,170630,0,0,1,66,1.8333333333333333,1.1676458,3
2020-09-18-170630,170630,0,0,1,66,5.833333333333332,1.952372,4
2020-09-19-170630,170630,0,0,0,66,0.8333333333333334,0.77642095,5
2020-09-20-170630,170630,0,0,2,66,0.8333333333333334,0.39896303,6
2020-09-21-170630,170630,0,0,1,66,4.833333333333333,1.5792301,0
2020-09-22-170630,170630,0,0,2,66,3.0,2.262961,1
2020-09-23-170630,170630,1,0,5,67,0.5,1.4097886,2
2020-09-24-170630,170630,0,0,0,67,3.1666666666666665,2.4655046,3
2020-09-25-170630,170630,1,0,1,68,5.833333333333332,1.8426493,4
2020-09-26-170630,170630,0,0,0,68,5.166666666666667,1.1477165,5
2020-09-27-170630,170630,0,0,0,68,0.5,0.34844086,6
2020-09-28-170630,170630,0,0,0,68,0.6666666666666666,1.180451,0
2020-09-29-170630,170630,0,0,0,68,1.6666666666666667,1.3060931,1
2020-09-30-170630,170630,0,0,0,68,1.1666666666666667,1.2101865,2
2020-10-01-170630,170630,1,0,0,69,2.0,1.4481463,3
2020-10-02-170630,170630,1,0,2,70,0.8333333333333334,1.0060693,4
2020-10-03-170630,170630,0,0,1,70,0.6666666666666666,0.31094688,5
2020-10-04-170630,170630,2,0,1,72,0.5,0.978199,6
2020-10-05-170630,170630,1,0,1,73,1.0,1.3223463,0
2020-10-06-170630,170630,2,0,0,75,1.3333333333333333,1.4835575,1
2020-10-07-170630,170630,5,0,0,80,1.3333333333333333,1.510172,2
2020-10-08-170630,170630,0,1,1,80,0.5,0.83877367,3
2020-10-09-170630,170630,1,1,3,81,2.0,1.3358852,4
2020-10-10-170630,170630,0,0,0,81,0.5,0.76881135,5
2020-10-11-170630,170630,0,0,1,81,0.6666666666666666,0.9722832,6
2020-10-12-170630,170630,0,0,0,81,0.6666666666666666,0.5796833,0
2020-10-13-170630,170630,0,0,2,81,1.1666666666666667,1.2315041,1
2020-10-14-170630,170630,0,0,0,81,2.1666666666666665,1.1772006,2
2020-10-15-170630,170630,0,0,0,81,0.3333333333333333,1.1007321,3
2020-10-16-170630,170630,2,0,1,83,3.333333333333333,1.9454672,4
2020-10-17-170630,170630,1,0,0,84,0.8333333333333334,0.71583295,5
2020-10-18-170630,170630,1,0,0,85,0.5,0.519839,6
2020-10-19-170630,170630,1,0,1,86,3.333333333333333,2.1658463,0
2020-10-20-170630,170630,0,0,1,86,2.1666666666666665,2.039912,1
2020-10-21-170630,170630,0,0,2,86,1.5,1.4482311,2
2020-10-22-170630,170630,1,0,2,87,1.6666666666666667,1.9821646,3
2020-10-23-170630,170630,3,0,2,90,2.6666666666666665,1.7684482,4
2020-10-24-170630,170630,0,0,0,90,0.5,0.72246593,5
2020-10-25-170630,170630,1,0,0,91,0.5,0.79921716,6
2020-10-26-170630,170630,0,0,1,91,3.8333333333333335,1.2576654,0
2020-10-27-170630,170630,2,0,4,93,2.5,1.6798218,1
2020-10-28-170630,170630,0,0,4,93,2.5,1.7331269,2
2020-10-29-170630,170630,0,0,0,93,3.0,2.3418005,3
2020-10-30-170630,170630,1,0,0,94,3.0,1.9633584,4
2020-10-31-170630,170630,0,1,0,94,2.0,0.6326665,5
2020-11-01-170630,170630,0,1,0,94,1.5,0.8657439,6
2020-11-02-170630,170630,1,0,0,95,1.5,1.2508034,0
2020-11-03-170630,170630,1,0,0,96,1.6666666666666667,1.374694,1
2020-11-04-170630,170630,2,0,0,98,3.8333333333333335,1.9965018,2
2020-11-05-170630,170630,2,0,0,100,1.3333333333333333,0.9194303,3
2020-11-06-170630,170630,2,0,0,102,3.5,1.5145757,4
2020-11-07-170630,170630,0,0,0,102,0.8333333333333334,0.60296136,5
2020-11-08-170630,170630,0,1,0,102,1.6666666666666667,0.34982753,6
2020-11-09-170630,170630,1,0,0,103,2.6666666666666665,1.0251303,0
2020-11-10-170630,170630,4,0,0,107,0.8333333333333334,1.3315663,1
2020-11-11-170630,170630,4,0,0,111,1.5,1.7600316,2
2020-11-12-170630,170630,0,0,0,111,1.5,1.2268454,3
2020-11-13-170630,170630,0,0,0,111,2.5,1.0274233,4
2020-03-01-170631,170631,0,0,6,0,0.0,0.01485123,6
2020-03-02-170631,170631,0,1,13,0,0.2,0.043895002,0
2020-03-03-170631,170631,0,0,18,0,0.8,0.15342617,1
2020-03-04-170631,170631,0,0,8,0,0.0,0.15897237,2
2020-03-05-170631,170631,0,0,13,0,0.2,0.01846615,3
2020-03-06-170631,170631,0,0,23,0,0.2,0.015959997,4
2020-03-07-170631,170631,0,0,5,0,0.0,0.004510227,5
2020-03-08-170631,170631,0,0,3,0,0.2,0.041315254,6
2020-03-09-170631,170631,0,0,27,0,0.4,0.16872685,0
2020-03-10-170631,170631,0,0,18,0,0.8,0.50396323,1
2020-03-11-170631,170631,1,0,13,1,1.0,0.21703266,2
2020-03-12-170631,170631,0,0,22,1,1.0,0.09354189,3
2020-03-13-170631,170631,1,0,24,2,3.0,0.8652758,4
2020-03-14-170631,170631,4,0,9,6,4.6,0.8313474,5
2020-03-15-170631,170631,6,0,9,12,9.6,1.6743689,6
2020-03-16-170631,170631,13,0,25,25,13.0,3.5789938,0
2020-03-17-170631,170631,18,1,9,43,17.4,3.9179049,1
2020-03-18-170631,170631,8,0,10,51,16.0,3.291854,2
2020-03-19-170631,170631,13,0,11,64,20.6,4.0809255,3
2020-03-20-170631,170631,23,0,14,87,21.0,4.244394,4
2020-03-21-170631,170631,5,0,2,92,8.4,1.4789394,5
2020-03-22-170631,170631,3,0,5,95,9.8,1.2600182,6
2020-03-23-170631,170631,27,0,8,122,37.2,8.283423,0
2020-03-24-170631,170631,18,0,3,140,26.2,5.8897357,1
2020-03-25-170631,170631,13,0,2,153,29.0,6.7189465,2
2020-03-26-170631,170631,22,0,5,175,27.0,5.606148,3
2020-03-27-170631,170631,24,0,4,199,24.2,5.847669,4
2020-03-28-170631,170631,9,0,0,208,6.6,1.0489208,5
2020-03-29-170631,170631,9,0,1,217,7.4,1.2043211,6
2020-03-30-170631,170631,25,0,6,242,23.2,5.715673,0
2020-03-31-170631,170631,9,0,0,251,16.8,3.0899632,1
2020-04-01-170631,170631,10,0,5,261,17.4,3.9554882,2
2020-04-02-170631,170631,11,0,19,272,8.2,1.8592187,3
2020-04-03-170631,170631,14,0,13,286,12.4,2.4818718,4
2020-04-04-170631,170631,2,0,2,288,3.4,0.57291055,5
2020-04-05-170631,170631,5,0,0,293,2.2,0.63209105,6
2020-04-06-170631,170631,8,1,4,301,15.8,3.32922,0
2020-04-07-170631,170631,3,0,6,304,13.2,2.3641212,1
2020-04-08-170631,170631,2,0,5,306,8.8,2.2141688,2
2020-04-09-170631,170631,5,0,3,311,5.8,0.90949523,3
2020-04-10-170631,170631,4,0,1,315,7.6,0.80021524,4
2020-04-11-170631,170631,0,0,1,315,3.4,0.47408438,5
2020-04-12-170631,170631,1,0,0,316,6.0,0.6048768,6
2020-04-13-170631,170631,6,0,4,322,9.8,2.5897682,0
2020-04-14-170631,170631,0,0,3,322,13.8,3.1466444,1
2020-04-15-170631,170631,5,0,6,327,5.4,2.111001,2
2020-04-16-170631,170631,19,0,4,346,8.0,1.2786595,3
2020-04-17-170631,170631,13,0,0,359,6.6,1.7372217,4
2020-04-18-170631,170631,2,0,1,361,5.4,1.5948622,5
2020-04-19-170631,170631,0,0,0,361,1.2,0.32242048,6
2020-04-20-170631,170631,4,0,3,365,8.8,1.5668715,0
2020-04-21-170631,170631,6,0,1,371,10.8,2.7981434,1
2020-04-22-170631,170631,5,0,1,376,11.2,2.9001884,2
2020-04-23-170631,170631,3,0,2,379,2.2,0.57119995,3
2020-04-24-170631,170631,1,1,5,380,5.2,1.2957186,4
2020-04-25-170631,170631,1,0,1,381,2.2,0.868063,5
2020-04-26-170631,170631,0,0,0,381,3.0,1.0792115,6
2020-04-27-170631,170631,4,0,4,385,8.8,2.5539906,0
2020-04-28-170631,170631,3,0,5,388,4.2,1.0727795,1
2020-04-29-170631,170631,6,0,3,394,5.8,1.747528,2
2020-04-30-170631,170631,4,0,4,398,5.4,0.9905455,3
2020-05-01-170631,170631,0,0,1,398,4.2,1.2699802,4
2020-05-02-170631,170631,1,0,0,399,1.8,0.58360815,5
2020-05-03-170631,170631,0,0,1,399,1.0,0.18463016,6
2020-05-04-170631,170631,3,0,1,402,9.0,3.56151,0
2020-05-05-170631,170631,1,0,7,403,5.0,1.4802312,1
2020-05-06-170631,170631,1,0,2,404,5.0,3.05396,2
2020-05-07-170631,170631,2,0,4,406,4.2,2.5161886,3
2020-05-08-170631,170631,5,0,1,411,8.4,1.5204214,4
2020-05-09-170631,170631,1,0,0,412,1.8,0.2656265,5
2020-05-10-170631,170631,0,2,1,412,0.8,0.05150004,6
2020-05-11-170631,170631,4,0,0,416,9.0,2.4612012,0
2020-05-12-170631,170631,5,0,2,421,10.6,2.258338,1
2020-05-13-170631,170631,3,0,0,424,6.6,1.4434876,2
2020-05-14-170631,170631,4,1,2,428,2.2,0.86230946,3
2020-05-15-170631,170631,1,0,6,429,6.4,1.2691934,4
2020-05-16-170631,170631,0,0,0,429,1.0,0.032821506,5
2020-05-17-170631,170631,1,0,0,430,0.0,0.027902914,6
2020-05-18-170631,170631,1,0,1,431,3.4,1.3640841,0
2020-05-19-170631,170631,7,0,0,438,2.8,0.97098273,1
2020-05-20-170631,170631,2,0,2,440,3.0,0.8549826,2
2020-05-21-170631,170631,4,0,1,444,2.8,0.41127765,3
2020-05-22-170631,170631,1,0,1,445,4.0,0.5813392,4
2020-05-23-170631,170631,0,0,0,445,0.2,0.13156952,5
2020-05-24-170631,170631,1,0,0,446,0.0,0.06348067,6
2020-05-25-170631,170631,0,0,1,446,3.2,0.71813065,0
2020-05-26-170631,170631,2,0,3,448,2.0,0.5588022,1
2020-05-27-170631,170631,0,0,2,448,2.4,0.72775996,2
2020-05-28-170631,170631,2,2,7,450,2.0,0.856822,3
2020-05-29-170631,170631,6,0,0,456,3.6,0.9104837,4
2020-05-30-170631,170631,0,0,0,456,0.2,0.04388738,5
2020-05-31-170631,170631,0,0,0,456,0.0,0.022387141,6
2020-06-01-170631,170631,1,0,2,457,3.8,1.3507329,0
2020-06-02-170631,170631,0,0,3,457,0.6,0.4996978,1
2020-06-03-170631,170631,2,0,3,459,1.2,0.27898434,2
2020-06-04-170631,170631,1,0,4,460,2.0,0.8490518,3
2020-06-05-170631,170631,1,0,1,461,3.6,1.9466503,4
2020-06-06-170631,170631,0,1,0,461,0.0,0.095353045,5
2020-06-07-170631,170631,0,0,0,461,0.2,0.137006,6
2020-06-08-170631,170631,1,0,2,462,1.4,0.41576573,0
2020-06-09-170631,170631,3,0,2,465,1.6,0.38087264,1
2020-06-10-170631,170631,2,0,0,467,1.8,0.33197153,2
2020-06-11-170631,170631,7,0,1,474,2.6,0.4118972,3
2020-06-12-170631,170631,0,0,1,474,0.2,0.20607695,4
2020-06-13-170631,170631,0,0,0,474,0.0,0.011709698,5
2020-06-14-170631,170631,0,0,0,474,0.0,0.014312598,6
2020-06-15-170631,170631,2,0,3,476,1.4,0.18775631,0
2020-06-16-170631,170631,3,0,2,479,2.0,0.63534135,1
2020-06-17-170631,170631,3,0,6,482,1.6,0.5267744,2
2020-06-18-170631,170631,4,0,1,486,1.8,0.54211044,3
2020-06-19-170631,170631,1,0,1,487,2.0,0.85055643,4
2020-06-20-170631,170631,0,2,0,487,0.0,0.0024886944,5
2020-06-21-170631,170631,0,0,0,487,0.0,0.028945824,6
2020-06-22-170631,170631,2,0,1,489,1.8,0.46418372,0
2020-06-23-170631,170631,2,0,0,491,2.2,0.7395763,1
2020-06-24-170631,170631,0,0,1,491,0.8,0.18438238,2
2020-06-25-170631,170631,1,1,1,492,0.8,0.29344687,3
2020-06-26-170631,170631,1,0,1,493,2.2,0.32896662,4
2020-06-27-170631,170631,0,0,0,493,0.2,0.055445876,5
2020-06-28-170631,170631,0,0,0,493,0.0,0.035040595,6
2020-06-29-170631,170631,3,0,1,496,1.6,0.35788956,0
2020-06-30-170631,170631,2,0,0,498,0.4,0.39540416,1
2020-07-01-170631,170631,6,0,0,504,0.8,0.20939252,2
2020-07-02-170631,170631,1,0,3,505,0.6,0.108733445,3
2020-07-03-170631,170631,1,0,1,506,0.8,0.25710142,4
2020-07-04-170631,170631,0,1,0,506,0.0,0.0104380725,5
2020-07-05-170631,170631,0,0,0,506,0.0,0.028807694,6
2020-07-06-170631,170631,1,0,1,507,0.4,0.15800816,0
2020-07-07-170631,170631,0,0,16,507,0.8,0.1678792,1
2020-07-08-170631,170631,1,0,0,508,0.0,0.017483976,2
2020-07-09-170631,170631,1,0,3,509,0.4,0.23209931,3
2020-07-10-170631,170631,1,0,0,510,0.4,0.1448997,4
2020-07-11-170631,170631,0,0,0,510,0.0,0.012510089,5
2020-07-12-170631,170631,0,0,0,510,0.2,0.1197236,6
2020-07-13-170631,170631,1,0,3,511,0.8,0.22602162,0
2020-07-14-170631,170631,0,0,0,511,0.8,0.30361184,1
2020-07-15-170631,170631,0,0,3,511,0.4,0.04071158,2
2020-07-16-170631,170631,3,0,2,514,0.8,0.14345093,3
2020-07-17-170631,170631,1,0,5,515,0.4,0.093415655,4
2020-07-18-170631,170631,0,0,0,515,0.0,0.049023896,5
2020-07-19-170631,170631,0,0,1,515,0.0,0.0043817195,6
2020-07-20-170631,170631,1,0,1,516,0.6,0.13901272,0
2020-07-21-170631,170631,16,0,5,532,0.6,0.08945394,1
2020-07-22-170631,170631,0,0,5,532,1.0,0.36594382,2
2020-07-23-170631,170631,3,0,3,535,1.0,0.02774874,3
2020-07-24-170631,170631,0,0,6,535,0.2,0.04482443,4
2020-07-25-170631,170631,0,0,3,535,0.0,0.032372244,5
2020-07-26-170631,170631,0,0,1,535,0.8,0.035890326,6
2020-07-27-170631,170631,3,0,5,538,0.2,0.13889919,0
2020-07-28-170631,170631,0,0,1,538,0.6,0.20147072,1
2020-07-29-170631,170631,3,0,7,541,0.4,0.15412644,2
2020-07-30-170631,170631,2,0,3,543,0.6,0.4292179,3
2020-07-31-170631,170631,5,0,4,548,3.0,0.52026606,4
2020-08-01-170631,170631,0,0,1,548,1.0,0.49211234,5
2020-08-02-170631,170631,1,0,2,549,1.0,0.4986545,6
2020-08-03-170631,170631,1,0,12,550,3.0,0.6898665,0
2020-08-04-170631,170631,5,0,3,555,2.6,0.7439922,1
2020-08-05-170631,170631,5,0,9,560,3.8,1.2200819,2
2020-08-06-170631,170631,3,0,13,563,2.8,0.86095536,3
2020-08-07-170631,170631,6,0,7,569,4.4,1.30953,4
2020-08-08-170631,170631,3,0,0,572,2.0,0.65848595,5
2020-08-09-170631,170631,1,0,0,573,0.2,0.14268807,6
2020-08-10-170631,170631,5,0,19,578,3.6,0.8765013,0
2020-08-11-170631,170631,1,1,8,579,1.8,0.9952027,1
2020-08-12-170631,170631,7,1,25,586,5.4,1.8494782,2
2020-08-13-170631,170631,3,0,6,589,3.6,1.3822094,3
2020-08-14-170631,170631,4,0,10,593,3.8,1.0847718,4
2020-08-15-170631,170631,1,0,2,594,1.8,0.27148557,5
2020-08-16-170631,170631,2,0,1,596,1.8,0.5275826,6
2020-08-17-170631,170631,12,0,16,608,5.8,1.0031087,0
2020-08-18-170631,170631,3,0,3,611,5.2,1.7102944,1
2020-08-19-170631,170631,9,0,5,620,4.2,1.1167276,2
2020-08-20-170631,170631,13,0,3,633,6.6,2.1294038,3
2020-08-21-170631,170631,7,0,17,640,4.4,1.509904,4
2020-08-22-170631,170631,0,0,9,640,0.8,0.35468483,5
2020-08-23-170631,170631,0,0,1,640,4.2,0.5964159,6
2020-08-24-170631,170631,19,0,5,659,7.8,2.3589847,0
2020-08-25-170631,170631,8,0,0,667,5.8,1.6682365,1
2020-08-26-170631,170631,25,0,3,692,8.2,2.1106827,2
2020-08-27-170631,170631,6,0,6,698,6.4,1.5373057,3
2020-08-28-170631,170631,10,0,10,708,7.2,1.7632481,4
2020-08-29-170631,170631,2,0,2,710,3.2,0.985609,5
2020-08-30-170631,170631,1,0,0,711,2.0,0.3478239,6
2020-08-31-170631,170631,16,0,19,727,8.8,2.6871052,0
2020-09-01-170631,170631,3,0,2,730,5.6,2.969038,1
2020-09-02-170631,170631,5,0,10,735,5.2,2.3216562,2
2020-09-03-170631,170631,3,0,8,738,8.4,3.1430156,3
2020-09-04-170631,170631,17,0,11,755,11.2,2.9662242,4
2020-09-05-170631,170631,9,0,0,764,4.6,1.883611,5
2020-09-06-170631,170631,1,0,0,765,1.6,1.2590274,6
2020-09-07-170631,170631,5,0,8,770,10.8,3.567424,0
2020-09-08-170631,170631,0,0,17,770,2.8,1.5022724,1
2020-09-09-170631,170631,3,0,11,773,6.0,1.8730425,2
2020-09-10-170631,170631,6,0,10,779,4.4,1.8990458,3
2020-09-11-170631,170631,10,0,9,789,10.2,3.7350338,4
2020-09-12-170631,170631,2,0,0,791,2.2,1.0746105,5
2020-09-13-170631,170631,0,0,0,791,0.8,0.5375281,6
2020-09-14-170631,170631,19,0,5,810,13.6,3.9642901,0
2020-09-15-170631,170631,2,0,8,812,6.6,2.0525138,1
2020-09-16-170631,170631,10,0,8,822,5.0,2.3614953,2
2020-09-17-170631,170631,8,0,5,830,7.6,1.8889292,3
2020-09-18-170631,170631,11,0,4,841,9.6,3.9572408,4
2020-09-19-170631,170631,0,1,0,841,2.4,1.1641442,5
2020-09-20-170631,170631,0,0,2,841,3.6,1.2848047,6
2020-09-21-170631,170631,8,0,8,849,12.6,4.010056,0
2020-09-22-170631,170631,17,0,8,866,9.8,2.6441743,1
2020-09-23-170631,170631,11,0,9,877,8.8,3.0547502,2
2020-09-24-170631,170631,10,0,11,887,9.6,2.8548253,3
2020-09-25-170631,170631,9,0,16,896,9.0,2.970718,4
2020-09-26-170631,170631,0,0,1,896,3.4,1.7639214,5
2020-09-27-170631,170631,0,0,1,896,2.0,0.9321552,6
2020-09-28-170631,170631,5,1,2,901,5.2,2.3956344,0
2020-09-29-170631,170631,8,0,17,909,6.4,2.4430296,1
2020-09-30-170631,170631,8,0,12,917,6.4,2.1098037,2
2020-10-01-170631,170631,5,0,11,922,6.0,1.6620357,3
2020-10-02-170631,170631,4,0,13,926,6.6,2.3062837,4
2020-10-03-170631,170631,0,0,0,926,2.8,0.9684154,5
2020-10-04-170631,170631,2,0,1,928,3.2,0.7516872,6
2020-10-05-170631,170631,8,0,12,936,18.0,5.963626,0
2020-10-06-170631,170631,8,0,9,944,9.2,2.993791,1
2020-10-07-170631,170631,9,0,10,953,11.4,3.9642327,2
2020-10-08-170631,170631,11,0,10,964,9.4,3.0898747,3
2020-10-09-170631,170631,16,0,14,980,10.6,2.5640006,4
2020-10-10-170631,170631,1,0,0,981,4.2,0.93531275,5
2020-10-11-170631,170631,1,0,3,982,5.8,1.5784055,6
2020-10-12-170631,170631,2,0,13,984,5.0,1.3294713,0
2020-10-13-170631,170631,17,0,15,1001,13.0,3.5474653,1
2020-10-14-170631,170631,12,0,15,1013,12.2,3.694094,2
2020-10-15-170631,170631,11,0,9,1024,11.6,5.165466,3
2020-10-16-170631,170631,13,0,12,1037,20.6,5.9341593,4
2020-10-17-170631,170631,0,0,3,1037,4.2,1.3260864,5
2020-10-18-170631,170631,1,0,4,1038,11.2,1.2072469,6
2020-10-19-170631,170631,12,1,3,1050,17.8,4.672767,0
2020-10-20-170631,170631,9,0,13,1059,21.0,4.647643,1
2020-10-21-170631,170631,10,0,14,1069,23.0,5.956547,2
2020-10-22-170631,170631,10,0,11,1079,23.4,6.4445534,3
2020-10-23-170631,170631,14,0,14,1093,26.4,5.370607,4
2020-10-24-170631,170631,0,1,1,1093,6.6,1.5428488,5
2020-10-25-170631,170631,3,0,2,1096,12.6,1.7041266,6
2020-10-26-170631,170631,13,0,12,1109,20.0,4.5533295,0
2020-10-27-170631,170631,15,0,10,1124,21.8,4.4454837,1
2020-10-28-170631,170631,15,0,5,1139,17.6,4.7673693,2
2020-10-29-170631,170631,9,0,5,1148,13.2,4.5696645,3
2020-10-30-170631,170631,12,0,4,1160,21.6,4.4183073,4
2020-10-31-170631,170631,3,0,0,1163,6.8,0.73140407,5
2020-11-01-170631,170631,4,3,0,1167,6.0,1.2101408,6
2020-11-02-170631,170631,3,0,0,1170,2.8,1.1850315,0
2020-11-03-170631,170631,13,0,0,1183,18.0,4.8886414,1
2020-11-04-170631,170631,14,0,0,1197,14.6,4.129498,2
2020-11-05-170631,170631,11,0,0,1208,13.0,4.15817,3
2020-11-06-170631,170631,14,1,0,1222,10.2,3.3061652,4
2020-11-07-170631,170631,1,0,0,1223,3.2,1.0002255,5
2020-11-08-170631,170631,2,0,0,1225,5.2,1.0191493,6
2020-11-09-170631,170631,12,0,0,1237,16.4,4.769283,0
2020-11-10-170631,170631,10,1,0,1247,8.0,2.2743573,1
2020-11-11-170631,170631,5,1,0,1252,12.6,2.814929,2
2020-11-12-170631,170631,5,0,0,1257,13.2,2.5800807,3
2020-11-13-170631,170631,4,0,0,1261,10.2,2.2768686,4
2020-03-01-170633,170633,0,0,0,0,0.2,0.036982473,6
2020-03-02-170633,170633,0,0,5,0,0.0,0.0039508324,0
2020-03-03-170633,170633,0,0,2,0,0.0,0.01264845,1
2020-03-04-170633,170633,0,0,3,0,0.2,0.014043197,2
2020-03-05-170633,170633,0,4,1,0,0.0,0.0018892194,3
2020-03-06-170633,170633,0,0,7,0,0.0,0.0019121239,4
2020-03-07-170633,170633,0,0,1,0,0.0,0.0007665161,5
2020-03-08-170633,170633,0,0,0,0,0.2,0.010017057,6
2020-03-09-170633,170633,0,0,23,0,0.2,0.012520092,0
2020-03-10-170633,170633,0,0,6,0,0.2,0.035409763,1
2020-03-11-170633,170633,0,0,3,0,0.6,0.05822156,2
2020-03-12-170633,170633,0,0,7,0,0.2,0.075817145,3
2020-03-13-170633,170633,1,0,15,1,0.6,0.12130669,4
2020-03-14-170633,170633,0,0,4,1,2.0,0.20845361,5
2020-03-15-170633,170633,0,0,2,1,4.4,0.3280854,6
2020-03-16-170633,170633,5,0,31,6,8.2,0.91070795,0
2020-03-17-170633,170633,2,0,3,8,8.2,0.9097411,1
2020-03-18-170633,170633,3,0,4,11,5.8,0.7716112,2
2020-03-19-170633,170633,1,0,5,12,8.2,0.9352031,3
2020-03-20-170633,170633,7,0,2,19,9.2,1.2209493,4
2020-03-21-170633,170633,1,0,1,20,4.2,0.47153863,5
2020-03-22-170633,170633,0,0,1,20,5.8,0.47794715,6
2020-03-23-170633,170633,23,1,2,43,20.2,2.4686003,0
2020-03-24-170633,170633,6,1,2,49,15.2,1.6204118,1
2020-03-25-170633,170633,3,0,2,52,16.8,2.1837127,2
2020-03-26-170633,170633,7,0,1,59,10.6,1.6000671,3
2020-03-27-170633,170633,15,0,5,74,13.8,2.0398314,4
2020-03-28-170633,170633,4,0,0,78,3.2,0.327049,5
2020-03-29-170633,170633,2,0,1,80,4.0,0.3530267,6
2020-03-30-170633,170633,31,0,1,111,11.2,2.1382835,0
2020-03-31-170633,170633,3,0,0,114,11.0,1.2130105,1
2020-04-01-170633,170633,4,0,1,118,13.2,1.3700742,2
2020-04-02-170633,170633,5,0,3,123,5.6,0.7275091,3
2020-04-03-170633,170633,2,0,3,125,11.2,1.0919799,4
2020-04-04-170633,170633,1,0,0,126,1.8,0.1978668,5
2020-04-05-170633,170633,1,1,0,127,4.4,0.26996723,6
2020-04-06-170633,170633,2,0,1,129,12.6,1.394918,0
2020-04-07-170633,170633,2,0,0,131,14.0,0.851396,1
2020-04-08-170633,170633,2,0,0,133,7.8,0.71019334,2
2020-04-09-170633,170633,1,0,0,134,2.6,0.27644718,3
2020-04-10-170633,170633,5,0,2,139,4.2,0.51916134,4
2020-04-11-170633,170633,0,0,0,139,3.6,0.26791534,5
2020-04-12-170633,170633,1,0,1,140,4.8,0.21193203,6
2020-04-13-170633,170633,1,1,3,141,10.8,0.9293955,0
2020-04-14-170633,170633,0,0,2,141,12.2,1.0196525,1
2020-04-15-170633,170633,1,0,1,142,6.8,0.8509131,2
2020-04-16-170633,170633,3,0,0,145,5.2,0.5372186,3
2020-04-17-170633,170633,3,0,1,148,5.8,0.7433436,4
2020-04-18-170633,170633,0,0,0,148,3.0,0.32229736,5
2020-04-19-170633,170633,0,0,0,148,0.8,0.14381683,6
2020-04-20-170633,170633,1,0,2,149,5.2,0.5155186,0
2020-04-21-170633,170633,0,0,0,149,9.4,1.1231282,1
2020-04-22-170633,170633,0,0,0,149,7.8,0.7527886,2
2020-04-23-170633,170633,0,0,1,149,1.2,0.1717897,3
2020-04-24-170633,170633,2,0,1,151,4.6,0.5872916,4
2020-04-25-170633,170633,0,0,0,151,2.2,0.20357786,5
2020-04-26-170633,170633,1,0,0,152,0.8,0.13875547,6
2020-04-27-170633,170633,3,0,2,155,3.8,0.5763564,0
2020-04-28-170633,170633,2,0,1,157,4.0,0.4925417,1
2020-04-29-170633,170633,1,0,2,158,4.4,0.60400134,2
2020-04-30-170633,170633,0,0,2,158,4.0,0.46621135,3
2020-05-01-170633,170633,1,0,2,159,2.8,0.24807484,4
2020-05-02-170633,170633,0,0,0,159,0.4,0.19717555,5
2020-05-03-170633,170633,0,0,0,159,0.6,0.035557017,6
2020-05-04-170633,170633,2,0,2,161,3.4,0.96393675,0
2020-05-05-170633,170633,0,0,0,161,3.0,0.41786143,1
2020-05-06-170633,170633,0,0,2,161,1.4,1.5772543,2
2020-05-07-170633,170633,1,0,0,162,4.6,1.1179268,3
2020-05-08-170633,170633,1,0,0,163,5.0,0.59304124,4
2020-05-09-170633,170633,0,0,0,163,1.6,0.13345106,5
2020-05-10-170633,170633,0,0,0,163,0.4,0.026435636,6
2020-05-11-170633,170633,2,0,0,165,4.2,0.5175368,0
2020-05-12-170633,170633,1,1,1,166,6.8,0.5432056,1
2020-05-13-170633,170633,2,0,0,168,4.2,0.32432696,2
2020-05-14-170633,170633,2,0,1,170,1.4,0.23932864,3
2020-05-15-170633,170633,2,0,1,172,4.0,0.38510975,4
2020-05-16-170633,170633,0,1,0,172,0.2,0.009102148,5
2020-05-17-170633,170633,0,0,0,172,0.0,0.015790718,6
2020-05-18-170633,170633,2,0,0,174,2.0,0.36351067,0
2020-05-19-170633,170633,0,0,2,174,2.2,0.25954175,1
2020-05-20-170633,170633,2,0,2,176,1.0,0.25362408,2
2020-05-21-170633,170633,0,0,0,176,1.4,0.15921529,3
2020-05-22-170633,170633,0,0,0,176,2.2,0.33950758,4
2020-05-23-170633,170633,0,0,0,176,0.4,0.054875195,5
2020-05-24-170633,170633,0,0,0,176,0.0,0.03809956,6
2020-05-25-170633,170633,0,0,0,176,2.8,0.3521941,0
2020-05-26-170633,170633,1,0,1,177,0.6,0.12123467,1
2020-05-27-170633,170633,0,2,0,177,1.2,0.15744469,2
2020-05-28-170633,170633,1,1,0,178,2.0,0.38516325,3
2020-05-29-170633,170633,1,1,0,179,1.6,0.16498524,4
2020-05-30-170633,170633,0,0,0,179,0.0,0.012983361,5
2020-05-31-170633,170633,0,0,0,179,0.2,0.008313094,6
2020-06-01-170633,170633,0,2,0,179,1.4,0.25505227,0
2020-06-02-170633,170633,2,0,0,181,0.4,0.3035353,1
2020-06-03-170633,170633,2,0,0,183,1.2,0.19782913,2
2020-06-04-170633,170633,0,0,0,183,1.4,0.19691095,3
2020-06-05-170633,170633,0,0,0,183,0.8,0.4099646,4
2020-06-06-170633,170633,0,0,0,183,0.0,0.050828915,5
2020-06-07-170633,170633,0,0,0,183,0.0,0.0110354815,6
2020-06-08-170633,170633,0,0,0,183,0.6,0.11578618,0
2020-06-09-170633,170633,1,0,0,184,1.0,0.10900993,1
2020-06-10-170633,170633,0,0,0,184,0.4,0.08847515,2
2020-06-11-170633,170633,0,0,0,184,1.8,0.08262536,3
2020-06-12-170633,170633,0,0,0,184,1.0,0.12113696,4
2020-06-13-170633,170633,0,0,0,184,0.0,0.0015438214,5
2020-06-14-170633,170633,0,0,0,184,0.0,0.0021266672,6
2020-06-15-170633,170633,0,1,0,184,0.2,0.027380766,0
2020-06-16-170633,170633,0,0,0,184,1.0,0.15213497,1
2020-06-17-170633,170633,0,0,0,184,0.4,0.106926724,2
2020-06-18-170633,170633,0,0,0,184,1.2,0.19822498,3
2020-06-19-170633,170633,0,1,0,184,2.2,0.33174846,4
2020-06-20-170633,170633,0,0,0,184,0.0,0.0011841861,5
2020-06-21-170633,170633,0,0,0,184,0.2,0.009259246,6
2020-06-22-170633,170633,0,0,0,184,1.0,0.15043792,0
2020-06-23-170633,170633,0,0,0,184,1.2,0.2554156,1
2020-06-24-170633,170633,0,0,0,184,0.6,0.10999339,2
2020-06-25-170633,170633,0,1,0,184,0.8,0.10852554,3
2020-06-26-170633,170633,0,0,0,184,1.0,0.080103114,4
2020-06-27-170633,170633,0,0,0,184,0.2,0.018991627,5
2020-06-28-170633,170633,0,0,0,184,0.2,0.054833304,6
2020-06-29-170633,170633,0,0,0,184,0.4,0.06654121,0
2020-06-30-170633,170633,0,0,0,184,0.6,0.092627555,1
2020-07-01-170633,170633,0,0,0,184,0.2,0.02806719,2
2020-07-02-170633,170633,0,0,0,184,0.4,0.04275963,3
2020-07-03-170633,170633,0,0,0,184,0.8,0.051973782,4
2020-07-04-170633,170633,0,0,0,184,0.0,0.02400993,5
2020-07-05-170633,170633,0,0,0,184,0.2,0.043315392,6
2020-07-06-170633,170633,0,0,0,184,0.0,0.018948128,0
2020-07-07-170633,170633,0,0,1,184,0.8,0.038471032,1
2020-07-08-170633,170633,0,0,0,184,0.2,0.06242999,2
2020-07-09-170633,170633,0,0,0,184,0.6,0.090375945,3
2020-07-10-170633,170633,0,0,0,184,0.0,0.030881628,4
2020-07-11-170633,170633,0,0,0,184,0.0,0.011645809,5
2020-07-12-170633,170633,0,0,0,184,0.0,0.03364437,6
2020-07-13-170633,170633,0,0,1,184,0.0,0.08122268,0
2020-07-14-170633,170633,0,0,0,184,0.4,0.056372955,1
2020-07-15-170633,170633,0,0,0,184,0.2,0.015663987,2
2020-07-16-170633,170633,0,0,0,184,0.8,0.13438687,3
2020-07-17-170633,170633,0,0,0,184,0.4,0.032397546,4
2020-07-18-170633,170633,0,0,0,184,0.0,0.030798648,5
2020-07-19-170633,170633,0,0,0,184,0.0,0.016274843,6
2020-07-20-170633,170633,0,0,1,184,0.8,0.03834807,0
2020-07-21-170633,170633,1,0,0,185,0.0,0.053941466,1
2020-07-22-170633,170633,0,0,0,185,1.0,0.08342793,2
2020-07-23-170633,170633,0,0,0,185,0.0,0.013764617,3
2020-07-24-170633,170633,0,0,0,185,0.2,0.021238588,4
2020-07-25-170633,170633,0,0,0,185,0.4,0.009536923,5
2020-07-26-170633,170633,0,0,0,185,0.2,0.014898358,6
2020-07-27-170633,170633,1,0,0,186,0.6,0.056659877,0
2020-07-28-170633,170633,0,0,0,186,0.8,0.03928924,1
2020-07-29-170633,170633,0,0,0,186,0.4,0.035781827,2
2020-07-30-170633,170633,0,0,0,186,0.4,0.2550161,3
2020-07-31-170633,170633,0,0,0,186,0.6,0.11098562,4
2020-08-01-170633,170633,0,0,0,186,0.6,0.083805464,5
2020-08-02-170633,170633,0,0,0,186,1.4,0.13914396,6
2020-08-03-170633,170633,1,0,1,187,1.8,0.27730092,0
2020-08-04-170633,170633,0,0,0,187,1.0,0.2686187,1
2020-08-05-170633,170633,0,0,0,187,2.4,0.32256573,2
2020-08-06-170633,170633,0,0,1,187,1.6,0.24225315,3
2020-08-07-170633,170633,0,0,0,187,2.0,0.47822383,4
2020-08-08-170633,170633,0,0,0,187,0.8,0.20450193,5
2020-08-09-170633,170633,0,0,1,187,0.0,0.080638744,6
2020-08-10-170633,170633,0,0,0,187,1.8,0.3196568,0
2020-08-11-170633,170633,0,0,1,187,0.8,0.38383853,1
2020-08-12-170633,170633,0,1,0,187,1.4,0.5553922,2
2020-08-13-170633,170633,0,0,0,187,4.0,0.5764065,3
2020-08-14-170633,170633,0,0,0,187,2.8,0.73414296,4
2020-08-15-170633,170633,0,0,0,187,1.0,0.07223929,5
2020-08-16-170633,170633,0,0,2,187,1.6,0.29233375,6
2020-08-17-170633,170633,1,0,3,188,2.2,0.34579116,0
2020-08-18-170633,170633,0,0,3,188,2.2,0.43003717,1
2020-08-19-170633,170633,0,0,0,188,2.0,0.45513284,2
2020-08-20-170633,170633,1,0,2,189,3.0,0.74158126,3
2020-08-21-170633,170633,0,0,0,189,1.8,0.57535076,4
2020-08-22-170633,170633,0,0,3,189,0.8,0.23649943,5
2020-08-23-170633,170633,1,0,1,190,3.0,0.29852718,6
2020-08-24-170633,170633,0,0,1,190,6.2,0.9344844,0
2020-08-25-170633,170633,1,0,1,191,5.4,0.9399422,1
2020-08-26-170633,170633,0,0,0,191,7.2,1.1792983,2
2020-08-27-170633,170633,0,0,0,191,5.0,1.2445604,3
2020-08-28-170633,170633,0,0,4,191,5.4,1.0114472,4
2020-08-29-170633,170633,0,0,2,191,1.8,0.4368397,5
2020-08-30-170633,170633,2,0,0,193,2.4,0.4318719,6
2020-08-31-170633,170633,3,0,0,196,5.2,1.5392566,0
2020-09-01-170633,170633,3,0,15,199,5.0,1.1107647,1
2020-09-02-170633,170633,0,0,5,199,4.0,0.61320055,2
2020-09-03-170633,170633,2,1,2,201,5.2,0.93642527,3
2020-09-04-170633,170633,0,0,0,201,7.4,0.879825,4
2020-09-05-170633,170633,3,0,0,204,3.6,0.7016219,5
2020-09-06-170633,170633,1,0,1,205,2.6,1.0985838,6
2020-09-07-170633,170633,1,0,0,206,5.2,1.1251111,0
2020-09-08-170633,170633,1,0,1,207,1.0,0.4291799,1
2020-09-09-170633,170633,0,0,2,207,2.2,0.38368043,2
2020-09-10-170633,170633,0,0,1,207,4.2,0.7872393,3
2020-09-11-170633,170633,4,0,0,211,7.4,1.2625328,4
2020-09-12-170633,170633,2,0,0,213,2.8,0.69599295,5
2020-09-13-170633,170633,0,0,0,213,3.2,0.7867832,6
2020-09-14-170633,170633,0,0,1,213,7.4,1.0243086,0
2020-09-15-170633,170633,15,0,0,228,4.2,0.9588897,1
2020-09-16-170633,170633,5,0,0,233,2.4,1.3465496,2
2020-09-17-170633,170633,2,0,1,235,4.2,0.8701765,3
2020-09-18-170633,170633,0,0,0,235,17.8,1.3706353,4
2020-09-19-170633,170633,0,0,1,235,6.6,1.3923491,5
2020-09-20-170633,170633,1,0,1,236,5.4,0.97435313,6
2020-09-21-170633,170633,0,2,0,236,6.6,1.1293509,0
2020-09-22-170633,170633,1,0,0,237,8.4,0.6824316,1
2020-09-23-170633,170633,2,1,1,239,7.4,1.0794733,2
2020-09-24-170633,170633,1,0,1,240,5.2,1.0433995,3
2020-09-25-170633,170633,0,0,3,240,5.4,0.78772604,4
2020-09-26-170633,170633,0,0,0,240,1.6,0.40881816,5
2020-09-27-170633,170633,0,0,0,240,1.6,0.39908856,6
2020-09-28-170633,170633,1,0,1,241,5.6,0.6958193,0
2020-09-29-170633,170633,0,0,3,241,2.2,0.53096145,1
2020-09-30-170633,170633,0,0,0,241,7.4,1.1460419,2
2020-10-01-170633,170633,1,0,0,242,4.2,0.72868305,3
2020-10-02-170633,170633,0,0,4,242,3.4,0.6275083,4
2020-10-03-170633,170633,1,1,0,243,1.2,0.35563296,5
2020-10-04-170633,170633,1,0,0,244,2.6,0.30511376,6
2020-10-05-170633,170633,0,0,0,244,14.0,1.3494852,0
2020-10-06-170633,170633,0,0,1,244,3.2,0.6767323,1
2020-10-07-170633,170633,1,0,4,245,7.0,1.4976872,2
2020-10-08-170633,170633,1,0,1,246,6.4,0.916374,3
2020-10-09-170633,170633,3,0,3,249,7.0,1.1537094,4
2020-10-10-170633,170633,0,0,0,249,2.6,0.44919798,5
2020-10-11-170633,170633,0,0,1,249,3.8,0.38816974,6
2020-10-12-170633,170633,1,0,0,250,2.2,0.43101025,0
2020-10-13-170633,170633,3,0,3,253,4.8,0.99522144,1
2020-10-14-170633,170633,0,0,0,253,4.0,0.821606,2
2020-10-15-170633,170633,0,0,0,253,12.2,1.4216228,3
2020-10-16-170633,170633,4,0,1,257,9.8,1.7983453,4
2020-10-17-170633,170633,0,0,2,257,2.8,0.56191134,5
2020-10-18-170633,170633,0,0,1,257,5.2,0.58210784,6
2020-10-19-170633,170633,0,0,0,257,12.8,1.839261,0
2020-10-20-170633,170633,1,1,5,258,9.6,1.2898921,1
2020-10-21-170633,170633,4,0,0,262,10.2,1.746249,2
2020-10-22-170633,170633,1,0,5,263,9.2,1.9279116,3
2020-10-23-170633,170633,3,0,1,266,13.4,1.9766352,4
2020-10-24-170633,170633,0,0,0,266,3.2,0.5246205,5
2020-10-25-170633,170633,1,0,1,267,4.6,0.4559724,6
2020-10-26-170633,170633,0,0,2,267,10.6,1.7452862,0
2020-10-27-170633,170633,3,0,1,270,8.8,1.3814254,1
2020-10-28-170633,170633,0,0,2,270,7.8,1.1530377,2
2020-10-29-170633,170633,0,0,2,270,8.2,1.6182933,3
2020-10-30-170633,170633,1,0,1,271,12.2,1.4364982,4
2020-10-31-170633,170633,2,1,0,273,3.4,0.60973096,5
2020-11-01-170633,170633,1,0,0,274,3.8,0.52335805,6
2020-11-02-170633,170633,0,0,0,274,4.0,0.4543235,0
2020-11-03-170633,170633,5,0,0,279,10.2,1.5423589,1
2020-11-04-170633,170633,0,0,0,279,10.2,1.7164482,2
2020-11-05-170633,170633,5,0,0,284,7.6,1.3689446,3
2020-11-06-170633,170633,1,1,0,285,6.6,1.4988209,4
2020-11-07-170633,170633,0,0,0,285,1.6,0.26674405,5
2020-11-08-170633,170633,1,0,0,286,3.0,0.46132395,6
2020-11-09-170633,170633,2,0,0,288,9.2,1.5180614,0
2020-11-10-170633,170633,1,0,0,289,6.2,0.9730477,1
2020-11-11-170633,170633,2,0,0,291,7.0,0.9349194,2
2020-11-12-170633,170633,2,0,0,293,6.2,1.115968,3
2020-11-13-170633,170633,1,0,0,294,7.0,0.93034333,4
2020-03-01-170634,170634,0,0,1,0,0.0,0.00023667679,6
2020-03-02-170634,170634,0,0,1,0,0.0,0.00538311,0
2020-03-03-170634,170634,0,0,4,0,0.0,0.0064011156,1
2020-03-04-170634,170634,0,0,8,0,0.0,0.004984145,2
2020-03-05-170634,170634,0,0,4,0,0.0,0.016721401,3
2020-03-06-170634,170634,0,0,0,0,0.0,0.01737085,4
2020-03-07-170634,170634,0,0,0,0,0.0,0.004235022,5
2020-03-08-170634,170634,0,0,0,0,0.0,0.0010934824,6
2020-03-09-170634,170634,0,0,2,0,0.0,0.009003739,0
2020-03-10-170634,170634,0,0,1,0,0.0,0.014806457,1
2020-03-11-170634,170634,0,0,0,0,0.0,0.04595459,2
2020-03-12-170634,170634,1,0,0,1,0.0,0.3084142,3
2020-03-13-170634,170634,2,0,1,3,0.16666666666666666,0.623476,4
2020-03-14-170634,170634,0,0,2,3,0.0,0.07179935,5
2020-03-15-170634,170634,1,0,1,4,0.16666666666666666,0.23285812,6
2020-03-16-170634,170634,1,0,5,5,0.16666666666666666,0.36975276,0
2020-03-17-170634,170634,4,0,3,9,1.0,1.182082,1
2020-03-18-170634,170634,8,0,1,17,1.0,0.9851956,2
2020-03-19-170634,170634,4,0,0,21,1.0,1.2159272,3
2020-03-20-170634,170634,0,0,4,21,0.5,0.35470584,4
2020-03-21-170634,170634,0,0,0,21,0.3333333333333333,0.1384451,5
2020-03-22-170634,170634,0,0,1,21,0.0,0.13943578,6
2020-03-23-170634,170634,2,0,3,23,1.6666666666666667,1.1254178,0
2020-03-24-170634,170634,1,0,2,24,1.0,0.6811782,1
2020-03-25-170634,170634,0,0,0,24,1.6666666666666667,0.7986197,2
2020-03-26-170634,170634,0,0,1,24,1.8333333333333333,0.56238145,3
2020-03-27-170634,170634,1,0,2,25,1.3333333333333333,0.7256774,4
2020-03-28-170634,170634,2,0,0,27,0.0,0.15004744,5
2020-03-29-170634,170634,1,0,1,28,0.6666666666666666,0.16448122,6
2020-03-30-170634,170634,5,0,0,33,1.1666666666666667,1.18461,0
2020-03-31-170634,170634,3,0,2,36,0.5,0.5835588,1
2020-04-01-170634,170634,1,0,2,37,1.0,0.35139042,2
2020-04-02-170634,170634,0,0,1,37,4.833333333333333,0.8947765,3
2020-04-03-170634,170634,4,0,0,41,1.3333333333333333,0.62541866,4
2020-04-04-170634,170634,0,0,0,41,0.6666666666666666,0.08733151,5
2020-04-05-170634,170634,1,0,0,42,0.5,0.16234577,6
2020-04-06-170634,170634,3,1,3,45,0.3333333333333333,0.5392985,0
2020-04-07-170634,170634,2,2,0,47,0.3333333333333333,0.49102244,1
2020-04-08-170634,170634,0,0,0,47,0.3333333333333333,0.13778728,2
2020-04-09-170634,170634,1,3,1,48,0.16666666666666666,0.17001303,3
2020-04-10-170634,170634,2,0,0,50,0.3333333333333333,0.25408697,4
2020-04-11-170634,170634,0,0,0,50,0.16666666666666666,0.035745546,5
2020-04-12-170634,170634,1,0,0,51,0.0,0.112656645,6
2020-04-13-170634,170634,0,0,0,51,0.6666666666666666,0.39535987,0
2020-04-14-170634,170634,2,0,4,53,0.16666666666666666,0.52211994,1
2020-04-15-170634,170634,2,0,3,55,0.3333333333333333,0.47859156,2
2020-04-16-170634,170634,1,0,0,56,1.5,0.2574105,3
2020-04-17-170634,170634,0,0,0,56,0.0,0.07454462,4
2020-04-18-170634,170634,0,0,1,56,0.3333333333333333,0.12397235,5
2020-04-19-170634,170634,0,0,0,56,0.3333333333333333,0.048394475,6
2020-04-20-170634,170634,3,0,1,59,4.0,1.2953434,0
2020-04-21-170634,170634,0,1,0,59,0.3333333333333333,0.2419403,1
2020-04-22-170634,170634,0,0,1,59,0.0,0.10771858,2
2020-04-23-170634,170634,1,0,1,60,0.16666666666666666,0.21185538,3
2020-04-24-170634,170634,0,0,0,60,0.8333333333333334,0.17761028,4
2020-04-25-170634,170634,0,0,0,60,0.16666666666666666,0.026824627,5
2020-04-26-170634,170634,0,0,0,60,0.0,0.029490778,6
2020-04-27-170634,170634,0,0,0,60,0.5,0.35635749,0
2020-04-28-170634,170634,4,0,1,64,0.8333333333333334,0.9356628,1
2020-04-29-170634,170634,3,0,2,67,0.16666666666666666,0.5117691,2
2020-04-30-170634,170634,0,0,1,67,0.0,0.07071881,3
2020-05-01-170634,170634,0,0,0,67,0.16666666666666666,0.05350353,4
2020-05-02-170634,170634,1,0,0,68,0.3333333333333333,0.29097143,5
2020-05-03-170634,170634,0,0,0,68,0.16666666666666666,0.014892578,6
2020-05-04-170634,170634,1,0,0,69,0.5,0.51858026,0
2020-05-05-170634,170634,0,0,0,69,2.0,0.4686381,1
2020-05-06-170634,170634,1,0,1,70,0.8333333333333334,1.6366544,2
2020-05-07-170634,170634,1,0,0,71,0.16666666666666666,0.4314072,3
2020-05-08-170634,170634,0,0,0,71,1.1666666666666667,0.2690501,4
2020-05-09-170634,170634,0,1,0,71,0.16666666666666666,0.04257955,5
2020-05-10-170634,170634,0,0,0,71,0.0,0.0047165714,6
2020-05-11-170634,170634,0,1,0,71,0.3333333333333333,0.15917194,0
2020-05-12-170634,170634,1,1,0,72,0.5,0.38841546,1
2020-05-13-170634,170634,2,0,2,74,0.3333333333333333,0.37905106,2
2020-05-14-170634,170634,1,0,0,75,0.0,0.25390658,3
2020-05-15-170634,170634,0,0,1,75,0.0,0.053132065,4
2020-05-16-170634,170634,0,0,0,75,0.0,0.0032848474,5
2020-05-17-170634,170634,0,0,0,75,0.0,0.0038136654,6
2020-05-18-170634,170634,0,0,0,75,0.3333333333333333,0.1585417,0
2020-05-19-170634,170634,0,0,0,75,0.3333333333333333,0.18807909,1
2020-05-20-170634,170634,1,0,1,76,0.16666666666666666,0.29653817,2
2020-05-21-170634,170634,0,0,0,76,0.16666666666666666,0.14865923,3
2020-05-22-170634,170634,0,0,0,76,0.0,0.037739992,4
2020-05-23-170634,170634,0,0,0,76,0.0,0.0077511305,5
2020-05-24-170634,170634,0,0,0,76,0.0,0.0180748,6
2020-05-25-170634,170634,0,0,0,76,0.0,0.050830927,0
2020-05-26-170634,170634,0,0,0,76,0.0,0.04530332,1
2020-05-27-170634,170634,2,4,0,78,0.0,0.6056467,2
2020-05-28-170634,170634,0,0,0,78,0.0,0.07512062,3
2020-05-29-170634,170634,1,0,0,79,0.0,0.31564516,4
2020-05-30-170634,170634,0,0,0,79,0.0,0.0021629133,5
2020-05-31-170634,170634,0,0,0,79,0.0,0.0006424198,6
2020-06-01-170634,170634,0,0,0,79,0.0,0.16392656,0
2020-06-02-170634,170634,0,0,0,79,0.3333333333333333,0.10671399,1
2020-06-03-170634,170634,1,0,0,80,0.5,0.5154539,2
2020-06-04-170634,170634,0,0,0,80,0.16666666666666666,0.12184951,3
2020-06-05-170634,170634,0,0,0,80,0.5,0.33121443,4
2020-06-06-170634,170634,0,6,0,80,0.0,0.0074777068,5
2020-06-07-170634,170634,0,0,0,80,0.16666666666666666,0.04390979,6
2020-06-08-170634,170634,0,0,1,80,0.0,0.021623716,0
2020-06-09-170634,170634,0,0,0,80,0.0,0.020929161,1
2020-06-10-170634,170634,0,0,0,80,0.16666666666666666,0.080267176,2
2020-06-11-170634,170634,0,0,1,80,0.0,0.054549765,3
2020-06-12-170634,170634,0,0,0,80,0.16666666666666666,0.104445204,4
2020-06-13-170634,170634,0,0,0,80,0.0,0.005448869,5
2020-06-14-170634,170634,0,0,0,80,0.0,0.0012041152,6
2020-06-15-170634,170634,0,0,0,80,0.16666666666666666,0.020169267,0
2020-06-16-170634,170634,0,0,0,80,0.0,0.026303006,1
2020-06-17-170634,170634,0,1,0,80,0.16666666666666666,0.06859315,2
2020-06-18-170634,170634,0,0,0,80,0.3333333333333333,0.11027614,3
2020-06-19-170634,170634,0,0,0,80,0.0,0.075430185,4
2020-06-20-170634,170634,0,0,0,80,0.16666666666666666,0.05466366,5
2020-06-21-170634,170634,0,0,0,80,0.0,0.00047829657,6
2020-06-22-170634,170634,1,0,0,81,0.0,0.14255056,0
2020-06-23-170634,170634,0,0,0,81,0.16666666666666666,0.103550665,1
2020-06-24-170634,170634,0,0,0,81,0.16666666666666666,0.06023247,2
2020-06-25-170634,170634,1,1,0,82,0.0,0.30079827,3
2020-06-26-170634,170634,0,0,0,82,0.0,0.017603496,4
2020-06-27-170634,170634,0,0,0,82,0.0,0.0031276108,5
2020-06-28-170634,170634,0,0,0,82,0.0,0.011336902,6
2020-06-29-170634,170634,0,1,0,82,0.3333333333333333,0.10611267,0
2020-06-30-170634,170634,0,0,0,82,0.0,0.026843503,1
2020-07-01-170634,170634,0,0,0,82,0.0,0.0089519955,2
2020-07-02-170634,170634,0,0,1,82,0.16666666666666666,0.051875852,3
2020-07-03-170634,170634,0,0,0,82,0.16666666666666666,0.059455022,4
2020-07-04-170634,170634,0,0,0,82,0.0,0.00059199805,5
2020-07-05-170634,170634,0,0,0,82,0.0,0.021500893,6
2020-07-06-170634,170634,0,0,0,82,0.0,0.010830383,0
2020-07-07-170634,170634,0,0,0,82,0.0,0.009249375,1
2020-07-08-170634,170634,0,0,0,82,0.0,0.0006289801,2
2020-07-09-170634,170634,0,0,0,82,0.0,0.011160724,3
2020-07-10-170634,170634,0,0,0,82,0.0,0.011826911,4
2020-07-11-170634,170634,0,0,0,82,0.0,0.0014609051,5
2020-07-12-170634,170634,0,0,0,82,0.16666666666666666,0.053851545,6
2020-07-13-170634,170634,0,0,0,82,0.16666666666666666,0.100034155,0
2020-07-14-170634,170634,0,0,0,82,0.16666666666666666,0.081006564,1
2020-07-15-170634,170634,0,0,1,82,0.0,0.0019195016,2
2020-07-16-170634,170634,1,0,0,83,0.3333333333333333,0.34228915,3
2020-07-17-170634,170634,0,0,0,83,0.0,0.0048793806,4
2020-07-18-170634,170634,0,0,0,83,0.0,0.00999824,5
2020-07-19-170634,170634,0,0,0,83,0.0,0.0014344816,6
2020-07-20-170634,170634,0,0,0,83,0.0,0.002644255,0
2020-07-21-170634,170634,0,0,0,83,0.0,0.019657433,1
2020-07-22-170634,170634,0,0,0,83,0.0,0.028841829,2
2020-07-23-170634,170634,0,0,1,83,0.0,0.02426915,3
2020-07-24-170634,170634,0,0,1,83,0.0,0.014071799,4
2020-07-25-170634,170634,0,0,1,83,0.0,0.0058484743,5
2020-07-26-170634,170634,0,0,1,83,0.0,0.003441332,6
2020-07-27-170634,170634,0,0,0,83,0.0,0.004154674,0
2020-07-28-170634,170634,0,0,0,83,0.16666666666666666,0.06603809,1
2020-07-29-170634,170634,1,0,1,84,0.0,0.32272428,2
2020-07-30-170634,170634,0,0,4,84,0.0,0.04219958,3
2020-07-31-170634,170634,0,0,2,84,0.3333333333333333,0.09626511,4
2020-08-01-170634,170634,0,0,0,84,0.16666666666666666,0.12492658,5
2020-08-02-170634,170634,0,0,1,84,0.0,0.03629526,6
2020-08-03-170634,170634,0,0,3,84,0.0,0.03551878,0
2020-08-04-170634,170634,0,0,2,84,0.16666666666666666,0.14867316,1
2020-08-05-170634,170634,0,0,0,84,0.0,0.06101538,2
2020-08-06-170634,170634,1,0,0,85,0.16666666666666666,0.46993482,3
2020-08-07-170634,170634,1,0,2,86,1.0,0.86298275,4
2020-08-08-170634,170634,1,0,0,87,0.16666666666666666,0.4013397,5
2020-08-09-170634,170634,1,0,3,88,0.3333333333333333,0.3620877,6
2020-08-10-170634,170634,0,0,2,88,2.333333333333333,1.0548408,0
2020-08-11-170634,170634,0,0,4,88,0.6666666666666666,0.5113359,1
2020-08-12-170634,170634,1,0,1,89,0.3333333333333333,0.64164954,2
2020-08-13-170634,170634,4,0,1,93,0.0,1.580038,3
2020-08-14-170634,170634,2,0,0,95,0.16666666666666666,0.79285824,4
2020-08-15-170634,170634,0,0,1,95,0.3333333333333333,0.19932057,5
2020-08-16-170634,170634,1,0,0,96,0.8333333333333334,0.65904397,6
2020-08-17-170634,170634,3,0,3,99,1.0,0.7878737,0
2020-08-18-170634,170634,2,0,4,101,1.6666666666666667,1.5415972,1
2020-08-19-170634,170634,0,0,2,101,0.3333333333333333,0.5639554,2
2020-08-20-170634,170634,0,0,2,101,0.8333333333333334,0.6387235,3
2020-08-21-170634,170634,2,0,0,103,0.6666666666666666,0.9366855,4
2020-08-22-170634,170634,0,0,0,103,0.5,0.4914974,5
2020-08-23-170634,170634,3,0,0,106,0.3333333333333333,0.43801966,6
2020-08-24-170634,170634,2,0,0,108,1.3333333333333333,0.6334548,0
2020-08-25-170634,170634,4,0,0,112,0.8333333333333334,1.7743822,1
2020-08-26-170634,170634,1,0,0,113,0.8333333333333334,1.4916425,2
2020-08-27-170634,170634,1,0,1,114,0.3333333333333333,0.61397284,3
2020-08-28-170634,170634,0,0,1,114,1.3333333333333333,1.3338437,4
2020-08-29-170634,170634,1,0,0,115,2.333333333333333,1.4753824,5
2020-08-30-170634,170634,0,0,0,115,0.3333333333333333,0.12873842,6
2020-08-31-170634,170634,3,0,1,118,1.1666666666666667,0.818561,0
2020-09-01-170634,170634,4,0,0,122,2.1666666666666665,2.067665,1
2020-09-02-170634,170634,2,0,0,124,2.1666666666666665,1.760313,2
2020-09-03-170634,170634,2,0,0,126,2.333333333333333,1.4806604,3
2020-09-04-170634,170634,0,0,1,126,0.16666666666666666,0.39573908,4
2020-09-05-170634,170634,0,0,0,126,1.6666666666666667,0.45775557,5
2020-09-06-170634,170634,0,0,0,126,0.8333333333333334,0.4421507,6
2020-09-07-170634,170634,0,0,2,126,3.333333333333333,0.72514844,0
2020-09-08-170634,170634,0,0,0,126,1.0,0.4017422,1
2020-09-09-170634,170634,0,0,0,126,0.3333333333333333,0.34436417,2
2020-09-10-170634,170634,1,0,0,127,0.6666666666666666,0.59161645,3
2020-09-11-170634,170634,1,0,1,128,0.8333333333333334,0.3518086,4
2020-09-12-170634,170634,0,0,0,128,0.8333333333333334,0.3686876,5
2020-09-13-170634,170634,0,0,1,128,1.5,0.474975,6
2020-09-14-170634,170634,1,0,0,129,0.5,0.47957748,0
2020-09-15-170634,170634,0,0,3,129,0.16666666666666666,0.11738114,1
2020-09-16-170634,170634,0,0,4,129,0.16666666666666666,0.16351591,2
2020-09-17-170634,170634,0,0,4,129,0.8333333333333334,0.5783205,3
2020-09-18-170634,170634,1,0,3,130,1.1666666666666667,0.68877566,4
2020-09-19-170634,170634,0,1,0,130,1.1666666666666667,0.34558693,5
2020-09-20-170634,170634,0,0,1,130,1.1666666666666667,0.5037676,6
2020-09-21-170634,170634,2,1,1,132,1.1666666666666667,0.41242152,0
2020-09-22-170634,170634,0,0,0,132,1.8333333333333333,1.0557057,1
2020-09-23-170634,170634,0,0,1,132,2.333333333333333,1.0669057,2
2020-09-24-170634,170634,0,0,0,132,2.6666666666666665,1.2070252,3
2020-09-25-170634,170634,1,0,3,133,2.5,1.2651087,4
2020-09-26-170634,170634,0,0,0,133,0.8333333333333334,0.46733934,5
2020-09-27-170634,170634,1,0,0,134,0.5,0.43124908,6
2020-09-28-170634,170634,0,0,0,134,1.1666666666666667,0.15908511,0
2020-09-29-170634,170634,3,0,1,137,1.3333333333333333,1.0765228,1
2020-09-30-170634,170634,4,0,1,141,1.0,1.3563293,2
2020-10-01-170634,170634,4,0,2,145,1.8333333333333333,1.6507802,3
2020-10-02-170634,170634,3,1,2,148,0.5,0.4503301,4
2020-10-03-170634,170634,0,0,1,148,0.6666666666666666,0.30817816,5
2020-10-04-170634,170634,1,1,0,149,0.3333333333333333,0.32155967,6
2020-10-05-170634,170634,1,0,3,150,1.5,0.3758583,0
2020-10-06-170634,170634,0,0,0,150,2.1666666666666665,0.65200037,1
2020-10-07-170634,170634,1,0,1,151,1.0,1.2216821,2
2020-10-08-170634,170634,0,0,0,151,0.5,0.27641198,3
2020-10-09-170634,170634,3,0,1,154,0.8333333333333334,0.92984813,4
2020-10-10-170634,170634,0,0,2,154,0.3333333333333333,0.27526027,5
2020-10-11-170634,170634,0,0,0,154,0.16666666666666666,0.18494737,6
2020-10-12-170634,170634,0,0,0,154,0.5,0.14129283,0
2020-10-13-170634,170634,1,0,1,155,1.3333333333333333,1.157755,1
2020-10-14-170634,170634,1,0,1,156,1.3333333333333333,0.8692714,2
2020-10-15-170634,170634,2,0,2,158,0.5,0.77936447,3
2020-10-16-170634,170634,2,0,2,160,1.1666666666666667,1.0536354,4
2020-10-17-170634,170634,1,0,0,161,0.16666666666666666,0.38199264,5
2020-10-18-170634,170634,0,0,0,161,1.0,0.40705478,6
2020-10-19-170634,170634,3,1,0,164,2.5,0.8956039,0
2020-10-20-170634,170634,0,0,1,164,2.333333333333333,1.0855236,1
2020-10-21-170634,170634,1,0,1,165,0.5,0.85852724,2
2020-10-22-170634,170634,0,0,1,165,2.5,1.3231885,3
2020-10-23-170634,170634,1,0,3,166,1.5,2.2301393,4
2020-10-24-170634,170634,2,1,0,168,0.3333333333333333,0.6005799,5
2020-10-25-170634,170634,0,0,1,168,2.0,0.8074056,6
2020-10-26-170634,170634,0,0,0,168,3.1666666666666665,0.694583,0
2020-10-27-170634,170634,1,1,0,169,2.333333333333333,1.2775261,1
2020-10-28-170634,170634,1,0,0,170,3.333333333333333,1.2771664,2
2020-10-29-170634,170634,2,0,0,172,3.333333333333333,1.7746266,3
2020-10-30-170634,170634,2,0,0,174,1.8333333333333333,1.4078133,4
2020-10-31-170634,170634,0,0,0,174,0.6666666666666666,0.47747222,5
2020-11-01-170634,170634,0,1,0,174,0.16666666666666666,0.208165,6
2020-11-02-170634,170634,0,1,0,174,0.3333333333333333,0.18524458,0
2020-11-03-170634,170634,1,0,0,175,0.6666666666666666,0.71713185,1
2020-11-04-170634,170634,1,0,0,176,1.8333333333333333,0.86562663,2
2020-11-05-170634,170634,1,0,0,177,1.8333333333333333,1.0125822,3
2020-11-06-170634,170634,3,0,0,180,3.333333333333333,1.5881437,4
2020-11-07-170634,170634,0,0,0,180,0.3333333333333333,0.17701674,5
2020-11-08-170634,170634,1,0,0,181,0.6666666666666666,0.37420437,6
2020-11-09-170634,170634,0,0,0,181,1.3333333333333333,0.52181244,0
2020-11-10-170634,170634,0,1,0,181,0.3333333333333333,0.33440024,1
2020-11-11-170634,170634,0,3,0,181,2.5,0.6841305,2
2020-11-12-170634,170634,0,0,0,181,0.5,0.41036478,3
2020-11-13-170634,170634,0,0,0,181,1.6666666666666667,0.5529256,4
2020-03-01-170635,170635,0,0,5,0,0.0,0.009859005,6
2020-03-02-170635,170635,0,0,5,0,0.16666666666666666,0.017475314,0
2020-03-03-170635,170635,0,0,8,0,0.5,0.05545119,1
2020-03-04-170635,170635,0,0,14,0,0.0,0.048607584,2
2020-03-05-170635,170635,0,2,13,0,0.16666666666666666,0.008529533,3
2020-03-06-170635,170635,0,0,8,0,0.16666666666666666,0.01160664,4
2020-03-07-170635,170635,0,0,3,0,0.0,0.009823737,5
2020-03-08-170635,170635,0,1,7,0,0.0,0.02880084,6
2020-03-09-170635,170635,2,1,11,2,0.3333333333333333,0.057774346,0
2020-03-10-170635,170635,1,0,18,3,0.16666666666666666,0.16311607,1
2020-03-11-170635,170635,0,0,14,3,1.6666666666666667,0.11174442,2
2020-03-12-170635,170635,1,0,27,4,1.6666666666666667,0.051582254,3
2020-03-13-170635,170635,2,0,13,6,3.5,0.25584134,4
2020-03-14-170635,170635,2,0,4,8,3.6666666666666665,0.1945879,5
2020-03-15-170635,170635,5,0,2,13,6.166666666666668,0.35834137,6
2020-03-16-170635,170635,5,0,11,18,14.333333333333336,0.7957493,0
2020-03-17-170635,170635,8,1,11,26,17.666666666666668,0.87434137,1
2020-03-18-170635,170635,14,0,12,40,21.0,0.7339351,2
2020-03-19-170635,170635,13,0,5,53,17.833333333333332,0.9223539,3
2020-03-20-170635,170635,8,0,3,61,23.83333333333333,0.8703881,4
2020-03-21-170635,170635,3,0,3,64,9.166666666666666,0.24581784,5
2020-03-22-170635,170635,7,0,1,71,8.333333333333334,0.21880499,6
2020-03-23-170635,170635,11,0,5,82,33.666666666666664,1.6161842,0
2020-03-24-170635,170635,18,0,7,100,22.83333333333333,1.3023673,1
2020-03-25-170635,170635,14,0,4,114,25.33333333333333,1.3945812,2
2020-03-26-170635,170635,27,0,4,141,23.66666666666667,1.0706795,3
2020-03-27-170635,170635,13,0,7,154,21.33333333333333,1.2587272,4
2020-03-28-170635,170635,4,0,3,158,8.0,0.13083278,5
2020-03-29-170635,170635,2,0,3,160,7.5,0.17709038,6
2020-03-30-170635,170635,11,0,7,171,22.0,1.2301567,0
2020-03-31-170635,170635,11,0,8,182,14.166666666666664,0.6333825,1
2020-04-01-170635,170635,12,0,1,194,11.5,0.86003155,2
2020-04-02-170635,170635,5,0,19,199,8.5,0.379506,3
2020-04-03-170635,170635,3,0,3,202,10.833333333333336,0.5410187,4
2020-04-04-170635,170635,3,0,2,205,3.1666666666666665,0.10351732,5
2020-04-05-170635,170635,1,0,1,206,3.333333333333333,0.08510559,6
2020-04-06-170635,170635,5,0,1,211,17.0,0.7662795,0
2020-04-07-170635,170635,7,0,5,218,5.5,0.5973732,1
2020-04-08-170635,170635,4,0,9,222,5.666666666666668,0.4968919,2
2020-04-09-170635,170635,4,0,0,226,3.6666666666666665,0.18040821,3
2020-04-10-170635,170635,7,0,5,233,5.0,0.14530356,4
2020-04-11-170635,170635,3,0,1,236,2.6666666666666665,0.09177303,5
2020-04-12-170635,170635,3,0,1,239,2.833333333333333,0.14364314,6
2020-04-13-170635,170635,7,0,8,246,8.333333333333334,0.5163005,0
2020-04-14-170635,170635,8,0,4,254,4.666666666666667,0.8369411,1
2020-04-15-170635,170635,1,0,6,255,4.333333333333333,0.46549577,2
2020-04-16-170635,170635,19,0,5,274,6.0,0.28454226,3
2020-04-17-170635,170635,3,0,0,277,8.666666666666666,0.44943252,4
2020-04-18-170635,170635,2,0,0,279,2.0,0.23596358,5
2020-04-19-170635,170635,1,0,0,280,0.5,0.04911256,6
2020-04-20-170635,170635,1,0,2,281,7.333333333333332,0.3581432,0
2020-04-21-170635,170635,5,1,7,286,4.166666666666667,0.72757554,1
2020-04-22-170635,170635,9,0,12,295,4.5,0.7072182,2
2020-04-23-170635,170635,0,0,4,295,1.3333333333333333,0.11034901,3
2020-04-24-170635,170635,5,0,6,300,3.0,0.34255487,4
2020-04-25-170635,170635,1,0,0,301,1.0,0.1359018,5
2020-04-26-170635,170635,1,0,0,302,0.8333333333333334,0.12095571,6
2020-04-27-170635,170635,8,0,4,310,5.833333333333332,0.56851554,0
2020-04-28-170635,170635,4,0,8,314,2.833333333333333,0.23944724,1
2020-04-29-170635,170635,6,0,2,320,4.666666666666667,0.4342422,2
2020-04-30-170635,170635,5,0,0,325,3.6666666666666665,0.27308112,3
2020-05-01-170635,170635,0,0,5,325,1.0,0.19687933,4
2020-05-02-170635,170635,0,0,2,325,1.8333333333333333,0.11253403,5
2020-05-03-170635,170635,0,0,0,325,1.1666666666666667,0.038386054,6
2020-05-04-170635,170635,2,0,0,327,6.0,0.86634105,0
2020-05-05-170635,170635,7,0,1,334,5.166666666666667,0.35268018,1
2020-05-06-170635,170635,12,0,0,346,2.833333333333333,0.73572314,2
2020-05-07-170635,170635,4,0,2,350,2.6666666666666665,0.72467005,3
2020-05-08-170635,170635,6,0,5,356,6.5,0.40454686,4
2020-05-09-170635,170635,0,0,0,356,1.3333333333333333,0.058433183,5
2020-05-10-170635,170635,0,0,0,356,0.6666666666666666,0.012609929,6
2020-05-11-170635,170635,4,0,1,360,6.666666666666668,0.6265806,0
2020-05-12-170635,170635,8,1,1,368,14.833333333333336,0.5700469,1
2020-05-13-170635,170635,2,0,4,370,4.0,0.4306816,2
2020-05-14-170635,170635,0,0,1,370,3.8333333333333335,0.21222582,3
2020-05-15-170635,170635,5,0,4,375,4.833333333333333,0.33933607,4
2020-05-16-170635,170635,2,0,1,377,0.6666666666666666,0.009658846,5
2020-05-17-170635,170635,0,0,0,377,0.16666666666666666,0.005904721,6
2020-05-18-170635,170635,0,0,2,377,2.0,0.31929815,0
2020-05-19-170635,170635,1,0,1,378,3.1666666666666665,0.29508469,1
2020-05-20-170635,170635,0,0,0,378,3.1666666666666665,0.23123811,2
2020-05-21-170635,170635,2,0,2,380,3.1666666666666665,0.1429627,3
2020-05-22-170635,170635,5,0,2,385,3.0,0.20360969,4
2020-05-23-170635,170635,0,0,0,385,0.0,0.02834681,5
2020-05-24-170635,170635,0,0,0,385,0.16666666666666666,0.016190208,6
2020-05-25-170635,170635,1,0,0,386,1.5,0.30104503,0
2020-05-26-170635,170635,1,0,1,387,2.0,0.1806573,1
2020-05-27-170635,170635,4,0,3,391,1.6666666666666667,0.2220219,2
2020-05-28-170635,170635,1,1,2,392,2.0,0.29831803,3
2020-05-29-170635,170635,4,0,0,396,3.1666666666666665,0.27919427,4
2020-05-30-170635,170635,1,0,0,397,0.5,0.019172098,5
2020-05-31-170635,170635,0,0,0,397,0.0,0.004147172,6
2020-06-01-170635,170635,2,0,1,399,2.1666666666666665,0.449073,0
2020-06-02-170635,170635,1,0,2,400,0.8333333333333334,0.19287115,1
2020-06-03-170635,170635,0,0,0,400,2.5,0.10577444,2
2020-06-04-170635,170635,2,0,1,402,2.5,0.29857266,3
2020-06-05-170635,170635,2,0,1,404,1.1666666666666667,0.67142624,4
2020-06-06-170635,170635,0,1,0,404,0.16666666666666666,0.03456132,5
2020-06-07-170635,170635,0,0,0,404,0.16666666666666666,0.032698996,6
2020-06-08-170635,170635,0,0,0,404,1.5,0.14904349,0
2020-06-09-170635,170635,1,0,2,405,2.5,0.13585202,1
2020-06-10-170635,170635,3,0,0,408,1.5,0.098770924,2
2020-06-11-170635,170635,2,0,0,410,2.5,0.1671865,3
2020-06-12-170635,170635,0,0,2,410,0.16666666666666666,0.06516749,4
2020-06-13-170635,170635,0,0,0,410,0.3333333333333333,0.0064610834,5
2020-06-14-170635,170635,0,0,0,410,0.0,0.004531692,6
2020-06-15-170635,170635,1,0,0,411,2.5,0.06034688,0
2020-06-16-170635,170635,2,0,0,413,1.5,0.22668402,1
2020-06-17-170635,170635,0,0,1,413,2.1666666666666665,0.17463708,2
2020-06-18-170635,170635,1,0,0,414,2.1666666666666665,0.1947952,3
2020-06-19-170635,170635,1,1,0,415,1.8333333333333333,0.32863227,4
2020-06-20-170635,170635,0,0,0,415,0.0,0.0014367271,5
2020-06-21-170635,170635,0,0,0,415,0.0,0.0075697014,6
2020-06-22-170635,170635,0,0,0,415,2.1666666666666665,0.16233282,0
2020-06-23-170635,170635,2,0,3,417,1.6666666666666667,0.2705361,1
2020-06-24-170635,170635,0,0,0,417,1.3333333333333333,0.08536405,2
2020-06-25-170635,170635,0,2,0,417,1.1666666666666667,0.10786418,3
2020-06-26-170635,170635,2,0,0,419,2.0,0.18576476,4
2020-06-27-170635,170635,0,0,0,419,0.0,0.037831243,5
2020-06-28-170635,170635,0,0,1,419,0.0,0.021590285,6
2020-06-29-170635,170635,0,0,2,419,1.5,0.14353062,0
2020-06-30-170635,170635,0,0,0,419,1.1666666666666667,0.12564163,1
2020-07-01-170635,170635,1,0,1,420,1.8333333333333333,0.080012076,2
2020-07-02-170635,170635,0,0,2,420,1.0,0.050773144,3
2020-07-03-170635,170635,0,0,0,420,1.1666666666666667,0.13517787,4
2020-07-04-170635,170635,0,0,0,420,0.0,0.005722318,5
2020-07-05-170635,170635,0,0,0,420,0.0,0.02176962,6
2020-07-06-170635,170635,0,0,0,420,0.6666666666666666,0.058213163,0
2020-07-07-170635,170635,3,0,0,423,0.16666666666666666,0.05988125,1
2020-07-08-170635,170635,0,0,0,423,0.5,0.011012309,2
2020-07-09-170635,170635,0,2,1,423,1.0,0.079593584,3
2020-07-10-170635,170635,0,0,1,423,1.1666666666666667,0.05471535,4
2020-07-11-170635,170635,0,0,0,423,0.16666666666666666,0.01277216,5
2020-07-12-170635,170635,1,0,3,424,0.0,0.041830488,6
2020-07-13-170635,170635,2,0,0,426,0.5,0.08883913,0
2020-07-14-170635,170635,0,0,0,426,0.6666666666666666,0.109069064,1
2020-07-15-170635,170635,1,0,1,427,0.3333333333333333,0.013197192,2
2020-07-16-170635,170635,2,0,0,429,0.8333333333333334,0.06289725,3
2020-07-17-170635,170635,0,0,3,429,0.6666666666666666,0.039147083,4
2020-07-18-170635,170635,0,0,0,429,0.0,0.021879036,5
2020-07-19-170635,170635,0,0,0,429,0.0,0.0032594795,6
2020-07-20-170635,170635,0,0,3,429,0.8333333333333334,0.052054342,0
2020-07-21-170635,170635,0,0,0,429,3.5,0.036700945,1
2020-07-22-170635,170635,0,0,1,429,0.6666666666666666,0.1579736,2
2020-07-23-170635,170635,1,0,3,430,1.1666666666666667,0.02282073,3
2020-07-24-170635,170635,1,0,7,431,0.16666666666666666,0.02261258,4
2020-07-25-170635,170635,0,0,2,431,0.0,0.013135102,5
2020-07-26-170635,170635,3,0,1,434,0.0,0.011531712,6
2020-07-27-170635,170635,0,0,2,434,0.6666666666666666,0.067685924,0
2020-07-28-170635,170635,0,0,3,434,1.0,0.12115758,1
2020-07-29-170635,170635,1,0,6,435,0.8333333333333334,0.07374838,2
2020-07-30-170635,170635,0,0,6,435,1.1666666666666667,0.20745564,3
2020-07-31-170635,170635,3,0,3,438,2.833333333333333,0.21248779,4
2020-08-01-170635,170635,0,0,2,438,0.3333333333333333,0.23622765,5
2020-08-02-170635,170635,0,0,1,438,0.6666666666666666,0.16805439,6
2020-08-03-170635,170635,3,0,5,441,2.5,0.35391396,0
2020-08-04-170635,170635,0,0,4,441,2.6666666666666665,0.34642428,1
2020-08-05-170635,170635,1,1,5,442,4.0,0.50361687,2
2020-08-06-170635,170635,3,0,5,445,2.833333333333333,0.4038697,3
2020-08-07-170635,170635,7,0,9,452,4.5,0.59197795,4
2020-08-08-170635,170635,2,0,0,454,1.0,0.28114393,5
2020-08-09-170635,170635,1,0,1,455,0.3333333333333333,0.06396289,6
2020-08-10-170635,170635,2,0,4,457,3.6666666666666665,0.37664577,0
2020-08-11-170635,170635,3,0,6,460,2.6666666666666665,0.4501353,1
2020-08-12-170635,170635,6,1,7,466,3.1666666666666665,0.6768049,2
2020-08-13-170635,170635,6,0,11,472,2.6666666666666665,0.7090394,3
2020-08-14-170635,170635,3,0,13,475,4.666666666666667,0.54114425,4
2020-08-15-170635,170635,2,0,2,477,1.5,0.14898087,5
2020-08-16-170635,170635,1,0,2,478,1.5,0.20984146,6
2020-08-17-170635,170635,5,0,8,483,8.666666666666666,0.4854614,0
2020-08-18-170635,170635,4,0,8,487,3.0,0.75084424,1
2020-08-19-170635,170635,5,0,3,492,6.333333333333332,0.5585804,2
2020-08-20-170635,170635,5,0,7,497,7.833333333333332,0.92325675,3
2020-08-21-170635,170635,9,0,6,506,3.6666666666666665,0.7731808,4
2020-08-22-170635,170635,0,0,3,506,0.8333333333333334,0.18926021,5
2020-08-23-170635,170635,1,0,2,507,0.6666666666666666,0.27679443,6
2020-08-24-170635,170635,4,0,11,511,8.833333333333334,1.0234132,0
2020-08-25-170635,170635,6,0,1,517,5.166666666666667,0.7493239,1
2020-08-26-170635,170635,7,0,5,524,10.166666666666666,0.89178526,2
2020-08-27-170635,170635,11,1,4,535,4.5,0.80951077,3
2020-08-28-170635,170635,13,0,5,548,7.333333333333332,0.81048757,4
2020-08-29-170635,170635,2,0,2,550,2.333333333333333,0.46701083,5
2020-08-30-170635,170635,2,0,1,552,1.8333333333333333,0.16203782,6
2020-08-31-170635,170635,8,0,9,560,10.166666666666666,1.1217806,0
2020-09-01-170635,170635,8,0,3,568,4.0,1.1145527,1
2020-09-02-170635,170635,3,0,2,571,3.8333333333333335,0.95374215,2
2020-09-03-170635,170635,7,0,3,578,5.166666666666667,1.2679441,3
2020-09-04-170635,170635,6,1,3,584,9.5,1.3345683,4
2020-09-05-170635,170635,3,0,0,587,3.333333333333333,0.73626065,5
2020-09-06-170635,170635,2,0,1,589,2.5,0.42881364,6
2020-09-07-170635,170635,11,0,6,600,6.333333333333332,1.4341526,0
2020-09-08-170635,170635,1,0,4,601,2.0,0.46679592,1
2020-09-09-170635,170635,5,0,8,606,5.0,0.7214496,2
2020-09-10-170635,170635,4,0,4,610,4.5,0.856251,3
2020-09-11-170635,170635,5,0,4,615,10.333333333333334,1.5888962,4
2020-09-12-170635,170635,2,0,1,617,1.6666666666666667,0.53120947,5
2020-09-13-170635,170635,1,0,0,618,1.6666666666666667,0.28529125,6
2020-09-14-170635,170635,9,0,4,627,9.5,1.5927669,0
2020-09-15-170635,170635,3,0,4,630,4.5,0.9142919,1
2020-09-16-170635,170635,2,0,4,632,5.5,0.94859153,2
2020-09-17-170635,170635,3,0,5,635,4.333333333333333,0.7634667,3
2020-09-18-170635,170635,3,0,1,638,8.166666666666666,1.7489119,4
2020-09-19-170635,170635,0,0,1,638,2.1666666666666665,0.6218546,5
2020-09-20-170635,170635,1,1,1,639,2.6666666666666665,0.5059383,6
2020-09-21-170635,170635,6,0,3,645,6.833333333333332,1.4602828,0
2020-09-22-170635,170635,4,0,5,649,8.166666666666666,1.2477255,1
2020-09-23-170635,170635,8,0,4,657,4.5,1.3720816,2
2020-09-24-170635,170635,4,0,8,661,8.333333333333334,1.3371258,3
2020-09-25-170635,170635,4,0,11,665,4.666666666666667,1.4323121,4
2020-09-26-170635,170635,1,0,4,666,0.8333333333333334,0.8528557,5
2020-09-27-170635,170635,0,0,4,666,1.6666666666666667,0.37376395,6
2020-09-28-170635,170635,4,0,5,670,3.0,1.2225548,0
2020-09-29-170635,170635,4,0,16,674,5.166666666666667,0.98766255,1
2020-09-30-170635,170635,4,0,13,678,5.0,0.90221477,2
2020-10-01-170635,170635,5,0,11,683,4.5,0.79423946,3
2020-10-02-170635,170635,1,0,31,684,4.5,0.97431463,4
2020-10-03-170635,170635,1,0,1,685,1.5,0.5003667,5
2020-10-04-170635,170635,1,0,11,686,3.0,0.37008607,6
2020-10-05-170635,170635,3,1,19,689,8.5,3.1311893,0
2020-10-06-170635,170635,5,3,25,694,10.833333333333336,1.3634622,1
2020-10-07-170635,170635,4,0,34,698,9.333333333333334,1.8608956,2
2020-10-08-170635,170635,8,0,28,706,8.166666666666666,1.4813262,3
2020-10-09-170635,170635,11,1,31,717,11.5,1.328263,4
2020-10-10-170635,170635,4,0,8,721,3.1666666666666665,0.4999389,5
2020-10-11-170635,170635,4,0,4,725,3.1666666666666665,0.7268871,6
2020-10-12-170635,170635,5,0,34,730,3.6666666666666665,0.5281711,0
2020-10-13-170635,170635,16,0,24,746,12.5,1.4528013,1
2020-10-14-170635,170635,13,0,30,759,11.5,1.4584974,2
2020-10-15-170635,170635,11,0,17,770,10.833333333333336,2.0958664,3
2020-10-16-170635,170635,31,0,27,801,13.0,2.7662034,4
2020-10-17-170635,170635,1,0,16,802,3.333333333333333,0.3634399,5
2020-10-18-170635,170635,11,0,7,813,6.0,0.32606485,6
2020-10-19-170635,170635,19,1,2,832,20.0,1.6404774,0
2020-10-20-170635,170635,25,0,21,857,17.5,1.4785637,1
2020-10-21-170635,170635,34,0,22,891,14.833333333333336,2.281169,2
2020-10-22-170635,170635,28,0,16,919,18.33333333333333,2.2733397,3
2020-10-23-170635,170635,31,1,17,950,20.166666666666668,2.056163,4
2020-10-24-170635,170635,8,0,3,958,2.5,0.49801165,5
2020-10-25-170635,170635,4,1,5,962,9.833333333333334,0.46032435,6
2020-10-26-170635,170635,34,1,21,996,17.166666666666668,1.7258544,0
2020-10-27-170635,170635,24,0,14,1020,18.0,1.7968553,1
2020-10-28-170635,170635,30,0,12,1050,12.0,1.9996415,2
2020-10-29-170635,170635,17,0,12,1067,11.0,1.8374051,3
2020-10-30-170635,170635,27,0,8,1094,18.0,1.924942,4
2020-10-31-170635,170635,16,0,0,1110,3.5,0.35195932,5
2020-11-01-170635,170635,7,1,0,1117,5.166666666666667,0.47431058,6
2020-11-02-170635,170635,2,0,0,1119,2.6666666666666665,0.45578268,0
2020-11-03-170635,170635,21,0,0,1140,17.333333333333332,2.019274,1
2020-11-04-170635,170635,22,0,0,1162,12.166666666666664,1.6535683,2
2020-11-05-170635,170635,16,0,0,1178,9.666666666666666,1.7354834,3
2020-11-06-170635,170635,17,0,0,1195,9.666666666666666,1.4417098,4
2020-11-07-170635,170635,3,0,0,1198,3.1666666666666665,0.3409137,5
2020-11-08-170635,170635,5,0,0,1203,3.6666666666666665,0.36723262,6
2020-11-09-170635,170635,21,2,0,1224,11.833333333333336,1.9713401,0
2020-11-10-170635,170635,14,1,0,1238,8.333333333333334,0.8798717,1
2020-11-11-170635,170635,12,1,0,1250,8.5,1.284506,2
2020-11-12-170635,170635,12,1,0,1262,9.0,1.0955683,3
2020-11-13-170635,170635,8,1,0,1270,7.166666666666668,0.9984207,4
2020-03-01-170636,170636,0,0,4,0,0.14285714285714285,0.0022369395,6
2020-03-02-170636,170636,0,0,12,0,0.2857142857142857,0.0049120374,0
2020-03-03-170636,170636,0,1,21,0,0.14285714285714285,0.013700994,1
2020-03-04-170636,170636,0,0,28,0,0.0,0.012649217,2
2020-03-05-170636,170636,0,0,18,0,0.14285714285714285,0.0018250261,3
2020-03-06-170636,170636,0,0,25,0,0.5714285714285714,0.0023671484,4
2020-03-07-170636,170636,0,0,9,0,0.0,0.0012431876,5
2020-03-08-170636,170636,0,0,11,0,0.0,0.008512476,6
2020-03-09-170636,170636,1,0,31,1,0.8571428571428571,0.014101428,0
2020-03-10-170636,170636,0,0,28,1,0.5714285714285714,0.036762115,1
2020-03-11-170636,170636,4,0,26,5,1.4285714285714286,0.032909732,2
2020-03-12-170636,170636,1,0,28,6,1.5714285714285714,0.011064717,3
2020-03-13-170636,170636,6,0,17,12,3.571428571428572,0.078586616,4
2020-03-14-170636,170636,1,0,11,13,3.2857142857142856,0.0645775,5
2020-03-15-170636,170636,4,0,7,17,9.285714285714286,0.13142225,6
2020-03-16-170636,170636,12,0,21,29,16.857142857142858,0.28508037,0
2020-03-17-170636,170636,21,1,12,50,17.428571428571427,0.33192277,1
2020-03-18-170636,170636,28,0,15,78,23.857142857142854,0.25706688,2
2020-03-19-170636,170636,18,0,6,96,20.142857142857142,0.34987047,3
2020-03-20-170636,170636,25,0,10,121,23.285714285714285,0.3514709,4
2020-03-21-170636,170636,9,0,3,130,11.142857142857142,0.0963868,5
2020-03-22-170636,170636,11,0,5,141,10.857142857142858,0.10142061,6
2020-03-23-170636,170636,31,0,11,172,32.142857142857146,0.65771145,0
2020-03-24-170636,170636,28,0,7,200,29.714285714285715,0.48734218,1
2020-03-25-170636,170636,26,0,7,226,31.142857142857146,0.54372954,2
2020-03-26-170636,170636,28,0,2,254,28.285714285714285,0.44213006,3
2020-03-27-170636,170636,17,0,4,271,26.57142857142857,0.47864288,4
2020-03-28-170636,170636,11,0,2,282,6.0,0.07227026,5
2020-03-29-170636,170636,7,0,3,289,7.428571428571429,0.08801429,6
2020-03-30-170636,170636,21,0,6,310,20.428571428571427,0.41893297,0
2020-03-31-170636,170636,12,0,6,322,16.857142857142858,0.27394974,1
2020-04-01-170636,170636,15,0,1,337,14.285714285714285,0.34629682,2
2020-04-02-170636,170636,6,0,4,343,9.857142857142858,0.15138888,3
2020-04-03-170636,170636,10,0,6,353,11.0,0.23217286,4
2020-04-04-170636,170636,3,0,1,356,5.0,0.047129728,5
2020-04-05-170636,170636,5,0,0,361,4.0,0.045830056,6
2020-04-06-170636,170636,11,0,5,372,18.571428571428573,0.31688255,0
2020-04-07-170636,170636,7,0,4,379,7.857142857142858,0.3014662,1
2020-04-08-170636,170636,7,0,4,386,11.0,0.20255433,2
2020-04-09-170636,170636,2,0,0,388,5.285714285714286,0.06642491,3
2020-04-10-170636,170636,4,0,5,392,8.285714285714286,0.08115325,4
2020-04-11-170636,170636,2,0,2,394,3.0,0.054536015,5
2020-04-12-170636,170636,3,0,0,397,3.8571428571428568,0.08128788,6
2020-04-13-170636,170636,6,0,4,403,10.285714285714286,0.22891027,0
2020-04-14-170636,170636,6,0,2,409,8.714285714285714,0.3503374,1
2020-04-15-170636,170636,1,0,6,410,5.142857142857143,0.18036725,2
2020-04-16-170636,170636,4,0,4,414,7.428571428571429,0.11223198,3
2020-04-17-170636,170636,6,0,2,420,8.0,0.17677595,4
2020-04-18-170636,170636,1,0,4,421,3.2857142857142856,0.10551653,5
2020-04-19-170636,170636,0,0,2,421,2.142857142857143,0.021443428,6
2020-04-20-170636,170636,5,1,3,426,10.857142857142858,0.15135026,0
2020-04-21-170636,170636,4,0,10,430,6.857142857142858,0.2999762,1
2020-04-22-170636,170636,4,0,2,434,5.857142857142858,0.26955125,2
2020-04-23-170636,170636,0,0,2,434,1.8571428571428568,0.04219454,3
2020-04-24-170636,170636,5,0,4,439,4.285714285714286,0.13243409,4
2020-04-25-170636,170636,2,0,0,441,2.0,0.059216145,5
2020-04-26-170636,170636,0,0,1,441,1.1428571428571428,0.047456525,6
2020-04-27-170636,170636,4,0,10,445,8.285714285714286,0.189484,0
2020-04-28-170636,170636,2,0,14,447,3.8571428571428568,0.104387455,1
2020-04-29-170636,170636,6,0,4,453,5.7142857142857135,0.15569645,2
2020-04-30-170636,170636,4,0,4,457,4.142857142857143,0.11103078,3
2020-05-01-170636,170636,2,0,11,459,1.4285714285714286,0.08093059,4
2020-05-02-170636,170636,4,0,1,463,3.0,0.03603742,5
2020-05-03-170636,170636,2,0,0,465,0.7142857142857143,0.015669584,6
2020-05-04-170636,170636,3,0,1,468,6.142857142857142,0.2756654,0
2020-05-05-170636,170636,10,0,0,478,5.857142857142858,0.12028231,1
2020-05-06-170636,170636,2,0,2,480,6.571428571428571,0.2443472,2
2020-05-07-170636,170636,2,0,0,482,5.0,0.24835023,3
2020-05-08-170636,170636,4,0,2,486,8.0,0.17416006,4
2020-05-09-170636,170636,0,1,0,486,1.1428571428571428,0.03377384,5
2020-05-10-170636,170636,1,0,0,487,0.2857142857142857,0.005653388,6
2020-05-11-170636,170636,10,0,2,497,6.571428571428571,0.21506917,0
2020-05-12-170636,170636,14,2,2,511,15.428571428571427,0.25544977,1
2020-05-13-170636,170636,4,0,1,515,5.142857142857143,0.16591914,2
2020-05-14-170636,170636,4,0,0,519,4.285714285714286,0.07129642,3
2020-05-15-170636,170636,11,0,0,530,4.857142857142857,0.14709933,4
2020-05-16-170636,170636,1,0,3,531,0.8571428571428571,0.0062052133,5
2020-05-17-170636,170636,0,0,0,531,0.14285714285714285,0.0016887268,6
2020-05-18-170636,170636,1,0,2,532,3.7142857142857135,0.11268349,0
2020-05-19-170636,170636,0,0,1,532,3.0,0.102661915,1
2020-05-20-170636,170636,2,0,5,534,4.0,0.079571396,2
2020-05-21-170636,170636,0,0,3,534,4.571428571428571,0.06266402,3
2020-05-22-170636,170636,2,0,0,536,4.571428571428571,0.07927711,4
2020-05-23-170636,170636,0,0,0,536,0.14285714285714285,0.010049361,5
2020-05-24-170636,170636,0,0,1,536,0.14285714285714285,0.0042407415,6
2020-05-25-170636,170636,2,0,1,538,3.0,0.11732335,0
2020-05-26-170636,170636,2,0,4,540,2.8571428571428568,0.05534813,1
2020-05-27-170636,170636,1,0,0,541,3.4285714285714284,0.071284294,2
2020-05-28-170636,170636,0,0,1,541,2.0,0.0897539,3
2020-05-29-170636,170636,0,0,0,541,3.2857142857142856,0.09474506,4
2020-05-30-170636,170636,3,0,1,544,0.2857142857142857,0.008440957,5
2020-05-31-170636,170636,0,0,0,544,0.0,0.00195495,6
2020-06-01-170636,170636,2,0,3,546,4.428571428571429,0.1385009,0
2020-06-02-170636,170636,1,0,2,547,3.1428571428571432,0.046589278,1
2020-06-03-170636,170636,5,0,4,552,3.0,0.03735993,2
2020-06-04-170636,170636,3,0,1,555,4.0,0.09060408,3
2020-06-05-170636,170636,0,0,2,555,2.4285714285714284,0.16210221,4
2020-06-06-170636,170636,0,0,0,555,0.14285714285714285,0.008524075,5
2020-06-07-170636,170636,1,0,0,556,0.0,0.009433382,6
2020-06-08-170636,170636,1,0,1,557,1.8571428571428568,0.045442477,0
2020-06-09-170636,170636,4,0,0,561,2.142857142857143,0.04291319,1
2020-06-10-170636,170636,0,0,2,561,2.571428571428572,0.027691856,2
2020-06-11-170636,170636,1,0,1,562,1.5714285714285714,0.05507607,3
2020-06-12-170636,170636,0,0,3,562,0.2857142857142857,0.025371883,4
2020-06-13-170636,170636,1,0,0,563,0.14285714285714285,0.0016870782,5
2020-06-14-170636,170636,0,1,0,563,0.0,0.0018913075,6
2020-06-15-170636,170636,3,0,0,566,2.142857142857143,0.0164018,0
2020-06-16-170636,170636,2,0,1,568,1.0,0.06727756,1
2020-06-17-170636,170636,4,0,1,572,1.2857142857142858,0.043668207,2
2020-06-18-170636,170636,1,0,2,573,2.0,0.050983425,3
2020-06-19-170636,170636,2,0,1,575,2.2857142857142856,0.092425905,4
2020-06-20-170636,170636,0,0,0,575,0.0,0.00013124882,5
2020-06-21-170636,170636,0,0,0,575,0.0,0.0027981307,6
2020-06-22-170636,170636,1,0,0,576,2.571428571428572,0.054135006,0
2020-06-23-170636,170636,0,0,0,576,1.4285714285714286,0.068300635,1
2020-06-24-170636,170636,2,0,1,578,0.7142857142857143,0.023165675,2
2020-06-25-170636,170636,1,1,2,579,0.5714285714285714,0.027399106,3
2020-06-26-170636,170636,3,0,1,582,1.8571428571428568,0.06487578,4
2020-06-27-170636,170636,0,0,0,582,0.0,0.010415249,5
2020-06-28-170636,170636,0,0,0,582,0.0,0.008637614,6
2020-06-29-170636,170636,0,0,0,582,1.1428571428571428,0.036968466,0
2020-06-30-170636,170636,1,0,0,583,0.5714285714285714,0.035272826,1
2020-07-01-170636,170636,1,0,0,584,1.0,0.02202317,2
2020-07-02-170636,170636,2,0,0,586,0.14285714285714285,0.010822585,3
2020-07-03-170636,170636,1,0,1,587,1.1428571428571428,0.04312249,4
2020-07-04-170636,170636,0,0,0,587,0.0,0.0018563352,5
2020-07-05-170636,170636,0,0,0,587,0.0,0.006971278,6
2020-07-06-170636,170636,0,0,2,587,0.5714285714285714,0.0135513935,0
2020-07-07-170636,170636,0,0,0,587,0.8571428571428571,0.013823412,1
2020-07-08-170636,170636,1,0,2,588,0.14285714285714285,0.0024384346,2
2020-07-09-170636,170636,2,0,0,590,0.42857142857142855,0.020836083,3
2020-07-10-170636,170636,1,0,0,591,1.0,0.012624841,4
2020-07-11-170636,170636,0,0,0,591,0.14285714285714285,0.0018533715,5
2020-07-12-170636,170636,0,0,0,591,0.14285714285714285,0.01139852,6
2020-07-13-170636,170636,0,0,1,591,0.7142857142857143,0.022032391,0
2020-07-14-170636,170636,0,0,1,591,0.2857142857142857,0.027631149,1
2020-07-15-170636,170636,0,0,0,591,1.0,0.003980439,2
2020-07-16-170636,170636,0,0,2,591,1.0,0.014663511,3
2020-07-17-170636,170636,1,0,1,592,0.14285714285714285,0.009284102,4
2020-07-18-170636,170636,0,0,0,592,0.0,0.004891387,5
2020-07-19-170636,170636,0,0,1,592,0.0,0.00025167523,6
2020-07-20-170636,170636,2,0,7,594,0.8571428571428571,0.018147007,0
2020-07-21-170636,170636,0,0,2,594,1.0,0.008960919,1
2020-07-22-170636,170636,2,0,3,596,0.5714285714285714,0.04451961,2
2020-07-23-170636,170636,0,0,3,596,1.1428571428571428,0.0041929744,3
2020-07-24-170636,170636,0,0,4,596,1.5714285714285714,0.0049740253,4
2020-07-25-170636,170636,0,0,1,596,0.0,0.0031064341,5
2020-07-26-170636,170636,0,0,1,596,0.42857142857142855,0.003554796,6
2020-07-27-170636,170636,1,0,6,597,0.8571428571428571,0.021439362,0
2020-07-28-170636,170636,1,0,7,598,1.1428571428571428,0.03137533,1
2020-07-29-170636,170636,0,0,2,598,1.1428571428571428,0.016492337,2
2020-07-30-170636,170636,2,0,0,600,0.8571428571428571,0.05858825,3
2020-07-31-170636,170636,1,0,3,601,3.4285714285714284,0.048217874,4
2020-08-01-170636,170636,0,0,0,601,0.5714285714285714,0.05184693,5
2020-08-02-170636,170636,1,0,1,602,1.0,0.04789944,6
2020-08-03-170636,170636,7,0,6,609,1.8571428571428568,0.1099639,0
2020-08-04-170636,170636,2,0,3,611,1.2857142857142858,0.083735034,1
2020-08-05-170636,170636,3,0,4,614,4.571428571428571,0.14410016,2
2020-08-06-170636,170636,3,0,3,617,3.0,0.09826498,3
2020-08-07-170636,170636,4,0,3,621,5.571428571428571,0.14928326,4
2020-08-08-170636,170636,1,0,2,622,1.1428571428571428,0.06497742,5
2020-08-09-170636,170636,1,0,0,623,1.1428571428571428,0.015223885,6
2020-08-10-170636,170636,6,0,6,629,2.8571428571428568,0.0938335,0
2020-08-11-170636,170636,7,0,5,636,3.571428571428572,0.1015703,1
2020-08-12-170636,170636,2,0,7,638,4.0,0.16764037,2
2020-08-13-170636,170636,0,0,7,638,6.571428571428571,0.17210154,3
2020-08-14-170636,170636,3,0,4,641,4.142857142857143,0.120616436,4
2020-08-15-170636,170636,0,0,0,641,3.0,0.03200826,5
2020-08-16-170636,170636,1,0,2,642,1.5714285714285714,0.063944764,6
2020-08-17-170636,170636,6,0,4,648,6.7142857142857135,0.12767603,0
2020-08-18-170636,170636,3,0,4,651,3.1428571428571432,0.1818206,1
2020-08-19-170636,170636,4,0,2,655,6.0,0.12025485,2
2020-08-20-170636,170636,3,0,5,658,6.7142857142857135,0.24243511,3
2020-08-21-170636,170636,3,0,9,661,6.142857142857142,0.15957972,4
2020-08-22-170636,170636,2,0,5,663,0.5714285714285714,0.042572293,5
2020-08-23-170636,170636,0,0,8,663,1.2857142857142858,0.09389355,6
2020-08-24-170636,170636,6,0,11,669,6.857142857142858,0.29518598,0
2020-08-25-170636,170636,5,0,2,674,8.428571428571429,0.18324496,1
2020-08-26-170636,170636,7,0,5,681,8.0,0.24506691,2
2020-08-27-170636,170636,7,0,3,688,6.0,0.22113007,3
2020-08-28-170636,170636,4,0,14,692,13.142857142857142,0.22164096,4
2020-08-29-170636,170636,0,0,0,692,3.0,0.09343844,5
2020-08-30-170636,170636,2,0,4,694,2.0,0.048650943,6
2020-08-31-170636,170636,4,0,6,698,11.857142857142858,0.3257682,0
2020-09-01-170636,170636,4,0,6,702,6.428571428571429,0.29584375,1
2020-09-02-170636,170636,2,0,8,704,4.714285714285714,0.22349113,2
2020-09-03-170636,170636,5,0,3,709,5.7142857142857135,0.3445313,3
2020-09-04-170636,170636,9,0,8,718,10.857142857142858,0.37134495,4
2020-09-05-170636,170636,5,0,2,723,3.0,0.16199869,5
2020-09-06-170636,170636,8,0,5,731,2.571428571428572,0.11488165,6
2020-09-07-170636,170636,11,0,4,742,8.428571428571429,0.37823555,0
2020-09-08-170636,170636,2,0,3,744,4.0,0.11747689,1
2020-09-09-170636,170636,5,0,4,749,4.571428571428571,0.19227663,2
2020-09-10-170636,170636,3,0,7,752,6.428571428571429,0.20769645,3
2020-09-11-170636,170636,14,0,3,766,12.857142857142858,0.41853034,4
2020-09-12-170636,170636,0,0,0,766,3.2857142857142856,0.12521243,5
2020-09-13-170636,170636,4,0,1,770,3.4285714285714284,0.07502748,6
2020-09-14-170636,170636,6,0,3,776,12.142857142857142,0.44842586,0
2020-09-15-170636,170636,6,0,3,782,7.857142857142858,0.24158932,1
2020-09-16-170636,170636,8,0,3,790,6.428571428571429,0.25992578,2
2020-09-17-170636,170636,3,0,2,793,5.857142857142858,0.21015127,3
2020-09-18-170636,170636,8,0,2,801,8.285714285714286,0.46349183,4
2020-09-19-170636,170636,2,0,3,803,2.2857142857142856,0.16321486,5
2020-09-20-170636,170636,5,0,0,808,3.1428571428571432,0.14440553,6
2020-09-21-170636,170636,4,0,6,812,11.428571428571427,0.42663828,0
2020-09-22-170636,170636,3,0,13,815,9.142857142857142,0.37401503,1
2020-09-23-170636,170636,4,1,8,819,6.7142857142857135,0.40406576,2
2020-09-24-170636,170636,7,0,8,826,8.857142857142858,0.35580862,3
2020-09-25-170636,170636,3,0,12,829,6.857142857142858,0.3492636,4
2020-09-26-170636,170636,0,0,2,829,2.0,0.18488868,5
2020-09-27-170636,170636,1,0,1,830,2.4285714285714284,0.095098004,6
2020-09-28-170636,170636,3,1,4,833,5.142857142857143,0.34033188,0
2020-09-29-170636,170636,3,0,11,836,7.7142857142857135,0.24780512,1
2020-09-30-170636,170636,3,0,13,839,6.0,0.26324663,2
2020-10-01-170636,170636,2,0,5,841,5.428571428571429,0.1988885,3
2020-10-02-170636,170636,2,0,7,843,5.7142857142857135,0.2660131,4
2020-10-03-170636,170636,3,0,7,846,2.142857142857143,0.12856404,5
2020-10-04-170636,170636,0,0,1,846,3.571428571428572,0.10014508,6
2020-10-05-170636,170636,6,0,9,852,8.857142857142858,0.97298396,0
2020-10-06-170636,170636,13,0,15,865,9.428571428571429,0.35123348,1
2020-10-07-170636,170636,8,0,15,873,8.571428571428571,0.55906254,2
2020-10-08-170636,170636,8,1,21,881,7.7142857142857135,0.39493802,3
2020-10-09-170636,170636,12,1,12,893,11.142857142857142,0.33609948,4
2020-10-10-170636,170636,2,0,3,895,5.571428571428571,0.110321425,5
2020-10-11-170636,170636,1,0,9,896,5.285714285714286,0.17167254,6
2020-10-12-170636,170636,4,0,29,900,4.428571428571429,0.13431478,0
2020-10-13-170636,170636,11,0,9,911,14.285714285714285,0.381113,1
2020-10-14-170636,170636,13,0,9,924,11.0,0.37218302,2
2020-10-15-170636,170636,5,0,11,929,11.571428571428573,0.57432526,3
2020-10-16-170636,170636,7,0,22,936,19.142857142857142,0.74560344,4
2020-10-17-170636,170636,7,0,3,943,3.7142857142857135,0.0889913,5
2020-10-18-170636,170636,1,0,11,944,8.142857142857142,0.09280822,6
2020-10-19-170636,170636,9,0,6,953,20.571428571428573,0.4728251,0
2020-10-20-170636,170636,15,0,24,968,19.0,0.43283117,1
2020-10-21-170636,170636,15,1,8,983,19.142857142857142,0.62381953,2
2020-10-22-170636,170636,21,1,5,1004,20.285714285714285,0.65815055,3
2020-10-23-170636,170636,12,1,10,1016,25.57142857142857,0.5976497,4
2020-10-24-170636,170636,3,1,4,1019,3.8571428571428568,0.1393504,5
2020-10-25-170636,170636,9,1,5,1028,10.285714285714286,0.15415028,6
2020-10-26-170636,170636,29,0,7,1057,20.142857142857142,0.50518596,0
2020-10-27-170636,170636,9,0,6,1066,20.142857142857142,0.5727871,1
2020-10-28-170636,170636,9,1,3,1075,17.428571428571427,0.59443486,2
2020-10-29-170636,170636,11,1,6,1086,14.0,0.535535,3
2020-10-30-170636,170636,22,1,2,1108,20.0,0.539829,4
2020-10-31-170636,170636,3,1,0,1111,4.571428571428571,0.1114004,5
2020-11-01-170636,170636,11,3,0,1122,4.142857142857143,0.14433548,6
2020-11-02-170636,170636,6,0,0,1128,2.4285714285714284,0.12558576,0
2020-11-03-170636,170636,24,0,0,1152,17.571428571428573,0.59412336,1
2020-11-04-170636,170636,8,0,0,1160,16.714285714285715,0.45533922,2
2020-11-05-170636,170636,5,0,0,1165,12.142857142857142,0.48984796,3
2020-11-06-170636,170636,10,1,0,1175,13.285714285714285,0.39343134,4
2020-11-07-170636,170636,4,0,0,1179,3.1428571428571432,0.09624293,5
2020-11-08-170636,170636,5,0,0,1184,4.0,0.11225137,6
2020-11-09-170636,170636,7,0,0,1191,15.428571428571427,0.51909983,0
2020-11-10-170636,170636,6,0,0,1197,10.285714285714286,0.25639394,1
2020-11-11-170636,170636,3,2,0,1200,10.428571428571429,0.3681124,2
2020-11-12-170636,170636,6,0,0,1206,8.142857142857142,0.29915857,3
2020-11-13-170636,170636,2,2,0,1208,8.285714285714286,0.2766948,4
2020-03-01-170637,170637,0,0,9,0,0.0,0.0038894014,6
2020-03-02-170637,170637,1,0,6,1,0.2,0.013929633,0
2020-03-03-170637,170637,0,2,15,1,0.2,0.028810324,1
2020-03-04-170637,170637,0,0,10,1,0.0,0.028016798,2
2020-03-05-170637,170637,0,0,6,1,0.2,0.006127801,3
2020-03-06-170637,170637,2,0,11,3,0.2,0.006798948,4
2020-03-07-170637,170637,0,0,3,3,0.0,0.0024510105,5
2020-03-08-170637,170637,0,0,8,3,0.2,0.013670583,6
2020-03-09-170637,170637,1,0,19,4,0.2,0.02973612,0
2020-03-10-170637,170637,1,0,17,5,0.2,0.0759936,1
2020-03-11-170637,170637,2,0,48,7,2.6,0.068901874,2
2020-03-12-170637,170637,0,0,11,7,1.6,0.031491462,3
2020-03-13-170637,170637,3,0,28,10,3.8,0.15388905,4
2020-03-14-170637,170637,3,0,6,13,2.8,0.121893115,5
2020-03-15-170637,170637,9,0,6,22,9.4,0.23689146,6
2020-03-16-170637,170637,6,0,5,28,15.4,0.5427153,0
2020-03-17-170637,170637,15,0,7,43,19.6,0.6525652,1
2020-03-18-170637,170637,10,0,10,53,19.0,0.5140793,2
2020-03-19-170637,170637,6,0,5,59,22.2,0.71439284,3
2020-03-20-170637,170637,11,0,5,70,28.0,0.70078075,4
2020-03-21-170637,170637,3,0,3,73,9.8,0.1650267,5
2020-03-22-170637,170637,8,0,3,81,11.0,0.16334789,6
2020-03-23-170637,170637,19,0,8,100,36.8,1.279632,0
2020-03-24-170637,170637,17,0,6,117,33.2,0.9013126,1
2020-03-25-170637,170637,48,0,7,165,29.2,1.0493711,2
2020-03-26-170637,170637,11,1,4,176,32.6,0.90752864,3
2020-03-27-170637,170637,28,0,6,204,28.4,0.9321103,4
2020-03-28-170637,170637,6,0,1,210,9.6,0.11001433,5
2020-03-29-170637,170637,6,0,3,216,9.8,0.15194829,6
2020-03-30-170637,170637,5,0,6,221,23.2,0.8304864,0
2020-03-31-170637,170637,7,0,6,228,18.2,0.54235494,1
2020-04-01-170637,170637,10,0,4,238,20.8,0.6163642,2
2020-04-02-170637,170637,5,0,5,243,10.6,0.30595455,3
2020-04-03-170637,170637,5,0,5,248,17.6,0.41570324,4
2020-04-04-170637,170637,3,0,4,251,5.2,0.08306312,5
2020-04-05-170637,170637,3,0,1,254,4.2,0.06175308,6
2020-04-06-170637,170637,8,0,2,262,19.2,0.5772133,0
2020-04-07-170637,170637,6,1,6,268,16.6,0.5271811,1
2020-04-08-170637,170637,7,0,5,275,11.4,0.36471128,2
2020-04-09-170637,170637,4,1,0,279,5.8,0.12521288,3
2020-04-10-170637,170637,6,0,8,285,8.4,0.14200789,4
2020-04-11-170637,170637,1,0,4,286,2.8,0.08406361,5
2020-04-12-170637,170637,3,0,0,289,7.0,0.12409429,6
2020-04-13-170637,170637,6,0,5,295,10.6,0.40491143,0
2020-04-14-170637,170637,6,0,5,301,14.6,0.66187143,1
2020-04-15-170637,170637,4,0,10,305,6.2,0.35264948,2
2020-04-16-170637,170637,5,0,1,310,7.4,0.22677463,3
2020-04-17-170637,170637,5,0,3,315,10.2,0.33186772,4
2020-04-18-170637,170637,4,0,0,319,4.2,0.20477483,5
2020-04-19-170637,170637,1,0,1,320,0.8,0.037801463,6
2020-04-20-170637,170637,2,1,2,322,13.6,0.29874447,0
2020-04-21-170637,170637,6,0,3,328,11.8,0.58757436,1
2020-04-22-170637,170637,5,0,10,333,8.4,0.5214089,2
2020-04-23-170637,170637,0,0,1,333,1.8,0.08420584,3
2020-04-24-170637,170637,8,0,1,341,5.2,0.25763413,4
2020-04-25-170637,170637,4,0,2,345,2.2,0.1119356,5
2020-04-26-170637,170637,0,0,0,345,1.0,0.08532816,6
2020-04-27-170637,170637,5,0,6,350,7.4,0.37341812,0
2020-04-28-170637,170637,5,0,4,355,3.6,0.20993547,1
2020-04-29-170637,170637,10,0,3,365,5.2,0.30347258,2
2020-04-30-170637,170637,1,0,3,366,6.0,0.21590811,3
2020-05-01-170637,170637,3,0,3,369,3.6,0.1501229,4
2020-05-02-170637,170637,0,0,0,369,4.0,0.06763543,5
2020-05-03-170637,170637,1,0,0,370,0.8,0.024133839,6
2020-05-04-170637,170637,2,0,2,372,7.0,0.59412026,0
2020-05-05-170637,170637,3,0,2,375,5.6,0.24769986,1
2020-05-06-170637,170637,10,0,1,385,4.6,0.6376285,2
2020-05-07-170637,170637,1,0,6,386,4.8,0.5385746,3
2020-05-08-170637,170637,1,0,1,387,8.4,0.33449838,4
2020-05-09-170637,170637,2,0,0,389,1.6,0.05491974,5
2020-05-10-170637,170637,0,0,0,389,0.8,0.010373004,6
2020-05-11-170637,170637,6,0,1,395,9.2,0.417204,0
2020-05-12-170637,170637,4,0,2,399,13.6,0.46965843,1
2020-05-13-170637,170637,3,0,0,402,7.2,0.31499386,2
2020-05-14-170637,170637,3,0,3,405,4.0,0.14295082,3
2020-05-15-170637,170637,3,0,2,408,8.4,0.2583523,4
2020-05-16-170637,170637,0,0,0,408,0.8,0.010104921,5
2020-05-17-170637,170637,0,0,0,408,0.0,0.004683109,6
2020-05-18-170637,170637,2,0,3,410,3.4,0.23022965,0
2020-05-19-170637,170637,2,0,5,412,2.0,0.20307866,1
2020-05-20-170637,170637,1,0,3,413,4.6,0.16409329,2
2020-05-21-170637,170637,6,0,0,419,3.0,0.1286867,3
2020-05-22-170637,170637,1,0,2,420,4.6,0.1486583,4
2020-05-23-170637,170637,0,0,0,420,0.0,0.019342694,5
2020-05-24-170637,170637,0,0,0,420,0.0,0.01079618,6
2020-05-25-170637,170637,1,0,2,421,4.8,0.21488981,0
2020-05-26-170637,170637,2,0,0,423,3.4,0.114250444,1
2020-05-27-170637,170637,0,0,2,423,3.0,0.14538899,2
2020-05-28-170637,170637,3,0,1,426,1.2,0.17244928,3
2020-05-29-170637,170637,2,1,0,428,2.8,0.18627489,4
2020-05-30-170637,170637,0,0,0,428,1.0,0.013846548,5
2020-05-31-170637,170637,0,0,0,428,0.2,0.0021659688,6
2020-06-01-170637,170637,3,0,1,431,4.0,0.28045523,0
2020-06-02-170637,170637,5,0,0,436,2.4,0.11116803,1
2020-06-03-170637,170637,3,0,2,439,2.6,0.08242526,2
2020-06-04-170637,170637,0,0,2,439,3.4,0.18064454,3
2020-06-05-170637,170637,2,0,1,441,2.0,0.34816882,4
2020-06-06-170637,170637,0,0,0,441,0.0,0.017835163,5
2020-06-07-170637,170637,0,0,0,441,0.2,0.022573464,6
2020-06-08-170637,170637,2,0,0,443,2.2,0.095283546,0
2020-06-09-170637,170637,0,0,1,443,2.8,0.081974216,1
2020-06-10-170637,170637,2,0,0,445,1.4,0.057589922,2
2020-06-11-170637,170637,1,0,1,446,3.0,0.10700656,3
2020-06-12-170637,170637,0,0,2,446,0.4,0.052234415,4
2020-06-13-170637,170637,0,0,0,446,0.2,0.004132413,5
2020-06-14-170637,170637,0,0,0,446,0.0,0.00439884,6
2020-06-15-170637,170637,1,0,0,447,1.4,0.033745583,0
2020-06-16-170637,170637,0,0,0,447,3.8,0.13283037,1
2020-06-17-170637,170637,2,0,1,449,2.6,0.09860677,2
2020-06-18-170637,170637,2,0,0,451,1.2,0.10884984,3
2020-06-19-170637,170637,1,0,2,452,2.6,0.17852624,4
2020-06-20-170637,170637,0,0,0,452,0.0,0.00052558543,5
2020-06-21-170637,170637,0,0,0,452,0.0,0.0036548784,6
2020-06-22-170637,170637,0,0,0,452,2.8,0.11160427,0
2020-06-23-170637,170637,1,0,0,453,1.4,0.14661127,1
2020-06-24-170637,170637,0,1,0,453,0.8,0.049836874,2
2020-06-25-170637,170637,1,1,0,454,0.6,0.055743672,3
2020-06-26-170637,170637,2,0,0,456,2.8,0.109211974,4
2020-06-27-170637,170637,0,0,0,456,0.2,0.01841552,5
2020-06-28-170637,170637,0,0,0,456,0.0,0.01953331,6
2020-06-29-170637,170637,0,0,0,456,2.0,0.0818263,0
2020-06-30-170637,170637,0,0,0,456,0.2,0.07140354,1
2020-07-01-170637,170637,1,0,0,457,1.2,0.04494606,2
2020-07-02-170637,170637,0,0,1,457,0.4,0.024876062,3
2020-07-03-170637,170637,2,0,0,459,1.4,0.081856556,4
2020-07-04-170637,170637,0,0,0,459,0.0,0.0031942478,5
2020-07-05-170637,170637,0,0,0,459,0.0,0.017188162,6
2020-07-06-170637,170637,0,0,1,459,0.0,0.031778198,0
2020-07-07-170637,170637,0,0,2,459,0.8,0.021389356,1
2020-07-08-170637,170637,0,0,0,459,0.2,0.005460297,2
2020-07-09-170637,170637,0,0,2,459,0.8,0.039762713,3
2020-07-10-170637,170637,0,0,2,459,0.4,0.026882814,4
2020-07-11-170637,170637,0,0,0,459,0.0,0.0042240443,5
2020-07-12-170637,170637,0,0,0,459,0.0,0.03031962,6
2020-07-13-170637,170637,0,0,0,459,0.4,0.05437552,0
2020-07-14-170637,170637,0,0,0,459,0.4,0.06019652,1
2020-07-15-170637,170637,0,0,2,459,0.6,0.0061691874,2
2020-07-16-170637,170637,1,0,1,460,0.8,0.032257732,3
2020-07-17-170637,170637,0,0,2,460,0.4,0.017803125,4
2020-07-18-170637,170637,0,0,0,460,0.0,0.011806091,5
2020-07-19-170637,170637,0,0,3,460,0.0,0.0008575034,6
2020-07-20-170637,170637,1,0,2,461,1.8,0.031868715,0
2020-07-21-170637,170637,2,1,0,463,0.8,0.021087022,1
2020-07-22-170637,170637,0,0,0,463,1.6,0.08872375,2
2020-07-23-170637,170637,2,0,1,465,0.8,0.010348968,3
2020-07-24-170637,170637,2,0,3,467,1.2,0.010854597,4
2020-07-25-170637,170637,0,0,0,467,0.2,0.004935434,5
2020-07-26-170637,170637,0,0,0,467,0.0,0.006308921,6
2020-07-27-170637,170637,0,0,3,467,1.4,0.038488317,0
2020-07-28-170637,170637,0,0,5,467,1.2,0.072431855,1
2020-07-29-170637,170637,2,0,4,469,0.6,0.03501872,2
2020-07-30-170637,170637,1,0,3,470,1.4,0.12440566,3
2020-07-31-170637,170637,2,0,2,472,3.4,0.09809958,4
2020-08-01-170637,170637,0,0,1,472,1.0,0.11534859,5
2020-08-02-170637,170637,3,0,2,475,0.8,0.09517048,6
2020-08-03-170637,170637,2,0,0,477,3.6,0.2241037,0
2020-08-04-170637,170637,0,0,2,477,1.8,0.17878532,1
2020-08-05-170637,170637,0,0,3,477,4.8,0.28214857,2
2020-08-06-170637,170637,1,0,6,478,3.4,0.19329552,3
2020-08-07-170637,170637,3,0,2,481,3.4,0.3301204,4
2020-08-08-170637,170637,0,0,0,481,2.0,0.13629209,5
2020-08-09-170637,170637,0,0,0,481,1.4,0.040995188,6
2020-08-10-170637,170637,3,0,4,484,5.2,0.2293249,0
2020-08-11-170637,170637,5,0,9,489,3.2,0.24169563,1
2020-08-12-170637,170637,4,0,3,493,4.2,0.37682155,2
2020-08-13-170637,170637,3,0,3,496,3.8,0.34639454,3
2020-08-14-170637,170637,2,0,5,498,4.0,0.27143595,4
2020-08-15-170637,170637,1,0,4,499,2.8,0.0723483,5
2020-08-16-170637,170637,2,0,4,501,1.6,0.13484679,6
2020-08-17-170637,170637,0,0,6,501,5.8,0.2821135,0
2020-08-18-170637,170637,2,0,2,503,4.0,0.386843,1
2020-08-19-170637,170637,3,0,2,506,5.6,0.26993376,2
2020-08-20-170637,170637,6,0,1,512,6.2,0.51235414,3
2020-08-21-170637,170637,2,0,4,514,2.4,0.3577431,4
2020-08-22-170637,170637,0,0,2,514,1.6,0.08502388,5
2020-08-23-170637,170637,0,0,3,514,3.2,0.17119738,6
2020-08-24-170637,170637,4,0,2,518,8.4,0.5936849,0
2020-08-25-170637,170637,9,0,3,527,7.6,0.39810446,1
2020-08-26-170637,170637,3,0,1,530,9.0,0.54887944,2
2020-08-27-170637,170637,3,0,3,533,7.2,0.44266728,3
2020-08-28-170637,170637,5,1,4,538,9.4,0.48193544,4
2020-08-29-170637,170637,4,0,1,542,1.8,0.19529404,5
2020-08-30-170637,170637,4,0,1,546,2.6,0.094351605,6
2020-08-31-170637,170637,6,0,6,552,7.0,0.68436056,0
2020-09-01-170637,170637,2,0,12,554,4.4,0.62459874,1
2020-09-02-170637,170637,2,0,12,556,2.6,0.47019047,2
2020-09-03-170637,170637,1,0,9,557,7.0,0.72243184,3
2020-09-04-170637,170637,4,0,10,561,12.4,0.76992345,4
2020-09-05-170637,170637,2,0,4,563,3.0,0.34006327,5
2020-09-06-170637,170637,3,0,3,566,2.0,0.2473238,6
2020-09-07-170637,170637,2,0,16,568,7.4,0.77368325,0
2020-09-08-170637,170637,3,0,9,571,4.2,0.27589023,1
2020-09-09-170637,170637,1,0,14,572,6.4,0.36455223,2
2020-09-10-170637,170637,3,0,4,575,5.6,0.44812936,3
2020-09-11-170637,170637,4,0,8,579,13.2,0.84399873,4
2020-09-12-170637,170637,1,0,1,580,2.4,0.25039005,5
2020-09-13-170637,170637,1,0,0,581,3.0,0.15562744,6
2020-09-14-170637,170637,6,0,0,587,13.2,0.91912246,0
2020-09-15-170637,170637,12,0,8,599,7.4,0.50825584,1
2020-09-16-170637,170637,12,0,4,611,6.8,0.55855733,2
2020-09-17-170637,170637,9,0,6,620,7.8,0.49207008,3
2020-09-18-170637,170637,10,0,2,630,14.4,1.0306579,4
2020-09-19-170637,170637,4,0,10,634,3.4,0.31188402,5
2020-09-20-170637,170637,3,0,3,637,3.8,0.303539,6
2020-09-21-170637,170637,16,1,3,653,12.4,0.9096647,0
2020-09-22-170637,170637,9,0,2,662,16.6,0.77878636,1
2020-09-23-170637,170637,14,0,8,676,12.0,0.85436195,2
2020-09-24-170637,170637,4,0,3,680,12.6,0.7743864,3
2020-09-25-170637,170637,8,0,6,688,10.8,0.7719013,4
2020-09-26-170637,170637,1,0,4,689,3.2,0.36023527,5
2020-09-27-170637,170637,0,0,4,689,3.2,0.20117286,6
2020-09-28-170637,170637,0,0,2,689,7.6,0.6966658,0
2020-09-29-170637,170637,8,0,9,697,5.4,0.5717378,1
2020-09-30-170637,170637,4,0,4,701,7.8,0.5822995,2
2020-10-01-170637,170637,6,0,4,707,6.8,0.46257037,3
2020-10-02-170637,170637,2,0,10,709,8.6,0.5673477,4
2020-10-03-170637,170637,10,0,1,719,1.8,0.2606917,5
2020-10-04-170637,170637,3,0,0,722,3.2,0.20406328,6
2020-10-05-170637,170637,3,1,7,725,19.8,1.9093379,0
2020-10-06-170637,170637,2,0,10,727,9.2,0.7256409,1
2020-10-07-170637,170637,8,0,11,735,12.2,1.215933,2
2020-10-08-170637,170637,3,0,12,738,11.0,0.8015767,3
2020-10-09-170637,170637,6,0,16,744,12.6,0.72227913,4
2020-10-10-170637,170637,4,0,1,748,5.8,0.21423998,5
2020-10-11-170637,170637,4,0,1,752,5.4,0.3099591,6
2020-10-12-170637,170637,2,0,15,754,4.4,0.2836649,0
2020-10-13-170637,170637,9,0,5,763,13.2,0.8385495,1
2020-10-14-170637,170637,4,0,11,767,11.6,0.85844326,2
2020-10-15-170637,170637,4,0,10,771,11.6,1.1284492,3
2020-10-16-170637,170637,10,0,10,781,15.6,1.5987008,4
2020-10-17-170637,170637,1,0,1,782,5.6,0.17635399,5
2020-10-18-170637,170637,0,0,1,782,12.0,0.1769762,6
2020-10-19-170637,170637,7,0,0,789,18.6,1.0122933,0
2020-10-20-170637,170637,10,0,10,799,20.0,0.95581615,1
2020-10-21-170637,170637,11,1,9,810,19.4,1.2361008,2
2020-10-22-170637,170637,12,0,8,822,20.8,1.4243035,3
2020-10-23-170637,170637,16,0,6,838,24.0,1.1839797,4
2020-10-24-170637,170637,1,0,0,839,5.2,0.27803108,5
2020-10-25-170637,170637,1,0,0,840,13.0,0.33003777,6
2020-10-26-170637,170637,15,0,2,855,21.8,1.1208348,0
2020-10-27-170637,170637,5,0,3,860,21.0,1.1688371,1
2020-10-28-170637,170637,11,1,1,871,13.8,1.2353903,2
2020-10-29-170637,170637,10,1,2,881,13.4,1.1806377,3
2020-10-30-170637,170637,10,0,3,891,23.2,1.1278877,4
2020-10-31-170637,170637,1,1,0,892,3.6,0.20993955,5
2020-11-01-170637,170637,1,0,0,893,6.2,0.27256697,6
2020-11-02-170637,170637,0,0,0,893,3.8,0.28677046,0
2020-11-03-170637,170637,10,0,0,903,18.8,1.2693309,1
2020-11-04-170637,170637,9,0,0,912,16.4,1.0230297,2
2020-11-05-170637,170637,8,0,0,920,8.6,1.0176779,3
2020-11-06-170637,170637,6,1,0,926,11.8,0.91496813,4
2020-11-07-170637,170637,0,0,0,926,4.2,0.2071179,5
2020-11-08-170637,170637,0,0,0,926,4.8,0.25519404,6
2020-11-09-170637,170637,2,0,0,928,16.4,1.1416173,0
2020-11-10-170637,170637,3,0,0,931,8.0,0.58417004,1
2020-11-11-170637,170637,1,0,0,932,12.2,0.78441817,2
2020-11-12-170637,170637,2,0,0,934,9.0,0.6684823,3
2020-11-13-170637,170637,3,1,0,937,6.4,0.5937701,4
2020-03-01-170701,170701,0,0,1,0,0.0,0.00028166696,6
2020-03-02-170701,170701,0,1,3,0,0.0,0.0014960706,0
2020-03-03-170701,170701,1,0,4,1,0.0,0.06773446,1
2020-03-04-170701,170701,0,0,8,1,0.0,6.7846566e-05,2
2020-03-05-170701,170701,0,0,12,1,0.0,0.006063719,3
2020-03-06-170701,170701,0,0,10,1,0.16666666666666666,0.06295801,4
2020-03-07-170701,170701,1,0,5,2,0.16666666666666666,0.12363089,5
2020-03-08-170701,170701,0,1,14,2,0.0,1.10859455e-05,6
2020-03-09-170701,170701,0,0,22,2,0.16666666666666666,0.06443937,0
2020-03-10-170701,170701,0,0,22,2,0.0,0.05922325,1
2020-03-11-170701,170701,0,0,11,2,0.3333333333333333,0.069404505,2
2020-03-12-170701,170701,0,0,9,2,0.8333333333333334,0.2832985,3
2020-03-13-170701,170701,0,0,18,2,0.8333333333333334,0.4264197,4
2020-03-14-170701,170701,1,0,5,3,1.1666666666666667,0.29094285,5
2020-03-15-170701,170701,1,0,0,4,1.1666666666666667,0.23241538,6
2020-03-16-170701,170701,3,0,11,7,6.166666666666668,1.6682894,0
2020-03-17-170701,170701,4,0,8,11,5.333333333333333,1.599251,1
2020-03-18-170701,170701,8,0,19,19,10.666666666666666,4.0045667,2
2020-03-19-170701,170701,12,0,6,31,13.0,4.8834376,3
2020-03-20-170701,170701,10,0,7,41,7.5,2.7240214,4
2020-03-21-170701,170701,5,0,0,46,5.0,1.4658953,5
2020-03-22-170701,170701,14,0,4,60,8.5,2.1674764,6
2020-03-23-170701,170701,22,0,3,82,12.5,4.7277203,0
2020-03-24-170701,170701,22,0,1,104,9.833333333333334,4.3639946,1
2020-03-25-170701,170701,11,0,9,115,12.166666666666664,3.6580195,2
2020-03-26-170701,170701,9,2,4,124,10.666666666666666,3.3842432,3
2020-03-27-170701,170701,18,0,2,142,13.666666666666664,3.237204,4
2020-03-28-170701,170701,5,0,1,147,5.833333333333332,1.5386738,5
2020-03-29-170701,170701,0,0,0,147,4.5,0.7599239,6
2020-03-30-170701,170701,11,0,3,158,11.833333333333336,2.8080642,0
2020-03-31-170701,170701,8,0,3,166,8.0,2.2245598,1
2020-04-01-170701,170701,19,0,3,185,8.333333333333334,3.1565862,2
2020-04-02-170701,170701,6,0,2,191,12.166666666666664,2.9858718,3
2020-04-03-170701,170701,7,0,4,198,5.666666666666668,1.5125955,4
2020-04-04-170701,170701,0,0,14,198,7.666666666666668,1.160186,5
2020-04-05-170701,170701,4,0,2,202,3.6666666666666665,0.856039,6
2020-04-06-170701,170701,3,0,3,205,8.833333333333334,2.281097,0
2020-04-07-170701,170701,1,1,7,206,7.5,1.6037014,1
2020-04-08-170701,170701,9,0,1,215,3.5,1.5151551,2
2020-04-09-170701,170701,4,0,3,219,4.333333333333333,0.77767825,3
2020-04-10-170701,170701,2,0,3,221,2.833333333333333,0.5937137,4
2020-04-11-170701,170701,1,0,2,222,1.5,0.24675226,5
2020-04-12-170701,170701,0,0,1,222,2.6666666666666665,0.35970235,6
2020-04-13-170701,170701,3,0,2,225,9.666666666666666,3.567205,0
2020-04-14-170701,170701,3,0,4,228,5.0,1.2777398,1
2020-04-15-170701,170701,3,0,3,231,5.833333333333332,1.7229478,2
2020-04-16-170701,170701,2,0,3,233,2.6666666666666665,0.89520645,3
2020-04-17-170701,170701,4,0,1,237,1.8333333333333333,1.133978,4
2020-04-18-170701,170701,14,0,0,251,7.833333333333332,2.3937337,5
2020-04-19-170701,170701,2,0,0,253,4.666666666666667,0.79305756,6
2020-04-20-170701,170701,3,1,0,256,2.833333333333333,1.031906,0
2020-04-21-170701,170701,7,0,0,263,6.833333333333332,1.5081807,1
2020-04-22-170701,170701,1,0,0,264,6.166666666666668,1.6319025,2
2020-04-23-170701,170701,3,0,2,267,1.8333333333333333,0.7075334,3
2020-04-24-170701,170701,3,0,3,270,4.5,1.3992784,4
2020-04-25-170701,170701,2,0,0,272,1.0,0.23499769,5
2020-04-26-170701,170701,1,0,1,273,1.0,0.4946885,6
2020-04-27-170701,170701,2,0,2,275,9.666666666666666,2.6914275,0
2020-04-28-170701,170701,4,0,5,279,3.8333333333333335,0.97495764,1
2020-04-29-170701,170701,3,0,1,282,4.333333333333333,1.1824025,2
2020-04-30-170701,170701,3,0,5,285,5.0,0.87646586,3
2020-05-01-170701,170701,1,0,5,286,1.1666666666666667,0.27160898,4
2020-05-02-170701,170701,0,0,0,286,0.16666666666666666,0.031267647,5
2020-05-03-170701,170701,0,0,0,286,0.16666666666666666,0.048153948,6
2020-05-04-170701,170701,0,0,6,286,1.6666666666666667,0.37846196,0
2020-05-05-170701,170701,0,0,4,286,3.0,0.7141745,1
2020-05-06-170701,170701,0,0,4,286,1.6666666666666667,0.48143783,2
2020-05-07-170701,170701,2,0,2,288,3.6666666666666665,0.98253155,3
2020-05-08-170701,170701,3,0,2,291,3.0,1.0767471,4
2020-05-09-170701,170701,0,0,3,291,2.0,0.44689614,5
2020-05-10-170701,170701,1,0,3,292,0.8333333333333334,0.24199033,6
2020-05-11-170701,170701,2,1,5,294,3.8333333333333335,1.0000867,0
2020-05-12-170701,170701,5,0,3,299,3.0,1.009306,1
2020-05-13-170701,170701,1,0,5,300,3.1666666666666665,1.3455429,2
2020-05-14-170701,170701,5,0,1,305,3.6666666666666665,1.6054097,3
2020-05-15-170701,170701,5,0,1,310,4.5,1.2640041,4
2020-05-16-170701,170701,0,0,0,310,1.8333333333333333,0.5362678,5
2020-05-17-170701,170701,0,0,0,310,2.0,0.40436015,6
2020-05-18-170701,170701,6,0,1,316,4.0,1.2320333,0
2020-05-19-170701,170701,4,0,2,320,4.0,1.5232782,1
2020-05-20-170701,170701,4,0,1,324,4.166666666666667,1.5141778,2
2020-05-21-170701,170701,2,0,0,326,3.1666666666666665,1.1866786,3
2020-05-22-170701,170701,2,0,1,328,5.0,1.5060514,4
2020-05-23-170701,170701,3,0,0,331,1.1666666666666667,0.587896,5
2020-05-24-170701,170701,3,0,1,334,1.6666666666666667,0.6288151,6
2020-05-25-170701,170701,5,0,3,339,4.333333333333333,1.7199668,0
2020-05-26-170701,170701,3,0,0,342,3.5,1.5921448,1
2020-05-27-170701,170701,5,2,0,347,5.166666666666667,2.334008,2
2020-05-28-170701,170701,1,0,0,348,2.0,0.7375624,3
2020-05-29-170701,170701,1,0,2,349,1.5,0.58646125,4
2020-05-30-170701,170701,0,0,0,349,0.0,0.0014488427,5
2020-05-31-170701,170701,0,1,0,349,0.16666666666666666,0.0009638908,6
2020-06-01-170701,170701,1,0,0,350,1.3333333333333333,0.40216404,0
2020-06-02-170701,170701,2,1,0,352,1.6666666666666667,0.528404,1
2020-06-03-170701,170701,1,0,0,353,1.6666666666666667,0.50707084,2
2020-06-04-170701,170701,0,0,1,353,1.5,0.62218696,3
2020-06-05-170701,170701,1,0,2,354,1.0,0.23116736,4
2020-06-06-170701,170701,0,0,0,354,0.3333333333333333,0.22235252,5
2020-06-07-170701,170701,1,0,0,355,0.6666666666666666,0.16728948,6
2020-06-08-170701,170701,3,0,0,358,1.8333333333333333,0.6642619,0
2020-06-09-170701,170701,0,0,0,358,1.5,0.46106067,1
2020-06-10-170701,170701,0,0,0,358,0.8333333333333334,0.19910659,2
2020-06-11-170701,170701,0,0,0,358,0.8333333333333334,0.47135377,3
2020-06-12-170701,170701,2,0,0,360,1.3333333333333333,0.54789424,4
2020-06-13-170701,170701,0,0,1,360,0.5,0.06425164,5
2020-06-14-170701,170701,0,0,0,360,0.3333333333333333,0.13610727,6
2020-06-15-170701,170701,0,3,1,360,1.1666666666666667,0.41252333,0
2020-06-16-170701,170701,0,0,2,360,1.8333333333333333,0.6522126,1
2020-06-17-170701,170701,0,0,0,360,1.5,0.65970063,2
2020-06-18-170701,170701,1,0,0,361,2.0,0.53078914,3
2020-06-19-170701,170701,2,0,0,363,2.833333333333333,1.3404187,4
2020-06-20-170701,170701,0,0,1,363,0.3333333333333333,0.10972385,5
2020-06-21-170701,170701,0,0,0,363,0.16666666666666666,0.047089495,6
2020-06-22-170701,170701,0,0,3,363,1.0,0.23705512,0
2020-06-23-170701,170701,0,0,1,363,1.8333333333333333,0.9740166,1
2020-06-24-170701,170701,0,0,0,363,0.5,0.39940932,2
2020-06-25-170701,170701,0,0,0,363,1.5,0.45734996,3
2020-06-26-170701,170701,0,0,0,363,1.1666666666666667,0.7384491,4
2020-06-27-170701,170701,1,0,0,364,0.16666666666666666,0.18679501,5
2020-06-28-170701,170701,0,0,0,364,0.3333333333333333,0.12672412,6
2020-06-29-170701,170701,1,0,0,365,0.3333333333333333,0.46697932,0
2020-06-30-170701,170701,2,0,0,367,0.5,0.81035066,1
2020-07-01-170701,170701,0,0,1,367,0.5,0.34496835,2
2020-07-02-170701,170701,0,0,1,367,0.8333333333333334,0.26887205,3
2020-07-03-170701,170701,0,0,1,367,1.3333333333333333,1.1915973,4
2020-07-04-170701,170701,1,0,2,368,0.16666666666666666,0.18626021,5
2020-07-05-170701,170701,0,0,0,368,0.0,5.8204187e-06,6
2020-07-06-170701,170701,3,0,1,371,0.5,0.370907,0
2020-07-07-170701,170701,1,0,0,372,0.3333333333333333,0.10704456,1
2020-07-08-170701,170701,0,1,2,372,0.8333333333333334,0.426391,2
2020-07-09-170701,170701,0,0,2,372,1.1666666666666667,0.35319683,3
2020-07-10-170701,170701,0,1,0,372,1.1666666666666667,0.9746185,4
2020-07-11-170701,170701,0,0,1,372,0.5,0.11976209,5
2020-07-12-170701,170701,0,0,0,372,0.3333333333333333,0.29036224,6
2020-07-13-170701,170701,0,0,0,372,0.5,0.21571182,0
2020-07-14-170701,170701,0,0,2,372,0.6666666666666666,0.4307118,1
2020-07-15-170701,170701,1,0,2,373,2.0,0.8231098,2
2020-07-16-170701,170701,1,0,9,374,2.333333333333333,0.67599064,3
2020-07-17-170701,170701,1,1,1,375,1.0,0.5546954,4
2020-07-18-170701,170701,2,0,2,377,0.3333333333333333,0.43107396,5
2020-07-19-170701,170701,0,0,0,377,0.3333333333333333,0.09152862,6
2020-07-20-170701,170701,1,0,2,378,1.1666666666666667,0.53237927,0
2020-07-21-170701,170701,0,0,0,378,0.6666666666666666,0.2274989,1
2020-07-22-170701,170701,2,0,1,380,2.1666666666666665,1.1162983,2
2020-07-23-170701,170701,2,0,0,382,0.8333333333333334,0.4012204,3
2020-07-24-170701,170701,0,0,4,382,1.8333333333333333,1.215114,4
2020-07-25-170701,170701,1,0,6,383,0.3333333333333333,0.14606704,5
2020-07-26-170701,170701,0,0,4,383,0.0,0.0036884912,6
2020-07-27-170701,170701,0,0,3,383,0.8333333333333334,0.24436948,0
2020-07-28-170701,170701,2,0,8,385,1.3333333333333333,0.6443219,1
2020-07-29-170701,170701,2,0,2,387,1.1666666666666667,0.7189279,2
2020-07-30-170701,170701,9,0,6,396,1.5,1.4850154,3
2020-07-31-170701,170701,1,0,22,397,1.1666666666666667,0.84501785,4
2020-08-01-170701,170701,2,0,5,399,0.6666666666666666,0.47867414,5
2020-08-02-170701,170701,0,0,3,399,0.6666666666666666,0.34540653,6
2020-08-03-170701,170701,2,0,21,401,0.3333333333333333,0.3776272,0
2020-08-04-170701,170701,0,0,30,401,0.5,0.10871233,1
2020-08-05-170701,170701,1,0,10,402,1.6666666666666667,0.91115844,2
2020-08-06-170701,170701,0,0,7,402,1.3333333333333333,0.7735433,3
2020-08-07-170701,170701,4,0,6,406,0.8333333333333334,0.76694643,4
2020-08-08-170701,170701,6,0,1,412,0.3333333333333333,1.1882179,5
2020-08-09-170701,170701,4,0,0,416,1.1666666666666667,0.8054402,6
2020-08-10-170701,170701,3,0,8,419,1.6666666666666667,1.9364803,0
2020-08-11-170701,170701,8,0,2,427,1.5,1.9415879,1
2020-08-12-170701,170701,2,0,1,429,3.0,2.5580962,2
2020-08-13-170701,170701,6,0,2,435,3.8333333333333335,3.9806402,3
2020-08-14-170701,170701,22,0,3,457,2.0,5.600282,4
2020-08-15-170701,170701,5,0,0,462,1.3333333333333333,1.9261032,5
2020-08-16-170701,170701,3,0,0,465,1.5,1.7414805,6
2020-08-17-170701,170701,21,0,2,486,3.6666666666666665,4.258016,0
2020-08-18-170701,170701,30,0,7,516,3.0,5.093557,1
2020-08-19-170701,170701,10,0,1,526,4.333333333333333,4.672404,2
2020-08-20-170701,170701,7,1,1,533,1.8333333333333333,1.5740072,3
2020-08-21-170701,170701,6,0,14,539,3.1666666666666665,2.2008615,4
2020-08-22-170701,170701,1,0,2,540,1.1666666666666667,1.3099593,5
2020-08-23-170701,170701,0,0,2,540,0.8333333333333334,0.23167686,6
2020-08-24-170701,170701,8,0,3,548,2.6666666666666665,3.597255,0
2020-08-25-170701,170701,2,0,6,550,3.0,1.6619424,1
2020-08-26-170701,170701,1,1,0,551,2.333333333333333,2.093836,2
2020-08-27-170701,170701,2,0,3,553,4.833333333333333,1.46278,3
2020-08-28-170701,170701,3,0,6,556,1.6666666666666667,0.75712043,4
2020-08-29-170701,170701,0,1,0,556,1.6666666666666667,1.5888349,5
2020-08-30-170701,170701,0,0,0,556,1.1666666666666667,1.5090894,6
2020-08-31-170701,170701,2,0,8,558,2.6666666666666665,1.1222986,0
2020-09-01-170701,170701,7,0,2,565,2.833333333333333,1.2653327,1
2020-09-02-170701,170701,1,0,8,566,1.5,0.44799727,2
2020-09-03-170701,170701,1,0,10,567,3.5,2.146619,3
2020-09-04-170701,170701,14,0,7,581,2.5,2.225721,4
2020-09-05-170701,170701,2,0,3,583,1.6666666666666667,0.7105201,5
2020-09-06-170701,170701,2,0,1,585,0.8333333333333334,0.683474,6
2020-09-07-170701,170701,3,0,16,588,2.6666666666666665,1.6281209,0
2020-09-08-170701,170701,6,0,5,594,4.0,2.1789167,1
2020-09-09-170701,170701,0,0,10,594,2.6666666666666665,1.1263775,2
2020-09-10-170701,170701,3,0,2,597,3.5,1.375816,3
2020-09-11-170701,170701,6,0,11,603,3.5,2.099176,4
2020-09-12-170701,170701,0,0,0,603,1.3333333333333333,1.1654382,5
2020-09-13-170701,170701,0,0,1,603,0.6666666666666666,0.7516763,6
2020-09-14-170701,170701,8,0,4,611,5.166666666666667,2.8056643,0
2020-09-15-170701,170701,2,0,3,613,1.8333333333333333,1.2741977,1
2020-09-16-170701,170701,8,0,4,621,3.1666666666666665,1.5476708,2
2020-09-17-170701,170701,10,0,1,631,3.0,1.7912197,3
2020-09-18-170701,170701,7,0,3,638,3.333333333333333,1.6486377,4
2020-09-19-170701,170701,3,0,0,641,1.3333333333333333,0.40158844,5
2020-09-20-170701,170701,1,0,3,642,2.6666666666666665,0.59372115,6
2020-09-21-170701,170701,16,0,2,658,4.333333333333333,1.2625915,0
2020-09-22-170701,170701,5,1,4,663,5.0,1.8015872,1
2020-09-23-170701,170701,10,2,0,673,4.166666666666667,1.6901733,2
2020-09-24-170701,170701,2,0,7,675,3.5,1.0690677,3
2020-09-25-170701,170701,11,1,5,686,6.0,2.924344,4
2020-09-26-170701,170701,0,0,2,686,1.5,1.1431819,5
2020-09-27-170701,170701,1,0,0,687,1.3333333333333333,0.6253523,6
2020-09-28-170701,170701,4,0,6,691,3.1666666666666665,1.5502968,0
2020-09-29-170701,170701,3,1,5,694,2.333333333333333,0.6247467,1
2020-09-30-170701,170701,4,0,0,698,2.1666666666666665,1.2615947,2
2020-10-01-170701,170701,1,0,1,699,2.0,1.1597636,3
2020-10-02-170701,170701,3,0,1,702,3.6666666666666665,1.5206914,4
2020-10-03-170701,170701,0,0,3,702,1.1666666666666667,0.79527414,5
2020-10-04-170701,170701,3,1,2,705,1.5,0.76250124,6
2020-10-05-170701,170701,2,0,3,707,2.6666666666666665,1.2537591,0
2020-10-06-170701,170701,4,0,1,711,3.333333333333333,1.7483964,1
2020-10-07-170701,170701,0,1,1,711,2.1666666666666665,0.97675216,2
2020-10-08-170701,170701,7,0,3,718,2.833333333333333,2.5963137,3
2020-10-09-170701,170701,5,0,2,723,3.1666666666666665,0.8948218,4
2020-10-10-170701,170701,2,0,0,725,1.6666666666666667,1.1393431,5
2020-10-11-170701,170701,0,0,2,725,2.1666666666666665,1.1530578,6
2020-10-12-170701,170701,6,0,4,731,1.1666666666666667,1.038466,0
2020-10-13-170701,170701,5,0,1,736,2.5,1.1570553,1
2020-10-14-170701,170701,0,0,5,736,3.1666666666666665,0.92244273,2
2020-10-15-170701,170701,1,0,8,737,3.6666666666666665,1.4400502,3
2020-10-16-170701,170701,1,0,3,738,5.166666666666667,1.8417231,4
2020-10-17-170701,170701,3,0,0,741,1.8333333333333333,1.6404945,5
2020-10-18-170701,170701,2,0,0,743,2.6666666666666665,0.95560765,6
2020-10-19-170701,170701,3,0,0,746,2.6666666666666665,1.2561134,0
2020-10-20-170701,170701,1,0,10,747,3.1666666666666665,1.0729333,1
2020-10-21-170701,170701,1,0,6,748,3.333333333333333,1.6131262,2
2020-10-22-170701,170701,3,0,7,751,6.0,2.9171593,3
2020-10-23-170701,170701,2,0,10,753,3.8333333333333335,1.3531368,4
2020-10-24-170701,170701,0,1,0,753,2.833333333333333,1.5143079,5
2020-10-25-170701,170701,2,0,2,755,2.5,0.81534773,6
2020-10-26-170701,170701,4,0,7,759,2.833333333333333,0.97668636,0
2020-10-27-170701,170701,1,0,7,760,3.6666666666666665,1.2001917,1
2020-10-28-170701,170701,5,0,1,765,4.0,1.9739126,2
2020-10-29-170701,170701,8,0,1,773,4.833333333333333,3.8810115,3
2020-10-30-170701,170701,3,0,3,776,6.666666666666668,1.2324952,4
2020-10-31-170701,170701,0,0,0,776,4.5,2.6637552,5
2020-11-01-170701,170701,0,0,0,776,1.1666666666666667,0.5823911,6
2020-11-02-170701,170701,0,0,0,776,2.833333333333333,1.0506786,0
2020-11-03-170701,170701,10,0,0,786,3.333333333333333,2.128948,1
2020-11-04-170701,170701,6,1,0,792,3.1666666666666665,1.6522573,2
2020-11-05-170701,170701,7,1,0,799,3.8333333333333335,1.574507,3
2020-11-06-170701,170701,10,0,0,809,4.833333333333333,1.9058908,4
2020-11-07-170701,170701,0,0,0,809,1.5,0.81007737,5
2020-11-08-170701,170701,2,0,0,811,1.0,0.7845426,6
2020-11-09-170701,170701,7,0,0,818,3.333333333333333,2.0671287,0
2020-11-10-170701,170701,7,0,0,825,2.0,1.2854283,1
2020-11-11-170701,170701,1,0,0,826,3.8333333333333335,2.032686,2
2020-11-12-170701,170701,1,0,0,827,2.333333333333333,0.4891572,3
2020-11-13-170701,170701,3,0,0,830,3.5,2.2077215,4
2020-03-01-170702,170702,0,0,3,0,0.0,0.0018802686,6
2020-03-02-170702,170702,0,0,14,0,0.0,0.00062238256,0
2020-03-03-170702,170702,0,0,5,0,0.16666666666666666,0.046935324,1
2020-03-04-170702,170702,0,0,14,0,0.0,0.0002291058,2
2020-03-05-170702,170702,0,1,29,0,0.16666666666666666,0.027428748,3
2020-03-06-170702,170702,0,0,13,0,0.16666666666666666,0.14013584,4
2020-03-07-170702,170702,0,0,14,0,0.3333333333333333,0.17771575,5
2020-03-08-170702,170702,0,0,16,0,0.0,7.7750636e-05,6
2020-03-09-170702,170702,0,0,16,0,0.16666666666666666,0.13447565,0
2020-03-10-170702,170702,0,0,11,0,0.0,0.1293948,1
2020-03-11-170702,170702,0,0,23,0,0.3333333333333333,0.13557082,2
2020-03-12-170702,170702,1,0,11,1,0.6666666666666666,0.6647121,3
2020-03-13-170702,170702,2,0,18,3,0.5,0.4421031,4
2020-03-14-170702,170702,4,0,16,7,0.6666666666666666,0.6161105,5
2020-03-15-170702,170702,3,0,7,10,1.0,0.5323449,6
2020-03-16-170702,170702,14,0,22,24,5.833333333333332,3.1931624,0
2020-03-17-170702,170702,5,1,16,29,8.166666666666666,2.9505115,1
2020-03-18-170702,170702,14,1,9,43,9.833333333333334,5.34318,2
2020-03-19-170702,170702,29,0,6,72,10.5,6.66063,3
2020-03-20-170702,170702,13,0,9,85,10.5,3.9310107,4
2020-03-21-170702,170702,14,0,11,99,4.0,1.9233972,5
2020-03-22-170702,170702,16,0,5,115,10.0,2.8120985,6
2020-03-23-170702,170702,16,0,5,131,19.33333333333333,7.0342684,0
2020-03-24-170702,170702,11,0,24,142,13.5,4.942986,1
2020-03-25-170702,170702,23,0,3,165,13.833333333333336,6.1301837,2
2020-03-26-170702,170702,11,0,17,176,13.5,5.131079,3
2020-03-27-170702,170702,18,0,0,194,18.666666666666668,5.673577,4
2020-03-28-170702,170702,16,0,3,210,5.166666666666667,1.7108138,5
2020-03-29-170702,170702,7,0,5,217,4.333333333333333,1.368738,6
2020-03-30-170702,170702,22,0,6,239,11.333333333333336,5.205913,0
2020-03-31-170702,170702,16,0,6,255,7.5,3.7774892,1
2020-04-01-170702,170702,9,0,5,264,12.5,4.4025846,2
2020-04-02-170702,170702,6,0,4,270,13.666666666666664,5.480413,3
2020-04-03-170702,170702,9,0,4,279,7.166666666666668,2.9673688,4
2020-04-04-170702,170702,11,0,3,290,6.333333333333332,2.3872168,5
2020-04-05-170702,170702,5,2,1,295,5.333333333333333,1.1464478,6
2020-04-06-170702,170702,5,0,5,300,10.5,3.967312,0
2020-04-07-170702,170702,24,0,19,324,4.833333333333333,4.264196,1
2020-04-08-170702,170702,3,0,1,327,6.166666666666668,2.2126389,2
2020-04-09-170702,170702,17,0,2,344,3.5,1.7456051,3
2020-04-10-170702,170702,0,0,4,344,4.0,0.84404343,4
2020-04-11-170702,170702,3,0,3,347,1.8333333333333333,0.6132248,5
2020-04-12-170702,170702,5,0,0,352,2.6666666666666665,0.9657558,6
2020-04-13-170702,170702,6,1,25,358,9.5,5.0951934,0
2020-04-14-170702,170702,6,0,9,364,5.5,2.7112677,1
2020-04-15-170702,170702,5,0,7,369,6.666666666666668,2.955083,2
2020-04-16-170702,170702,4,0,9,373,3.6666666666666665,1.4750584,3
2020-04-17-170702,170702,4,0,1,377,3.8333333333333335,1.5143243,4
2020-04-18-170702,170702,3,0,0,380,9.5,3.6159992,5
2020-04-19-170702,170702,1,0,1,381,5.0,1.6833967,6
2020-04-20-170702,170702,5,0,3,386,7.5,2.5474517,0
2020-04-21-170702,170702,19,0,4,405,5.5,2.8773346,1
2020-04-22-170702,170702,1,0,2,406,7.0,3.4545422,2
2020-04-23-170702,170702,2,0,7,408,2.0,1.1156561,3
2020-04-24-170702,170702,4,0,5,412,5.166666666666667,2.79019,4
2020-04-25-170702,170702,3,0,3,415,1.3333333333333333,0.71887314,5
2020-04-26-170702,170702,0,0,0,415,0.6666666666666666,0.26291716,6
2020-04-27-170702,170702,25,0,7,440,3.1666666666666665,4.94767,0
2020-04-28-170702,170702,9,0,3,449,4.666666666666667,2.4371367,1
2020-04-29-170702,170702,7,0,5,456,4.833333333333333,2.2433867,2
2020-04-30-170702,170702,9,0,7,465,4.5,1.1549613,3
2020-05-01-170702,170702,1,0,10,466,1.5,0.18766184,4
2020-05-02-170702,170702,0,0,2,466,1.1666666666666667,0.048749547,5
2020-05-03-170702,170702,1,0,3,467,1.1666666666666667,0.2049885,6
2020-05-04-170702,170702,3,0,7,470,3.0,0.39453593,0
2020-05-05-170702,170702,4,0,6,474,4.166666666666667,1.9262289,1
2020-05-06-170702,170702,2,0,9,476,2.833333333333333,1.2658613,2
2020-05-07-170702,170702,7,0,4,483,4.666666666666667,2.3385038,3
2020-05-08-170702,170702,5,0,12,488,3.8333333333333335,2.0359755,4
2020-05-09-170702,170702,3,0,1,491,1.5,0.7716924,5
2020-05-10-170702,170702,0,0,2,491,1.1666666666666667,0.31436664,6
2020-05-11-170702,170702,7,2,9,498,4.166666666666667,3.0015237,0
2020-05-12-170702,170702,3,3,3,501,4.333333333333333,2.0714757,1
2020-05-13-170702,170702,5,0,14,506,2.833333333333333,2.306934,2
2020-05-14-170702,170702,7,0,3,513,4.833333333333333,2.6553812,3
2020-05-15-170702,170702,10,0,3,523,4.166666666666667,3.1720736,4
2020-05-16-170702,170702,2,0,0,525,2.333333333333333,0.83645135,5
2020-05-17-170702,170702,3,0,0,528,2.0,0.8007642,6
2020-05-18-170702,170702,7,0,4,535,5.666666666666668,2.7115407,0
2020-05-19-170702,170702,6,0,3,541,5.0,1.9634538,1
2020-05-20-170702,170702,9,0,4,550,5.333333333333333,3.1259587,2
2020-05-21-170702,170702,4,0,6,554,5.166666666666667,2.2880752,3
2020-05-22-170702,170702,12,0,4,566,4.166666666666667,3.0821838,4
2020-05-23-170702,170702,1,0,0,567,2.5,0.5765358,5
2020-05-24-170702,170702,2,0,2,569,2.0,0.6351918,6
2020-05-25-170702,170702,9,0,4,578,5.666666666666668,3.0176675,0
2020-05-26-170702,170702,3,0,3,581,4.333333333333333,2.69709,1
2020-05-27-170702,170702,14,1,3,595,4.833333333333333,3.778465,2
2020-05-28-170702,170702,3,0,0,598,2.1666666666666665,1.3245459,3
2020-05-29-170702,170702,3,0,1,601,1.5,1.0618142,4
2020-05-30-170702,170702,0,0,3,601,0.16666666666666666,0.005384991,5
2020-05-31-170702,170702,0,0,1,601,0.16666666666666666,0.0020304795,6
2020-06-01-170702,170702,4,0,0,605,1.6666666666666667,0.8841833,0
2020-06-02-170702,170702,3,0,4,608,1.5,0.94869363,1
2020-06-03-170702,170702,4,0,2,612,1.5,1.1174146,2
2020-06-04-170702,170702,6,0,5,618,0.16666666666666666,0.79233426,3
2020-06-05-170702,170702,4,0,6,622,1.1666666666666667,0.61960673,4
2020-06-06-170702,170702,0,0,0,622,0.16666666666666666,0.118100904,5
2020-06-07-170702,170702,2,0,0,624,0.6666666666666666,0.30184135,6
2020-06-08-170702,170702,4,0,2,628,2.1666666666666665,1.1579517,0
2020-06-09-170702,170702,3,1,3,631,1.8333333333333333,1.0218138,1
2020-06-10-170702,170702,3,0,1,634,0.6666666666666666,0.52472126,2
2020-06-11-170702,170702,0,0,4,634,1.3333333333333333,0.50547326,3
2020-06-12-170702,170702,1,0,2,635,1.5,0.8656156,4
2020-06-13-170702,170702,3,0,0,638,0.0,0.24673402,5
2020-06-14-170702,170702,1,0,1,639,0.0,0.1424017,6
2020-06-15-170702,170702,0,0,1,639,1.0,0.81375885,0
2020-06-16-170702,170702,4,0,0,643,1.5,1.090492,1
2020-06-17-170702,170702,2,0,1,645,1.6666666666666667,1.0510787,2
2020-06-18-170702,170702,5,1,2,650,1.1666666666666667,0.98007125,3
2020-06-19-170702,170702,6,0,3,656,2.0,1.7273002,4
2020-06-20-170702,170702,0,0,0,656,0.3333333333333333,0.23457123,5
2020-06-21-170702,170702,0,0,0,656,0.5,0.10292849,6
2020-06-22-170702,170702,2,0,1,658,1.0,0.6670942,0
2020-06-23-170702,170702,3,0,1,661,0.8333333333333334,1.1408623,1
2020-06-24-170702,170702,1,0,4,662,1.0,0.3823947,2
2020-06-25-170702,170702,4,0,3,666,1.5,1.1268874,3
2020-06-26-170702,170702,2,0,1,668,1.0,1.1369612,4
2020-06-27-170702,170702,0,0,2,668,0.5,0.2582228,5
2020-06-28-170702,170702,1,0,0,669,0.0,0.07211743,6
2020-06-29-170702,170702,1,0,2,670,0.8333333333333334,0.28852063,0
2020-06-30-170702,170702,0,0,1,670,0.5,0.29283252,1
2020-07-01-170702,170702,1,0,3,671,0.3333333333333333,0.3153761,2
2020-07-02-170702,170702,2,0,8,673,0.8333333333333334,0.7188754,3
2020-07-03-170702,170702,3,0,1,676,1.1666666666666667,0.8300086,4
2020-07-04-170702,170702,0,0,0,676,0.5,0.17935574,5
2020-07-05-170702,170702,0,0,0,676,0.0,2.9250384e-06,6
2020-07-06-170702,170702,1,0,4,677,1.5,0.5584647,0
2020-07-07-170702,170702,1,0,1,678,0.6666666666666666,0.28155705,1
2020-07-08-170702,170702,4,0,5,682,0.6666666666666666,0.6381252,2
2020-07-09-170702,170702,3,0,0,685,1.1666666666666667,0.89181733,3
2020-07-10-170702,170702,1,0,3,686,0.5,0.72313106,4
2020-07-11-170702,170702,2,0,0,688,0.16666666666666666,0.4050981,5
2020-07-12-170702,170702,0,0,0,688,0.16666666666666666,0.14723703,6
2020-07-13-170702,170702,2,0,2,690,0.3333333333333333,0.53272355,0
2020-07-14-170702,170702,1,0,1,691,0.3333333333333333,0.3086681,1
2020-07-15-170702,170702,3,0,4,694,1.6666666666666667,1.2824957,2
2020-07-16-170702,170702,8,0,1,702,1.3333333333333333,1.6787349,3
2020-07-17-170702,170702,1,0,1,703,0.8333333333333334,0.8857995,4
2020-07-18-170702,170702,0,0,1,703,0.5,0.35408777,5
2020-07-19-170702,170702,0,0,0,703,0.5,0.18615341,6
2020-07-20-170702,170702,4,1,0,707,0.3333333333333333,0.7717911,0
2020-07-21-170702,170702,1,0,1,708,0.6666666666666666,0.52812225,1
2020-07-22-170702,170702,5,0,1,713,1.6666666666666667,1.8412583,2
2020-07-23-170702,170702,0,0,1,713,1.5,0.6129446,3
2020-07-24-170702,170702,3,0,1,716,1.0,1.140725,4
2020-07-25-170702,170702,0,0,0,716,0.8333333333333334,0.1617255,5
2020-07-26-170702,170702,0,0,0,716,0.16666666666666666,0.018240761,6
2020-07-27-170702,170702,2,0,2,718,0.8333333333333334,0.6348432,0
2020-07-28-170702,170702,1,0,1,719,2.1666666666666665,1.0471002,1
2020-07-29-170702,170702,4,0,1,723,1.1666666666666667,0.8603472,2
2020-07-30-170702,170702,1,0,5,724,2.833333333333333,1.215417,3
2020-07-31-170702,170702,1,0,2,725,1.1666666666666667,0.44140908,4
2020-08-01-170702,170702,1,0,1,726,0.6666666666666666,0.39972508,5
2020-08-02-170702,170702,0,0,1,726,0.8333333333333334,0.26834905,6
2020-08-03-170702,170702,0,0,5,726,2.0,0.43838522,0
2020-08-04-170702,170702,1,0,1,727,0.6666666666666666,0.14563616,1
2020-08-05-170702,170702,1,0,6,728,1.8333333333333333,1.2416412,2
2020-08-06-170702,170702,1,0,3,729,2.0,1.1462831,3
2020-08-07-170702,170702,1,0,9,730,2.1666666666666665,0.9745628,4
2020-08-08-170702,170702,0,1,0,730,1.1666666666666667,0.43334535,5
2020-08-09-170702,170702,0,0,0,730,1.8333333333333333,0.533513,6
2020-08-10-170702,170702,2,0,3,732,1.5,1.4340776,0
2020-08-11-170702,170702,1,0,2,733,3.0,1.5409684,1
2020-08-12-170702,170702,1,0,3,734,2.833333333333333,1.5646648,2
2020-08-13-170702,170702,5,0,7,739,3.1666666666666665,2.9756691,3
2020-08-14-170702,170702,2,0,2,741,5.166666666666667,2.6934001,4
2020-08-15-170702,170702,1,0,1,742,1.6666666666666667,0.781757,5
2020-08-16-170702,170702,1,1,0,743,1.1666666666666667,0.6675118,6
2020-08-17-170702,170702,5,1,0,748,6.333333333333332,3.5435214,0
2020-08-18-170702,170702,1,0,9,749,6.666666666666668,2.5739906,1
2020-08-19-170702,170702,6,0,5,755,4.666666666666667,2.936454,2
2020-08-20-170702,170702,3,0,5,758,2.6666666666666665,1.2155199,3
2020-08-21-170702,170702,9,0,6,767,4.833333333333333,3.6243422,4
2020-08-22-170702,170702,0,0,5,767,2.333333333333333,1.2965264,5
2020-08-23-170702,170702,0,0,3,767,1.5,0.16650131,6
2020-08-24-170702,170702,3,0,2,770,3.5,2.0989861,0
2020-08-25-170702,170702,2,0,9,772,4.166666666666667,1.9957232,1
2020-08-26-170702,170702,3,0,6,775,2.0,1.468861,2
2020-08-27-170702,170702,7,0,8,782,3.6666666666666665,2.138161,3
2020-08-28-170702,170702,2,0,7,784,2.6666666666666665,0.8317855,4
2020-08-29-170702,170702,1,0,0,785,1.0,0.79338807,5
2020-08-30-170702,170702,0,0,1,785,0.6666666666666666,0.48931143,6
2020-08-31-170702,170702,0,0,6,785,3.5,1.4919602,0
2020-09-01-170702,170702,9,0,5,794,2.6666666666666665,1.8706708,1
2020-09-02-170702,170702,5,0,4,799,5.333333333333333,1.4576299,2
2020-09-03-170702,170702,5,0,2,804,4.5,2.3773017,3
2020-09-04-170702,170702,6,0,6,810,6.833333333333332,1.8840673,4
2020-09-05-170702,170702,5,0,2,815,3.1666666666666665,1.1278784,5
2020-09-06-170702,170702,3,0,0,818,3.6666666666666665,0.93786466,6
2020-09-07-170702,170702,2,0,4,820,5.333333333333333,1.6283563,0
2020-09-08-170702,170702,9,0,10,829,8.166666666666666,3.204769,1
2020-09-09-170702,170702,6,0,11,835,4.666666666666667,1.7358246,2
2020-09-10-170702,170702,8,0,3,843,4.0,1.597774,3
2020-09-11-170702,170702,7,0,9,850,8.0,1.7132052,4
2020-09-12-170702,170702,0,0,4,850,2.5,0.81332237,5
2020-09-13-170702,170702,1,0,2,851,1.8333333333333333,0.3299277,6
2020-09-14-170702,170702,6,0,4,857,6.166666666666668,3.355077,0
2020-09-15-170702,170702,5,0,7,862,4.5,1.1889011,1
2020-09-16-170702,170702,4,0,5,866,5.333333333333333,1.5237461,2
2020-09-17-170702,170702,2,0,3,868,6.0,2.2049682,3
2020-09-18-170702,170702,6,0,8,874,5.833333333333332,2.0369318,4
2020-09-19-170702,170702,2,0,1,876,3.1666666666666665,0.6073795,5
2020-09-20-170702,170702,0,0,5,876,4.333333333333333,0.6187703,6
2020-09-21-170702,170702,4,1,4,880,9.333333333333334,2.1028032,0
2020-09-22-170702,170702,10,1,5,890,5.333333333333333,1.5712804,1
2020-09-23-170702,170702,11,0,2,901,6.333333333333332,2.5254898,2
2020-09-24-170702,170702,3,1,4,904,4.833333333333333,1.6430088,3
2020-09-25-170702,170702,9,0,5,913,7.833333333333332,3.2366822,4
2020-09-26-170702,170702,4,0,3,917,3.333333333333333,0.9390684,5
2020-09-27-170702,170702,2,0,2,919,2.0,0.5341766,6
2020-09-28-170702,170702,4,0,1,923,3.6666666666666665,1.9046361,0
2020-09-29-170702,170702,7,0,5,930,4.0,1.569449,1
2020-09-30-170702,170702,5,0,10,935,2.833333333333333,1.5519868,2
2020-10-01-170702,170702,3,0,8,938,1.8333333333333333,1.1391102,3
2020-10-02-170702,170702,8,0,17,946,4.5,2.4628263,4
2020-10-03-170702,170702,1,0,5,947,1.1666666666666667,0.581188,5
2020-10-04-170702,170702,5,1,10,952,1.3333333333333333,0.9504998,6
2020-10-05-170702,170702,4,2,7,956,2.1666666666666665,1.6002666,0
2020-10-06-170702,170702,5,0,12,961,4.333333333333333,2.5179093,1
2020-10-07-170702,170702,2,0,8,963,2.5,1.287966,2
2020-10-08-170702,170702,4,1,8,967,8.166666666666666,1.8320477,3
2020-10-09-170702,170702,5,2,12,972,4.666666666666667,1.4960631,4
2020-10-10-170702,170702,3,0,2,975,3.0,1.0220046,5
2020-10-11-170702,170702,2,0,1,977,1.6666666666666667,0.9789746,6
2020-10-12-170702,170702,1,0,14,978,2.833333333333333,0.78897613,0
2020-10-13-170702,170702,5,0,8,983,4.5,1.6146463,1
2020-10-14-170702,170702,10,0,9,993,2.333333333333333,1.4182512,2
2020-10-15-170702,170702,8,0,8,1001,4.166666666666667,2.7290604,3
2020-10-16-170702,170702,17,0,18,1018,4.166666666666667,3.614678,4
2020-10-17-170702,170702,5,1,4,1023,1.3333333333333333,1.1990086,5
2020-10-18-170702,170702,10,0,1,1033,3.0,1.5676585,6
2020-10-19-170702,170702,7,0,7,1040,3.333333333333333,2.1568816,0
2020-10-20-170702,170702,12,0,5,1052,3.6666666666666665,2.0737805,1
2020-10-21-170702,170702,8,1,7,1060,3.6666666666666665,2.0381846,2
2020-10-22-170702,170702,8,0,9,1068,6.166666666666668,3.7748995,3
2020-10-23-170702,170702,12,0,10,1080,5.166666666666667,2.7973542,4
2020-10-24-170702,170702,2,1,2,1082,3.333333333333333,1.3869922,5
2020-10-25-170702,170702,1,1,2,1083,2.1666666666666665,0.9410441,6
2020-10-26-170702,170702,14,1,3,1097,2.6666666666666665,2.0312,0
2020-10-27-170702,170702,8,0,5,1105,4.0,2.3591027,1
2020-10-28-170702,170702,9,1,4,1114,4.166666666666667,2.8546422,2
2020-10-29-170702,170702,8,1,5,1122,5.333333333333333,3.4850676,3
2020-10-30-170702,170702,18,0,3,1140,4.5,2.9594893,4
2020-10-31-170702,170702,4,1,0,1144,2.6666666666666665,2.0299077,5
2020-11-01-170702,170702,1,0,0,1145,2.333333333333333,0.60864896,6
2020-11-02-170702,170702,7,1,0,1152,2.333333333333333,1.7312305,0
2020-11-03-170702,170702,5,0,0,1157,6.166666666666668,2.7896945,1
2020-11-04-170702,170702,7,1,0,1164,3.6666666666666665,2.3495615,2
2020-11-05-170702,170702,9,0,0,1173,8.166666666666666,2.6190631,3
2020-11-06-170702,170702,10,1,0,1183,6.166666666666668,3.4915273,4
2020-11-07-170702,170702,2,1,0,1185,1.1666666666666667,0.63907254,5
2020-11-08-170702,170702,2,0,0,1187,1.0,0.39062583,6
2020-11-09-170702,170702,3,1,0,1190,5.166666666666667,2.617598,0
2020-11-10-170702,170702,5,0,0,1195,8.0,2.1827283,1
2020-11-11-170702,170702,4,0,0,1199,4.833333333333333,2.093888,2
2020-11-12-170702,170702,5,0,0,1204,4.166666666666667,1.1510938,3
2020-11-13-170702,170702,3,0,0,1207,6.5,3.7417283,4
2020-03-01-170703,170703,0,0,0,0,0.0,0.0029737556,6
2020-03-02-170703,170703,0,0,12,0,0.0,0.003205854,0
2020-03-03-170703,170703,0,0,14,0,0.0,0.004768764,1
2020-03-04-170703,170703,0,0,16,0,0.0,0.0006497773,2
2020-03-05-170703,170703,0,0,9,0,0.3333333333333333,0.012902858,3
2020-03-06-170703,170703,0,0,24,0,0.0,0.024314256,4
2020-03-07-170703,170703,0,0,7,0,0.0,0.015207493,5
2020-03-08-170703,170703,0,0,3,0,0.0,9.092624e-05,6
2020-03-09-170703,170703,0,0,23,0,0.16666666666666666,0.053932287,0
2020-03-10-170703,170703,0,0,12,0,0.16666666666666666,0.055896826,1
2020-03-11-170703,170703,0,0,14,0,0.16666666666666666,0.026660508,2
2020-03-12-170703,170703,0,0,9,0,0.16666666666666666,0.10323099,3
2020-03-13-170703,170703,0,0,18,0,0.6666666666666666,0.0943344,4
2020-03-14-170703,170703,0,0,3,0,0.6666666666666666,0.027474415,5
2020-03-15-170703,170703,0,0,7,0,1.0,0.018387638,6
2020-03-16-170703,170703,12,0,7,12,3.0,1.5301762,0
2020-03-17-170703,170703,14,0,10,26,4.333333333333333,1.6598717,1
2020-03-18-170703,170703,16,1,17,42,5.333333333333333,2.0318046,2
2020-03-19-170703,170703,9,0,5,51,8.333333333333334,1.6097826,3
2020-03-20-170703,170703,24,0,3,75,6.166666666666668,2.6694863,4
2020-03-21-170703,170703,7,0,0,82,4.0,0.59385717,5
2020-03-22-170703,170703,3,0,11,85,8.5,0.27385598,6
2020-03-23-170703,170703,23,0,10,108,12.333333333333336,2.910692,0
2020-03-24-170703,170703,12,0,7,120,8.5,1.6817478,1
2020-03-25-170703,170703,14,0,5,134,9.5,1.9112219,2
2020-03-26-170703,170703,9,0,4,143,8.333333333333334,1.335515,3
2020-03-27-170703,170703,18,0,6,161,11.833333333333336,2.2863023,4
2020-03-28-170703,170703,3,0,0,164,6.166666666666668,0.33380863,5
2020-03-29-170703,170703,7,1,2,171,2.833333333333333,0.44997653,6
2020-03-30-170703,170703,7,0,9,178,8.5,1.1968584,0
2020-03-31-170703,170703,10,0,5,188,6.833333333333332,1.2038178,1
2020-04-01-170703,170703,17,0,6,205,6.0,1.8740748,2
2020-04-02-170703,170703,5,0,7,210,5.333333333333333,1.0898012,3
2020-04-03-170703,170703,3,0,5,213,5.333333333333333,0.661122,4
2020-04-04-170703,170703,0,1,2,213,4.166666666666667,0.16169967,5
2020-04-05-170703,170703,11,0,2,224,3.333333333333333,0.7642106,6
2020-04-06-170703,170703,10,1,0,234,4.166666666666667,1.2374051,0
2020-04-07-170703,170703,7,0,4,241,6.666666666666668,1.0670415,1
2020-04-08-170703,170703,5,0,4,246,4.333333333333333,0.8791147,2
2020-04-09-170703,170703,4,0,3,250,5.333333333333333,0.46227062,3
2020-04-10-170703,170703,6,0,8,256,0.8333333333333334,0.47025195,4
2020-04-11-170703,170703,0,0,0,256,3.6666666666666665,0.07310479,5
2020-04-12-170703,170703,2,0,1,258,3.1666666666666665,0.16423531,6
2020-04-13-170703,170703,9,0,4,267,3.6666666666666665,1.488594,0
2020-04-14-170703,170703,5,0,8,272,2.833333333333333,0.7623636,1
2020-04-15-170703,170703,6,0,7,278,3.333333333333333,1.0157244,2
2020-04-16-170703,170703,7,0,2,285,2.833333333333333,0.8685065,3
2020-04-17-170703,170703,5,0,3,290,3.5,0.5942309,4
2020-04-18-170703,170703,2,0,2,292,1.1666666666666667,0.3295907,5
2020-04-19-170703,170703,2,0,4,294,0.5,0.15866731,6
2020-04-20-170703,170703,0,0,8,294,7.666666666666668,0.37256825,0
2020-04-21-170703,170703,4,0,7,298,4.833333333333333,0.8285172,1
2020-04-22-170703,170703,4,0,9,302,2.0,0.8169424,2
2020-04-23-170703,170703,3,0,8,305,1.0,0.26904327,3
2020-04-24-170703,170703,8,0,4,313,3.0,1.0343953,4
2020-04-25-170703,170703,0,0,1,313,1.3333333333333333,0.028259851,5
2020-04-26-170703,170703,1,0,1,314,2.5,0.17360213,6
2020-04-27-170703,170703,4,0,3,318,6.0,0.8450232,0
2020-04-28-170703,170703,8,0,4,326,3.8333333333333335,0.9214123,1
2020-04-29-170703,170703,7,0,5,333,2.5,1.006262,2
2020-04-30-170703,170703,2,0,5,335,3.0,0.47419947,3
2020-05-01-170703,170703,3,0,1,338,0.5,0.24467434,4
2020-05-02-170703,170703,2,0,3,340,1.3333333333333333,0.23746379,5
2020-05-03-170703,170703,4,0,4,344,0.6666666666666666,0.22998409,6
2020-05-04-170703,170703,8,0,5,352,3.0,1.086533,0
2020-05-05-170703,170703,7,0,10,359,2.333333333333333,1.0550761,1
2020-05-06-170703,170703,9,0,11,368,2.5,1.1001476,2
2020-05-07-170703,170703,8,0,8,376,3.1666666666666665,1.120403,3
2020-05-08-170703,170703,4,0,2,380,2.5,0.6908518,4
2020-05-09-170703,170703,1,0,1,381,0.5,0.029076658,5
2020-05-10-170703,170703,1,1,1,382,0.0,0.08628435,6
2020-05-11-170703,170703,3,0,7,385,3.6666666666666665,0.6965508,0
2020-05-12-170703,170703,4,0,2,389,1.6666666666666667,0.645719,1
2020-05-13-170703,170703,5,1,5,394,1.6666666666666667,0.73175186,2
2020-05-14-170703,170703,5,0,2,399,3.1666666666666665,0.77397424,3
2020-05-15-170703,170703,1,0,1,400,2.1666666666666665,0.34404224,4
2020-05-16-170703,170703,3,0,1,403,1.1666666666666667,0.22934407,5
2020-05-17-170703,170703,4,0,0,407,0.5,0.1893025,6
2020-05-18-170703,170703,5,0,2,412,3.0,0.8300593,0
2020-05-19-170703,170703,10,0,1,422,1.5,1.2442666,1
2020-05-20-170703,170703,11,0,1,433,3.0,1.5345533,2
2020-05-21-170703,170703,8,0,0,441,2.0,1.2995676,3
2020-05-22-170703,170703,2,0,3,443,3.6666666666666665,0.5129185,4
2020-05-23-170703,170703,1,0,0,444,1.3333333333333333,0.1581327,5
2020-05-24-170703,170703,1,0,2,445,0.6666666666666666,0.12821357,6
2020-05-25-170703,170703,7,0,2,452,3.1666666666666665,1.148366,0
2020-05-26-170703,170703,2,0,2,454,2.0,0.5533861,1
2020-05-27-170703,170703,5,0,1,459,4.5,1.0524391,2
2020-05-28-170703,170703,2,0,4,461,1.5,0.45897898,3
2020-05-29-170703,170703,1,0,1,462,1.3333333333333333,0.28970668,4
2020-05-30-170703,170703,1,1,0,463,0.0,0.12851419,5
2020-05-31-170703,170703,0,0,0,463,0.5,0.006652009,6
2020-06-01-170703,170703,2,0,0,465,2.5,0.39863083,0
2020-06-02-170703,170703,1,0,2,466,1.3333333333333333,0.30777597,1
2020-06-03-170703,170703,1,0,2,467,1.3333333333333333,0.29969165,2
2020-06-04-170703,170703,0,0,0,467,1.5,0.1545436,3
2020-06-05-170703,170703,3,0,3,470,1.3333333333333333,0.48902494,4
2020-06-06-170703,170703,0,0,0,470,0.0,0.030058574,5
2020-06-07-170703,170703,2,0,2,472,0.5,0.21824646,6
2020-06-08-170703,170703,2,0,1,474,1.6666666666666667,0.44903317,0
2020-06-09-170703,170703,2,0,1,476,1.6666666666666667,0.29862043,1
2020-06-10-170703,170703,1,0,3,477,1.0,0.20596491,2
2020-06-11-170703,170703,4,0,2,481,1.5,0.50379354,3
2020-06-12-170703,170703,1,0,1,482,0.3333333333333333,0.23853198,4
2020-06-13-170703,170703,0,0,0,482,0.5,0.032904457,5
2020-06-14-170703,170703,0,0,0,482,0.16666666666666666,0.00852769,6
2020-06-15-170703,170703,0,0,3,482,1.3333333333333333,0.15557827,0
2020-06-16-170703,170703,2,0,0,484,1.5,0.32155067,1
2020-06-17-170703,170703,2,0,1,486,0.8333333333333334,0.41966453,2
2020-06-18-170703,170703,0,0,1,486,1.3333333333333333,0.12083497,3
2020-06-19-170703,170703,3,0,5,489,2.6666666666666665,0.6077697,4
2020-06-20-170703,170703,0,0,0,489,0.16666666666666666,0.028011268,5
2020-06-21-170703,170703,2,0,0,491,0.0,0.12169284,6
2020-06-22-170703,170703,1,0,3,492,1.0,0.23790206,0
2020-06-23-170703,170703,1,3,2,493,0.8333333333333334,0.30264822,1
2020-06-24-170703,170703,3,1,4,496,1.0,0.49286965,2
2020-06-25-170703,170703,2,0,1,498,1.3333333333333333,0.44402334,3
2020-06-26-170703,170703,1,0,0,499,1.0,0.1924769,4
2020-06-27-170703,170703,0,0,0,499,0.16666666666666666,0.027652638,5
2020-06-28-170703,170703,0,0,0,499,0.16666666666666666,0.011861948,6
2020-06-29-170703,170703,3,0,0,502,0.6666666666666666,0.47546354,0
2020-06-30-170703,170703,0,0,1,502,0.5,0.073772006,1
2020-07-01-170703,170703,1,0,1,503,0.8333333333333334,0.21896109,2
2020-07-02-170703,170703,1,0,0,504,0.8333333333333334,0.2574717,3
2020-07-03-170703,170703,5,0,0,509,1.1666666666666667,0.85753566,4
2020-07-04-170703,170703,0,0,0,509,0.3333333333333333,0.02972116,5
2020-07-05-170703,170703,0,0,1,509,0.0,0.00025903562,6
2020-07-06-170703,170703,3,0,0,512,0.8333333333333334,0.5087349,0
2020-07-07-170703,170703,2,0,1,514,0.3333333333333333,0.2858086,1
2020-07-08-170703,170703,4,1,2,518,1.1666666666666667,0.41268575,2
2020-07-09-170703,170703,1,0,3,519,0.8333333333333334,0.26370677,3
2020-07-10-170703,170703,0,1,2,519,0.5,0.10542018,4
2020-07-11-170703,170703,0,0,2,519,0.3333333333333333,0.023173671,5
2020-07-12-170703,170703,0,0,0,519,0.0,0.01847567,6
2020-07-13-170703,170703,0,0,1,519,0.5,0.07462542,0
2020-07-14-170703,170703,1,0,1,520,0.5,0.20093161,1
2020-07-15-170703,170703,1,0,3,521,1.1666666666666667,0.18046099,2
2020-07-16-170703,170703,0,0,3,521,3.333333333333333,0.27068838,3
2020-07-17-170703,170703,0,1,2,521,0.8333333333333334,0.12499817,4
2020-07-18-170703,170703,0,0,0,521,0.0,0.022617694,5
2020-07-19-170703,170703,1,0,2,522,0.3333333333333333,0.030365832,6
2020-07-20-170703,170703,0,0,5,522,1.3333333333333333,0.0978878,0
2020-07-21-170703,170703,1,0,2,523,1.1666666666666667,0.23437913,1
2020-07-22-170703,170703,2,0,3,525,1.0,0.5055863,2
2020-07-23-170703,170703,3,0,5,528,0.16666666666666666,0.547122,3
2020-07-24-170703,170703,2,0,5,530,1.8333333333333333,0.60627383,4
2020-07-25-170703,170703,2,0,1,532,0.16666666666666666,0.30408314,5
2020-07-26-170703,170703,0,1,2,532,0.5,0.013892351,6
2020-07-27-170703,170703,1,0,3,533,2.1666666666666665,0.31186482,0
2020-07-28-170703,170703,1,0,4,534,3.333333333333333,0.22504309,1
2020-07-29-170703,170703,3,0,6,537,2.1666666666666665,0.5824516,2
2020-07-30-170703,170703,3,0,4,540,2.5,0.8189974,3
2020-07-31-170703,170703,2,0,2,542,2.1666666666666665,0.13017607,4
2020-08-01-170703,170703,0,0,2,542,0.8333333333333334,0.05362189,5
2020-08-02-170703,170703,2,0,1,544,0.0,0.15648286,6
2020-08-03-170703,170703,5,0,1,549,1.8333333333333333,0.80234283,0
2020-08-04-170703,170703,2,0,1,551,2.1666666666666665,0.502636,1
2020-08-05-170703,170703,3,0,3,554,2.333333333333333,0.7373632,2
2020-08-06-170703,170703,5,0,1,559,1.5,0.8650567,3
2020-08-07-170703,170703,5,0,10,564,1.6666666666666667,0.74587595,4
2020-08-08-170703,170703,1,0,0,565,0.8333333333333334,0.2663766,5
2020-08-09-170703,170703,2,0,2,567,1.1666666666666667,0.32247362,6
2020-08-10-170703,170703,3,0,3,570,0.8333333333333334,0.59729314,0
2020-08-11-170703,170703,4,0,3,574,1.6666666666666667,0.85146993,1
2020-08-12-170703,170703,6,0,5,580,1.1666666666666667,0.9613292,2
2020-08-13-170703,170703,4,0,1,584,2.333333333333333,0.83339834,3
2020-08-14-170703,170703,2,0,3,586,1.8333333333333333,0.7484061,4
2020-08-15-170703,170703,2,0,1,588,1.1666666666666667,0.36221474,5
2020-08-16-170703,170703,1,0,0,589,1.0,0.27158856,6
2020-08-17-170703,170703,1,0,1,590,1.8333333333333333,0.5714708,0
2020-08-18-170703,170703,1,0,0,591,1.8333333333333333,0.59783614,1
2020-08-19-170703,170703,3,0,2,594,3.333333333333333,0.8966143,2
2020-08-20-170703,170703,1,0,9,595,4.333333333333333,0.6458602,3
2020-08-21-170703,170703,10,0,5,605,4.166666666666667,1.8544474,4
2020-08-22-170703,170703,0,0,3,605,1.1666666666666667,0.28268138,5
2020-08-23-170703,170703,2,0,9,607,1.0,0.28218907,6
2020-08-24-170703,170703,3,0,7,610,2.1666666666666665,0.90328133,0
2020-08-25-170703,170703,3,0,17,613,3.6666666666666665,0.87222826,1
2020-08-26-170703,170703,5,1,12,618,4.666666666666667,1.2110162,2
2020-08-27-170703,170703,1,0,7,619,3.333333333333333,0.59698176,3
2020-08-28-170703,170703,3,1,10,622,4.666666666666667,0.89298534,4
2020-08-29-170703,170703,1,1,6,623,2.0,0.5249716,5
2020-08-30-170703,170703,0,0,7,623,1.3333333333333333,0.11745043,6
2020-08-31-170703,170703,1,1,5,624,4.166666666666667,0.638708,0
2020-09-01-170703,170703,0,0,8,624,3.5,0.26431787,1
2020-09-02-170703,170703,2,0,4,626,7.5,0.70592606,2
2020-09-03-170703,170703,9,0,9,635,4.333333333333333,1.2650185,3
2020-09-04-170703,170703,5,0,5,640,6.0,1.0187232,4
2020-09-05-170703,170703,3,0,5,643,4.666666666666667,0.67105716,5
2020-09-06-170703,170703,9,0,3,652,5.666666666666668,1.3132958,6
2020-09-07-170703,170703,7,0,15,659,5.0,1.5054873,0
2020-09-08-170703,170703,17,0,13,676,8.666666666666666,3.0219078,1
2020-09-09-170703,170703,12,0,14,688,7.166666666666668,3.019831,2
2020-09-10-170703,170703,7,0,6,695,6.833333333333332,1.7516183,3
2020-09-11-170703,170703,10,0,11,705,10.333333333333334,2.4200685,4
2020-09-12-170703,170703,6,0,12,711,3.333333333333333,1.1790487,5
2020-09-13-170703,170703,7,0,7,718,1.8333333333333333,0.7465732,6
2020-09-14-170703,170703,5,1,2,723,6.333333333333332,1.2360567,0
2020-09-15-170703,170703,8,0,9,731,11.166666666666664,1.489886,1
2020-09-16-170703,170703,4,0,7,735,7.666666666666668,0.77929825,2
2020-09-17-170703,170703,9,0,2,744,6.833333333333332,1.7932435,3
2020-09-18-170703,170703,5,0,10,749,5.166666666666667,0.8544069,4
2020-09-19-170703,170703,5,0,2,754,4.0,0.7262351,5
2020-09-20-170703,170703,3,0,2,757,2.5,0.3959333,6
2020-09-21-170703,170703,15,0,1,772,7.5,1.9695475,0
2020-09-22-170703,170703,13,0,4,785,9.333333333333334,1.8394029,1
2020-09-23-170703,170703,14,0,5,799,9.5,2.5943782,2
2020-09-24-170703,170703,6,0,29,805,6.833333333333332,1.2945938,3
2020-09-25-170703,170703,11,1,5,816,7.5,2.2969837,4
2020-09-26-170703,170703,12,0,1,828,6.5,1.8665805,5
2020-09-27-170703,170703,7,0,1,835,1.1666666666666667,1.0869889,6
2020-09-28-170703,170703,2,0,0,837,4.5,0.6849259,0
2020-09-29-170703,170703,9,0,8,846,6.333333333333332,1.6443485,1
2020-09-30-170703,170703,7,0,3,853,2.833333333333333,1.0706221,2
2020-10-01-170703,170703,2,1,3,855,4.666666666666667,0.6000463,3
2020-10-02-170703,170703,10,0,7,865,6.666666666666668,1.9099488,4
2020-10-03-170703,170703,2,0,1,867,1.6666666666666667,0.37535834,5
2020-10-04-170703,170703,2,1,7,869,3.0,0.3037945,6
2020-10-05-170703,170703,1,0,8,870,2.333333333333333,0.7417775,0
2020-10-06-170703,170703,4,1,8,874,6.833333333333332,1.01575,1
2020-10-07-170703,170703,5,1,13,879,4.166666666666667,1.4224241,2
2020-10-08-170703,170703,29,0,11,908,4.333333333333333,4.6430807,3
2020-10-09-170703,170703,5,2,14,913,4.666666666666667,1.2300091,4
2020-10-10-170703,170703,1,0,15,914,3.0,0.5544345,5
2020-10-11-170703,170703,1,0,3,915,2.5,0.35068983,6
2020-10-12-170703,170703,0,0,4,915,2.333333333333333,0.15564369,0
2020-10-13-170703,170703,8,0,8,923,4.833333333333333,1.4504503,1
2020-10-14-170703,170703,3,0,8,926,4.833333333333333,0.93262315,2
2020-10-15-170703,170703,3,0,8,929,5.166666666666667,1.3247995,3
2020-10-16-170703,170703,7,0,6,936,7.833333333333332,2.0193832,4
2020-10-17-170703,170703,1,0,2,937,3.0,0.3272533,5
2020-10-18-170703,170703,7,0,6,944,4.166666666666667,0.98782957,6
2020-10-19-170703,170703,8,0,9,952,5.833333333333332,1.7971181,0
2020-10-20-170703,170703,8,0,10,960,7.333333333333332,1.7108457,1
2020-10-21-170703,170703,13,0,6,973,5.166666666666667,2.4504726,2
2020-10-22-170703,170703,11,0,24,984,5.0,2.380372,3
2020-10-23-170703,170703,14,0,8,998,6.5,2.579302,4
2020-10-24-170703,170703,15,0,5,1013,2.833333333333333,2.2050998,5
2020-10-25-170703,170703,3,1,1,1016,2.6666666666666665,0.38964233,6
2020-10-26-170703,170703,4,0,9,1020,9.0,1.237303,0
2020-10-27-170703,170703,8,0,29,1028,7.666666666666668,1.92103,1
2020-10-28-170703,170703,8,0,14,1036,8.5,2.1423552,2
2020-10-29-170703,170703,8,0,12,1044,6.333333333333332,1.8887624,3
2020-10-30-170703,170703,6,1,12,1050,9.0,1.620219,4
2020-10-31-170703,170703,2,0,0,1052,6.0,0.831604,5
2020-11-01-170703,170703,6,1,0,1058,1.8333333333333333,0.83199376,6
2020-11-02-170703,170703,9,0,0,1067,4.0,1.2762986,0
2020-11-03-170703,170703,10,0,0,1077,4.5,2.0938985,1
2020-11-04-170703,170703,6,0,0,1083,8.333333333333334,1.6597902,2
2020-11-05-170703,170703,24,0,0,1107,7.5,4.6604595,3
2020-11-06-170703,170703,8,1,0,1115,8.333333333333334,2.32466,4
2020-11-07-170703,170703,5,0,0,1120,3.1666666666666665,0.869832,5
2020-11-08-170703,170703,1,0,0,1121,4.5,0.3300764,6
2020-11-09-170703,170703,9,0,0,1130,5.833333333333332,2.0995944,0
2020-11-10-170703,170703,29,2,0,1159,6.666666666666668,4.2637486,1
2020-11-11-170703,170703,14,2,0,1173,5.0,2.5996106,2
2020-11-12-170703,170703,12,0,0,1185,5.0,1.6438903,3
2020-11-13-170703,170703,12,0,0,1197,8.0,2.7507079,4
2020-03-01-170704,170704,0,0,0,0,0.0,2.7373167e-07,6
2020-03-02-170704,170704,0,0,0,0,0.0,2.2946624e-07,0
2020-03-03-170704,170704,0,0,0,0,0.2,1.3300644e-07,1
2020-03-04-170704,170704,0,0,4,0,0.0,4.4933272e-11,2
2020-03-05-170704,170704,0,0,1,0,0.0,0.0007269812,3
2020-03-06-170704,170704,0,0,0,0,0.0,3.1102311e-07,4
2020-03-07-170704,170704,0,0,0,0,0.2,2.2090363e-07,5
2020-03-08-170704,170704,0,0,0,0,0.0,1.3834393e-08,6
2020-03-09-170704,170704,0,0,1,0,0.2,6.2998274e-06,0
2020-03-10-170704,170704,0,0,2,0,0.2,5.5638347e-06,1
2020-03-11-170704,170704,1,0,0,1,0.0,8.882896e-07,2
2020-03-12-170704,170704,0,0,0,1,0.2,1.4576166e-06,3
2020-03-13-170704,170704,0,0,17,1,0.4,4.63994e-06,4
2020-03-14-170704,170704,0,0,3,1,1.0,1.929645e-06,5
2020-03-15-170704,170704,0,0,2,1,0.8,6.391648e-07,6
2020-03-16-170704,170704,0,0,3,1,6.0,1.8103052e-05,0
2020-03-17-170704,170704,0,0,1,1,4.8,1.9097628e-05,1
2020-03-18-170704,170704,4,1,1,5,8.4,2.9819936e-05,2
2020-03-19-170704,170704,1,0,0,6,10.0,1.9750376e-05,3
2020-03-20-170704,170704,0,0,0,6,10.6,4.971104e-05,4
2020-03-21-170704,170704,0,0,1,6,5.6,8.639013e-06,5
2020-03-22-170704,170704,0,0,0,6,7.8,1.3285783e-05,6
2020-03-23-170704,170704,1,0,2,7,15.2,8.4441795e-05,0
2020-03-24-170704,170704,2,0,1,9,11.2,4.8829286e-05,1
2020-03-25-170704,170704,0,0,1,9,10.6,4.2447246e-05,2
2020-03-26-170704,170704,0,0,1,9,8.0,4.938057e-05,3
2020-03-27-170704,170704,17,0,0,26,12.8,4.9442664e-05,4
2020-03-28-170704,170704,3,0,0,29,6.2,1.2388282e-05,5
2020-03-29-170704,170704,2,0,0,31,3.6,5.1038974e-06,6
2020-03-30-170704,170704,3,0,0,34,9.8,3.5388668e-05,0
2020-03-31-170704,170704,1,1,0,35,7.6,2.1953008e-05,1
2020-04-01-170704,170704,1,0,1,36,10.6,3.2117347e-05,2
2020-04-02-170704,170704,0,0,0,36,5.0,2.532964e-05,3
2020-04-03-170704,170704,0,0,0,36,4.8,2.6590955e-05,4
2020-04-04-170704,170704,1,0,0,37,3.2,4.632722e-06,5
2020-04-05-170704,170704,0,0,0,37,5.8,1.2805945e-05,6
2020-04-06-170704,170704,2,0,0,39,4.4,2.4377463e-05,0
2020-04-07-170704,170704,1,0,0,40,8.0,3.41187e-05,1
2020-04-08-170704,170704,1,0,0,41,4.2,3.128826e-05,2
2020-04-09-170704,170704,1,0,0,42,6.4,1.3866337e-05,3
2020-04-10-170704,170704,0,0,0,42,1.8,4.0007117e-06,4
2020-04-11-170704,170704,0,0,1,42,1.4,6.9267803e-06,5
2020-04-12-170704,170704,0,0,0,42,1.4,5.9588187e-06,6
2020-04-13-170704,170704,0,1,0,42,4.4,3.9558927e-05,0
2020-04-14-170704,170704,0,0,2,42,3.4,2.6571712e-05,1
2020-04-15-170704,170704,1,0,1,43,4.2,4.0559215e-05,2
2020-04-16-170704,170704,0,0,0,43,3.2,2.5692314e-05,3
2020-04-17-170704,170704,0,0,0,43,2.8,1.1352581e-05,4
2020-04-18-170704,170704,0,0,0,43,3.8,3.4166012e-06,5
2020-04-19-170704,170704,0,0,0,43,1.0,1.2451189e-06,6
2020-04-20-170704,170704,0,1,1,43,2.0,2.2827824e-05,0
2020-04-21-170704,170704,0,0,1,43,8.8,1.7504104e-05,1
2020-04-22-170704,170704,0,0,0,43,2.6,2.7742672e-05,2
2020-04-23-170704,170704,0,0,0,43,2.0,5.788501e-06,3
2020-04-24-170704,170704,0,0,0,43,4.4,4.253606e-05,4
2020-04-25-170704,170704,1,0,0,44,1.0,3.9062343e-07,5
2020-04-26-170704,170704,0,0,0,44,3.2,5.22593e-05,6
2020-04-27-170704,170704,0,0,0,44,6.8,1.8938115e-05,0
2020-04-28-170704,170704,2,1,0,46,4.8,1.608756e-05,1
2020-04-29-170704,170704,1,0,0,47,3.8,1.9773404e-05,2
2020-04-30-170704,170704,0,0,1,47,2.8,0.07850159,3
2020-05-01-170704,170704,0,0,0,47,1.0,0.035860717,4
2020-05-02-170704,170704,0,0,0,47,0.4,1.7261546e-06,5
2020-05-03-170704,170704,0,0,0,47,1.0,1.4344066e-06,6
2020-05-04-170704,170704,1,0,1,48,2.6,0.0770671,0
2020-05-05-170704,170704,1,0,0,49,2.6,1.8634959e-05,1
2020-05-06-170704,170704,0,0,0,49,2.4,2.1463415e-05,2
2020-05-07-170704,170704,0,0,0,49,3.8,2.11823e-05,3
2020-05-08-170704,170704,0,0,2,49,3.0,2.2260276e-05,4
2020-05-09-170704,170704,0,1,0,49,0.8,8.1719793e-07,5
2020-05-10-170704,170704,0,0,0,49,0.4,6.3943514e-07,6
2020-05-11-170704,170704,0,0,1,49,2.6,2.0263495e-05,0
2020-05-12-170704,170704,0,3,1,49,2.6,8.354853e-06,1
2020-05-13-170704,170704,0,0,1,49,2.2,1.1686685e-05,2
2020-05-14-170704,170704,1,0,1,50,3.6,1.3079606e-05,3
2020-05-15-170704,170704,0,0,0,50,3.4,7.3704323e-06,4
2020-05-16-170704,170704,0,0,0,50,1.0,2.470001e-06,5
2020-05-17-170704,170704,0,0,1,50,1.4,2.4785422e-06,6
2020-05-18-170704,170704,1,0,0,51,3.6,1.5002902e-05,0
2020-05-19-170704,170704,0,0,0,51,4.2,1.7279626e-05,1
2020-05-20-170704,170704,0,0,0,51,5.2,2.2965598e-05,2
2020-05-21-170704,170704,0,0,0,51,2.8,1.679133e-05,3
2020-05-22-170704,170704,2,0,0,53,3.2,6.605819e-06,4
2020-05-23-170704,170704,0,0,0,53,1.0,1.5437048e-06,5
2020-05-24-170704,170704,0,1,0,53,1.2,8.501386e-07,6
2020-05-25-170704,170704,1,0,0,54,4.2,1.7165505e-05,0
2020-05-26-170704,170704,1,0,0,55,1.8,1.5785308e-05,1
2020-05-27-170704,170704,1,0,0,56,4.8,1.3451963e-05,2
2020-05-28-170704,170704,1,0,0,57,1.2,8.441201e-06,3
2020-05-29-170704,170704,0,0,0,57,1.0,8.506421e-06,4
2020-05-30-170704,170704,0,0,0,57,0.2,1.6573538e-06,5
2020-05-31-170704,170704,1,0,0,58,0.0,1.2756971e-06,6
2020-06-01-170704,170704,0,0,0,58,1.4,8.430228e-06,0
2020-06-02-170704,170704,0,0,0,58,1.6,1.0995003e-05,1
2020-06-03-170704,170704,0,0,0,58,1.2,4.4829476e-06,2
2020-06-04-170704,170704,0,0,0,58,1.2,5.0071244e-06,3
2020-06-05-170704,170704,0,0,0,58,1.6,6.925058e-06,4
2020-06-06-170704,170704,0,2,0,58,0.0,1.1051978e-06,5
2020-06-07-170704,170704,0,0,0,58,1.0,1.6110304e-06,6
2020-06-08-170704,170704,0,0,0,58,1.8,1.1776106e-05,0
2020-06-09-170704,170704,0,0,0,58,1.0,6.6997445e-06,1
2020-06-10-170704,170704,0,0,0,58,0.8,5.201496e-06,2
2020-06-11-170704,170704,0,0,0,58,0.8,8.586601e-06,3
2020-06-12-170704,170704,0,0,0,58,0.8,3.763887e-06,4
2020-06-13-170704,170704,0,0,0,58,0.6,2.4727456e-07,5
2020-06-14-170704,170704,0,0,0,58,0.2,1.82595e-08,6
2020-06-15-170704,170704,0,0,0,58,0.0,6.3763255e-06,0
2020-06-16-170704,170704,0,0,0,58,1.4,1.2829966e-05,1
2020-06-17-170704,170704,0,0,0,58,0.8,4.7285716e-06,2
2020-06-18-170704,170704,0,0,0,58,1.8,3.7538045e-06,3
2020-06-19-170704,170704,0,0,0,58,2.4,1.266522e-05,4
2020-06-20-170704,170704,0,0,0,58,0.0,1.2777498e-06,5
2020-06-21-170704,170704,0,0,0,58,0.4,1.3672981e-06,6
2020-06-22-170704,170704,0,0,0,58,0.6,4.5043153e-06,0
2020-06-23-170704,170704,0,1,0,58,0.8,5.6827757e-06,1
2020-06-24-170704,170704,0,0,0,58,0.8,7.4546774e-06,2
2020-06-25-170704,170704,0,2,0,58,1.2,1.00026855e-05,3
2020-06-26-170704,170704,0,0,0,58,0.6,9.908652e-06,4
2020-06-27-170704,170704,0,0,0,58,0.2,6.336088e-07,5
2020-06-28-170704,170704,0,0,0,58,0.2,5.1208576e-07,6
2020-06-29-170704,170704,0,0,0,58,1.0,6.5785457e-06,0
2020-06-30-170704,170704,0,0,0,58,0.4,3.2553492e-06,1
2020-07-01-170704,170704,0,0,0,58,0.4,3.659118e-06,2
2020-07-02-170704,170704,0,0,0,58,0.8,9.823404e-06,3
2020-07-03-170704,170704,0,0,0,58,1.6,1.1285278e-05,4
2020-07-04-170704,170704,0,0,0,58,0.2,9.332978e-07,5
2020-07-05-170704,170704,0,0,0,58,0.0,1.2235985e-07,6
2020-07-06-170704,170704,0,0,0,58,1.4,7.2810462e-06,0
2020-07-07-170704,170704,0,0,0,58,0.8,5.5982887e-06,1
2020-07-08-170704,170704,0,0,0,58,1.6,6.712825e-06,2
2020-07-09-170704,170704,0,0,0,58,0.8,3.3652755e-06,3
2020-07-10-170704,170704,0,0,0,58,0.2,3.560788e-06,4
2020-07-11-170704,170704,0,0,0,58,0.4,2.6105334e-07,5
2020-07-12-170704,170704,0,0,0,58,0.0,6.6959416e-07,6
2020-07-13-170704,170704,0,0,0,58,0.4,1.2281641e-06,0
2020-07-14-170704,170704,0,0,0,58,0.6,2.845529e-06,1
2020-07-15-170704,170704,0,0,0,58,1.4,3.350913e-06,2
2020-07-16-170704,170704,0,0,0,58,2.4,3.6950003e-06,3
2020-07-17-170704,170704,0,0,0,58,0.4,5.1100424e-06,4
2020-07-18-170704,170704,0,0,1,58,0.4,4.0375969e-07,5
2020-07-19-170704,170704,0,0,0,58,0.2,3.5144594e-06,6
2020-07-20-170704,170704,0,0,0,58,1.0,4.1903104e-06,0
2020-07-21-170704,170704,0,0,0,58,0.4,7.518024e-06,1
2020-07-22-170704,170704,0,0,0,58,1.8,6.9102416e-06,2
2020-07-23-170704,170704,0,0,0,58,1.0,7.7250415e-06,3
2020-07-24-170704,170704,0,0,0,58,1.0,9.261405e-06,4
2020-07-25-170704,170704,0,0,0,58,0.8,4.3275954e-06,5
2020-07-26-170704,170704,0,0,2,58,0.0,8.2950305e-07,6
2020-07-27-170704,170704,0,0,0,58,0.6,6.872323e-06,0
2020-07-28-170704,170704,0,0,0,58,0.8,6.4521396e-06,1
2020-07-29-170704,170704,0,0,0,58,1.8,7.0632777e-06,2
2020-07-30-170704,170704,0,0,1,58,2.6,1.2109817e-05,3
2020-07-31-170704,170704,0,0,0,58,0.8,6.0624766e-06,4
2020-08-01-170704,170704,1,0,0,59,0.6,3.903496e-06,5
2020-08-02-170704,170704,0,0,0,59,0.4,2.04982e-06,6
2020-08-03-170704,170704,0,0,0,59,1.4,1.1921824e-05,0
2020-08-04-170704,170704,0,0,1,59,0.6,1.2909871e-05,1
2020-08-05-170704,170704,0,1,0,59,1.0,2.3676905e-05,2
2020-08-06-170704,170704,0,0,1,59,1.2,1.4846602e-05,3
2020-08-07-170704,170704,0,0,0,59,2.0,1.3020522e-05,4
2020-08-08-170704,170704,0,0,0,59,1.8,2.337865e-05,5
2020-08-09-170704,170704,2,0,1,61,1.4,5.7005554e-06,6
2020-08-10-170704,170704,0,0,0,61,1.8,2.471234e-05,0
2020-08-11-170704,170704,0,0,0,61,3.2,2.7044023e-05,1
2020-08-12-170704,170704,0,0,0,61,2.4,2.4402614e-05,2
2020-08-13-170704,170704,1,0,1,62,3.8,2.3364975e-05,3
2020-08-14-170704,170704,0,0,1,62,5.8,3.4812976e-05,4
2020-08-15-170704,170704,0,0,1,62,2.4,2.793882e-05,5
2020-08-16-170704,170704,0,0,0,62,2.0,2.9438004e-05,6
2020-08-17-170704,170704,0,0,4,62,5.4,1.6067232e-05,0
2020-08-18-170704,170704,1,0,0,63,7.2,2.623571e-05,1
2020-08-19-170704,170704,0,0,0,63,5.2,4.199582e-05,2
2020-08-20-170704,170704,1,0,0,64,4.0,7.004972e-05,3
2020-08-21-170704,170704,0,0,0,64,6.0,6.853632e-05,4
2020-08-22-170704,170704,0,0,0,64,0.2,1.6278786e-05,5
2020-08-23-170704,170704,1,0,0,65,0.8,7.873979e-06,6
2020-08-24-170704,170704,0,0,0,65,3.2,3.860091e-05,0
2020-08-25-170704,170704,0,0,0,65,2.8,4.2248717e-05,1
2020-08-26-170704,170704,0,0,0,65,3.0,7.559545e-05,2
2020-08-27-170704,170704,1,0,2,66,3.2,5.4846045e-05,3
2020-08-28-170704,170704,1,0,1,67,3.4,5.701366e-05,4
2020-08-29-170704,170704,1,0,0,68,2.0,4.5105564e-05,5
2020-08-30-170704,170704,0,0,0,68,0.6,1.8393324e-05,6
2020-08-31-170704,170704,4,0,0,72,2.6,4.6854002e-05,0
2020-09-01-170704,170704,0,0,0,72,3.4,5.6999424e-06,1
2020-09-02-170704,170704,0,0,1,72,2.2,2.0732454e-05,2
2020-09-03-170704,170704,0,0,0,72,3.2,2.643536e-05,3
2020-09-04-170704,170704,0,0,0,72,6.6,2.2450222e-05,4
2020-09-05-170704,170704,0,0,0,72,3.2,5.4407832e-05,5
2020-09-06-170704,170704,0,0,1,72,3.4,4.130552e-05,6
2020-09-07-170704,170704,0,0,0,72,2.4,3.1757914e-05,0
2020-09-08-170704,170704,0,0,2,72,8.8,0.000120849145,1
2020-09-09-170704,170704,0,0,0,72,7.0,0.0002004568,2
2020-09-10-170704,170704,2,0,1,74,5.4,0.00011524143,3
2020-09-11-170704,170704,1,0,0,75,7.8,0.000115728,4
2020-09-12-170704,170704,0,0,0,75,2.2,4.997747e-05,5
2020-09-13-170704,170704,0,0,0,75,1.8,1.3858896e-05,6
2020-09-14-170704,170704,0,0,0,75,4.6,3.596832e-05,0
2020-09-15-170704,170704,0,0,2,75,5.6,0.000112484086,1
2020-09-16-170704,170704,1,0,0,76,5.0,3.5988505e-05,2
2020-09-17-170704,170704,0,0,0,76,5.2,7.401421e-05,3
2020-09-18-170704,170704,0,0,1,76,4.4,4.317402e-05,4
2020-09-19-170704,170704,0,0,0,76,3.0,4.539279e-05,5
2020-09-20-170704,170704,1,0,0,77,1.4,1.04591545e-05,6
2020-09-21-170704,170704,0,0,1,77,8.6,5.9425965e-05,0
2020-09-22-170704,170704,2,0,2,79,7.8,3.2011565e-05,1
2020-09-23-170704,170704,0,0,0,79,9.2,5.374383e-05,2
2020-09-24-170704,170704,1,0,0,80,3.6,3.6368183e-05,3
2020-09-25-170704,170704,0,0,2,80,7.4,4.688937e-05,4
2020-09-26-170704,170704,0,0,2,80,3.2,4.111482e-05,5
2020-09-27-170704,170704,0,0,0,80,2.2,1.7950708e-05,6
2020-09-28-170704,170704,0,0,0,80,3.0,3.355063e-05,0
2020-09-29-170704,170704,2,0,1,82,4.6,4.502983e-05,1
2020-09-30-170704,170704,0,0,0,82,3.4,3.2755826e-05,2
2020-10-01-170704,170704,0,0,0,82,2.2,4.0542312e-05,3
2020-10-02-170704,170704,1,0,0,83,4.8,2.6917327e-05,4
2020-10-03-170704,170704,0,0,0,83,0.6,1.0507274e-05,5
2020-10-04-170704,170704,0,0,0,83,2.0,5.082699e-06,6
2020-10-05-170704,170704,1,0,0,84,2.4,4.6735677e-05,0
2020-10-06-170704,170704,2,1,1,86,2.8,3.716425e-05,1
2020-10-07-170704,170704,0,0,0,86,2.6,7.674491e-05,2
2020-10-08-170704,170704,0,0,0,86,8.4,9.519867e-05,3
2020-10-09-170704,170704,2,0,0,88,4.6,5.2778265e-05,4
2020-10-10-170704,170704,2,0,0,90,1.4,2.0183268e-05,5
2020-10-11-170704,170704,0,0,0,90,1.4,1.8668874e-05,6
2020-10-12-170704,170704,0,0,0,90,1.4,8.661904e-06,0
2020-10-13-170704,170704,1,0,0,91,4.6,4.2434127e-05,1
2020-10-14-170704,170704,0,0,0,91,3.4,5.260068e-05,2
2020-10-15-170704,170704,0,0,1,91,3.2,7.881265e-05,3
2020-10-16-170704,170704,0,0,0,91,6.4,4.4230514e-05,4
2020-10-17-170704,170704,0,0,0,91,2.0,1.5747923e-05,5
2020-10-18-170704,170704,0,0,0,91,4.4,2.8119837e-05,6
2020-10-19-170704,170704,0,0,0,91,4.4,5.367063e-05,0
2020-10-20-170704,170704,1,0,0,92,5.6,6.1004455e-05,1
2020-10-21-170704,170704,0,0,0,92,6.4,6.712466e-05,2
2020-10-22-170704,170704,0,0,1,92,4.6,4.5106553e-05,3
2020-10-23-170704,170704,0,0,0,92,8.6,8.243708e-05,4
2020-10-24-170704,170704,0,0,0,92,4.0,4.9451126e-05,5
2020-10-25-170704,170704,0,0,0,92,1.4,9.621874e-06,6
2020-10-26-170704,170704,0,0,0,92,5.4,6.399478e-05,0
2020-10-27-170704,170704,0,0,0,92,5.0,8.391487e-05,1
2020-10-28-170704,170704,0,0,0,92,6.0,9.542367e-05,2
2020-10-29-170704,170704,1,0,2,93,5.2,7.026513e-05,3
2020-10-30-170704,170704,0,0,0,93,8.2,7.315709e-05,4
2020-10-31-170704,170704,0,0,0,93,1.8,4.6296514e-05,5
2020-11-01-170704,170704,0,0,0,93,1.4,1.7048595e-05,6
2020-11-02-170704,170704,0,0,0,93,3.2,2.4853483e-05,0
2020-11-03-170704,170704,0,0,0,93,5.6,6.0871167e-05,1
2020-11-04-170704,170704,0,0,0,93,4.8,6.638886e-05,2
2020-11-05-170704,170704,1,0,0,94,9.2,0.000120829296,3
2020-11-06-170704,170704,0,0,0,94,7.0,7.872843e-05,4
2020-11-07-170704,170704,0,0,0,94,2.0,3.4583773e-05,5
2020-11-08-170704,170704,0,0,0,94,1.6,2.2847145e-05,6
2020-11-09-170704,170704,0,0,0,94,4.2,4.796256e-05,0
2020-11-10-170704,170704,0,0,0,94,8.6,6.631227e-05,1
2020-11-11-170704,170704,0,0,0,94,5.4,6.212458e-05,2
2020-11-12-170704,170704,2,0,0,96,4.6,5.2969903e-05,3
2020-11-13-170704,170704,0,0,0,96,6.8,9.989895e-05,4
2020-03-01-170705,170705,0,0,0,0,0.0,8.917681e-05,6
2020-03-02-170705,170705,0,0,0,0,0.0,6.877438e-08,0
2020-03-03-170705,170705,0,1,3,0,0.25,0.04579098,1
2020-03-04-170705,170705,0,0,19,0,0.0,0.00017753073,2
2020-03-05-170705,170705,0,0,6,0,0.0,0.0042584436,3
2020-03-06-170705,170705,0,0,6,0,0.25,0.05551402,4
2020-03-07-170705,170705,0,0,4,0,0.5,0.09185548,5
2020-03-08-170705,170705,0,0,3,0,0.0,5.686207e-06,6
2020-03-09-170705,170705,0,0,3,0,0.25,0.057348453,0
2020-03-10-170705,170705,0,0,0,0,0.0,0.04904119,1
2020-03-11-170705,170705,0,0,3,0,0.25,0.061371952,2
2020-03-12-170705,170705,0,2,6,0,1.0,0.24777703,3
2020-03-13-170705,170705,0,0,2,0,0.75,0.30261275,4
2020-03-14-170705,170705,0,0,3,0,1.25,0.29529878,5
2020-03-15-170705,170705,0,0,3,0,1.5,0.21395391,6
2020-03-16-170705,170705,0,0,3,0,7.0,1.3531166,0
2020-03-17-170705,170705,3,0,6,3,7.25,1.3834234,1
2020-03-18-170705,170705,19,0,7,22,9.0,3.4335558,2
2020-03-19-170705,170705,6,0,3,28,13.75,4.125208,3
2020-03-20-170705,170705,6,0,0,34,9.25,2.31013,4
2020-03-21-170705,170705,4,0,2,38,4.25,1.1465812,5
2020-03-22-170705,170705,3,0,4,41,11.75,1.6710831,6
2020-03-23-170705,170705,3,0,1,44,20.0,3.8754873,0
2020-03-24-170705,170705,0,0,0,44,17.0,3.3268113,1
2020-03-25-170705,170705,3,0,2,47,14.25,2.9721425,2
2020-03-26-170705,170705,6,0,2,53,13.25,2.9202013,3
2020-03-27-170705,170705,2,0,1,55,16.25,2.7398543,4
2020-03-28-170705,170705,3,0,0,58,3.75,1.1310848,5
2020-03-29-170705,170705,3,0,0,61,3.25,0.69745094,6
2020-03-30-170705,170705,3,0,10,64,12.75,2.3276398,0
2020-03-31-170705,170705,6,1,1,70,7.75,1.8488592,1
2020-04-01-170705,170705,7,0,1,77,13.75,2.59384,2
2020-04-02-170705,170705,3,0,0,80,17.0,2.6450326,3
2020-04-03-170705,170705,0,0,1,80,7.75,1.2179909,4
2020-04-04-170705,170705,2,0,2,82,7.75,1.0771706,5
2020-04-05-170705,170705,4,0,3,86,3.75,0.70206136,6
2020-04-06-170705,170705,1,1,0,87,11.75,1.8052891,0
2020-04-07-170705,170705,0,0,0,87,4.5,1.3223271,1
2020-04-08-170705,170705,2,0,0,89,6.0,1.2086258,2
2020-04-09-170705,170705,2,0,4,91,2.5,0.5781703,3
2020-04-10-170705,170705,1,1,3,92,4.75,0.54035413,4
2020-04-11-170705,170705,0,0,0,92,1.5,0.20186895,5
2020-04-12-170705,170705,0,0,1,92,3.25,0.32538828,6
2020-04-13-170705,170705,10,0,21,102,11.25,2.8000524,0
2020-04-14-170705,170705,1,0,1,103,6.75,1.0600975,1
2020-04-15-170705,170705,1,0,1,104,8.0,1.3900595,2
2020-04-16-170705,170705,0,0,0,104,3.25,0.6905965,3
2020-04-17-170705,170705,1,0,2,105,3.5,1.0756314,4
2020-04-18-170705,170705,2,0,1,107,14.25,1.894346,5
2020-04-19-170705,170705,3,0,0,110,6.5,0.6962711,6
2020-04-20-170705,170705,0,0,0,110,4.5,0.8531025,0
2020-04-21-170705,170705,0,0,0,110,4.75,1.1394603,1
2020-04-22-170705,170705,0,0,1,110,9.0,1.3294197,2
2020-04-23-170705,170705,4,0,0,114,2.25,0.617989,3
2020-04-24-170705,170705,3,0,0,117,6.0,1.1879302,4
2020-04-25-170705,170705,0,0,0,117,1.0,0.17728019,5
2020-04-26-170705,170705,1,0,0,118,1.5,0.417814,6
2020-04-27-170705,170705,21,0,0,139,3.75,2.733196,0
2020-04-28-170705,170705,1,0,1,140,3.5,0.78161335,1
2020-04-29-170705,170705,1,0,1,141,5.0,1.0035875,2
2020-04-30-170705,170705,0,0,1,141,6.25,0.7587931,3
2020-05-01-170705,170705,2,0,0,143,1.25,0.23431313,4
2020-05-02-170705,170705,1,0,1,144,0.25,0.049762357,5
2020-05-03-170705,170705,0,0,0,144,0.0,0.037508078,6
2020-05-04-170705,170705,0,0,0,144,2.25,0.3473334,0
2020-05-05-170705,170705,0,0,1,144,3.5,0.6335192,1
2020-05-06-170705,170705,1,0,0,145,1.75,0.39608938,2
2020-05-07-170705,170705,0,0,1,145,4.5,0.85203105,3
2020-05-08-170705,170705,0,0,0,145,4.25,0.87059546,4
2020-05-09-170705,170705,0,1,0,145,2.25,0.37180632,5
2020-05-10-170705,170705,0,0,0,145,1.75,0.22441652,6
2020-05-11-170705,170705,0,0,0,145,4.25,0.809707,0
2020-05-12-170705,170705,1,0,1,146,4.75,0.8526802,1
2020-05-13-170705,170705,1,0,1,147,3.5,1.0618049,2
2020-05-14-170705,170705,1,0,0,148,4.75,1.2611145,3
2020-05-15-170705,170705,0,0,1,148,5.25,1.0113505,4
2020-05-16-170705,170705,1,0,0,149,2.25,0.5049138,5
2020-05-17-170705,170705,0,0,0,149,2.25,0.34620026,6
2020-05-18-170705,170705,0,0,0,149,5.75,0.99018145,0
2020-05-19-170705,170705,1,0,1,150,5.75,1.3532937,1
2020-05-20-170705,170705,0,1,1,150,5.75,1.3303198,2
2020-05-21-170705,170705,1,0,0,151,4.25,0.9932394,3
2020-05-22-170705,170705,0,0,0,151,4.75,1.1824906,4
2020-05-23-170705,170705,0,0,0,151,3.25,0.5492816,5
2020-05-24-170705,170705,0,0,1,151,3.0,0.5172473,6
2020-05-25-170705,170705,0,0,0,151,5.5,1.450404,0
2020-05-26-170705,170705,1,0,0,152,5.25,1.3196915,1
2020-05-27-170705,170705,1,0,0,153,5.25,1.9318812,2
2020-05-28-170705,170705,0,1,0,153,2.25,0.64901143,3
2020-05-29-170705,170705,1,3,1,154,1.75,0.52857643,4
2020-05-30-170705,170705,0,0,0,154,0.0,0.0011802217,5
2020-05-31-170705,170705,0,0,1,154,0.0,0.0012191966,6
2020-06-01-170705,170705,0,0,1,154,1.5,0.34908453,0
2020-06-02-170705,170705,1,0,0,155,2.0,0.4464021,1
2020-06-03-170705,170705,1,0,0,156,1.5,0.45465264,2
2020-06-04-170705,170705,0,0,1,156,0.75,0.51442707,3
2020-06-05-170705,170705,0,0,7,156,0.75,0.17381766,4
2020-06-06-170705,170705,0,0,0,156,0.5,0.2089405,5
2020-06-07-170705,170705,1,0,0,157,0.5,0.15103629,6
2020-06-08-170705,170705,0,0,0,157,2.5,0.55619746,0
2020-06-09-170705,170705,0,0,3,157,2.0,0.41181657,1
2020-06-10-170705,170705,0,0,0,157,0.5,0.16682622,2
2020-06-11-170705,170705,0,0,1,157,1.75,0.46839252,3
2020-06-12-170705,170705,1,0,0,158,2.25,0.44542074,4
2020-06-13-170705,170705,0,0,0,158,0.0,0.044364948,5
2020-06-14-170705,170705,1,0,1,159,0.0,0.12175102,6
2020-06-15-170705,170705,1,0,0,160,1.5,0.38415566,0
2020-06-16-170705,170705,0,0,0,160,1.75,0.54629946,1
2020-06-17-170705,170705,0,0,0,160,1.75,0.5406177,2
2020-06-18-170705,170705,1,0,0,161,1.0,0.46796504,3
2020-06-19-170705,170705,7,0,0,168,1.25,1.1813307,4
2020-06-20-170705,170705,0,0,0,168,0.5,0.09429079,5
2020-06-21-170705,170705,0,0,0,168,0.25,0.042169284,6
2020-06-22-170705,170705,0,0,0,168,1.0,0.19324288,0
2020-06-23-170705,170705,3,0,0,171,1.25,0.9042252,1
2020-06-24-170705,170705,0,0,0,171,0.75,0.35612762,2
2020-06-25-170705,170705,1,7,0,172,1.0,0.39196363,3
2020-06-26-170705,170705,0,0,1,172,1.25,0.59549034,4
2020-06-27-170705,170705,0,0,0,172,0.5,0.13731568,5
2020-06-28-170705,170705,1,0,0,173,0.0,0.14447293,6
2020-06-29-170705,170705,0,0,0,173,0.75,0.39965078,0
2020-06-30-170705,170705,0,0,1,173,1.5,0.6758725,1
2020-07-01-170705,170705,0,0,0,173,0.5,0.29239666,2
2020-07-02-170705,170705,0,0,1,173,0.75,0.21080904,3
2020-07-03-170705,170705,0,0,1,173,1.75,0.97603875,4
2020-07-04-170705,170705,0,0,1,173,0.75,0.19881864,5
2020-07-05-170705,170705,0,0,0,173,0.0,5.90568e-06,6
2020-07-06-170705,170705,0,0,2,173,1.25,0.2907154,0
2020-07-07-170705,170705,0,0,0,173,0.5,0.08569465,1
2020-07-08-170705,170705,0,0,1,173,0.25,0.35014105,2
2020-07-09-170705,170705,0,0,0,173,1.0,0.30447596,3
2020-07-10-170705,170705,1,0,6,174,1.25,0.8629666,4
2020-07-11-170705,170705,0,0,0,174,0.25,0.09551274,5
2020-07-12-170705,170705,0,0,0,174,0.5,0.28570753,6
2020-07-13-170705,170705,0,0,0,174,0.5,0.21483466,0
2020-07-14-170705,170705,1,1,2,175,0.5,0.37039185,1
2020-07-15-170705,170705,0,0,1,175,3.0,0.6789146,2
2020-07-16-170705,170705,1,0,5,176,1.75,0.5626215,3
2020-07-17-170705,170705,1,0,0,177,1.25,0.5033851,4
2020-07-18-170705,170705,1,0,1,178,0.75,0.41639057,5
2020-07-19-170705,170705,0,0,1,178,0.75,0.08554834,6
2020-07-20-170705,170705,2,0,0,180,0.5,0.49936277,0
2020-07-21-170705,170705,0,0,0,180,0.75,0.1945984,1
2020-07-22-170705,170705,1,1,2,181,2.25,0.94418466,2
2020-07-23-170705,170705,0,0,1,181,1.75,0.3385368,3
2020-07-24-170705,170705,6,0,0,187,0.5,1.2426742,4
2020-07-25-170705,170705,0,0,1,187,0.5,0.13913602,5
2020-07-26-170705,170705,0,0,2,187,0.0,0.0035240045,6
2020-07-27-170705,170705,0,0,4,187,0.75,0.19948341,0
2020-07-28-170705,170705,2,0,1,189,1.75,0.5897829,1
2020-07-29-170705,170705,1,0,4,190,1.25,0.69286877,2
2020-07-30-170705,170705,5,0,5,195,3.0,1.4319361,3
2020-07-31-170705,170705,0,0,2,195,2.0,0.7293444,4
2020-08-01-170705,170705,1,0,1,196,0.75,0.4517634,5
2020-08-02-170705,170705,1,0,2,197,1.0,0.4233253,6
2020-08-03-170705,170705,0,0,3,197,1.25,0.3953813,0
2020-08-04-170705,170705,0,0,5,197,0.5,0.15258643,1
2020-08-05-170705,170705,2,0,5,199,2.0,0.9743834,2
2020-08-06-170705,170705,1,0,0,200,1.75,0.8564708,3
2020-08-07-170705,170705,0,0,1,200,2.0,0.69528633,4
2020-08-08-170705,170705,1,0,0,201,1.75,1.0511042,5
2020-08-09-170705,170705,2,0,0,203,1.5,0.8618143,6
2020-08-10-170705,170705,4,0,4,207,1.5,2.012332,0
2020-08-11-170705,170705,1,0,0,208,3.75,1.9036881,1
2020-08-12-170705,170705,4,0,1,212,4.0,2.7140996,2
2020-08-13-170705,170705,5,0,0,217,5.75,3.743367,3
2020-08-14-170705,170705,2,0,2,219,10.5,5.098466,4
2020-08-15-170705,170705,1,0,4,220,2.25,1.8667744,5
2020-08-16-170705,170705,2,0,1,222,2.25,1.6504323,6
2020-08-17-170705,170705,3,0,0,225,8.75,3.75823,0
2020-08-18-170705,170705,5,0,0,230,9.75,4.3189354,1
2020-08-19-170705,170705,5,0,0,235,5.0,4.4767375,2
2020-08-20-170705,170705,0,0,4,235,3.75,1.3963716,3
2020-08-21-170705,170705,1,0,0,236,3.25,1.8065946,4
2020-08-22-170705,170705,0,0,1,236,2.75,1.3667896,5
2020-08-23-170705,170705,0,0,1,236,2.0,0.3469218,6
2020-08-24-170705,170705,4,0,1,240,4.25,3.5264072,0
2020-08-25-170705,170705,0,0,2,240,6.75,1.9510356,1
2020-08-26-170705,170705,1,0,1,241,3.0,2.2221568,2
2020-08-27-170705,170705,0,0,2,241,7.25,1.5525707,3
2020-08-28-170705,170705,2,0,0,243,2.75,0.8919144,4
2020-08-29-170705,170705,4,0,0,247,4.25,2.0571432,5
2020-08-30-170705,170705,1,0,1,248,5.0,1.7636087,6
2020-08-31-170705,170705,0,0,1,248,3.75,0.99784106,0
2020-09-01-170705,170705,0,0,1,248,4.75,1.1670451,1
2020-09-02-170705,170705,0,0,1,248,1.75,0.4132464,2
2020-09-03-170705,170705,4,0,2,252,4.0,1.8557372,3
2020-09-04-170705,170705,0,0,1,252,7.5,2.0987716,4
2020-09-05-170705,170705,1,0,0,253,1.25,0.6139365,5
2020-09-06-170705,170705,1,0,1,254,1.25,0.67294085,6
2020-09-07-170705,170705,1,0,4,255,4.25,1.4665575,0
2020-09-08-170705,170705,2,1,3,257,7.25,2.013114,1
2020-09-09-170705,170705,1,0,1,258,2.75,1.0254406,2
2020-09-10-170705,170705,2,0,2,260,3.75,1.2800024,3
2020-09-11-170705,170705,0,0,1,260,6.0,2.0461164,4
2020-09-12-170705,170705,0,1,0,260,2.25,1.0322171,5
2020-09-13-170705,170705,1,0,0,261,1.5,0.9278434,6
2020-09-14-170705,170705,1,0,0,262,9.25,2.387085,0
2020-09-15-170705,170705,1,0,0,263,4.0,1.2515122,1
2020-09-16-170705,170705,1,0,1,264,7.5,1.3814875,2
2020-09-17-170705,170705,2,0,0,266,8.0,1.5535281,3
2020-09-18-170705,170705,1,0,0,267,6.75,1.3400425,4
2020-09-19-170705,170705,0,1,1,267,2.75,0.39299342,5
2020-09-20-170705,170705,1,0,0,268,4.25,0.648107,6
2020-09-21-170705,170705,4,0,0,272,9.0,1.1043845,0
2020-09-22-170705,170705,3,0,0,275,5.25,1.5823176,1
2020-09-23-170705,170705,1,0,0,276,7.0,1.3146936,2
2020-09-24-170705,170705,2,0,0,278,4.75,1.0424987,3
2020-09-25-170705,170705,1,0,2,279,12.0,2.8036022,4
2020-09-26-170705,170705,0,0,0,279,1.25,0.9818215,5
2020-09-27-170705,170705,0,0,5,279,1.75,0.6150727,6
2020-09-28-170705,170705,0,0,1,279,6.0,1.2803718,0
2020-09-29-170705,170705,0,0,0,279,2.25,0.52545434,1
2020-09-30-170705,170705,1,0,2,280,4.0,1.1061937,2
2020-10-01-170705,170705,0,0,2,280,5.0,1.1226798,3
2020-10-02-170705,170705,0,0,1,280,9.25,1.6128204,4
2020-10-03-170705,170705,1,0,1,281,4.0,0.96629286,5
2020-10-04-170705,170705,0,0,1,281,4.5,0.8313198,6
2020-10-05-170705,170705,0,0,1,281,5.0,1.167781,0
2020-10-06-170705,170705,0,0,1,281,5.25,1.4430839,1
2020-10-07-170705,170705,0,0,4,281,3.25,0.80948675,2
2020-10-08-170705,170705,0,1,1,281,10.0,2.678,3
2020-10-09-170705,170705,2,0,3,283,5.5,0.89387035,4
2020-10-10-170705,170705,0,0,11,283,2.5,1.078897,5
2020-10-11-170705,170705,5,0,6,288,3.0,1.3929697,6
2020-10-12-170705,170705,1,0,2,289,4.0,0.968407,0
2020-10-13-170705,170705,0,0,2,289,6.0,1.240093,1
2020-10-14-170705,170705,2,0,5,291,3.0,0.91646945,2
2020-10-15-170705,170705,2,0,5,293,4.75,1.34166,3
2020-10-16-170705,170705,1,0,6,294,6.25,1.7597781,4
2020-10-17-170705,170705,1,0,13,295,2.75,1.2609504,5
2020-10-18-170705,170705,1,0,1,296,2.75,0.9269939,6
2020-10-19-170705,170705,1,0,5,297,3.75,1.120384,0
2020-10-20-170705,170705,1,0,3,298,2.0,0.8776305,1
2020-10-21-170705,170705,4,0,2,302,2.25,1.4840361,2
2020-10-22-170705,170705,1,0,4,303,8.0,2.5313447,3
2020-10-23-170705,170705,3,0,2,306,2.5,1.1530733,4
2020-10-24-170705,170705,11,0,3,317,1.0,1.702446,5
2020-10-25-170705,170705,6,0,1,323,2.25,0.7569494,6
2020-10-26-170705,170705,2,0,5,325,2.5,0.94270575,0
2020-10-27-170705,170705,2,0,1,327,4.0,1.1144785,1
2020-10-28-170705,170705,5,0,3,332,4.25,1.7388984,2
2020-10-29-170705,170705,5,0,1,337,6.75,3.2516377,3
2020-10-30-170705,170705,6,0,0,343,5.0,1.0568169,4
2020-10-31-170705,170705,13,0,0,356,3.0,2.5493023,5
2020-11-01-170705,170705,1,0,0,357,1.75,0.5676986,6
2020-11-02-170705,170705,5,0,0,362,1.5,1.0640835,0
2020-11-03-170705,170705,3,0,0,365,6.25,1.7270113,1
2020-11-04-170705,170705,2,0,0,367,4.5,1.3078673,2
2020-11-05-170705,170705,4,1,0,371,4.75,1.3094101,3
2020-11-06-170705,170705,2,0,0,373,7.5,1.5913649,4
2020-11-07-170705,170705,3,0,0,376,1.0,0.7336625,5
2020-11-08-170705,170705,1,0,0,377,1.5,0.6290419,6
2020-11-09-170705,170705,5,0,0,382,5.0,1.6255753,0
2020-11-10-170705,170705,1,0,0,383,4.25,1.0963798,1
2020-11-11-170705,170705,3,0,0,386,3.25,1.5683311,2
2020-11-12-170705,170705,1,0,0,387,1.75,0.45899606,3
2020-11-13-170705,170705,0,0,0,387,4.5,1.8315651,4
2020-03-01-170706,170706,0,0,1,0,0.16666666666666666,0.06250882,6
2020-03-02-170706,170706,0,0,0,0,0.3333333333333333,0.018226953,0
2020-03-03-170706,170706,0,0,8,0,0.0,0.0053368383,1
2020-03-04-170706,170706,0,0,7,0,0.0,1.8617453e-05,2
2020-03-05-170706,170706,1,0,8,1,0.16666666666666666,0.20511611,3
2020-03-06-170706,170706,0,0,5,1,0.16666666666666666,0.0761032,4
2020-03-07-170706,170706,0,0,3,1,0.16666666666666666,0.06163242,5
2020-03-08-170706,170706,0,0,16,1,0.0,6.1327635e-05,6
2020-03-09-170706,170706,0,0,19,1,0.16666666666666666,0.07171321,0
2020-03-10-170706,170706,0,0,7,1,0.16666666666666666,0.14888419,1
2020-03-11-170706,170706,0,0,13,1,0.16666666666666666,0.07310804,2
2020-03-12-170706,170706,0,0,20,1,0.8333333333333334,0.32954976,3
2020-03-13-170706,170706,1,0,16,2,0.8333333333333334,0.41837713,4
2020-03-14-170706,170706,0,0,11,2,1.1666666666666667,0.21501268,5
2020-03-15-170706,170706,1,0,3,3,1.8333333333333333,0.30734253,6
2020-03-16-170706,170706,0,0,5,3,8.5,1.600017,0
2020-03-17-170706,170706,8,0,3,11,8.833333333333334,2.0871682,1
2020-03-18-170706,170706,7,0,8,18,9.833333333333334,2.6376276,2
2020-03-19-170706,170706,8,0,9,26,16.5,3.9618087,3
2020-03-20-170706,170706,5,0,8,31,12.5,2.1972523,4
2020-03-21-170706,170706,3,0,5,34,6.0,0.81285584,5
2020-03-22-170706,170706,16,0,5,50,9.5,1.9678128,6
2020-03-23-170706,170706,19,0,6,69,20.33333333333333,5.5873213,0
2020-03-24-170706,170706,7,0,2,76,13.0,3.3674939,1
2020-03-25-170706,170706,13,0,8,89,17.5,4.2850285,2
2020-03-26-170706,170706,20,0,6,109,13.666666666666664,4.862072,3
2020-03-27-170706,170706,16,0,1,125,15.5,3.9243286,4
2020-03-28-170706,170706,11,1,4,136,7.0,1.6950272,5
2020-03-29-170706,170706,3,0,3,139,6.833333333333332,1.1207436,6
2020-03-30-170706,170706,5,0,8,144,14.833333333333336,3.191853,0
2020-03-31-170706,170706,3,0,2,147,10.666666666666666,1.9830664,1
2020-04-01-170706,170706,8,0,3,155,10.833333333333336,2.222926,2
2020-04-02-170706,170706,9,0,2,164,14.833333333333336,4.0029535,3
2020-04-03-170706,170706,8,0,10,172,7.166666666666668,2.134271,4
2020-04-04-170706,170706,5,0,2,177,9.166666666666666,1.5609037,5
2020-04-05-170706,170706,5,0,2,182,5.166666666666667,0.68204117,6
2020-04-06-170706,170706,6,1,30,188,16.833333333333332,3.0016408,0
2020-04-07-170706,170706,2,0,1,190,9.5,1.778989,1
2020-04-08-170706,170706,8,0,2,198,5.333333333333333,1.8693241,2
2020-04-09-170706,170706,6,1,1,204,6.0,1.1996111,3
2020-04-10-170706,170706,1,0,1,205,6.0,1.0840491,4
2020-04-11-170706,170706,4,0,3,209,2.6666666666666665,0.9592724,5
2020-04-12-170706,170706,3,1,0,212,3.5,0.65472907,6
2020-04-13-170706,170706,8,0,1,220,10.5,3.0132291,0
2020-04-14-170706,170706,2,1,3,222,7.833333333333332,2.0676973,1
2020-04-15-170706,170706,3,0,2,225,8.166666666666666,2.2972374,2
2020-04-16-170706,170706,2,0,1,227,5.0,1.1522031,3
2020-04-17-170706,170706,10,0,1,237,4.0,1.7678845,4
2020-04-18-170706,170706,2,0,5,239,8.666666666666666,1.9375291,5
2020-04-19-170706,170706,2,0,3,241,4.833333333333333,0.9376767,6
2020-04-20-170706,170706,30,1,3,271,5.833333333333332,4.9882708,0
2020-04-21-170706,170706,1,0,4,272,6.166666666666668,1.2039634,1
2020-04-22-170706,170706,2,0,1,274,9.0,2.9900496,2
2020-04-23-170706,170706,1,0,3,275,2.5,0.64696753,3
2020-04-24-170706,170706,1,0,4,276,6.333333333333332,1.6281551,4
2020-04-25-170706,170706,3,0,0,279,1.3333333333333333,0.60291916,5
2020-04-26-170706,170706,0,0,0,279,0.8333333333333334,0.19061048,6
2020-04-27-170706,170706,1,1,4,280,9.5,1.8408539,0
2020-04-28-170706,170706,3,0,3,283,5.666666666666668,1.1557113,1
2020-04-29-170706,170706,2,1,0,285,6.833333333333332,1.541848,2
2020-04-30-170706,170706,1,0,7,286,6.333333333333332,1.2643899,3
2020-05-01-170706,170706,1,1,2,287,1.5,0.21958587,4
2020-05-02-170706,170706,5,2,4,292,0.8333333333333334,0.41996804,5
2020-05-03-170706,170706,3,0,0,295,0.8333333333333334,0.3696895,6
2020-05-04-170706,170706,3,0,6,298,5.0,1.0596304,0
2020-05-05-170706,170706,4,0,1,302,4.666666666666667,1.528134,1
2020-05-06-170706,170706,1,0,1,303,4.833333333333333,0.98529273,2
2020-05-07-170706,170706,3,0,7,306,6.833333333333332,1.6314967,3
2020-05-08-170706,170706,4,0,4,310,4.5,1.8301767,4
2020-05-09-170706,170706,0,2,7,310,2.1666666666666665,0.37229323,5
2020-05-10-170706,170706,0,1,2,310,1.3333333333333333,0.22403292,6
2020-05-11-170706,170706,4,0,6,314,5.166666666666667,1.691354,0
2020-05-12-170706,170706,3,0,5,317,4.333333333333333,1.3732431,1
2020-05-13-170706,170706,0,0,7,317,4.333333333333333,1.113149,2
2020-05-14-170706,170706,7,0,2,324,5.0,1.6912514,3
2020-05-15-170706,170706,2,0,2,326,4.666666666666667,1.3204186,4
2020-05-16-170706,170706,4,0,0,330,2.5,0.7815359,5
2020-05-17-170706,170706,0,0,0,330,2.6666666666666665,0.3107019,6
2020-05-18-170706,170706,6,0,3,336,6.333333333333332,2.193055,0
2020-05-19-170706,170706,1,0,1,337,5.666666666666668,1.2190552,1
2020-05-20-170706,170706,1,0,2,338,6.833333333333332,1.3515321,2
2020-05-21-170706,170706,7,0,0,345,5.0,1.8684196,3
2020-05-22-170706,170706,4,0,1,349,5.666666666666668,1.5725251,4
2020-05-23-170706,170706,7,0,0,356,1.3333333333333333,1.1162004,5
2020-05-24-170706,170706,2,0,0,358,1.6666666666666667,0.39575827,6
2020-05-25-170706,170706,6,0,1,364,5.833333333333332,1.7905235,0
2020-05-26-170706,170706,5,0,3,369,3.8333333333333335,1.7015017,1
2020-05-27-170706,170706,7,1,1,376,6.5,2.3742685,2
2020-05-28-170706,170706,2,0,0,378,2.833333333333333,1.0303979,3
2020-05-29-170706,170706,2,2,0,380,1.6666666666666667,0.72880024,4
2020-05-30-170706,170706,0,0,0,380,0.16666666666666666,0.014890426,5
2020-05-31-170706,170706,0,0,0,380,0.0,0.004249598,6
2020-06-01-170706,170706,3,0,0,383,2.5,0.71444243,0
2020-06-02-170706,170706,1,0,1,384,2.6666666666666665,1.0157154,1
2020-06-03-170706,170706,2,1,2,386,2.333333333333333,0.80602664,2
2020-06-04-170706,170706,0,0,0,386,1.8333333333333333,0.515292,3
2020-06-05-170706,170706,1,3,3,387,2.1666666666666665,0.43718737,4
2020-06-06-170706,170706,0,0,0,387,0.3333333333333333,0.12467815,5
2020-06-07-170706,170706,0,0,0,387,1.0,0.08101411,6
2020-06-08-170706,170706,1,0,1,388,2.5,0.69754285,0
2020-06-09-170706,170706,3,0,0,391,2.0,0.8340028,1
2020-06-10-170706,170706,1,0,2,392,1.5,0.521511,2
2020-06-11-170706,170706,0,0,3,392,3.0,0.4511016,3
2020-06-12-170706,170706,0,0,1,392,1.5,0.46209887,4
2020-06-13-170706,170706,0,1,1,392,0.6666666666666666,0.11752,5
2020-06-14-170706,170706,0,0,0,392,0.16666666666666666,0.03755372,6
2020-06-15-170706,170706,0,1,1,392,2.1666666666666665,0.5885971,0
2020-06-16-170706,170706,1,0,0,393,2.6666666666666665,0.8409165,1
2020-06-17-170706,170706,2,0,0,395,1.8333333333333333,0.6931234,2
2020-06-18-170706,170706,0,0,1,395,1.8333333333333333,0.2807348,3
2020-06-19-170706,170706,3,0,0,398,3.333333333333333,0.910219,4
2020-06-20-170706,170706,0,0,1,398,0.6666666666666666,0.20605856,5
2020-06-21-170706,170706,0,0,0,398,0.8333333333333334,0.17349884,6
2020-06-22-170706,170706,1,0,1,399,1.5,0.41721308,0
2020-06-23-170706,170706,0,0,0,399,1.6666666666666667,0.41431773,1
2020-06-24-170706,170706,2,0,0,401,1.5,0.6662765,2
2020-06-25-170706,170706,3,2,2,404,1.8333333333333333,0.8076986,3
2020-06-26-170706,170706,1,0,0,405,1.8333333333333333,0.8204724,4
2020-06-27-170706,170706,1,0,0,406,0.3333333333333333,0.5338349,5
2020-06-28-170706,170706,0,1,0,406,0.5,0.18295233,6
2020-06-29-170706,170706,1,0,1,407,0.8333333333333334,0.18152422,0
2020-06-30-170706,170706,0,0,0,407,0.5,0.18107687,1
2020-07-01-170706,170706,0,0,0,407,1.5,0.31997707,2
2020-07-02-170706,170706,1,0,2,408,1.1666666666666667,0.45547855,3
2020-07-03-170706,170706,0,0,0,408,1.8333333333333333,0.28307658,4
2020-07-04-170706,170706,1,0,0,409,0.3333333333333333,0.16912709,5
2020-07-05-170706,170706,0,0,0,409,0.0,0.0013394809,6
2020-07-06-170706,170706,1,0,0,410,1.5,0.4199844,0
2020-07-07-170706,170706,0,0,0,410,1.0,0.18462166,1
2020-07-08-170706,170706,0,0,0,410,1.5,0.2088561,2
2020-07-09-170706,170706,2,0,0,412,1.6666666666666667,0.83894956,3
2020-07-10-170706,170706,0,0,2,412,0.6666666666666666,0.28077814,4
2020-07-11-170706,170706,0,0,0,412,0.5,0.11898278,5
2020-07-12-170706,170706,0,0,1,412,0.16666666666666666,0.06315543,6
2020-07-13-170706,170706,1,0,1,413,0.5,0.35200453,0
2020-07-14-170706,170706,0,0,5,413,0.6666666666666666,0.22803643,1
2020-07-15-170706,170706,0,0,1,413,2.0,0.5022746,2
2020-07-16-170706,170706,2,0,2,415,3.0,0.532698,3
2020-07-17-170706,170706,0,0,1,415,1.1666666666666667,0.49731493,4
2020-07-18-170706,170706,0,0,0,415,0.3333333333333333,0.101611964,5
2020-07-19-170706,170706,0,0,0,415,0.5,0.11653012,6
2020-07-20-170706,170706,0,0,3,415,1.1666666666666667,0.21813115,0
2020-07-21-170706,170706,0,0,0,415,1.5,0.2789334,1
2020-07-22-170706,170706,0,0,0,415,2.1666666666666665,0.6016373,2
2020-07-23-170706,170706,0,0,1,415,1.8333333333333333,0.42133817,3
2020-07-24-170706,170706,2,0,0,417,2.333333333333333,0.46333134,4
2020-07-25-170706,170706,0,0,0,417,0.6666666666666666,0.07950742,5
2020-07-26-170706,170706,1,0,1,418,0.16666666666666666,0.104998216,6
2020-07-27-170706,170706,1,0,1,419,2.6666666666666665,0.4758875,0
2020-07-28-170706,170706,5,0,1,424,3.5,1.1422372,1
2020-07-29-170706,170706,1,0,1,425,2.833333333333333,0.4114622,2
2020-07-30-170706,170706,2,0,0,427,3.333333333333333,0.74471146,3
2020-07-31-170706,170706,1,0,3,428,3.0,0.4414575,4
2020-08-01-170706,170706,0,0,0,428,0.5,0.19921415,5
2020-08-02-170706,170706,0,0,0,428,1.0,0.19904964,6
2020-08-03-170706,170706,3,0,4,431,2.833333333333333,0.85713017,0
2020-08-04-170706,170706,0,0,1,431,2.333333333333333,0.117331415,1
2020-08-05-170706,170706,0,0,6,431,3.5,0.6214459,2
2020-08-06-170706,170706,1,0,1,432,3.333333333333333,0.7649123,3
2020-08-07-170706,170706,0,0,6,432,3.0,0.5605687,4
2020-08-08-170706,170706,0,0,7,432,0.5,0.059051,5
2020-08-09-170706,170706,1,0,2,433,1.0,0.25505558,6
2020-08-10-170706,170706,1,0,3,434,1.5,0.29762694,0
2020-08-11-170706,170706,1,0,6,435,2.5,1.0234119,1
2020-08-12-170706,170706,1,0,2,436,3.333333333333333,0.8715969,2
2020-08-13-170706,170706,0,0,2,436,3.0,1.0933955,3
2020-08-14-170706,170706,3,0,4,439,2.0,1.1817569,4
2020-08-15-170706,170706,0,0,1,439,2.333333333333333,0.84262216,5
2020-08-16-170706,170706,0,0,1,439,0.6666666666666666,0.14977647,6
2020-08-17-170706,170706,4,0,4,443,3.8333333333333335,1.9999387,0
2020-08-18-170706,170706,1,0,6,444,3.1666666666666665,1.6123693,1
2020-08-19-170706,170706,6,0,25,450,4.166666666666667,2.6951177,2
2020-08-20-170706,170706,1,1,9,451,4.0,0.93159336,3
2020-08-21-170706,170706,6,0,18,457,7.5,4.468979,4
2020-08-22-170706,170706,7,0,11,464,1.6666666666666667,1.6080292,5
2020-08-23-170706,170706,2,0,10,466,1.6666666666666667,0.6321808,6
2020-08-24-170706,170706,3,0,13,469,3.6666666666666665,1.7765759,0
2020-08-25-170706,170706,6,1,16,475,4.833333333333333,2.3671198,1
2020-08-26-170706,170706,2,0,9,477,4.666666666666667,1.0964807,2
2020-08-27-170706,170706,2,0,5,479,4.166666666666667,1.2118477,3
2020-08-28-170706,170706,4,0,25,483,3.333333333333333,1.7182169,4
2020-08-29-170706,170706,1,0,4,484,1.5,0.7240755,5
2020-08-30-170706,170706,1,0,4,485,1.1666666666666667,0.29189393,6
2020-08-31-170706,170706,4,0,4,489,2.333333333333333,1.3977427,0
2020-09-01-170706,170706,6,0,14,495,3.6666666666666665,1.712496,1
2020-09-02-170706,170706,25,0,11,520,4.166666666666667,3.7753227,2
2020-09-03-170706,170706,9,0,5,529,5.333333333333333,2.1035419,3
2020-09-04-170706,170706,18,0,12,547,3.1666666666666665,3.2186985,4
2020-09-05-170706,170706,11,0,5,558,2.6666666666666665,1.5904856,5
2020-09-06-170706,170706,10,0,8,568,2.1666666666666665,1.3597387,6
2020-09-07-170706,170706,13,0,9,581,5.5,2.9450915,0
2020-09-08-170706,170706,16,0,4,597,8.333333333333334,3.4891334,1
2020-09-09-170706,170706,9,0,3,606,5.666666666666668,3.0511315,2
2020-09-10-170706,170706,5,0,6,611,6.166666666666668,1.1157335,3
2020-09-11-170706,170706,25,0,4,636,7.0,2.1653967,4
2020-09-12-170706,170706,4,0,6,640,3.333333333333333,0.9976862,5
2020-09-13-170706,170706,4,0,0,644,2.333333333333333,0.49891496,6
2020-09-14-170706,170706,4,0,2,648,9.166666666666666,2.159749,0
2020-09-15-170706,170706,14,0,5,662,6.166666666666668,1.8204807,1
2020-09-16-170706,170706,11,1,0,673,6.333333333333332,1.8110309,2
2020-09-17-170706,170706,5,0,1,678,8.166666666666666,2.0233498,3
2020-09-18-170706,170706,12,0,1,690,5.5,2.9449694,4
2020-09-19-170706,170706,5,2,1,695,5.833333333333332,0.9429079,5
2020-09-20-170706,170706,8,0,0,703,3.5,0.9795953,6
2020-09-21-170706,170706,9,0,0,712,8.666666666666666,1.9021763,0
2020-09-22-170706,170706,4,0,6,716,8.166666666666666,1.9154079,1
2020-09-23-170706,170706,3,0,1,719,11.666666666666664,1.8103764,2
2020-09-24-170706,170706,6,0,5,725,7.833333333333332,2.1643755,3
2020-09-25-170706,170706,4,1,6,729,11.5,2.3755176,4
2020-09-26-170706,170706,6,0,11,735,6.666666666666668,1.716298,5
2020-09-27-170706,170706,0,0,3,735,2.833333333333333,0.22567841,6
2020-09-28-170706,170706,2,0,7,737,5.666666666666668,1.3448839,0
2020-09-29-170706,170706,5,1,4,742,5.666666666666668,1.4438605,1
2020-09-30-170706,170706,0,0,5,742,6.166666666666668,0.9319377,2
2020-10-01-170706,170706,1,1,10,743,6.666666666666668,1.7157987,3
2020-10-02-170706,170706,1,0,4,744,9.333333333333334,2.11062,4
2020-10-03-170706,170706,1,0,3,745,3.333333333333333,0.74645996,5
2020-10-04-170706,170706,0,1,5,745,4.5,0.62517935,6
2020-10-05-170706,170706,0,1,2,745,4.166666666666667,1.2195824,0
2020-10-06-170706,170706,6,1,8,751,9.0,2.5978205,1
2020-10-07-170706,170706,1,1,2,752,4.333333333333333,2.0676172,2
2020-10-08-170706,170706,5,1,2,757,8.5,2.0579927,3
2020-10-09-170706,170706,6,1,7,763,4.5,1.5098577,4
2020-10-10-170706,170706,11,0,1,774,2.1666666666666665,1.4326509,5
2020-10-11-170706,170706,3,0,1,777,2.6666666666666665,0.76431406,6
2020-10-12-170706,170706,7,0,7,784,1.5,1.0229579,0
2020-10-13-170706,170706,4,0,3,788,5.166666666666667,1.2773826,1
2020-10-14-170706,170706,5,0,3,793,4.666666666666667,1.3993407,2
2020-10-15-170706,170706,10,0,4,803,4.5,1.8922864,3
2020-10-16-170706,170706,4,0,2,807,11.0,1.563147,4
2020-10-17-170706,170706,3,0,7,810,5.166666666666667,1.3334543,5
2020-10-18-170706,170706,5,0,4,815,4.666666666666667,0.97148013,6
2020-10-19-170706,170706,2,0,1,817,7.5,1.4172987,0
2020-10-20-170706,170706,8,0,6,825,8.833333333333334,2.4742944,1
2020-10-21-170706,170706,2,0,2,827,5.833333333333332,1.4868656,2
2020-10-22-170706,170706,2,0,8,829,9.333333333333334,2.292254,3
2020-10-23-170706,170706,7,0,3,836,7.5,2.5827622,4
2020-10-24-170706,170706,1,0,1,837,10.666666666666666,2.1236813,5
2020-10-25-170706,170706,1,0,3,838,4.833333333333333,0.9916365,6
2020-10-26-170706,170706,7,0,4,845,7.166666666666668,2.1703188,0
2020-10-27-170706,170706,3,0,7,848,10.833333333333336,3.2488515,1
2020-10-28-170706,170706,3,0,2,851,12.0,3.9201725,2
2020-10-29-170706,170706,4,0,4,855,9.833333333333334,3.499928,3
2020-10-30-170706,170706,2,2,9,857,11.833333333333336,3.0028625,4
2020-10-31-170706,170706,7,0,0,864,7.5,2.6083915,5
2020-11-01-170706,170706,4,0,0,868,4.833333333333333,1.6893586,6
2020-11-02-170706,170706,1,0,0,869,5.833333333333332,0.8961418,0
2020-11-03-170706,170706,6,0,0,875,7.833333333333332,2.4842396,1
2020-11-04-170706,170706,2,0,0,877,7.0,1.8113611,2
2020-11-05-170706,170706,8,1,0,885,11.5,3.154863,3
2020-11-06-170706,170706,3,1,0,888,13.333333333333336,3.4838252,4
2020-11-07-170706,170706,1,0,0,889,5.5,1.2375308,5
2020-11-08-170706,170706,3,0,0,892,2.1666666666666665,0.5933863,6
2020-11-09-170706,170706,4,0,0,896,7.0,2.1671975,0
2020-11-10-170706,170706,7,0,0,903,10.0,2.499699,1
2020-11-11-170706,170706,2,0,0,905,7.166666666666668,1.7300218,2
2020-11-12-170706,170706,4,0,0,909,5.833333333333332,1.3227473,3
2020-11-13-170706,170706,9,0,0,918,9.333333333333334,4.1759787,4
2020-03-01-170707,170707,0,0,1,0,0.0,0.00012050154,6
2020-03-02-170707,170707,0,0,2,0,0.0,0.00010772195,0
2020-03-03-170707,170707,0,0,1,0,0.0,0.026393997,1
2020-03-04-170707,170707,0,0,2,0,0.0,7.622167e-05,2
2020-03-05-170707,170707,0,1,1,0,0.0,0.0031799148,3
2020-03-06-170707,170707,0,0,1,0,0.0,0.0063366196,4
2020-03-07-170707,170707,0,0,0,0,0.0,0.034748703,5
2020-03-08-170707,170707,0,0,1,0,0.0,3.9753922e-05,6
2020-03-09-170707,170707,0,0,3,0,0.0,0.028529184,0
2020-03-10-170707,170707,0,0,3,0,0.0,0.008458067,1
2020-03-11-170707,170707,0,0,2,0,0.25,0.058858994,2
2020-03-12-170707,170707,0,0,3,0,0.25,0.09734856,3
2020-03-13-170707,170707,0,0,3,0,0.25,0.21815342,4
2020-03-14-170707,170707,1,0,0,1,1.25,0.35958052,5
2020-03-15-170707,170707,1,0,0,2,1.5,0.23873043,6
2020-03-16-170707,170707,2,0,0,4,2.5,1.2014439,0
2020-03-17-170707,170707,1,0,0,5,4.0,1.0090172,1
2020-03-18-170707,170707,2,0,5,7,9.5,2.4670086,2
2020-03-19-170707,170707,1,0,1,8,8.25,2.8145556,3
2020-03-20-170707,170707,1,0,0,9,4.75,1.4911757,4
2020-03-21-170707,170707,0,0,3,9,3.5,0.72272754,5
2020-03-22-170707,170707,1,0,0,10,4.5,1.0186999,6
2020-03-23-170707,170707,3,0,0,13,10.25,2.7306218,0
2020-03-24-170707,170707,3,0,0,16,6.75,2.3561015,1
2020-03-25-170707,170707,2,0,0,18,6.5,1.6158916,2
2020-03-26-170707,170707,3,0,0,21,5.25,2.0404806,3
2020-03-27-170707,170707,3,0,2,24,4.5,1.7822556,4
2020-03-28-170707,170707,0,0,0,24,3.25,0.90509605,5
2020-03-29-170707,170707,0,0,2,24,2.5,0.4052235,6
2020-03-30-170707,170707,0,0,0,24,4.0,0.9049372,0
2020-03-31-170707,170707,0,0,1,24,5.25,1.2282233,1
2020-04-01-170707,170707,5,0,2,29,6.5,2.0742283,2
2020-04-02-170707,170707,1,0,0,30,2.75,0.8339241,3
2020-04-03-170707,170707,0,0,4,30,1.5,0.47580636,4
2020-04-04-170707,170707,3,0,1,33,1.25,0.5698071,5
2020-04-05-170707,170707,0,0,0,33,1.5,0.423155,6
2020-04-06-170707,170707,0,0,3,33,2.25,0.73354185,0
2020-04-07-170707,170707,0,0,2,33,2.25,0.60458654,1
2020-04-08-170707,170707,0,0,0,33,2.25,0.65797925,2
2020-04-09-170707,170707,0,0,2,33,1.25,0.26103106,3
2020-04-10-170707,170707,2,0,1,35,1.75,0.5613906,4
2020-04-11-170707,170707,0,0,0,35,0.75,0.057405327,5
2020-04-12-170707,170707,2,0,0,37,1.5,0.2955078,6
2020-04-13-170707,170707,0,0,1,37,5.5,1.4115244,0
2020-04-14-170707,170707,1,0,0,38,2.25,0.5963888,1
2020-04-15-170707,170707,2,0,0,40,0.75,0.6305345,2
2020-04-16-170707,170707,0,0,1,40,1.25,0.36967224,3
2020-04-17-170707,170707,4,0,0,44,5.5,1.5467274,4
2020-04-18-170707,170707,1,0,1,45,1.25,0.88054013,5
2020-04-19-170707,170707,0,0,0,45,1.25,0.19369234,6
2020-04-20-170707,170707,3,0,3,48,1.75,0.894693,0
2020-04-21-170707,170707,2,0,1,50,0.75,0.7625809,1
2020-04-22-170707,170707,0,0,0,50,0.25,0.3387508,2
2020-04-23-170707,170707,2,0,2,52,1.25,0.6299758,3
2020-04-24-170707,170707,1,0,2,53,2.25,0.7210768,4
2020-04-25-170707,170707,0,0,0,53,0.0,0.042165037,5
2020-04-26-170707,170707,0,0,1,53,1.75,0.47895026,6
2020-04-27-170707,170707,1,0,0,54,6.0,1.6961211,0
2020-04-28-170707,170707,0,0,1,54,1.5,0.25901163,1
2020-04-29-170707,170707,0,0,0,54,1.75,0.48034644,2
2020-04-30-170707,170707,1,0,1,55,0.5,0.26438627,3
2020-05-01-170707,170707,0,0,0,55,1.5,0.18491629,4
2020-05-02-170707,170707,1,0,1,56,0.25,0.11838491,5
2020-05-03-170707,170707,0,0,0,56,0.25,0.0137853185,6
2020-05-04-170707,170707,3,0,1,59,1.75,0.6129943,0
2020-05-05-170707,170707,1,0,3,60,0.0,0.23072372,1
2020-05-06-170707,170707,0,0,3,60,0.75,0.2873123,2
2020-05-07-170707,170707,2,0,1,62,0.5,0.5079055,3
2020-05-08-170707,170707,2,0,1,64,0.25,0.5768885,4
2020-05-09-170707,170707,0,0,4,64,0.25,0.19196206,5
2020-05-10-170707,170707,1,0,1,65,0.0,0.20083359,6
2020-05-11-170707,170707,0,1,1,65,0.5,0.15514334,0
2020-05-12-170707,170707,1,0,2,66,0.25,0.38945442,1
2020-05-13-170707,170707,0,0,1,66,2.0,0.6932622,2
2020-05-14-170707,170707,1,0,0,67,1.25,0.8024207,3
2020-05-15-170707,170707,0,0,1,67,0.25,0.22555555,4
2020-05-16-170707,170707,1,0,0,68,0.5,0.39515403,5
2020-05-17-170707,170707,0,1,0,68,0.25,0.15975498,6
2020-05-18-170707,170707,1,0,1,69,1.5,0.5202867,0
2020-05-19-170707,170707,3,0,0,72,1.5,1.0854691,1
2020-05-20-170707,170707,3,0,0,75,1.5,0.802021,2
2020-05-21-170707,170707,1,0,0,76,0.75,0.48983228,3
2020-05-22-170707,170707,1,0,0,77,0.25,0.4803958,4
2020-05-23-170707,170707,4,0,0,81,0.5,0.64762384,5
2020-05-24-170707,170707,1,0,0,82,0.5,0.4150209,6
2020-05-25-170707,170707,1,0,0,83,1.0,0.7823192,0
2020-05-26-170707,170707,2,0,2,85,1.0,0.98202795,1
2020-05-27-170707,170707,1,3,0,86,1.25,1.3246258,2
2020-05-28-170707,170707,0,0,2,86,0.25,0.32338288,3
2020-05-29-170707,170707,1,0,1,87,0.75,0.4186299,4
2020-05-30-170707,170707,0,0,0,87,0.0,0.015380562,5
2020-05-31-170707,170707,0,0,0,87,0.25,0.0065593724,6
2020-06-01-170707,170707,1,0,0,88,0.5,0.306913,0
2020-06-02-170707,170707,0,0,0,88,1.0,0.22089557,1
2020-06-03-170707,170707,0,0,0,88,1.0,0.24673356,2
2020-06-04-170707,170707,0,0,0,88,0.75,0.42837462,3
2020-06-05-170707,170707,0,2,0,88,0.0,0.05304151,4
2020-06-06-170707,170707,0,0,0,88,0.25,0.2054548,5
2020-06-07-170707,170707,0,0,0,88,0.25,0.08374296,6
2020-06-08-170707,170707,0,0,0,88,0.0,0.12200257,0
2020-06-09-170707,170707,2,0,0,90,0.0,0.21714285,1
2020-06-10-170707,170707,0,0,1,90,0.0,0.040906776,2
2020-06-11-170707,170707,2,0,0,92,0.5,0.6749028,3
2020-06-12-170707,170707,1,0,0,93,0.25,0.18199572,4
2020-06-13-170707,170707,0,0,0,93,0.0,0.006859107,5
2020-06-14-170707,170707,0,0,0,93,0.5,0.099952176,6
2020-06-15-170707,170707,0,6,1,93,0.25,0.12709342,0
2020-06-16-170707,170707,0,0,1,93,0.25,0.2689006,1
2020-06-17-170707,170707,0,0,0,93,0.25,0.24398114,2
2020-06-18-170707,170707,0,0,0,93,0.25,0.234932,3
2020-06-19-170707,170707,0,1,2,93,2.5,0.6796792,4
2020-06-20-170707,170707,0,0,1,93,0.0,0.019015636,5
2020-06-21-170707,170707,0,0,0,93,0.0,0.008837346,6
2020-06-22-170707,170707,0,0,0,93,0.5,0.0795991,0
2020-06-23-170707,170707,0,0,0,93,1.5,0.6160646,1
2020-06-24-170707,170707,1,0,0,94,0.25,0.47226456,2
2020-06-25-170707,170707,0,2,0,94,0.25,0.16337353,3
2020-06-26-170707,170707,0,0,0,94,0.25,0.31365198,4
2020-06-27-170707,170707,0,0,0,94,0.0,0.047009207,5
2020-06-28-170707,170707,0,0,0,94,0.25,0.15169884,6
2020-06-29-170707,170707,1,0,1,95,0.5,0.5697747,0
2020-06-30-170707,170707,1,0,0,96,0.5,0.83749753,1
2020-07-01-170707,170707,0,0,3,96,0.75,0.27648908,2
2020-07-02-170707,170707,0,0,1,96,0.75,0.04856981,3
2020-07-03-170707,170707,2,0,0,98,1.25,0.9390322,4
2020-07-04-170707,170707,1,0,0,99,0.0,0.26643363,5
2020-07-05-170707,170707,0,0,1,99,0.0,9.251167e-07,6
2020-07-06-170707,170707,0,0,0,99,0.0,0.09649045,0
2020-07-07-170707,170707,0,0,0,99,0.0,0.0246352,1
2020-07-08-170707,170707,0,0,0,99,0.25,0.24124172,2
2020-07-09-170707,170707,0,0,0,99,0.0,0.046516374,3
2020-07-10-170707,170707,0,0,0,99,1.0,0.7170135,4
2020-07-11-170707,170707,0,0,0,99,0.0,0.010190696,5
2020-07-12-170707,170707,0,0,0,99,0.25,0.26406825,6
2020-07-13-170707,170707,1,0,0,100,0.0,0.23724353,0
2020-07-14-170707,170707,0,0,0,100,0.75,0.37391797,1
2020-07-15-170707,170707,3,0,1,103,0.5,0.32577783,2
2020-07-16-170707,170707,1,0,0,104,0.5,0.176629,3
2020-07-17-170707,170707,0,1,1,104,0.25,0.19686171,4
2020-07-18-170707,170707,0,0,0,104,0.25,0.2443352,5
2020-07-19-170707,170707,1,0,1,105,0.0,0.017580012,6
2020-07-20-170707,170707,0,0,1,105,0.75,0.399219,0
2020-07-21-170707,170707,0,0,0,105,0.25,0.10788768,1
2020-07-22-170707,170707,0,0,0,105,0.5,0.48233077,2
2020-07-23-170707,170707,0,0,1,105,1.0,0.12648816,3
2020-07-24-170707,170707,0,0,0,105,1.75,0.8351548,4
2020-07-25-170707,170707,0,0,0,105,0.75,0.15249173,5
2020-07-26-170707,170707,0,0,0,105,0.25,0.024858031,6
2020-07-27-170707,170707,0,0,0,105,0.0,0.03337725,0
2020-07-28-170707,170707,0,0,1,105,0.75,0.3318644,1
2020-07-29-170707,170707,1,0,3,106,0.75,0.69871503,2
2020-07-30-170707,170707,0,0,7,106,1.75,0.94629604,3
2020-07-31-170707,170707,1,0,13,107,2.0,0.64713764,4
2020-08-01-170707,170707,0,0,0,107,1.5,0.42924395,5
2020-08-02-170707,170707,1,0,2,108,0.25,0.67431283,6
2020-08-03-170707,170707,1,0,0,109,1.5,0.7851872,0
2020-08-04-170707,170707,0,0,1,109,1.5,0.5211612,1
2020-08-05-170707,170707,0,0,0,109,3.5,1.370782,2
2020-08-06-170707,170707,1,0,1,110,4.0,1.4012365,3
2020-08-07-170707,170707,0,0,0,110,2.5,0.7608204,4
2020-08-08-170707,170707,0,0,3,110,2.5,1.0374067,5
2020-08-09-170707,170707,0,0,4,110,4.25,1.2634435,6
2020-08-10-170707,170707,0,0,1,110,8.25,2.4274662,0
2020-08-11-170707,170707,1,0,10,111,5.25,2.437503,1
2020-08-12-170707,170707,3,0,1,114,4.5,2.4411051,2
2020-08-13-170707,170707,7,0,9,121,5.0,4.0417886,3
2020-08-14-170707,170707,13,0,4,134,3.75,5.8946686,4
2020-08-15-170707,170707,0,0,13,134,3.75,1.9765892,5
2020-08-16-170707,170707,2,0,14,136,1.5,1.7437482,6
2020-08-17-170707,170707,0,0,1,136,10.0,3.6717691,0
2020-08-18-170707,170707,1,0,4,137,5.0,3.5721118,1
2020-08-19-170707,170707,0,0,2,137,5.75,3.6520364,2
2020-08-20-170707,170707,1,0,3,138,2.75,1.7258871,3
2020-08-21-170707,170707,0,0,7,138,2.75,1.1868664,4
2020-08-22-170707,170707,3,0,0,141,0.5,1.3348926,5
2020-08-23-170707,170707,4,0,2,145,1.0,1.0654569,6
2020-08-24-170707,170707,1,0,1,146,2.75,2.793976,0
2020-08-25-170707,170707,10,0,10,156,1.5,3.224372,1
2020-08-26-170707,170707,1,0,2,157,3.5,2.6370466,2
2020-08-27-170707,170707,9,0,3,166,3.0,2.857226,3
2020-08-28-170707,170707,4,0,5,170,1.5,1.8477796,4
2020-08-29-170707,170707,13,1,1,183,1.5,4.159733,5
2020-08-30-170707,170707,14,0,4,197,1.25,4.0018153,6
2020-08-31-170707,170707,1,0,6,198,1.0,0.56580436,0
2020-09-01-170707,170707,4,0,9,202,1.25,1.4622016,1
2020-09-02-170707,170707,2,0,11,204,0.25,0.553132,2
2020-09-03-170707,170707,3,0,8,207,2.75,1.8058418,3
2020-09-04-170707,170707,7,0,8,214,2.0,2.6685157,4
2020-09-05-170707,170707,0,0,3,214,0.75,0.43202087,5
2020-09-06-170707,170707,2,0,4,216,0.5,0.8076586,6
2020-09-07-170707,170707,1,0,3,217,1.75,1.1672466,0
2020-09-08-170707,170707,10,0,3,227,2.0,2.4024584,1
2020-09-09-170707,170707,2,0,8,229,1.25,0.84450805,2
2020-09-10-170707,170707,3,0,4,232,6.0,2.2007275,3
2020-09-11-170707,170707,5,0,14,237,6.25,3.1667325,4
2020-09-12-170707,170707,1,0,0,238,1.25,1.1181293,5
2020-09-13-170707,170707,4,0,0,242,2.75,1.9700015,6
2020-09-14-170707,170707,6,0,6,248,1.75,2.331537,0
2020-09-15-170707,170707,9,0,1,257,2.75,2.7652833,1
2020-09-16-170707,170707,11,0,5,268,1.5,2.1208827,2
2020-09-17-170707,170707,8,0,10,276,2.0,2.016846,3
2020-09-18-170707,170707,8,0,21,284,2.25,1.6020876,4
2020-09-19-170707,170707,3,0,11,287,1.5,0.7068301,5
2020-09-20-170707,170707,4,0,11,291,2.5,1.1800523,6
2020-09-21-170707,170707,3,0,7,294,3.25,0.8368983,0
2020-09-22-170707,170707,3,0,4,297,3.25,1.6361157,1
2020-09-23-170707,170707,8,0,3,305,1.0,1.3361222,2
2020-09-24-170707,170707,4,0,20,309,1.75,1.4047614,3
2020-09-25-170707,170707,14,0,7,323,2.75,3.6859057,4
2020-09-26-170707,170707,0,0,3,323,1.5,0.8987534,5
2020-09-27-170707,170707,0,0,7,323,1.0,0.48444363,6
2020-09-28-170707,170707,6,1,5,329,1.25,1.8006432,0
2020-09-29-170707,170707,1,0,12,330,0.25,0.32979596,1
2020-09-30-170707,170707,5,0,5,335,1.0,1.4510226,2
2020-10-01-170707,170707,10,0,6,345,1.25,1.5956821,3
2020-10-02-170707,170707,21,1,11,366,0.75,2.8909588,4
2020-10-03-170707,170707,11,0,3,377,0.75,1.9207107,5
2020-10-04-170707,170707,11,0,4,388,1.5,2.5602098,6
2020-10-05-170707,170707,7,1,4,395,0.75,1.7491411,0
2020-10-06-170707,170707,4,0,2,399,1.25,1.5155573,1
2020-10-07-170707,170707,3,0,1,402,1.25,0.9366927,2
2020-10-08-170707,170707,20,1,2,422,3.75,5.8655047,3
2020-10-09-170707,170707,7,0,3,429,2.0,1.4520137,4
2020-10-10-170707,170707,3,0,1,432,2.25,1.5561597,5
2020-10-11-170707,170707,7,0,0,439,3.0,2.1316214,6
2020-10-12-170707,170707,5,0,5,444,2.0,1.7617089,0
2020-10-13-170707,170707,12,0,4,456,1.25,3.0047402,1
2020-10-14-170707,170707,5,0,2,461,1.25,1.4532195,2
2020-10-15-170707,170707,6,0,5,467,1.5,1.7424241,3
2020-10-16-170707,170707,11,0,2,478,1.75,2.6965969,4
2020-10-17-170707,170707,3,1,2,481,1.25,1.7368515,5
2020-10-18-170707,170707,4,0,2,485,3.0,1.2440014,6
2020-10-19-170707,170707,4,1,1,489,2.75,1.6122115,0
2020-10-20-170707,170707,2,1,3,491,1.0,0.9401544,1
2020-10-21-170707,170707,1,0,2,492,3.75,1.7766649,2
2020-10-22-170707,170707,2,0,3,494,3.75,2.0532453,3
2020-10-23-170707,170707,3,0,5,497,3.5,0.82821417,4
2020-10-24-170707,170707,1,0,0,498,3.25,1.4525702,5
2020-10-25-170707,170707,0,1,1,498,2.5,0.66726965,6
2020-10-26-170707,170707,5,0,1,503,2.5,1.5220631,0
2020-10-27-170707,170707,4,0,4,507,1.5,1.0982975,1
2020-10-28-170707,170707,2,0,0,509,4.5,1.8078932,2
2020-10-29-170707,170707,5,0,0,514,5.0,3.900783,3
2020-10-30-170707,170707,2,1,1,516,6.75,1.3487319,4
2020-10-31-170707,170707,2,0,0,518,5.0,2.4675682,5
2020-11-01-170707,170707,2,0,0,520,1.75,0.90268075,6
2020-11-02-170707,170707,1,0,0,521,6.25,1.1506178,0
2020-11-03-170707,170707,3,2,0,524,5.75,2.144282,1
2020-11-04-170707,170707,2,0,0,526,3.5,1.2948238,2
2020-11-05-170707,170707,3,1,0,529,3.0,1.1628548,3
2020-11-06-170707,170707,5,0,0,534,5.5,1.5755527,4
2020-11-07-170707,170707,0,2,0,534,5.0,0.84744066,5
2020-11-08-170707,170707,1,0,0,535,2.75,0.8826192,6
2020-11-09-170707,170707,1,0,0,536,5.25,1.4967672,0
2020-11-10-170707,170707,4,1,0,540,1.25,1.4469509,1
2020-11-11-170707,170707,0,0,0,540,4.5,1.509387,2
2020-11-12-170707,170707,0,2,0,540,5.25,0.7946907,3
2020-11-13-170707,170707,1,0,0,541,1.75,1.0542728,4
2020-03-01-170708,170708,0,0,3,0,0.0,0.00079376315,6
2020-03-02-170708,170708,2,0,37,2,0.3333333333333333,0.00025377003,0
2020-03-03-170708,170708,1,0,36,3,0.3333333333333333,0.0031285747,1
2020-03-04-170708,170708,0,0,43,3,1.0,1.2631683e-06,2
2020-03-05-170708,170708,1,0,49,4,0.0,0.002993528,3
2020-03-06-170708,170708,0,0,45,4,0.3333333333333333,0.25355905,4
2020-03-07-170708,170708,0,0,39,4,0.6666666666666666,0.21681587,5
2020-03-08-170708,170708,0,0,19,4,0.0,2.6786502e-05,6
2020-03-09-170708,170708,0,0,66,4,1.3333333333333333,0.25473437,0
2020-03-10-170708,170708,2,0,67,6,2.6666666666666665,0.26700702,1
2020-03-11-170708,170708,2,0,45,8,2.0,0.264078,2
2020-03-12-170708,170708,1,0,53,9,3.0,1.0044799,3
2020-03-13-170708,170708,3,0,30,12,5.0,0.46793494,4
2020-03-14-170708,170708,2,0,15,14,4.333333333333333,0.43002725,5
2020-03-15-170708,170708,3,0,15,17,3.333333333333333,0.39746967,6
2020-03-16-170708,170708,37,0,58,54,23.33333333333333,2.739036,0
2020-03-17-170708,170708,36,0,32,90,21.33333333333333,2.6662288,1
2020-03-18-170708,170708,43,0,25,133,26.0,3.0101843,2
2020-03-19-170708,170708,49,0,26,182,35.0,3.9262018,3
2020-03-20-170708,170708,45,1,17,227,38.0,2.8915956,4
2020-03-21-170708,170708,39,0,9,266,14.333333333333336,0.88770217,5
2020-03-22-170708,170708,19,0,12,285,20.666666666666668,2.0291305,6
2020-03-23-170708,170708,66,0,25,351,51.66666666666666,5.6138015,0
2020-03-24-170708,170708,67,0,9,418,49.33333333333334,3.7137437,1
2020-03-25-170708,170708,45,1,31,463,41.66666666666666,4.6092362,2
2020-03-26-170708,170708,53,0,18,516,43.0,3.9043887,3
2020-03-27-170708,170708,30,0,22,546,39.333333333333336,4.234713,4
2020-03-28-170708,170708,15,0,0,561,11.666666666666664,0.5596545,5
2020-03-29-170708,170708,15,0,8,576,13.0,0.97892207,6
2020-03-30-170708,170708,58,0,25,634,34.0,4.055114,0
2020-03-31-170708,170708,32,0,7,666,23.66666666666667,2.2377894,1
2020-04-01-170708,170708,25,0,11,691,27.0,3.043004,2
2020-04-02-170708,170708,26,0,8,717,33.333333333333336,6.18991,3
2020-04-03-170708,170708,17,0,10,734,23.0,2.3637712,4
2020-04-04-170708,170708,9,0,2,743,14.333333333333336,2.4816554,5
2020-04-05-170708,170708,12,0,3,755,6.0,0.7682279,6
2020-04-06-170708,170708,25,0,4,780,28.0,4.125346,0
2020-04-07-170708,170708,9,0,9,789,19.33333333333333,1.5877464,1
2020-04-08-170708,170708,31,0,9,820,12.666666666666664,1.5907135,2
2020-04-09-170708,170708,18,0,6,838,6.333333333333332,0.41620395,3
2020-04-10-170708,170708,22,0,4,860,10.0,1.1307353,4
2020-04-11-170708,170708,0,0,4,860,4.666666666666667,0.51849407,5
2020-04-12-170708,170708,8,0,3,868,8.666666666666666,0.98632926,6
2020-04-13-170708,170708,25,0,11,893,17.333333333333332,4.1688166,0
2020-04-14-170708,170708,7,0,15,900,15.333333333333336,2.4361937,1
2020-04-15-170708,170708,11,0,12,911,16.666666666666668,2.593321,2
2020-04-16-170708,170708,8,0,5,919,9.0,1.0422081,3
2020-04-17-170708,170708,10,0,5,929,5.333333333333333,0.8909537,4
2020-04-18-170708,170708,2,0,1,931,17.333333333333332,3.5865507,5
2020-04-19-170708,170708,3,0,6,934,9.0,1.7273431,6
2020-04-20-170708,170708,4,1,13,938,8.0,1.4136487,0
2020-04-21-170708,170708,9,0,19,947,7.333333333333332,1.0184065,1
2020-04-22-170708,170708,9,0,12,956,15.666666666666664,3.6531858,2
2020-04-23-170708,170708,6,0,15,962,3.6666666666666665,0.32771498,3
2020-04-24-170708,170708,4,0,12,966,11.333333333333336,2.0830877,4
2020-04-25-170708,170708,4,0,4,970,3.6666666666666665,0.18926269,5
2020-04-26-170708,170708,3,0,2,973,2.333333333333333,0.16389936,6
2020-04-27-170708,170708,11,0,12,984,7.666666666666668,1.3420913,0
2020-04-28-170708,170708,15,0,11,999,12.0,1.1869291,1
2020-04-29-170708,170708,12,0,16,1011,11.0,1.8064456,2
2020-04-30-170708,170708,5,0,12,1016,14.666666666666664,2.4904313,3
2020-05-01-170708,170708,5,0,12,1021,2.0,0.2608779,4
2020-05-02-170708,170708,1,0,5,1022,3.6666666666666665,0.002520851,5
2020-05-03-170708,170708,6,0,5,1028,0.6666666666666666,0.0027906497,6
2020-05-04-170708,170708,13,0,11,1041,8.0,0.65761054,0
2020-05-05-170708,170708,19,0,11,1060,13.0,1.7784036,1
2020-05-06-170708,170708,12,0,17,1072,7.0,0.86669105,2
2020-05-07-170708,170708,15,0,16,1087,10.666666666666666,1.858997,3
2020-05-08-170708,170708,12,0,12,1099,13.0,1.4110327,4
2020-05-09-170708,170708,4,0,9,1103,5.333333333333333,0.75467044,5
2020-05-10-170708,170708,2,0,4,1105,13.333333333333336,0.387563,6
2020-05-11-170708,170708,12,1,9,1117,16.333333333333332,2.0843656,0
2020-05-12-170708,170708,11,0,14,1128,12.333333333333336,1.7163525,1
2020-05-13-170708,170708,16,0,11,1144,11.666666666666664,1.5164542,2
2020-05-14-170708,170708,12,0,16,1156,12.0,1.4372206,3
2020-05-15-170708,170708,12,1,6,1168,12.666666666666664,2.16871,4
2020-05-16-170708,170708,5,0,0,1173,5.0,0.83814406,5
2020-05-17-170708,170708,5,0,0,1178,8.0,0.8747344,6
2020-05-18-170708,170708,11,0,3,1189,10.666666666666666,2.3786798,0
2020-05-19-170708,170708,11,0,6,1200,13.333333333333336,1.9140043,1
2020-05-20-170708,170708,17,0,5,1217,18.0,2.392411,2
2020-05-21-170708,170708,16,0,2,1233,13.333333333333336,2.0873423,3
2020-05-22-170708,170708,12,0,5,1245,11.333333333333336,2.3631783,4
2020-05-23-170708,170708,9,0,2,1254,7.0,0.53739274,5
2020-05-24-170708,170708,4,0,1,1258,3.6666666666666665,0.5717551,6
2020-05-25-170708,170708,9,0,8,1267,11.0,2.8764367,0
2020-05-26-170708,170708,14,0,8,1281,12.333333333333336,2.7775533,1
2020-05-27-170708,170708,11,0,1,1292,15.333333333333336,1.996509,2
2020-05-28-170708,170708,16,0,7,1308,5.666666666666668,1.2412678,3
2020-05-29-170708,170708,6,1,5,1314,6.333333333333332,0.95110744,4
2020-05-30-170708,170708,0,0,0,1314,1.0,0.006880935,5
2020-05-31-170708,170708,0,0,1,1314,0.3333333333333333,0.0027674993,6
2020-06-01-170708,170708,3,0,3,1317,7.666666666666668,0.7341155,0
2020-06-02-170708,170708,6,0,6,1323,6.666666666666668,0.7684163,1
2020-06-03-170708,170708,5,0,7,1328,3.333333333333333,0.9038894,2
2020-06-04-170708,170708,2,0,6,1330,3.0,0.22481683,3
2020-06-05-170708,170708,5,2,8,1335,3.0,0.21311475,4
2020-06-06-170708,170708,2,0,1,1337,0.6666666666666666,0.1694378,5
2020-06-07-170708,170708,1,0,0,1338,2.0,0.14285113,6
2020-06-08-170708,170708,8,0,5,1346,5.666666666666668,1.4447267,0
2020-06-09-170708,170708,8,1,10,1354,5.0,1.2158191,1
2020-06-10-170708,170708,1,0,2,1355,4.0,0.41362092,2
2020-06-11-170708,170708,7,0,5,1362,3.333333333333333,0.79216564,3
2020-06-12-170708,170708,5,0,10,1367,6.333333333333332,0.9729436,4
2020-06-13-170708,170708,0,0,0,1367,1.0,0.01195778,5
2020-06-14-170708,170708,1,2,0,1368,1.0,0.026692277,6
2020-06-15-170708,170708,3,0,0,1371,5.666666666666668,1.1799161,0
2020-06-16-170708,170708,6,0,2,1377,5.666666666666668,1.1944141,1
2020-06-17-170708,170708,7,0,0,1384,6.0,1.1930512,2
2020-06-18-170708,170708,6,1,6,1390,2.6666666666666665,0.44431764,3
2020-06-19-170708,170708,8,0,2,1398,3.333333333333333,0.7522371,4
2020-06-20-170708,170708,1,0,2,1399,0.6666666666666666,0.3549236,5
2020-06-21-170708,170708,0,0,1,1399,0.6666666666666666,0.15079163,6
2020-06-22-170708,170708,5,0,5,1404,4.0,0.64544886,0
2020-06-23-170708,170708,10,0,4,1414,5.333333333333333,0.865274,1
2020-06-24-170708,170708,2,2,4,1416,4.0,0.22949012,2
2020-06-25-170708,170708,5,1,4,1421,3.333333333333333,0.9086895,3
2020-06-26-170708,170708,10,0,4,1431,3.6666666666666665,0.89121455,4
2020-06-27-170708,170708,0,0,0,1431,1.0,0.17782107,5
2020-06-28-170708,170708,0,0,3,1431,0.0,0.008112498,6
2020-06-29-170708,170708,0,0,6,1431,1.0,0.012555098,0
2020-06-30-170708,170708,2,0,2,1433,1.6666666666666667,0.2322456,1
2020-07-01-170708,170708,0,0,6,1433,1.6666666666666667,0.22462627,2
2020-07-02-170708,170708,6,0,2,1439,2.333333333333333,0.67844224,3
2020-07-03-170708,170708,2,0,2,1441,2.6666666666666665,0.4969118,4
2020-07-04-170708,170708,2,0,0,1443,1.3333333333333333,0.1961064,5
2020-07-05-170708,170708,1,0,1,1444,0.3333333333333333,0.0004906101,6
2020-07-06-170708,170708,5,0,1,1449,3.333333333333333,0.4196921,0
2020-07-07-170708,170708,4,0,7,1453,0.6666666666666666,0.20591392,1
2020-07-08-170708,170708,4,1,1,1457,1.0,0.21099241,2
2020-07-09-170708,170708,4,0,2,1461,3.0,0.85538006,3
2020-07-10-170708,170708,4,0,0,1465,3.0,0.68828535,4
2020-07-11-170708,170708,0,0,2,1465,2.0,0.20633733,5
2020-07-12-170708,170708,3,0,1,1468,0.3333333333333333,0.16005133,6
2020-07-13-170708,170708,6,0,0,1474,1.3333333333333333,0.44323385,0
2020-07-14-170708,170708,2,0,1,1476,0.6666666666666666,0.030504074,1
2020-07-15-170708,170708,6,0,1,1482,4.0,1.2711439,2
2020-07-16-170708,170708,2,0,1,1484,5.0,0.88331485,3
2020-07-17-170708,170708,2,0,4,1486,3.333333333333333,0.9136886,4
2020-07-18-170708,170708,0,0,0,1486,0.3333333333333333,0.20540367,5
2020-07-19-170708,170708,1,0,3,1487,1.0,0.2818088,6
2020-07-20-170708,170708,1,0,1,1488,1.3333333333333333,0.2590094,0
2020-07-21-170708,170708,7,0,3,1495,3.333333333333333,0.5952118,1
2020-07-22-170708,170708,1,0,1,1496,3.6666666666666665,1.2543919,2
2020-07-23-170708,170708,2,0,3,1498,2.0,0.881281,3
2020-07-24-170708,170708,0,0,2,1498,2.333333333333333,0.52493024,4
2020-07-25-170708,170708,2,0,2,1500,1.0,0.19184881,5
2020-07-26-170708,170708,1,0,2,1501,0.6666666666666666,0.0024715562,6
2020-07-27-170708,170708,0,0,1,1501,2.333333333333333,0.6094792,0
2020-07-28-170708,170708,1,0,2,1502,1.6666666666666667,1.0116221,1
2020-07-29-170708,170708,1,0,4,1503,2.0,0.2643091,2
2020-07-30-170708,170708,1,0,5,1504,2.6666666666666665,0.48975375,3
2020-07-31-170708,170708,4,0,6,1508,2.6666666666666665,0.23150101,4
2020-08-01-170708,170708,0,0,1,1508,0.6666666666666666,0.18927829,5
2020-08-02-170708,170708,3,0,1,1511,1.3333333333333333,0.31187415,6
2020-08-03-170708,170708,1,0,2,1512,4.0,0.4393438,0
2020-08-04-170708,170708,3,0,4,1515,1.3333333333333333,0.19754247,1
2020-08-05-170708,170708,1,0,11,1516,4.333333333333333,1.2811594,2
2020-08-06-170708,170708,3,0,13,1519,2.333333333333333,1.2311653,3
2020-08-07-170708,170708,2,0,6,1521,4.333333333333333,0.8210162,4
2020-08-08-170708,170708,2,0,4,1523,0.6666666666666666,0.045386173,5
2020-08-09-170708,170708,2,0,1,1525,1.6666666666666667,0.21325387,6
2020-08-10-170708,170708,1,0,6,1526,2.6666666666666665,0.30889547,0
2020-08-11-170708,170708,2,0,8,1528,4.0,0.9759483,1
2020-08-12-170708,170708,4,0,2,1532,6.666666666666668,0.66565174,2
2020-08-13-170708,170708,5,0,3,1537,4.0,1.9890026,3
2020-08-14-170708,170708,6,0,9,1543,2.333333333333333,0.76857364,4
2020-08-15-170708,170708,1,0,3,1544,1.3333333333333333,0.22023349,5
2020-08-16-170708,170708,1,0,1,1545,1.0,0.21088205,6
2020-08-17-170708,170708,2,0,2,1547,7.666666666666668,2.036533,0
2020-08-18-170708,170708,4,0,8,1551,5.666666666666668,0.61434716,1
2020-08-19-170708,170708,11,0,11,1562,3.0,1.1015885,2
2020-08-20-170708,170708,13,0,7,1575,6.666666666666668,0.827201,3
2020-08-21-170708,170708,6,0,9,1581,8.0,1.4632587,4
2020-08-22-170708,170708,4,0,9,1585,5.333333333333333,1.1970106,5
2020-08-23-170708,170708,1,0,2,1586,2.0,0.16007227,6
2020-08-24-170708,170708,6,0,8,1592,7.333333333333332,1.402669,0
2020-08-25-170708,170708,8,0,8,1600,9.333333333333334,2.2610285,1
2020-08-26-170708,170708,2,0,7,1602,5.0,0.909797,2
2020-08-27-170708,170708,3,0,6,1605,7.0,1.9020004,3
2020-08-28-170708,170708,9,0,8,1614,5.0,0.6500945,4
2020-08-29-170708,170708,3,0,6,1617,6.333333333333332,0.4031696,5
2020-08-30-170708,170708,1,0,2,1618,1.6666666666666667,0.4985985,6
2020-08-31-170708,170708,2,0,20,1620,7.0,2.199239,0
2020-09-01-170708,170708,8,0,15,1628,2.0,0.7041295,1
2020-09-02-170708,170708,11,0,12,1639,5.0,0.54891574,2
2020-09-03-170708,170708,7,0,19,1646,6.0,1.687784,3
2020-09-04-170708,170708,9,0,5,1655,7.666666666666668,0.6368916,4
2020-09-05-170708,170708,9,0,9,1664,1.3333333333333333,0.4742908,5
2020-09-06-170708,170708,2,0,4,1666,2.0,0.22161907,6
2020-09-07-170708,170708,8,0,10,1674,8.0,1.7158753,0
2020-09-08-170708,170708,8,0,10,1682,8.666666666666666,2.7954922,1
2020-09-09-170708,170708,7,0,10,1689,8.0,1.5575235,2
2020-09-10-170708,170708,6,0,9,1695,6.666666666666668,1.1260973,3
2020-09-11-170708,170708,8,0,23,1703,5.333333333333333,1.1883948,4
2020-09-12-170708,170708,6,0,1,1709,5.333333333333333,1.2244006,5
2020-09-13-170708,170708,2,0,0,1711,0.3333333333333333,0.03206417,6
2020-09-14-170708,170708,20,0,3,1731,15.0,3.9092002,0
2020-09-15-170708,170708,15,0,8,1746,7.0,0.7616537,1
2020-09-16-170708,170708,12,0,6,1758,9.0,0.99180156,2
2020-09-17-170708,170708,19,0,3,1777,10.0,2.5397913,3
2020-09-18-170708,170708,5,0,4,1782,10.666666666666666,1.8468052,4
2020-09-19-170708,170708,9,1,2,1791,4.666666666666667,0.76042277,5
2020-09-20-170708,170708,4,2,6,1795,7.333333333333332,0.982602,6
2020-09-21-170708,170708,10,0,4,1805,16.666666666666668,2.3444316,0
2020-09-22-170708,170708,10,2,5,1815,7.666666666666668,1.6046716,1
2020-09-23-170708,170708,10,0,3,1825,9.0,2.037581,2
2020-09-24-170708,170708,9,0,4,1834,11.333333333333336,2.1592522,3
2020-09-25-170708,170708,23,1,6,1857,13.333333333333336,4.197463,4
2020-09-26-170708,170708,1,0,1,1858,2.0,0.64817476,5
2020-09-27-170708,170708,0,0,3,1858,2.0,0.69890165,6
2020-09-28-170708,170708,3,0,0,1861,11.333333333333336,3.269151,0
2020-09-29-170708,170708,8,0,5,1869,4.666666666666667,1.0294636,1
2020-09-30-170708,170708,6,0,2,1875,6.666666666666668,0.9558536,2
2020-10-01-170708,170708,3,0,7,1878,9.0,1.0633532,3
2020-10-02-170708,170708,4,0,10,1882,8.333333333333334,2.4364593,4
2020-10-03-170708,170708,2,0,6,1884,4.0,0.67661476,5
2020-10-04-170708,170708,6,0,9,1890,1.0,0.5566488,6
2020-10-05-170708,170708,4,0,6,1894,7.333333333333332,1.416461,0
2020-10-06-170708,170708,5,0,5,1899,5.0,2.2897823,1
2020-10-07-170708,170708,3,1,12,1902,9.333333333333334,1.4814068,2
2020-10-08-170708,170708,4,1,6,1906,5.333333333333333,1.5839983,3
2020-10-09-170708,170708,6,1,9,1912,8.0,1.3282924,4
2020-10-10-170708,170708,1,0,0,1913,3.6666666666666665,0.38996994,5
2020-10-11-170708,170708,3,0,5,1916,3.6666666666666665,0.95139897,6
2020-10-12-170708,170708,0,0,3,1916,3.0,0.6469155,0
2020-10-13-170708,170708,5,0,8,1921,7.333333333333332,1.5406585,1
2020-10-14-170708,170708,2,0,13,1923,8.0,0.88090444,2
2020-10-15-170708,170708,7,0,9,1930,12.666666666666664,2.3843813,3
2020-10-16-170708,170708,10,0,2,1940,11.0,3.3626912,4
2020-10-17-170708,170708,6,0,6,1946,9.0,0.25257233,5
2020-10-18-170708,170708,9,0,5,1955,3.6666666666666665,0.76338613,6
2020-10-19-170708,170708,6,0,7,1961,10.666666666666666,1.6040076,0
2020-10-20-170708,170708,5,0,11,1966,5.333333333333333,0.88993883,1
2020-10-21-170708,170708,12,0,10,1978,8.0,1.3247274,2
2020-10-22-170708,170708,6,0,8,1984,16.0,4.4275694,3
2020-10-23-170708,170708,9,0,3,1993,13.333333333333336,1.640894,4
2020-10-24-170708,170708,0,0,2,1993,4.333333333333333,0.5841479,5
2020-10-25-170708,170708,5,0,1,1998,3.6666666666666665,0.76532245,6
2020-10-26-170708,170708,3,1,6,2001,1.6666666666666667,0.21882424,0
2020-10-27-170708,170708,8,0,7,2009,13.0,2.0511172,1
2020-10-28-170708,170708,13,1,3,2022,7.666666666666668,1.6259041,2
2020-10-29-170708,170708,9,0,4,2031,10.333333333333334,2.0093136,3
2020-10-30-170708,170708,2,0,7,2033,11.333333333333336,1.250333,4
2020-10-31-170708,170708,6,1,0,2039,5.0,1.0979404,5
2020-11-01-170708,170708,5,1,0,2044,4.0,0.49419796,6
2020-11-02-170708,170708,7,0,0,2051,7.333333333333332,0.6112054,0
2020-11-03-170708,170708,11,0,0,2062,8.666666666666666,1.9756234,1
2020-11-04-170708,170708,10,0,0,2072,7.666666666666668,1.8755736,2
2020-11-05-170708,170708,8,2,0,2080,11.0,1.5605425,3
2020-11-06-170708,170708,3,2,0,2083,11.666666666666664,2.4412167,4
2020-11-07-170708,170708,2,0,0,2085,2.333333333333333,0.1562252,5
2020-11-08-170708,170708,1,0,0,2086,1.6666666666666667,0.022976363,6
2020-11-09-170708,170708,6,0,0,2092,10.0,2.0122535,0
2020-11-10-170708,170708,7,1,0,2099,4.333333333333333,0.86984694,1
2020-11-11-170708,170708,3,1,0,2102,7.0,1.5262495,2
2020-11-12-170708,170708,4,1,0,2106,10.666666666666666,0.4922872,3
2020-11-13-170708,170708,7,1,0,2113,12.333333333333336,4.40906,4
2020-03-01-170709,170709,0,0,6,0,0.0,0.0015349654,6
2020-03-02-170709,170709,0,1,39,0,1.0,0.000314216,0
2020-03-03-170709,170709,1,1,29,1,0.3333333333333333,0.008287073,1
2020-03-04-170709,170709,2,0,33,3,0.3333333333333333,1.1819196e-05,2
2020-03-05-170709,170709,0,0,39,3,0.3333333333333333,0.006878957,3
2020-03-06-170709,170709,0,1,51,3,0.3333333333333333,0.5789934,4
2020-03-07-170709,170709,1,0,24,4,0.3333333333333333,0.45175686,5
2020-03-08-170709,170709,0,0,13,4,0.0,4.5670444e-05,6
2020-03-09-170709,170709,3,0,59,7,0.3333333333333333,0.5502252,0
2020-03-10-170709,170709,7,0,71,14,1.0,0.5696904,1
2020-03-11-170709,170709,4,0,49,18,1.3333333333333333,0.56606,2
2020-03-12-170709,170709,1,0,52,19,3.0,2.2720242,3
2020-03-13-170709,170709,11,0,41,30,2.333333333333333,1.052298,4
2020-03-14-170709,170709,9,0,14,39,2.0,1.0902616,5
2020-03-15-170709,170709,6,0,17,45,2.333333333333333,0.99947554,6
2020-03-16-170709,170709,39,0,23,84,22.66666666666667,6.3509865,0
2020-03-17-170709,170709,29,0,27,113,23.66666666666667,7.0611157,1
2020-03-18-170709,170709,33,0,25,146,29.33333333333333,7.364408,2
2020-03-19-170709,170709,39,0,15,185,38.333333333333336,9.224886,3
2020-03-20-170709,170709,51,2,22,236,36.0,7.71236,4
2020-03-21-170709,170709,24,0,12,260,19.33333333333333,2.601685,5
2020-03-22-170709,170709,13,0,2,273,22.66666666666667,5.3525066,6
2020-03-23-170709,170709,59,0,30,332,54.0,15.582046,0
2020-03-24-170709,170709,71,0,25,403,48.0,9.956819,1
2020-03-25-170709,170709,49,0,11,452,40.333333333333336,11.232815,2
2020-03-26-170709,170709,52,0,6,504,43.33333333333334,10.322824,3
2020-03-27-170709,170709,41,0,9,545,35.666666666666664,11.244719,4
2020-03-28-170709,170709,14,0,3,559,12.0,1.4777057,5
2020-03-29-170709,170709,17,0,8,576,12.333333333333336,2.7457576,6
2020-03-30-170709,170709,23,0,8,599,45.66666666666666,10.771068,0
2020-03-31-170709,170709,27,0,10,626,25.33333333333333,5.9774814,1
2020-04-01-170709,170709,25,0,11,651,27.0,7.312257,2
2020-04-02-170709,170709,15,0,9,666,37.0,15.656076,3
2020-04-03-170709,170709,22,0,7,688,21.33333333333333,5.9808187,4
2020-04-04-170709,170709,12,0,4,700,13.333333333333336,6.8433433,5
2020-04-05-170709,170709,2,0,2,702,9.333333333333334,2.078207,6
2020-04-06-170709,170709,30,0,6,732,26.33333333333333,10.517497,0
2020-04-07-170709,170709,25,0,9,757,14.0,3.9550307,1
2020-04-08-170709,170709,11,0,8,768,19.33333333333333,3.8850222,2
2020-04-09-170709,170709,6,0,5,774,10.333333333333334,1.1552349,3
2020-04-10-170709,170709,9,0,7,783,14.333333333333336,2.820509,4
2020-04-11-170709,170709,3,0,6,786,3.6666666666666665,1.4478093,5
2020-04-12-170709,170709,8,0,1,794,8.666666666666666,2.5271869,6
2020-04-13-170709,170709,8,0,5,802,23.0,10.163636,0
2020-04-14-170709,170709,10,0,9,812,14.333333333333336,6.4194264,1
2020-04-15-170709,170709,11,0,5,823,16.666666666666668,6.6246424,2
2020-04-16-170709,170709,9,0,14,832,8.666666666666666,2.6561253,3
2020-04-17-170709,170709,7,0,1,839,6.333333333333332,2.46502,4
2020-04-18-170709,170709,4,0,3,843,16.666666666666668,9.4537,5
2020-04-19-170709,170709,2,0,1,845,9.333333333333334,4.4973607,6
2020-04-20-170709,170709,6,0,9,851,7.333333333333332,3.5496988,0
2020-04-21-170709,170709,9,0,12,860,7.333333333333332,2.6792047,1
2020-04-22-170709,170709,8,0,6,868,16.0,9.6297,2
2020-04-23-170709,170709,5,0,8,873,4.0,0.9601157,3
2020-04-24-170709,170709,7,0,13,880,10.333333333333334,5.5064874,4
2020-04-25-170709,170709,6,0,5,886,3.0,0.5064575,5
2020-04-26-170709,170709,1,0,8,887,3.0,0.467329,6
2020-04-27-170709,170709,5,0,12,892,9.666666666666666,3.575445,0
2020-04-28-170709,170709,9,0,16,901,14.0,2.95731,1
2020-04-29-170709,170709,5,0,14,906,13.333333333333336,4.618511,2
2020-04-30-170709,170709,14,0,15,920,11.666666666666664,6.0249195,3
2020-05-01-170709,170709,1,0,11,921,3.333333333333333,0.6571009,4
2020-05-02-170709,170709,3,0,4,924,3.0,0.009093452,5
2020-05-03-170709,170709,1,0,15,925,2.333333333333333,0.007467203,6
2020-05-04-170709,170709,9,0,5,934,9.333333333333334,1.694498,0
2020-05-05-170709,170709,12,0,12,946,15.333333333333336,4.5822473,1
2020-05-06-170709,170709,6,0,21,952,9.0,2.2983742,2
2020-05-07-170709,170709,8,0,14,960,13.0,4.732295,3
2020-05-08-170709,170709,13,0,8,973,12.666666666666664,3.7014737,4
2020-05-09-170709,170709,5,5,9,978,5.0,1.9638115,5
2020-05-10-170709,170709,8,0,3,986,11.333333333333336,0.96569544,6
2020-05-11-170709,170709,12,0,12,998,16.333333333333332,4.941351,0
2020-05-12-170709,170709,16,0,13,1014,10.666666666666666,4.2059836,1
2020-05-13-170709,170709,14,0,21,1028,12.333333333333336,3.8023145,2
2020-05-14-170709,170709,15,1,3,1043,11.0,3.8254583,3
2020-05-15-170709,170709,11,0,8,1054,13.0,5.354878,4
2020-05-16-170709,170709,4,0,1,1058,5.333333333333333,2.1331148,5
2020-05-17-170709,170709,15,0,0,1073,4.666666666666667,2.1483114,6
2020-05-18-170709,170709,5,0,8,1078,12.666666666666664,6.029985,0
2020-05-19-170709,170709,12,0,8,1090,13.0,4.5155187,1
2020-05-20-170709,170709,21,0,3,1111,16.666666666666668,6.0399094,2
2020-05-21-170709,170709,14,1,4,1125,14.0,5.358195,3
2020-05-22-170709,170709,8,0,6,1133,12.666666666666664,5.7149305,4
2020-05-23-170709,170709,9,0,0,1142,7.0,1.3066819,5
2020-05-24-170709,170709,3,0,3,1145,4.0,1.4215505,6
2020-05-25-170709,170709,12,0,4,1157,10.0,6.284421,0
2020-05-26-170709,170709,13,0,1,1170,12.666666666666664,6.177915,1
2020-05-27-170709,170709,21,0,5,1191,12.0,4.621592,2
2020-05-28-170709,170709,3,2,3,1194,10.0,2.8656452,3
2020-05-29-170709,170709,8,0,8,1202,5.666666666666668,2.0491843,4
2020-05-30-170709,170709,1,0,0,1203,0.6666666666666666,0.029258134,5
2020-05-31-170709,170709,0,0,1,1203,0.3333333333333333,0.013246284,6
2020-06-01-170709,170709,8,0,9,1211,6.0,1.7086107,0
2020-06-02-170709,170709,8,0,3,1219,6.0,1.7144442,1
2020-06-03-170709,170709,3,0,4,1222,4.0,2.106004,2
2020-06-04-170709,170709,4,0,3,1226,2.333333333333333,0.5006211,3
2020-06-05-170709,170709,6,1,6,1232,2.6666666666666665,0.47135103,4
2020-06-06-170709,170709,0,0,0,1232,1.3333333333333333,0.38356924,5
2020-06-07-170709,170709,3,0,1,1235,1.3333333333333333,0.32060844,6
2020-06-08-170709,170709,4,0,2,1239,7.0,3.203521,0
2020-06-09-170709,170709,1,0,7,1240,7.333333333333332,2.6776638,1
2020-06-10-170709,170709,5,0,3,1245,2.6666666666666665,0.88954,2
2020-06-11-170709,170709,3,0,3,1248,4.666666666666667,1.6827762,3
2020-06-12-170709,170709,8,0,3,1256,5.333333333333333,2.1522155,4
2020-06-13-170709,170709,0,0,0,1256,1.0,0.032402713,5
2020-06-14-170709,170709,1,0,0,1257,1.0,0.059638385,6
2020-06-15-170709,170709,9,0,2,1266,3.6666666666666665,2.6514647,0
2020-06-16-170709,170709,3,0,0,1269,6.666666666666668,2.7346585,1
2020-06-17-170709,170709,4,0,3,1273,7.0,2.727279,2
2020-06-18-170709,170709,3,0,3,1276,3.6666666666666665,0.96577525,3
2020-06-19-170709,170709,6,0,3,1282,4.0,1.5369133,4
2020-06-20-170709,170709,0,0,3,1282,1.0,0.79627365,5
2020-06-21-170709,170709,1,0,0,1283,0.3333333333333333,0.33997047,6
2020-06-22-170709,170709,2,0,7,1285,5.0,1.4245173,0
2020-06-23-170709,170709,7,1,1,1292,6.333333333333332,1.7891804,1
2020-06-24-170709,170709,3,0,2,1295,3.6666666666666665,0.46372956,2
2020-06-25-170709,170709,3,0,1,1298,4.0,1.9111093,3
2020-06-26-170709,170709,3,0,4,1301,6.0,1.9046394,4
2020-06-27-170709,170709,0,0,3,1301,1.0,0.41078213,5
2020-06-28-170709,170709,0,0,0,1301,0.0,0.01783955,6
2020-06-29-170709,170709,2,0,3,1303,0.3333333333333333,0.02791676,0
2020-06-30-170709,170709,0,0,0,1303,2.333333333333333,0.3944772,1
2020-07-01-170709,170709,3,0,2,1306,0.6666666666666666,0.36682954,2
2020-07-02-170709,170709,3,0,5,1309,3.333333333333333,1.1700628,3
2020-07-03-170709,170709,3,0,4,1312,2.333333333333333,0.7781993,4
2020-07-04-170709,170709,3,0,0,1315,1.0,0.32971275,5
2020-07-05-170709,170709,0,0,1,1315,0.6666666666666666,0.0008077374,6
2020-07-06-170709,170709,7,0,1,1322,2.6666666666666665,0.7016197,0
2020-07-07-170709,170709,1,0,2,1323,1.6666666666666667,0.32349613,1
2020-07-08-170709,170709,2,0,2,1325,1.6666666666666667,0.34503692,2
2020-07-09-170709,170709,1,0,2,1326,4.0,1.396088,3
2020-07-10-170709,170709,4,0,3,1330,3.0,0.9923074,4
2020-07-11-170709,170709,3,0,1,1333,1.0,0.31284592,5
2020-07-12-170709,170709,0,0,1,1333,1.3333333333333333,0.23437706,6
2020-07-13-170709,170709,3,0,3,1336,2.333333333333333,0.66906786,0
2020-07-14-170709,170709,0,0,0,1336,1.3333333333333333,0.053725965,1
2020-07-15-170709,170709,2,0,4,1338,5.333333333333333,2.0083628,2
2020-07-16-170709,170709,5,0,2,1343,4.0,1.3498861,3
2020-07-17-170709,170709,4,0,2,1347,2.6666666666666665,1.2965587,4
2020-07-18-170709,170709,0,0,1,1347,0.3333333333333333,0.32106027,5
2020-07-19-170709,170709,1,0,1,1348,1.0,0.44525778,6
2020-07-20-170709,170709,1,0,4,1349,1.3333333333333333,0.42712376,0
2020-07-21-170709,170709,2,1,1,1351,5.0,0.96011454,1
2020-07-22-170709,170709,2,0,3,1353,3.333333333333333,2.02575,2
2020-07-23-170709,170709,2,0,1,1355,2.0,1.2897345,3
2020-07-24-170709,170709,3,0,6,1358,1.3333333333333333,0.76170766,4
2020-07-25-170709,170709,1,0,1,1359,1.3333333333333333,0.26739952,5
2020-07-26-170709,170709,1,0,1,1360,0.6666666666666666,0.0032101346,6
2020-07-27-170709,170709,3,0,5,1363,1.3333333333333333,0.9599981,0
2020-07-28-170709,170709,0,0,0,1363,2.0,1.5579299,1
2020-07-29-170709,170709,4,0,7,1367,1.0,0.38652354,2
2020-07-30-170709,170709,2,0,2,1369,2.333333333333333,0.7944852,3
2020-07-31-170709,170709,2,1,2,1371,3.333333333333333,0.34329066,4
2020-08-01-170709,170709,1,0,3,1372,0.3333333333333333,0.29418275,5
2020-08-02-170709,170709,1,0,1,1373,2.0,0.4524948,6
2020-08-03-170709,170709,4,0,4,1377,3.0,0.6870452,0
2020-08-04-170709,170709,1,0,5,1378,2.0,0.32731852,1
2020-08-05-170709,170709,3,0,5,1381,3.6666666666666665,1.968819,2
2020-08-06-170709,170709,1,0,14,1382,3.0,1.8193271,3
2020-08-07-170709,170709,6,0,10,1388,3.0,1.267798,4
2020-08-08-170709,170709,1,0,6,1389,1.0,0.083635405,5
2020-08-09-170709,170709,1,0,0,1390,2.0,0.34600484,6
2020-08-10-170709,170709,5,0,5,1395,1.3333333333333333,0.4925805,0
2020-08-11-170709,170709,0,0,6,1395,4.666666666666667,1.566942,1
2020-08-12-170709,170709,7,0,6,1402,5.666666666666668,1.0854659,2
2020-08-13-170709,170709,2,0,3,1404,5.0,2.9501157,3
2020-08-14-170709,170709,2,0,5,1406,3.6666666666666665,1.2160131,4
2020-08-15-170709,170709,3,0,10,1409,0.6666666666666666,0.33979467,5
2020-08-16-170709,170709,1,0,1,1410,1.0,0.32451335,6
2020-08-17-170709,170709,4,0,3,1414,7.0,3.2237785,0
2020-08-18-170709,170709,5,0,2,1419,5.333333333333333,0.9408057,1
2020-08-19-170709,170709,5,0,6,1424,5.0,1.4994764,2
2020-08-20-170709,170709,14,0,5,1438,6.333333333333332,1.2179847,3
2020-08-21-170709,170709,10,0,7,1448,6.666666666666668,2.1953666,4
2020-08-22-170709,170709,6,0,2,1454,4.666666666666667,1.8890628,5
2020-08-23-170709,170709,0,0,2,1454,2.333333333333333,0.2451085,6
2020-08-24-170709,170709,5,0,3,1459,7.666666666666668,2.118204,0
2020-08-25-170709,170709,6,0,10,1465,10.0,3.4330387,1
2020-08-26-170709,170709,6,0,4,1471,3.6666666666666665,1.3897808,2
2020-08-27-170709,170709,3,0,11,1474,7.0,2.7320957,3
2020-08-28-170709,170709,5,0,3,1479,6.333333333333332,1.0187737,4
2020-08-29-170709,170709,10,0,8,1489,4.0,0.5975914,5
2020-08-30-170709,170709,1,0,1,1490,1.6666666666666667,0.70030415,6
2020-08-31-170709,170709,3,0,10,1493,6.666666666666668,3.4822562,0
2020-09-01-170709,170709,2,0,6,1495,4.0,1.1951637,1
2020-09-02-170709,170709,6,0,7,1501,6.666666666666668,0.9747515,2
2020-09-03-170709,170709,5,1,6,1506,6.666666666666668,2.65535,3
2020-09-04-170709,170709,7,0,9,1513,8.333333333333334,0.94962835,4
2020-09-05-170709,170709,2,0,4,1515,3.6666666666666665,0.8485656,5
2020-09-06-170709,170709,2,0,3,1517,2.0,0.3375162,6
2020-09-07-170709,170709,3,0,11,1520,9.666666666666666,2.7719698,0
2020-09-08-170709,170709,10,0,6,1530,8.0,4.1270294,1
2020-09-09-170709,170709,4,0,11,1534,9.0,2.5308099,2
2020-09-10-170709,170709,11,0,11,1545,5.0,1.7476448,3
2020-09-11-170709,170709,3,0,12,1548,7.0,1.8261139,4
2020-09-12-170709,170709,8,0,2,1556,4.666666666666667,1.9195104,5
2020-09-13-170709,170709,1,0,1,1557,0.6666666666666666,0.04897561,6
2020-09-14-170709,170709,10,0,13,1567,18.33333333333333,6.1937943,0
2020-09-15-170709,170709,6,0,4,1573,10.0,1.1998776,1
2020-09-16-170709,170709,7,0,6,1580,10.666666666666666,1.5636728,2
2020-09-17-170709,170709,6,0,7,1586,14.333333333333336,3.8746252,3
2020-09-18-170709,170709,9,1,9,1595,9.333333333333334,2.9136968,4
2020-09-19-170709,170709,4,0,6,1599,6.333333333333332,1.1346536,5
2020-09-20-170709,170709,3,0,0,1602,7.666666666666668,1.6569335,6
2020-09-21-170709,170709,11,0,5,1613,16.333333333333332,3.5609508,0
2020-09-22-170709,170709,6,1,2,1619,9.0,2.6744077,1
2020-09-23-170709,170709,11,1,4,1630,8.666666666666666,3.3167787,2
2020-09-24-170709,170709,11,0,4,1641,10.666666666666666,3.9348361,3
2020-09-25-170709,170709,12,0,7,1653,17.0,7.2234774,4
2020-09-26-170709,170709,2,0,6,1655,1.6666666666666667,1.076708,5
2020-09-27-170709,170709,1,0,5,1656,1.6666666666666667,1.1247834,6
2020-09-28-170709,170709,13,0,5,1669,8.0,4.9449115,0
2020-09-29-170709,170709,4,0,9,1673,6.0,1.8523378,1
2020-09-30-170709,170709,6,0,11,1679,6.666666666666668,1.7461662,2
2020-10-01-170709,170709,7,0,8,1686,7.666666666666668,1.6117617,3
2020-10-02-170709,170709,9,0,8,1695,6.666666666666668,4.67364,4
2020-10-03-170709,170709,6,0,12,1701,2.6666666666666665,1.2017549,5
2020-10-04-170709,170709,0,0,4,1701,3.0,1.0531282,6
2020-10-05-170709,170709,5,1,11,1706,7.0,2.488716,0
2020-10-06-170709,170709,2,0,5,1708,6.0,4.258751,1
2020-10-07-170709,170709,4,0,5,1712,9.0,2.696126,2
2020-10-08-170709,170709,4,2,9,1716,5.333333333333333,2.8383315,3
2020-10-09-170709,170709,7,1,20,1723,7.666666666666668,2.1845205,4
2020-10-10-170709,170709,6,0,8,1729,2.0,0.6776832,5
2020-10-11-170709,170709,5,0,0,1734,3.0,1.5196173,6
2020-10-12-170709,170709,5,0,1,1739,1.3333333333333333,1.1311436,0
2020-10-13-170709,170709,9,0,7,1748,6.0,2.7054842,1
2020-10-14-170709,170709,11,0,8,1759,5.0,1.5843524,2
2020-10-15-170709,170709,8,0,9,1767,12.333333333333336,4.078394,3
2020-10-16-170709,170709,8,0,6,1775,11.666666666666664,5.9784684,4
2020-10-17-170709,170709,12,0,8,1787,7.0,0.43457216,5
2020-10-18-170709,170709,4,1,4,1791,5.333333333333333,1.3987882,6
2020-10-19-170709,170709,11,0,10,1802,9.0,2.6478424,0
2020-10-20-170709,170709,5,0,6,1807,5.333333333333333,1.6244522,1
2020-10-21-170709,170709,5,0,7,1812,10.333333333333334,2.529812,2
2020-10-22-170709,170709,9,0,8,1821,15.0,8.070569,3
2020-10-23-170709,170709,20,0,15,1841,9.666666666666666,3.0732052,4
2020-10-24-170709,170709,8,1,5,1849,1.6666666666666667,1.0877194,5
2020-10-25-170709,170709,0,1,3,1849,5.333333333333333,1.5073041,6
2020-10-26-170709,170709,1,1,9,1850,2.333333333333333,0.48523596,0
2020-10-27-170709,170709,7,0,3,1857,13.333333333333336,3.9310808,1
2020-10-28-170709,170709,8,0,10,1865,9.333333333333334,3.1930108,2
2020-10-29-170709,170709,9,0,11,1874,10.333333333333334,3.4863987,3
2020-10-30-170709,170709,6,0,14,1880,10.0,2.233494,4
2020-10-31-170709,170709,8,1,0,1888,4.333333333333333,2.1451032,5
2020-11-01-170709,170709,4,0,0,1892,4.333333333333333,0.90994865,6
2020-11-02-170709,170709,10,0,0,1902,6.333333333333332,1.2760462,0
2020-11-03-170709,170709,6,0,0,1908,10.333333333333334,4.216901,1
2020-11-04-170709,170709,7,0,0,1915,8.666666666666666,3.6188529,2
2020-11-05-170709,170709,8,0,0,1923,11.0,3.156785,3
2020-11-06-170709,170709,15,0,0,1938,7.666666666666668,4.6313252,4
2020-11-07-170709,170709,5,1,0,1943,1.3333333333333333,0.32346332,5
2020-11-08-170709,170709,3,0,0,1946,1.0,0.06484528,6
2020-11-09-170709,170709,9,0,0,1955,9.0,4.1031923,0
2020-11-10-170709,170709,3,0,0,1958,5.666666666666668,1.6763732,1
2020-11-11-170709,170709,10,0,0,1968,4.666666666666667,2.98178,2
2020-11-12-170709,170709,11,0,0,1979,8.333333333333334,0.983643,3
2020-11-13-170709,170709,14,0,0,1993,10.0,8.281351,4
2020-03-01-170710,170710,0,0,0,0,0.0,0.0012262631,6
2020-03-02-170710,170710,1,0,11,1,0.6666666666666666,0.00015760836,0
2020-03-03-170710,170710,0,0,12,1,0.6666666666666666,0.007409993,1
2020-03-04-170710,170710,1,0,22,2,0.6666666666666666,1.6214199e-06,2
2020-03-05-170710,170710,0,0,33,2,0.3333333333333333,0.006545785,3
2020-03-06-170710,170710,0,0,39,2,0.3333333333333333,0.4584156,4
2020-03-07-170710,170710,0,0,10,2,0.6666666666666666,0.4001535,5
2020-03-08-170710,170710,0,1,22,2,0.0,0.00029086397,6
2020-03-09-170710,170710,0,0,45,2,1.3333333333333333,0.42644244,0
2020-03-10-170710,170710,1,0,42,3,3.0,0.43787315,1
2020-03-11-170710,170710,1,1,34,4,2.333333333333333,0.44097745,2
2020-03-12-170710,170710,4,0,40,8,2.0,1.753409,3
2020-03-13-170710,170710,2,0,35,10,5.333333333333333,0.80743736,4
2020-03-14-170710,170710,1,0,15,11,4.666666666666667,0.70310956,5
2020-03-15-170710,170710,0,0,10,11,4.333333333333333,0.7217656,6
2020-03-16-170710,170710,11,0,40,22,32.0,4.5262594,0
2020-03-17-170710,170710,12,0,23,34,29.33333333333333,4.5978193,1
2020-03-18-170710,170710,22,0,28,56,33.0,5.275558,2
2020-03-19-170710,170710,33,0,26,89,40.333333333333336,6.579713,3
2020-03-20-170710,170710,39,0,23,128,40.0,5.0601034,4
2020-03-21-170710,170710,10,0,3,138,24.0,1.6757907,5
2020-03-22-170710,170710,22,0,6,160,19.666666666666668,3.5525799,6
2020-03-23-170710,170710,45,0,13,205,58.66666666666666,10.588033,0
2020-03-24-170710,170710,42,0,18,247,57.66666666666666,6.9532094,1
2020-03-25-170710,170710,34,0,13,281,45.33333333333334,7.7700133,2
2020-03-26-170710,170710,40,0,7,321,47.33333333333334,6.7326117,3
2020-03-27-170710,170710,35,0,7,356,37.66666666666666,7.826448,4
2020-03-28-170710,170710,15,0,6,371,11.666666666666664,0.94360113,5
2020-03-29-170710,170710,10,0,7,381,14.666666666666664,1.7895538,6
2020-03-30-170710,170710,40,0,7,421,40.0,7.510951,0
2020-03-31-170710,170710,23,0,13,444,26.66666666666667,4.019173,1
2020-04-01-170710,170710,28,0,13,472,26.0,5.352343,2
2020-04-02-170710,170710,26,0,8,498,33.333333333333336,10.430526,3
2020-04-03-170710,170710,23,0,5,521,21.0,4.1924505,4
2020-04-04-170710,170710,3,0,9,524,16.333333333333332,4.254301,5
2020-04-05-170710,170710,6,0,1,530,8.0,1.5179404,6
2020-04-06-170710,170710,13,0,6,543,32.0,7.8345594,0
2020-04-07-170710,170710,18,0,4,561,16.333333333333332,2.7274134,1
2020-04-08-170710,170710,13,0,5,574,18.666666666666668,2.6973147,2
2020-04-09-170710,170710,7,0,2,581,10.0,0.7707741,3
2020-04-10-170710,170710,7,0,8,588,15.0,2.00236,4
2020-04-11-170710,170710,6,0,3,594,2.6666666666666665,0.9448491,5
2020-04-12-170710,170710,7,0,4,601,9.0,1.7929875,6
2020-04-13-170710,170710,7,0,6,608,23.33333333333333,7.1756577,0
2020-04-14-170710,170710,13,0,17,621,13.333333333333336,4.3827147,1
2020-04-15-170710,170710,13,0,12,634,16.0,4.462664,2
2020-04-16-170710,170710,8,0,9,642,9.0,1.790602,3
2020-04-17-170710,170710,5,0,1,647,7.0,1.7255741,4
2020-04-18-170710,170710,9,0,8,656,15.0,6.128857,5
2020-04-19-170710,170710,1,0,1,657,9.666666666666666,3.2823873,6
2020-04-20-170710,170710,6,1,9,663,7.333333333333332,2.5792992,0
2020-04-21-170710,170710,4,0,14,667,9.0,1.7498797,1
2020-04-22-170710,170710,5,0,8,672,17.0,6.297858,2
2020-04-23-170710,170710,2,0,10,674,5.0,0.55174935,3
2020-04-24-170710,170710,8,0,15,682,10.0,3.777287,4
2020-04-25-170710,170710,3,0,3,685,4.0,0.3343018,5
2020-04-26-170710,170710,4,0,27,689,2.0,0.28710875,6
2020-04-27-170710,170710,6,0,22,695,9.333333333333334,2.3408546,0
2020-04-28-170710,170710,17,0,8,712,11.333333333333336,2.0813768,1
2020-04-29-170710,170710,12,0,10,724,11.0,3.1262918,2
2020-04-30-170710,170710,9,0,10,733,13.333333333333336,4.413406,3
2020-05-01-170710,170710,1,0,11,734,3.333333333333333,0.45336428,4
2020-05-02-170710,170710,8,0,4,742,1.3333333333333333,0.0019514414,5
2020-05-03-170710,170710,1,0,1,743,2.333333333333333,0.0062110643,6
2020-05-04-170710,170710,9,0,11,752,9.333333333333334,1.1884422,0
2020-05-05-170710,170710,14,0,14,766,14.666666666666664,3.0268836,1
2020-05-06-170710,170710,8,0,17,774,8.333333333333334,1.6154382,2
2020-05-07-170710,170710,10,0,12,784,12.333333333333336,3.310706,3
2020-05-08-170710,170710,15,0,11,799,12.0,2.8393195,4
2020-05-09-170710,170710,3,0,8,802,5.666666666666668,1.3862869,5
2020-05-10-170710,170710,27,1,2,829,5.0,0.6744891,6
2020-05-11-170710,170710,22,0,6,851,13.0,3.7484736,0
2020-05-12-170710,170710,8,0,9,859,13.333333333333336,3.1301284,1
2020-05-13-170710,170710,10,0,14,869,13.666666666666664,2.7260497,2
2020-05-14-170710,170710,10,0,7,879,12.666666666666664,2.5802102,3
2020-05-15-170710,170710,11,0,6,890,13.0,3.857997,4
2020-05-16-170710,170710,4,0,2,894,5.333333333333333,1.4565252,5
2020-05-17-170710,170710,1,0,1,895,9.333333333333334,1.4925656,6
2020-05-18-170710,170710,11,0,11,906,10.666666666666666,4.0875125,0
2020-05-19-170710,170710,14,0,7,920,12.333333333333336,3.316635,1
2020-05-20-170710,170710,17,0,2,937,18.0,4.122583,2
2020-05-21-170710,170710,12,0,4,949,14.666666666666664,3.7995455,3
2020-05-22-170710,170710,11,0,1,960,11.666666666666664,4.207205,4
2020-05-23-170710,170710,8,0,1,968,7.333333333333332,0.9643012,5
2020-05-24-170710,170710,2,0,2,970,4.333333333333333,0.9921433,6
2020-05-25-170710,170710,6,0,6,976,12.0,4.8548565,0
2020-05-26-170710,170710,9,0,8,985,14.0,4.531694,1
2020-05-27-170710,170710,14,0,5,999,14.333333333333336,3.615184,2
2020-05-28-170710,170710,7,0,3,1006,8.666666666666666,2.2070663,3
2020-05-29-170710,170710,6,1,5,1012,6.333333333333332,1.6591783,4
2020-05-30-170710,170710,2,0,3,1014,0.3333333333333333,0.009581447,5
2020-05-31-170710,170710,1,0,2,1015,0.0,0.0043079685,6
2020-06-01-170710,170710,11,0,2,1026,5.0,1.3117402,0
2020-06-02-170710,170710,7,0,8,1033,6.333333333333332,1.3657966,1
2020-06-03-170710,170710,2,0,8,1035,4.333333333333333,1.5779581,2
2020-06-04-170710,170710,4,0,2,1039,2.333333333333333,0.38446462,3
2020-06-05-170710,170710,1,0,1,1040,4.333333333333333,0.38644087,4
2020-06-06-170710,170710,1,0,0,1041,1.0,0.27637362,5
2020-06-07-170710,170710,2,0,0,1043,1.6666666666666667,0.23183139,6
2020-06-08-170710,170710,6,0,6,1049,6.333333333333332,2.3455257,0
2020-06-09-170710,170710,8,0,5,1057,5.0,2.0786464,1
2020-06-10-170710,170710,5,0,8,1062,2.6666666666666665,0.7454319,2
2020-06-11-170710,170710,3,0,3,1065,4.666666666666667,1.3786689,3
2020-06-12-170710,170710,5,0,4,1070,6.333333333333332,1.799427,4
2020-06-13-170710,170710,3,0,2,1073,0.0,0.026676787,5
2020-06-14-170710,170710,2,1,0,1075,0.6666666666666666,0.03822805,6
2020-06-15-170710,170710,2,0,1,1077,6.0,2.241836,0
2020-06-16-170710,170710,8,0,4,1085,5.0,2.158568,1
2020-06-17-170710,170710,8,0,1,1093,5.666666666666668,2.1804197,2
2020-06-18-170710,170710,2,0,1,1095,4.0,0.8051164,3
2020-06-19-170710,170710,1,0,3,1096,5.666666666666668,1.3711962,4
2020-06-20-170710,170710,0,0,0,1096,1.0,0.66149324,5
2020-06-21-170710,170710,0,0,1,1096,0.6666666666666666,0.27482826,6
2020-06-22-170710,170710,6,0,1,1102,3.6666666666666665,1.1530339,0
2020-06-23-170710,170710,5,0,0,1107,7.0,1.5174896,1
2020-06-24-170710,170710,8,0,1,1115,2.0,0.40927184,2
2020-06-25-170710,170710,3,1,4,1118,4.0,1.6255966,3
2020-06-26-170710,170710,4,0,2,1122,5.666666666666668,1.7188185,4
2020-06-27-170710,170710,2,0,2,1124,0.3333333333333333,0.35593665,5
2020-06-28-170710,170710,0,0,0,1124,0.0,0.011400852,6
2020-06-29-170710,170710,1,0,0,1125,0.6666666666666666,0.021733629,0
2020-06-30-170710,170710,4,0,1,1129,1.0,0.47909954,1
2020-07-01-170710,170710,1,0,3,1130,1.3333333333333333,0.41423294,2
2020-07-02-170710,170710,1,0,5,1131,4.0,1.3052262,3
2020-07-03-170710,170710,3,0,2,1134,2.333333333333333,0.8901622,4
2020-07-04-170710,170710,0,0,0,1134,2.0,0.38000742,5
2020-07-05-170710,170710,1,0,0,1135,0.3333333333333333,0.00037565042,6
2020-07-06-170710,170710,1,0,2,1136,4.666666666666667,0.7957662,0
2020-07-07-170710,170710,0,0,5,1136,2.0,0.38326493,1
2020-07-08-170710,170710,1,1,3,1137,2.0,0.39619818,2
2020-07-09-170710,170710,4,0,0,1141,3.0,1.5781325,3
2020-07-10-170710,170710,2,0,2,1143,3.6666666666666665,1.2808942,4
2020-07-11-170710,170710,2,0,1,1145,1.3333333333333333,0.38157836,5
2020-07-12-170710,170710,0,0,1,1145,1.3333333333333333,0.308017,6
2020-07-13-170710,170710,0,0,1,1145,3.333333333333333,0.8002516,0
2020-07-14-170710,170710,1,0,0,1146,1.0,0.058102958,1
2020-07-15-170710,170710,3,0,1,1149,5.0,2.3682294,2
2020-07-16-170710,170710,5,0,3,1154,4.0,1.6436355,3
2020-07-17-170710,170710,2,0,3,1156,3.333333333333333,1.6882317,4
2020-07-18-170710,170710,0,0,0,1156,0.3333333333333333,0.3882888,5
2020-07-19-170710,170710,0,0,0,1156,1.3333333333333333,0.56482536,6
2020-07-20-170710,170710,2,0,6,1158,1.0,0.49114108,0
2020-07-21-170710,170710,5,0,1,1163,4.0,1.1335974,1
2020-07-22-170710,170710,3,0,3,1166,3.0,2.3413177,2
2020-07-23-170710,170710,0,0,0,1166,2.6666666666666665,1.5668561,3
2020-07-24-170710,170710,2,0,3,1168,1.6666666666666667,0.9229349,4
2020-07-25-170710,170710,1,0,1,1169,1.3333333333333333,0.35066736,5
2020-07-26-170710,170710,1,0,3,1170,0.6666666666666666,0.0044448227,6
2020-07-27-170710,170710,1,0,2,1171,2.0,1.1561072,0
2020-07-28-170710,170710,0,0,8,1171,2.0,1.9712611,1
2020-07-29-170710,170710,1,0,7,1172,2.0,0.4716694,2
2020-07-30-170710,170710,3,0,4,1175,2.0,0.8909109,3
2020-07-31-170710,170710,3,0,2,1178,3.0,0.4387603,4
2020-08-01-170710,170710,0,0,0,1178,0.6666666666666666,0.37923247,5
2020-08-02-170710,170710,0,1,1,1178,2.333333333333333,0.60573196,6
2020-08-03-170710,170710,6,0,7,1184,2.333333333333333,0.81109464,0
2020-08-04-170710,170710,1,0,8,1185,2.0,0.3969301,1
2020-08-05-170710,170710,3,0,0,1188,3.6666666666666665,2.3406868,2
2020-08-06-170710,170710,0,0,0,1188,3.333333333333333,2.3380127,3
2020-08-07-170710,170710,3,0,9,1191,4.0,1.6654453,4
2020-08-08-170710,170710,1,0,4,1192,1.0,0.08820853,5
2020-08-09-170710,170710,3,0,2,1195,1.3333333333333333,0.40877622,6
2020-08-10-170710,170710,2,0,11,1197,2.333333333333333,0.5772107,0
2020-08-11-170710,170710,8,0,9,1205,2.0,1.8890575,1
2020-08-12-170710,170710,7,0,5,1212,5.666666666666668,1.2760266,2
2020-08-13-170710,170710,4,0,5,1216,4.333333333333333,3.7354348,3
2020-08-14-170710,170710,2,0,6,1218,3.6666666666666665,1.4459044,4
2020-08-15-170710,170710,0,0,6,1218,1.6666666666666667,0.41695988,5
2020-08-16-170710,170710,1,0,1,1219,1.0,0.38805485,6
2020-08-17-170710,170710,7,0,8,1226,6.0,4.0486383,0
2020-08-18-170710,170710,8,0,1,1234,4.333333333333333,1.0676376,1
2020-08-19-170710,170710,0,0,5,1234,6.666666666666668,1.8554562,2
2020-08-20-170710,170710,0,0,5,1234,11.0,1.6031924,3
2020-08-21-170710,170710,9,0,12,1243,7.0,2.8140604,4
2020-08-22-170710,170710,4,0,0,1247,5.333333333333333,2.4225032,5
2020-08-23-170710,170710,2,0,3,1249,1.6666666666666667,0.31780848,6
2020-08-24-170710,170710,11,0,12,1260,5.666666666666668,2.9847014,0
2020-08-25-170710,170710,9,0,6,1269,9.0,4.1205983,1
2020-08-26-170710,170710,5,0,13,1274,4.0,1.6123732,2
2020-08-27-170710,170710,5,0,2,1279,6.333333333333332,3.4298139,3
2020-08-28-170710,170710,6,0,7,1285,6.0,1.3008884,4
2020-08-29-170710,170710,6,0,3,1291,5.333333333333333,0.808368,5
2020-08-30-170710,170710,1,0,0,1292,1.6666666666666667,0.9083808,6
2020-08-31-170710,170710,8,0,16,1300,5.0,4.3178816,0
2020-09-01-170710,170710,1,0,12,1301,4.333333333333333,1.3761737,1
2020-09-02-170710,170710,5,0,14,1306,7.0,1.0578985,2
2020-09-03-170710,170710,5,0,12,1311,6.666666666666668,3.362606,3
2020-09-04-170710,170710,12,0,13,1323,6.666666666666668,1.0971636,4
2020-09-05-170710,170710,0,0,5,1323,4.333333333333333,0.91141504,5
2020-09-06-170710,170710,3,0,8,1326,1.6666666666666667,0.39221758,6
2020-09-07-170710,170710,12,0,24,1338,6.666666666666668,3.3646483,0
2020-09-08-170710,170710,6,0,11,1344,9.333333333333334,4.9673123,1
2020-09-09-170710,170710,13,0,8,1357,6.0,3.067005,2
2020-09-10-170710,170710,2,0,11,1359,8.0,2.1171374,3
2020-09-11-170710,170710,7,0,10,1366,5.666666666666668,2.278008,4
2020-09-12-170710,170710,3,0,2,1369,6.333333333333332,2.3546374,5
2020-09-13-170710,170710,0,0,1,1369,1.0,0.071989976,6
2020-09-14-170710,170710,16,0,8,1385,16.333333333333332,7.2431154,0
2020-09-15-170710,170710,12,0,5,1397,8.0,1.414351,1
2020-09-16-170710,170710,14,0,8,1411,8.333333333333334,1.835342,2
2020-09-17-170710,170710,12,0,13,1423,12.333333333333336,4.768693,3
2020-09-18-170710,170710,13,0,4,1436,8.0,3.5681326,4
2020-09-19-170710,170710,5,0,2,1441,6.0,1.4744512,5
2020-09-20-170710,170710,8,0,0,1449,6.0,1.8893672,6
2020-09-21-170710,170710,24,1,8,1473,12.0,4.250178,0
2020-09-22-170710,170710,11,1,3,1484,7.333333333333332,2.8529797,1
2020-09-23-170710,170710,8,0,16,1492,9.666666666666666,3.5413835,2
2020-09-24-170710,170710,11,0,4,1503,10.666666666666666,3.8281374,3
2020-09-25-170710,170710,10,0,7,1513,17.666666666666668,7.6626987,4
2020-09-26-170710,170710,2,0,3,1515,1.6666666666666667,1.2188542,5
2020-09-27-170710,170710,1,0,1,1516,1.6666666666666667,1.3116415,6
2020-09-28-170710,170710,8,0,0,1524,9.666666666666666,5.57522,0
2020-09-29-170710,170710,5,0,6,1529,5.666666666666668,2.1210406,1
2020-09-30-170710,170710,8,0,7,1537,6.0,1.9920123,2
2020-10-01-170710,170710,13,0,19,1550,5.666666666666668,2.1832924,3
2020-10-02-170710,170710,4,0,12,1554,8.333333333333334,4.8273764,4
2020-10-03-170710,170710,2,0,14,1556,4.0,1.4821371,5
2020-10-04-170710,170710,0,0,3,1556,3.0,1.1554543,6
2020-10-05-170710,170710,8,0,14,1564,6.0,2.9526029,0
2020-10-06-170710,170710,3,0,7,1567,5.666666666666668,4.4833674,1
2020-10-07-170710,170710,16,1,14,1583,5.0,2.939152,2
2020-10-08-170710,170710,4,1,18,1587,5.333333333333333,3.292242,3
2020-10-09-170710,170710,7,1,15,1594,7.666666666666668,2.8563204,4
2020-10-10-170710,170710,3,0,2,1597,3.0,0.87503624,5
2020-10-11-170710,170710,1,0,5,1598,4.333333333333333,2.0894341,6
2020-10-12-170710,170710,0,0,3,1598,3.0,1.3430451,0
2020-10-13-170710,170710,6,0,21,1604,7.0,3.0377042,1
2020-10-14-170710,170710,7,0,6,1611,6.333333333333332,1.7530574,2
2020-10-15-170710,170710,19,0,12,1630,8.666666666666666,5.002517,3
2020-10-16-170710,170710,12,0,13,1642,10.333333333333334,7.0608077,4
2020-10-17-170710,170710,14,0,0,1656,6.333333333333332,0.48160028,5
2020-10-18-170710,170710,3,0,4,1659,5.666666666666668,1.6509228,6
2020-10-19-170710,170710,14,1,8,1673,8.0,3.0526247,0
2020-10-20-170710,170710,7,0,9,1680,4.666666666666667,1.7998836,1
2020-10-21-170710,170710,14,0,8,1694,7.333333333333332,2.6739016,2
2020-10-22-170710,170710,18,0,16,1712,12.0,9.175279,3
2020-10-23-170710,170710,15,0,6,1727,11.333333333333336,3.358376,4
2020-10-24-170710,170710,2,0,1,1729,3.6666666666666665,1.2163874,5
2020-10-25-170710,170710,5,0,2,1734,3.6666666666666665,1.6341377,6
2020-10-26-170710,170710,3,0,10,1737,1.6666666666666667,0.41532508,0
2020-10-27-170710,170710,21,0,5,1758,8.666666666666666,4.6304073,1
2020-10-28-170710,170710,6,0,3,1764,10.0,3.8511865,2
2020-10-29-170710,170710,12,0,15,1776,9.333333333333334,4.372203,3
2020-10-30-170710,170710,13,0,12,1789,7.666666666666668,2.8315184,4
2020-10-31-170710,170710,0,0,0,1789,7.0,2.492732,5
2020-11-01-170710,170710,4,0,0,1793,4.333333333333333,1.1808871,6
2020-11-02-170710,170710,8,1,0,1801,7.0,1.5106803,0
2020-11-03-170710,170710,9,0,0,1810,9.333333333333334,4.8458514,1
2020-11-04-170710,170710,8,0,0,1818,8.333333333333334,4.533131,2
2020-11-05-170710,170710,16,0,0,1834,8.333333333333334,3.5965424,3
2020-11-06-170710,170710,6,1,0,1840,10.666666666666666,5.638151,4
2020-11-07-170710,170710,1,1,0,1841,2.6666666666666665,0.3587513,5
2020-11-08-170710,170710,2,0,0,1843,1.3333333333333333,0.061942667,6
2020-11-09-170710,170710,10,0,0,1853,8.666666666666666,4.3140583,0
2020-11-10-170710,170710,5,0,0,1858,5.0,1.9785844,1
2020-11-11-170710,170710,3,0,0,1861,7.0,3.4740126,2
2020-11-12-170710,170710,15,0,0,1876,7.0,1.1678077,3
2020-11-13-170710,170710,12,0,0,1888,10.666666666666666,9.195215,4
2020-03-01-170711,170711,0,0,4,0,0.09090909090909093,0.01348202,6
2020-03-02-170711,170711,0,0,20,0,0.2727272727272727,0.003723631,0
2020-03-03-170711,170711,0,0,23,0,0.2727272727272727,0.09127343,1
2020-03-04-170711,170711,0,0,23,0,0.2727272727272727,0.00031156756,2
2020-03-05-170711,170711,0,0,33,0,0.2727272727272727,0.09778446,3
2020-03-06-170711,170711,1,0,24,1,0.0,4.117309,4
2020-03-07-170711,170711,1,0,9,2,0.2727272727272727,3.565165,5
2020-03-08-170711,170711,0,1,27,2,0.0,0.0006882973,6
2020-03-09-170711,170711,1,0,51,3,0.2727272727272727,3.941203,0
2020-03-10-170711,170711,0,0,35,3,1.0,4.1086903,1
2020-03-11-170711,170711,1,0,42,4,0.7272727272727273,4.037037,2
2020-03-12-170711,170711,4,0,37,8,1.0,16.392433,3
2020-03-13-170711,170711,2,0,42,10,2.4545454545454546,8.337909,4
2020-03-14-170711,170711,3,0,6,13,2.1818181818181817,8.679347,5
2020-03-15-170711,170711,4,0,12,17,2.272727272727273,8.617002,6
2020-03-16-170711,170711,20,0,39,37,11.090909090909092,52.648785,0
2020-03-17-170711,170711,23,1,21,60,10.363636363636363,57.049564,1
2020-03-18-170711,170711,23,0,28,83,16.09090909090909,68.19922,2
2020-03-19-170711,170711,33,0,59,116,18.90909090909091,79.6911,3
2020-03-20-170711,170711,24,0,24,140,18.181818181818183,62.52905,4
2020-03-21-170711,170711,9,0,28,149,11.636363636363635,21.287228,5
2020-03-22-170711,170711,27,0,10,176,11.545454545454545,45.795357,6
2020-03-23-170711,170711,51,0,41,227,25.09090909090909,127.617935,0
2020-03-24-170711,170711,35,0,15,262,24.54545454545455,84.55856,1
2020-03-25-170711,170711,42,0,14,304,20.363636363636363,99.800064,2
2020-03-26-170711,170711,37,0,6,341,22.181818181818183,85.11671,3
2020-03-27-170711,170711,42,0,14,383,18.0,92.13097,4
2020-03-28-170711,170711,6,0,5,389,10.363636363636363,13.140796,5
2020-03-29-170711,170711,12,0,11,401,6.8181818181818175,21.83278,6
2020-03-30-170711,170711,39,0,37,440,21.63636363636364,86.542175,0
2020-03-31-170711,170711,21,0,23,461,13.454545454545455,47.455284,1
2020-04-01-170711,170711,28,0,26,489,13.272727272727273,59.729313,2
2020-04-02-170711,170711,59,0,10,548,10.0,124.99427,3
2020-04-03-170711,170711,24,0,4,572,9.818181818181818,49.805214,4
2020-04-04-170711,170711,28,0,39,600,5.0,51.785633,5
2020-04-05-170711,170711,10,0,24,610,4.454545454545454,17.203465,6
2020-04-06-170711,170711,41,0,12,651,9.545454545454543,85.86533,0
2020-04-07-170711,170711,15,0,9,666,8.090909090909092,35.04063,1
2020-04-08-170711,170711,14,0,34,680,8.545454545454545,31.713243,2
2020-04-09-170711,170711,6,0,4,686,7.1818181818181825,10.469968,3
2020-04-10-170711,170711,14,0,19,700,5.454545454545454,22.379278,4
2020-04-11-170711,170711,5,0,2,705,3.5454545454545454,11.757883,5
2020-04-12-170711,170711,11,0,2,716,3.1818181818181817,20.280336,6
2020-04-13-170711,170711,37,0,12,753,7.727272727272727,83.162254,0
2020-04-14-170711,170711,23,0,10,776,5.545454545454546,51.94169,1
2020-04-15-170711,170711,26,0,16,802,6.090909090909091,61.258526,2
2020-04-16-170711,170711,10,0,21,812,4.181818181818182,24.747438,3
2020-04-17-170711,170711,4,0,4,816,4.727272727272728,21.130106,4
2020-04-18-170711,170711,39,0,0,855,4.2727272727272725,83.315285,5
2020-04-19-170711,170711,24,0,0,879,2.1818181818181817,42.76093,6
2020-04-20-170711,170711,12,0,6,891,7.363636363636362,34.43702,0
2020-04-21-170711,170711,9,0,13,900,5.636363636363638,24.219532,1
2020-04-22-170711,170711,34,1,7,934,4.090909090909091,84.845474,2
2020-04-23-170711,170711,4,0,14,938,3.0,8.961151,3
2020-04-24-170711,170711,19,0,11,957,4.727272727272728,47.568764,4
2020-04-25-170711,170711,2,0,8,959,2.363636363636364,4.764746,5
2020-04-26-170711,170711,2,0,5,961,1.818181818181818,4.121979,6
2020-04-27-170711,170711,12,0,15,973,8.0,33.265648,0
2020-04-28-170711,170711,10,0,13,983,6.363636363636362,27.71967,1
2020-04-29-170711,170711,16,0,11,999,8.272727272727273,40.94433,2
2020-04-30-170711,170711,21,0,11,1020,4.2727272727272725,51.329334,3
2020-05-01-170711,170711,4,0,16,1024,1.2727272727272727,5.582022,4
2020-05-02-170711,170711,0,0,7,1024,2.0,0.23194927,5
2020-05-03-170711,170711,0,0,8,1024,1.2727272727272727,0.27132362,6
2020-05-04-170711,170711,6,0,16,1030,4.363636363636363,14.087087,0
2020-05-05-170711,170711,13,1,14,1043,6.090909090909091,38.83298,1
2020-05-06-170711,170711,7,0,16,1050,3.636363636363636,19.358757,2
2020-05-07-170711,170711,14,0,14,1064,5.0,39.785934,3
2020-05-08-170711,170711,11,0,15,1075,6.0,33.769276,4
2020-05-09-170711,170711,8,2,4,1083,1.5454545454545454,16.597292,5
2020-05-10-170711,170711,5,0,6,1088,3.636363636363636,8.510994,6
2020-05-11-170711,170711,15,0,15,1103,6.454545454545454,43.090008,0
2020-05-12-170711,170711,13,0,15,1116,5.454545454545454,37.434814,1
2020-05-13-170711,170711,11,0,11,1127,5.363636363636363,35.03591,2
2020-05-14-170711,170711,11,0,7,1138,6.363636363636362,32.122932,3
2020-05-15-170711,170711,16,0,5,1154,5.363636363636363,46.137653,4
2020-05-16-170711,170711,7,0,0,1161,2.636363636363636,17.85949,5
2020-05-17-170711,170711,8,0,0,1169,2.636363636363636,17.937521,6
2020-05-18-170711,170711,16,0,4,1185,5.0,51.417324,0
2020-05-19-170711,170711,14,1,5,1199,5.2727272727272725,37.217564,1
2020-05-20-170711,170711,16,0,5,1215,7.0,49.665306,2
2020-05-21-170711,170711,14,0,1,1229,5.909090909090909,41.91216,3
2020-05-22-170711,170711,15,0,2,1244,5.363636363636363,46.99451,4
2020-05-23-170711,170711,4,0,1,1248,4.0,10.623506,5
2020-05-24-170711,170711,6,0,1,1254,2.1818181818181817,11.289752,6
2020-05-25-170711,170711,15,0,7,1269,4.727272727272728,50.480854,0
2020-05-26-170711,170711,15,0,6,1284,5.090909090909091,51.254738,1
2020-05-27-170711,170711,11,1,2,1295,8.818181818181818,38.216854,2
2020-05-28-170711,170711,7,0,4,1302,3.363636363636364,23.025095,3
2020-05-29-170711,170711,5,1,6,1307,3.1818181818181817,17.484156,4
2020-05-30-170711,170711,0,0,0,1307,0.5454545454545454,0.29706788,5
2020-05-31-170711,170711,0,0,0,1307,0.4545454545454545,0.13986203,6
2020-06-01-170711,170711,4,1,6,1311,3.0,13.949958,0
2020-06-02-170711,170711,5,0,6,1316,3.727272727272727,14.875058,1
2020-06-03-170711,170711,5,0,6,1321,2.0,17.539211,2
2020-06-04-170711,170711,1,0,3,1322,2.0,4.6805367,3
2020-06-05-170711,170711,2,0,3,1324,2.090909090909091,4.145338,4
2020-06-06-170711,170711,1,0,2,1325,1.0,3.1155784,5
2020-06-07-170711,170711,1,0,1,1326,0.9090909090909092,2.833794,6
2020-06-08-170711,170711,7,0,4,1333,2.727272727272727,26.70144,0
2020-06-09-170711,170711,6,0,4,1339,2.363636363636364,22.348759,1
2020-06-10-170711,170711,2,0,1,1341,1.818181818181818,7.4365306,2
2020-06-11-170711,170711,4,0,4,1345,1.3636363636363635,13.757999,3
2020-06-12-170711,170711,6,0,4,1351,2.727272727272727,17.647804,4
2020-06-13-170711,170711,0,0,1,1351,0.7272727272727273,0.4740106,5
2020-06-14-170711,170711,0,1,0,1351,0.8181818181818182,0.7639335,6
2020-06-15-170711,170711,6,0,0,1357,1.6363636363636365,21.551292,0
2020-06-16-170711,170711,6,0,1,1363,2.636363636363636,22.354849,1
2020-06-17-170711,170711,6,0,1,1369,2.5454545454545454,22.013391,2
2020-06-18-170711,170711,3,0,3,1372,1.7272727272727273,8.351892,3
2020-06-19-170711,170711,3,0,2,1375,3.9090909090909087,13.841029,4
2020-06-20-170711,170711,2,0,1,1377,0.2727272727272727,6.694439,5
2020-06-21-170711,170711,1,0,0,1378,0.2727272727272727,2.8238134,6
2020-06-22-170711,170711,4,0,2,1382,1.5454545454545454,11.253252,0
2020-06-23-170711,170711,4,0,1,1386,2.8181818181818183,14.61833,1
2020-06-24-170711,170711,1,1,0,1387,2.363636363636364,3.9704866,2
2020-06-25-170711,170711,4,0,4,1391,2.1818181818181817,15.738264,3
2020-06-26-170711,170711,4,0,3,1395,2.272727272727273,15.817564,4
2020-06-27-170711,170711,1,0,1,1396,0.5454545454545454,3.3496013,5
2020-06-28-170711,170711,0,1,1,1396,0.3636363636363637,0.22836487,6
2020-06-29-170711,170711,0,0,1,1396,0.7272727272727273,0.4133707,0
2020-06-30-170711,170711,1,0,1,1397,1.0,3.7909203,1
2020-07-01-170711,170711,1,0,7,1398,0.7272727272727273,3.598711,2
2020-07-02-170711,170711,3,0,5,1401,1.2727272727272727,10.671738,3
2020-07-03-170711,170711,2,0,4,1403,1.0909090909090908,7.449638,4
2020-07-04-170711,170711,1,0,1,1404,0.8181818181818182,3.2032816,5
2020-07-05-170711,170711,0,0,2,1404,0.18181818181818185,0.0024387152,6
2020-07-06-170711,170711,2,0,1,1406,1.9090909090909087,6.7785378,0
2020-07-07-170711,170711,1,0,3,1407,0.8181818181818182,3.2770417,1
2020-07-08-170711,170711,0,2,6,1407,1.0,3.5960953,2
2020-07-09-170711,170711,4,0,4,1411,1.5454545454545454,13.436504,3
2020-07-10-170711,170711,3,1,2,1414,1.2727272727272727,10.016698,4
2020-07-11-170711,170711,1,0,1,1415,0.7272727272727273,3.2412617,5
2020-07-12-170711,170711,1,0,0,1416,0.4545454545454545,2.445918,6
2020-07-13-170711,170711,1,0,3,1417,1.0909090909090908,6.7747917,0
2020-07-14-170711,170711,1,1,5,1418,0.5454545454545454,0.739475,1
2020-07-15-170711,170711,7,0,1,1425,1.6363636363636365,19.626135,2
2020-07-16-170711,170711,5,0,3,1430,2.4545454545454546,13.949135,3
2020-07-17-170711,170711,4,0,3,1434,1.0909090909090908,13.483115,4
2020-07-18-170711,170711,1,0,1,1435,0.4545454545454545,3.4324694,5
2020-07-19-170711,170711,2,0,3,1437,0.2727272727272727,4.578071,6
2020-07-20-170711,170711,1,0,2,1438,1.5454545454545454,4.8372455,0
2020-07-21-170711,170711,3,0,2,1441,1.4545454545454546,9.63392,1
2020-07-22-170711,170711,6,0,7,1447,1.3636363636363635,20.26647,2
2020-07-23-170711,170711,4,0,6,1451,1.0,12.685853,3
2020-07-24-170711,170711,2,0,4,1453,1.7272727272727273,8.207799,4
2020-07-25-170711,170711,1,1,0,1454,0.7272727272727273,2.7738543,5
2020-07-26-170711,170711,0,1,1,1454,0.5454545454545454,0.05842659,6
2020-07-27-170711,170711,3,0,1,1457,0.7272727272727273,9.595793,0
2020-07-28-170711,170711,5,1,4,1462,1.2727272727272727,15.95504,1
2020-07-29-170711,170711,1,0,6,1463,1.818181818181818,4.237024,2
2020-07-30-170711,170711,3,0,6,1466,2.636363636363636,8.243651,3
2020-07-31-170711,170711,3,0,3,1469,1.9090909090909087,3.7823122,4
2020-08-01-170711,170711,1,0,1,1470,0.6363636363636364,3.2284317,5
2020-08-02-170711,170711,3,0,1,1473,0.8181818181818182,4.776886,6
2020-08-03-170711,170711,2,0,12,1475,1.9090909090909087,6.845798,0
2020-08-04-170711,170711,2,0,4,1477,0.7272727272727273,3.2681735,1
2020-08-05-170711,170711,7,0,4,1484,1.818181818181818,19.618353,2
2020-08-06-170711,170711,6,0,6,1490,0.9090909090909092,19.26708,3
2020-08-07-170711,170711,4,0,5,1494,1.818181818181818,12.917286,4
2020-08-08-170711,170711,0,0,6,1494,1.0909090909090908,1.2480628,5
2020-08-09-170711,170711,1,0,4,1495,1.6363636363636365,3.9098475,6
2020-08-10-170711,170711,1,0,6,1496,2.0,5.818604,0
2020-08-11-170711,170711,4,0,13,1500,2.9090909090909087,16.616722,1
2020-08-12-170711,170711,6,0,4,1506,2.9090909090909087,11.652656,2
2020-08-13-170711,170711,6,0,13,1512,3.1818181818181817,31.10473,3
2020-08-14-170711,170711,3,0,4,1515,4.2727272727272725,13.78245,4
2020-08-15-170711,170711,1,0,3,1516,2.1818181818181817,3.937,5
2020-08-16-170711,170711,1,0,3,1517,1.0,3.6709275,6
2020-08-17-170711,170711,12,0,10,1529,4.727272727272728,32.65155,0
2020-08-18-170711,170711,4,0,3,1533,6.1818181818181825,10.598525,1
2020-08-19-170711,170711,4,0,4,1537,5.090909090909091,17.194412,2
2020-08-20-170711,170711,6,0,8,1543,4.636363636363637,13.033637,3
2020-08-21-170711,170711,5,0,4,1548,6.1818181818181825,24.17002,4
2020-08-22-170711,170711,6,0,2,1554,3.0909090909090913,19.352648,5
2020-08-23-170711,170711,4,0,1,1558,1.4545454545454546,2.6004572,6
2020-08-24-170711,170711,6,0,9,1564,5.090909090909091,22.577614,0
2020-08-25-170711,170711,13,0,10,1577,4.454545454545454,33.74737,1
2020-08-26-170711,170711,4,0,7,1581,3.0909090909090913,14.2890415,2
2020-08-27-170711,170711,13,0,7,1594,2.636363636363636,27.93719,3
2020-08-28-170711,170711,4,1,6,1598,4.2727272727272725,10.200507,4
2020-08-29-170711,170711,3,0,5,1601,2.636363636363636,6.566767,5
2020-08-30-170711,170711,3,0,0,1604,0.5454545454545454,7.2599754,6
2020-08-31-170711,170711,10,0,19,1614,2.272727272727273,32.934364,0
2020-09-01-170711,170711,3,1,3,1617,4.454545454545454,11.851147,1
2020-09-02-170711,170711,4,0,6,1621,6.454545454545454,9.616205,2
2020-09-03-170711,170711,8,0,12,1629,4.454545454545454,26.200665,3
2020-09-04-170711,170711,4,1,10,1633,7.272727272727272,10.631192,4
2020-09-05-170711,170711,2,0,5,1635,3.363636363636364,7.828098,5
2020-09-06-170711,170711,1,0,11,1636,2.636363636363636,3.8744285,6
2020-09-07-170711,170711,9,0,15,1645,4.545454545454546,26.220055,0
2020-09-08-170711,170711,10,0,6,1655,5.8181818181818175,39.924088,1
2020-09-09-170711,170711,7,0,8,1662,4.363636363636363,24.172745,2
2020-09-10-170711,170711,7,1,12,1669,3.8181818181818175,17.130716,3
2020-09-11-170711,170711,6,1,18,1675,6.636363636363638,17.9247,4
2020-09-12-170711,170711,5,0,2,1680,2.636363636363636,18.560482,5
2020-09-13-170711,170711,0,0,4,1680,0.9090909090909092,0.8745846,6
2020-09-14-170711,170711,19,0,13,1699,7.636363636363638,57.021294,0
2020-09-15-170711,170711,3,0,5,1702,5.909090909090909,11.940449,1
2020-09-16-170711,170711,6,0,6,1708,6.0,14.686817,2
2020-09-17-170711,170711,12,0,7,1720,6.545454545454546,37.597694,3
2020-09-18-170711,170711,10,0,12,1730,6.363636363636362,28.865969,4
2020-09-19-170711,170711,5,1,4,1735,3.5454545454545454,11.264691,5
2020-09-20-170711,170711,11,1,3,1746,2.9090909090909087,14.91032,6
2020-09-21-170711,170711,15,0,9,1761,7.8181818181818175,33.97079,0
2020-09-22-170711,170711,6,2,10,1767,5.181818181818182,24.641115,1
2020-09-23-170711,170711,8,1,8,1775,6.8181818181818175,27.525438,2
2020-09-24-170711,170711,12,0,8,1787,5.454545454545454,28.549232,3
2020-09-25-170711,170711,18,0,10,1805,7.727272727272727,54.43946,4
2020-09-26-170711,170711,2,0,2,1807,2.363636363636364,8.89762,5
2020-09-27-170711,170711,4,0,5,1811,0.9090909090909092,8.98185,6
2020-09-28-170711,170711,13,1,4,1824,3.727272727272727,39.410816,0
2020-09-29-170711,170711,5,1,7,1829,3.8181818181818175,15.004293,1
2020-09-30-170711,170711,6,0,6,1835,4.0,15.051406,2
2020-10-01-170711,170711,7,2,11,1842,4.363636363636363,14.312515,3
2020-10-02-170711,170711,12,0,13,1854,4.727272727272728,36.505898,4
2020-10-03-170711,170711,4,0,1,1858,1.7272727272727273,9.958177,5
2020-10-04-170711,170711,3,0,4,1861,2.272727272727273,8.707067,6
2020-10-05-170711,170711,9,1,7,1870,3.0,20.222635,0
2020-10-06-170711,170711,10,0,4,1880,3.5454545454545454,32.503277,1
2020-10-07-170711,170711,8,0,5,1888,2.636363636363636,21.661263,2
2020-10-08-170711,170711,8,0,21,1896,3.5454545454545454,23.336496,3
2020-10-09-170711,170711,10,3,5,1906,4.818181818181818,19.193817,4
2020-10-10-170711,170711,2,0,3,1908,2.4545454545454546,6.5776744,5
2020-10-11-170711,170711,5,0,6,1913,2.090909090909091,13.590409,6
2020-10-12-170711,170711,4,0,1,1917,1.818181818181818,10.063013,0
2020-10-13-170711,170711,7,0,11,1924,4.363636363636363,21.893965,1
2020-10-14-170711,170711,6,0,9,1930,4.909090909090909,13.370013,2
2020-10-15-170711,170711,11,0,10,1941,5.181818181818182,33.821762,3
2020-10-16-170711,170711,13,0,15,1954,7.1818181818181825,46.697353,4
2020-10-17-170711,170711,1,0,7,1955,5.454545454545454,4.267819,5
2020-10-18-170711,170711,4,0,4,1959,3.8181818181818175,12.032499,6
2020-10-19-170711,170711,7,1,4,1966,6.0,22.027176,0
2020-10-20-170711,170711,4,0,11,1970,5.090909090909091,14.2414875,1
2020-10-21-170711,170711,5,0,8,1975,5.363636363636363,20.153475,2
2020-10-22-170711,170711,21,0,9,1996,5.545454545454546,64.27165,3
2020-10-23-170711,170711,5,0,14,2001,7.363636363636362,24.576181,4
2020-10-24-170711,170711,3,0,1,2004,4.363636363636363,9.820808,5
2020-10-25-170711,170711,6,0,0,2010,3.0,12.586036,6
2020-10-26-170711,170711,1,0,11,2011,4.636363636363637,5.1658044,0
2020-10-27-170711,170711,11,1,5,2022,6.909090909090909,35.394184,1
2020-10-28-170711,170711,9,2,8,2031,7.545454545454546,29.819998,2
2020-10-29-170711,170711,10,0,6,2041,6.909090909090909,35.000298,3
2020-10-30-170711,170711,15,0,11,2056,7.545454545454546,21.712385,4
2020-10-31-170711,170711,7,1,0,2063,5.181818181818182,20.486132,5
2020-11-01-170711,170711,4,2,0,2067,2.9090909090909087,8.905697,6
2020-11-02-170711,170711,4,1,0,2071,4.181818181818182,12.054383,0
2020-11-03-170711,170711,11,2,0,2082,6.727272727272728,37.509117,1
2020-11-04-170711,170711,8,1,0,2090,4.545454545454546,32.768505,2
2020-11-05-170711,170711,9,1,0,2099,7.0,28.031347,3
2020-11-06-170711,170711,14,2,0,2113,7.909090909090909,43.515697,4
2020-11-07-170711,170711,1,0,0,2114,2.4545454545454546,3.289974,5
2020-11-08-170711,170711,0,0,0,2114,1.5454545454545454,0.98816776,6
2020-11-09-170711,170711,11,1,0,2125,5.090909090909091,33.41698,0
2020-11-10-170711,170711,5,0,0,2130,4.454545454545454,15.060838,1
2020-11-11-170711,170711,8,2,0,2138,3.4545454545454546,24.135185,2
2020-11-12-170711,170711,6,1,0,2144,6.454545454545454,8.989673,3
2020-11-13-170711,170711,11,1,0,2155,6.2727272727272725,71.7088,4
2020-03-01-170712,170712,0,0,0,0,0.0,0.00020450701,6
2020-03-02-170712,170712,0,0,3,0,0.0,0.0013884059,0
2020-03-03-170712,170712,0,0,1,0,0.16666666666666666,0.07025214,1
2020-03-04-170712,170712,0,0,3,0,0.0,0.00020517614,2
2020-03-05-170712,170712,0,0,9,0,0.0,0.00138634,3
2020-03-06-170712,170712,0,0,2,0,0.0,0.020484967,4
2020-03-07-170712,170712,0,1,3,0,0.16666666666666666,0.08699573,5
2020-03-08-170712,170712,0,0,5,0,0.0,9.2465507e-07,6
2020-03-09-170712,170712,0,0,4,0,0.16666666666666666,0.025322324,0
2020-03-10-170712,170712,0,0,8,0,0.0,0.02170094,1
2020-03-11-170712,170712,0,1,2,0,0.16666666666666666,0.038153477,2
2020-03-12-170712,170712,0,0,4,0,0.16666666666666666,0.09330761,3
2020-03-13-170712,170712,1,0,2,1,0.0,0.3915053,4
2020-03-14-170712,170712,0,0,4,1,1.1666666666666667,0.22596964,5
2020-03-15-170712,170712,0,0,1,1,0.6666666666666666,0.13715589,6
2020-03-16-170712,170712,3,1,1,4,2.5,1.164585,0
2020-03-17-170712,170712,1,1,2,5,2.833333333333333,1.11418,1
2020-03-18-170712,170712,3,0,3,8,6.166666666666668,3.4309413,2
2020-03-19-170712,170712,9,0,2,17,5.333333333333333,4.098338,3
2020-03-20-170712,170712,2,0,0,19,4.0,2.166729,4
2020-03-21-170712,170712,3,1,0,22,1.8333333333333333,1.1475713,5
2020-03-22-170712,170712,5,0,1,27,3.6666666666666665,1.7840792,6
2020-03-23-170712,170712,4,0,3,31,9.0,3.5992455,0
2020-03-24-170712,170712,8,0,2,39,7.0,3.876968,1
2020-03-25-170712,170712,2,0,1,41,6.5,2.4058838,2
2020-03-26-170712,170712,4,0,0,45,6.0,2.5058446,3
2020-03-27-170712,170712,2,0,1,47,6.0,2.3015203,4
2020-03-28-170712,170712,4,0,0,51,2.833333333333333,1.5092493,5
2020-03-29-170712,170712,1,0,0,52,1.5,0.4890123,6
2020-03-30-170712,170712,1,1,5,53,5.0,1.4765507,0
2020-03-31-170712,170712,2,0,0,55,4.666666666666667,1.8273286,1
2020-04-01-170712,170712,3,0,1,58,8.0,2.566339,2
2020-04-02-170712,170712,2,0,1,60,2.6666666666666665,1.3459926,3
2020-04-03-170712,170712,0,0,2,60,2.0,0.6784756,4
2020-04-04-170712,170712,0,0,3,60,1.8333333333333333,0.54921764,5
2020-04-05-170712,170712,1,0,0,61,1.6666666666666667,0.7386545,6
2020-04-06-170712,170712,3,0,0,64,1.3333333333333333,1.3296958,0
2020-04-07-170712,170712,2,0,1,66,1.8333333333333333,0.7645107,1
2020-04-08-170712,170712,1,0,1,67,2.5,1.1516804,2
2020-04-09-170712,170712,0,1,0,67,1.5,0.4342496,3
2020-04-10-170712,170712,1,0,1,68,1.1666666666666667,0.51988953,4
2020-04-11-170712,170712,0,0,0,68,0.5,0.08693245,5
2020-04-12-170712,170712,0,0,3,68,0.6666666666666666,0.16816974,6
2020-04-13-170712,170712,5,0,0,73,3.0,2.6946537,0
2020-04-14-170712,170712,0,0,0,73,1.8333333333333333,0.61679244,1
2020-04-15-170712,170712,1,0,1,74,1.3333333333333333,0.98728204,2
2020-04-16-170712,170712,1,0,0,75,1.0,0.56193244,3
2020-04-17-170712,170712,2,0,0,77,4.666666666666667,1.1611747,4
2020-04-18-170712,170712,3,0,0,80,3.0,1.6488645,5
2020-04-19-170712,170712,0,0,0,80,1.1666666666666667,0.33194935,6
2020-04-20-170712,170712,0,0,0,80,2.1666666666666665,0.63281983,0
2020-04-21-170712,170712,1,0,0,81,3.6666666666666665,1.0203534,1
2020-04-22-170712,170712,1,0,0,82,0.5,0.6607473,2
2020-04-23-170712,170712,0,0,0,82,1.6666666666666667,0.6110265,3
2020-04-24-170712,170712,1,0,1,83,1.6666666666666667,0.9136064,4
2020-04-25-170712,170712,0,0,1,83,0.3333333333333333,0.09292261,5
2020-04-26-170712,170712,3,1,0,86,0.6666666666666666,0.5834171,6
2020-04-27-170712,170712,0,0,0,86,4.5,2.2777405,0
2020-04-28-170712,170712,0,0,0,86,1.3333333333333333,0.47895747,1
2020-04-29-170712,170712,1,0,2,87,1.3333333333333333,0.74044067,2
2020-04-30-170712,170712,0,0,2,87,0.8333333333333334,0.44757494,3
2020-05-01-170712,170712,0,0,0,87,0.6666666666666666,0.24465045,4
2020-05-02-170712,170712,0,0,1,87,0.3333333333333333,0.058823314,5
2020-05-03-170712,170712,0,0,1,87,0.0,0.0057323654,6
2020-05-04-170712,170712,0,0,0,87,1.5,0.42410457,0
2020-05-05-170712,170712,0,0,2,87,0.16666666666666666,0.21720968,1
2020-05-06-170712,170712,0,0,0,87,0.5,0.23674123,2
2020-05-07-170712,170712,0,0,0,87,1.0,0.45967126,3
2020-05-08-170712,170712,1,0,1,88,1.1666666666666667,0.8250055,4
2020-05-09-170712,170712,1,1,2,89,0.0,0.27304235,5
2020-05-10-170712,170712,0,1,2,89,0.5,0.20546964,6
2020-05-11-170712,170712,0,0,1,89,0.6666666666666666,0.30160362,0
2020-05-12-170712,170712,0,5,1,89,1.3333333333333333,0.59914154,1
2020-05-13-170712,170712,2,0,4,91,1.0,1.032381,2
2020-05-14-170712,170712,2,0,1,93,1.3333333333333333,1.2671648,3
2020-05-15-170712,170712,0,0,0,93,1.1666666666666667,0.47468498,4
2020-05-16-170712,170712,1,0,0,94,0.3333333333333333,0.47091344,5
2020-05-17-170712,170712,1,0,0,95,0.0,0.2432307,6
2020-05-18-170712,170712,0,0,0,95,2.1666666666666665,0.67707866,0
2020-05-19-170712,170712,2,0,1,97,1.8333333333333333,1.3558217,1
2020-05-20-170712,170712,0,0,0,97,1.8333333333333333,0.8106462,2
2020-05-21-170712,170712,0,0,2,97,1.3333333333333333,0.6402619,3
2020-05-22-170712,170712,1,0,0,98,0.5,0.7764617,4
2020-05-23-170712,170712,2,0,1,100,1.1666666666666667,0.70112354,5
2020-05-24-170712,170712,2,0,0,102,0.6666666666666666,0.62774026,6
2020-05-25-170712,170712,1,0,0,103,1.6666666666666667,1.107621,0
2020-05-26-170712,170712,1,0,0,104,1.3333333333333333,1.0975045,1
2020-05-27-170712,170712,4,0,0,108,1.5,2.0119214,2
2020-05-28-170712,170712,1,2,1,109,0.6666666666666666,0.47983196,3
2020-05-29-170712,170712,0,0,0,109,0.8333333333333334,0.4288146,4
2020-05-30-170712,170712,0,1,0,109,0.0,0.00083555427,5
2020-05-31-170712,170712,0,0,0,109,0.0,0.00054336456,6
2020-06-01-170712,170712,0,0,0,109,0.5,0.22836086,0
2020-06-02-170712,170712,1,0,1,110,0.5,0.33556852,1
2020-06-03-170712,170712,0,0,1,110,0.8333333333333334,0.2781613,2
2020-06-04-170712,170712,2,0,0,112,0.16666666666666666,0.6556948,3
2020-06-05-170712,170712,0,0,0,112,0.16666666666666666,0.10195729,4
2020-06-06-170712,170712,1,0,0,113,0.0,0.2643368,5
2020-06-07-170712,170712,0,0,0,113,0.3333333333333333,0.12117223,6
2020-06-08-170712,170712,0,0,0,113,0.5,0.30173522,0
2020-06-09-170712,170712,0,0,1,113,0.3333333333333333,0.22082381,1
2020-06-10-170712,170712,0,0,1,113,0.0,0.053163167,2
2020-06-11-170712,170712,1,0,0,114,0.3333333333333333,0.5218384,3
2020-06-12-170712,170712,0,0,1,114,0.6666666666666666,0.37652457,4
2020-06-13-170712,170712,0,0,0,114,0.0,0.014784952,5
2020-06-14-170712,170712,0,0,0,114,0.16666666666666666,0.14087242,6
2020-06-15-170712,170712,0,0,1,114,0.16666666666666666,0.23199655,0
2020-06-16-170712,170712,1,0,2,115,0.0,0.42764878,1
2020-06-17-170712,170712,1,0,1,116,0.0,0.42956153,2
2020-06-18-170712,170712,0,0,0,116,0.8333333333333334,0.38084453,3
2020-06-19-170712,170712,0,0,3,116,2.333333333333333,1.2559221,4
2020-06-20-170712,170712,0,0,0,116,0.16666666666666666,0.03640665,5
2020-06-21-170712,170712,0,0,0,116,0.0,0.013955754,6
2020-06-22-170712,170712,0,0,0,116,0.3333333333333333,0.087401606,0
2020-06-23-170712,170712,1,0,0,117,0.6666666666666666,0.95426035,1
2020-06-24-170712,170712,1,1,1,118,0.3333333333333333,0.47853124,2
2020-06-25-170712,170712,0,0,0,118,0.16666666666666666,0.26721606,3
2020-06-26-170712,170712,1,0,2,119,0.16666666666666666,0.61522204,4
2020-06-27-170712,170712,0,0,0,119,0.16666666666666666,0.12774247,5
2020-06-28-170712,170712,0,0,1,119,0.16666666666666666,0.17652845,6
2020-06-29-170712,170712,1,0,0,120,0.5,0.63274026,0
2020-06-30-170712,170712,2,0,1,122,0.6666666666666666,1.0746498,1
2020-07-01-170712,170712,1,0,1,123,0.3333333333333333,0.39148897,2
2020-07-02-170712,170712,0,0,0,123,0.0,0.083695464,3
2020-07-03-170712,170712,3,0,0,126,0.3333333333333333,1.3816674,4
2020-07-04-170712,170712,0,0,0,126,0.3333333333333333,0.21828656,5
2020-07-05-170712,170712,0,0,0,126,0.0,3.7876827e-08,6
2020-07-06-170712,170712,0,0,0,126,0.5,0.27562132,0
2020-07-07-170712,170712,0,0,0,126,0.16666666666666666,0.035574444,1
2020-07-08-170712,170712,1,0,1,127,0.0,0.3917997,2
2020-07-09-170712,170712,0,0,1,127,0.16666666666666666,0.11531868,3
2020-07-10-170712,170712,2,0,0,129,0.5,1.1103438,4
2020-07-11-170712,170712,0,0,0,129,0.16666666666666666,0.040570404,5
2020-07-12-170712,170712,1,0,0,130,0.0,0.3724812,6
2020-07-13-170712,170712,0,1,0,130,0.16666666666666666,0.14485419,0
2020-07-14-170712,170712,1,0,0,131,0.3333333333333333,0.5217245,1
2020-07-15-170712,170712,1,0,1,132,1.0,0.614258,2
2020-07-16-170712,170712,0,0,0,132,0.6666666666666666,0.32479534,3
2020-07-17-170712,170712,0,0,3,132,0.3333333333333333,0.39889485,4
2020-07-18-170712,170712,0,0,0,132,0.5,0.47416574,5
2020-07-19-170712,170712,0,0,0,132,0.16666666666666666,0.035088953,6
2020-07-20-170712,170712,0,0,0,132,0.6666666666666666,0.5136354,0
2020-07-21-170712,170712,0,0,0,132,0.16666666666666666,0.09169894,1
2020-07-22-170712,170712,1,0,0,133,0.5,0.8540772,2
2020-07-23-170712,170712,1,0,0,134,0.3333333333333333,0.24226856,3
2020-07-24-170712,170712,0,0,0,134,1.1666666666666667,1.3199002,4
2020-07-25-170712,170712,0,0,1,134,0.5,0.13364911,5
2020-07-26-170712,170712,0,0,1,134,0.0,0.0019392013,6
2020-07-27-170712,170712,0,0,2,134,0.0,0.08740709,0
2020-07-28-170712,170712,0,0,2,134,0.8333333333333334,0.50088173,1
2020-07-29-170712,170712,1,0,5,135,0.6666666666666666,0.8174149,2
2020-07-30-170712,170712,0,0,4,135,2.5,1.6376731,3
2020-07-31-170712,170712,3,0,4,138,0.6666666666666666,1.0693432,4
2020-08-01-170712,170712,0,0,3,138,1.1666666666666667,0.52835345,5
2020-08-02-170712,170712,0,0,3,138,0.3333333333333333,0.477344,6
2020-08-03-170712,170712,0,0,2,138,1.6666666666666667,0.47125438,0
2020-08-04-170712,170712,0,0,4,138,1.1666666666666667,0.17914875,1
2020-08-05-170712,170712,0,0,6,138,2.6666666666666665,0.9754189,2
2020-08-06-170712,170712,0,0,1,138,3.1666666666666665,0.85657036,3
2020-08-07-170712,170712,0,1,2,138,2.5,0.7306981,4
2020-08-08-170712,170712,1,0,1,139,2.6666666666666665,1.5390497,5
2020-08-09-170712,170712,1,0,0,140,3.5,1.0297045,6
2020-08-10-170712,170712,2,0,2,142,5.833333333333332,2.365264,0
2020-08-11-170712,170712,2,1,2,144,5.166666666666667,2.3883193,1
2020-08-12-170712,170712,5,0,6,149,4.166666666666667,3.3556666,2
2020-08-13-170712,170712,4,0,5,153,5.5,4.796282,3
2020-08-14-170712,170712,4,0,0,157,8.0,6.9013634,4
2020-08-15-170712,170712,3,0,1,160,3.6666666666666665,2.5632522,5
2020-08-16-170712,170712,3,0,3,163,1.6666666666666667,2.3037696,6
2020-08-17-170712,170712,2,0,2,165,10.0,4.706199,0
2020-08-18-170712,170712,4,0,5,169,9.0,6.2574506,1
2020-08-19-170712,170712,6,0,0,175,5.333333333333333,5.8365674,2
2020-08-20-170712,170712,1,0,4,176,3.8333333333333335,1.8374037,3
2020-08-21-170712,170712,2,0,5,178,3.1666666666666665,1.9778645,4
2020-08-22-170712,170712,1,0,1,179,0.8333333333333334,1.4373587,5
2020-08-23-170712,170712,0,0,0,179,1.5,0.47780174,6
2020-08-24-170712,170712,2,0,4,181,3.5,4.52165,0
2020-08-25-170712,170712,2,0,3,183,3.0,2.1265814,1
2020-08-26-170712,170712,6,0,2,189,1.6666666666666667,2.9266622,2
2020-08-27-170712,170712,5,0,2,194,3.8333333333333335,1.7134572,3
2020-08-28-170712,170712,0,0,7,194,3.0,1.0638034,4
2020-08-29-170712,170712,1,0,3,195,3.333333333333333,2.782508,5
2020-08-30-170712,170712,3,0,2,198,3.0,2.5615447,6
2020-08-31-170712,170712,2,0,4,200,1.0,0.95824295,0
2020-09-01-170712,170712,5,0,2,205,2.0,1.3605628,1
2020-09-02-170712,170712,0,0,5,205,0.8333333333333334,0.3182447,2
2020-09-03-170712,170712,4,1,2,209,4.333333333333333,2.245533,3
2020-09-04-170712,170712,5,0,2,214,4.5,2.8756714,4
2020-09-05-170712,170712,1,0,0,215,0.8333333333333334,0.68556714,5
2020-09-06-170712,170712,0,0,1,215,3.6666666666666665,0.7469446,6
2020-09-07-170712,170712,4,0,2,219,1.1666666666666667,1.8608817,0
2020-09-08-170712,170712,3,0,7,222,3.6666666666666665,2.3949606,1
2020-09-09-170712,170712,2,0,2,224,1.3333333333333333,1.0277673,2
2020-09-10-170712,170712,2,0,1,226,4.833333333333333,1.6154648,3
2020-09-11-170712,170712,7,0,5,233,5.5,2.8175786,4
2020-09-12-170712,170712,3,0,3,236,0.8333333333333334,1.3811339,5
2020-09-13-170712,170712,2,0,2,238,2.1666666666666665,1.3168228,6
2020-09-14-170712,170712,4,0,1,242,3.1666666666666665,2.755414,0
2020-09-15-170712,170712,2,0,0,244,4.333333333333333,1.7701572,1
2020-09-16-170712,170712,5,0,1,249,5.333333333333333,1.9045991,2
2020-09-17-170712,170712,2,0,2,251,4.5,1.7665594,3
2020-09-18-170712,170712,2,0,1,253,4.666666666666667,1.5779958,4
2020-09-19-170712,170712,0,0,1,253,2.333333333333333,0.38015392,5
2020-09-20-170712,170712,1,0,1,254,3.333333333333333,0.7302384,6
2020-09-21-170712,170712,2,1,2,256,5.666666666666668,1.0733207,0
2020-09-22-170712,170712,7,0,3,263,2.833333333333333,2.0594864,1
2020-09-23-170712,170712,2,0,2,265,4.0,1.5685046,2
2020-09-24-170712,170712,1,0,5,266,2.333333333333333,1.0934579,3
2020-09-25-170712,170712,5,0,0,271,6.666666666666668,3.356212,4
2020-09-26-170712,170712,3,0,3,274,0.6666666666666666,1.3513007,5
2020-09-27-170712,170712,2,0,0,276,1.0,0.7029456,6
2020-09-28-170712,170712,1,0,1,277,2.5,1.4976923,0
2020-09-29-170712,170712,0,0,0,277,3.333333333333333,0.35245675,1
2020-09-30-170712,170712,1,0,1,278,2.333333333333333,1.3552773,2
2020-10-01-170712,170712,2,0,1,280,2.6666666666666665,1.4443073,3
2020-10-02-170712,170712,1,0,0,281,4.833333333333333,1.7607027,4
2020-10-03-170712,170712,1,0,4,282,2.1666666666666665,1.2388092,5
2020-10-04-170712,170712,1,0,1,283,3.0,1.0593123,6
2020-10-05-170712,170712,2,0,1,285,1.5,1.4287812,0
2020-10-06-170712,170712,3,0,1,288,1.8333333333333333,1.7625571,1
2020-10-07-170712,170712,2,0,2,290,1.3333333333333333,0.9929689,2
2020-10-08-170712,170712,5,0,6,295,5.666666666666668,3.809814,3
2020-10-09-170712,170712,0,0,0,295,2.833333333333333,0.93725216,4
2020-10-10-170712,170712,3,0,0,298,1.8333333333333333,1.4507356,5
2020-10-11-170712,170712,0,0,1,298,2.833333333333333,1.647476,6
2020-10-12-170712,170712,1,0,0,299,3.5,1.3411007,0
2020-10-13-170712,170712,0,0,0,299,4.0,1.5499405,1
2020-10-14-170712,170712,1,0,1,300,2.833333333333333,1.0348946,2
2020-10-15-170712,170712,1,0,4,301,2.5,1.2988479,3
2020-10-16-170712,170712,0,0,0,301,3.5,1.6245153,4
2020-10-17-170712,170712,4,1,3,305,1.6666666666666667,1.9734563,5
2020-10-18-170712,170712,1,0,1,306,2.333333333333333,0.9618873,6
2020-10-19-170712,170712,1,0,1,307,3.5,1.2261225,0
2020-10-20-170712,170712,1,0,1,308,1.5,0.8964462,1
2020-10-21-170712,170712,2,0,2,310,4.0,1.7164944,2
2020-10-22-170712,170712,6,0,0,316,3.0,2.6901314,3
2020-10-23-170712,170712,0,0,1,316,3.5,1.064058,4
2020-10-24-170712,170712,0,0,3,316,3.6666666666666665,1.8394608,5
2020-10-25-170712,170712,1,0,3,317,2.5,0.83302176,6
2020-10-26-170712,170712,0,0,1,317,3.8333333333333335,1.0802865,0
2020-10-27-170712,170712,0,0,1,317,2.5,0.94964844,1
2020-10-28-170712,170712,1,0,4,318,5.5,1.874634,2
2020-10-29-170712,170712,4,0,0,322,5.5,4.399762,3
2020-10-30-170712,170712,0,0,3,322,6.0,0.96972793,4
2020-10-31-170712,170712,3,0,0,325,3.6666666666666665,3.0288498,5
2020-11-01-170712,170712,1,0,0,326,2.333333333333333,0.6878297,6
2020-11-02-170712,170712,1,0,0,327,2.833333333333333,1.089314,0
2020-11-03-170712,170712,1,0,0,328,7.833333333333332,2.068485,1
2020-11-04-170712,170712,2,0,0,330,2.6666666666666665,1.4389864,2
2020-11-05-170712,170712,0,0,0,330,7.333333333333332,1.4198397,3
2020-11-06-170712,170712,1,0,0,331,7.666666666666668,1.6037581,4
2020-11-07-170712,170712,3,0,0,334,2.833333333333333,1.0328991,5
2020-11-08-170712,170712,3,0,0,337,2.5,0.94797474,6
2020-11-09-170712,170712,1,0,0,338,4.0,1.9674227,0
2020-11-10-170712,170712,1,0,0,339,4.166666666666667,1.3164135,1
2020-11-11-170712,170712,4,0,0,343,4.333333333333333,2.0841196,2
2020-11-12-170712,170712,0,0,0,343,4.333333333333333,0.43406555,3
2020-11-13-170712,170712,3,0,0,346,3.6666666666666665,1.5376579,4
2020-03-01-170713,170713,0,0,5,0,0.2,0.0065031815,6
2020-03-02-170713,170713,0,0,5,0,0.0,0.00012667697,0
2020-03-03-170713,170713,0,4,10,0,0.0,0.0018524831,1
2020-03-04-170713,170713,0,0,10,0,0.2,0.0007610244,2
2020-03-05-170713,170713,0,0,5,0,0.2,0.014816522,3
2020-03-06-170713,170713,0,0,11,0,0.2,0.12481896,4
2020-03-07-170713,170713,0,0,7,0,0.2,0.10726208,5
2020-03-08-170713,170713,0,0,5,0,0.0,2.9726007e-06,6
2020-03-09-170713,170713,0,0,9,0,0.2,0.11294404,0
2020-03-10-170713,170713,0,0,6,0,0.8,0.13452286,1
2020-03-11-170713,170713,0,0,7,0,0.4,0.14443961,2
2020-03-12-170713,170713,3,0,6,3,0.8,0.68949556,3
2020-03-13-170713,170713,3,0,7,6,1.4,0.541453,4
2020-03-14-170713,170713,4,0,4,10,1.6,0.5053245,5
2020-03-15-170713,170713,5,0,2,15,1.6,0.553091,6
2020-03-16-170713,170713,5,0,4,20,6.2,2.3923807,0
2020-03-17-170713,170713,10,1,5,30,6.8,2.877072,1
2020-03-18-170713,170713,10,0,1,40,8.2,3.2935166,2
2020-03-19-170713,170713,5,0,0,45,13.0,3.5221987,3
2020-03-20-170713,170713,11,0,1,56,8.2,3.2911663,4
2020-03-21-170713,170713,7,0,0,63,3.6,1.1846545,5
2020-03-22-170713,170713,5,0,0,68,7.6,1.8977373,6
2020-03-23-170713,170713,9,0,3,77,17.0,5.4142485,0
2020-03-24-170713,170713,6,0,0,83,12.6,3.9368098,1
2020-03-25-170713,170713,7,0,0,90,15.4,4.8979464,2
2020-03-26-170713,170713,6,0,1,96,15.0,4.238102,3
2020-03-27-170713,170713,7,0,0,103,13.4,3.95815,4
2020-03-28-170713,170713,4,0,2,107,7.4,0.8330112,5
2020-03-29-170713,170713,2,0,1,109,5.6,1.0436825,6
2020-03-30-170713,170713,4,0,0,113,14.6,3.8982077,0
2020-03-31-170713,170713,5,0,2,118,10.6,2.5707128,1
2020-04-01-170713,170713,1,0,3,119,9.0,2.3119843,2
2020-04-02-170713,170713,0,0,0,119,18.2,5.1210885,3
2020-04-03-170713,170713,1,0,0,120,8.0,2.1495762,4
2020-04-04-170713,170713,0,0,0,120,7.4,1.8096762,5
2020-04-05-170713,170713,0,0,0,120,3.8,0.6807949,6
2020-04-06-170713,170713,3,0,0,123,12.4,3.8307917,0
2020-04-07-170713,170713,0,0,1,123,5.6,1.4960035,1
2020-04-08-170713,170713,0,0,0,123,5.4,1.2782041,2
2020-04-09-170713,170713,1,0,0,124,4.8,0.5736946,3
2020-04-10-170713,170713,0,0,0,124,6.4,1.1354411,4
2020-04-11-170713,170713,2,0,1,126,3.6,0.53887165,5
2020-04-12-170713,170713,1,0,1,127,4.4,1.0452492,6
2020-04-13-170713,170713,0,1,0,127,11.0,3.2573352,0
2020-04-14-170713,170713,2,0,2,129,11.8,2.8619337,1
2020-04-15-170713,170713,3,0,0,132,7.8,3.0570064,2
2020-04-16-170713,170713,0,0,1,132,4.8,1.3261322,3
2020-04-17-170713,170713,0,0,0,132,3.0,1.713265,4
2020-04-18-170713,170713,0,0,0,132,9.8,3.3194535,5
2020-04-19-170713,170713,0,0,0,132,6.6,2.0909495,6
2020-04-20-170713,170713,0,0,1,132,7.4,2.0884392,0
2020-04-21-170713,170713,1,0,1,133,4.6,1.1765126,1
2020-04-22-170713,170713,0,0,0,133,10.2,3.624612,2
2020-04-23-170713,170713,0,0,1,133,2.6,0.40507093,3
2020-04-24-170713,170713,0,0,0,133,7.4,2.121582,4
2020-04-25-170713,170713,1,0,0,134,1.2,0.24007025,5
2020-04-26-170713,170713,1,0,0,135,1.4,0.2218855,6
2020-04-27-170713,170713,0,1,0,135,4.4,1.4164484,0
2020-04-28-170713,170713,2,0,0,137,3.2,1.4157614,1
2020-04-29-170713,170713,0,0,5,137,6.0,1.8403337,2
2020-04-30-170713,170713,1,0,2,138,5.6,2.052611,3
2020-05-01-170713,170713,0,0,1,138,1.2,0.22537056,4
2020-05-02-170713,170713,0,0,1,138,1.8,0.17390591,5
2020-05-03-170713,170713,0,0,0,138,0.6,0.046669684,6
2020-05-04-170713,170713,1,0,1,139,3.0,0.7633327,0
2020-05-05-170713,170713,1,0,1,140,3.6,1.5029362,1
2020-05-06-170713,170713,0,0,3,140,3.8,1.1351175,2
2020-05-07-170713,170713,1,0,0,141,4.4,1.9467643,3
2020-05-08-170713,170713,0,0,2,141,5.4,1.3866246,4
2020-05-09-170713,170713,0,0,0,141,2.2,0.6333313,5
2020-05-10-170713,170713,0,0,1,141,1.8,0.43784553,6
2020-05-11-170713,170713,0,0,0,141,5.6,2.1247375,0
2020-05-12-170713,170713,0,0,1,141,5.4,1.5699552,1
2020-05-13-170713,170713,5,0,1,146,3.4,1.5679175,2
2020-05-14-170713,170713,2,0,0,148,4.4,2.132305,3
2020-05-15-170713,170713,1,0,0,149,4.4,1.6398801,4
2020-05-16-170713,170713,1,0,2,150,2.0,0.6862351,5
2020-05-17-170713,170713,0,0,1,150,2.2,0.6317213,6
2020-05-18-170713,170713,1,0,0,151,6.2,1.9607551,0
2020-05-19-170713,170713,1,0,2,152,3.8,1.3679616,1
2020-05-20-170713,170713,3,0,0,155,4.0,1.8760731,2
2020-05-21-170713,170713,0,0,2,155,4.2,1.4588763,3
2020-05-22-170713,170713,2,1,0,157,4.6,1.9198079,4
2020-05-23-170713,170713,0,0,0,157,2.4,0.38949507,5
2020-05-24-170713,170713,1,0,0,158,2.0,0.4525933,6
2020-05-25-170713,170713,0,0,0,158,3.6,1.7147949,0
2020-05-26-170713,170713,1,0,0,159,4.2,1.8605757,1
2020-05-27-170713,170713,1,0,0,160,5.6,2.056289,2
2020-05-28-170713,170713,0,1,0,160,2.6,1.6582314,3
2020-05-29-170713,170713,0,0,2,160,2.2,0.6809079,4
2020-05-30-170713,170713,2,0,1,162,0.0,0.13126443,5
2020-05-31-170713,170713,1,0,3,163,0.0,0.06346939,6
2020-06-01-170713,170713,0,1,0,163,1.6,0.5404687,0
2020-06-02-170713,170713,2,0,0,165,3.4,0.9424582,1
2020-06-03-170713,170713,0,0,1,165,2.0,0.71367127,2
2020-06-04-170713,170713,2,0,0,167,1.4,0.4408641,3
2020-06-05-170713,170713,0,0,2,167,1.0,0.167605,4
2020-06-06-170713,170713,0,0,1,167,1.4,0.13887449,5
2020-06-07-170713,170713,0,0,0,167,0.4,0.11852236,6
2020-06-08-170713,170713,0,0,0,167,2.0,1.0202688,0
2020-06-09-170713,170713,0,0,0,167,1.8,0.94145733,1
2020-06-10-170713,170713,0,0,0,167,1.0,0.33601847,2
2020-06-11-170713,170713,0,0,1,167,1.2,0.6222549,3
2020-06-12-170713,170713,2,0,0,169,2.4,1.405976,4
2020-06-13-170713,170713,1,0,0,170,0.4,0.093373545,5
2020-06-14-170713,170713,3,0,0,173,0.0,0.22608712,6
2020-06-15-170713,170713,0,0,0,173,1.8,0.8230094,0
2020-06-16-170713,170713,0,0,0,173,2.0,0.8440182,1
2020-06-17-170713,170713,1,0,0,174,1.8,0.9433542,2
2020-06-18-170713,170713,0,1,1,174,0.6,0.29952523,3
2020-06-19-170713,170713,2,0,1,176,1.6,0.61117435,4
2020-06-20-170713,170713,1,0,1,177,0.6,0.34961236,5
2020-06-21-170713,170713,0,0,0,177,0.6,0.13247162,6
2020-06-22-170713,170713,0,0,1,177,1.2,0.46507668,0
2020-06-23-170713,170713,0,0,0,177,1.2,1.0490764,1
2020-06-24-170713,170713,0,0,0,177,0.8,0.27926138,2
2020-06-25-170713,170713,1,0,0,178,0.8,0.6317975,3
2020-06-26-170713,170713,0,0,0,178,1.4,0.5861907,4
2020-06-27-170713,170713,0,0,1,178,0.4,0.2351112,5
2020-06-28-170713,170713,0,0,0,178,0.6,0.10303876,6
2020-06-29-170713,170713,0,0,0,178,0.4,0.0176717,0
2020-06-30-170713,170713,0,0,1,178,0.4,0.2780684,1
2020-07-01-170713,170713,0,0,0,178,0.8,0.25166124,2
2020-07-02-170713,170713,1,0,0,179,0.8,0.93952036,3
2020-07-03-170713,170713,1,0,0,180,0.4,0.36033377,4
2020-07-04-170713,170713,1,0,2,181,0.4,0.32747933,5
2020-07-05-170713,170713,0,0,1,181,0.0,0.0075586704,6
2020-07-06-170713,170713,1,0,4,182,0.8,0.371192,0
2020-07-07-170713,170713,0,0,0,182,0.4,0.1321269,1
2020-07-08-170713,170713,0,0,0,182,0.2,0.16321304,2
2020-07-09-170713,170713,0,0,0,182,2.0,0.86077553,3
2020-07-10-170713,170713,0,1,1,182,2.0,0.53709483,4
2020-07-11-170713,170713,1,0,0,183,0.2,0.30129814,5
2020-07-12-170713,170713,0,0,0,183,0.2,0.12410995,6
2020-07-13-170713,170713,0,0,0,183,0.6,0.38792995,0
2020-07-14-170713,170713,1,0,0,184,0.2,0.10044891,1
2020-07-15-170713,170713,0,0,2,184,1.6,1.230358,2
2020-07-16-170713,170713,0,0,2,184,1.0,0.61988586,3
2020-07-17-170713,170713,0,0,1,184,1.0,0.63091785,4
2020-07-18-170713,170713,2,0,0,186,0.2,0.34898788,5
2020-07-19-170713,170713,1,0,0,187,0.4,0.34751102,6
2020-07-20-170713,170713,4,0,1,191,0.4,0.526278,0
2020-07-21-170713,170713,0,0,1,191,1.0,0.43639603,1
2020-07-22-170713,170713,0,0,2,191,1.8,0.7032132,2
2020-07-23-170713,170713,0,0,1,191,1.0,0.6065721,3
2020-07-24-170713,170713,1,0,1,192,0.4,0.57573605,4
2020-07-25-170713,170713,0,0,1,192,0.4,0.14204976,5
2020-07-26-170713,170713,0,0,4,192,0.0,0.0048992233,6
2020-07-27-170713,170713,0,0,1,192,0.6,0.51342446,0
2020-07-28-170713,170713,0,0,1,192,1.0,0.95829207,1
2020-07-29-170713,170713,2,0,1,194,0.6,0.2581308,2
2020-07-30-170713,170713,2,1,1,196,1.0,0.38026294,3
2020-07-31-170713,170713,1,0,1,197,2.0,0.4155572,4
2020-08-01-170713,170713,0,0,2,197,0.4,0.12743892,5
2020-08-02-170713,170713,0,0,1,197,1.2,0.32938123,6
2020-08-03-170713,170713,1,0,1,198,1.2,0.43623987,0
2020-08-04-170713,170713,1,0,2,199,0.4,0.21418424,1
2020-08-05-170713,170713,2,0,2,201,1.6,1.3768535,2
2020-08-06-170713,170713,1,0,2,202,1.6,1.134136,3
2020-08-07-170713,170713,1,0,1,203,1.2,0.66826886,4
2020-08-08-170713,170713,1,0,4,204,1.0,0.22026116,5
2020-08-09-170713,170713,4,0,3,208,0.4,0.6050284,6
2020-08-10-170713,170713,1,0,1,209,0.6,0.50708663,0
2020-08-11-170713,170713,1,0,2,210,2.0,0.9237421,1
2020-08-12-170713,170713,1,0,2,211,2.0,0.71513474,2
2020-08-13-170713,170713,1,0,1,212,1.6,1.9512308,3
2020-08-14-170713,170713,1,0,1,213,1.6,0.80315346,4
2020-08-15-170713,170713,2,0,0,215,2.2,0.4962292,5
2020-08-16-170713,170713,1,0,0,216,0.6,0.3831588,6
2020-08-17-170713,170713,1,0,2,217,3.0,1.5364486,0
2020-08-18-170713,170713,2,0,3,219,3.0,0.71180433,1
2020-08-19-170713,170713,2,0,3,221,2.8,1.4996561,2
2020-08-20-170713,170713,2,0,1,223,2.4,0.6408886,3
2020-08-21-170713,170713,1,0,2,224,5.0,1.4344621,4
2020-08-22-170713,170713,4,0,0,228,2.2,1.6129116,5
2020-08-23-170713,170713,3,1,1,231,1.8,0.35845828,6
2020-08-24-170713,170713,1,0,1,232,3.2,1.0164119,0
2020-08-25-170713,170713,2,0,1,234,5.0,2.9796972,1
2020-08-26-170713,170713,2,0,0,236,3.0,1.0044992,2
2020-08-27-170713,170713,1,0,0,237,3.6,1.4025735,3
2020-08-28-170713,170713,1,0,1,238,3.0,0.7222938,4
2020-08-29-170713,170713,0,0,4,238,1.8,0.43863788,5
2020-08-30-170713,170713,0,0,0,238,1.8,0.51920193,6
2020-08-31-170713,170713,2,0,3,240,4.2,2.0967524,0
2020-09-01-170713,170713,3,0,2,243,3.0,0.86774594,1
2020-09-02-170713,170713,3,0,0,246,3.0,0.99185693,2
2020-09-03-170713,170713,1,0,1,247,3.6,1.256497,3
2020-09-04-170713,170713,2,0,1,249,2.2,0.7421656,4
2020-09-05-170713,170713,0,0,2,249,1.8,0.82189053,5
2020-09-06-170713,170713,1,0,0,250,1.6,0.37214872,6
2020-09-07-170713,170713,1,0,1,251,4.4,1.5997012,0
2020-09-08-170713,170713,1,0,1,252,4.2,2.3016458,1
2020-09-09-170713,170713,0,0,9,252,2.2,1.3780152,2
2020-09-10-170713,170713,0,0,2,252,2.2,0.73874784,3
2020-09-11-170713,170713,1,0,2,253,6.0,0.97177047,4
2020-09-12-170713,170713,4,0,5,257,1.2,1.5333315,5
2020-09-13-170713,170713,0,0,1,257,0.6,0.10606897,6
2020-09-14-170713,170713,3,0,3,260,8.0,2.6720648,0
2020-09-15-170713,170713,2,0,0,262,1.8,0.8419427,1
2020-09-16-170713,170713,0,0,9,262,3.6,1.0114231,2
2020-09-17-170713,170713,1,0,1,263,4.8,1.5941696,3
2020-09-18-170713,170713,1,0,0,264,6.0,2.106957,4
2020-09-19-170713,170713,2,0,0,266,1.8,0.47601756,5
2020-09-20-170713,170713,0,0,1,266,2.8,0.9133584,6
2020-09-21-170713,170713,1,1,0,267,4.4,1.6146693,0
2020-09-22-170713,170713,1,0,3,268,4.4,1.1268623,1
2020-09-23-170713,170713,9,0,0,277,4.2,1.2947608,2
2020-09-24-170713,170713,2,0,2,279,4.4,1.1905506,3
2020-09-25-170713,170713,2,0,2,281,7.0,2.4965582,4
2020-09-26-170713,170713,5,0,0,286,1.8,0.6377272,5
2020-09-27-170713,170713,1,0,1,287,0.8,0.45224124,6
2020-09-28-170713,170713,3,0,0,290,4.6,1.9586654,0
2020-09-29-170713,170713,0,0,3,290,2.2,0.5011404,1
2020-09-30-170713,170713,9,0,0,299,2.8,1.0816394,2
2020-10-01-170713,170713,1,0,0,300,5.2,0.7681746,3
2020-10-02-170713,170713,0,0,1,300,6.4,1.1724184,4
2020-10-03-170713,170713,0,1,1,300,2.6,0.44089526,5
2020-10-04-170713,170713,1,0,4,301,2.2,0.34675264,6
2020-10-05-170713,170713,0,1,4,301,3.8,0.79049283,0
2020-10-06-170713,170713,3,0,1,304,4.6,1.2347533,1
2020-10-07-170713,170713,0,1,1,304,2.6,0.7010771,2
2020-10-08-170713,170713,2,0,0,306,2.2,0.7389258,3
2020-10-09-170713,170713,2,0,1,308,5.4,1.1656606,4
2020-10-10-170713,170713,0,0,1,308,1.2,0.33381668,5
2020-10-11-170713,170713,1,0,1,309,1.6,0.45856628,6
2020-10-12-170713,170713,0,0,4,309,1.8,0.4315517,0
2020-10-13-170713,170713,3,0,1,312,3.4,0.84499675,1
2020-10-14-170713,170713,0,0,2,312,4.4,0.6288819,2
2020-10-15-170713,170713,0,0,1,312,2.4,0.90418977,3
2020-10-16-170713,170713,1,0,0,313,6.0,1.4855394,4
2020-10-17-170713,170713,1,0,0,314,3.4,0.29780334,5
2020-10-18-170713,170713,4,1,1,318,1.8,0.5836353,6
2020-10-19-170713,170713,4,0,0,322,5.2,1.0930133,0
2020-10-20-170713,170713,1,0,2,323,3.8,0.7230184,1
2020-10-21-170713,170713,1,0,1,324,3.0,0.63970697,2
2020-10-22-170713,170713,0,0,6,324,8.4,2.2335124,3
2020-10-23-170713,170713,1,0,3,325,4.0,0.9770674,4
2020-10-24-170713,170713,1,0,0,326,6.0,0.6520963,5
2020-10-25-170713,170713,1,1,0,327,5.0,0.6124505,6
2020-10-26-170713,170713,4,0,1,331,2.4,0.54958963,0
2020-10-27-170713,170713,1,0,1,332,7.8,1.4206734,1
2020-10-28-170713,170713,2,0,3,334,8.6,1.3778952,2
2020-10-29-170713,170713,1,0,0,335,10.6,2.1937113,3
2020-10-30-170713,170713,0,1,3,335,9.8,1.1690437,4
2020-10-31-170713,170713,0,0,0,335,6.2,0.91003305,5
2020-11-01-170713,170713,1,0,0,336,3.4,0.50122404,6
2020-11-02-170713,170713,0,0,0,336,2.8,0.44120228,0
2020-11-03-170713,170713,2,0,0,338,7.4,1.7782763,1
2020-11-04-170713,170713,1,0,0,339,5.2,1.3769252,2
2020-11-05-170713,170713,6,0,0,345,6.0,1.6578376,3
2020-11-06-170713,170713,3,0,0,348,10.2,1.7704192,4
2020-11-07-170713,170713,0,0,0,348,3.0,0.2923824,5
2020-11-08-170713,170713,0,0,0,348,0.8,0.14685939,6
2020-11-09-170713,170713,1,0,0,349,3.8,1.0673006,0
2020-11-10-170713,170713,1,0,0,350,3.8,0.5781315,1
2020-11-11-170713,170713,3,3,0,353,3.0,1.0224386,2
2020-11-12-170713,170713,0,0,0,353,6.8,0.4639117,3
2020-11-13-170713,170713,3,0,0,356,6.8,2.6479292,4
2020-03-01-170714,170714,0,0,0,0,0.0,0.0010684895,6
2020-03-02-170714,170714,0,0,0,0,0.0,0.00024180317,0
2020-03-03-170714,170714,0,1,0,0,0.0,0.00032269166,1
2020-03-04-170714,170714,0,0,0,0,0.25,0.001548574,2
2020-03-05-170714,170714,0,0,2,0,0.0,0.0030823266,3
2020-03-06-170714,170714,0,0,2,0,0.25,0.042603895,4
2020-03-07-170714,170714,0,0,2,0,0.5,0.029975597,5
2020-03-08-170714,170714,0,0,4,0,0.0,7.269585e-11,6
2020-03-09-170714,170714,0,0,1,0,0.25,0.039298013,0
2020-03-10-170714,170714,0,0,7,0,0.75,0.050441414,1
2020-03-11-170714,170714,0,0,9,0,0.5,0.055002492,2
2020-03-12-170714,170714,0,0,10,0,2.0,0.3144005,3
2020-03-13-170714,170714,0,0,7,0,2.75,0.23867966,4
2020-03-14-170714,170714,0,0,11,0,3.75,0.17073508,5
2020-03-15-170714,170714,0,0,0,0,3.75,0.19973941,6
2020-03-16-170714,170714,0,1,8,0,9.25,0.66986364,0
2020-03-17-170714,170714,0,0,11,0,11.5,0.98852503,1
2020-03-18-170714,170714,0,0,1,0,13.75,1.127695,2
2020-03-19-170714,170714,2,0,4,2,13.75,0.9887928,3
2020-03-20-170714,170714,2,0,9,4,14.0,0.8897519,4
2020-03-21-170714,170714,2,0,0,6,9.0,0.3099599,5
2020-03-22-170714,170714,4,0,5,10,10.5,0.42747465,6
2020-03-23-170714,170714,1,0,1,11,20.5,1.7266554,0
2020-03-24-170714,170714,7,0,3,18,17.25,0.8153508,1
2020-03-25-170714,170714,9,0,5,27,16.5,0.88229775,2
2020-03-26-170714,170714,10,0,6,37,16.5,1.0463483,3
2020-03-27-170714,170714,7,0,1,44,16.25,0.994757,4
2020-03-28-170714,170714,11,0,3,55,4.25,0.12297128,5
2020-03-29-170714,170714,0,0,0,55,6.0,0.16257766,6
2020-03-30-170714,170714,8,0,6,63,24.0,0.98327243,0
2020-03-31-170714,170714,11,0,4,74,9.25,0.4671969,1
2020-04-01-170714,170714,1,0,1,75,13.5,0.48409206,2
2020-04-02-170714,170714,4,0,3,79,16.25,1.0882496,3
2020-04-03-170714,170714,9,0,2,88,8.75,0.44869128,4
2020-04-04-170714,170714,0,0,1,88,9.0,0.34756938,5
2020-04-05-170714,170714,5,0,3,93,3.75,0.1219345,6
2020-04-06-170714,170714,1,1,3,94,14.0,0.8439421,0
2020-04-07-170714,170714,3,0,3,97,5.25,0.2907441,1
2020-04-08-170714,170714,5,0,3,102,5.5,0.25208098,2
2020-04-09-170714,170714,6,0,3,108,3.0,0.08182149,3
2020-04-10-170714,170714,1,0,10,109,5.0,0.09977353,4
2020-04-11-170714,170714,3,0,1,112,4.5,0.112536326,5
2020-04-12-170714,170714,0,2,3,112,3.0,0.13101459,6
2020-04-13-170714,170714,6,0,2,118,10.5,0.7263742,0
2020-04-14-170714,170714,4,0,3,122,7.25,0.652674,1
2020-04-15-170714,170714,1,0,2,123,9.5,0.67112815,2
2020-04-16-170714,170714,3,1,2,126,3.75,0.21532165,3
2020-04-17-170714,170714,2,0,1,128,2.0,0.19847405,4
2020-04-18-170714,170714,1,0,1,129,10.25,0.55979705,5
2020-04-19-170714,170714,3,0,2,132,7.25,0.30656335,6
2020-04-20-170714,170714,3,3,0,135,5.75,0.41625997,0
2020-04-21-170714,170714,3,0,1,138,3.75,0.32262698,1
2020-04-22-170714,170714,3,0,4,141,9.75,0.89553934,2
2020-04-23-170714,170714,3,0,1,144,2.25,0.07550204,3
2020-04-24-170714,170714,10,0,7,154,6.75,0.33796194,4
2020-04-25-170714,170714,1,0,1,155,1.25,0.06440187,5
2020-04-26-170714,170714,3,0,0,158,1.75,0.043735046,6
2020-04-27-170714,170714,2,0,3,160,5.0,0.2708498,0
2020-04-28-170714,170714,3,0,5,163,4.75,0.29148078,1
2020-04-29-170714,170714,2,0,2,165,13.5,0.34661052,2
2020-04-30-170714,170714,2,0,6,167,5.5,0.4920672,3
2020-05-01-170714,170714,1,0,3,168,1.0,0.038372904,4
2020-05-02-170714,170714,1,0,1,169,0.5,0.0014646988,5
2020-05-03-170714,170714,2,0,2,171,0.0,1.3597856e-05,6
2020-05-04-170714,170714,0,0,1,171,2.75,0.12435223,0
2020-05-05-170714,170714,1,0,2,172,5.75,0.38713267,1
2020-05-06-170714,170714,4,0,2,176,2.0,0.14687441,2
2020-05-07-170714,170714,1,0,3,177,4.5,0.37827307,3
2020-05-08-170714,170714,7,0,5,184,3.0,0.26987508,4
2020-05-09-170714,170714,1,0,5,185,2.0,0.08415197,5
2020-05-10-170714,170714,0,0,3,185,1.25,0.056585405,6
2020-05-11-170714,170714,3,0,3,188,5.25,0.3671347,0
2020-05-12-170714,170714,5,0,2,193,4.25,0.35274497,1
2020-05-13-170714,170714,2,0,9,195,4.75,0.5534929,2
2020-05-14-170714,170714,6,0,2,201,3.75,0.36610368,3
2020-05-15-170714,170714,3,0,4,204,5.25,0.3300127,4
2020-05-16-170714,170714,1,0,0,205,3.25,0.13608247,5
2020-05-17-170714,170714,2,0,0,207,2.75,0.09711929,6
2020-05-18-170714,170714,1,0,2,208,5.25,0.4375352,0
2020-05-19-170714,170714,2,0,1,210,4.75,0.38675007,1
2020-05-20-170714,170714,2,0,1,212,5.0,0.5911571,2
2020-05-21-170714,170714,3,0,1,215,4.25,0.38555664,3
2020-05-22-170714,170714,5,0,0,220,5.0,0.48025787,4
2020-05-23-170714,170714,5,0,5,225,1.0,0.07685017,5
2020-05-24-170714,170714,3,0,0,228,2.5,0.09480924,6
2020-05-25-170714,170714,3,0,1,231,4.25,0.51102364,0
2020-05-26-170714,170714,2,0,1,233,4.75,0.56404454,1
2020-05-27-170714,170714,9,0,1,242,5.0,0.49028736,2
2020-05-28-170714,170714,2,0,0,244,2.0,0.24101785,3
2020-05-29-170714,170714,4,0,2,248,2.5,0.17196,4
2020-05-30-170714,170714,0,0,0,248,0.75,0.06352007,5
2020-05-31-170714,170714,0,0,0,248,1.0,0.03168435,6
2020-06-01-170714,170714,2,1,0,250,1.75,0.1399579,0
2020-06-02-170714,170714,1,0,0,251,2.75,0.27799216,1
2020-06-03-170714,170714,1,0,2,252,2.25,0.16555268,2
2020-06-04-170714,170714,1,0,0,253,1.5,0.13033289,3
2020-06-05-170714,170714,0,0,0,253,1.5,0.0441026,4
2020-06-06-170714,170714,5,0,0,258,0.75,0.023825794,5
2020-06-07-170714,170714,0,2,0,258,0.5,0.02274233,6
2020-06-08-170714,170714,1,0,0,259,2.25,0.311257,0
2020-06-09-170714,170714,1,0,0,260,2.25,0.24382472,1
2020-06-10-170714,170714,1,0,0,261,1.0,0.08324149,2
2020-06-11-170714,170714,0,0,0,261,1.0,0.15240052,3
2020-06-12-170714,170714,2,0,1,263,3.0,0.26459903,4
2020-06-13-170714,170714,0,0,0,263,0.5,0.032105822,5
2020-06-14-170714,170714,0,0,0,263,0.75,0.09698314,6
2020-06-15-170714,170714,0,0,1,263,1.75,0.18781012,0
2020-06-16-170714,170714,0,0,0,263,2.5,0.32826027,1
2020-06-17-170714,170714,2,0,0,265,2.25,0.2798317,2
2020-06-18-170714,170714,0,0,0,265,1.0,0.07185543,3
2020-06-19-170714,170714,0,0,0,265,2.0,0.2470067,4
2020-06-20-170714,170714,0,0,0,265,0.75,0.108501926,5
2020-06-21-170714,170714,0,0,0,265,0.25,0.025903622,6
2020-06-22-170714,170714,0,0,1,265,1.5,0.13613006,0
2020-06-23-170714,170714,0,2,0,265,2.0,0.18183812,1
2020-06-24-170714,170714,0,0,0,265,2.0,0.0490627,2
2020-06-25-170714,170714,0,1,1,265,2.25,0.20428714,3
2020-06-26-170714,170714,1,2,0,266,1.5,0.19263396,4
2020-06-27-170714,170714,0,0,0,266,0.5,0.03537101,5
2020-06-28-170714,170714,0,0,0,266,0.0,0.008445548,6
2020-06-29-170714,170714,1,0,0,267,0.5,0.0049946913,0
2020-06-30-170714,170714,0,0,0,267,0.75,0.057223286,1
2020-07-01-170714,170714,0,0,0,267,0.5,0.040690668,2
2020-07-02-170714,170714,0,0,0,267,1.0,0.1891273,3
2020-07-03-170714,170714,0,0,0,267,0.75,0.1207659,4
2020-07-04-170714,170714,0,0,0,267,0.5,0.14597853,5
2020-07-05-170714,170714,0,0,0,267,0.0,0.00024308577,6
2020-07-06-170714,170714,1,0,0,268,0.75,0.1293827,0
2020-07-07-170714,170714,0,1,1,268,0.5,0.049451213,1
2020-07-08-170714,170714,0,0,0,268,0.25,0.12932524,2
2020-07-09-170714,170714,1,0,0,269,1.75,0.12923235,3
2020-07-10-170714,170714,0,0,0,269,2.5,0.11120006,4
2020-07-11-170714,170714,0,1,1,269,0.5,0.30421352,5
2020-07-12-170714,170714,0,0,0,269,0.75,0.10815962,6
2020-07-13-170714,170714,0,0,0,269,0.5,0.08031884,0
2020-07-14-170714,170714,0,0,0,269,0.5,0.053456556,1
2020-07-15-170714,170714,0,0,0,269,2.75,0.31042808,2
2020-07-16-170714,170714,0,0,1,269,2.0,0.53818023,3
2020-07-17-170714,170714,0,0,3,269,1.0,0.15920337,4
2020-07-18-170714,170714,0,0,0,269,0.75,0.093980804,5
2020-07-19-170714,170714,0,0,1,269,0.75,0.10171217,6
2020-07-20-170714,170714,0,0,1,269,2.0,0.33977136,0
2020-07-21-170714,170714,1,0,0,270,1.0,0.14967267,1
2020-07-22-170714,170714,0,0,0,270,2.25,0.19013841,2
2020-07-23-170714,170714,0,0,0,270,2.0,0.14197662,3
2020-07-24-170714,170714,0,0,1,270,1.25,0.16070157,4
2020-07-25-170714,170714,1,0,0,271,0.75,0.041609738,5
2020-07-26-170714,170714,0,0,0,271,0.5,0.0010174188,6
2020-07-27-170714,170714,0,1,0,271,1.0,0.45842293,0
2020-07-28-170714,170714,0,0,1,271,2.0,0.17397498,1
2020-07-29-170714,170714,0,0,0,271,1.25,0.10888727,2
2020-07-30-170714,170714,1,0,1,272,1.75,0.10083826,3
2020-07-31-170714,170714,3,0,1,275,2.25,0.045044217,4
2020-08-01-170714,170714,0,0,1,275,0.5,0.050670963,5
2020-08-02-170714,170714,1,0,1,276,1.5,0.049719267,6
2020-08-03-170714,170714,1,0,0,277,0.75,0.08381971,0
2020-08-04-170714,170714,0,0,2,277,1.0,0.09443943,1
2020-08-05-170714,170714,0,0,0,277,4.0,0.7336985,2
2020-08-06-170714,170714,0,0,0,277,2.0,0.29928005,3
2020-08-07-170714,170714,1,0,0,278,1.5,0.5915093,4
2020-08-08-170714,170714,0,0,1,278,1.5,0.08578566,5
2020-08-09-170714,170714,0,0,0,278,1.5,0.2609937,6
2020-08-10-170714,170714,0,0,1,278,1.25,0.09710285,0
2020-08-11-170714,170714,1,0,3,279,3.0,0.24640067,1
2020-08-12-170714,170714,0,0,2,279,2.25,0.13479492,2
2020-08-13-170714,170714,1,0,1,280,3.0,0.3601886,3
2020-08-14-170714,170714,1,0,0,281,2.0,0.15212259,4
2020-08-15-170714,170714,1,0,0,282,1.25,0.090953715,5
2020-08-16-170714,170714,1,0,0,283,0.5,0.054923866,6
2020-08-17-170714,170714,0,0,1,283,3.75,0.34555233,0
2020-08-18-170714,170714,2,0,5,285,1.75,0.16759089,1
2020-08-19-170714,170714,0,0,3,285,2.5,0.23447156,2
2020-08-20-170714,170714,0,0,6,285,3.75,0.31250137,3
2020-08-21-170714,170714,0,0,3,285,2.0,0.28029117,4
2020-08-22-170714,170714,1,0,3,286,3.5,0.24996407,5
2020-08-23-170714,170714,0,0,0,286,2.75,0.07228686,6
2020-08-24-170714,170714,1,0,2,287,4.25,0.44105724,0
2020-08-25-170714,170714,3,0,1,290,4.75,0.48158777,1
2020-08-26-170714,170714,2,0,0,292,3.0,0.2574571,2
2020-08-27-170714,170714,1,0,1,293,4.75,0.35022333,3
2020-08-28-170714,170714,0,0,4,293,3.0,0.17536879,4
2020-08-29-170714,170714,0,0,1,293,0.75,0.18511952,5
2020-08-30-170714,170714,0,0,0,293,1.5,0.066167615,6
2020-08-31-170714,170714,1,0,3,294,5.25,0.45257446,0
2020-09-01-170714,170714,5,0,0,299,2.25,0.48348975,1
2020-09-02-170714,170714,3,0,1,302,4.75,0.17519717,2
2020-09-03-170714,170714,6,0,4,308,3.25,0.3626345,3
2020-09-04-170714,170714,3,0,1,311,3.75,0.17229559,4
2020-09-05-170714,170714,3,0,0,314,1.0,0.15178119,5
2020-09-06-170714,170714,0,0,0,314,2.75,0.09242567,6
2020-09-07-170714,170714,2,0,1,316,4.5,0.33578992,0
2020-09-08-170714,170714,1,0,0,317,4.25,0.5535583,1
2020-09-09-170714,170714,0,0,1,317,3.5,0.21195814,2
2020-09-10-170714,170714,1,0,0,318,2.5,0.42775255,3
2020-09-11-170714,170714,4,0,0,322,4.75,0.34811372,4
2020-09-12-170714,170714,1,0,0,323,3.0,0.38739982,5
2020-09-13-170714,170714,0,0,0,323,0.25,0.009106457,6
2020-09-14-170714,170714,3,0,1,326,10.5,0.8981588,0
2020-09-15-170714,170714,0,0,2,326,3.75,0.13571656,1
2020-09-16-170714,170714,1,0,1,327,3.75,0.13705455,2
2020-09-17-170714,170714,4,0,2,331,5.25,0.5314291,3
2020-09-18-170714,170714,1,0,8,332,7.75,0.29842204,4
2020-09-19-170714,170714,0,0,0,332,4.0,0.122501455,5
2020-09-20-170714,170714,0,0,0,332,3.75,0.35761738,6
2020-09-21-170714,170714,1,0,1,333,6.25,1.5259322,0
2020-09-22-170714,170714,0,0,0,333,4.5,0.526755,1
2020-09-23-170714,170714,1,0,0,334,6.0,0.5125439,2
2020-09-24-170714,170714,0,0,1,334,5.75,0.35205048,3
2020-09-25-170714,170714,0,0,7,334,6.75,0.77978843,4
2020-09-26-170714,170714,0,0,0,334,1.75,0.21953996,5
2020-09-27-170714,170714,0,0,2,334,2.25,0.08262629,6
2020-09-28-170714,170714,1,0,0,335,4.75,0.5626861,0
2020-09-29-170714,170714,2,0,7,337,2.5,0.46980837,1
2020-09-30-170714,170714,1,0,8,338,4.75,0.75908625,2
2020-10-01-170714,170714,2,0,1,340,4.0,0.22562896,3
2020-10-02-170714,170714,8,0,4,348,4.5,0.4219797,4
2020-10-03-170714,170714,0,1,4,348,1.5,0.14952052,5
2020-10-04-170714,170714,0,0,2,348,1.75,0.0975885,6
2020-10-05-170714,170714,1,0,7,349,2.5,0.28909492,0
2020-10-06-170714,170714,0,0,0,349,4.25,0.4975991,1
2020-10-07-170714,170714,0,1,5,349,2.25,0.28973165,2
2020-10-08-170714,170714,1,0,2,350,4.5,0.37792566,3
2020-10-09-170714,170714,7,0,2,357,3.75,0.2830058,4
2020-10-10-170714,170714,0,0,1,357,0.5,0.08913159,5
2020-10-11-170714,170714,2,0,3,359,1.5,0.1239246,6
2020-10-12-170714,170714,0,0,2,359,1.25,0.11408714,0
2020-10-13-170714,170714,7,0,5,366,3.0,0.33180892,1
2020-10-14-170714,170714,8,0,1,374,3.5,0.1648546,2
2020-10-15-170714,170714,1,0,0,375,3.0,0.4164837,3
2020-10-16-170714,170714,4,0,1,379,6.5,0.550228,4
2020-10-17-170714,170714,4,0,6,383,0.5,0.17770964,5
2020-10-18-170714,170714,2,0,0,385,2.0,0.21074177,6
2020-10-19-170714,170714,7,0,3,392,4.0,0.3710219,0
2020-10-20-170714,170714,0,0,10,392,2.0,0.23774055,1
2020-10-21-170714,170714,5,0,0,397,2.5,0.30295807,2
2020-10-22-170714,170714,2,0,1,399,6.75,0.79094607,3
2020-10-23-170714,170714,2,0,4,401,2.25,0.27061152,4
2020-10-24-170714,170714,1,1,2,402,1.25,0.13710766,5
2020-10-25-170714,170714,3,0,0,405,2.0,0.11479606,6
2020-10-26-170714,170714,2,1,3,407,2.25,0.1757648,0
2020-10-27-170714,170714,5,0,2,412,4.5,0.38185298,1
2020-10-28-170714,170714,1,0,0,413,4.25,0.39766997,2
2020-10-29-170714,170714,0,0,21,413,4.5,0.46908095,3
2020-10-30-170714,170714,1,1,6,414,6.0,0.29298663,4
2020-10-31-170714,170714,6,0,0,420,2.75,0.25950944,5
2020-11-01-170714,170714,0,0,0,420,1.25,0.094838314,6
2020-11-02-170714,170714,3,0,0,423,1.75,0.08637544,0
2020-11-03-170714,170714,10,0,0,433,4.0,0.5351684,1
2020-11-04-170714,170714,0,0,0,433,2.75,0.50993294,2
2020-11-05-170714,170714,1,0,0,434,4.25,0.7241654,3
2020-11-06-170714,170714,4,0,0,438,6.25,0.7133248,4
2020-11-07-170714,170714,2,0,0,440,0.75,0.025583982,5
2020-11-08-170714,170714,0,0,0,440,0.5,0.009639987,6
2020-11-09-170714,170714,3,0,0,443,3.75,0.33104032,0
2020-11-10-170714,170714,2,0,0,445,2.25,0.26703513,1
2020-11-11-170714,170714,0,0,0,445,3.5,0.41018334,2
2020-11-12-170714,170714,21,0,0,466,2.25,0.1070264,3
2020-11-13-170714,170714,6,2,0,472,4.25,1.2055506,4
2020-03-01-170715,170715,0,0,4,0,0.0,6.429794e-05,6
2020-03-02-170715,170715,0,0,9,0,0.0,3.5656187e-05,0
2020-03-03-170715,170715,0,0,5,0,0.0,0.002885779,1
2020-03-04-170715,170715,0,1,18,0,0.0,1.8483442e-07,2
2020-03-05-170715,170715,0,0,9,0,0.0,0.0012899541,3
2020-03-06-170715,170715,0,0,14,0,0.5,0.1806376,4
2020-03-07-170715,170715,1,0,17,1,0.5,0.14856657,5
2020-03-08-170715,170715,0,0,9,1,0.0,2.1805837e-07,6
2020-03-09-170715,170715,0,0,19,1,0.5,0.16344358,0
2020-03-10-170715,170715,0,0,25,1,0.0,0.19094741,1
2020-03-11-170715,170715,1,0,14,2,0.5,0.19290836,2
2020-03-12-170715,170715,1,0,20,3,2.0,0.7584948,3
2020-03-13-170715,170715,4,0,14,7,1.0,0.34553465,4
2020-03-14-170715,170715,3,0,5,10,1.5,0.418501,5
2020-03-15-170715,170715,4,0,7,14,2.0,0.39814663,6
2020-03-16-170715,170715,9,0,49,23,10.0,2.301225,0
2020-03-17-170715,170715,5,1,8,28,11.5,2.290314,1
2020-03-18-170715,170715,18,0,19,46,11.5,2.8888144,2
2020-03-19-170715,170715,9,0,2,55,17.5,3.1616857,3
2020-03-20-170715,170715,14,0,9,69,13.0,2.6105459,4
2020-03-21-170715,170715,17,0,7,86,5.5,0.9389941,5
2020-03-22-170715,170715,9,0,4,95,15.5,1.8150858,6
2020-03-23-170715,170715,19,0,10,114,26.0,5.8795576,0
2020-03-24-170715,170715,25,0,4,139,21.0,3.3945086,1
2020-03-25-170715,170715,14,0,7,153,25.5,4.360501,2
2020-03-26-170715,170715,20,0,5,173,23.5,4.0795817,3
2020-03-27-170715,170715,14,0,6,187,24.5,4.5497637,4
2020-03-28-170715,170715,5,0,9,192,8.5,0.58817136,5
2020-03-29-170715,170715,7,0,0,199,6.0,0.9128779,6
2020-03-30-170715,170715,49,0,4,248,23.5,4.116614,0
2020-03-31-170715,170715,8,0,1,256,16.0,2.063173,1
2020-04-01-170715,170715,19,0,8,275,14.5,2.2557163,2
2020-04-02-170715,170715,2,0,5,277,31.5,6.046635,3
2020-04-03-170715,170715,9,0,3,286,16.5,2.1825202,4
2020-04-04-170715,170715,7,0,2,293,14.0,2.1853209,5
2020-04-05-170715,170715,4,0,5,297,7.5,0.6607742,6
2020-04-06-170715,170715,10,0,11,307,21.0,3.6579902,0
2020-04-07-170715,170715,4,0,5,311,9.0,1.4592463,1
2020-04-08-170715,170715,7,0,4,318,9.5,1.2702028,2
2020-04-09-170715,170715,5,0,3,323,6.0,0.4002395,3
2020-04-10-170715,170715,6,0,6,329,7.5,0.91567725,4
2020-04-11-170715,170715,9,0,1,338,4.0,0.48492956,5
2020-04-12-170715,170715,0,0,4,338,5.5,0.8745794,6
2020-04-13-170715,170715,4,0,8,342,21.5,4.172449,0
2020-04-14-170715,170715,1,0,6,343,13.5,2.2395751,1
2020-04-15-170715,170715,8,0,38,351,13.5,2.4421859,2
2020-04-16-170715,170715,5,0,0,356,6.5,0.97806305,3
2020-04-17-170715,170715,3,0,0,359,3.0,0.9646027,4
2020-04-18-170715,170715,2,0,1,361,20.0,2.903196,5
2020-04-19-170715,170715,5,0,0,366,13.5,1.7530155,6
2020-04-20-170715,170715,11,0,4,377,7.5,1.4398732,0
2020-04-21-170715,170715,5,0,9,382,6.0,1.008735,1
2020-04-22-170715,170715,4,0,1,386,18.5,4.6119337,2
2020-04-23-170715,170715,3,0,3,389,3.5,0.43243006,3
2020-04-24-170715,170715,6,0,1,395,14.5,1.8352543,4
2020-04-25-170715,170715,1,0,0,396,1.5,0.15938982,5
2020-04-26-170715,170715,4,0,0,400,2.5,0.12503448,6
2020-04-27-170715,170715,8,0,6,408,7.0,1.3248681,0
2020-04-28-170715,170715,6,0,3,414,6.5,1.0390409,1
2020-04-29-170715,170715,38,0,2,452,9.0,1.7159301,2
2020-04-30-170715,170715,0,0,2,452,11.5,1.7255646,3
2020-05-01-170715,170715,0,0,3,452,2.5,0.1517134,4
2020-05-02-170715,170715,1,0,5,453,0.5,0.0005063123,5
2020-05-03-170715,170715,0,0,3,453,1.0,0.0022079886,6
2020-05-04-170715,170715,4,0,1,457,3.0,0.4008255,0
2020-05-05-170715,170715,9,0,4,466,7.0,1.8144451,1
2020-05-06-170715,170715,1,0,1,467,5.5,0.7161379,2
2020-05-07-170715,170715,3,0,3,470,7.5,1.6466788,3
2020-05-08-170715,170715,1,0,2,471,9.0,1.271942,4
2020-05-09-170715,170715,0,1,0,471,4.5,0.6420489,5
2020-05-10-170715,170715,0,0,3,471,2.5,0.29618078,6
2020-05-11-170715,170715,6,0,2,477,9.0,1.6397003,0
2020-05-12-170715,170715,3,1,3,480,9.0,1.5595793,1
2020-05-13-170715,170715,2,0,7,482,6.5,1.6787461,2
2020-05-14-170715,170715,2,0,1,484,8.5,1.3775718,3
2020-05-15-170715,170715,3,0,4,487,9.5,2.11848,4
2020-05-16-170715,170715,5,0,1,492,4.0,0.6693989,5
2020-05-17-170715,170715,3,0,3,495,5.0,0.6419628,6
2020-05-18-170715,170715,1,0,1,496,8.5,2.322487,0
2020-05-19-170715,170715,4,0,4,500,8.0,1.8488257,1
2020-05-20-170715,170715,1,0,2,501,9.0,1.9691966,2
2020-05-21-170715,170715,3,0,1,504,8.5,1.8430474,3
2020-05-22-170715,170715,2,0,3,506,10.0,2.3331866,4
2020-05-23-170715,170715,0,0,2,506,4.5,0.38404638,5
2020-05-24-170715,170715,3,0,0,509,4.5,0.39898685,6
2020-05-25-170715,170715,2,0,2,511,9.0,2.5463574,0
2020-05-26-170715,170715,3,0,2,514,8.5,2.3241951,1
2020-05-27-170715,170715,7,0,2,521,10.0,1.9754901,2
2020-05-28-170715,170715,1,0,0,522,4.5,1.1528715,3
2020-05-29-170715,170715,4,1,3,526,4.5,0.7079605,4
2020-05-30-170715,170715,1,0,0,527,0.0,0.005428061,5
2020-05-31-170715,170715,3,0,0,530,0.0,0.0033270153,6
2020-06-01-170715,170715,1,0,1,531,3.0,0.60069245,0
2020-06-02-170715,170715,4,0,4,535,3.0,0.5310126,1
2020-06-03-170715,170715,2,0,2,537,3.0,0.64599156,2
2020-06-04-170715,170715,1,0,1,538,1.0,0.14845037,3
2020-06-05-170715,170715,3,0,3,541,1.0,0.16714965,4
2020-06-06-170715,170715,2,0,0,543,3.0,0.12983696,5
2020-06-07-170715,170715,0,0,0,543,0.5,0.09041476,6
2020-06-08-170715,170715,2,0,1,545,4.0,1.0879507,0
2020-06-09-170715,170715,2,0,3,547,3.5,0.83743757,1
2020-06-10-170715,170715,2,0,7,549,1.5,0.30121514,2
2020-06-11-170715,170715,0,0,4,549,2.0,0.55741316,3
2020-06-12-170715,170715,3,0,2,552,4.0,0.67489177,4
2020-06-13-170715,170715,0,0,1,552,0.0,0.008184391,5
2020-06-14-170715,170715,0,0,0,552,0.0,0.035811074,6
2020-06-15-170715,170715,1,0,1,553,3.0,0.771693,0
2020-06-16-170715,170715,4,0,2,557,3.0,0.8258381,1
2020-06-17-170715,170715,2,1,1,559,4.0,1.0926639,2
2020-06-18-170715,170715,1,0,0,560,1.5,0.38144106,3
2020-06-19-170715,170715,3,0,0,563,1.5,0.6500409,4
2020-06-20-170715,170715,0,0,0,563,1.0,0.3636419,5
2020-06-21-170715,170715,0,0,0,563,0.5,0.1754767,6
2020-06-22-170715,170715,1,0,0,564,2.0,0.60154176,0
2020-06-23-170715,170715,3,1,1,567,2.0,0.86977726,1
2020-06-24-170715,170715,7,0,0,574,0.5,0.19881403,2
2020-06-25-170715,170715,4,1,0,578,2.0,0.7613456,3
2020-06-26-170715,170715,2,0,2,580,2.5,0.7545938,4
2020-06-27-170715,170715,1,0,0,581,0.5,0.19661735,5
2020-06-28-170715,170715,0,0,2,581,0.0,0.015245182,6
2020-06-29-170715,170715,1,0,0,582,0.5,0.0160176,0
2020-06-30-170715,170715,2,0,0,584,0.5,0.19458045,1
2020-07-01-170715,170715,1,0,3,585,0.5,0.19289264,2
2020-07-02-170715,170715,0,0,3,585,1.5,0.56856054,3
2020-07-03-170715,170715,0,0,0,585,1.0,0.4236751,4
2020-07-04-170715,170715,0,0,0,585,0.5,0.20640959,5
2020-07-05-170715,170715,0,0,0,585,0.0,2.3818681e-07,6
2020-07-06-170715,170715,0,0,2,585,1.5,0.3618112,0
2020-07-07-170715,170715,1,0,0,586,0.5,0.187978,1
2020-07-08-170715,170715,0,0,1,586,0.0,0.20134968,2
2020-07-09-170715,170715,0,0,4,586,2.5,0.7342746,3
2020-07-10-170715,170715,2,0,2,588,1.5,0.58410776,4
2020-07-11-170715,170715,0,0,2,588,0.5,0.19211762,5
2020-07-12-170715,170715,2,0,2,590,0.5,0.1609025,6
2020-07-13-170715,170715,0,0,1,590,0.5,0.39759493,0
2020-07-14-170715,170715,0,0,3,590,0.5,0.030430065,1
2020-07-15-170715,170715,3,0,2,593,3.5,1.1703176,2
2020-07-16-170715,170715,3,1,2,596,2.5,0.7770363,3
2020-07-17-170715,170715,0,0,4,596,2.0,0.8516926,4
2020-07-18-170715,170715,0,0,1,596,0.5,0.2276771,5
2020-07-19-170715,170715,0,0,2,596,1.0,0.36094883,6
2020-07-20-170715,170715,2,0,0,598,0.5,0.22187482,0
2020-07-21-170715,170715,0,0,1,598,2.0,0.53015506,1
2020-07-22-170715,170715,1,0,7,599,3.0,1.199281,2
2020-07-23-170715,170715,4,0,1,603,2.0,0.7241848,3
2020-07-24-170715,170715,2,0,1,605,1.0,0.455966,4
2020-07-25-170715,170715,2,0,0,607,1.0,0.16509423,5
2020-07-26-170715,170715,2,0,1,609,0.0,0.0021804215,6
2020-07-27-170715,170715,1,0,3,610,1.5,0.5096388,0
2020-07-28-170715,170715,3,0,6,613,2.5,0.93637776,1
2020-07-29-170715,170715,2,0,2,615,0.5,0.2516447,2
2020-07-30-170715,170715,2,0,5,617,2.0,0.4485665,3
2020-07-31-170715,170715,4,0,4,621,3.0,0.23393907,4
2020-08-01-170715,170715,1,0,2,622,0.5,0.22595786,5
2020-08-02-170715,170715,2,0,0,624,2.0,0.38674542,6
2020-08-03-170715,170715,0,0,2,624,1.5,0.3598987,0
2020-08-04-170715,170715,1,0,1,625,1.0,0.19096881,1
2020-08-05-170715,170715,7,0,3,632,3.5,1.1455687,2
2020-08-06-170715,170715,1,0,6,633,3.0,1.1506227,3
2020-08-07-170715,170715,1,0,1,634,2.5,0.78321534,4
2020-08-08-170715,170715,0,0,4,634,0.0,0.062461633,5
2020-08-09-170715,170715,1,0,4,635,0.5,0.24551183,6
2020-08-10-170715,170715,3,0,8,638,0.5,0.26355135,0
2020-08-11-170715,170715,6,0,3,644,2.5,0.83174604,1
2020-08-12-170715,170715,2,1,4,646,3.0,0.58870584,2
2020-08-13-170715,170715,5,0,3,651,3.5,1.7096653,3
2020-08-14-170715,170715,4,0,6,655,2.0,0.7687356,4
2020-08-15-170715,170715,2,0,0,657,1.0,0.26297984,5
2020-08-16-170715,170715,0,0,0,657,1.0,0.26607367,6
2020-08-17-170715,170715,2,0,1,659,6.0,1.8329077,0
2020-08-18-170715,170715,1,0,2,660,3.0,0.6028818,1
2020-08-19-170715,170715,3,0,9,663,2.0,1.0021533,2
2020-08-20-170715,170715,6,0,3,669,3.0,0.7947237,3
2020-08-21-170715,170715,1,0,8,670,2.5,1.4505076,4
2020-08-22-170715,170715,4,0,1,674,3.5,1.1967837,5
2020-08-23-170715,170715,4,0,5,678,2.0,0.19620848,6
2020-08-24-170715,170715,8,1,1,686,3.5,1.1586848,0
2020-08-25-170715,170715,3,0,3,689,8.0,1.8617513,1
2020-08-26-170715,170715,4,1,6,693,3.0,0.7700299,2
2020-08-27-170715,170715,3,0,3,696,7.0,1.6041565,3
2020-08-28-170715,170715,6,0,4,702,2.0,0.5491595,4
2020-08-29-170715,170715,0,0,3,702,1.5,0.34665838,5
2020-08-30-170715,170715,0,0,0,702,1.5,0.5026564,6
2020-08-31-170715,170715,1,0,10,703,5.5,1.6231862,0
2020-09-01-170715,170715,2,0,7,705,4.0,0.5239282,1
2020-09-02-170715,170715,9,0,3,714,3.5,0.42272314,2
2020-09-03-170715,170715,3,0,6,717,7.0,1.320076,3
2020-09-04-170715,170715,8,0,11,725,3.5,0.43223926,4
2020-09-05-170715,170715,1,0,7,726,2.5,0.37798303,5
2020-09-06-170715,170715,5,0,4,731,0.5,0.23378439,6
2020-09-07-170715,170715,1,0,5,732,5.5,1.1371793,0
2020-09-08-170715,170715,3,0,2,735,5.5,1.7601596,1
2020-09-09-170715,170715,6,0,5,741,3.5,1.227982,2
2020-09-10-170715,170715,3,0,9,744,4.0,0.8909583,3
2020-09-11-170715,170715,4,0,4,748,5.0,0.95736825,4
2020-09-12-170715,170715,3,0,0,751,3.0,1.0366033,5
2020-09-13-170715,170715,0,0,4,751,0.0,0.06403865,6
2020-09-14-170715,170715,10,0,0,761,11.0,2.8876333,0
2020-09-15-170715,170715,7,0,5,768,1.5,0.54816884,1
2020-09-16-170715,170715,3,0,2,771,3.5,0.7112032,2
2020-09-17-170715,170715,6,1,5,777,8.0,1.8589782,3
2020-09-18-170715,170715,11,0,6,788,5.5,1.2296181,4
2020-09-19-170715,170715,7,0,1,795,2.5,0.543934,5
2020-09-20-170715,170715,4,1,3,799,5.5,0.7132175,6
2020-09-21-170715,170715,5,0,1,804,8.0,1.6640666,0
2020-09-22-170715,170715,2,0,2,806,3.0,1.1483462,1
2020-09-23-170715,170715,5,0,0,811,4.5,1.278535,2
2020-09-24-170715,170715,9,0,7,820,6.0,1.3610256,3
2020-09-25-170715,170715,4,0,2,824,9.0,2.548449,4
2020-09-26-170715,170715,0,0,0,824,1.0,0.5306714,5
2020-09-27-170715,170715,4,0,0,828,2.0,0.5194736,6
2020-09-28-170715,170715,0,0,0,828,7.0,2.0378413,0
2020-09-29-170715,170715,5,0,2,833,3.5,0.75396943,1
2020-09-30-170715,170715,2,0,7,835,3.5,0.77790225,2
2020-10-01-170715,170715,5,0,1,840,4.5,0.7290585,3
2020-10-02-170715,170715,6,0,12,846,10.0,1.5912827,4
2020-10-03-170715,170715,1,0,0,847,2.0,0.5239893,5
2020-10-04-170715,170715,3,0,0,850,1.5,0.4015599,6
2020-10-05-170715,170715,1,0,5,851,5.0,0.9496292,0
2020-10-06-170715,170715,2,0,3,853,5.0,1.4952841,1
2020-10-07-170715,170715,0,0,3,853,4.0,0.96990865,2
2020-10-08-170715,170715,7,0,3,860,4.5,1.0722485,3
2020-10-09-170715,170715,2,1,3,862,8.5,0.86087495,4
2020-10-10-170715,170715,0,0,0,862,1.0,0.33556846,5
2020-10-11-170715,170715,0,0,0,862,3.5,0.9211198,6
2020-10-12-170715,170715,0,0,4,862,2.0,0.6009168,0
2020-10-13-170715,170715,2,0,3,864,7.0,1.0077754,1
2020-10-14-170715,170715,7,0,4,871,7.0,0.5395024,2
2020-10-15-170715,170715,1,0,2,872,6.0,1.6487764,3
2020-10-16-170715,170715,12,0,8,884,8.5,2.223253,4
2020-10-17-170715,170715,0,0,2,884,2.5,0.22796099,5
2020-10-18-170715,170715,0,0,0,884,3.0,0.6928452,6
2020-10-19-170715,170715,5,0,1,889,7.0,0.8883914,0
2020-10-20-170715,170715,3,0,3,892,2.0,0.51837885,1
2020-10-21-170715,170715,3,0,1,895,5.0,0.8378367,2
2020-10-22-170715,170715,3,0,2,898,11.5,2.8804874,3
2020-10-23-170715,170715,3,0,6,901,3.5,1.0315218,4
2020-10-24-170715,170715,0,0,2,901,2.0,0.5612968,5
2020-10-25-170715,170715,0,0,2,901,4.5,0.6337629,6
2020-10-26-170715,170715,4,0,3,905,1.5,0.21223585,0
2020-10-27-170715,170715,3,0,1,908,8.0,1.3047998,1
2020-10-28-170715,170715,4,0,3,912,5.0,1.1382476,2
2020-10-29-170715,170715,2,0,3,914,5.0,1.2401805,3
2020-10-30-170715,170715,8,0,0,922,8.0,0.7067635,4
2020-10-31-170715,170715,2,0,0,924,6.5,0.639896,5
2020-11-01-170715,170715,0,0,0,924,2.0,0.39164495,6
2020-11-02-170715,170715,1,0,0,925,3.5,0.46936414,0
2020-11-03-170715,170715,3,0,0,928,10.5,1.2873152,1
2020-11-04-170715,170715,1,0,0,929,4.0,1.1698776,2
2020-11-05-170715,170715,2,0,0,931,5.0,0.8983214,3
2020-11-06-170715,170715,6,0,0,937,9.0,1.3081592,4
2020-11-07-170715,170715,2,0,0,939,1.5,0.09642762,5
2020-11-08-170715,170715,2,0,0,941,0.0,0.03955908,6
2020-11-09-170715,170715,3,0,0,944,7.0,1.1460354,0
2020-11-10-170715,170715,1,0,0,945,3.5,0.5808258,1
2020-11-11-170715,170715,3,0,0,948,4.0,0.87437576,2
2020-11-12-170715,170715,3,0,0,951,13.5,0.35897398,3
2020-11-13-170715,170715,0,0,0,951,8.5,3.1796436,4
2020-03-01-170716,170716,0,0,0,0,0.0,5.9175727e-07,6
2020-03-02-170716,170716,0,0,0,0,0.0,1.6000806e-07,0
2020-03-03-170716,170716,0,0,0,0,0.16666666666666666,1.1517954e-07,1
2020-03-04-170716,170716,0,0,1,0,0.0,5.187914e-07,2
2020-03-05-170716,170716,0,0,0,0,0.0,0.0009016863,3
2020-03-06-170716,170716,0,0,0,0,0.0,4.8529535e-07,4
2020-03-07-170716,170716,0,0,0,0,0.16666666666666666,4.7356843e-07,5
2020-03-08-170716,170716,0,0,0,0,0.0,5.336228e-08,6
2020-03-09-170716,170716,0,0,0,0,0.3333333333333333,2.1405955e-05,0
2020-03-10-170716,170716,0,1,3,0,0.16666666666666666,1.4088528e-05,1
2020-03-11-170716,170716,0,0,3,0,0.16666666666666666,4.9002876e-05,2
2020-03-12-170716,170716,0,1,6,0,0.16666666666666666,4.9609425e-05,3
2020-03-13-170716,170716,0,0,1,0,0.5,2.1582158e-05,4
2020-03-14-170716,170716,0,0,3,0,0.8333333333333334,0.00017702555,5
2020-03-15-170716,170716,0,0,2,0,1.0,2.060011e-05,6
2020-03-16-170716,170716,0,2,3,0,4.333333333333333,0.0002569946,0
2020-03-17-170716,170716,0,0,2,0,1.8333333333333333,0.00032534194,1
2020-03-18-170716,170716,1,0,2,1,5.5,0.00027383814,2
2020-03-19-170716,170716,0,0,3,1,9.0,0.00040983406,3
2020-03-20-170716,170716,0,0,1,1,5.666666666666668,0.00025755158,4
2020-03-21-170716,170716,0,0,4,1,4.166666666666667,7.180265e-05,5
2020-03-22-170716,170716,0,0,2,1,7.333333333333332,8.45782e-05,6
2020-03-23-170716,170716,0,0,1,1,9.833333333333334,0.0010179902,0
2020-03-24-170716,170716,3,0,3,4,8.833333333333334,0.00051731855,1
2020-03-25-170716,170716,3,0,0,7,6.666666666666668,0.0006266621,2
2020-03-26-170716,170716,6,0,0,13,5.333333333333333,0.00047904404,3
2020-03-27-170716,170716,1,0,1,14,11.0,0.0004730991,4
2020-03-28-170716,170716,3,0,1,17,5.666666666666668,0.00014493092,5
2020-03-29-170716,170716,2,1,0,19,2.1666666666666665,8.824175e-05,6
2020-03-30-170716,170716,3,0,0,22,7.5,0.0003502674,0
2020-03-31-170716,170716,2,0,0,24,5.0,0.00034054607,1
2020-04-01-170716,170716,2,0,1,26,6.5,0.00037008853,2
2020-04-02-170716,170716,3,0,1,29,3.333333333333333,0.00013497965,3
2020-04-03-170716,170716,1,0,0,30,3.333333333333333,0.00016792047,4
2020-04-04-170716,170716,4,0,0,34,2.1666666666666665,6.570581e-05,5
2020-04-05-170716,170716,2,0,0,36,2.833333333333333,2.3051232e-05,6
2020-04-06-170716,170716,1,0,0,37,2.6666666666666665,0.000117570366,0
2020-04-07-170716,170716,3,1,12,40,5.833333333333332,0.00021870177,1
2020-04-08-170716,170716,0,0,1,40,3.0,0.00016986483,2
2020-04-09-170716,170716,0,0,1,40,5.0,6.983993e-05,3
2020-04-10-170716,170716,1,0,0,41,0.5,3.3459022e-05,4
2020-04-11-170716,170716,1,0,0,42,1.0,3.9256076e-05,5
2020-04-12-170716,170716,0,0,0,42,1.0,5.3292122e-05,6
2020-04-13-170716,170716,0,0,0,42,3.0,0.0001958471,0
2020-04-14-170716,170716,0,0,1,42,2.0,0.00026406624,1
2020-04-15-170716,170716,1,0,0,43,2.6666666666666665,0.00011256754,2
2020-04-16-170716,170716,1,0,0,44,1.5,0.00012282877,3
2020-04-17-170716,170716,0,0,0,44,1.8333333333333333,0.00073849875,4
2020-04-18-170716,170716,0,0,0,44,3.5,1.7456965e-05,5
2020-04-19-170716,170716,0,0,0,44,0.5,4.960778e-05,6
2020-04-20-170716,170716,0,0,0,44,1.8333333333333333,0.00022593075,0
2020-04-21-170716,170716,12,0,0,56,4.833333333333333,6.814087e-05,1
2020-04-22-170716,170716,1,0,0,57,1.6666666666666667,4.301511e-05,2
2020-04-23-170716,170716,1,0,1,58,1.0,1.4833611e-05,3
2020-04-24-170716,170716,0,0,1,58,2.6666666666666665,0.00012279635,4
2020-04-25-170716,170716,0,0,0,58,1.0,3.8706088e-07,5
2020-04-26-170716,170716,0,0,0,58,3.0,0.00011453033,6
2020-04-27-170716,170716,0,0,1,58,5.0,0.00013566192,0
2020-04-28-170716,170716,1,0,1,59,2.833333333333333,6.023288e-05,1
2020-04-29-170716,170716,0,0,0,59,2.333333333333333,0.00015892195,2
2020-04-30-170716,170716,0,0,0,59,2.1666666666666665,0.097436585,3
2020-05-01-170716,170716,0,0,1,59,0.5,0.04450719,4
2020-05-02-170716,170716,0,0,0,59,0.0,6.751192e-06,5
2020-05-03-170716,170716,0,0,0,59,0.16666666666666666,8.489475e-06,6
2020-05-04-170716,170716,0,0,0,59,1.1666666666666667,0.095805265,0
2020-05-05-170716,170716,0,0,1,59,1.1666666666666667,3.7485122e-05,1
2020-05-06-170716,170716,0,0,0,59,0.5,0.00011113144,2
2020-05-07-170716,170716,1,0,0,60,1.8333333333333333,5.4037806e-05,3
2020-05-08-170716,170716,1,0,0,61,2.0,8.528404e-05,4
2020-05-09-170716,170716,0,0,0,61,0.6666666666666666,3.7126003e-05,5
2020-05-10-170716,170716,0,1,0,61,0.3333333333333333,3.3438424e-05,6
2020-05-11-170716,170716,1,0,0,62,1.5,7.9257545e-05,0
2020-05-12-170716,170716,1,0,0,63,1.3333333333333333,8.916357e-06,1
2020-05-13-170716,170716,0,0,0,63,1.3333333333333333,0.00017449715,2
2020-05-14-170716,170716,0,0,0,63,2.6666666666666665,8.003111e-05,3
2020-05-15-170716,170716,1,0,0,64,2.5,5.7117366e-05,4
2020-05-16-170716,170716,0,0,0,64,0.5,1.5187125e-06,5
2020-05-17-170716,170716,0,0,0,64,0.6666666666666666,6.0563148e-06,6
2020-05-18-170716,170716,0,0,0,64,2.5,0.00020333422,0
2020-05-19-170716,170716,1,0,0,65,2.0,0.00011130121,1
2020-05-20-170716,170716,0,0,0,65,2.5,0.00018546804,2
2020-05-21-170716,170716,0,0,0,65,1.3333333333333333,0.000110948844,3
2020-05-22-170716,170716,0,0,0,65,2.833333333333333,1.0635186e-05,4
2020-05-23-170716,170716,0,0,0,65,1.0,5.2333994e-06,5
2020-05-24-170716,170716,0,0,0,65,1.1666666666666667,1.3497179e-06,6
2020-05-25-170716,170716,0,0,0,65,2.833333333333333,0.00018807294,0
2020-05-26-170716,170716,0,0,0,65,1.5,0.000104128354,1
2020-05-27-170716,170716,0,2,0,65,4.333333333333333,5.5445893e-05,2
2020-05-28-170716,170716,0,0,0,65,1.5,5.861774e-05,3
2020-05-29-170716,170716,0,0,0,65,0.6666666666666666,0.0001169102,4
2020-05-30-170716,170716,0,0,0,65,0.0,1.1336841e-06,5
2020-05-31-170716,170716,0,0,0,65,0.16666666666666666,9.4914344e-07,6
2020-06-01-170716,170716,0,0,0,65,0.8333333333333334,5.0365776e-05,0
2020-06-02-170716,170716,0,0,0,65,1.3333333333333333,2.0939e-05,1
2020-06-03-170716,170716,0,1,0,65,1.0,0.00011494185,2
2020-06-04-170716,170716,0,0,3,65,1.3333333333333333,1.9959987e-05,3
2020-06-05-170716,170716,0,1,1,65,0.8333333333333334,1.1822429e-05,4
2020-06-06-170716,170716,0,0,0,65,0.16666666666666666,1.4105621e-05,5
2020-06-07-170716,170716,0,0,0,65,0.5,5.490315e-07,6
2020-06-08-170716,170716,0,0,0,65,1.1666666666666667,2.9551595e-05,0
2020-06-09-170716,170716,0,0,0,65,0.5,1.3814216e-05,1
2020-06-10-170716,170716,0,0,0,65,0.5,4.1446915e-06,2
2020-06-11-170716,170716,0,0,0,65,0.16666666666666666,7.849518e-06,3
2020-06-12-170716,170716,0,0,0,65,0.5,5.958506e-06,4
2020-06-13-170716,170716,0,1,0,65,0.5,3.496949e-07,5
2020-06-14-170716,170716,0,0,0,65,0.16666666666666666,3.004795e-07,6
2020-06-15-170716,170716,0,0,0,65,0.0,4.561308e-06,0
2020-06-16-170716,170716,0,0,0,65,1.0,1.93377e-05,1
2020-06-17-170716,170716,0,0,0,65,0.5,4.6101513e-06,2
2020-06-18-170716,170716,3,0,0,68,1.0,7.762944e-06,3
2020-06-19-170716,170716,1,0,0,69,1.8333333333333333,8.904929e-05,4
2020-06-20-170716,170716,0,0,0,69,0.16666666666666666,2.0458345e-05,5
2020-06-21-170716,170716,0,0,0,69,0.0,5.942612e-07,6
2020-06-22-170716,170716,0,0,0,69,0.5,7.505034e-05,0
2020-06-23-170716,170716,0,0,0,69,0.6666666666666666,5.143594e-05,1
2020-06-24-170716,170716,0,0,0,69,0.5,1.4607444e-05,2
2020-06-25-170716,170716,0,0,0,69,0.6666666666666666,1.0334431e-05,3
2020-06-26-170716,170716,0,0,0,69,0.6666666666666666,3.5648623e-05,4
2020-06-27-170716,170716,0,0,0,69,0.16666666666666666,1.8657365e-06,5
2020-06-28-170716,170716,0,0,0,69,0.16666666666666666,6.9760773e-07,6
2020-06-29-170716,170716,0,0,0,69,0.5,5.369789e-05,0
2020-06-30-170716,170716,0,0,0,69,0.8333333333333334,2.3171197e-05,1
2020-07-01-170716,170716,0,0,1,69,0.3333333333333333,5.1784595e-05,2
2020-07-02-170716,170716,0,0,0,69,0.5,1.6500775e-05,3
2020-07-03-170716,170716,0,0,0,69,1.0,1.210319e-05,4
2020-07-04-170716,170716,0,0,0,69,0.16666666666666666,3.4300529e-06,5
2020-07-05-170716,170716,0,0,0,69,0.0,1.5433439e-07,6
2020-07-06-170716,170716,0,0,0,69,0.6666666666666666,4.357546e-06,0
2020-07-07-170716,170716,0,0,0,69,0.3333333333333333,1.2431354e-05,1
2020-07-08-170716,170716,0,2,0,69,0.8333333333333334,5.5101627e-06,2
2020-07-09-170716,170716,0,0,0,69,0.6666666666666666,1.9794625e-05,3
2020-07-10-170716,170716,0,0,0,69,0.6666666666666666,6.8554924e-05,4
2020-07-11-170716,170716,0,0,1,69,0.5,2.0044067e-07,5
2020-07-12-170716,170716,0,0,0,69,0.16666666666666666,8.960721e-06,6
2020-07-13-170716,170716,0,0,0,69,0.3333333333333333,1.2477231e-05,0
2020-07-14-170716,170716,0,0,0,69,0.5,2.226464e-05,1
2020-07-15-170716,170716,1,0,0,70,1.0,1.2360249e-05,2
2020-07-16-170716,170716,0,0,0,70,2.0,1.2049046e-05,3
2020-07-17-170716,170716,0,0,0,70,0.3333333333333333,4.3374525e-06,4
2020-07-18-170716,170716,0,0,0,70,0.3333333333333333,1.6820732e-06,5
2020-07-19-170716,170716,0,0,0,70,0.0,7.982553e-06,6
2020-07-20-170716,170716,0,0,0,70,0.8333333333333334,5.419817e-05,0
2020-07-21-170716,170716,0,0,0,70,0.3333333333333333,7.7913595e-05,1
2020-07-22-170716,170716,0,0,0,70,1.3333333333333333,5.789015e-06,2
2020-07-23-170716,170716,0,0,0,70,0.5,5.858808e-06,3
2020-07-24-170716,170716,0,0,0,70,0.5,5.7789384e-05,4
2020-07-25-170716,170716,1,0,0,71,0.16666666666666666,4.959637e-05,5
2020-07-26-170716,170716,0,0,1,71,0.0,8.8452276e-07,6
2020-07-27-170716,170716,0,0,1,71,0.3333333333333333,5.500299e-06,0
2020-07-28-170716,170716,0,0,1,71,0.5,9.821371e-05,1
2020-07-29-170716,170716,0,0,2,71,1.1666666666666667,1.6195725e-05,2
2020-07-30-170716,170716,0,0,2,71,1.6666666666666667,6.187799e-05,3
2020-07-31-170716,170716,0,0,1,71,0.8333333333333334,6.2212384e-05,4
2020-08-01-170716,170716,0,0,2,71,0.8333333333333334,0.00010906561,5
2020-08-02-170716,170716,0,0,2,71,0.0,1.3730802e-05,6
2020-08-03-170716,170716,0,0,0,71,0.5,0.00030488943,0
2020-08-04-170716,170716,0,0,3,71,0.5,0.0003974951,1
2020-08-05-170716,170716,0,0,5,71,0.5,0.0008808139,2
2020-08-06-170716,170716,0,0,0,71,0.5,0.00090638286,3
2020-08-07-170716,170716,0,0,2,71,1.0,0.00050297467,4
2020-08-08-170716,170716,0,0,0,71,1.6666666666666667,0.00037106153,5
2020-08-09-170716,170716,1,0,0,72,1.1666666666666667,0.0004641851,6
2020-08-10-170716,170716,1,0,1,73,1.1666666666666667,0.0009004771,0
2020-08-11-170716,170716,1,0,1,74,2.5,0.0008919775,1
2020-08-12-170716,170716,2,0,0,76,2.333333333333333,0.00046088707,2
2020-08-13-170716,170716,2,0,3,78,3.333333333333333,0.00023612814,3
2020-08-14-170716,170716,1,0,1,79,5.166666666666667,0.00047184763,4
2020-08-15-170716,170716,2,0,0,81,2.5,0.00042981905,5
2020-08-16-170716,170716,2,0,0,83,1.6666666666666667,9.739597e-05,6
2020-08-17-170716,170716,0,0,0,83,4.833333333333333,0.0014598365,0
2020-08-18-170716,170716,3,0,0,86,6.833333333333332,0.00043727178,1
2020-08-19-170716,170716,5,0,0,91,4.166666666666667,0.00049082737,2
2020-08-20-170716,170716,0,0,0,91,4.5,0.0006116916,3
2020-08-21-170716,170716,2,0,0,93,3.6666666666666665,0.0003611407,4
2020-08-22-170716,170716,0,0,1,93,0.3333333333333333,8.3986e-05,5
2020-08-23-170716,170716,0,0,0,93,0.6666666666666666,0.00021191484,6
2020-08-24-170716,170716,1,0,0,94,2.6666666666666665,0.00023888782,0
2020-08-25-170716,170716,1,0,0,95,2.333333333333333,0.00013380553,1
2020-08-26-170716,170716,0,0,0,95,2.833333333333333,0.00040383035,2
2020-08-27-170716,170716,3,0,0,98,3.333333333333333,0.00026689464,3
2020-08-28-170716,170716,1,0,0,99,3.0,0.00027102767,4
2020-08-29-170716,170716,0,0,0,99,2.333333333333333,0.00013487504,5
2020-08-30-170716,170716,0,0,0,99,1.3333333333333333,0.00012110727,6
2020-08-31-170716,170716,0,0,1,99,3.333333333333333,0.000119917466,0
2020-09-01-170716,170716,0,0,0,99,3.8333333333333335,4.319274e-05,1
2020-09-02-170716,170716,0,1,2,99,1.6666666666666667,9.801362e-05,2
2020-09-03-170716,170716,0,0,0,99,4.333333333333333,0.00036641318,3
2020-09-04-170716,170716,0,0,1,99,6.0,0.00023731276,4
2020-09-05-170716,170716,1,0,1,100,2.1666666666666665,0.00013018504,5
2020-09-06-170716,170716,0,0,2,100,4.0,0.000272425,6
2020-09-07-170716,170716,0,0,1,100,1.5,8.9777044e-05,0
2020-09-08-170716,170716,0,0,2,100,5.166666666666667,0.00027615082,1
2020-09-09-170716,170716,0,0,3,100,4.666666666666667,0.00035571388,2
2020-09-10-170716,170716,0,0,2,100,4.166666666666667,0.0010871768,3
2020-09-11-170716,170716,0,0,3,100,7.0,0.00094193866,4
2020-09-12-170716,170716,0,0,0,100,1.8333333333333333,0.00016147582,5
2020-09-13-170716,170716,0,0,0,100,0.6666666666666666,0.00029867378,6
2020-09-14-170716,170716,1,0,1,101,3.6666666666666665,0.00011303354,0
2020-09-15-170716,170716,0,0,0,101,4.666666666666667,0.0005555935,1
2020-09-16-170716,170716,2,0,0,103,5.833333333333332,0.0002960377,2
2020-09-17-170716,170716,0,0,0,103,3.6666666666666665,0.00036101605,3
2020-09-18-170716,170716,1,0,0,104,3.8333333333333335,0.00022154993,4
2020-09-19-170716,170716,1,0,0,105,1.8333333333333333,0.00018770524,5
2020-09-20-170716,170716,2,1,0,107,1.3333333333333333,0.0002686617,6
2020-09-21-170716,170716,1,0,0,108,5.333333333333333,0.000345852,0
2020-09-22-170716,170716,2,0,0,110,5.833333333333332,9.967991e-05,1
2020-09-23-170716,170716,3,0,1,113,5.333333333333333,0.00013657959,2
2020-09-24-170716,170716,2,0,0,115,2.0,0.000115972594,3
2020-09-25-170716,170716,3,0,0,118,6.0,0.00029699047,4
2020-09-26-170716,170716,0,0,0,118,1.5,0.0001507974,5
2020-09-27-170716,170716,0,0,1,118,1.5,8.3183404e-05,6
2020-09-28-170716,170716,1,0,0,119,2.6666666666666665,0.00020409722,0
2020-09-29-170716,170716,0,0,2,119,5.166666666666667,0.000316959,1
2020-09-30-170716,170716,0,0,0,119,2.333333333333333,8.163822e-05,2
2020-10-01-170716,170716,0,0,0,119,2.1666666666666665,0.00021574083,3
2020-10-02-170716,170716,0,0,0,119,3.333333333333333,0.00019438883,4
2020-10-03-170716,170716,0,0,0,119,0.3333333333333333,6.651349e-05,5
2020-10-04-170716,170716,0,0,0,119,1.5,0.000110660236,6
2020-10-05-170716,170716,0,0,0,119,2.333333333333333,8.491147e-05,0
2020-10-06-170716,170716,0,0,0,119,2.833333333333333,0.0001530228,1
2020-10-07-170716,170716,1,1,1,120,1.8333333333333333,0.00023841033,2
2020-10-08-170716,170716,0,0,0,120,3.8333333333333335,0.00023883022,3
2020-10-09-170716,170716,0,0,3,120,3.6666666666666665,0.00019323801,4
2020-10-10-170716,170716,0,0,1,120,2.1666666666666665,0.00017360756,5
2020-10-11-170716,170716,1,0,1,121,0.8333333333333334,0.00017462806,6
2020-10-12-170716,170716,0,0,0,121,1.8333333333333333,0.00023551343,0
2020-10-13-170716,170716,2,0,1,123,2.333333333333333,0.00025173288,1
2020-10-14-170716,170716,0,0,0,123,3.8333333333333335,0.00031623855,2
2020-10-15-170716,170716,0,0,1,123,2.833333333333333,0.00025268426,3
2020-10-16-170716,170716,0,0,1,123,4.833333333333333,0.00021091236,4
2020-10-17-170716,170716,0,0,0,123,2.6666666666666665,6.387163e-05,5
2020-10-18-170716,170716,0,0,0,123,2.833333333333333,0.00022746468,6
2020-10-19-170716,170716,0,0,0,123,3.1666666666666665,0.0005015204,0
2020-10-20-170716,170716,0,0,0,123,4.166666666666667,0.00023223784,1
2020-10-21-170716,170716,1,0,0,124,5.0,0.00039911634,2
2020-10-22-170716,170716,0,0,0,124,3.6666666666666665,0.00030770112,3
2020-10-23-170716,170716,3,0,2,127,5.166666666666667,0.00016345004,4
2020-10-24-170716,170716,1,0,0,128,2.0,0.00019039118,5
2020-10-25-170716,170716,1,0,0,129,1.1666666666666667,0.00013264322,6
2020-10-26-170716,170716,0,0,0,129,4.5,0.00041408223,0
2020-10-27-170716,170716,1,0,0,130,3.1666666666666665,0.00033648286,1
2020-10-28-170716,170716,0,0,4,130,5.666666666666668,0.0006651302,2
2020-10-29-170716,170716,1,0,0,131,4.166666666666667,0.00059405016,3
2020-10-30-170716,170716,1,0,4,132,7.166666666666668,0.00059656,4
2020-10-31-170716,170716,0,0,0,132,2.333333333333333,0.00024114877,5
2020-11-01-170716,170716,0,0,0,132,1.3333333333333333,0.00023333429,6
2020-11-02-170716,170716,0,0,0,132,1.6666666666666667,0.000313966,0
2020-11-03-170716,170716,0,0,0,132,5.5,0.00077678525,1
2020-11-04-170716,170716,0,0,0,132,4.0,0.00031621856,2
2020-11-05-170716,170716,0,0,0,132,7.5,0.00071241375,3
2020-11-06-170716,170716,2,0,0,134,6.0,0.0008623826,4
2020-11-07-170716,170716,0,0,0,134,2.833333333333333,0.00026340678,5
2020-11-08-170716,170716,0,0,0,134,3.0,0.00018305787,6
2020-11-09-170716,170716,0,0,0,134,2.5,0.00039942723,0
2020-11-10-170716,170716,0,0,0,134,4.166666666666667,0.00031232034,1
2020-11-11-170716,170716,4,0,0,138,3.5,0.0005450949,2
2020-11-12-170716,170716,0,0,0,138,3.1666666666666665,0.00071535126,3
2020-11-13-170716,170716,4,0,0,142,5.333333333333333,0.0003539584,4
2020-03-01-170801,170801,0,0,0,0,0.0,7.0203974e-14,6
2020-03-02-170801,170801,0,0,0,0,0.0,3.1942818e-08,0
2020-03-03-170801,170801,0,0,1,0,0.0,0.00010415221,1
2020-03-04-170801,170801,0,0,0,0,0.0,9.928627e-06,2
2020-03-05-170801,170801,0,1,2,0,0.3333333333333333,0.060059026,3
2020-03-06-170801,170801,0,0,0,0,0.0,1.8870782e-05,4
2020-03-07-170801,170801,0,0,1,0,0.3333333333333333,0.057831474,5
2020-03-08-170801,170801,0,0,0,0,0.0,2.9811985e-05,6
2020-03-09-170801,170801,0,0,0,0,0.6666666666666666,0.12455304,0
2020-03-10-170801,170801,0,1,0,0,0.0,0.00082928897,1
2020-03-11-170801,170801,0,0,2,0,0.6666666666666666,0.14498697,2
2020-03-12-170801,170801,0,0,0,0,1.0,0.21072756,3
2020-03-13-170801,170801,0,0,2,0,0.3333333333333333,0.07342884,4
2020-03-14-170801,170801,0,0,0,0,0.3333333333333333,0.021846274,5
2020-03-15-170801,170801,0,0,0,0,0.3333333333333333,0.046104975,6
2020-03-16-170801,170801,0,0,1,0,2.6666666666666665,0.5447888,0
2020-03-17-170801,170801,1,0,0,1,3.0,0.49123394,1
2020-03-18-170801,170801,0,0,0,1,4.0,0.6525018,2
2020-03-19-170801,170801,2,0,1,3,1.6666666666666667,0.28293452,3
2020-03-20-170801,170801,0,0,0,3,2.6666666666666665,0.47288665,4
2020-03-21-170801,170801,1,0,0,4,1.3333333333333333,0.1585465,5
2020-03-22-170801,170801,0,0,0,4,0.6666666666666666,0.07050098,6
2020-03-23-170801,170801,0,0,0,4,4.0,0.77698374,0
2020-03-24-170801,170801,0,0,0,4,4.333333333333333,0.6533642,1
2020-03-25-170801,170801,2,0,0,6,2.6666666666666665,0.37844065,2
2020-03-26-170801,170801,0,0,0,6,4.0,0.614465,3
2020-03-27-170801,170801,2,0,0,8,5.333333333333333,0.799443,4
2020-03-28-170801,170801,0,0,1,8,1.3333333333333333,0.1398648,5
2020-03-29-170801,170801,0,0,0,8,0.6666666666666666,0.024463248,6
2020-03-30-170801,170801,1,0,1,9,3.6666666666666665,0.60718375,0
2020-03-31-170801,170801,0,0,1,9,3.333333333333333,0.59449255,1
2020-04-01-170801,170801,0,0,1,9,9.333333333333334,1.1578426,2
2020-04-02-170801,170801,1,0,0,10,2.333333333333333,0.34860125,3
2020-04-03-170801,170801,0,0,0,10,1.0,0.2101891,4
2020-04-04-170801,170801,0,0,1,10,1.3333333333333333,0.13567103,5
2020-04-05-170801,170801,0,2,0,10,1.3333333333333333,0.13866301,6
2020-04-06-170801,170801,0,0,0,10,3.6666666666666665,0.5911442,0
2020-04-07-170801,170801,0,0,1,10,5.0,0.67861724,1
2020-04-08-170801,170801,0,1,2,10,3.333333333333333,0.5639673,2
2020-04-09-170801,170801,0,0,1,10,3.333333333333333,0.34152114,3
2020-04-10-170801,170801,0,0,0,10,1.0,0.15258662,4
2020-04-11-170801,170801,1,0,0,11,1.3333333333333333,0.15983127,5
2020-04-12-170801,170801,0,0,0,11,0.6666666666666666,0.10124624,6
2020-04-13-170801,170801,1,0,0,12,4.333333333333333,0.7620704,0
2020-04-14-170801,170801,1,0,1,13,6.333333333333332,1.2083975,1
2020-04-15-170801,170801,1,0,0,14,1.0,0.31599787,2
2020-04-16-170801,170801,0,0,0,14,7.333333333333332,1.4292946,3
2020-04-17-170801,170801,0,0,2,14,1.0,0.16176312,4
2020-04-18-170801,170801,1,0,1,15,3.6666666666666665,0.52416325,5
2020-04-19-170801,170801,0,0,0,15,0.6666666666666666,0.09395277,6
2020-04-20-170801,170801,0,0,1,15,13.666666666666664,3.289849,0
2020-04-21-170801,170801,1,0,0,16,0.3333333333333333,0.1173352,1
2020-04-22-170801,170801,2,0,0,18,3.0,0.5041935,2
2020-04-23-170801,170801,1,0,0,19,0.0,0.034901097,3
2020-04-24-170801,170801,0,0,0,19,2.0,0.5465952,4
2020-04-25-170801,170801,0,0,1,19,1.0,0.17002101,5
2020-04-26-170801,170801,0,0,0,19,0.0,0.10455408,6
2020-04-27-170801,170801,0,0,0,19,2.333333333333333,0.44430947,0
2020-04-28-170801,170801,1,0,6,20,1.3333333333333333,0.29053718,1
2020-04-29-170801,170801,0,0,1,20,0.3333333333333333,0.1663698,2
2020-04-30-170801,170801,0,0,0,20,1.3333333333333333,0.32384855,3
2020-05-01-170801,170801,2,0,0,22,0.3333333333333333,0.0688229,4
2020-05-02-170801,170801,1,0,0,23,0.6666666666666666,0.1462606,5
2020-05-03-170801,170801,0,1,0,23,0.0,0.007640001,6
2020-05-04-170801,170801,1,0,1,24,3.333333333333333,0.7040983,0
2020-05-05-170801,170801,0,0,1,24,2.6666666666666665,0.60152537,1
2020-05-06-170801,170801,0,0,0,24,3.0,0.74469215,2
2020-05-07-170801,170801,0,0,1,24,2.0,0.51737887,3
2020-05-08-170801,170801,0,0,0,24,2.333333333333333,0.33020133,4
2020-05-09-170801,170801,1,0,0,25,0.0,0.019234905,5
2020-05-10-170801,170801,0,1,0,25,0.3333333333333333,0.01341161,6
2020-05-11-170801,170801,0,1,0,25,1.6666666666666667,0.3869289,0
2020-05-12-170801,170801,6,1,1,31,2.6666666666666665,0.3620451,1
2020-05-13-170801,170801,1,0,0,32,2.6666666666666665,0.6853112,2
2020-05-14-170801,170801,0,0,0,32,0.6666666666666666,0.10036835,3
2020-05-15-170801,170801,0,0,0,32,2.6666666666666665,0.28022152,4
2020-05-16-170801,170801,0,0,0,32,0.3333333333333333,0.05077865,5
2020-05-17-170801,170801,0,0,1,32,0.3333333333333333,0.008577567,6
2020-05-18-170801,170801,1,0,0,33,1.3333333333333333,0.2915899,0
2020-05-19-170801,170801,1,0,0,34,1.6666666666666667,0.3481569,1
2020-05-20-170801,170801,0,0,0,34,0.3333333333333333,0.10069178,2
2020-05-21-170801,170801,1,0,0,35,1.3333333333333333,0.17003398,3
2020-05-22-170801,170801,0,0,0,35,0.6666666666666666,0.1131527,4
2020-05-23-170801,170801,0,0,0,35,0.0,0.0062349546,5
2020-05-24-170801,170801,0,0,0,35,1.3333333333333333,0.1783962,6
2020-05-25-170801,170801,0,0,0,35,1.6666666666666667,0.32989278,0
2020-05-26-170801,170801,1,0,0,36,2.0,0.42250583,1
2020-05-27-170801,170801,0,0,0,36,0.0,0.018298414,2
2020-05-28-170801,170801,0,0,0,36,2.0,0.5219454,3
2020-05-29-170801,170801,0,0,0,36,0.6666666666666666,0.12577441,4
2020-05-30-170801,170801,0,0,0,36,1.0,0.17247999,5
2020-05-31-170801,170801,1,0,0,37,0.0,0.020971145,6
2020-06-01-170801,170801,0,0,0,37,0.3333333333333333,0.089516945,0
2020-06-02-170801,170801,0,0,0,37,1.0,0.24261425,1
2020-06-03-170801,170801,0,0,0,37,0.6666666666666666,0.1462961,2
2020-06-04-170801,170801,0,0,0,37,0.3333333333333333,0.10420527,3
2020-06-05-170801,170801,0,0,0,37,0.3333333333333333,0.13404085,4
2020-06-06-170801,170801,0,1,0,37,0.3333333333333333,0.067911565,5
2020-06-07-170801,170801,0,0,0,37,0.6666666666666666,0.07050685,6
2020-06-08-170801,170801,0,0,0,37,1.0,0.15812671,0
2020-06-09-170801,170801,0,0,0,37,1.0,0.1890797,1
2020-06-10-170801,170801,0,0,0,37,1.3333333333333333,0.32106873,2
2020-06-11-170801,170801,0,0,0,37,0.3333333333333333,0.055724945,3
2020-06-12-170801,170801,0,0,0,37,0.6666666666666666,0.14985621,4
2020-06-13-170801,170801,0,0,0,37,1.6666666666666667,0.09868386,5
2020-06-14-170801,170801,0,0,0,37,0.3333333333333333,0.05758663,6
2020-06-15-170801,170801,0,0,0,37,0.3333333333333333,0.07959134,0
2020-06-16-170801,170801,0,0,0,37,1.0,0.23503926,1
2020-06-17-170801,170801,0,0,0,37,2.0,0.47384495,2
2020-06-18-170801,170801,0,0,0,37,0.3333333333333333,0.0850195,3
2020-06-19-170801,170801,0,0,1,37,0.6666666666666666,0.17295784,4
2020-06-20-170801,170801,0,1,0,37,0.0,0.003088145,5
2020-06-21-170801,170801,0,0,0,37,0.0,0.014141505,6
2020-06-22-170801,170801,0,0,0,37,0.3333333333333333,0.09469511,0
2020-06-23-170801,170801,0,0,0,37,0.3333333333333333,0.012555716,1
2020-06-24-170801,170801,0,0,0,37,0.0,0.0011870507,2
2020-06-25-170801,170801,0,0,0,37,0.3333333333333333,0.09610651,3
2020-06-26-170801,170801,0,0,0,37,1.0,0.2855,4
2020-06-27-170801,170801,0,0,0,37,0.3333333333333333,0.09102919,5
2020-06-28-170801,170801,0,0,0,37,0.6666666666666666,0.16556461,6
2020-06-29-170801,170801,0,0,0,37,0.0,0.00037560065,0
2020-06-30-170801,170801,0,0,0,37,0.0,0.007005582,1
2020-07-01-170801,170801,0,0,0,37,0.3333333333333333,0.08716975,2
2020-07-02-170801,170801,0,0,0,37,0.3333333333333333,0.09022445,3
2020-07-03-170801,170801,1,0,0,38,0.0,0.037424594,4
2020-07-04-170801,170801,0,0,0,38,0.0,0.0047842455,5
2020-07-05-170801,170801,0,0,0,38,0.0,0.00020637858,6
2020-07-06-170801,170801,0,0,1,38,0.0,0.00972444,0
2020-07-07-170801,170801,0,0,0,38,0.3333333333333333,0.103705205,1
2020-07-08-170801,170801,0,0,0,38,1.0,0.13512598,2
2020-07-09-170801,170801,0,0,0,38,0.3333333333333333,0.024359835,3
2020-07-10-170801,170801,0,0,0,38,0.3333333333333333,0.0009683429,4
2020-07-11-170801,170801,0,0,0,38,0.0,0.00023154766,5
2020-07-12-170801,170801,0,0,0,38,0.0,0.008611267,6
2020-07-13-170801,170801,0,0,0,38,0.6666666666666666,0.1776566,0
2020-07-14-170801,170801,0,0,0,38,0.3333333333333333,0.0882787,1
2020-07-15-170801,170801,0,0,0,38,0.6666666666666666,0.1898613,2
2020-07-16-170801,170801,0,0,0,38,1.0,0.29228866,3
2020-07-17-170801,170801,0,0,0,38,0.0,0.010328392,4
2020-07-18-170801,170801,0,0,0,38,0.0,0.010358997,5
2020-07-19-170801,170801,0,0,0,38,0.0,0.00253495,6
2020-07-20-170801,170801,1,0,0,39,0.0,0.06498176,0
2020-07-21-170801,170801,0,0,0,39,0.6666666666666666,0.106124096,1
2020-07-22-170801,170801,0,0,0,39,0.3333333333333333,0.110428266,2
2020-07-23-170801,170801,0,0,0,39,0.6666666666666666,0.35681885,3
2020-07-24-170801,170801,0,0,0,39,0.3333333333333333,0.115781136,4
2020-07-25-170801,170801,0,0,0,39,0.3333333333333333,0.106245294,5
2020-07-26-170801,170801,0,0,0,39,0.3333333333333333,0.10904139,6
2020-07-27-170801,170801,0,0,0,39,0.3333333333333333,0.034392923,0
2020-07-28-170801,170801,0,0,0,39,0.0,0.00069129514,1
2020-07-29-170801,170801,0,0,0,39,1.0,0.22595826,2
2020-07-30-170801,170801,0,0,6,39,0.6666666666666666,0.115621634,3
2020-07-31-170801,170801,0,0,10,39,1.0,0.32178003,4
2020-08-01-170801,170801,0,0,0,39,1.6666666666666667,0.37419724,5
2020-08-02-170801,170801,0,0,0,39,0.0,0.0049945316,6
2020-08-03-170801,170801,0,0,0,39,0.6666666666666666,0.15085874,0
2020-08-04-170801,170801,0,0,2,39,1.3333333333333333,0.30059266,1
2020-08-05-170801,170801,0,0,1,39,4.333333333333333,1.284745,2
2020-08-06-170801,170801,0,0,0,39,4.333333333333333,1.3176317,3
2020-08-07-170801,170801,0,1,1,39,1.0,0.23536438,4
2020-08-08-170801,170801,0,0,0,39,1.0,0.3391859,5
2020-08-09-170801,170801,0,0,0,39,0.6666666666666666,0.15178925,6
2020-08-10-170801,170801,0,0,0,39,0.6666666666666666,0.29383644,0
2020-08-11-170801,170801,0,0,0,39,2.0,0.54179657,1
2020-08-12-170801,170801,0,0,0,39,1.6666666666666667,0.5347051,2
2020-08-13-170801,170801,6,0,1,45,0.0,0.4788915,3
2020-08-14-170801,170801,10,0,1,55,3.333333333333333,1.1513788,4
2020-08-15-170801,170801,0,0,1,55,0.3333333333333333,0.12437244,5
2020-08-16-170801,170801,0,0,1,55,1.3333333333333333,0.32432184,6
2020-08-17-170801,170801,0,0,2,55,0.3333333333333333,0.10360943,0
2020-08-18-170801,170801,2,0,0,57,2.6666666666666665,0.94053745,1
2020-08-19-170801,170801,1,0,1,58,2.0,0.58201885,2
2020-08-20-170801,170801,0,0,0,58,0.3333333333333333,0.120511554,3
2020-08-21-170801,170801,1,0,1,59,0.3333333333333333,0.09572949,4
2020-08-22-170801,170801,0,0,1,59,1.0,0.3659026,5
2020-08-23-170801,170801,0,0,0,59,0.6666666666666666,0.049655933,6
2020-08-24-170801,170801,0,0,0,59,1.3333333333333333,0.30042735,0
2020-08-25-170801,170801,0,0,0,59,0.6666666666666666,0.19619736,1
2020-08-26-170801,170801,0,0,1,59,1.6666666666666667,0.31370327,2
2020-08-27-170801,170801,1,0,1,60,2.333333333333333,0.75486207,3
2020-08-28-170801,170801,1,0,0,61,1.0,0.13738726,4
2020-08-29-170801,170801,1,0,0,62,0.0,0.037662916,5
2020-08-30-170801,170801,1,0,0,63,0.3333333333333333,0.086898245,6
2020-08-31-170801,170801,2,0,0,65,2.0,0.25601733,0
2020-09-01-170801,170801,0,0,0,65,1.6666666666666667,0.74985087,1
2020-09-02-170801,170801,1,0,0,66,0.3333333333333333,0.16741323,2
2020-09-03-170801,170801,0,0,0,66,1.3333333333333333,0.2581548,3
2020-09-04-170801,170801,1,0,0,67,2.333333333333333,0.2827292,4
2020-09-05-170801,170801,1,0,0,68,1.6666666666666667,0.060816046,5
2020-09-06-170801,170801,0,0,0,68,1.6666666666666667,0.14675435,6
2020-09-07-170801,170801,0,0,0,68,0.6666666666666666,0.11642167,0
2020-09-08-170801,170801,0,0,0,68,0.3333333333333333,0.10427439,1
2020-09-09-170801,170801,1,0,0,69,3.0,0.28945255,2
2020-09-10-170801,170801,1,0,0,70,1.0,0.22315761,3
2020-09-11-170801,170801,0,0,2,70,1.3333333333333333,0.18332888,4
2020-09-12-170801,170801,0,0,2,70,3.0,0.2820355,5
2020-09-13-170801,170801,0,0,0,70,0.0,0.02117188,6
2020-09-14-170801,170801,0,0,0,70,3.0,0.29330423,0
2020-09-15-170801,170801,0,0,0,70,0.3333333333333333,0.029773798,1
2020-09-16-170801,170801,0,0,0,70,1.6666666666666667,0.19632922,2
2020-09-17-170801,170801,0,0,0,70,0.3333333333333333,0.09332601,3
2020-09-18-170801,170801,0,0,1,70,1.6666666666666667,0.3196328,4
2020-09-19-170801,170801,0,0,0,70,0.0,0.004895511,5
2020-09-20-170801,170801,0,0,0,70,1.6666666666666667,0.39149308,6
2020-09-21-170801,170801,0,0,3,70,1.6666666666666667,0.30703855,0
2020-09-22-170801,170801,0,1,0,70,1.0,0.155281,1
2020-09-23-170801,170801,0,1,1,70,2.6666666666666665,0.47638854,2
2020-09-24-170801,170801,0,0,1,70,2.333333333333333,0.40459594,3
2020-09-25-170801,170801,2,0,0,72,0.6666666666666666,0.143353,4
2020-09-26-170801,170801,2,0,1,74,1.3333333333333333,0.33278573,5
2020-09-27-170801,170801,0,0,0,74,0.0,0.0054812925,6
2020-09-28-170801,170801,0,0,0,74,0.6666666666666666,0.160324,0
2020-09-29-170801,170801,0,0,0,74,0.0,0.010285621,1
2020-09-30-170801,170801,0,1,1,74,1.6666666666666667,0.20818299,2
2020-10-01-170801,170801,0,0,1,74,0.3333333333333333,0.08773231,3
2020-10-02-170801,170801,1,0,5,75,0.0,0.00064306485,4
2020-10-03-170801,170801,0,0,4,75,0.0,0.0007591548,5
2020-10-04-170801,170801,0,0,1,75,0.0,0.0051505943,6
2020-10-05-170801,170801,3,0,1,78,0.6666666666666666,0.22956721,0
2020-10-06-170801,170801,0,0,0,78,1.3333333333333333,0.21246815,1
2020-10-07-170801,170801,1,0,0,79,0.6666666666666666,0.16607377,2
2020-10-08-170801,170801,1,2,3,80,1.0,0.20071788,3
2020-10-09-170801,170801,0,0,3,80,1.6666666666666667,0.31671023,4
2020-10-10-170801,170801,1,0,3,81,1.3333333333333333,0.27607778,5
2020-10-11-170801,170801,0,0,1,81,2.0,0.19121474,6
2020-10-12-170801,170801,0,0,1,81,1.0,0.22834279,0
2020-10-13-170801,170801,0,0,1,81,3.6666666666666665,0.6019318,1
2020-10-14-170801,170801,1,0,5,82,1.0,0.23207437,2
2020-10-15-170801,170801,1,0,1,83,2.6666666666666665,0.4234688,3
2020-10-16-170801,170801,5,0,4,88,7.333333333333332,1.5799559,4
2020-10-17-170801,170801,4,0,1,92,14.666666666666664,2.5577626,5
2020-10-18-170801,170801,1,0,1,93,3.333333333333333,0.26314288,6
2020-10-19-170801,170801,1,0,1,94,2.0,0.1973746,0
2020-10-20-170801,170801,0,0,1,94,2.333333333333333,0.34569442,1
2020-10-21-170801,170801,0,0,0,94,5.333333333333333,0.77055925,2
2020-10-22-170801,170801,3,0,0,97,3.6666666666666665,0.6990501,3
2020-10-23-170801,170801,3,0,0,100,5.666666666666668,0.60913706,4
2020-10-24-170801,170801,3,0,2,103,2.333333333333333,0.5351022,5
2020-10-25-170801,170801,1,0,0,104,3.333333333333333,0.3568409,6
2020-10-26-170801,170801,1,0,2,105,3.0,0.71940714,0
2020-10-27-170801,170801,1,0,1,106,2.333333333333333,0.32139194,1
2020-10-28-170801,170801,5,0,0,111,4.0,1.6193265,2
2020-10-29-170801,170801,1,0,4,112,2.6666666666666665,0.37569305,3
2020-10-30-170801,170801,4,0,5,116,3.6666666666666665,0.6202093,4
2020-10-31-170801,170801,1,0,0,117,3.333333333333333,0.649012,5
2020-11-01-170801,170801,1,0,0,118,1.6666666666666667,0.25451377,6
2020-11-02-170801,170801,1,0,0,119,3.333333333333333,0.4472189,0
2020-11-03-170801,170801,1,1,0,120,3.6666666666666665,0.6620552,1
2020-11-04-170801,170801,0,0,0,120,2.333333333333333,0.4114601,2
2020-11-05-170801,170801,0,0,0,120,5.333333333333333,0.9442374,3
2020-11-06-170801,170801,0,1,0,120,4.333333333333333,0.50200206,4
2020-11-07-170801,170801,2,1,0,122,5.333333333333333,0.45259058,5
2020-11-08-170801,170801,0,0,0,122,8.333333333333334,0.99640125,6
2020-11-09-170801,170801,2,0,0,124,6.0,0.6767509,0
2020-11-10-170801,170801,1,1,0,125,4.0,0.572355,1
2020-11-11-170801,170801,0,1,0,125,6.0,0.9922807,2
2020-11-12-170801,170801,4,0,0,129,5.0,0.9035541,3
2020-11-13-170801,170801,5,0,0,134,2.0,0.3185567,4
2020-03-01-170802,170802,0,0,1,0,0.0,5.922374e-08,6
2020-03-02-170802,170802,0,0,7,0,0.0,4.4256238e-05,0
2020-03-03-170802,170802,0,0,8,0,0.25,0.00040240167,1
2020-03-04-170802,170802,0,0,5,0,0.0,1.0159834e-05,2
2020-03-05-170802,170802,0,0,10,0,0.25,0.099156894,3
2020-03-06-170802,170802,0,0,16,0,0.0,0.000604504,4
2020-03-07-170802,170802,0,0,5,0,0.25,0.08309947,5
2020-03-08-170802,170802,0,0,7,0,0.0,0.0,6
2020-03-09-170802,170802,1,0,25,1,0.5,0.6373811,0
2020-03-10-170802,170802,0,1,21,1,0.0,0.0009847791,1
2020-03-11-170802,170802,1,0,15,2,0.5,0.60901064,2
2020-03-12-170802,170802,2,0,11,4,0.25,0.9919635,3
2020-03-13-170802,170802,1,0,8,5,0.0,0.48960242,4
2020-03-14-170802,170802,3,0,2,8,0.0,1.0150671,5
2020-03-15-170802,170802,1,0,5,9,0.5,0.40844366,6
2020-03-16-170802,170802,7,0,20,16,2.0,3.2421803,0
2020-03-17-170802,170802,8,0,6,24,2.0,3.2151947,1
2020-03-18-170802,170802,5,0,16,29,3.0,2.4378362,2
2020-03-19-170802,170802,10,0,16,39,1.25,3.3882487,3
2020-03-20-170802,170802,16,0,8,55,2.25,5.0398145,4
2020-03-21-170802,170802,5,0,1,60,1.25,1.4566205,5
2020-03-22-170802,170802,7,1,3,67,0.5,1.803216,6
2020-03-23-170802,170802,25,0,8,92,3.25,8.41757,0
2020-03-24-170802,170802,21,0,2,113,2.75,7.377129,1
2020-03-25-170802,170802,15,0,5,128,1.75,6.063984,2
2020-03-26-170802,170802,11,0,6,139,3.75,4.9006357,3
2020-03-27-170802,170802,8,0,25,147,5.25,4.2812743,4
2020-03-28-170802,170802,2,0,1,149,1.25,0.8025603,5
2020-03-29-170802,170802,5,0,0,154,0.5,1.2812482,6
2020-03-30-170802,170802,20,0,5,174,3.25,7.107877,0
2020-03-31-170802,170802,6,0,8,180,3.25,2.8139253,1
2020-04-01-170802,170802,16,0,16,196,8.0,6.9717975,2
2020-04-02-170802,170802,16,0,34,212,2.25,5.6662807,3
2020-04-03-170802,170802,8,0,5,220,1.0,2.8269043,4
2020-04-04-170802,170802,1,0,2,221,1.5,0.7467054,5
2020-04-05-170802,170802,3,0,0,224,1.25,1.0402601,6
2020-04-06-170802,170802,8,0,5,232,3.5,3.5714774,0
2020-04-07-170802,170802,2,0,2,234,3.0,1.4021416,1
2020-04-08-170802,170802,5,0,4,239,3.0,1.9922202,2
2020-04-09-170802,170802,6,0,0,245,3.75,2.3932395,3
2020-04-10-170802,170802,25,0,4,270,0.75,5.9811387,4
2020-04-11-170802,170802,1,0,1,271,2.75,0.5551486,5
2020-04-12-170802,170802,0,0,2,271,0.5,0.09816862,6
2020-04-13-170802,170802,5,0,2,276,3.5,2.4415324,0
2020-04-14-170802,170802,8,0,0,284,6.0,4.7874556,1
2020-04-15-170802,170802,16,0,2,300,1.25,4.8048105,2
2020-04-16-170802,170802,34,0,3,334,6.25,11.091402,3
2020-04-17-170802,170802,5,0,2,339,0.75,1.9320017,4
2020-04-18-170802,170802,2,0,9,341,2.75,1.1829073,5
2020-04-19-170802,170802,0,0,4,341,0.5,0.09666645,6
2020-04-20-170802,170802,5,1,4,346,10.5,5.029764,0
2020-04-21-170802,170802,2,0,9,348,0.25,0.84887916,1
2020-04-22-170802,170802,4,0,5,352,2.0,2.1002405,2
2020-04-23-170802,170802,0,0,1,352,0.5,0.33242908,3
2020-04-24-170802,170802,4,0,2,356,3.75,2.8277009,4
2020-04-25-170802,170802,1,0,2,357,1.0,0.64432675,5
2020-04-26-170802,170802,2,0,2,359,0.5,0.54849017,6
2020-04-27-170802,170802,2,0,6,361,1.75,0.8064319,0
2020-04-28-170802,170802,0,0,1,361,1.0,0.28930432,1
2020-04-29-170802,170802,2,0,3,363,0.5,0.79000956,2
2020-04-30-170802,170802,3,0,4,366,0.75,1.2289363,3
2020-05-01-170802,170802,2,0,3,368,0.5,0.5268368,4
2020-05-02-170802,170802,9,0,3,377,0.75,2.5629976,5
2020-05-03-170802,170802,4,0,0,381,0.0,1.1984407,6
2020-05-04-170802,170802,4,0,1,385,2.25,1.5099502,0
2020-05-05-170802,170802,9,0,1,394,2.0,3.4559093,1
2020-05-06-170802,170802,5,0,2,399,2.75,3.0483217,2
2020-05-07-170802,170802,1,0,1,400,2.0,0.93727493,3
2020-05-08-170802,170802,2,0,2,402,1.5,1.5301391,4
2020-05-09-170802,170802,2,0,2,404,0.25,0.55039614,5
2020-05-10-170802,170802,2,0,0,406,0.0,0.61158854,6
2020-05-11-170802,170802,6,0,3,412,1.25,2.8303518,0
2020-05-12-170802,170802,1,1,6,413,1.25,0.69346905,1
2020-05-13-170802,170802,3,0,1,416,2.75,1.696394,2
2020-05-14-170802,170802,4,0,3,420,0.5,1.4568559,3
2020-05-15-170802,170802,3,0,2,423,1.5,1.4709921,4
2020-05-16-170802,170802,3,0,0,426,0.25,0.95483536,5
2020-05-17-170802,170802,0,0,0,426,0.0,0.0069503724,6
2020-05-18-170802,170802,1,1,0,427,1.0,0.69743955,0
2020-05-19-170802,170802,1,0,1,428,1.5,1.0032969,1
2020-05-20-170802,170802,2,0,0,430,0.25,0.9015696,2
2020-05-21-170802,170802,1,0,1,431,0.25,0.5576553,3
2020-05-22-170802,170802,2,0,0,433,0.5,1.231466,4
2020-05-23-170802,170802,2,0,0,435,0.0,0.7785578,5
2020-05-24-170802,170802,0,0,1,435,1.0,0.1441978,6
2020-05-25-170802,170802,3,0,0,438,1.5,1.881815,0
2020-05-26-170802,170802,6,0,1,444,1.5,3.0636742,1
2020-05-27-170802,170802,1,3,1,445,0.25,0.4961739,2
2020-05-28-170802,170802,3,0,1,448,2.25,2.1250381,3
2020-05-29-170802,170802,2,0,6,450,0.5,1.0511029,4
2020-05-30-170802,170802,0,0,0,450,0.75,0.24804646,5
2020-05-31-170802,170802,0,0,0,450,0.0,0.0040954617,6
2020-06-01-170802,170802,0,0,1,450,0.75,0.25797296,0
2020-06-02-170802,170802,1,0,1,451,0.75,0.78689265,1
2020-06-03-170802,170802,0,0,2,451,0.75,0.3006443,2
2020-06-04-170802,170802,1,0,1,452,0.5,0.8322635,3
2020-06-05-170802,170802,0,0,1,452,0.25,0.22088675,4
2020-06-06-170802,170802,0,1,0,452,0.5,0.10878652,5
2020-06-07-170802,170802,1,0,3,453,0.5,0.4896525,6
2020-06-08-170802,170802,0,0,1,453,0.75,0.18467008,0
2020-06-09-170802,170802,1,0,2,454,1.0,0.9731973,1
2020-06-10-170802,170802,1,0,0,455,1.0,0.78239113,2
2020-06-11-170802,170802,1,0,1,456,0.25,0.63212234,3
2020-06-12-170802,170802,6,0,1,462,0.5,2.5319843,4
2020-06-13-170802,170802,0,0,0,462,0.25,0.10525816,5
2020-06-14-170802,170802,0,0,0,462,0.25,0.06658369,6
2020-06-15-170802,170802,1,0,0,463,0.0,0.43993676,0
2020-06-16-170802,170802,1,0,0,464,0.75,0.74717975,1
2020-06-17-170802,170802,2,0,1,466,1.75,1.5245942,2
2020-06-18-170802,170802,1,0,1,467,0.25,0.51668996,3
2020-06-19-170802,170802,1,0,0,468,0.75,0.66851544,4
2020-06-20-170802,170802,0,0,1,468,0.0,0.015259526,5
2020-06-21-170802,170802,3,0,0,471,0.0,1.2325696,6
2020-06-22-170802,170802,1,0,0,472,0.25,0.54990023,0
2020-06-23-170802,170802,2,2,0,474,0.0,0.99245054,1
2020-06-24-170802,170802,0,2,1,474,0.0,0.017041983,2
2020-06-25-170802,170802,1,0,0,475,0.25,0.54652077,3
2020-06-26-170802,170802,1,0,0,476,0.75,0.7388065,4
2020-06-27-170802,170802,0,0,0,476,0.25,0.094408594,5
2020-06-28-170802,170802,0,0,1,476,0.5,0.1724518,6
2020-06-29-170802,170802,0,0,0,476,0.0,0.00086732476,0
2020-06-30-170802,170802,0,0,0,476,0.25,0.063751005,1
2020-07-01-170802,170802,1,0,0,477,0.25,0.60919076,2
2020-07-02-170802,170802,1,0,0,478,0.0,0.46315163,3
2020-07-03-170802,170802,0,0,1,478,0.25,0.06463196,4
2020-07-04-170802,170802,1,0,0,479,0.0,0.394131,5
2020-07-05-170802,170802,0,0,0,479,0.0,7.535271e-05,6
2020-07-06-170802,170802,0,0,0,479,0.25,0.06993691,0
2020-07-07-170802,170802,0,0,0,479,0.5,0.33174565,1
2020-07-08-170802,170802,1,0,1,480,0.75,0.789222,2
2020-07-09-170802,170802,0,0,1,480,0.0,0.014746721,3
2020-07-10-170802,170802,0,0,1,480,0.25,0.0030771622,4
2020-07-11-170802,170802,0,0,0,480,0.0,8.813484e-05,5
2020-07-12-170802,170802,1,0,2,481,0.0,0.38893086,6
2020-07-13-170802,170802,0,0,0,481,1.75,0.76899886,0
2020-07-14-170802,170802,0,0,0,481,0.5,0.20171204,1
2020-07-15-170802,170802,0,0,3,481,0.5,0.27736428,2
2020-07-16-170802,170802,0,0,1,481,1.5,0.42947426,3
2020-07-17-170802,170802,1,0,0,482,0.5,0.6777671,4
2020-07-18-170802,170802,0,0,0,482,0.5,0.10506642,5
2020-07-19-170802,170802,0,0,1,482,0.0,0.014700088,6
2020-07-20-170802,170802,0,0,2,482,1.0,0.2918512,0
2020-07-21-170802,170802,0,0,0,482,0.75,0.35893756,1
2020-07-22-170802,170802,1,0,1,483,0.25,0.55835867,2
2020-07-23-170802,170802,1,0,0,484,1.25,1.3715448,3
2020-07-24-170802,170802,1,0,0,485,0.5,0.69352645,4
2020-07-25-170802,170802,0,0,3,485,0.0,0.057506908,5
2020-07-26-170802,170802,2,0,2,487,0.5,0.8378604,6
2020-07-27-170802,170802,0,0,0,487,0.75,0.17289221,0
2020-07-28-170802,170802,0,0,0,487,0.0,0.0031205865,1
2020-07-29-170802,170802,3,0,0,490,0.75,1.6256154,2
2020-07-30-170802,170802,1,0,2,491,0.25,0.6211888,3
2020-07-31-170802,170802,0,0,0,491,0.75,1.4928567,4
2020-08-01-170802,170802,0,0,2,491,1.25,0.4776082,5
2020-08-02-170802,170802,1,0,0,492,0.0,0.3905707,6
2020-08-03-170802,170802,2,0,0,494,0.25,0.96186996,0
2020-08-04-170802,170802,0,0,0,494,1.5,0.49687773,1
2020-08-05-170802,170802,1,0,0,495,3.5,2.118665,2
2020-08-06-170802,170802,0,0,0,495,2.75,1.4960519,3
2020-08-07-170802,170802,0,0,4,495,1.0,0.5775104,4
2020-08-08-170802,170802,3,0,0,498,1.75,2.2715728,5
2020-08-09-170802,170802,2,0,2,500,0.0,0.88476557,6
2020-08-10-170802,170802,0,0,2,500,1.25,1.0752275,0
2020-08-11-170802,170802,0,0,0,500,2.25,0.7591667,1
2020-08-12-170802,170802,0,0,0,500,1.25,1.0115006,2
2020-08-13-170802,170802,2,0,2,502,2.0,1.1100444,3
2020-08-14-170802,170802,0,0,1,502,1.25,0.7869939,4
2020-08-15-170802,170802,2,0,0,504,0.25,1.0091078,5
2020-08-16-170802,170802,0,0,1,504,0.5,0.17062938,6
2020-08-17-170802,170802,0,0,0,504,1.0,0.27313992,0
2020-08-18-170802,170802,0,0,0,504,3.25,1.9331213,1
2020-08-19-170802,170802,0,0,0,504,2.75,2.142969,2
2020-08-20-170802,170802,0,1,0,504,0.25,0.17949115,3
2020-08-21-170802,170802,4,0,2,508,1.0,2.0999134,4
2020-08-22-170802,170802,0,0,0,508,1.5,0.8341363,5
2020-08-23-170802,170802,2,0,0,510,0.25,0.76605815,6
2020-08-24-170802,170802,2,0,1,512,1.25,0.8510635,0
2020-08-25-170802,170802,0,0,0,512,0.5,0.25502247,1
2020-08-26-170802,170802,0,0,1,512,1.5,0.58339703,2
2020-08-27-170802,170802,2,0,1,514,1.0,1.459424,3
2020-08-28-170802,170802,1,1,3,515,1.25,3.5756378,4
2020-08-29-170802,170802,0,1,1,515,0.0,0.070559725,5
2020-08-30-170802,170802,1,0,2,516,0.25,0.15000902,6
2020-08-31-170802,170802,0,0,1,516,1.0,0.32941484,0
2020-09-01-170802,170802,0,0,8,516,1.5,1.0536644,1
2020-09-02-170802,170802,0,0,2,516,0.75,0.5240987,2
2020-09-03-170802,170802,0,0,4,516,1.0,0.657599,3
2020-09-04-170802,170802,2,0,5,518,0.75,1.2557839,4
2020-09-05-170802,170802,0,0,0,518,0.25,0.20794974,5
2020-09-06-170802,170802,0,0,2,518,0.25,0.17046091,6
2020-09-07-170802,170802,1,0,8,519,1.75,0.60765785,0
2020-09-08-170802,170802,0,0,1,519,0.75,0.31853127,1
2020-09-09-170802,170802,1,0,3,520,1.25,0.84596413,2
2020-09-10-170802,170802,1,0,4,521,1.0,0.3418071,3
2020-09-11-170802,170802,3,0,2,524,0.5,1.5360284,4
2020-09-12-170802,170802,1,0,0,525,1.0,0.72590214,5
2020-09-13-170802,170802,2,0,0,527,0.0,0.75092816,6
2020-09-14-170802,170802,1,0,1,528,1.0,0.74825025,0
2020-09-15-170802,170802,8,0,0,536,0.25,1.1789454,1
2020-09-16-170802,170802,2,0,0,538,0.75,0.36060718,2
2020-09-17-170802,170802,4,0,0,542,0.0,0.78720975,3
2020-09-18-170802,170802,5,0,0,547,1.0,1.6284082,4
2020-09-19-170802,170802,0,0,0,547,0.0,0.025219962,5
2020-09-20-170802,170802,2,0,0,549,2.25,1.5284346,6
2020-09-21-170802,170802,8,0,1,557,1.5,1.6232773,0
2020-09-22-170802,170802,1,0,0,558,0.75,0.62925375,1
2020-09-23-170802,170802,3,1,3,561,1.75,1.4599336,2
2020-09-24-170802,170802,4,0,0,565,3.25,2.085112,3
2020-09-25-170802,170802,2,0,0,567,6.75,1.2590657,4
2020-09-26-170802,170802,0,0,0,567,2.25,0.60685104,5
2020-09-27-170802,170802,0,0,0,567,0.25,0.055590823,6
2020-09-28-170802,170802,1,0,0,568,1.75,0.84177756,0
2020-09-29-170802,170802,0,0,0,568,0.25,0.05033176,1
2020-09-30-170802,170802,0,0,0,568,0.5,0.22247851,2
2020-10-01-170802,170802,0,0,0,568,1.25,0.22168922,3
2020-10-02-170802,170802,0,0,0,568,0.0,0.017705644,4
2020-10-03-170802,170802,0,0,0,568,0.0,0.004963085,5
2020-10-04-170802,170802,0,1,0,568,0.0,0.031943448,6
2020-10-05-170802,170802,1,0,0,569,0.75,0.6048372,0
2020-10-06-170802,170802,0,0,0,569,0.75,0.28951427,1
2020-10-07-170802,170802,3,0,1,572,0.25,1.3706143,2
2020-10-08-170802,170802,0,0,0,572,2.25,0.57675886,3
2020-10-09-170802,170802,0,0,1,572,0.75,0.38422894,4
2020-10-10-170802,170802,0,0,1,572,1.0,0.3901472,5
2020-10-11-170802,170802,0,0,1,572,0.5,0.2287298,6
2020-10-12-170802,170802,0,0,0,572,1.0,0.28179637,0
2020-10-13-170802,170802,0,0,0,572,1.0,0.6660975,1
2020-10-14-170802,170802,0,0,1,572,1.0,0.36269137,2
2020-10-15-170802,170802,0,0,0,572,2.0,0.6607264,3
2020-10-16-170802,170802,0,0,0,572,7.25,2.2832928,4
2020-10-17-170802,170802,0,0,0,572,9.75,3.5484324,5
2020-10-18-170802,170802,0,0,0,572,0.25,0.5018054,6
2020-10-19-170802,170802,0,0,3,572,0.5,0.20932968,0
2020-10-20-170802,170802,0,0,1,572,0.25,0.4151861,1
2020-10-21-170802,170802,1,0,4,573,2.25,1.1483827,2
2020-10-22-170802,170802,0,0,6,573,2.25,0.89337206,3
2020-10-23-170802,170802,1,1,4,574,2.75,1.0128644,4
2020-10-24-170802,170802,1,0,6,575,2.25,1.2774944,5
2020-10-25-170802,170802,1,0,4,576,2.0,1.2832471,6
2020-10-26-170802,170802,0,1,2,576,2.0,1.1245139,0
2020-10-27-170802,170802,0,0,2,576,0.75,0.63170034,1
2020-10-28-170802,170802,1,0,0,577,2.25,1.5807257,2
2020-10-29-170802,170802,0,0,0,577,1.0,0.4666346,3
2020-10-30-170802,170802,0,0,0,577,1.75,1.0444136,4
2020-10-31-170802,170802,0,0,0,577,2.25,0.83873636,5
2020-11-01-170802,170802,0,2,0,577,0.75,0.29519555,6
2020-11-02-170802,170802,3,1,0,580,1.25,2.0054717,0
2020-11-03-170802,170802,1,1,0,581,2.25,1.6487056,1
2020-11-04-170802,170802,4,0,0,585,0.5,1.8026822,2
2020-11-05-170802,170802,6,0,0,591,2.25,3.1478856,3
2020-11-06-170802,170802,4,0,0,595,2.75,2.042786,4
2020-11-07-170802,170802,6,0,0,601,0.75,1.8989683,5
2020-11-08-170802,170802,4,0,0,605,3.5,2.139468,6
2020-11-09-170802,170802,2,0,0,607,1.25,0.969278,0
2020-11-10-170802,170802,2,0,0,609,1.0,1.3006915,1
2020-11-11-170802,170802,0,0,0,609,1.75,0.98360866,2
2020-11-12-170802,170802,0,0,0,609,2.75,1.3182096,3
2020-11-13-170802,170802,0,0,0,609,1.25,0.43635792,4
2020-03-01-170803,170803,0,0,0,0,0.0,7.784195e-09,6
2020-03-02-170803,170803,0,0,0,0,0.0,6.1992156e-05,0
2020-03-03-170803,170803,0,0,1,0,0.0,0.0002223399,1
2020-03-04-170803,170803,0,0,1,0,0.0,1.6122158e-05,2
2020-03-05-170803,170803,0,0,0,0,0.0,0.03648961,3
2020-03-06-170803,170803,0,0,0,0,0.0,1.7997061e-05,4
2020-03-07-170803,170803,0,0,0,0,0.0,0.03499839,5
2020-03-08-170803,170803,0,0,0,0,0.0,0.0,6
2020-03-09-170803,170803,0,0,1,0,0.5,0.1281125,0
2020-03-10-170803,170803,0,0,0,0,0.0,0.0002271792,1
2020-03-11-170803,170803,0,0,1,0,0.5,0.13863479,2
2020-03-12-170803,170803,0,0,1,0,1.0,0.18839602,3
2020-03-13-170803,170803,0,0,3,0,0.5,0.0767024,4
2020-03-14-170803,170803,0,0,1,0,1.5,0.12171458,5
2020-03-15-170803,170803,0,0,1,0,0.5,0.082779765,6
2020-03-16-170803,170803,0,0,1,0,4.5,0.6689984,0
2020-03-17-170803,170803,1,1,0,1,4.0,0.48477823,1
2020-03-18-170803,170803,1,0,0,2,3.5,0.681994,2
2020-03-19-170803,170803,0,0,1,2,5.0,0.4651923,3
2020-03-20-170803,170803,0,0,1,2,8.5,0.8020267,4
2020-03-21-170803,170803,0,0,0,2,2.5,0.2095845,5
2020-03-22-170803,170803,0,1,1,2,3.5,0.2280935,6
2020-03-23-170803,170803,1,0,1,3,13.5,1.2756077,0
2020-03-24-170803,170803,0,0,0,3,10.5,1.1364546,1
2020-03-25-170803,170803,1,0,0,4,7.5,0.74234873,2
2020-03-26-170803,170803,1,0,6,5,7.0,1.1538742,3
2020-03-27-170803,170803,3,0,0,8,5.5,1.1245877,4
2020-03-28-170803,170803,1,0,7,9,1.5,0.21452928,5
2020-03-29-170803,170803,1,0,0,10,2.5,0.15611562,6
2020-03-30-170803,170803,1,0,0,11,11.0,1.1185232,0
2020-03-31-170803,170803,0,0,0,11,4.5,0.628535,1
2020-04-01-170803,170803,0,0,2,11,9.5,1.4744009,2
2020-04-02-170803,170803,1,0,0,12,9.0,0.8600842,3
2020-04-03-170803,170803,1,0,0,13,4.0,0.5334544,4
2020-04-04-170803,170803,0,0,0,13,1.5,0.30393913,5
2020-04-05-170803,170803,1,0,0,14,1.5,0.19710743,6
2020-04-06-170803,170803,1,0,0,15,5.0,0.8006275,0
2020-04-07-170803,170803,0,0,0,15,2.0,0.48689246,1
2020-04-08-170803,170803,0,0,1,15,3.0,0.5636324,2
2020-04-09-170803,170803,6,0,0,21,3.5,0.46141577,3
2020-04-10-170803,170803,0,0,1,21,12.5,0.744618,4
2020-04-11-170803,170803,7,0,0,28,0.5,0.14987972,5
2020-04-12-170803,170803,0,0,0,28,0.0,0.042611793,6
2020-04-13-170803,170803,0,0,1,28,2.5,0.5832102,0
2020-04-14-170803,170803,0,0,0,28,6.5,1.2221339,1
2020-04-15-170803,170803,2,0,1,30,8.0,0.7077784,2
2020-04-16-170803,170803,0,0,0,30,18.0,2.0356123,3
2020-04-17-170803,170803,0,0,0,30,2.5,0.27580827,4
2020-04-18-170803,170803,0,0,0,30,1.0,0.35358137,5
2020-04-19-170803,170803,0,0,0,30,0.0,0.04234045,6
2020-04-20-170803,170803,0,2,0,30,3.0,1.7403934,0
2020-04-21-170803,170803,0,0,1,30,1.0,0.12212309,1
2020-04-22-170803,170803,1,0,1,31,3.0,0.5029906,2
2020-04-23-170803,170803,0,0,0,31,1.0,0.17858098,3
2020-04-24-170803,170803,1,0,0,32,5.5,0.92532176,4
2020-04-25-170803,170803,0,0,0,32,1.0,0.16734841,5
2020-04-26-170803,170803,0,0,0,32,2.0,0.14705862,6
2020-04-27-170803,170803,1,0,0,33,1.0,0.23159525,0
2020-04-28-170803,170803,0,1,0,33,0.0,0.12641165,1
2020-04-29-170803,170803,1,0,2,34,1.0,0.14765723,2
2020-04-30-170803,170803,0,0,0,34,1.5,0.22146206,3
2020-05-01-170803,170803,0,0,0,34,1.0,0.10646492,4
2020-05-02-170803,170803,0,0,0,34,5.0,0.45171922,5
2020-05-03-170803,170803,0,0,0,34,2.0,0.1700395,6
2020-05-04-170803,170803,0,0,0,34,2.0,0.48997006,0
2020-05-05-170803,170803,1,0,0,35,4.5,0.71577007,1
2020-05-06-170803,170803,1,0,0,36,3.0,0.7578913,2
2020-05-07-170803,170803,0,0,0,36,1.0,0.42630893,3
2020-05-08-170803,170803,0,0,0,36,2.0,0.41937292,4
2020-05-09-170803,170803,0,0,0,36,1.5,0.15113446,5
2020-05-10-170803,170803,0,0,0,36,1.0,0.046861753,6
2020-05-11-170803,170803,0,0,0,36,3.0,0.42045105,0
2020-05-12-170803,170803,0,0,0,36,0.5,0.1833014,1
2020-05-13-170803,170803,2,1,1,38,1.5,0.4812877,2
2020-05-14-170803,170803,0,0,1,38,2.5,0.28629914,3
2020-05-15-170803,170803,0,0,0,38,1.5,0.26632392,4
2020-05-16-170803,170803,0,1,0,38,1.5,0.113826126,5
2020-05-17-170803,170803,0,0,0,38,0.0,0.0036027152,6
2020-05-18-170803,170803,0,0,1,38,0.5,0.22822692,0
2020-05-19-170803,170803,0,0,0,38,0.5,0.27324283,1
2020-05-20-170803,170803,0,0,0,38,1.0,0.13927898,2
2020-05-21-170803,170803,0,0,0,38,0.5,0.12054233,3
2020-05-22-170803,170803,0,0,0,38,1.5,0.24842937,4
2020-05-23-170803,170803,0,0,1,38,1.0,0.07401744,5
2020-05-24-170803,170803,0,0,1,38,0.0,0.07939947,6
2020-05-25-170803,170803,0,0,0,38,1.5,0.35408664,0
2020-05-26-170803,170803,0,0,1,38,3.0,0.516284,1
2020-05-27-170803,170803,1,0,0,39,0.5,0.08444873,2
2020-05-28-170803,170803,1,0,0,40,1.5,0.5295707,3
2020-05-29-170803,170803,0,0,0,40,1.0,0.19861224,4
2020-05-30-170803,170803,0,0,0,40,0.0,0.11675204,5
2020-05-31-170803,170803,0,0,0,40,0.0,0.0037709586,6
2020-06-01-170803,170803,1,0,0,41,0.0,0.090566486,0
2020-06-02-170803,170803,0,0,0,41,0.5,0.18763578,1
2020-06-03-170803,170803,0,0,1,41,0.0,0.12788922,2
2020-06-04-170803,170803,0,0,0,41,1.0,0.21563347,3
2020-06-05-170803,170803,0,0,1,41,0.0,0.09022835,4
2020-06-06-170803,170803,1,0,0,42,0.0,0.047432505,5
2020-06-07-170803,170803,1,0,0,43,0.5,0.082803726,6
2020-06-08-170803,170803,0,0,0,43,0.0,0.082410455,0
2020-06-09-170803,170803,1,0,0,44,1.0,0.31296685,1
2020-06-10-170803,170803,0,0,0,44,0.5,0.2333494,2
2020-06-11-170803,170803,0,0,0,44,1.0,0.15684658,3
2020-06-12-170803,170803,0,0,2,44,3.0,0.34373462,4
2020-06-13-170803,170803,0,0,0,44,0.0,0.05278901,5
2020-06-14-170803,170803,0,0,0,44,0.0,0.032285657,6
2020-06-15-170803,170803,0,0,0,44,0.5,0.06944859,0
2020-06-16-170803,170803,0,0,1,44,0.5,0.1819249,1
2020-06-17-170803,170803,1,1,0,45,1.0,0.39056608,2
2020-06-18-170803,170803,0,0,0,45,0.5,0.104110435,3
2020-06-19-170803,170803,1,0,1,46,0.5,0.14716688,4
2020-06-20-170803,170803,0,0,0,46,0.0,0.0058041317,5
2020-06-21-170803,170803,0,0,0,46,1.5,0.13194439,6
2020-06-22-170803,170803,0,0,1,46,0.5,0.10596594,0
2020-06-23-170803,170803,0,0,1,46,1.0,0.12616217,1
2020-06-24-170803,170803,0,0,2,46,0.0,0.0066612973,2
2020-06-25-170803,170803,0,0,0,46,0.5,0.1168884,3
2020-06-26-170803,170803,2,2,0,48,0.5,0.1928894,4
2020-06-27-170803,170803,0,0,0,48,0.0,0.046594903,5
2020-06-28-170803,170803,0,0,0,48,0.0,0.079303786,6
2020-06-29-170803,170803,0,0,1,48,0.0,0.0004081111,0
2020-06-30-170803,170803,1,0,1,49,0.0,0.026592003,1
2020-07-01-170803,170803,0,0,0,49,0.5,0.12369316,2
2020-07-02-170803,170803,0,0,3,49,0.5,0.083954856,3
2020-07-03-170803,170803,1,0,1,50,0.0,0.03119766,4
2020-07-04-170803,170803,0,0,2,50,0.5,0.05412881,5
2020-07-05-170803,170803,0,0,0,50,0.0,4.1617845e-05,6
2020-07-06-170803,170803,1,0,4,51,0.0,0.032635767,0
2020-07-07-170803,170803,1,1,1,52,0.0,0.12636824,1
2020-07-08-170803,170803,2,0,1,54,0.5,0.18242778,2
2020-07-09-170803,170803,0,0,3,54,0.0,0.00837412,3
2020-07-10-170803,170803,0,0,1,54,0.0,0.0010878971,4
2020-07-11-170803,170803,0,0,0,54,0.0,4.8697344e-05,5
2020-07-12-170803,170803,0,0,1,54,0.5,0.04755228,6
2020-07-13-170803,170803,1,0,3,55,0.0,0.27693957,0
2020-07-14-170803,170803,1,0,0,56,0.0,0.08475808,1
2020-07-15-170803,170803,0,0,1,56,0.0,0.13601063,2
2020-07-16-170803,170803,3,0,0,59,0.0,0.19906947,3
2020-07-17-170803,170803,1,0,1,60,0.5,0.13006948,4
2020-07-18-170803,170803,2,0,0,62,0.0,0.054734517,5
2020-07-19-170803,170803,0,0,0,62,0.0,0.0073604784,6
2020-07-20-170803,170803,4,0,1,66,0.0,0.12861729,0
2020-07-21-170803,170803,1,0,2,67,0.0,0.14720608,1
2020-07-22-170803,170803,1,0,1,68,0.5,0.13212593,2
2020-07-23-170803,170803,3,0,1,71,0.5,0.3519438,3
2020-07-24-170803,170803,1,0,0,72,0.5,0.177462,4
2020-07-25-170803,170803,0,0,1,72,0.0,0.045235325,5
2020-07-26-170803,170803,1,0,0,73,1.0,0.275473,6
2020-07-27-170803,170803,3,0,0,76,0.0,0.046929866,0
2020-07-28-170803,170803,0,0,5,76,0.0,0.0005943637,1
2020-07-29-170803,170803,1,0,3,77,1.5,0.32063112,2
2020-07-30-170803,170803,0,0,7,77,0.5,0.14258835,3
2020-07-31-170803,170803,1,0,0,78,0.0,0.631445,4
2020-08-01-170803,170803,0,0,0,78,0.0,0.23954518,5
2020-08-02-170803,170803,0,0,0,78,0.5,0.058765516,6
2020-08-03-170803,170803,1,0,3,79,1.0,0.19410373,0
2020-08-04-170803,170803,2,0,4,81,0.0,0.21838191,1
2020-08-05-170803,170803,1,0,3,82,0.5,0.86032027,2
2020-08-06-170803,170803,1,0,0,83,0.0,0.68892765,3
2020-08-07-170803,170803,0,0,4,83,0.0,0.24590713,4
2020-08-08-170803,170803,1,0,1,84,2.0,0.6735193,5
2020-08-09-170803,170803,0,0,1,84,1.0,0.17398669,6
2020-08-10-170803,170803,0,0,2,84,0.5,0.43687665,0
2020-08-11-170803,170803,5,0,0,89,0.0,0.39588183,1
2020-08-12-170803,170803,3,0,1,92,0.0,0.39436233,2
2020-08-13-170803,170803,7,0,0,99,1.5,0.43432128,3
2020-08-14-170803,170803,0,0,4,99,0.0,0.4149681,4
2020-08-15-170803,170803,0,0,0,99,1.0,0.22529913,5
2020-08-16-170803,170803,0,0,0,99,0.0,0.123476475,6
2020-08-17-170803,170803,3,0,3,102,0.0,0.12874565,0
2020-08-18-170803,170803,4,0,0,106,1.0,0.9987095,1
2020-08-19-170803,170803,3,0,1,109,2.5,1.3209656,2
2020-08-20-170803,170803,0,0,2,109,0.0,0.085625805,3
2020-08-21-170803,170803,4,0,1,113,2.0,0.3330172,4
2020-08-22-170803,170803,1,0,0,114,0.5,0.44096553,5
2020-08-23-170803,170803,1,0,0,115,1.0,0.15358528,6
2020-08-24-170803,170803,2,0,6,117,1.0,0.27489606,0
2020-08-25-170803,170803,0,0,1,117,0.0,0.120290175,1
2020-08-26-170803,170803,1,0,3,118,0.0,0.25561625,2
2020-08-27-170803,170803,0,0,2,118,1.0,0.46103665,3
2020-08-28-170803,170803,4,0,2,122,0.5,0.7196287,4
2020-08-29-170803,170803,0,0,1,122,0.0,0.039339155,5
2020-08-30-170803,170803,0,0,0,122,0.5,0.05680852,6
2020-08-31-170803,170803,3,0,0,125,0.0,0.15372731,0
2020-09-01-170803,170803,0,0,1,125,0.5,0.41222447,1
2020-09-02-170803,170803,1,0,1,126,0.5,0.24119644,2
2020-09-03-170803,170803,2,0,0,128,0.0,0.30585697,3
2020-09-04-170803,170803,1,0,1,129,1.0,0.28491354,4
2020-09-05-170803,170803,0,0,0,129,0.0,0.08515876,5
2020-09-06-170803,170803,0,0,2,129,0.0,0.086958386,6
2020-09-07-170803,170803,6,0,2,135,0.5,0.18665335,0
2020-09-08-170803,170803,1,0,2,136,0.0,0.1178669,1
2020-09-09-170803,170803,3,0,2,139,0.5,0.24806257,2
2020-09-10-170803,170803,2,0,8,141,0.5,0.14596722,3
2020-09-11-170803,170803,2,0,26,143,1.5,0.26220962,4
2020-09-12-170803,170803,1,0,5,144,0.5,0.19646434,5
2020-09-13-170803,170803,0,0,1,144,1.0,0.11888821,6
2020-09-14-170803,170803,0,0,5,144,0.5,0.19028355,0
2020-09-15-170803,170803,1,0,1,145,4.0,0.2205456,1
2020-09-16-170803,170803,1,0,2,146,1.0,0.14840655,2
2020-09-17-170803,170803,0,0,4,146,2.0,0.1325264,3
2020-09-18-170803,170803,1,0,0,147,2.5,0.3158179,4
2020-09-19-170803,170803,0,0,0,147,0.0,0.010666199,5
2020-09-20-170803,170803,2,0,0,149,1.0,0.3526936,6
2020-09-21-170803,170803,2,0,1,151,4.0,0.3534767,0
2020-09-22-170803,170803,2,0,1,153,0.5,0.167593,1
2020-09-23-170803,170803,2,0,0,155,1.5,0.36691192,2
2020-09-24-170803,170803,8,0,8,163,2.0,0.5597553,3
2020-09-25-170803,170803,26,0,0,189,1.0,0.4248465,4
2020-09-26-170803,170803,5,0,1,194,0.0,0.28923994,5
2020-09-27-170803,170803,1,0,0,195,0.0,0.027757145,6
2020-09-28-170803,170803,5,0,1,200,0.5,0.25976643,0
2020-09-29-170803,170803,1,0,0,201,0.0,0.022006646,1
2020-09-30-170803,170803,2,0,2,203,0.0,0.109343834,2
2020-10-01-170803,170803,4,2,3,207,0.0,0.089993306,3
2020-10-02-170803,170803,0,0,11,207,0.0,0.003386936,4
2020-10-03-170803,170803,0,1,4,207,0.0,0.0021023431,5
2020-10-04-170803,170803,0,0,0,207,0.0,0.015277736,6
2020-10-05-170803,170803,1,1,1,208,0.5,0.18426245,0
2020-10-06-170803,170803,1,1,0,209,0.0,0.12566213,1
2020-10-07-170803,170803,0,0,1,209,1.5,0.22775365,2
2020-10-08-170803,170803,8,0,2,217,0.0,0.24743925,3
2020-10-09-170803,170803,0,3,2,217,0.0,0.1871276,4
2020-10-10-170803,170803,1,0,2,218,0.0,0.20809531,5
2020-10-11-170803,170803,0,0,0,218,0.0,0.124897964,6
2020-10-12-170803,170803,1,0,0,219,0.0,0.14392824,0
2020-10-13-170803,170803,0,0,0,219,0.0,0.33276838,1
2020-10-14-170803,170803,2,0,0,221,0.0,0.16026306,2
2020-10-15-170803,170803,3,0,1,224,0.0,0.28541028,3
2020-10-16-170803,170803,11,0,0,235,0.0,1.0466411,4
2020-10-17-170803,170803,4,0,0,239,0.0,1.8794018,5
2020-10-18-170803,170803,0,0,0,239,0.0,0.22935112,6
2020-10-19-170803,170803,1,0,0,240,0.0,0.093701646,0
2020-10-20-170803,170803,0,0,2,240,0.0,0.17598443,1
2020-10-21-170803,170803,1,0,0,241,0.5,0.37648648,2
2020-10-22-170803,170803,2,0,3,243,0.5,0.42823163,3
2020-10-23-170803,170803,2,0,0,245,0.5,0.31724337,4
2020-10-24-170803,170803,2,1,0,247,1.0,0.50638115,5
2020-10-25-170803,170803,0,0,0,247,2.0,0.53543866,6
2020-10-26-170803,170803,0,1,2,247,0.5,0.4886996,0
2020-10-27-170803,170803,0,0,0,247,0.5,0.30319524,1
2020-10-28-170803,170803,0,2,1,247,1.0,0.6830249,2
2020-10-29-170803,170803,1,1,3,248,0.0,0.24668114,3
2020-10-30-170803,170803,0,0,2,248,0.5,0.44546518,4
2020-10-31-170803,170803,0,0,0,248,0.0,0.45514473,5
2020-11-01-170803,170803,0,1,0,248,0.0,0.15583932,6
2020-11-02-170803,170803,0,0,0,248,3.0,0.7236364,0
2020-11-03-170803,170803,2,0,0,250,1.5,0.5653666,1
2020-11-04-170803,170803,0,1,0,250,2.0,0.3521627,2
2020-11-05-170803,170803,3,0,0,253,3.0,0.9632218,3
2020-11-06-170803,170803,0,1,0,253,2.0,0.48491186,4
2020-11-07-170803,170803,0,0,0,253,3.0,0.36389077,5
2020-11-08-170803,170803,0,1,0,253,2.0,0.5599141,6
2020-11-09-170803,170803,2,0,0,255,1.0,0.38268793,0
2020-11-10-170803,170803,0,0,0,255,1.0,0.3099972,1
2020-11-11-170803,170803,1,0,0,256,0.0,0.43327352,2
2020-11-12-170803,170803,3,0,0,259,0.5,0.6521622,3
2020-11-13-170803,170803,2,0,0,261,0.0,0.2223649,4
2020-03-01-170804,170804,0,0,1,0,0.0,4.521106e-09,6
2020-03-02-170804,170804,0,0,1,0,0.0,1.2958942e-05,0
2020-03-03-170804,170804,1,0,0,1,0.0,0.00067187706,1
2020-03-04-170804,170804,0,0,1,1,0.0,1.8526989e-06,2
2020-03-05-170804,170804,0,1,2,1,0.25,0.046499383,3
2020-03-06-170804,170804,0,0,3,1,0.0,5.754685e-05,4
2020-03-07-170804,170804,0,0,2,1,0.25,0.042671736,5
2020-03-08-170804,170804,0,0,0,1,0.0,2.003781e-05,6
2020-03-09-170804,170804,0,0,1,1,1.0,0.14421582,0
2020-03-10-170804,170804,0,0,1,1,0.0,0.00032305613,1
2020-03-11-170804,170804,0,1,1,1,0.75,0.13964319,2
2020-03-12-170804,170804,0,0,2,1,1.0,0.15027787,3
2020-03-13-170804,170804,0,0,3,1,0.25,0.05429712,4
2020-03-14-170804,170804,0,0,0,1,0.75,0.09164174,5
2020-03-15-170804,170804,1,0,0,2,2.25,0.10184904,6
2020-03-16-170804,170804,1,0,0,3,4.5,0.49852824,0
2020-03-17-170804,170804,0,0,0,3,5.0,0.5279677,1
2020-03-18-170804,170804,1,0,2,4,6.5,0.6275771,2
2020-03-19-170804,170804,2,0,0,6,5.75,0.40978175,3
2020-03-20-170804,170804,3,0,0,9,8.5,0.6810889,4
2020-03-21-170804,170804,2,0,1,11,5.25,0.21394217,5
2020-03-22-170804,170804,0,2,1,11,4.5,0.14628774,6
2020-03-23-170804,170804,1,0,0,12,14.0,1.0064496,0
2020-03-24-170804,170804,1,0,0,13,11.0,0.9409347,1
2020-03-25-170804,170804,1,0,1,14,9.5,0.72782844,2
2020-03-26-170804,170804,2,0,0,16,6.25,0.77480656,3
2020-03-27-170804,170804,3,0,0,19,8.25,0.8591024,4
2020-03-28-170804,170804,0,0,0,19,2.5,0.16649951,5
2020-03-29-170804,170804,0,0,0,19,3.25,0.10943016,6
2020-03-30-170804,170804,0,0,1,19,11.75,0.8857865,0
2020-03-31-170804,170804,0,0,0,19,9.0,0.5061052,1
2020-04-01-170804,170804,2,0,0,21,12.75,1.3261725,2
2020-04-02-170804,170804,0,0,1,21,8.75,0.6744246,3
2020-04-03-170804,170804,0,0,1,21,8.0,0.56749487,4
2020-04-04-170804,170804,1,0,0,22,3.25,0.18239924,5
2020-04-05-170804,170804,1,1,0,23,4.0,0.19932052,6
2020-04-06-170804,170804,0,1,1,23,8.5,0.6919821,0
2020-04-07-170804,170804,0,0,0,23,5.75,0.39099532,1
2020-04-08-170804,170804,1,0,0,24,7.5,0.59827954,2
2020-04-09-170804,170804,0,0,0,24,4.25,0.36673987,3
2020-04-10-170804,170804,0,0,1,24,11.75,0.52440923,4
2020-04-11-170804,170804,0,0,0,24,2.5,0.14343485,5
2020-04-12-170804,170804,0,0,0,24,3.25,0.07447533,6
2020-04-13-170804,170804,1,0,0,25,5.5,0.6687986,0
2020-04-14-170804,170804,0,0,0,25,8.5,0.97915643,1
2020-04-15-170804,170804,0,0,0,25,5.25,0.51576,2
2020-04-16-170804,170804,1,0,0,26,14.5,1.6015508,3
2020-04-17-170804,170804,1,0,1,27,2.25,0.28422344,4
2020-04-18-170804,170804,0,0,0,27,3.75,0.3904017,5
2020-04-19-170804,170804,0,0,0,27,0.75,0.059247468,6
2020-04-20-170804,170804,1,0,0,28,11.5,1.5512304,0
2020-04-21-170804,170804,0,0,0,28,1.5,0.1208166,1
2020-04-22-170804,170804,0,0,0,28,2.25,0.34729543,2
2020-04-23-170804,170804,0,0,2,28,0.5,0.045799427,3
2020-04-24-170804,170804,1,0,0,29,4.0,0.47691765,4
2020-04-25-170804,170804,0,0,0,29,1.5,0.12926626,5
2020-04-26-170804,170804,0,0,0,29,1.0,0.03967165,6
2020-04-27-170804,170804,0,0,0,29,3.0,0.26892027,0
2020-04-28-170804,170804,0,0,0,29,2.25,0.1535247,1
2020-04-29-170804,170804,0,0,1,29,1.5,0.12460916,2
2020-04-30-170804,170804,0,0,0,29,2.25,0.22847413,3
2020-05-01-170804,170804,1,0,1,30,1.75,0.102283485,4
2020-05-02-170804,170804,0,0,0,30,3.25,0.25315765,5
2020-05-03-170804,170804,0,0,0,30,2.75,0.1258027,6
2020-05-04-170804,170804,0,0,1,30,4.75,0.46680942,0
2020-05-05-170804,170804,0,0,1,30,4.5,0.59699005,1
2020-05-06-170804,170804,0,0,0,30,9.75,0.81843215,2
2020-05-07-170804,170804,2,0,0,32,2.25,0.43024465,3
2020-05-08-170804,170804,0,0,1,32,1.5,0.34727225,4
2020-05-09-170804,170804,0,0,0,32,0.75,0.053120576,5
2020-05-10-170804,170804,0,0,0,32,0.5,0.040367752,6
2020-05-11-170804,170804,0,0,1,32,3.75,0.37158662,0
2020-05-12-170804,170804,0,0,1,32,1.75,0.18572439,1
2020-05-13-170804,170804,1,1,0,33,3.25,0.5317874,2
2020-05-14-170804,170804,0,0,3,33,2.25,0.2411454,3
2020-05-15-170804,170804,1,1,0,34,2.0,0.2943051,4
2020-05-16-170804,170804,0,0,0,34,1.25,0.09939404,5
2020-05-17-170804,170804,0,0,0,34,0.0,0.00081362505,6
2020-05-18-170804,170804,1,0,1,35,1.5,0.23465645,0
2020-05-19-170804,170804,1,0,0,36,2.5,0.34855804,1
2020-05-20-170804,170804,0,0,1,36,2.0,0.15848656,2
2020-05-21-170804,170804,0,0,0,36,0.75,0.10691193,3
2020-05-22-170804,170804,1,0,0,37,0.5,0.16233175,4
2020-05-23-170804,170804,0,0,0,37,0.5,0.044862054,5
2020-05-24-170804,170804,0,0,0,37,1.0,0.08833477,6
2020-05-25-170804,170804,1,0,0,38,2.0,0.40177456,0
2020-05-26-170804,170804,1,0,0,39,2.75,0.53239095,1
2020-05-27-170804,170804,0,2,0,39,0.5,0.08727184,2
2020-05-28-170804,170804,3,0,0,42,2.5,0.57213527,3
2020-05-29-170804,170804,0,1,0,42,1.0,0.1829166,4
2020-05-30-170804,170804,0,0,0,42,1.25,0.15381026,5
2020-05-31-170804,170804,0,0,0,42,0.25,0.002494033,6
2020-06-01-170804,170804,1,0,0,43,0.75,0.12538314,0
2020-06-02-170804,170804,0,0,0,43,2.0,0.21424563,1
2020-06-03-170804,170804,1,0,0,44,0.75,0.15988047,2
2020-06-04-170804,170804,0,0,0,44,0.5,0.13507508,3
2020-06-05-170804,170804,0,0,0,44,0.75,0.11862331,4
2020-06-06-170804,170804,0,0,0,44,0.25,0.057159673,5
2020-06-07-170804,170804,0,0,0,44,1.0,0.08437158,6
2020-06-08-170804,170804,0,0,0,44,1.0,0.105526224,0
2020-06-09-170804,170804,0,0,0,44,1.5,0.2389567,1
2020-06-10-170804,170804,0,1,0,44,1.75,0.26797545,2
2020-06-11-170804,170804,0,0,0,44,0.75,0.10356859,3
2020-06-12-170804,170804,0,0,0,44,2.5,0.3368667,4
2020-06-13-170804,170804,0,0,0,44,0.25,0.044174183,5
2020-06-14-170804,170804,0,0,0,44,0.5,0.04508033,6
2020-06-15-170804,170804,0,0,0,44,0.25,0.05077117,0
2020-06-16-170804,170804,0,0,0,44,1.25,0.19768655,1
2020-06-17-170804,170804,0,0,0,44,2.0,0.4580667,2
2020-06-18-170804,170804,0,2,0,44,0.5,0.10879565,3
2020-06-19-170804,170804,0,0,0,44,1.25,0.16387331,4
2020-06-20-170804,170804,0,0,0,44,0.25,0.015277484,5
2020-06-21-170804,170804,0,0,0,44,1.0,0.11381552,6
2020-06-22-170804,170804,0,0,0,44,0.75,0.10457678,0
2020-06-23-170804,170804,0,1,0,44,1.0,0.124599144,1
2020-06-24-170804,170804,0,0,0,44,0.25,0.016065383,2
2020-06-25-170804,170804,0,0,0,44,1.0,0.13023587,3
2020-06-26-170804,170804,0,0,0,44,0.5,0.123952605,4
2020-06-27-170804,170804,0,0,0,44,0.25,0.05830084,5
2020-06-28-170804,170804,0,0,0,44,0.5,0.10478421,6
2020-06-29-170804,170804,0,0,4,44,0.0,0.0008940713,0
2020-06-30-170804,170804,0,0,0,44,0.25,0.030897101,1
2020-07-01-170804,170804,0,0,0,44,0.75,0.14912803,2
2020-07-02-170804,170804,0,0,0,44,1.0,0.06788723,3
2020-07-03-170804,170804,0,0,1,44,0.75,0.038286027,4
2020-07-04-170804,170804,0,0,0,44,0.25,0.03989065,5
2020-07-05-170804,170804,0,0,0,44,0.0,0.000119700424,6
2020-07-06-170804,170804,0,0,0,44,0.25,0.03865883,0
2020-07-07-170804,170804,0,0,1,44,0.25,0.16612552,1
2020-07-08-170804,170804,0,1,0,44,1.0,0.18400036,2
2020-07-09-170804,170804,0,0,1,44,0.0,0.0029710557,3
2020-07-10-170804,170804,0,0,0,44,0.25,0.00013175103,4
2020-07-11-170804,170804,0,0,0,44,0.0,0.00014074845,5
2020-07-12-170804,170804,0,0,0,44,0.25,0.036251657,6
2020-07-13-170804,170804,4,0,0,48,1.25,0.42243484,0
2020-07-14-170804,170804,0,0,0,48,0.75,0.10222117,1
2020-07-15-170804,170804,0,0,0,48,1.0,0.18267332,2
2020-07-16-170804,170804,0,0,0,48,0.75,0.25380394,3
2020-07-17-170804,170804,1,0,0,49,0.5,0.13539417,4
2020-07-18-170804,170804,0,0,0,49,0.25,0.04404909,5
2020-07-19-170804,170804,0,0,0,49,0.25,0.018264357,6
2020-07-20-170804,170804,0,0,0,49,1.0,0.13324447,0
2020-07-21-170804,170804,1,0,0,50,1.0,0.19997022,1
2020-07-22-170804,170804,0,0,0,50,0.5,0.102320366,2
2020-07-23-170804,170804,1,0,0,51,1.5,0.34477466,3
2020-07-24-170804,170804,0,0,2,51,1.5,0.21426472,4
2020-07-25-170804,170804,0,0,2,51,1.0,0.05969382,5
2020-07-26-170804,170804,0,0,0,51,1.0,0.22792147,6
2020-07-27-170804,170804,0,0,3,51,0.0,0.029705415,0
2020-07-28-170804,170804,0,0,0,51,0.0,0.0005231926,1
2020-07-29-170804,170804,0,0,0,51,1.75,0.31498647,2
2020-07-30-170804,170804,0,0,0,51,2.0,0.19440639,3
2020-07-31-170804,170804,0,0,0,51,1.25,0.36175385,4
2020-08-01-170804,170804,0,0,0,51,1.75,0.35301673,5
2020-08-02-170804,170804,0,0,0,51,0.25,0.052006654,6
2020-08-03-170804,170804,0,0,0,51,0.75,0.15628053,0
2020-08-04-170804,170804,0,0,0,51,1.25,0.30248988,1
2020-08-05-170804,170804,0,1,0,51,3.5,1.1014028,2
2020-08-06-170804,170804,0,0,0,51,2.5,0.89383346,3
2020-08-07-170804,170804,2,0,0,53,1.0,0.37487814,4
2020-08-08-170804,170804,2,0,1,55,1.5,0.7361515,5
2020-08-09-170804,170804,0,0,0,55,0.75,0.19854999,6
2020-08-10-170804,170804,3,0,0,58,0.75,0.5016701,0
2020-08-11-170804,170804,0,0,0,58,2.0,0.47982374,1
2020-08-12-170804,170804,0,2,1,58,1.75,0.4547984,2
2020-08-13-170804,170804,0,0,0,58,1.0,0.3149557,3
2020-08-14-170804,170804,0,0,0,58,2.25,0.52660805,4
2020-08-15-170804,170804,0,0,0,58,1.25,0.2780206,5
2020-08-16-170804,170804,0,0,0,58,0.75,0.123295076,6
2020-08-17-170804,170804,0,0,0,58,0.25,0.16972026,0
2020-08-18-170804,170804,0,0,0,58,1.75,0.77119744,1
2020-08-19-170804,170804,0,0,0,58,1.0,0.6665511,2
2020-08-20-170804,170804,0,0,1,58,0.75,0.12977165,3
2020-08-21-170804,170804,0,0,0,58,1.25,0.28681546,4
2020-08-22-170804,170804,1,0,1,59,1.0,0.39195234,5
2020-08-23-170804,170804,0,0,0,59,0.5,0.12253914,6
2020-08-24-170804,170804,0,0,0,59,1.75,0.3075347,0
2020-08-25-170804,170804,0,0,1,59,1.0,0.17072639,1
2020-08-26-170804,170804,1,0,1,60,2.25,0.3720041,2
2020-08-27-170804,170804,0,0,1,60,2.0,0.5050421,3
2020-08-28-170804,170804,0,0,0,60,2.0,0.4860873,4
2020-08-29-170804,170804,0,0,0,60,1.0,0.06881464,5
2020-08-30-170804,170804,0,0,0,60,1.0,0.09912236,6
2020-08-31-170804,170804,0,0,0,60,0.75,0.1459181,0
2020-09-01-170804,170804,0,0,0,60,4.25,0.51764834,1
2020-09-02-170804,170804,0,0,0,60,1.25,0.22177282,2
2020-09-03-170804,170804,1,0,0,61,3.0,0.49377853,3
2020-09-04-170804,170804,0,0,0,61,3.0,0.3837319,4
2020-09-05-170804,170804,1,0,0,62,0.5,0.14059152,5
2020-09-06-170804,170804,0,0,2,62,1.25,0.12350718,6
2020-09-07-170804,170804,0,0,3,62,1.25,0.19573875,0
2020-09-08-170804,170804,1,0,0,63,1.0,0.17448503,1
2020-09-09-170804,170804,1,0,0,64,0.75,0.26204896,2
2020-09-10-170804,170804,1,0,0,65,1.25,0.20267387,3
2020-09-11-170804,170804,0,0,0,65,2.25,0.27021378,4
2020-09-12-170804,170804,0,0,1,65,1.5,0.23628157,5
2020-09-13-170804,170804,0,0,0,65,1.5,0.1597259,6
2020-09-14-170804,170804,0,0,0,65,1.75,0.24723428,0
2020-09-15-170804,170804,0,0,0,65,3.75,0.22571796,1
2020-09-16-170804,170804,0,0,0,65,2.75,0.25463992,2
2020-09-17-170804,170804,0,0,0,65,1.5,0.13247578,3
2020-09-18-170804,170804,0,0,0,65,4.0,0.3879809,4
2020-09-19-170804,170804,0,0,0,65,0.75,0.027442284,5
2020-09-20-170804,170804,2,0,0,67,3.25,0.50560343,6
2020-09-21-170804,170804,3,0,0,70,3.5,0.3812427,0
2020-09-22-170804,170804,0,0,0,70,3.25,0.16913962,1
2020-09-23-170804,170804,0,0,0,70,4.25,0.46781355,2
2020-09-24-170804,170804,0,0,0,70,3.0,0.4980301,3
2020-09-25-170804,170804,0,0,0,70,1.5,0.37735298,4
2020-09-26-170804,170804,1,0,0,71,2.5,0.38477138,5
2020-09-27-170804,170804,0,0,0,71,0.5,0.035215642,6
2020-09-28-170804,170804,0,0,0,71,2.75,0.2810755,0
2020-09-29-170804,170804,0,0,0,71,0.0,0.019064637,1
2020-09-30-170804,170804,0,0,0,71,0.75,0.09892575,2
2020-10-01-170804,170804,0,0,0,71,0.5,0.08383302,3
2020-10-02-170804,170804,0,0,2,71,0.5,0.006909715,4
2020-10-03-170804,170804,0,0,0,71,0.0,0.0053102793,5
2020-10-04-170804,170804,0,0,0,71,0.75,0.03628674,6
2020-10-05-170804,170804,0,1,0,71,1.25,0.210694,0
2020-10-06-170804,170804,0,0,0,71,0.75,0.13169117,1
2020-10-07-170804,170804,0,0,0,71,2.0,0.2301155,2
2020-10-08-170804,170804,0,0,0,71,3.25,0.25146297,3
2020-10-09-170804,170804,0,0,0,71,2.5,0.23439825,4
2020-10-10-170804,170804,0,0,0,71,1.25,0.21189876,5
2020-10-11-170804,170804,0,0,0,71,1.25,0.16059387,6
2020-10-12-170804,170804,0,0,0,71,0.75,0.16668774,0
2020-10-13-170804,170804,0,0,1,71,2.0,0.38039184,1
2020-10-14-170804,170804,0,0,0,71,1.25,0.16340318,2
2020-10-15-170804,170804,0,0,0,71,1.25,0.35388586,3
2020-10-16-170804,170804,2,0,0,73,5.75,1.1351305,4
2020-10-17-170804,170804,0,0,0,73,9.0,2.1402931,5
2020-10-18-170804,170804,0,0,0,73,3.75,0.42009234,6
2020-10-19-170804,170804,0,0,0,73,0.5,0.10073379,0
2020-10-20-170804,170804,0,0,0,73,0.75,0.20134398,1
2020-10-21-170804,170804,0,0,0,73,2.75,0.43785396,2
2020-10-22-170804,170804,0,0,0,73,2.0,0.35665417,3
2020-10-23-170804,170804,0,0,0,73,6.0,0.37961715,4
2020-10-24-170804,170804,0,0,0,73,4.5,0.56986076,5
2020-10-25-170804,170804,0,1,0,73,2.0,0.33482152,6
2020-10-26-170804,170804,0,0,0,73,3.0,0.5834946,0
2020-10-27-170804,170804,1,1,0,74,0.75,0.22932622,1
2020-10-28-170804,170804,0,0,1,74,3.25,0.6119019,2
2020-10-29-170804,170804,0,0,1,74,1.0,0.27017188,3
2020-10-30-170804,170804,0,0,1,74,3.5,0.47386453,4
2020-10-31-170804,170804,0,0,0,74,2.5,0.5762388,5
2020-11-01-170804,170804,0,0,0,74,1.0,0.20037092,6
2020-11-02-170804,170804,0,0,0,74,3.75,0.44114134,0
2020-11-03-170804,170804,0,0,0,74,3.5,0.5114169,1
2020-11-04-170804,170804,0,0,0,74,4.25,0.3944349,2
2020-11-05-170804,170804,0,0,0,74,4.5,0.89097464,3
2020-11-06-170804,170804,0,0,0,74,5.0,0.5141519,4
2020-11-07-170804,170804,0,0,0,74,5.25,0.36876267,5
2020-11-08-170804,170804,0,0,0,74,5.75,0.7202814,6
2020-11-09-170804,170804,0,0,0,74,3.5,0.36062118,0
2020-11-10-170804,170804,0,0,0,74,1.75,0.29772964,1
2020-11-11-170804,170804,1,1,0,75,2.25,0.5385358,2
2020-11-12-170804,170804,1,0,0,76,2.0,0.57335776,3
2020-11-13-170804,170804,1,0,0,77,1.0,0.28122234,4
2020-03-01-170805,170805,0,0,1,0,0.0,0.00016341705,6
2020-03-02-170805,170805,0,0,4,0,0.0,0.0002545387,0
2020-03-03-170805,170805,0,0,2,0,0.25,0.00049372617,1
2020-03-04-170805,170805,0,1,3,0,0.0,0.0001364888,2
2020-03-05-170805,170805,0,0,2,0,0.25,0.098868,3
2020-03-06-170805,170805,0,0,6,0,0.0,0.00036702928,4
2020-03-07-170805,170805,0,0,7,0,0.25,0.093926,5
2020-03-08-170805,170805,0,0,0,0,0.0,0.00040091446,6
2020-03-09-170805,170805,1,0,13,1,0.5,0.4469592,0
2020-03-10-170805,170805,0,0,6,1,0.0,0.0019380983,1
2020-03-11-170805,170805,0,0,15,1,0.5,0.27524188,2
2020-03-12-170805,170805,1,0,3,2,0.5,0.43538025,3
2020-03-13-170805,170805,0,0,9,2,0.0,0.034231976,4
2020-03-14-170805,170805,0,0,3,2,0.0,0.04535712,5
2020-03-15-170805,170805,1,0,4,3,2.25,0.34195927,6
2020-03-16-170805,170805,4,1,16,7,2.75,1.5228298,0
2020-03-17-170805,170805,2,0,18,9,3.0,0.9721795,1
2020-03-18-170805,170805,3,1,6,12,5.5,1.729367,2
2020-03-19-170805,170805,2,0,9,14,4.75,1.0888586,3
2020-03-20-170805,170805,6,0,19,20,4.25,1.8407505,4
2020-03-21-170805,170805,7,0,8,27,3.0,0.9385705,5
2020-03-22-170805,170805,0,0,9,27,3.25,0.265301,6
2020-03-23-170805,170805,13,0,13,40,5.0,3.2691004,0
2020-03-24-170805,170805,6,0,9,46,6.0,2.0905442,1
2020-03-25-170805,170805,15,0,13,61,3.25,3.0849714,2
2020-03-26-170805,170805,3,0,2,64,4.0,1.299342,3
2020-03-27-170805,170805,9,0,15,73,4.75,2.5318105,4
2020-03-28-170805,170805,3,0,3,76,1.25,0.529654,5
2020-03-29-170805,170805,4,0,6,80,1.25,0.4290488,6
2020-03-30-170805,170805,16,0,2,96,3.5,2.3548331,0
2020-03-31-170805,170805,18,0,5,114,3.0,3.1163015,1
2020-04-01-170805,170805,6,0,2,120,8.25,2.2295597,2
2020-04-02-170805,170805,9,0,1,129,3.0,1.6181121,3
2020-04-03-170805,170805,19,0,2,148,1.25,2.6207576,4
2020-04-04-170805,170805,8,0,2,156,1.25,1.095067,5
2020-04-05-170805,170805,9,0,1,165,1.25,1.1125304,6
2020-04-06-170805,170805,13,0,0,178,3.25,2.4152882,0
2020-04-07-170805,170805,9,0,2,187,3.75,2.0776577,1
2020-04-08-170805,170805,13,0,0,200,3.5,2.4998422,2
2020-04-09-170805,170805,2,0,1,202,2.5,0.59129167,3
2020-04-10-170805,170805,15,0,3,217,2.5,2.271415,4
2020-04-11-170805,170805,3,0,2,220,1.5,0.5074183,5
2020-04-12-170805,170805,6,0,1,226,1.75,0.7331991,6
2020-04-13-170805,170805,2,0,4,228,4.5,1.3626051,0
2020-04-14-170805,170805,5,0,2,233,5.25,2.0705419,1
2020-04-15-170805,170805,2,0,2,235,0.75,0.83226943,2
2020-04-16-170805,170805,1,0,1,236,6.0,2.7180336,3
2020-04-17-170805,170805,2,0,0,238,0.75,0.629533,4
2020-04-18-170805,170805,2,0,2,240,2.75,0.83560514,5
2020-04-19-170805,170805,1,0,6,241,0.75,0.15911095,6
2020-04-20-170805,170805,0,0,4,241,10.5,2.2201893,0
2020-04-21-170805,170805,2,0,2,243,1.0,0.47669902,1
2020-04-22-170805,170805,0,0,25,243,1.75,0.37346974,2
2020-04-23-170805,170805,1,0,1,244,0.25,0.03510226,3
2020-04-24-170805,170805,3,0,0,247,3.0,0.864086,4
2020-04-25-170805,170805,2,0,1,249,1.0,0.40227288,5
2020-04-26-170805,170805,1,0,0,250,0.25,0.13019134,6
2020-04-27-170805,170805,4,0,3,254,1.75,1.1057873,0
2020-04-28-170805,170805,2,0,1,256,1.75,0.6568176,1
2020-04-29-170805,170805,2,0,1,258,0.75,0.48168665,2
2020-04-30-170805,170805,1,0,3,259,1.25,0.32930833,3
2020-05-01-170805,170805,0,0,0,259,1.75,0.14978021,4
2020-05-02-170805,170805,2,0,1,261,0.5,0.36420566,5
2020-05-03-170805,170805,6,0,0,267,0.25,0.82476866,6
2020-05-04-170805,170805,4,0,1,271,2.75,1.1404132,0
2020-05-05-170805,170805,2,0,3,273,1.75,0.95680386,1
2020-05-06-170805,170805,25,0,3,298,2.5,5.6086187,2
2020-05-07-170805,170805,1,0,1,299,2.25,0.82570684,3
2020-05-08-170805,170805,0,1,0,299,1.0,0.33081236,4
2020-05-09-170805,170805,1,1,0,300,0.0,0.014708752,5
2020-05-10-170805,170805,0,0,0,300,0.0,0.012489523,6
2020-05-11-170805,170805,3,0,0,303,1.5,0.9295054,0
2020-05-12-170805,170805,1,0,0,304,1.75,0.5776818,1
2020-05-13-170805,170805,1,0,1,305,2.75,1.068495,2
2020-05-14-170805,170805,3,0,2,308,1.0,1.2484279,3
2020-05-15-170805,170805,0,0,0,308,2.0,0.49969262,4
2020-05-16-170805,170805,1,2,2,309,0.25,0.2266525,5
2020-05-17-170805,170805,0,0,0,309,0.0,0.00017668362,6
2020-05-18-170805,170805,1,0,1,310,1.5,0.6241111,0
2020-05-19-170805,170805,3,0,2,313,1.75,1.1539714,1
2020-05-20-170805,170805,3,0,0,316,0.75,0.9766603,2
2020-05-21-170805,170805,1,0,0,317,0.25,0.3430928,3
2020-05-22-170805,170805,0,0,2,317,0.75,0.11473552,4
2020-05-23-170805,170805,0,0,0,317,0.0,0.034608707,5
2020-05-24-170805,170805,0,0,2,317,1.0,0.1504862,6
2020-05-25-170805,170805,0,0,1,317,1.5,0.6043865,0
2020-05-26-170805,170805,0,0,3,317,1.75,0.577022,1
2020-05-27-170805,170805,1,2,2,318,1.0,0.37582552,2
2020-05-28-170805,170805,2,0,1,320,2.0,1.1001099,3
2020-05-29-170805,170805,0,0,2,320,0.5,0.25600418,4
2020-05-30-170805,170805,2,0,0,322,0.75,0.6445045,5
2020-05-31-170805,170805,0,0,0,322,0.25,0.039411668,6
2020-06-01-170805,170805,1,0,0,323,0.75,0.37408376,0
2020-06-02-170805,170805,2,0,1,325,1.75,0.95002425,1
2020-06-03-170805,170805,0,0,0,325,1.0,0.30149552,2
2020-06-04-170805,170805,0,0,0,325,0.25,0.11320392,3
2020-06-05-170805,170805,2,0,0,327,0.25,0.6262289,4
2020-06-06-170805,170805,0,0,1,327,0.25,0.09356329,5
2020-06-07-170805,170805,2,0,1,329,0.25,0.40271246,6
2020-06-08-170805,170805,1,0,0,330,0.75,0.37747768,0
2020-06-09-170805,170805,3,1,1,333,1.0,0.87071705,1
2020-06-10-170805,170805,2,0,1,335,1.0,0.7526774,2
2020-06-11-170805,170805,1,0,2,336,0.25,0.3347263,3
2020-06-12-170805,170805,2,0,0,338,0.5,0.45558733,4
2020-06-13-170805,170805,0,0,0,338,0.25,0.0816591,5
2020-06-14-170805,170805,0,0,0,338,0.5,0.11188722,6
2020-06-15-170805,170805,0,0,0,338,0.0,0.020106014,0
2020-06-16-170805,170805,1,0,1,339,1.0,0.41365802,1
2020-06-17-170805,170805,0,0,1,339,1.5,0.6563053,2
2020-06-18-170805,170805,0,0,0,339,0.5,0.17514546,3
2020-06-19-170805,170805,0,0,1,339,1.0,0.32014027,4
2020-06-20-170805,170805,1,0,0,340,0.0,0.19381548,5
2020-06-21-170805,170805,1,0,0,341,0.0,0.23472817,6
2020-06-22-170805,170805,0,0,1,341,0.5,0.19313142,0
2020-06-23-170805,170805,1,0,0,342,0.25,0.3563658,1
2020-06-24-170805,170805,1,0,2,343,0.0,0.27005157,2
2020-06-25-170805,170805,2,1,0,345,0.5,0.66907597,3
2020-06-26-170805,170805,0,1,0,345,0.25,0.17653972,4
2020-06-27-170805,170805,0,0,0,345,0.25,0.12305403,5
2020-06-28-170805,170805,0,0,0,345,0.5,0.38745028,6
2020-06-29-170805,170805,0,0,3,345,0.0,0.017655322,0
2020-06-30-170805,170805,1,0,2,346,0.0,0.2564899,1
2020-07-01-170805,170805,1,0,2,347,0.25,0.4054451,2
2020-07-02-170805,170805,0,0,0,347,0.75,0.15963586,3
2020-07-03-170805,170805,1,0,1,348,0.5,0.35864913,4
2020-07-04-170805,170805,0,0,1,348,0.0,0.029222839,5
2020-07-05-170805,170805,0,0,1,348,0.0,3.6134952e-05,6
2020-07-06-170805,170805,1,0,4,349,0.25,0.28400642,0
2020-07-07-170805,170805,0,2,2,349,0.75,0.256267,1
2020-07-08-170805,170805,2,0,1,351,0.25,0.76321036,2
2020-07-09-170805,170805,0,0,1,351,0.0,0.0051808697,3
2020-07-10-170805,170805,0,1,4,351,0.25,0.01054622,4
2020-07-11-170805,170805,0,0,2,351,0.0,0.00011037176,5
2020-07-12-170805,170805,0,0,0,351,0.0,0.021419464,6
2020-07-13-170805,170805,3,0,0,354,1.5,1.2570211,0
2020-07-14-170805,170805,2,0,0,356,0.25,0.3818953,1
2020-07-15-170805,170805,2,0,1,358,0.5,0.77608925,2
2020-07-16-170805,170805,0,0,5,358,1.0,0.7632268,3
2020-07-17-170805,170805,1,0,0,359,0.25,0.092068866,4
2020-07-18-170805,170805,1,0,0,360,0.0,0.27949762,5
2020-07-19-170805,170805,1,0,0,361,0.0,0.21356529,6
2020-07-20-170805,170805,4,0,1,365,0.0,1.0127916,0
2020-07-21-170805,170805,2,0,0,367,0.75,0.78190005,1
2020-07-22-170805,170805,1,0,0,368,0.0,0.3377711,2
2020-07-23-170805,170805,1,0,0,369,1.25,0.4940028,3
2020-07-24-170805,170805,4,0,2,373,0.5,1.4148753,4
2020-07-25-170805,170805,2,0,0,375,0.5,0.66273814,5
2020-07-26-170805,170805,0,0,1,375,0.5,0.24732986,6
2020-07-27-170805,170805,0,0,2,375,0.0,0.022187416,0
2020-07-28-170805,170805,0,0,4,375,0.0,0.017507402,1
2020-07-29-170805,170805,1,0,5,376,0.75,0.7431581,2
2020-07-30-170805,170805,5,0,2,381,0.75,1.4097493,3
2020-07-31-170805,170805,0,0,4,381,1.25,0.49749407,4
2020-08-01-170805,170805,0,0,1,381,1.75,0.76329,5
2020-08-02-170805,170805,0,0,1,381,0.0,0.054776564,6
2020-08-03-170805,170805,1,0,0,382,0.0,0.4911221,0
2020-08-04-170805,170805,0,0,0,382,1.75,0.77578527,1
2020-08-05-170805,170805,0,0,0,382,3.25,2.2334495,2
2020-08-06-170805,170805,0,0,1,382,3.0,1.8931735,3
2020-08-07-170805,170805,2,0,1,384,1.0,1.1446613,4
2020-08-08-170805,170805,0,0,1,384,1.25,0.8137577,5
2020-08-09-170805,170805,1,0,0,385,1.5,0.5808116,6
2020-08-10-170805,170805,2,0,2,387,1.5,1.1921844,0
2020-08-11-170805,170805,4,0,1,391,1.5,1.8640434,1
2020-08-12-170805,170805,5,0,4,396,1.5,2.241737,2
2020-08-13-170805,170805,2,0,2,398,0.5,1.1217471,3
2020-08-14-170805,170805,4,0,6,402,2.25,2.3807912,4
2020-08-15-170805,170805,1,0,3,403,0.5,0.6674293,5
2020-08-16-170805,170805,1,0,2,404,0.5,0.2325938,6
2020-08-17-170805,170805,0,0,1,404,0.25,0.40685344,0
2020-08-18-170805,170805,0,0,12,404,1.75,1.2956152,1
2020-08-19-170805,170805,0,0,4,404,1.0,0.7915824,2
2020-08-20-170805,170805,1,0,11,405,0.5,0.7373397,3
2020-08-21-170805,170805,1,0,8,406,0.0,0.54547834,4
2020-08-22-170805,170805,1,0,2,407,1.0,1.0680372,5
2020-08-23-170805,170805,0,0,4,407,0.0,0.10972752,6
2020-08-24-170805,170805,2,0,3,409,1.0,0.91009843,0
2020-08-25-170805,170805,1,0,3,410,1.5,0.65101093,1
2020-08-26-170805,170805,4,0,1,414,1.75,1.441462,2
2020-08-27-170805,170805,2,0,3,416,1.25,2.2403867,3
2020-08-28-170805,170805,6,0,5,422,0.25,1.3511225,4
2020-08-29-170805,170805,3,0,1,425,0.25,0.97408974,5
2020-08-30-170805,170805,2,0,4,427,0.25,0.6513723,6
2020-08-31-170805,170805,1,0,2,428,0.5,0.49738076,0
2020-09-01-170805,170805,12,0,7,440,1.5,4.0921574,1
2020-09-02-170805,170805,4,0,7,444,0.75,1.5556165,2
2020-09-03-170805,170805,11,0,2,455,0.75,3.096933,3
2020-09-04-170805,170805,8,0,8,463,0.75,2.645848,4
2020-09-05-170805,170805,2,0,2,465,0.25,1.0982544,5
2020-09-06-170805,170805,4,0,6,469,0.25,0.9015882,6
2020-09-07-170805,170805,3,0,5,472,1.25,1.0384123,0
2020-09-08-170805,170805,3,0,10,475,1.25,1.1379892,1
2020-09-09-170805,170805,1,0,9,476,0.75,1.0480411,2
2020-09-10-170805,170805,3,0,3,479,1.0,1.0922372,3
2020-09-11-170805,170805,5,0,1,484,1.0,1.6184655,4
2020-09-12-170805,170805,1,0,6,485,1.5,0.730153,5
2020-09-13-170805,170805,4,0,2,489,0.75,0.8462739,6
2020-09-14-170805,170805,2,0,5,491,1.25,0.8742876,0
2020-09-15-170805,170805,7,0,0,498,0.25,0.94511545,1
2020-09-16-170805,170805,7,0,2,505,0.75,1.9675028,2
2020-09-17-170805,170805,2,0,1,507,0.75,0.65328825,3
2020-09-18-170805,170805,8,0,1,515,1.5,1.834177,4
2020-09-19-170805,170805,2,0,0,517,0.5,0.45000616,5
2020-09-20-170805,170805,6,0,2,523,1.75,1.488946,6
2020-09-21-170805,170805,5,0,1,528,1.0,0.8427501,0
2020-09-22-170805,170805,10,0,0,538,0.75,0.8319738,1
2020-09-23-170805,170805,9,0,3,547,1.25,2.3821754,2
2020-09-24-170805,170805,3,1,4,550,1.25,1.1057099,3
2020-09-25-170805,170805,1,1,2,551,1.0,2.1128905,4
2020-09-26-170805,170805,6,0,0,557,2.25,1.9971989,5
2020-09-27-170805,170805,2,0,0,559,0.0,0.43136594,6
2020-09-28-170805,170805,5,0,0,564,1.25,1.7647829,0
2020-09-29-170805,170805,0,0,4,564,0.25,0.07007266,1
2020-09-30-170805,170805,2,0,3,566,1.0,0.7645153,2
2020-10-01-170805,170805,1,0,0,567,0.25,0.20514508,3
2020-10-02-170805,170805,1,0,5,568,0.25,0.18105653,4
2020-10-03-170805,170805,0,1,1,568,0.0,0.07774455,5
2020-10-04-170805,170805,2,0,10,570,0.25,0.44756627,6
2020-10-05-170805,170805,1,0,1,571,0.75,0.6082379,0
2020-10-06-170805,170805,0,1,2,571,0.75,0.59916544,1
2020-10-07-170805,170805,3,0,0,574,0.75,1.0778302,2
2020-10-08-170805,170805,4,0,2,578,2.25,1.582656,3
2020-10-09-170805,170805,2,1,8,580,2.0,1.4589478,4
2020-10-10-170805,170805,0,0,10,580,1.25,0.59504884,5
2020-10-11-170805,170805,0,0,2,580,1.5,0.7349131,6
2020-10-12-170805,170805,0,0,5,580,0.75,0.4461665,0
2020-10-13-170805,170805,4,0,2,584,1.5,1.9398881,1
2020-10-14-170805,170805,3,0,2,587,0.5,1.1126243,2
2020-10-15-170805,170805,0,0,1,587,1.5,1.2905865,3
2020-10-16-170805,170805,5,0,2,592,5.5,3.033497,4
2020-10-17-170805,170805,1,0,0,593,9.25,4.710631,5
2020-10-18-170805,170805,10,0,1,603,1.25,4.0733795,6
2020-10-19-170805,170805,1,0,0,604,0.25,0.43104586,0
2020-10-20-170805,170805,2,0,6,606,0.75,0.8297463,1
2020-10-21-170805,170805,0,0,3,606,3.0,1.3376933,2
2020-10-22-170805,170805,2,1,6,608,2.0,1.3933133,3
2020-10-23-170805,170805,8,0,3,616,4.25,1.7479975,4
2020-10-24-170805,170805,10,0,3,626,1.75,3.0625765,5
2020-10-25-170805,170805,2,0,1,628,1.5,0.92198765,6
2020-10-26-170805,170805,5,0,3,633,2.5,2.6517515,0
2020-10-27-170805,170805,2,1,1,635,1.25,0.88941854,1
2020-10-28-170805,170805,2,1,3,637,3.5,2.1635332,2
2020-10-29-170805,170805,1,0,0,638,1.0,0.7879238,3
2020-10-30-170805,170805,2,0,1,640,3.75,2.5085008,4
2020-10-31-170805,170805,0,1,0,640,2.5,1.2456222,5
2020-11-01-170805,170805,1,1,0,641,0.75,0.57533175,6
2020-11-02-170805,170805,0,0,0,641,3.75,1.1749061,0
2020-11-03-170805,170805,6,0,0,647,2.0,2.1815712,1
2020-11-04-170805,170805,3,0,0,650,3.5,1.764786,2
2020-11-05-170805,170805,6,0,0,656,2.0,2.2068093,3
2020-11-06-170805,170805,3,1,0,659,4.75,1.792056,4
2020-11-07-170805,170805,3,0,0,662,4.0,1.3776349,5
2020-11-08-170805,170805,1,1,0,663,7.25,1.7415947,6
2020-11-09-170805,170805,3,0,0,666,2.5,1.9952567,0
2020-11-10-170805,170805,1,0,0,667,2.75,0.8455438,1
2020-11-11-170805,170805,3,0,0,670,3.0,2.226361,2
2020-11-12-170805,170805,0,0,0,670,2.75,1.0184991,3
2020-11-13-170805,170805,1,2,0,671,1.5,1.600124,4
2020-03-01-170806,170806,0,0,6,0,0.0,5.166676e-08,6
2020-03-02-170806,170806,0,0,2,0,0.0,0.0016760859,0
2020-03-03-170806,170806,0,1,3,0,0.16666666666666666,0.00028197796,1
2020-03-04-170806,170806,0,0,10,0,0.0,0.00015979355,2
2020-03-05-170806,170806,0,0,8,0,0.0,0.05771771,3
2020-03-06-170806,170806,0,0,7,0,0.0,0.00063710933,4
2020-03-07-170806,170806,0,0,6,0,0.0,0.07049639,5
2020-03-08-170806,170806,0,0,9,0,0.0,0.00048735886,6
2020-03-09-170806,170806,0,0,9,0,0.16666666666666666,0.2284131,0
2020-03-10-170806,170806,0,0,7,0,0.0,0.0037082692,1
2020-03-11-170806,170806,0,0,3,0,0.16666666666666666,0.17003508,2
2020-03-12-170806,170806,0,0,2,0,0.5,0.24221212,3
2020-03-13-170806,170806,0,0,4,0,0.0,0.017736796,4
2020-03-14-170806,170806,0,0,2,0,1.0,0.051413,5
2020-03-15-170806,170806,6,0,3,6,0.6666666666666666,0.41917878,6
2020-03-16-170806,170806,2,0,1,8,2.5,0.813743,0
2020-03-17-170806,170806,3,0,2,11,2.333333333333333,0.76000935,1
2020-03-18-170806,170806,10,0,2,21,2.5,1.1831553,2
2020-03-19-170806,170806,8,1,4,29,3.5,1.2197733,3
2020-03-20-170806,170806,7,0,2,36,2.6666666666666665,1.1081653,4
2020-03-21-170806,170806,6,0,1,42,1.8333333333333333,0.597454,5
2020-03-22-170806,170806,9,0,1,51,0.6666666666666666,0.4813864,6
2020-03-23-170806,170806,9,0,2,60,7.333333333333332,1.7748638,0
2020-03-24-170806,170806,7,0,2,67,4.666666666666667,1.5715181,1
2020-03-25-170806,170806,3,0,2,70,6.666666666666668,1.4311597,2
2020-03-26-170806,170806,2,0,1,72,3.333333333333333,0.91536385,3
2020-03-27-170806,170806,4,0,4,76,4.333333333333333,1.1146647,4
2020-03-28-170806,170806,2,0,2,78,1.3333333333333333,0.2430037,5
2020-03-29-170806,170806,3,0,5,81,1.3333333333333333,0.19924016,6
2020-03-30-170806,170806,1,0,2,82,5.0,1.1779145,0
2020-03-31-170806,170806,2,0,2,84,4.833333333333333,1.0171896,1
2020-04-01-170806,170806,2,0,0,86,4.833333333333333,1.1114091,2
2020-04-02-170806,170806,4,0,1,90,2.333333333333333,0.75529337,3
2020-04-03-170806,170806,2,0,0,92,3.8333333333333335,1.0354749,4
2020-04-04-170806,170806,1,0,0,93,2.333333333333333,0.30241776,5
2020-04-05-170806,170806,1,0,0,94,1.6666666666666667,0.30493417,6
2020-04-06-170806,170806,2,0,1,96,2.6666666666666665,0.8773426,0
2020-04-07-170806,170806,2,0,1,98,2.833333333333333,1.0569297,1
2020-04-08-170806,170806,2,0,0,100,3.1666666666666665,1.1085498,2
2020-04-09-170806,170806,1,0,1,101,0.8333333333333334,0.35495192,3
2020-04-10-170806,170806,4,0,3,105,3.5,0.56332666,4
2020-04-11-170806,170806,2,1,0,107,0.6666666666666666,0.24685563,5
2020-04-12-170806,170806,5,0,1,112,1.5,0.31908545,6
2020-04-13-170806,170806,2,0,0,114,1.6666666666666667,1.1197821,0
2020-04-14-170806,170806,2,0,3,116,2.0,1.3581042,1
2020-04-15-170806,170806,0,0,1,116,0.8333333333333334,0.32408637,2
2020-04-16-170806,170806,1,0,2,117,0.8333333333333334,1.2244558,3
2020-04-17-170806,170806,0,0,4,117,4.333333333333333,0.59791535,4
2020-04-18-170806,170806,0,0,0,117,0.5,0.59782845,5
2020-04-19-170806,170806,0,0,1,117,0.6666666666666666,0.12009515,6
2020-04-20-170806,170806,1,0,2,118,1.6666666666666667,2.7595901,0
2020-04-21-170806,170806,1,0,0,119,1.1666666666666667,0.33895686,1
2020-04-22-170806,170806,0,0,0,119,0.3333333333333333,0.30481473,2
2020-04-23-170806,170806,1,0,2,120,0.5,0.08868499,3
2020-04-24-170806,170806,3,0,0,123,1.5,0.5370491,4
2020-04-25-170806,170806,0,0,0,123,0.5,0.14311874,5
2020-04-26-170806,170806,1,0,0,124,0.5,0.07524724,6
2020-04-27-170806,170806,0,2,1,124,1.5,0.50593525,0
2020-04-28-170806,170806,3,0,0,127,0.6666666666666666,0.47461677,1
2020-04-29-170806,170806,1,0,1,128,1.3333333333333333,0.31743005,2
2020-04-30-170806,170806,2,0,1,130,0.3333333333333333,0.2524381,3
2020-05-01-170806,170806,4,0,0,134,0.3333333333333333,0.21835002,4
2020-05-02-170806,170806,0,0,0,134,0.5,0.10170536,5
2020-05-03-170806,170806,1,0,0,135,1.0,0.16032678,6
2020-05-04-170806,170806,2,0,1,137,2.0,0.6571334,0
2020-05-05-170806,170806,0,0,1,137,0.5,0.6519938,1
2020-05-06-170806,170806,0,0,2,137,4.666666666666667,1.6873695,2
2020-05-07-170806,170806,2,0,0,139,0.8333333333333334,0.58004886,3
2020-05-08-170806,170806,0,0,0,139,0.3333333333333333,0.27102375,4
2020-05-09-170806,170806,0,0,0,139,0.16666666666666666,0.008009404,5
2020-05-10-170806,170806,0,0,0,139,0.16666666666666666,0.01598216,6
2020-05-11-170806,170806,1,1,0,140,0.6666666666666666,0.5496369,0
2020-05-12-170806,170806,0,0,0,140,0.6666666666666666,0.3472355,1
2020-05-13-170806,170806,1,1,0,141,1.1666666666666667,0.83413035,2
2020-05-14-170806,170806,1,0,0,142,1.1666666666666667,0.63668233,3
2020-05-15-170806,170806,0,0,0,142,0.6666666666666666,0.3821359,4
2020-05-16-170806,170806,0,0,0,142,0.3333333333333333,0.10632212,5
2020-05-17-170806,170806,0,0,1,142,0.0,0.0010148304,6
2020-05-18-170806,170806,1,0,1,143,1.5,0.5402696,0
2020-05-19-170806,170806,1,0,2,144,1.5,0.7390292,1
2020-05-20-170806,170806,2,0,1,146,1.6666666666666667,0.5581322,2
2020-05-21-170806,170806,0,0,0,146,0.6666666666666666,0.18276268,3
2020-05-22-170806,170806,0,0,0,146,0.6666666666666666,0.10451639,4
2020-05-23-170806,170806,0,0,0,146,0.6666666666666666,0.052405298,5
2020-05-24-170806,170806,0,0,0,146,0.16666666666666666,0.146831,6
2020-05-25-170806,170806,0,0,0,146,0.8333333333333334,0.4316626,0
2020-05-26-170806,170806,0,0,0,146,1.0,0.5201169,1
2020-05-27-170806,170806,0,4,0,146,1.0,0.2801626,2
2020-05-28-170806,170806,0,0,1,146,1.0,0.5611957,3
2020-05-29-170806,170806,0,2,0,146,0.5,0.36758694,4
2020-05-30-170806,170806,0,0,0,146,0.3333333333333333,0.26969132,5
2020-05-31-170806,170806,1,0,1,147,0.0,0.078129,6
2020-06-01-170806,170806,1,0,0,148,0.6666666666666666,0.2796662,0
2020-06-02-170806,170806,2,0,0,150,0.6666666666666666,0.7193933,1
2020-06-03-170806,170806,1,0,0,151,0.5,0.3616332,2
2020-06-04-170806,170806,0,0,0,151,0.16666666666666666,0.08660033,3
2020-06-05-170806,170806,0,1,2,151,0.3333333333333333,0.24722467,4
2020-06-06-170806,170806,0,0,0,151,0.0,0.06762484,5
2020-06-07-170806,170806,0,0,0,151,0.3333333333333333,0.12387808,6
2020-06-08-170806,170806,0,0,1,151,0.16666666666666666,0.20509821,0
2020-06-09-170806,170806,0,0,1,151,1.1666666666666667,0.49072582,1
2020-06-10-170806,170806,0,0,0,151,0.3333333333333333,0.3964705,2
2020-06-11-170806,170806,1,0,0,152,0.5,0.22866958,3
2020-06-12-170806,170806,0,0,0,152,0.5,0.2511245,4
2020-06-13-170806,170806,0,0,0,152,0.0,0.064614296,5
2020-06-14-170806,170806,1,0,0,153,0.0,0.1528507,6
2020-06-15-170806,170806,0,0,0,153,0.0,0.006156056,0
2020-06-16-170806,170806,0,0,0,153,0.3333333333333333,0.32241356,1
2020-06-17-170806,170806,0,0,0,153,0.0,0.4503055,2
2020-06-18-170806,170806,0,1,3,153,0.16666666666666666,0.14984615,3
2020-06-19-170806,170806,2,0,2,155,0.16666666666666666,0.39407012,4
2020-06-20-170806,170806,0,0,0,155,0.16666666666666666,0.053664375,5
2020-06-21-170806,170806,0,0,0,155,0.16666666666666666,0.06925784,6
2020-06-22-170806,170806,1,0,0,156,0.16666666666666666,0.21856779,0
2020-06-23-170806,170806,1,0,0,157,0.3333333333333333,0.2273522,1
2020-06-24-170806,170806,0,0,0,157,0.3333333333333333,0.114371575,2
2020-06-25-170806,170806,0,0,0,157,0.5,0.25598425,3
2020-06-26-170806,170806,0,0,0,157,0.0,0.11688491,4
2020-06-27-170806,170806,0,0,0,157,0.0,0.114701435,5
2020-06-28-170806,170806,0,0,0,157,0.0,0.18436188,6
2020-06-29-170806,170806,0,0,0,157,0.3333333333333333,0.05319301,0
2020-06-30-170806,170806,0,0,0,157,0.3333333333333333,0.105825394,1
2020-07-01-170806,170806,0,0,0,157,0.5,0.18359157,2
2020-07-02-170806,170806,3,0,0,160,0.0,0.24422942,3
2020-07-03-170806,170806,2,0,0,162,0.5,0.30690718,4
2020-07-04-170806,170806,0,0,0,162,0.16666666666666666,0.022926018,5
2020-07-05-170806,170806,0,0,0,162,0.0,1.8510706e-05,6
2020-07-06-170806,170806,0,0,0,162,0.3333333333333333,0.14630881,0
2020-07-07-170806,170806,0,0,1,162,0.3333333333333333,0.23947026,1
2020-07-08-170806,170806,0,0,0,162,0.3333333333333333,0.26261404,2
2020-07-09-170806,170806,0,0,3,162,0.0,0.00974277,3
2020-07-10-170806,170806,0,0,0,162,0.16666666666666666,0.04527288,4
2020-07-11-170806,170806,0,0,2,162,0.0,2.0305672e-06,5
2020-07-12-170806,170806,0,0,1,162,0.0,0.008667491,6
2020-07-13-170806,170806,0,0,0,162,1.3333333333333333,0.48472545,0
2020-07-14-170806,170806,0,0,0,162,0.5,0.18202373,1
2020-07-15-170806,170806,0,0,1,162,1.0,0.3059179,2
2020-07-16-170806,170806,0,0,1,162,0.5,0.4458097,3
2020-07-17-170806,170806,0,0,3,162,0.3333333333333333,0.024458518,4
2020-07-18-170806,170806,0,0,2,162,0.16666666666666666,0.073240146,5
2020-07-19-170806,170806,0,0,0,162,0.3333333333333333,0.058711067,6
2020-07-20-170806,170806,0,0,0,162,0.8333333333333334,0.3228936,0
2020-07-21-170806,170806,1,0,1,163,0.5,0.38433284,1
2020-07-22-170806,170806,0,0,0,163,0.16666666666666666,0.121465586,2
2020-07-23-170806,170806,3,0,0,166,0.3333333333333333,0.45823866,3
2020-07-24-170806,170806,0,0,0,166,1.0,0.48837128,4
2020-07-25-170806,170806,2,0,0,168,0.5,0.38739547,5
2020-07-26-170806,170806,1,0,0,169,0.0,0.21943182,6
2020-07-27-170806,170806,0,0,0,169,0.0,0.012615135,0
2020-07-28-170806,170806,0,0,0,169,0.16666666666666666,0.059470747,1
2020-07-29-170806,170806,1,0,0,170,0.3333333333333333,0.46582595,2
2020-07-30-170806,170806,1,0,0,171,1.1666666666666667,0.56404287,3
2020-07-31-170806,170806,3,0,0,174,0.5,0.5910203,4
2020-08-01-170806,170806,2,0,1,176,0.5,0.62807155,5
2020-08-02-170806,170806,0,0,0,176,0.16666666666666666,0.08638527,6
2020-08-03-170806,170806,0,0,0,176,1.3333333333333333,0.29356727,0
2020-08-04-170806,170806,1,0,0,177,1.1666666666666667,0.9464806,1
2020-08-05-170806,170806,0,0,1,177,2.0,1.5848652,2
2020-08-06-170806,170806,0,2,1,177,3.0,1.5172249,3
2020-08-07-170806,170806,0,0,0,177,2.333333333333333,0.62253577,4
2020-08-08-170806,170806,0,0,0,177,1.6666666666666667,0.55140185,5
2020-08-09-170806,170806,0,0,0,177,3.6666666666666665,0.5514754,6
2020-08-10-170806,170806,0,0,0,177,5.666666666666668,0.90633863,0
2020-08-11-170806,170806,0,0,1,177,4.166666666666667,1.2139953,1
2020-08-12-170806,170806,0,0,1,177,3.5,1.1666691,2
2020-08-13-170806,170806,0,0,0,177,3.6666666666666665,0.9637906,3
2020-08-14-170806,170806,0,0,0,177,5.333333333333333,1.5149866,4
2020-08-15-170806,170806,1,0,1,178,1.8333333333333333,0.5384882,5
2020-08-16-170806,170806,0,0,0,178,0.6666666666666666,0.3015119,6
2020-08-17-170806,170806,0,0,1,178,5.833333333333332,0.99519026,0
2020-08-18-170806,170806,0,0,0,178,2.0,0.92658764,1
2020-08-19-170806,170806,1,0,0,179,2.0,0.6450439,2
2020-08-20-170806,170806,1,0,0,180,1.8333333333333333,0.7297227,3
2020-08-21-170806,170806,0,0,0,180,1.5,0.4129847,4
2020-08-22-170806,170806,0,0,0,180,1.1666666666666667,0.69652575,5
2020-08-23-170806,170806,0,0,0,180,1.3333333333333333,0.17431319,6
2020-08-24-170806,170806,0,0,0,180,1.5,0.49382067,0
2020-08-25-170806,170806,1,0,0,181,2.833333333333333,0.980865,1
2020-08-26-170806,170806,1,0,0,182,2.1666666666666665,1.018751,2
2020-08-27-170806,170806,0,0,0,182,3.333333333333333,1.1595157,3
2020-08-28-170806,170806,0,0,1,182,2.333333333333333,0.54734427,4
2020-08-29-170806,170806,1,0,1,183,2.6666666666666665,0.6621245,5
2020-08-30-170806,170806,0,0,0,183,2.833333333333333,0.45797402,6
2020-08-31-170806,170806,1,0,0,184,0.5,0.28557774,0
2020-09-01-170806,170806,0,0,0,184,2.833333333333333,1.6562356,1
2020-09-02-170806,170806,0,0,0,184,1.5,0.6731703,2
2020-09-03-170806,170806,0,0,0,184,3.1666666666666665,1.3852042,3
2020-09-04-170806,170806,0,0,0,184,3.1666666666666665,1.1484345,4
2020-09-05-170806,170806,0,0,1,184,0.6666666666666666,0.39015114,5
2020-09-06-170806,170806,0,0,0,184,1.1666666666666667,0.40549734,6
2020-09-07-170806,170806,0,0,0,184,1.6666666666666667,0.47872287,0
2020-09-08-170806,170806,0,0,1,184,3.333333333333333,0.5465423,1
2020-09-09-170806,170806,0,0,0,184,1.5,0.48623484,2
2020-09-10-170806,170806,0,0,0,184,4.833333333333333,0.8754591,3
2020-09-11-170806,170806,1,0,2,185,5.166666666666667,0.8513795,4
2020-09-12-170806,170806,1,0,1,186,1.0,0.5390398,5
2020-09-13-170806,170806,0,0,0,186,3.1666666666666665,0.5213049,6
2020-09-14-170806,170806,0,0,3,186,1.8333333333333333,0.50056815,0
2020-09-15-170806,170806,0,0,0,186,4.333333333333333,0.6193451,1
2020-09-16-170806,170806,0,0,1,186,3.1666666666666665,0.83973086,2
2020-09-17-170806,170806,0,0,0,186,2.833333333333333,0.5460247,3
2020-09-18-170806,170806,0,0,1,186,4.166666666666667,0.9509927,4
2020-09-19-170806,170806,1,0,0,187,1.8333333333333333,0.18438794,5
2020-09-20-170806,170806,0,0,1,187,3.5,0.6320378,6
2020-09-21-170806,170806,0,0,1,187,3.1666666666666665,0.35774976,0
2020-09-22-170806,170806,1,0,1,188,2.6666666666666665,0.44532326,1
2020-09-23-170806,170806,0,0,1,188,3.0,1.0668826,2
2020-09-24-170806,170806,0,1,8,188,1.8333333333333333,0.5513652,3
2020-09-25-170806,170806,2,0,5,190,3.1666666666666665,1.0377344,4
2020-09-26-170806,170806,1,0,2,191,2.1666666666666665,0.87280875,5
2020-09-27-170806,170806,0,0,3,191,0.6666666666666666,0.13258731,6
2020-09-28-170806,170806,3,0,0,194,2.0,1.0396867,0
2020-09-29-170806,170806,0,0,0,194,0.5,0.10467725,1
2020-09-30-170806,170806,1,0,0,195,1.8333333333333333,0.4787056,2
2020-10-01-170806,170806,0,0,0,195,2.333333333333333,0.24587855,3
2020-10-02-170806,170806,1,0,2,196,3.8333333333333335,0.42032042,4
2020-10-03-170806,170806,0,0,0,196,2.1666666666666665,0.21594751,5
2020-10-04-170806,170806,1,0,4,197,2.833333333333333,0.39531642,6
2020-10-05-170806,170806,1,0,0,198,1.3333333333333333,0.42486063,0
2020-10-06-170806,170806,1,0,0,199,1.3333333333333333,0.40734807,1
2020-10-07-170806,170806,1,0,2,200,1.5,0.6326541,2
2020-10-08-170806,170806,8,0,0,208,4.333333333333333,1.3864987,3
2020-10-09-170806,170806,5,0,6,213,1.6666666666666667,1.1954565,4
2020-10-10-170806,170806,2,0,1,215,1.1666666666666667,0.6483905,5
2020-10-11-170806,170806,3,0,0,218,2.1666666666666665,0.7011103,6
2020-10-12-170806,170806,0,0,0,218,2.0,0.44803613,0
2020-10-13-170806,170806,0,0,0,218,3.8333333333333335,1.0526092,1
2020-10-14-170806,170806,0,0,2,218,1.8333333333333333,0.54496354,2
2020-10-15-170806,170806,0,0,0,218,1.6666666666666667,0.7528952,3
2020-10-16-170806,170806,2,0,6,220,4.0,1.9628127,4
2020-10-17-170806,170806,0,0,1,220,1.0,2.1803534,5
2020-10-18-170806,170806,4,0,0,224,3.333333333333333,1.8194829,6
2020-10-19-170806,170806,0,0,10,224,2.333333333333333,0.36623782,0
2020-10-20-170806,170806,0,0,2,224,1.3333333333333333,0.5069736,1
2020-10-21-170806,170806,2,0,8,226,2.1666666666666665,1.1650376,2
2020-10-22-170806,170806,0,0,0,226,2.5,0.9304561,3
2020-10-23-170806,170806,6,0,2,232,3.5,1.3401896,4
2020-10-24-170806,170806,1,0,9,233,2.0,1.1719902,5
2020-10-25-170806,170806,0,1,4,233,1.6666666666666667,0.60615164,6
2020-10-26-170806,170806,0,0,6,233,3.8333333333333335,1.3668444,0
2020-10-27-170806,170806,0,0,0,233,3.333333333333333,0.48488337,1
2020-10-28-170806,170806,2,0,1,235,3.1666666666666665,1.1735736,2
2020-10-29-170806,170806,0,0,2,235,3.333333333333333,0.77230203,3
2020-10-30-170806,170806,6,0,1,241,3.6666666666666665,2.1625893,4
2020-10-31-170806,170806,1,0,0,242,2.0,1.407302,5
2020-11-01-170806,170806,0,1,0,242,2.333333333333333,0.51953644,6
2020-11-02-170806,170806,10,0,0,252,3.0,1.1429497,0
2020-11-03-170806,170806,2,0,0,254,5.0,1.3322251,1
2020-11-04-170806,170806,8,0,0,262,1.8333333333333333,1.5976346,2
2020-11-05-170806,170806,0,0,0,262,3.5,1.1593603,3
2020-11-06-170806,170806,2,0,0,264,5.166666666666667,1.3389292,4
2020-11-07-170806,170806,9,0,0,273,2.0,1.1408243,5
2020-11-08-170806,170806,4,1,0,277,2.833333333333333,1.0724586,6
2020-11-09-170806,170806,6,0,0,283,2.5,1.3327359,0
2020-11-10-170806,170806,0,0,0,283,2.833333333333333,0.9074858,1
2020-11-11-170806,170806,1,0,0,284,3.5,1.343351,2
2020-11-12-170806,170806,2,0,0,286,3.5,1.0208788,3
2020-11-13-170806,170806,1,0,0,287,1.6666666666666667,0.8365212,4
2020-03-01-170807,170807,0,0,0,0,0.0,9.489457e-09,6
2020-03-02-170807,170807,0,0,2,0,0.0,7.020253e-05,0
2020-03-03-170807,170807,0,3,0,0,0.0,1.528294e-08,1
2020-03-04-170807,170807,0,0,2,0,0.0,1.9653093e-05,2
2020-03-05-170807,170807,0,0,0,0,0.25,0.025526939,3
2020-03-06-170807,170807,0,0,1,0,0.0,1.3402742e-07,4
2020-03-07-170807,170807,0,0,0,0,0.25,0.025233965,5
2020-03-08-170807,170807,0,0,0,0,0.0,2.961008e-09,6
2020-03-09-170807,170807,0,0,2,0,0.75,0.096068665,0
2020-03-10-170807,170807,0,0,0,0,0.0,0.00018040446,1
2020-03-11-170807,170807,0,0,0,0,0.75,0.111830264,2
2020-03-12-170807,170807,0,0,3,0,0.75,0.1670926,3
2020-03-13-170807,170807,0,0,3,0,0.25,0.070372365,4
2020-03-14-170807,170807,0,0,1,0,1.0,0.108948976,5
2020-03-15-170807,170807,0,0,0,0,0.5,0.058370233,6
2020-03-16-170807,170807,2,0,2,2,3.25,0.6062406,0
2020-03-17-170807,170807,0,0,3,2,4.5,0.3684515,1
2020-03-18-170807,170807,2,1,3,4,3.5,0.5683881,2
2020-03-19-170807,170807,0,0,2,4,3.75,0.39570126,3
2020-03-20-170807,170807,1,0,0,5,5.5,0.68929094,4
2020-03-21-170807,170807,0,1,2,5,2.0,0.16593271,5
2020-03-22-170807,170807,0,0,0,5,2.25,0.21671587,6
2020-03-23-170807,170807,2,0,2,7,9.0,1.1308125,0
2020-03-24-170807,170807,0,0,2,7,8.0,0.9901583,1
2020-03-25-170807,170807,0,0,1,7,6.0,0.59868735,2
2020-03-26-170807,170807,3,0,1,10,6.0,1.0804209,3
2020-03-27-170807,170807,3,0,0,13,6.5,1.0107334,4
2020-03-28-170807,170807,1,0,0,14,1.75,0.19122757,5
2020-03-29-170807,170807,0,0,0,14,2.0,0.14367265,6
2020-03-30-170807,170807,2,1,0,16,8.0,0.99405974,0
2020-03-31-170807,170807,3,0,5,19,4.0,0.5563837,1
2020-04-01-170807,170807,3,0,0,22,11.0,1.2451291,2
2020-04-02-170807,170807,2,0,2,24,5.75,0.7620653,3
2020-04-03-170807,170807,0,0,0,24,3.0,0.41021964,4
2020-04-04-170807,170807,2,0,0,26,1.0,0.29380688,5
2020-04-05-170807,170807,0,0,0,26,1.75,0.15633781,6
2020-04-06-170807,170807,2,2,1,28,5.0,0.6867229,0
2020-04-07-170807,170807,2,0,0,30,3.5,0.43269312,1
2020-04-08-170807,170807,1,0,2,31,3.75,0.44115254,2
2020-04-09-170807,170807,1,0,2,32,5.25,0.4075783,3
2020-04-10-170807,170807,0,1,7,32,7.0,0.6854555,4
2020-04-11-170807,170807,0,0,1,32,3.0,0.122998044,5
2020-04-12-170807,170807,0,0,2,32,0.5,0.02164489,6
2020-04-13-170807,170807,0,0,0,32,4.5,0.44092083,0
2020-04-14-170807,170807,5,0,0,37,6.75,1.0854509,1
2020-04-15-170807,170807,0,0,0,37,5.25,0.6442947,2
2020-04-16-170807,170807,2,1,0,39,14.0,1.8129404,3
2020-04-17-170807,170807,0,0,0,39,2.0,0.21584153,4
2020-04-18-170807,170807,0,0,1,39,3.25,0.27050474,5
2020-04-19-170807,170807,0,0,0,39,0.5,0.02734083,6
2020-04-20-170807,170807,1,0,0,40,11.25,1.4893041,0
2020-04-21-170807,170807,0,0,0,40,0.75,0.09839538,1
2020-04-22-170807,170807,2,0,1,42,3.5,0.468392,2
2020-04-23-170807,170807,2,0,1,44,0.0,0.19802257,3
2020-04-24-170807,170807,7,0,2,51,2.75,0.9284378,4
2020-04-25-170807,170807,1,0,1,52,1.0,0.15013352,5
2020-04-26-170807,170807,2,0,0,54,0.5,0.16242675,6
2020-04-27-170807,170807,0,0,0,54,2.5,0.17179202,0
2020-04-28-170807,170807,0,1,0,54,1.0,0.09191743,1
2020-04-29-170807,170807,0,0,0,54,1.0,0.12803023,2
2020-04-30-170807,170807,0,0,1,54,1.5,0.1736604,3
2020-05-01-170807,170807,0,0,0,54,0.75,0.086378396,4
2020-05-02-170807,170807,1,0,0,55,2.75,0.44312605,5
2020-05-03-170807,170807,0,0,0,55,1.0,0.1535322,6
2020-05-04-170807,170807,0,0,0,55,3.5,0.40554017,0
2020-05-05-170807,170807,0,0,0,55,4.5,0.6226573,1
2020-05-06-170807,170807,1,0,0,56,3.75,0.58481264,2
2020-05-07-170807,170807,1,0,0,57,1.5,0.3403995,3
2020-05-08-170807,170807,2,0,1,59,2.25,0.36502478,4
2020-05-09-170807,170807,1,0,0,60,0.5,0.16134253,5
2020-05-10-170807,170807,0,0,0,60,0.75,0.039731734,6
2020-05-11-170807,170807,0,0,0,60,2.75,0.35613453,0
2020-05-12-170807,170807,0,0,0,60,2.25,0.14756905,1
2020-05-13-170807,170807,0,0,0,60,3.25,0.36660382,2
2020-05-14-170807,170807,1,0,0,61,1.5,0.24701215,3
2020-05-15-170807,170807,0,1,0,61,2.75,0.20240897,4
2020-05-16-170807,170807,0,0,0,61,1.0,0.09678722,5
2020-05-17-170807,170807,0,0,0,61,0.25,0.0040403646,6
2020-05-18-170807,170807,0,0,0,61,1.25,0.18148848,0
2020-05-19-170807,170807,0,0,0,61,1.5,0.18916427,1
2020-05-20-170807,170807,0,0,0,61,0.75,0.10365677,2
2020-05-21-170807,170807,0,0,1,61,1.25,0.10209177,3
2020-05-22-170807,170807,1,0,0,62,0.75,0.23361628,4
2020-05-23-170807,170807,0,0,0,62,0.5,0.07092637,5
2020-05-24-170807,170807,0,0,0,62,1.0,0.060867224,6
2020-05-25-170807,170807,0,0,0,62,2.0,0.26660603,0
2020-05-26-170807,170807,0,0,1,62,3.0,0.4051399,1
2020-05-27-170807,170807,0,4,0,62,0.5,0.06647003,2
2020-05-28-170807,170807,0,0,1,62,2.25,0.40431464,3
2020-05-29-170807,170807,0,0,0,62,1.0,0.16560343,4
2020-05-30-170807,170807,0,0,0,62,0.75,0.080235906,5
2020-05-31-170807,170807,0,0,0,62,0.0,0.0036632074,6
2020-06-01-170807,170807,0,0,0,62,0.5,0.05792124,0
2020-06-02-170807,170807,0,0,0,62,1.0,0.14035375,1
2020-06-03-170807,170807,0,0,0,62,0.5,0.08996001,2
2020-06-04-170807,170807,1,0,0,63,0.5,0.20583086,3
2020-06-05-170807,170807,0,0,0,63,0.25,0.061770387,4
2020-06-06-170807,170807,0,0,0,63,0.5,0.0346743,5
2020-06-07-170807,170807,0,0,0,63,1.0,0.065822706,6
2020-06-08-170807,170807,0,0,0,63,0.75,0.05808197,0
2020-06-09-170807,170807,1,0,0,64,1.25,0.28254685,1
2020-06-10-170807,170807,0,0,0,64,1.25,0.17453909,2
2020-06-11-170807,170807,1,0,0,65,0.5,0.1470817,3
2020-06-12-170807,170807,0,0,0,65,2.0,0.27704456,4
2020-06-13-170807,170807,0,0,0,65,1.25,0.046548013,5
2020-06-14-170807,170807,0,0,0,65,0.25,0.021084214,6
2020-06-15-170807,170807,0,0,0,65,0.25,0.063017584,0
2020-06-16-170807,170807,0,0,0,65,1.0,0.14098485,1
2020-06-17-170807,170807,0,0,0,65,2.25,0.28652307,2
2020-06-18-170807,170807,0,0,0,65,0.5,0.08209339,3
2020-06-19-170807,170807,0,0,0,65,1.0,0.11227666,4
2020-06-20-170807,170807,0,0,0,65,0.0,0.0007059364,5
2020-06-21-170807,170807,0,0,0,65,0.75,0.11200326,6
2020-06-22-170807,170807,0,0,0,65,0.5,0.08577737,0
2020-06-23-170807,170807,0,0,0,65,0.75,0.10069638,1
2020-06-24-170807,170807,0,0,0,65,0.0,0.0014771617,2
2020-06-25-170807,170807,0,1,0,65,0.5,0.08845063,3
2020-06-26-170807,170807,0,0,0,65,1.0,0.18411204,4
2020-06-27-170807,170807,0,0,0,65,0.25,0.033710476,5
2020-06-28-170807,170807,0,0,0,65,0.5,0.054709334,6
2020-06-29-170807,170807,0,0,0,65,0.0,0.00015807105,0
2020-06-30-170807,170807,0,0,0,65,0.25,0.019372001,1
2020-07-01-170807,170807,0,0,0,65,0.5,0.08836588,2
2020-07-02-170807,170807,0,0,0,65,0.25,0.07362198,3
2020-07-03-170807,170807,0,0,0,65,0.25,0.022154838,4
2020-07-04-170807,170807,0,0,0,65,0.25,0.048879705,5
2020-07-05-170807,170807,0,0,0,65,0.0,4.6738546e-09,6
2020-07-06-170807,170807,0,0,0,65,0.25,0.023842521,0
2020-07-07-170807,170807,0,0,0,65,0.5,0.084536314,1
2020-07-08-170807,170807,0,0,0,65,1.5,0.14527111,2
2020-07-09-170807,170807,0,0,0,65,0.25,0.008976367,3
2020-07-10-170807,170807,0,0,0,65,0.25,0.0012939697,4
2020-07-11-170807,170807,0,0,0,65,0.0,9.632016e-09,5
2020-07-12-170807,170807,0,0,0,65,0.25,0.04253706,6
2020-07-13-170807,170807,0,0,0,65,0.75,0.16105811,0
2020-07-14-170807,170807,0,0,0,65,0.5,0.061528157,1
2020-07-15-170807,170807,0,0,0,65,0.5,0.09102021,2
2020-07-16-170807,170807,0,0,0,65,1.5,0.13917546,3
2020-07-17-170807,170807,0,0,0,65,0.5,0.10042837,4
2020-07-18-170807,170807,0,0,0,65,0.5,0.048097115,5
2020-07-19-170807,170807,0,0,0,65,0.0,0.0013253693,6
2020-07-20-170807,170807,0,0,0,65,1.0,0.10059093,0
2020-07-21-170807,170807,0,0,0,65,0.75,0.09604078,1
2020-07-22-170807,170807,0,0,0,65,0.5,0.11760051,2
2020-07-23-170807,170807,0,0,0,65,1.5,0.28369063,3
2020-07-24-170807,170807,0,0,0,65,0.75,0.12751889,4
2020-07-25-170807,170807,0,0,1,65,0.0,0.03080133,5
2020-07-26-170807,170807,0,0,0,65,1.0,0.2400423,6
2020-07-27-170807,170807,0,0,1,65,1.0,0.044600274,0
2020-07-28-170807,170807,0,0,0,65,0.0,0.00054151687,1
2020-07-29-170807,170807,0,0,0,65,1.75,0.2604537,2
2020-07-30-170807,170807,0,0,1,65,0.75,0.093231976,3
2020-07-31-170807,170807,0,0,0,65,0.75,0.61813015,4
2020-08-01-170807,170807,0,0,0,65,1.25,0.15113294,5
2020-08-02-170807,170807,0,0,0,65,0.25,0.049380507,6
2020-08-03-170807,170807,0,0,0,65,1.0,0.17019899,0
2020-08-04-170807,170807,0,0,2,65,1.5,0.14375608,1
2020-08-05-170807,170807,0,0,5,65,3.75,0.6043262,2
2020-08-06-170807,170807,0,0,0,65,3.5,0.48359403,3
2020-08-07-170807,170807,0,0,0,65,0.75,0.1443333,4
2020-08-08-170807,170807,1,0,1,66,1.75,0.5126368,5
2020-08-09-170807,170807,0,0,0,66,1.0,0.12939326,6
2020-08-10-170807,170807,1,0,0,67,0.5,0.32085487,0
2020-08-11-170807,170807,0,0,0,67,2.5,0.28935197,1
2020-08-12-170807,170807,0,0,0,67,1.25,0.2940333,2
2020-08-13-170807,170807,1,0,0,68,2.25,0.39941335,3
2020-08-14-170807,170807,0,0,0,68,1.5,0.2948946,4
2020-08-15-170807,170807,0,0,0,68,0.75,0.15827875,5
2020-08-16-170807,170807,0,0,0,68,0.5,0.100756966,6
2020-08-17-170807,170807,0,0,0,68,1.0,0.08708041,0
2020-08-18-170807,170807,2,0,1,70,3.0,0.89965266,1
2020-08-19-170807,170807,5,0,1,75,2.25,1.3317646,2
2020-08-20-170807,170807,0,0,0,75,0.25,0.052259587,3
2020-08-21-170807,170807,0,0,0,75,2.25,0.28407302,4
2020-08-22-170807,170807,1,0,0,76,1.0,0.3790519,5
2020-08-23-170807,170807,0,0,0,76,1.25,0.13490754,6
2020-08-24-170807,170807,0,0,0,76,2.0,0.20914048,0
2020-08-25-170807,170807,0,0,0,76,0.5,0.07913973,1
2020-08-26-170807,170807,0,0,0,76,1.25,0.15923116,2
2020-08-27-170807,170807,0,0,0,76,1.75,0.3557011,3
2020-08-28-170807,170807,0,0,0,76,2.0,0.6697965,4
2020-08-29-170807,170807,0,0,0,76,0.0,0.019657006,5
2020-08-30-170807,170807,0,0,0,76,0.5,0.029060725,6
2020-08-31-170807,170807,0,0,0,76,2.25,0.12690294,0
2020-09-01-170807,170807,1,0,0,77,1.25,0.2892049,1
2020-09-02-170807,170807,1,0,0,78,0.5,0.20156763,2
2020-09-03-170807,170807,0,0,0,78,1.5,0.16699946,3
2020-09-04-170807,170807,0,0,0,78,2.25,0.1876651,4
2020-09-05-170807,170807,0,0,0,78,1.0,0.044979505,5
2020-09-06-170807,170807,0,0,0,78,1.25,0.0556841,6
2020-09-07-170807,170807,0,0,0,78,2.25,0.14641412,0
2020-09-08-170807,170807,0,0,0,78,0.5,0.07158702,1
2020-09-09-170807,170807,0,1,0,78,3.25,0.1923407,2
2020-09-10-170807,170807,0,0,0,78,1.25,0.094363354,3
2020-09-11-170807,170807,0,0,0,78,2.0,0.20673293,4
2020-09-12-170807,170807,0,0,0,78,2.75,0.14287274,5
2020-09-13-170807,170807,0,0,0,78,0.5,0.07782703,6
2020-09-14-170807,170807,0,0,0,78,2.5,0.12932019,0
2020-09-15-170807,170807,0,0,0,78,2.5,0.17295402,1
2020-09-16-170807,170807,0,0,0,78,2.0,0.0750793,2
2020-09-17-170807,170807,0,1,0,78,1.0,0.106051266,3
2020-09-18-170807,170807,0,0,0,78,2.5,0.22514775,4
2020-09-19-170807,170807,0,0,0,78,0.0,0.001642896,5
2020-09-20-170807,170807,0,0,0,78,2.25,0.22037716,6
2020-09-21-170807,170807,0,1,0,78,3.0,0.26909882,0
2020-09-22-170807,170807,0,0,0,78,1.5,0.13369389,1
2020-09-23-170807,170807,0,0,0,78,3.25,0.255449,2
2020-09-24-170807,170807,0,0,0,78,4.75,0.47503966,3
2020-09-25-170807,170807,0,0,0,78,7.5,0.35901788,4
2020-09-26-170807,170807,0,0,0,78,2.25,0.19472861,5
2020-09-27-170807,170807,0,0,0,78,0.25,0.019128224,6
2020-09-28-170807,170807,0,0,0,78,2.0,0.20019303,0
2020-09-29-170807,170807,0,0,0,78,0.25,0.019052781,1
2020-09-30-170807,170807,0,0,0,78,1.25,0.09250502,2
2020-10-01-170807,170807,0,0,0,78,1.25,0.075318456,3
2020-10-02-170807,170807,0,0,0,78,0.0,0.001809652,4
2020-10-03-170807,170807,0,0,0,78,0.0,0.0005523007,5
2020-10-04-170807,170807,0,0,0,78,0.0,0.0037928142,6
2020-10-05-170807,170807,0,0,0,78,1.0,0.13678038,0
2020-10-06-170807,170807,0,0,0,78,1.25,0.09932551,1
2020-10-07-170807,170807,0,0,0,78,1.25,0.1812193,2
2020-10-08-170807,170807,0,0,1,78,2.75,0.19670086,3
2020-10-09-170807,170807,0,0,0,78,1.25,0.13393636,4
2020-10-10-170807,170807,0,0,1,78,1.25,0.16987595,5
2020-10-11-170807,170807,0,0,3,78,1.5,0.08991859,6
2020-10-12-170807,170807,0,0,1,78,1.0,0.109632365,0
2020-10-13-170807,170807,0,0,1,78,2.5,0.2528433,1
2020-10-14-170807,170807,0,0,1,78,1.25,0.12942055,2
2020-10-15-170807,170807,0,0,0,78,2.75,0.20444116,3
2020-10-16-170807,170807,0,0,1,78,7.5,0.8134002,4
2020-10-17-170807,170807,0,0,0,78,11.75,1.440736,5
2020-10-18-170807,170807,0,0,0,78,2.5,0.108482115,6
2020-10-19-170807,170807,0,0,3,78,1.75,0.07288205,0
2020-10-20-170807,170807,0,0,2,78,1.75,0.13263059,1
2020-10-21-170807,170807,0,0,0,78,4.5,0.2820508,2
2020-10-22-170807,170807,1,0,0,79,3.25,0.3781457,3
2020-10-23-170807,170807,0,0,0,79,5.0,0.23375297,4
2020-10-24-170807,170807,1,0,0,80,2.5,0.38638675,5
2020-10-25-170807,170807,3,0,0,83,2.75,0.515184,6
2020-10-26-170807,170807,1,0,0,84,2.25,0.35770705,0
2020-10-27-170807,170807,1,0,0,85,1.5,0.274148,1
2020-10-28-170807,170807,1,1,0,86,3.0,0.58465004,2
2020-10-29-170807,170807,0,0,1,86,2.25,0.18978956,3
2020-10-30-170807,170807,1,0,0,87,2.75,0.35098946,4
2020-10-31-170807,170807,0,0,0,87,2.5,0.32406208,5
2020-11-01-170807,170807,0,0,0,87,1.25,0.1086981,6
2020-11-02-170807,170807,3,0,0,90,3.0,0.6977917,0
2020-11-03-170807,170807,2,1,0,92,3.5,0.47904226,1
2020-11-04-170807,170807,0,0,0,92,2.25,0.26532844,2
2020-11-05-170807,170807,0,0,0,92,6.0,0.8035251,3
2020-11-06-170807,170807,0,0,0,92,4.25,0.378722,4
2020-11-07-170807,170807,0,0,0,92,5.25,0.29232854,5
2020-11-08-170807,170807,0,0,0,92,7.25,0.39215818,6
2020-11-09-170807,170807,0,0,0,92,5.5,0.31704476,0
2020-11-10-170807,170807,0,0,0,92,3.25,0.2553464,1
2020-11-11-170807,170807,0,0,0,92,3.75,0.30635995,2
2020-11-12-170807,170807,1,0,0,93,4.5,0.55853826,3
2020-11-13-170807,170807,0,0,0,93,2.0,0.1530832,4
2020-03-01-170808,170808,0,0,0,0,0.0,3.162523e-09,6
2020-03-02-170808,170808,0,1,1,0,0.0,2.3396156e-05,0
2020-03-03-170808,170808,0,0,2,0,0.0,1.7677625e-08,1
2020-03-04-170808,170808,0,0,0,0,0.0,6.551084e-06,2
2020-03-05-170808,170808,0,0,2,0,0.3333333333333333,0.036641426,3
2020-03-06-170808,170808,0,0,1,0,0.0,4.7112778e-08,4
2020-03-07-170808,170808,0,0,0,0,0.3333333333333333,0.030444054,5
2020-03-08-170808,170808,0,1,0,0,0.0,5.0599507e-09,6
2020-03-09-170808,170808,0,0,1,0,0.6666666666666666,0.085640624,0
2020-03-10-170808,170808,0,0,1,0,0.0,6.024163e-05,1
2020-03-11-170808,170808,0,0,3,0,0.6666666666666666,0.10490865,2
2020-03-12-170808,170808,0,0,3,0,0.3333333333333333,0.17159556,3
2020-03-13-170808,170808,0,0,3,0,0.0,0.06556088,4
2020-03-14-170808,170808,1,0,1,1,0.0,0.04931334,5
2020-03-15-170808,170808,0,0,1,1,0.3333333333333333,0.035414804,6
2020-03-16-170808,170808,1,1,1,2,2.333333333333333,0.4475728,0
2020-03-17-170808,170808,2,0,0,4,2.6666666666666665,0.32962638,1
2020-03-18-170808,170808,0,0,1,4,3.333333333333333,0.48236567,2
2020-03-19-170808,170808,2,0,0,6,1.6666666666666667,0.28638363,3
2020-03-20-170808,170808,1,0,0,7,2.0,0.47454312,4
2020-03-21-170808,170808,0,0,0,7,1.3333333333333333,0.12462298,5
2020-03-22-170808,170808,0,0,0,7,0.6666666666666666,0.09410361,6
2020-03-23-170808,170808,1,0,0,8,3.6666666666666665,0.722603,0
2020-03-24-170808,170808,1,1,2,9,3.333333333333333,0.6514964,1
2020-03-25-170808,170808,3,0,0,12,2.333333333333333,0.37344265,2
2020-03-26-170808,170808,3,0,1,15,4.0,0.6599609,3
2020-03-27-170808,170808,3,0,0,18,5.666666666666668,0.7129133,4
2020-03-28-170808,170808,1,0,0,19,1.3333333333333333,0.11841971,5
2020-03-29-170808,170808,1,0,0,20,0.3333333333333333,0.059832916,6
2020-03-30-170808,170808,1,0,0,21,4.333333333333333,0.59634703,0
2020-03-31-170808,170808,0,0,0,21,4.333333333333333,0.5124778,1
2020-04-01-170808,170808,1,0,0,22,10.0,0.8290418,2
2020-04-02-170808,170808,0,0,0,22,3.0,0.39617893,3
2020-04-03-170808,170808,0,0,1,22,1.0,0.22848694,4
2020-04-04-170808,170808,0,0,0,22,1.6666666666666667,0.13408604,5
2020-04-05-170808,170808,0,0,0,22,1.0,0.10594052,6
2020-04-06-170808,170808,0,0,0,22,4.333333333333333,0.47997487,0
2020-04-07-170808,170808,2,0,0,24,4.0,0.477543,1
2020-04-08-170808,170808,0,0,4,24,3.6666666666666665,0.3651781,2
2020-04-09-170808,170808,1,1,0,25,3.0,0.2761749,3
2020-04-10-170808,170808,0,0,0,25,1.0,0.2948537,4
2020-04-11-170808,170808,0,0,0,25,1.6666666666666667,0.09806515,5
2020-04-12-170808,170808,0,0,0,25,0.6666666666666666,0.057177052,6
2020-04-13-170808,170808,0,0,1,25,4.666666666666667,0.52384174,0
2020-04-14-170808,170808,0,0,0,25,8.333333333333334,0.9291559,1
2020-04-15-170808,170808,0,0,0,25,1.3333333333333333,0.37429804,2
2020-04-16-170808,170808,0,0,0,25,8.0,1.1828245,3
2020-04-17-170808,170808,1,0,0,26,0.6666666666666666,0.16012354,4
2020-04-18-170808,170808,0,0,0,26,4.0,0.29487947,5
2020-04-19-170808,170808,0,0,0,26,0.6666666666666666,0.045587115,6
2020-04-20-170808,170808,0,4,1,26,13.666666666666664,2.211647,0
2020-04-21-170808,170808,0,0,1,26,0.6666666666666666,0.0981188,1
2020-04-22-170808,170808,4,0,0,30,3.0,0.41418725,2
2020-04-23-170808,170808,0,0,0,30,1.0,0.07447693,3
2020-04-24-170808,170808,0,0,3,30,4.333333333333333,0.5651392,4
2020-04-25-170808,170808,0,0,0,30,1.3333333333333333,0.12711896,5
2020-04-26-170808,170808,0,0,1,30,0.6666666666666666,0.10341778,6
2020-04-27-170808,170808,1,0,0,31,2.0,0.28057835,0
2020-04-28-170808,170808,0,0,3,31,1.6666666666666667,0.16068166,1
2020-04-29-170808,170808,0,0,0,31,0.3333333333333333,0.11585929,2
2020-04-30-170808,170808,0,0,1,31,1.0,0.24748169,3
2020-05-01-170808,170808,0,0,3,31,1.0,0.04826931,4
2020-05-02-170808,170808,0,0,0,31,1.3333333333333333,0.20446971,5
2020-05-03-170808,170808,0,0,1,31,0.0,0.0528822,6
2020-05-04-170808,170808,1,0,1,32,3.333333333333333,0.48446897,0
2020-05-05-170808,170808,1,0,0,33,2.333333333333333,0.4898181,1
2020-05-06-170808,170808,0,0,0,33,3.333333333333333,0.5406849,2
2020-05-07-170808,170808,0,0,3,33,2.0,0.38832337,3
2020-05-08-170808,170808,3,0,1,36,2.0,0.26376438,4
2020-05-09-170808,170808,0,0,0,36,0.6666666666666666,0.055194817,5
2020-05-10-170808,170808,1,0,0,37,0.0,0.021226622,6
2020-05-11-170808,170808,0,0,0,37,1.6666666666666667,0.30583546,0
2020-05-12-170808,170808,3,0,1,40,3.6666666666666665,0.24038644,1
2020-05-13-170808,170808,0,0,0,40,3.0,0.49594226,2
2020-05-14-170808,170808,1,0,0,41,0.6666666666666666,0.12522514,3
2020-05-15-170808,170808,3,0,0,44,1.6666666666666667,0.19478422,4
2020-05-16-170808,170808,0,0,0,44,0.3333333333333333,0.050987057,5
2020-05-17-170808,170808,1,0,0,45,0.0,0.008431057,6
2020-05-18-170808,170808,1,0,0,46,1.3333333333333333,0.19262658,0
2020-05-19-170808,170808,0,0,0,46,2.0,0.21683681,1
2020-05-20-170808,170808,0,0,0,46,0.3333333333333333,0.08743252,2
2020-05-21-170808,170808,3,0,0,49,0.6666666666666666,0.13409,3
2020-05-22-170808,170808,1,0,0,50,0.3333333333333333,0.1315837,4
2020-05-23-170808,170808,0,0,0,50,0.0,0.027436813,5
2020-05-24-170808,170808,0,0,1,50,1.3333333333333333,0.09367009,6
2020-05-25-170808,170808,0,0,0,50,1.6666666666666667,0.22681624,0
2020-05-26-170808,170808,1,0,1,51,2.0,0.3454619,1
2020-05-27-170808,170808,0,0,0,51,0.0,0.02726149,2
2020-05-28-170808,170808,0,0,1,51,1.6666666666666667,0.38145128,3
2020-05-29-170808,170808,0,0,0,51,0.6666666666666666,0.09906704,4
2020-05-30-170808,170808,0,0,4,51,1.0,0.10053986,5
2020-05-31-170808,170808,0,0,0,51,0.3333333333333333,0.012423555,6
2020-06-01-170808,170808,0,0,0,51,0.3333333333333333,0.06415494,0
2020-06-02-170808,170808,0,1,0,51,1.0,0.1752618,1
2020-06-03-170808,170808,0,0,0,51,0.6666666666666666,0.087713696,2
2020-06-04-170808,170808,0,0,0,51,0.6666666666666666,0.113111,3
2020-06-05-170808,170808,0,1,0,51,0.3333333333333333,0.07598872,4
2020-06-06-170808,170808,0,0,0,51,0.3333333333333333,0.037147235,5
2020-06-07-170808,170808,1,1,0,52,0.3333333333333333,0.051888056,6
2020-06-08-170808,170808,0,0,0,52,1.0,0.09923691,0
2020-06-09-170808,170808,1,0,1,53,1.0,0.18134822,1
2020-06-10-170808,170808,0,0,0,53,1.3333333333333333,0.20747708,2
2020-06-11-170808,170808,1,0,0,54,0.3333333333333333,0.079542644,3
2020-06-12-170808,170808,0,0,0,54,0.6666666666666666,0.1593387,4
2020-06-13-170808,170808,4,0,0,58,0.3333333333333333,0.0639185,5
2020-06-14-170808,170808,0,0,0,58,0.3333333333333333,0.029065276,6
2020-06-15-170808,170808,0,0,0,58,0.0,0.05967665,0
2020-06-16-170808,170808,0,0,0,58,1.0,0.14960754,1
2020-06-17-170808,170808,0,0,0,58,2.0,0.3301978,2
2020-06-18-170808,170808,0,0,0,58,0.3333333333333333,0.06737026,3
2020-06-19-170808,170808,0,0,0,58,0.6666666666666666,0.12111937,4
2020-06-20-170808,170808,0,0,0,58,0.0,0.0013952269,5
2020-06-21-170808,170808,0,0,0,58,0.0,0.04317039,6
2020-06-22-170808,170808,0,0,0,58,0.3333333333333333,0.077863336,0
2020-06-23-170808,170808,1,1,0,59,0.0,0.039261945,1
2020-06-24-170808,170808,0,1,2,59,0.0,0.00076734566,2
2020-06-25-170808,170808,0,0,1,59,0.3333333333333333,0.07498275,3
2020-06-26-170808,170808,0,0,0,59,0.3333333333333333,0.210758,4
2020-06-27-170808,170808,0,0,0,59,0.3333333333333333,0.05349166,5
2020-06-28-170808,170808,0,0,0,59,0.6666666666666666,0.089784324,6
2020-06-29-170808,170808,0,0,0,59,0.0,0.00025080916,0
2020-06-30-170808,170808,0,0,0,59,0.0,0.010651073,1
2020-07-01-170808,170808,0,0,0,59,0.3333333333333333,0.06905017,2
2020-07-02-170808,170808,0,0,0,59,0.0,0.0743583,3
2020-07-03-170808,170808,0,0,0,59,0.3333333333333333,0.030459683,4
2020-07-04-170808,170808,0,0,0,59,0.0,0.018390842,5
2020-07-05-170808,170808,0,0,0,59,0.0,0.00015781309,6
2020-07-06-170808,170808,0,0,0,59,0.0,0.012637466,0
2020-07-07-170808,170808,0,0,1,59,0.3333333333333333,0.07463632,1
2020-07-08-170808,170808,2,0,0,61,0.3333333333333333,0.12110446,2
2020-07-09-170808,170808,1,0,1,62,0.0,0.020614099,3
2020-07-10-170808,170808,0,0,0,62,0.3333333333333333,0.0006716954,4
2020-07-11-170808,170808,0,0,0,62,0.0,0.00013614052,5
2020-07-12-170808,170808,0,0,0,62,0.0,0.017230753,6
2020-07-13-170808,170808,0,0,1,62,0.6666666666666666,0.12770452,0
2020-07-14-170808,170808,0,0,0,62,0.3333333333333333,0.057808492,1
2020-07-15-170808,170808,0,0,1,62,0.6666666666666666,0.12062655,2
2020-07-16-170808,170808,0,0,1,62,1.0,0.18368807,3
2020-07-17-170808,170808,0,0,0,62,0.0,0.035918623,4
2020-07-18-170808,170808,0,0,0,62,0.0,0.020562908,5
2020-07-19-170808,170808,0,0,0,62,0.0,0.0019704755,6
2020-07-20-170808,170808,0,0,1,62,0.3333333333333333,0.07156633,0
2020-07-21-170808,170808,1,0,0,63,0.3333333333333333,0.08252531,1
2020-07-22-170808,170808,0,0,0,63,0.0,0.093782574,2
2020-07-23-170808,170808,1,0,3,64,0.3333333333333333,0.28377813,3
2020-07-24-170808,170808,0,0,1,64,0.3333333333333333,0.0916252,4
2020-07-25-170808,170808,0,0,0,64,0.0,0.05844365,5
2020-07-26-170808,170808,0,0,2,64,0.3333333333333333,0.12401983,6
2020-07-27-170808,170808,1,0,1,65,0.0,0.03826349,0
2020-07-28-170808,170808,0,0,1,65,0.0,0.00036758164,1
2020-07-29-170808,170808,1,0,0,66,0.6666666666666666,0.19230191,2
2020-07-30-170808,170808,1,0,0,67,0.3333333333333333,0.085811414,3
2020-07-31-170808,170808,0,0,1,67,0.6666666666666666,0.3545344,4
2020-08-01-170808,170808,0,0,0,67,1.6666666666666667,0.18268077,5
2020-08-02-170808,170808,0,0,0,67,0.0,0.01846495,6
2020-08-03-170808,170808,1,0,0,68,0.0,0.13651577,0
2020-08-04-170808,170808,0,0,1,68,1.3333333333333333,0.1765113,1
2020-08-05-170808,170808,0,0,3,68,4.333333333333333,0.7227202,2
2020-08-06-170808,170808,3,0,0,71,3.333333333333333,0.82179016,3
2020-08-07-170808,170808,1,0,1,72,0.6666666666666666,0.16143273,4
2020-08-08-170808,170808,0,0,0,72,1.3333333333333333,0.30280882,5
2020-08-09-170808,170808,2,0,2,74,0.0,0.10999615,6
2020-08-10-170808,170808,1,0,1,75,0.6666666666666666,0.24283223,0
2020-08-11-170808,170808,1,0,0,76,1.3333333333333333,0.3321842,1
2020-08-12-170808,170808,0,1,0,76,0.6666666666666666,0.31375116,2
2020-08-13-170808,170808,0,0,1,76,2.333333333333333,0.4043816,3
2020-08-14-170808,170808,1,0,2,77,5.0,0.69388884,4
2020-08-15-170808,170808,0,0,0,77,0.3333333333333333,0.09526989,5
2020-08-16-170808,170808,0,0,0,77,0.6666666666666666,0.14948058,6
2020-08-17-170808,170808,0,0,5,77,0.3333333333333333,0.06839793,0
2020-08-18-170808,170808,1,0,0,78,3.6666666666666665,0.6654189,1
2020-08-19-170808,170808,3,0,0,81,3.0,0.7036057,2
2020-08-20-170808,170808,0,0,3,81,0.3333333333333333,0.060588166,3
2020-08-21-170808,170808,1,0,4,82,0.3333333333333333,0.14916378,4
2020-08-22-170808,170808,0,0,4,82,1.3333333333333333,0.24046147,5
2020-08-23-170808,170808,2,0,4,84,0.0,0.07794215,6
2020-08-24-170808,170808,1,0,1,85,1.0,0.19829543,0
2020-08-25-170808,170808,0,0,0,85,0.6666666666666666,0.10146071,1
2020-08-26-170808,170808,0,0,8,85,1.3333333333333333,0.18579468,2
2020-08-27-170808,170808,1,0,1,86,1.6666666666666667,0.50695837,3
2020-08-28-170808,170808,2,0,3,88,0.6666666666666666,0.29549614,4
2020-08-29-170808,170808,0,0,6,88,0.3333333333333333,0.0275499,5
2020-08-30-170808,170808,0,0,0,88,0.6666666666666666,0.04103273,6
2020-08-31-170808,170808,5,0,5,93,1.0,0.20635717,0
2020-09-01-170808,170808,0,0,1,93,2.0,0.5732809,1
2020-09-02-170808,170808,0,0,3,93,1.0,0.16266398,2
2020-09-03-170808,170808,3,0,0,96,0.3333333333333333,0.18826179,3
2020-09-04-170808,170808,4,0,1,100,1.0,0.21702445,4
2020-09-05-170808,170808,4,0,0,104,0.3333333333333333,0.052406266,5
2020-09-06-170808,170808,4,0,0,108,0.3333333333333333,0.100859985,6
2020-09-07-170808,170808,1,0,1,109,0.3333333333333333,0.10311328,0
2020-09-08-170808,170808,0,0,2,109,0.3333333333333333,0.07485352,1
2020-09-09-170808,170808,8,0,3,117,0.6666666666666666,0.24442773,2
2020-09-10-170808,170808,1,0,2,118,0.6666666666666666,0.15316088,3
2020-09-11-170808,170808,3,0,1,121,0.0,0.17162438,4
2020-09-12-170808,170808,6,0,1,127,1.0,0.19818893,5
2020-09-13-170808,170808,0,0,0,127,0.0,0.035656404,6
2020-09-14-170808,170808,5,0,0,132,1.3333333333333333,0.19089304,0
2020-09-15-170808,170808,1,0,0,133,0.0,0.0709285,1
2020-09-16-170808,170808,3,0,3,136,0.6666666666666666,0.12585992,2
2020-09-17-170808,170808,0,0,0,136,0.0,0.0852822,3
2020-09-18-170808,170808,1,0,0,137,1.0,0.22726487,4
2020-09-19-170808,170808,0,0,0,137,0.0,0.0033648051,5
2020-09-20-170808,170808,0,0,0,137,1.6666666666666667,0.21909659,6
2020-09-21-170808,170808,1,0,0,138,0.3333333333333333,0.27219677,0
2020-09-22-170808,170808,2,1,2,140,0.3333333333333333,0.1301049,1
2020-09-23-170808,170808,3,0,1,143,1.6666666666666667,0.33419955,2
2020-09-24-170808,170808,2,1,2,145,1.6666666666666667,0.36429697,3
2020-09-25-170808,170808,1,0,2,146,1.0,0.18398069,4
2020-09-26-170808,170808,1,0,1,147,1.6666666666666667,0.22557569,5
2020-09-27-170808,170808,0,0,4,147,0.0,0.0094383415,6
2020-09-28-170808,170808,0,0,0,147,0.6666666666666666,0.14498587,0
2020-09-29-170808,170808,0,0,6,147,0.0,0.008973484,1
2020-09-30-170808,170808,3,0,1,150,0.0,0.15418449,2
2020-10-01-170808,170808,0,0,3,150,0.3333333333333333,0.06926782,3
2020-10-02-170808,170808,0,0,3,150,0.3333333333333333,0.0008326294,4
2020-10-03-170808,170808,0,0,8,150,0.0,0.00045081548,5
2020-10-04-170808,170808,0,0,9,150,0.0,0.002883146,6
2020-10-05-170808,170808,0,0,5,150,1.6666666666666667,0.16825165,0
2020-10-06-170808,170808,2,1,6,152,0.6666666666666666,0.14536992,1
2020-10-07-170808,170808,1,1,8,153,0.6666666666666666,0.15853374,2
2020-10-08-170808,170808,2,0,5,155,0.6666666666666666,0.1817701,3
2020-10-09-170808,170808,2,1,8,157,1.0,0.20501441,4
2020-10-10-170808,170808,1,0,1,158,1.3333333333333333,0.1719072,5
2020-10-11-170808,170808,4,0,5,162,0.6666666666666666,0.10665695,6
2020-10-12-170808,170808,0,0,2,162,1.0,0.12221195,0
2020-10-13-170808,170808,6,0,5,168,1.3333333333333333,0.44386595,1
2020-10-14-170808,170808,1,0,3,169,1.0,0.17699748,2
2020-10-15-170808,170808,3,0,5,172,2.0,0.30050153,3
2020-10-16-170808,170808,3,0,5,175,7.0,1.108995,4
2020-10-17-170808,170808,8,0,1,183,13.0,1.503013,5
2020-10-18-170808,170808,9,1,2,192,0.6666666666666666,0.16285893,6
2020-10-19-170808,170808,5,0,7,197,0.6666666666666666,0.14582697,0
2020-10-20-170808,170808,6,0,6,203,0.3333333333333333,0.25170106,1
2020-10-21-170808,170808,8,0,3,211,2.6666666666666665,0.49562165,2
2020-10-22-170808,170808,5,0,9,216,3.333333333333333,0.5002007,3
2020-10-23-170808,170808,8,0,2,224,4.0,0.45080128,4
2020-10-24-170808,170808,1,0,12,225,3.333333333333333,0.36605257,5
2020-10-25-170808,170808,5,0,11,230,3.0,0.3267044,6
2020-10-26-170808,170808,2,0,15,232,3.0,0.49911782,0
2020-10-27-170808,170808,5,0,7,237,1.0,0.27463463,1
2020-10-28-170808,170808,3,0,9,240,4.666666666666667,1.2598035,2
2020-10-29-170808,170808,5,0,9,245,1.3333333333333333,0.2595407,3
2020-10-30-170808,170808,5,0,4,250,3.6666666666666665,0.44788563,4
2020-10-31-170808,170808,1,0,0,251,3.333333333333333,0.366894,5
2020-11-01-170808,170808,2,0,0,253,1.3333333333333333,0.15525001,6
2020-11-02-170808,170808,7,0,0,260,2.0,0.44467553,0
2020-11-03-170808,170808,6,0,0,266,2.6666666666666665,0.5470768,1
2020-11-04-170808,170808,3,0,0,269,0.6666666666666666,0.323178,2
2020-11-05-170808,170808,9,0,0,278,2.0,0.78460956,3
2020-11-06-170808,170808,2,0,0,280,3.6666666666666665,0.3954519,4
2020-11-07-170808,170808,12,0,0,292,1.6666666666666667,0.34227806,5
2020-11-08-170808,170808,11,0,0,303,4.666666666666667,0.6492599,6
2020-11-09-170808,170808,15,1,0,318,1.6666666666666667,0.55858445,0
2020-11-10-170808,170808,7,0,0,325,1.6666666666666667,0.4464266,1
2020-11-11-170808,170808,9,1,0,334,1.6666666666666667,0.7433876,2
2020-11-12-170808,170808,9,0,0,343,3.6666666666666665,0.7524267,3
2020-11-13-170808,170808,4,0,0,347,2.333333333333333,0.25196132,4
2020-03-01-170809,170809,0,0,1,0,0.0,1.5641638e-12,6
2020-03-02-170809,170809,0,0,15,0,0.0,6.199101e-08,0
2020-03-03-170809,170809,0,0,4,0,0.0,3.257654e-07,1
2020-03-04-170809,170809,0,0,20,0,0.0,1.317238e-07,2
2020-03-05-170809,170809,0,0,3,0,0.5,0.060812548,3
2020-03-06-170809,170809,0,0,7,0,0.0,0.0001368075,4
2020-03-07-170809,170809,0,0,2,0,0.5,0.062100034,5
2020-03-08-170809,170809,0,1,3,0,0.0,2.2551103e-07,6
2020-03-09-170809,170809,1,0,11,1,1.0,0.12812716,0
2020-03-10-170809,170809,1,0,6,2,0.0,0.008385536,1
2020-03-11-170809,170809,2,0,12,4,1.0,0.18466082,2
2020-03-12-170809,170809,0,0,15,4,0.5,0.106848694,3
2020-03-13-170809,170809,0,0,7,4,0.0,0.024409845,4
2020-03-14-170809,170809,0,0,4,4,0.0,0.012592706,5
2020-03-15-170809,170809,1,0,3,5,0.5,0.049076818,6
2020-03-16-170809,170809,15,0,4,20,2.5,0.35249683,0
2020-03-17-170809,170809,4,0,9,24,3.5,0.32196265,1
2020-03-18-170809,170809,20,1,4,44,5.0,0.5715437,2
2020-03-19-170809,170809,3,0,1,47,1.5,0.20203346,3
2020-03-20-170809,170809,7,0,0,54,4.0,0.38436663,4
2020-03-21-170809,170809,2,0,0,56,2.5,0.14989665,5
2020-03-22-170809,170809,3,0,0,59,1.0,0.0846699,6
2020-03-23-170809,170809,11,0,2,70,6.5,0.5035446,0
2020-03-24-170809,170809,6,0,5,76,5.5,0.51808745,1
2020-03-25-170809,170809,12,0,7,88,4.0,0.25897208,2
2020-03-26-170809,170809,15,0,16,103,6.0,0.43807593,3
2020-03-27-170809,170809,7,0,2,110,6.5,0.5975796,4
2020-03-28-170809,170809,4,0,1,114,2.0,0.11809097,5
2020-03-29-170809,170809,3,0,0,117,0.5,0.016473934,6
2020-03-30-170809,170809,4,1,4,121,7.0,0.48088703,0
2020-03-31-170809,170809,9,0,0,130,5.5,0.38446358,1
2020-04-01-170809,170809,4,0,5,134,14.5,1.0567969,2
2020-04-02-170809,170809,1,0,0,135,3.5,0.23873204,3
2020-04-03-170809,170809,0,0,1,135,3.0,0.1342073,4
2020-04-04-170809,170809,0,0,13,135,2.0,0.11943818,5
2020-04-05-170809,170809,0,1,1,135,2.5,0.09731153,6
2020-04-06-170809,170809,2,0,19,137,6.0,0.4564663,0
2020-04-07-170809,170809,5,0,1,142,6.0,0.2938795,1
2020-04-08-170809,170809,7,0,0,149,5.0,0.46327716,2
2020-04-09-170809,170809,16,0,0,165,4.5,0.39913633,3
2020-04-10-170809,170809,2,1,2,167,4.0,0.13671573,4
2020-04-11-170809,170809,1,0,1,168,2.5,0.15937465,5
2020-04-12-170809,170809,0,0,0,168,1.5,0.09359023,6
2020-04-13-170809,170809,4,0,1,172,7.0,0.74421656,0
2020-04-14-170809,170809,0,0,1,172,9.5,0.84520906,1
2020-04-15-170809,170809,5,0,2,177,2.5,0.27658594,2
2020-04-16-170809,170809,0,0,0,177,12.0,1.4494792,3
2020-04-17-170809,170809,1,0,0,178,1.5,0.09780242,4
2020-04-18-170809,170809,13,0,2,191,5.5,0.6670874,5
2020-04-19-170809,170809,1,0,0,192,1.0,0.09693198,6
2020-04-20-170809,170809,19,0,1,211,20.5,2.145329,0
2020-04-21-170809,170809,1,0,6,212,0.5,0.074899256,1
2020-04-22-170809,170809,0,0,1,212,2.5,0.2125166,2
2020-04-23-170809,170809,0,0,2,212,0.0,0.0040173763,3
2020-04-24-170809,170809,2,0,3,214,3.0,0.31172815,4
2020-04-25-170809,170809,1,0,1,215,2.0,0.105535105,5
2020-04-26-170809,170809,0,0,0,215,0.0,0.010994571,6
2020-04-27-170809,170809,1,0,2,216,3.0,0.3042361,0
2020-04-28-170809,170809,1,0,3,217,2.0,0.2062389,1
2020-04-29-170809,170809,2,0,6,219,0.5,0.068691015,2
2020-04-30-170809,170809,0,0,0,219,1.5,0.11125111,3
2020-05-01-170809,170809,0,0,2,219,0.5,0.030502303,4
2020-05-02-170809,170809,2,0,0,221,1.0,0.07701272,5
2020-05-03-170809,170809,0,0,0,221,0.0,0.0013920544,6
2020-05-04-170809,170809,1,0,1,222,5.0,0.5554049,0
2020-05-05-170809,170809,6,0,3,228,4.0,0.48998338,1
2020-05-06-170809,170809,1,0,3,229,5.0,0.5378989,2
2020-05-07-170809,170809,2,0,0,231,3.0,0.38827762,3
2020-05-08-170809,170809,3,0,0,234,2.0,0.27041188,4
2020-05-09-170809,170809,1,0,0,235,0.0,0.007822882,5
2020-05-10-170809,170809,0,0,0,235,0.0,0.00040172212,6
2020-05-11-170809,170809,2,1,2,237,2.5,0.33651423,0
2020-05-12-170809,170809,3,0,0,240,2.5,0.24544364,1
2020-05-13-170809,170809,6,0,1,246,4.0,0.5314861,2
2020-05-14-170809,170809,0,0,0,246,0.5,0.07618548,3
2020-05-15-170809,170809,2,0,2,248,2.5,0.30064583,4
2020-05-16-170809,170809,0,0,0,248,0.5,0.043586146,5
2020-05-17-170809,170809,0,0,0,248,0.0,3.597406e-05,6
2020-05-18-170809,170809,1,0,2,249,1.5,0.24495482,0
2020-05-19-170809,170809,3,0,0,252,2.5,0.38996637,1
2020-05-20-170809,170809,3,0,1,255,1.0,0.12319705,2
2020-05-21-170809,170809,0,0,3,255,0.5,0.07000676,3
2020-05-22-170809,170809,0,0,3,255,0.0,0.034511637,4
2020-05-23-170809,170809,0,0,1,255,0.0,0.0006869015,5
2020-05-24-170809,170809,0,0,0,255,2.0,0.16633031,6
2020-05-25-170809,170809,2,0,0,257,2.5,0.42429686,0
2020-05-26-170809,170809,0,0,1,257,2.5,0.34075892,1
2020-05-27-170809,170809,1,0,1,258,0.0,0.033243913,2
2020-05-28-170809,170809,0,2,0,258,2.5,0.35486406,3
2020-05-29-170809,170809,2,0,0,260,1.0,0.16240355,4
2020-05-30-170809,170809,0,0,0,260,1.5,0.28767553,5
2020-05-31-170809,170809,0,0,0,260,0.0,0.0028993415,6
2020-06-01-170809,170809,2,0,0,262,0.5,0.107106656,0
2020-06-02-170809,170809,0,0,1,262,1.5,0.29682273,1
2020-06-03-170809,170809,1,0,0,263,1.0,0.18180503,2
2020-06-04-170809,170809,3,0,1,266,0.5,0.146732,3
2020-06-05-170809,170809,3,0,2,269,0.5,0.2256684,4
2020-06-06-170809,170809,1,0,1,270,0.5,0.09013733,5
2020-06-07-170809,170809,0,0,0,270,0.5,0.05528871,6
2020-06-08-170809,170809,0,0,2,270,1.5,0.1496516,0
2020-06-09-170809,170809,1,0,0,271,1.0,0.17586373,1
2020-06-10-170809,170809,1,0,0,272,2.0,0.45505425,2
2020-06-11-170809,170809,0,0,0,272,0.0,0.004771303,3
2020-06-12-170809,170809,0,0,1,272,1.0,0.15190409,4
2020-06-13-170809,170809,0,0,0,272,0.5,0.08483526,5
2020-06-14-170809,170809,0,0,0,272,0.5,0.09269989,6
2020-06-15-170809,170809,0,0,0,272,0.0,0.027756631,0
2020-06-16-170809,170809,1,0,0,273,1.5,0.26819402,1
2020-06-17-170809,170809,0,0,0,273,3.0,0.47947267,2
2020-06-18-170809,170809,1,0,0,274,0.5,0.11298667,3
2020-06-19-170809,170809,2,0,0,276,1.5,0.22692953,4
2020-06-20-170809,170809,1,0,0,277,0.0,0.029814418,5
2020-06-21-170809,170809,0,0,0,277,0.0,0.00676496,6
2020-06-22-170809,170809,2,0,0,279,0.5,0.13233957,0
2020-06-23-170809,170809,0,0,0,279,0.0,0.010578981,1
2020-06-24-170809,170809,0,0,0,279,0.0,0.0028544068,2
2020-06-25-170809,170809,0,0,0,279,1.0,0.11581765,3
2020-06-26-170809,170809,1,0,0,280,0.5,0.22779197,4
2020-06-27-170809,170809,0,0,0,280,0.5,0.18428455,5
2020-06-28-170809,170809,0,0,2,280,1.0,0.26733574,6
2020-06-29-170809,170809,0,0,3,280,0.0,0.0005770048,0
2020-06-30-170809,170809,0,0,0,280,0.0,0.0044343104,1
2020-07-01-170809,170809,0,0,2,280,1.0,0.09253308,2
2020-07-02-170809,170809,0,0,1,280,0.5,0.027756942,3
2020-07-03-170809,170809,0,1,0,280,0.0,0.009889611,4
2020-07-04-170809,170809,0,0,0,280,0.0,0.0032453237,5
2020-07-05-170809,170809,0,0,0,280,0.0,1.2300472e-09,6
2020-07-06-170809,170809,0,0,1,280,0.0,0.016804362,0
2020-07-07-170809,170809,0,0,0,280,0.5,0.12807208,1
2020-07-08-170809,170809,0,0,0,280,0.5,0.12607947,2
2020-07-09-170809,170809,0,0,1,280,0.5,0.0019001018,3
2020-07-10-170809,170809,0,0,1,280,0.5,0.004711386,4
2020-07-11-170809,170809,0,0,0,280,0.0,0.00016195171,5
2020-07-12-170809,170809,2,0,0,282,0.0,0.029870335,6
2020-07-13-170809,170809,3,0,0,285,1.5,0.2867113,0
2020-07-14-170809,170809,0,0,0,285,0.5,0.10779974,1
2020-07-15-170809,170809,2,0,0,287,1.0,0.2144752,2
2020-07-16-170809,170809,1,0,0,288,1.5,0.36880594,3
2020-07-17-170809,170809,0,0,0,288,0.5,0.012456007,4
2020-07-18-170809,170809,0,0,0,288,0.0,0.0087453965,5
2020-07-19-170809,170809,0,0,0,288,0.0,0.009164352,6
2020-07-20-170809,170809,1,0,0,289,0.0,0.03313813,0
2020-07-21-170809,170809,0,0,0,289,1.0,0.12525104,1
2020-07-22-170809,170809,0,0,1,289,0.0,0.044767164,2
2020-07-23-170809,170809,1,1,0,290,0.5,0.2213865,3
2020-07-24-170809,170809,1,0,0,291,1.0,0.20208596,4
2020-07-25-170809,170809,0,0,0,291,0.0,0.06929762,5
2020-07-26-170809,170809,0,0,0,291,1.5,0.1838125,6
2020-07-27-170809,170809,0,0,0,291,0.5,0.0060535255,0
2020-07-28-170809,170809,0,0,0,291,0.5,0.0011641561,1
2020-07-29-170809,170809,0,0,0,291,1.5,0.25156716,2
2020-07-30-170809,170809,0,0,0,291,0.5,0.1387294,3
2020-07-31-170809,170809,0,0,0,291,1.0,0.29381183,4
2020-08-01-170809,170809,0,0,0,291,2.5,0.73692286,5
2020-08-02-170809,170809,0,0,0,291,0.0,0.012683508,6
2020-08-03-170809,170809,0,0,0,291,0.0,0.045674797,0
2020-08-04-170809,170809,0,0,0,291,4.0,0.44604337,1
2020-08-05-170809,170809,1,0,1,292,7.5,1.9432542,2
2020-08-06-170809,170809,0,0,5,292,5.5,1.6527591,3
2020-08-07-170809,170809,0,0,0,292,1.0,0.36733586,4
2020-08-08-170809,170809,0,0,0,292,1.5,0.64680624,5
2020-08-09-170809,170809,0,0,1,292,0.0,0.1775767,6
2020-08-10-170809,170809,0,0,0,292,1.5,0.28984666,0
2020-08-11-170809,170809,0,0,0,292,2.5,0.68520385,1
2020-08-12-170809,170809,0,1,1,292,1.0,0.48859674,2
2020-08-13-170809,170809,0,0,0,292,0.5,0.36018476,3
2020-08-14-170809,170809,0,0,3,292,3.0,0.96744823,4
2020-08-15-170809,170809,0,0,0,292,1.0,0.2742581,5
2020-08-16-170809,170809,0,0,0,292,1.0,0.30550918,6
2020-08-17-170809,170809,0,0,0,292,1.5,0.1510867,0
2020-08-18-170809,170809,0,0,1,292,4.5,1.0379589,1
2020-08-19-170809,170809,1,0,0,293,3.5,0.5541708,2
2020-08-20-170809,170809,5,0,0,298,0.5,0.31283253,3
2020-08-21-170809,170809,0,0,1,298,1.5,0.07292062,4
2020-08-22-170809,170809,0,0,0,298,3.5,0.6823436,5
2020-08-23-170809,170809,1,0,0,299,0.5,0.047347505,6
2020-08-24-170809,170809,0,0,0,299,4.5,0.34385383,0
2020-08-25-170809,170809,0,0,0,299,1.5,0.3868867,1
2020-08-26-170809,170809,1,1,0,300,3.0,0.45883104,2
2020-08-27-170809,170809,0,0,0,300,3.0,0.72880393,3
2020-08-28-170809,170809,3,0,0,303,0.5,0.114743076,4
2020-08-29-170809,170809,0,0,0,303,0.0,0.05294119,5
2020-08-30-170809,170809,0,0,0,303,1.0,0.13224727,6
2020-08-31-170809,170809,0,1,0,303,0.5,0.103838176,0
2020-09-01-170809,170809,1,0,0,304,3.5,0.5249803,1
2020-09-02-170809,170809,0,0,0,304,1.0,0.13029745,2
2020-09-03-170809,170809,0,0,0,304,1.0,0.28742552,3
2020-09-04-170809,170809,1,0,0,305,1.0,0.29403546,4
2020-09-05-170809,170809,0,0,0,305,1.0,0.044796135,5
2020-09-06-170809,170809,0,0,0,305,0.5,0.1322328,6
2020-09-07-170809,170809,0,0,0,305,1.0,0.11512862,0
2020-09-08-170809,170809,0,0,0,305,0.5,0.11049577,1
2020-09-09-170809,170809,0,0,0,305,0.5,0.1589183,2
2020-09-10-170809,170809,0,0,2,305,0.5,0.14408337,3
2020-09-11-170809,170809,0,0,0,305,0.0,0.09587799,4
2020-09-12-170809,170809,0,0,3,305,2.0,0.34454823,5
2020-09-13-170809,170809,0,0,0,305,0.5,0.06052935,6
2020-09-14-170809,170809,0,0,3,305,3.5,0.3045967,0
2020-09-15-170809,170809,0,0,2,305,0.0,0.025377758,1
2020-09-16-170809,170809,0,0,0,305,3.5,0.25028855,2
2020-09-17-170809,170809,0,0,0,305,0.5,0.07314905,3
2020-09-18-170809,170809,0,1,0,305,1.5,0.3863588,4
2020-09-19-170809,170809,0,0,0,305,0.0,0.011030898,5
2020-09-20-170809,170809,0,1,1,305,2.5,0.39985994,6
2020-09-21-170809,170809,0,0,0,305,0.5,0.15310672,0
2020-09-22-170809,170809,0,0,0,305,1.5,0.11377547,1
2020-09-23-170809,170809,0,0,2,305,3.0,0.44451374,2
2020-09-24-170809,170809,2,0,1,307,4.0,0.38019744,3
2020-09-25-170809,170809,0,0,0,307,1.0,0.117884874,4
2020-09-26-170809,170809,3,0,1,310,2.0,0.39643204,5
2020-09-27-170809,170809,0,0,1,310,0.0,0.01800305,6
2020-09-28-170809,170809,3,0,0,313,2.0,0.24607515,0
2020-09-29-170809,170809,2,0,0,315,0.0,0.03655138,1
2020-09-30-170809,170809,0,0,0,315,0.0,0.071681246,2
2020-10-01-170809,170809,0,0,0,315,0.5,0.093684025,3
2020-10-02-170809,170809,0,0,0,315,0.5,0.0054749707,4
2020-10-03-170809,170809,0,0,0,315,0.0,0.0002266276,5
2020-10-04-170809,170809,1,0,0,316,0.0,0.0399336,6
2020-10-05-170809,170809,0,0,0,316,1.0,0.14041889,0
2020-10-06-170809,170809,0,0,0,316,1.0,0.16231124,1
2020-10-07-170809,170809,2,0,2,318,1.0,0.14415795,2
2020-10-08-170809,170809,1,0,0,319,1.5,0.14224082,3
2020-10-09-170809,170809,0,0,0,319,2.0,0.36287427,4
2020-10-10-170809,170809,1,0,0,320,2.0,0.6105595,5
2020-10-11-170809,170809,1,0,2,321,1.0,0.41249037,6
2020-10-12-170809,170809,0,0,1,321,2.5,0.36610666,0
2020-10-13-170809,170809,0,0,1,321,3.0,0.5527701,1
2020-10-14-170809,170809,0,0,2,321,3.0,0.20543048,2
2020-10-15-170809,170809,0,0,2,321,4.5,0.40352702,3
2020-10-16-170809,170809,0,0,2,321,10.0,1.727856,4
2020-10-17-170809,170809,0,0,0,321,17.5,4.5761514,5
2020-10-18-170809,170809,0,0,1,321,2.5,0.30151767,6
2020-10-19-170809,170809,0,0,1,321,1.0,0.079492435,0
2020-10-20-170809,170809,0,0,0,321,4.5,0.26667175,1
2020-10-21-170809,170809,2,0,1,323,7.0,0.69083154,2
2020-10-22-170809,170809,0,0,1,323,4.5,0.5980382,3
2020-10-23-170809,170809,0,0,1,323,5.0,0.5577645,4
2020-10-24-170809,170809,0,0,0,323,3.0,0.85976017,5
2020-10-25-170809,170809,2,0,0,325,4.5,0.38581833,6
2020-10-26-170809,170809,1,0,0,326,8.0,0.76832587,0
2020-10-27-170809,170809,1,0,0,327,0.5,0.20762014,1
2020-10-28-170809,170809,2,0,1,329,5.5,0.9946551,2
2020-10-29-170809,170809,2,0,0,331,6.5,0.35761735,3
2020-10-30-170809,170809,2,0,0,333,7.0,0.48724014,4
2020-10-31-170809,170809,0,0,0,333,7.0,0.86789066,5
2020-11-01-170809,170809,1,0,0,334,1.5,0.3098016,6
2020-11-02-170809,170809,1,0,0,335,1.5,0.25173476,0
2020-11-03-170809,170809,0,0,0,335,3.5,0.40765694,1
2020-11-04-170809,170809,1,0,0,336,3.5,0.30322832,2
2020-11-05-170809,170809,1,0,0,337,6.0,0.841347,3
2020-11-06-170809,170809,1,2,0,338,8.0,0.48548195,4
2020-11-07-170809,170809,0,0,0,338,2.5,0.25364366,5
2020-11-08-170809,170809,0,0,0,338,13.0,1.1846417,6
2020-11-09-170809,170809,0,0,0,338,6.5,0.30149004,0
2020-11-10-170809,170809,0,1,0,338,7.0,0.34801233,1
2020-11-11-170809,170809,1,0,0,339,5.5,0.50924253,2
2020-11-12-170809,170809,0,0,0,339,8.5,0.54243076,3
2020-11-13-170809,170809,0,0,0,339,9.0,0.19324332,4
2020-03-01-170810,170810,0,0,1,0,0.0,2.3839076e-08,6
2020-03-02-170810,170810,0,0,3,0,0.0,0.0003439037,0
2020-03-03-170810,170810,0,0,2,0,0.0,0.002180402,1
2020-03-04-170810,170810,0,0,3,0,0.0,0.0008046883,2
2020-03-05-170810,170810,0,0,6,0,0.16666666666666666,0.062261265,3
2020-03-06-170810,170810,0,0,2,0,0.0,0.0013413257,4
2020-03-07-170810,170810,0,0,1,0,0.16666666666666666,0.06294617,5
2020-03-08-170810,170810,0,0,2,0,0.0,0.0009827932,6
2020-03-09-170810,170810,0,0,1,0,0.5,0.16166583,0
2020-03-10-170810,170810,0,0,6,0,0.0,0.0066107563,1
2020-03-11-170810,170810,0,0,4,0,0.3333333333333333,0.18107787,2
2020-03-12-170810,170810,1,0,3,1,0.6666666666666666,0.3645453,3
2020-03-13-170810,170810,0,0,0,1,0.3333333333333333,0.16585322,4
2020-03-14-170810,170810,0,0,0,1,0.0,0.032736354,5
2020-03-15-170810,170810,1,0,1,2,1.3333333333333333,0.1633438,6
2020-03-16-170810,170810,3,0,3,5,2.0,0.50346434,0
2020-03-17-170810,170810,2,1,0,7,2.1666666666666665,0.4873905,1
2020-03-18-170810,170810,3,1,2,10,4.166666666666667,0.81597227,2
2020-03-19-170810,170810,6,0,2,16,2.333333333333333,0.6562422,3
2020-03-20-170810,170810,2,0,0,18,3.5,0.578479,4
2020-03-21-170810,170810,1,0,0,19,3.1666666666666665,0.3349824,5
2020-03-22-170810,170810,2,0,0,21,2.1666666666666665,0.2565514,6
2020-03-23-170810,170810,1,0,0,22,6.5,1.1249048,0
2020-03-24-170810,170810,6,0,3,28,4.166666666666667,0.9780715,1
2020-03-25-170810,170810,4,0,1,32,4.5,0.843055,2
2020-03-26-170810,170810,3,0,1,35,3.0,0.65330535,3
2020-03-27-170810,170810,0,0,3,35,4.666666666666667,0.8312668,4
2020-03-28-170810,170810,0,0,0,35,1.6666666666666667,0.14256199,5
2020-03-29-170810,170810,1,0,0,36,1.3333333333333333,0.08139331,6
2020-03-30-170810,170810,3,0,2,39,5.333333333333333,0.96503025,0
2020-03-31-170810,170810,0,0,0,39,5.833333333333332,0.75915456,1
2020-04-01-170810,170810,2,0,0,41,6.5,1.2802504,2
2020-04-02-170810,170810,2,0,0,43,3.6666666666666665,0.48070008,3
2020-04-03-170810,170810,0,0,0,43,4.5,0.49732345,4
2020-04-04-170810,170810,0,0,0,43,2.333333333333333,0.18313792,5
2020-04-05-170810,170810,0,0,1,43,2.5,0.17120682,6
2020-04-06-170810,170810,0,0,0,43,4.5,0.6396619,0
2020-04-07-170810,170810,3,1,2,46,3.8333333333333335,0.6223777,1
2020-04-08-170810,170810,1,0,2,47,4.333333333333333,0.8583908,2
2020-04-09-170810,170810,1,0,0,48,2.0,0.25775152,3
2020-04-10-170810,170810,3,6,2,51,4.666666666666667,0.42527872,4
2020-04-11-170810,170810,0,0,1,51,1.6666666666666667,0.1567553,5
2020-04-12-170810,170810,0,0,0,51,2.5,0.16355386,6
2020-04-13-170810,170810,2,0,1,53,3.0,1.1161747,0
2020-04-14-170810,170810,0,0,0,53,4.5,1.1907641,1
2020-04-15-170810,170810,0,0,1,53,1.3333333333333333,0.36779135,2
2020-04-16-170810,170810,0,0,0,53,5.5,1.5193573,3
2020-04-17-170810,170810,0,0,1,53,1.0,0.30220604,4
2020-04-18-170810,170810,0,0,0,53,2.1666666666666665,0.50426376,5
2020-04-19-170810,170810,1,0,0,54,0.5,0.09588192,6
2020-04-20-170810,170810,0,0,0,54,7.0,2.3521693,0
2020-04-21-170810,170810,2,0,0,56,0.8333333333333334,0.22993709,1
2020-04-22-170810,170810,2,0,1,58,1.0,0.36434743,2
2020-04-23-170810,170810,0,0,0,58,0.6666666666666666,0.043093815,3
2020-04-24-170810,170810,2,0,0,60,2.0,0.42398885,4
2020-04-25-170810,170810,1,0,0,61,1.1666666666666667,0.14840797,5
2020-04-26-170810,170810,0,1,0,61,0.3333333333333333,0.029438755,6
2020-04-27-170810,170810,1,0,0,62,1.6666666666666667,0.37644646,0
2020-04-28-170810,170810,0,0,2,62,1.6666666666666667,0.35042447,1
2020-04-29-170810,170810,1,0,1,63,1.0,0.22496153,2
2020-04-30-170810,170810,0,0,2,63,1.5,0.31392747,3
2020-05-01-170810,170810,1,0,2,64,1.0,0.118658304,4
2020-05-02-170810,170810,0,0,0,64,0.6666666666666666,0.103501245,5
2020-05-03-170810,170810,0,0,0,64,1.3333333333333333,0.0806599,6
2020-05-04-170810,170810,0,0,1,64,2.833333333333333,0.6366259,0
2020-05-05-170810,170810,0,0,0,64,1.6666666666666667,0.5098596,1
2020-05-06-170810,170810,1,0,0,65,6.0,1.0702477,2
2020-05-07-170810,170810,0,0,0,65,1.5,0.4370565,3
2020-05-08-170810,170810,0,0,2,65,0.6666666666666666,0.23935428,4
2020-05-09-170810,170810,0,0,0,65,0.16666666666666666,0.0048702587,5
2020-05-10-170810,170810,0,2,0,65,0.0,0.006334693,6
2020-05-11-170810,170810,0,0,0,65,1.5,0.30844888,0
2020-05-12-170810,170810,2,0,1,67,1.0,0.30769768,1
2020-05-13-170810,170810,1,0,4,68,1.6666666666666667,0.6264279,2
2020-05-14-170810,170810,2,0,0,70,0.8333333333333334,0.280661,3
2020-05-15-170810,170810,2,0,0,72,1.0,0.38499996,4
2020-05-16-170810,170810,0,0,0,72,0.3333333333333333,0.065364145,5
2020-05-17-170810,170810,0,0,0,72,0.0,0.00090536685,6
2020-05-18-170810,170810,1,0,0,73,1.0,0.34699076,0
2020-05-19-170810,170810,0,0,2,73,1.5,0.4817899,1
2020-05-20-170810,170810,0,0,0,73,1.1666666666666667,0.23084994,2
2020-05-21-170810,170810,0,0,0,73,0.3333333333333333,0.10265465,3
2020-05-22-170810,170810,2,0,0,75,0.0,0.09426085,4
2020-05-23-170810,170810,0,0,0,75,0.0,0.01408274,5
2020-05-24-170810,170810,0,0,0,75,0.6666666666666666,0.12877811,6
2020-05-25-170810,170810,0,0,0,75,0.8333333333333334,0.48197386,0
2020-05-26-170810,170810,1,0,2,76,1.3333333333333333,0.5291993,1
2020-05-27-170810,170810,4,0,0,80,0.16666666666666666,0.16658126,2
2020-05-28-170810,170810,0,0,0,80,1.3333333333333333,0.3856988,3
2020-05-29-170810,170810,0,0,0,80,0.3333333333333333,0.20537305,4
2020-05-30-170810,170810,0,1,0,80,0.8333333333333334,0.24847482,5
2020-05-31-170810,170810,0,0,0,80,0.16666666666666666,0.022042783,6
2020-06-01-170810,170810,0,0,0,80,0.5,0.13798256,0
2020-06-02-170810,170810,2,0,1,82,1.1666666666666667,0.37634203,1
2020-06-03-170810,170810,0,0,0,82,0.5,0.22306798,2
2020-06-04-170810,170810,0,0,1,82,0.3333333333333333,0.14068435,3
2020-06-05-170810,170810,0,0,0,82,0.5,0.19809677,4
2020-06-06-170810,170810,0,0,0,82,0.16666666666666666,0.08827445,5
2020-06-07-170810,170810,0,0,0,82,0.5,0.0852603,6
2020-06-08-170810,170810,0,0,0,82,0.6666666666666666,0.18875949,0
2020-06-09-170810,170810,2,0,0,84,0.8333333333333334,0.3286841,1
2020-06-10-170810,170810,0,0,0,84,1.0,0.33919352,2
2020-06-11-170810,170810,0,0,1,84,0.3333333333333333,0.079020396,3
2020-06-12-170810,170810,0,0,0,84,0.8333333333333334,0.28611547,4
2020-06-13-170810,170810,0,1,0,84,0.16666666666666666,0.07098113,5
2020-06-14-170810,170810,0,0,0,84,0.3333333333333333,0.087291755,6
2020-06-15-170810,170810,0,0,0,84,0.0,0.013944686,0
2020-06-16-170810,170810,1,0,0,85,0.8333333333333334,0.38194272,1
2020-06-17-170810,170810,0,0,0,85,1.0,0.47105587,2
2020-06-18-170810,170810,1,0,0,86,0.16666666666666666,0.1512787,3
2020-06-19-170810,170810,0,0,0,86,0.8333333333333334,0.2746694,4
2020-06-20-170810,170810,0,0,0,86,0.16666666666666666,0.025834661,5
2020-06-21-170810,170810,0,0,0,86,0.16666666666666666,0.0288617,6
2020-06-22-170810,170810,0,0,1,86,0.3333333333333333,0.13182303,0
2020-06-23-170810,170810,0,0,2,86,0.3333333333333333,0.09030098,1
2020-06-24-170810,170810,0,0,0,86,0.16666666666666666,0.056514006,2
2020-06-25-170810,170810,1,0,0,87,0.6666666666666666,0.19471082,3
2020-06-26-170810,170810,0,0,0,87,0.16666666666666666,0.15012279,4
2020-06-27-170810,170810,0,0,0,87,0.16666666666666666,0.12868509,5
2020-06-28-170810,170810,0,0,0,87,0.3333333333333333,0.19670115,6
2020-06-29-170810,170810,0,0,0,87,0.0,0.013398106,0
2020-06-30-170810,170810,0,0,0,87,0.16666666666666666,0.041551378,1
2020-07-01-170810,170810,0,0,0,87,0.5,0.13140702,2
2020-07-02-170810,170810,0,0,1,87,0.6666666666666666,0.100523904,3
2020-07-03-170810,170810,0,0,0,87,0.5,0.09642001,4
2020-07-04-170810,170810,0,0,0,87,0.0,0.010725714,5
2020-07-05-170810,170810,0,0,0,87,0.0,4.64472e-05,6
2020-07-06-170810,170810,1,0,0,88,0.5,0.20478813,0
2020-07-07-170810,170810,2,0,0,90,0.16666666666666666,0.18541943,1
2020-07-08-170810,170810,0,0,0,90,0.6666666666666666,0.2527447,2
2020-07-09-170810,170810,0,0,0,90,0.16666666666666666,0.023802891,3
2020-07-10-170810,170810,0,0,1,90,0.16666666666666666,0.011063378,4
2020-07-11-170810,170810,0,0,0,90,0.0,8.461927e-05,5
2020-07-12-170810,170810,0,0,0,90,0.0,0.016425977,6
2020-07-13-170810,170810,0,0,0,90,1.0,0.38958478,0
2020-07-14-170810,170810,0,0,0,90,0.5,0.15683444,1
2020-07-15-170810,170810,0,0,0,90,0.6666666666666666,0.2588585,2
2020-07-16-170810,170810,1,0,1,91,0.6666666666666666,0.47723845,3
2020-07-17-170810,170810,0,0,0,91,0.3333333333333333,0.05164183,4
2020-07-18-170810,170810,0,0,0,91,0.16666666666666666,0.03606917,5
2020-07-19-170810,170810,0,0,0,91,0.16666666666666666,0.026123544,6
2020-07-20-170810,170810,0,0,0,91,0.6666666666666666,0.12970066,0
2020-07-21-170810,170810,0,0,2,91,0.8333333333333334,0.2457353,1
2020-07-22-170810,170810,0,0,0,91,0.3333333333333333,0.14404166,2
2020-07-23-170810,170810,0,0,2,91,0.8333333333333334,0.28172114,3
2020-07-24-170810,170810,1,0,0,92,1.0,0.33083367,4
2020-07-25-170810,170810,0,0,0,92,0.6666666666666666,0.14712001,5
2020-07-26-170810,170810,0,0,6,92,0.8333333333333334,0.22689338,6
2020-07-27-170810,170810,0,0,2,92,0.16666666666666666,0.056009524,0
2020-07-28-170810,170810,0,0,2,92,0.16666666666666666,0.021906018,1
2020-07-29-170810,170810,0,0,4,92,0.8333333333333334,0.40222383,2
2020-07-30-170810,170810,1,0,2,93,1.3333333333333333,0.33363396,3
2020-07-31-170810,170810,0,0,4,93,0.8333333333333334,0.38398287,4
2020-08-01-170810,170810,0,0,0,93,1.1666666666666667,0.7835916,5
2020-08-02-170810,170810,0,0,0,93,0.0,0.051081188,6
2020-08-03-170810,170810,0,0,0,93,0.16666666666666666,0.130039,0
2020-08-04-170810,170810,2,0,0,95,1.5,0.7772662,1
2020-08-05-170810,170810,0,0,0,95,2.5,1.8888226,2
2020-08-06-170810,170810,2,0,0,97,1.8333333333333333,1.7750634,3
2020-08-07-170810,170810,0,0,0,97,0.6666666666666666,0.45629168,4
2020-08-08-170810,170810,0,0,0,97,0.8333333333333334,0.6903495,5
2020-08-09-170810,170810,6,0,0,103,0.3333333333333333,0.36461926,6
2020-08-10-170810,170810,2,0,1,105,1.3333333333333333,0.7863816,0
2020-08-11-170810,170810,2,0,3,107,1.6666666666666667,1.131273,1
2020-08-12-170810,170810,4,0,1,111,1.6666666666666667,0.94941914,2
2020-08-13-170810,170810,2,0,1,113,1.1666666666666667,1.376695,3
2020-08-14-170810,170810,4,0,0,117,3.0,1.8444647,4
2020-08-15-170810,170810,0,0,0,117,0.6666666666666666,0.35695952,5
2020-08-16-170810,170810,0,0,0,117,1.3333333333333333,0.5331064,6
2020-08-17-170810,170810,0,0,0,117,0.6666666666666666,0.5784568,0
2020-08-18-170810,170810,0,0,1,117,1.8333333333333333,1.192685,1
2020-08-19-170810,170810,0,0,2,117,2.0,0.8271651,2
2020-08-20-170810,170810,0,0,1,117,1.1666666666666667,0.66923916,3
2020-08-21-170810,170810,0,0,1,117,1.3333333333333333,0.6732231,4
2020-08-22-170810,170810,0,0,0,117,2.6666666666666665,1.2596688,5
2020-08-23-170810,170810,0,0,0,117,0.16666666666666666,0.10715614,6
2020-08-24-170810,170810,1,0,4,118,2.0,0.5441529,0
2020-08-25-170810,170810,3,0,3,121,1.5,0.9293978,1
2020-08-26-170810,170810,1,0,1,122,2.0,0.635893,2
2020-08-27-170810,170810,1,0,2,123,1.5,0.8474077,3
2020-08-28-170810,170810,0,0,3,123,1.1666666666666667,0.2754595,4
2020-08-29-170810,170810,0,0,2,123,1.0,0.40540692,5
2020-08-30-170810,170810,0,0,3,123,0.6666666666666666,0.2404447,6
2020-08-31-170810,170810,0,0,1,123,0.6666666666666666,0.27183953,0
2020-09-01-170810,170810,1,0,1,124,3.1666666666666665,0.9127379,1
2020-09-02-170810,170810,2,0,1,126,1.5,0.58240455,2
2020-09-03-170810,170810,1,0,3,127,3.333333333333333,1.375525,3
2020-09-04-170810,170810,1,0,3,128,2.0,0.67048943,4
2020-09-05-170810,170810,0,0,1,128,1.0,0.16958936,5
2020-09-06-170810,170810,0,0,0,128,0.8333333333333334,0.25543076,6
2020-09-07-170810,170810,4,0,0,132,1.3333333333333333,0.63394654,0
2020-09-08-170810,170810,3,0,1,135,1.1666666666666667,0.49362487,1
2020-09-09-170810,170810,1,0,0,136,0.8333333333333334,0.39442757,2
2020-09-10-170810,170810,2,0,0,138,1.0,0.6013067,3
2020-09-11-170810,170810,3,0,1,141,1.3333333333333333,0.6076327,4
2020-09-12-170810,170810,2,0,4,143,1.1666666666666667,0.492766,5
2020-09-13-170810,170810,3,0,0,146,1.0,0.34851885,6
2020-09-14-170810,170810,1,0,0,147,1.6666666666666667,0.41512832,0
2020-09-15-170810,170810,1,0,1,148,1.6666666666666667,0.45388535,1
2020-09-16-170810,170810,1,0,3,149,2.6666666666666665,0.5940662,2
2020-09-17-170810,170810,3,0,0,152,0.6666666666666666,0.38760507,3
2020-09-18-170810,170810,3,0,0,155,2.0,0.65691566,4
2020-09-19-170810,170810,1,0,0,156,0.5,0.063142665,5
2020-09-20-170810,170810,0,0,0,156,2.0,0.5557031,6
2020-09-21-170810,170810,0,1,0,156,1.3333333333333333,0.29591137,0
2020-09-22-170810,170810,1,0,0,157,2.333333333333333,0.2526696,1
2020-09-23-170810,170810,0,0,1,157,2.5,0.77642894,2
2020-09-24-170810,170810,0,1,0,157,2.0,0.6289262,3
2020-09-25-170810,170810,1,0,0,158,0.8333333333333334,0.48125842,4
2020-09-26-170810,170810,4,0,0,162,1.8333333333333333,0.6566121,5
2020-09-27-170810,170810,0,0,1,162,0.3333333333333333,0.09529895,6
2020-09-28-170810,170810,0,0,0,162,2.333333333333333,0.52252436,0
2020-09-29-170810,170810,1,0,2,163,0.16666666666666666,0.14517121,1
2020-09-30-170810,170810,3,1,0,166,0.6666666666666666,0.3507697,2
2020-10-01-170810,170810,0,0,1,166,0.3333333333333333,0.16849458,3
2020-10-02-170810,170810,0,0,2,166,0.5,0.13977437,4
2020-10-03-170810,170810,0,0,2,166,0.16666666666666666,0.068089575,5
2020-10-04-170810,170810,0,1,0,166,0.5,0.13302948,6
2020-10-05-170810,170810,0,0,0,166,0.6666666666666666,0.27685,0
2020-10-06-170810,170810,0,0,2,166,1.0,0.25884673,1
2020-10-07-170810,170810,1,0,2,167,1.5,0.65390885,2
2020-10-08-170810,170810,0,0,2,167,2.6666666666666665,0.6094751,3
2020-10-09-170810,170810,0,0,2,167,2.0,0.7478713,4
2020-10-10-170810,170810,0,0,0,167,1.1666666666666667,0.58876175,5
2020-10-11-170810,170810,1,0,1,168,1.0,0.5198624,6
2020-10-12-170810,170810,0,0,3,168,1.0,0.44323847,0
2020-10-13-170810,170810,2,0,3,170,2.0,1.0329648,1
2020-10-14-170810,170810,0,0,4,170,2.6666666666666665,0.8902881,2
2020-10-15-170810,170810,1,0,1,171,1.5,0.878409,3
2020-10-16-170810,170810,2,0,3,173,5.333333333333333,2.250023,4
2020-10-17-170810,170810,2,0,0,175,6.333333333333332,4.0848446,5
2020-10-18-170810,170810,0,0,0,175,3.1666666666666665,0.9277988,6
2020-10-19-170810,170810,0,0,3,175,0.5,0.30892,0
2020-10-20-170810,170810,2,0,1,177,2.1666666666666665,0.791938,1
2020-10-21-170810,170810,2,0,4,179,3.6666666666666665,1.3171692,2
2020-10-22-170810,170810,2,0,2,181,2.6666666666666665,1.0464398,3
2020-10-23-170810,170810,2,0,6,183,4.666666666666667,1.0720586,4
2020-10-24-170810,170810,0,0,4,183,3.1666666666666665,1.169103,5
2020-10-25-170810,170810,1,0,11,184,3.0,0.63410676,6
2020-10-26-170810,170810,3,0,1,187,5.0,1.7707952,0
2020-10-27-170810,170810,3,0,7,190,1.8333333333333333,0.5803145,1
2020-10-28-170810,170810,4,0,5,194,7.0,2.6529691,2
2020-10-29-170810,170810,1,0,2,195,5.0,1.45184,3
2020-10-30-170810,170810,3,0,2,198,5.833333333333332,1.6714716,4
2020-10-31-170810,170810,0,0,0,198,5.833333333333332,1.8774339,5
2020-11-01-170810,170810,0,1,0,198,2.833333333333333,0.76561886,6
2020-11-02-170810,170810,3,1,0,201,3.333333333333333,0.7173852,0
2020-11-03-170810,170810,1,0,0,202,3.6666666666666665,1.1005589,1
2020-11-04-170810,170810,4,0,0,206,3.8333333333333335,1.0249872,2
2020-11-05-170810,170810,2,0,0,208,3.8333333333333335,1.1907494,3
2020-11-06-170810,170810,6,0,0,214,4.5,1.532682,4
2020-11-07-170810,170810,4,0,0,218,3.1666666666666665,0.757143,5
2020-11-08-170810,170810,11,0,0,229,8.166666666666666,1.9760525,6
2020-11-09-170810,170810,1,0,0,230,4.333333333333333,1.0169823,0
2020-11-10-170810,170810,7,0,0,237,4.5,1.6762409,1
2020-11-11-170810,170810,5,0,0,242,2.833333333333333,1.0424712,2
2020-11-12-170810,170810,2,0,0,244,4.666666666666667,1.3623824,3
2020-11-13-170810,170810,2,1,0,246,4.5,0.9526155,4
2020-03-01-170811,170811,0,0,1,0,0.0,4.1289194e-10,6
2020-03-02-170811,170811,0,0,5,0,0.0,3.898821e-05,0
2020-03-03-170811,170811,0,1,7,0,0.08333333333333333,0.0032374014,1
2020-03-04-170811,170811,0,0,8,0,0.0,0.00013810402,2
2020-03-05-170811,170811,1,0,3,1,0.0,0.32230455,3
2020-03-06-170811,170811,0,0,5,1,0.08333333333333333,0.00060521526,4
2020-03-07-170811,170811,1,0,3,2,0.0,0.3180822,5
2020-03-08-170811,170811,0,0,2,2,0.0,0.0012385544,6
2020-03-09-170811,170811,2,0,9,4,0.3333333333333333,0.6953766,0
2020-03-10-170811,170811,0,0,10,4,0.16666666666666666,0.015385929,1
2020-03-11-170811,170811,2,0,5,6,0.5,0.8831396,2
2020-03-12-170811,170811,1,0,9,7,0.9166666666666666,0.76745,3
2020-03-13-170811,170811,0,0,12,7,0.8333333333333334,0.18828982,4
2020-03-14-170811,170811,0,0,3,7,0.75,0.1148387,5
2020-03-15-170811,170811,1,0,1,8,1.25,0.3849292,6
2020-03-16-170811,170811,5,0,10,13,5.583333333333332,2.3018322,0
2020-03-17-170811,170811,7,0,10,20,4.916666666666667,2.1807485,1
2020-03-18-170811,170811,8,0,27,28,7.833333333333332,3.0069318,2
2020-03-19-170811,170811,3,0,6,31,8.5,1.5336382,3
2020-03-20-170811,170811,5,0,3,36,9.5,2.175846,4
2020-03-21-170811,170811,3,0,3,39,4.583333333333333,0.8983041,5
2020-03-22-170811,170811,2,0,3,41,2.833333333333333,0.5569033,6
2020-03-23-170811,170811,9,0,11,50,11.25,3.7311428,0
2020-03-24-170811,170811,10,0,10,60,8.5,3.476015,1
2020-03-25-170811,170811,5,0,10,65,10.666666666666666,2.3395934,2
2020-03-26-170811,170811,9,0,8,74,10.5,2.9096923,3
2020-03-27-170811,170811,12,0,3,86,10.166666666666666,3.735358,4
2020-03-28-170811,170811,3,0,4,89,5.166666666666667,0.6760147,5
2020-03-29-170811,170811,1,0,2,90,1.9166666666666667,0.20278835,6
2020-03-30-170811,170811,10,0,13,100,9.0,3.7118306,0
2020-03-31-170811,170811,10,0,19,110,9.25,2.5663562,1
2020-04-01-170811,170811,27,0,3,137,7.416666666666668,6.6880536,2
2020-04-02-170811,170811,6,0,22,143,5.666666666666668,1.8935965,3
2020-04-03-170811,170811,3,0,2,146,5.416666666666668,1.4756194,4
2020-04-04-170811,170811,3,0,11,149,2.083333333333333,0.79891026,5
2020-04-05-170811,170811,3,0,2,152,2.4166666666666665,0.7435719,6
2020-04-06-170811,170811,11,0,40,163,4.583333333333333,3.1011384,0
2020-04-07-170811,170811,10,1,1,173,4.416666666666667,2.571829,1
2020-04-08-170811,170811,10,0,5,183,4.083333333333333,3.4413118,2
2020-04-09-170811,170811,8,0,0,191,5.0,1.6332492,3
2020-04-10-170811,170811,3,0,6,194,5.75,1.2630537,4
2020-04-11-170811,170811,4,0,3,198,1.3333333333333333,0.83049417,5
2020-04-12-170811,170811,2,0,0,200,2.75,0.51837003,6
2020-04-13-170811,170811,13,0,6,213,3.75,4.6393123,0
2020-04-14-170811,170811,19,0,4,232,2.9166666666666665,5.6717525,1
2020-04-15-170811,170811,3,0,1,235,3.9166666666666665,1.5805324,2
2020-04-16-170811,170811,22,0,3,257,5.0,7.8453345,3
2020-04-17-170811,170811,2,0,1,259,2.583333333333333,0.7843301,4
2020-04-18-170811,170811,11,0,2,270,2.333333333333333,2.8288763,5
2020-04-19-170811,170811,2,0,0,272,3.4166666666666665,0.46427837,6
2020-04-20-170811,170811,40,0,9,312,11.0,12.346292,0
2020-04-21-170811,170811,1,0,7,313,2.75,0.51177585,1
2020-04-22-170811,170811,5,0,9,318,2.833333333333333,1.8157129,2
2020-04-23-170811,170811,0,0,5,318,3.0,0.13513796,3
2020-04-24-170811,170811,6,0,4,324,4.083333333333333,2.291907,4
2020-04-25-170811,170811,3,0,0,327,3.8333333333333335,0.7066275,5
2020-04-26-170811,170811,0,0,0,327,0.5,0.24348369,6
2020-04-27-170811,170811,6,0,5,333,2.9166666666666665,1.8096749,0
2020-04-28-170811,170811,4,0,5,337,2.1666666666666665,1.2892523,1
2020-04-29-170811,170811,1,0,8,338,1.4166666666666667,0.65959865,2
2020-04-30-170811,170811,3,0,1,341,1.5833333333333333,0.93252146,3
2020-05-01-170811,170811,1,0,5,342,0.9166666666666666,0.34376302,4
2020-05-02-170811,170811,2,0,1,344,2.083333333333333,0.7413484,5
2020-05-03-170811,170811,0,0,0,344,1.1666666666666667,0.1753793,6
2020-05-04-170811,170811,9,0,3,353,3.9166666666666665,3.1005225,0
2020-05-05-170811,170811,7,0,5,360,3.9166666666666665,2.7830544,1
2020-05-06-170811,170811,9,0,1,369,6.083333333333332,4.0294423,2
2020-05-07-170811,170811,5,0,1,374,4.166666666666667,2.1598852,3
2020-05-08-170811,170811,4,0,0,378,4.166666666666667,1.5098292,4
2020-05-09-170811,170811,0,0,0,378,1.0,0.10739224,5
2020-05-10-170811,170811,0,2,4,378,0.5,0.046851307,6
2020-05-11-170811,170811,5,0,5,383,5.166666666666667,1.6438159,0
2020-05-12-170811,170811,5,0,5,388,2.9166666666666665,1.3900872,1
2020-05-13-170811,170811,8,0,0,396,4.5,2.936032,2
2020-05-14-170811,170811,1,0,5,397,3.083333333333333,0.6701297,3
2020-05-15-170811,170811,5,1,2,402,2.6666666666666665,1.527953,4
2020-05-16-170811,170811,1,0,3,403,0.8333333333333334,0.3223614,5
2020-05-17-170811,170811,0,0,0,403,0.08333333333333333,0.0038966232,6
2020-05-18-170811,170811,3,0,1,406,2.5,1.4338852,0
2020-05-19-170811,170811,5,0,3,411,2.6666666666666665,1.9883811,1
2020-05-20-170811,170811,1,0,2,412,1.6666666666666667,0.6431801,2
2020-05-21-170811,170811,1,0,1,413,1.1666666666666667,0.49999094,3
2020-05-22-170811,170811,0,0,1,413,1.1666666666666667,0.42834848,4
2020-05-23-170811,170811,0,0,1,413,0.75,0.046437934,5
2020-05-24-170811,170811,4,0,1,417,0.4166666666666667,0.8038972,6
2020-05-25-170811,170811,5,0,3,422,2.1666666666666665,2.2932105,0
2020-05-26-170811,170811,5,0,2,427,1.9166666666666667,1.9931617,1
2020-05-27-170811,170811,0,0,4,427,3.0,0.2813991,2
2020-05-28-170811,170811,5,0,0,432,1.8333333333333333,2.2409933,3
2020-05-29-170811,170811,2,0,2,434,1.9166666666666667,0.8272097,4
2020-05-30-170811,170811,3,0,1,437,1.3333333333333333,1.1985537,5
2020-05-31-170811,170811,0,0,1,437,0.08333333333333333,0.051548693,6
2020-06-01-170811,170811,1,0,0,438,0.8333333333333334,0.51616997,0
2020-06-02-170811,170811,3,0,3,441,1.5,1.2563547,1
2020-06-03-170811,170811,2,0,6,443,0.9166666666666666,0.9259491,2
2020-06-04-170811,170811,1,0,1,444,2.0,0.5615311,3
2020-06-05-170811,170811,1,2,2,445,1.5833333333333333,0.891781,4
2020-06-06-170811,170811,1,0,0,446,0.4166666666666667,0.44092765,5
2020-06-07-170811,170811,1,0,0,447,0.3333333333333333,0.39404726,6
2020-06-08-170811,170811,3,0,1,450,1.0,0.83920133,0
2020-06-09-170811,170811,2,0,0,452,2.083333333333333,1.157897,1
2020-06-10-170811,170811,4,0,0,456,1.4166666666666667,1.8186107,2
2020-06-11-170811,170811,0,1,1,456,1.25,0.22473879,3
2020-06-12-170811,170811,2,0,1,458,1.4166666666666667,1.0459741,4
2020-06-13-170811,170811,1,0,1,459,0.3333333333333333,0.4152837,5
2020-06-14-170811,170811,1,0,2,460,0.25,0.36948863,6
2020-06-15-170811,170811,0,0,0,460,0.8333333333333334,0.21567717,0
2020-06-16-170811,170811,3,0,0,463,0.75,1.3461341,1
2020-06-17-170811,170811,6,0,1,469,0.75,2.4716604,2
2020-06-18-170811,170811,1,0,0,470,0.6666666666666666,0.57973754,3
2020-06-19-170811,170811,2,0,0,472,0.75,1.0335971,4
2020-06-20-170811,170811,0,0,0,472,0.25,0.06918138,5
2020-06-21-170811,170811,0,0,0,472,0.5,0.14386445,6
2020-06-22-170811,170811,1,0,0,473,0.8333333333333334,0.5402269,0
2020-06-23-170811,170811,0,0,1,473,0.6666666666666666,0.20023695,1
2020-06-24-170811,170811,0,1,1,473,0.6666666666666666,0.052941773,2
2020-06-25-170811,170811,1,0,0,474,0.5833333333333334,0.61625135,3
2020-06-26-170811,170811,1,0,1,475,1.0833333333333333,1.0002583,4
2020-06-27-170811,170811,1,0,0,476,0.0,0.60802674,5
2020-06-28-170811,170811,2,0,0,478,0.0,1.0003484,6
2020-06-29-170811,170811,0,0,2,478,0.25,0.007582244,0
2020-06-30-170811,170811,0,0,1,478,0.3333333333333333,0.06960067,1
2020-07-01-170811,170811,1,0,2,479,0.75,0.5714964,2
2020-07-02-170811,170811,0,0,3,479,0.5,0.26271728,3
2020-07-03-170811,170811,0,0,0,479,0.5,0.1582,4
2020-07-04-170811,170811,0,0,0,479,0.08333333333333333,0.052573044,5
2020-07-05-170811,170811,0,0,0,479,0.25,0.00031899993,6
2020-07-06-170811,170811,0,0,0,479,0.3333333333333333,0.15105197,0
2020-07-07-170811,170811,1,0,1,480,0.6666666666666666,0.6732109,1
2020-07-08-170811,170811,1,0,0,481,0.9166666666666666,0.7099154,2
2020-07-09-170811,170811,0,0,1,481,0.75,0.028117491,3
2020-07-10-170811,170811,1,0,1,482,0.3333333333333333,0.009475682,4
2020-07-11-170811,170811,0,0,0,482,0.25,0.0006808682,5
2020-07-12-170811,170811,0,0,1,482,0.25,0.09456293,6
2020-07-13-170811,170811,2,0,0,484,1.0,1.5801237,0
2020-07-14-170811,170811,1,0,0,485,0.4166666666666667,0.61449814,1
2020-07-15-170811,170811,2,0,2,487,0.9166666666666666,1.1251715,2
2020-07-16-170811,170811,3,0,1,490,0.4166666666666667,1.7261858,3
2020-07-17-170811,170811,0,1,2,490,0.8333333333333334,0.16451901,4
2020-07-18-170811,170811,0,0,5,490,0.25,0.104597695,5
2020-07-19-170811,170811,0,0,0,490,0.25,0.052485615,6
2020-07-20-170811,170811,0,0,0,490,1.1666666666666667,0.36325458,0
2020-07-21-170811,170811,1,0,4,491,0.9166666666666666,0.7784854,1
2020-07-22-170811,170811,0,0,13,491,0.4166666666666667,0.36397272,2
2020-07-23-170811,170811,1,0,10,492,0.9166666666666666,1.3601325,3
2020-07-24-170811,170811,1,0,2,493,1.0833333333333333,0.98677665,4
2020-07-25-170811,170811,0,0,3,493,0.5833333333333334,0.45649377,5
2020-07-26-170811,170811,1,0,0,494,0.4166666666666667,0.8439893,6
2020-07-27-170811,170811,0,0,1,494,0.6666666666666666,0.08338103,0
2020-07-28-170811,170811,0,0,4,494,0.6666666666666666,0.00841376,1
2020-07-29-170811,170811,2,0,2,496,1.3333333333333333,1.5035721,2
2020-07-30-170811,170811,1,0,0,497,1.75,0.8556531,3
2020-07-31-170811,170811,2,0,5,499,1.3333333333333333,1.6075022,4
2020-08-01-170811,170811,5,0,1,504,1.0833333333333333,3.0834858,5
2020-08-02-170811,170811,0,0,2,504,0.6666666666666666,0.0791192,6
2020-08-03-170811,170811,0,0,1,504,2.5,0.4877092,0
2020-08-04-170811,170811,4,0,7,508,2.5,2.1451194,1
2020-08-05-170811,170811,13,0,3,521,1.6666666666666667,8.697929,2
2020-08-06-170811,170811,10,0,1,531,1.8333333333333333,7.7694163,3
2020-08-07-170811,170811,2,0,0,533,0.9166666666666666,1.7420367,4
2020-08-08-170811,170811,3,0,3,536,0.6666666666666666,2.8719842,5
2020-08-09-170811,170811,0,0,0,536,1.0,0.92492926,6
2020-08-10-170811,170811,1,0,3,537,2.1666666666666665,1.672419,0
2020-08-11-170811,170811,4,0,2,541,2.0,3.6174126,1
2020-08-12-170811,170811,2,0,4,543,2.083333333333333,2.927189,2
2020-08-13-170811,170811,0,0,4,543,3.1666666666666665,1.887206,3
2020-08-14-170811,170811,5,0,1,548,3.1666666666666665,4.9240127,4
2020-08-15-170811,170811,1,0,0,549,0.4166666666666667,1.1342608,5
2020-08-16-170811,170811,2,0,1,551,0.6666666666666666,1.4277575,6
2020-08-17-170811,170811,1,0,1,552,2.1666666666666665,0.8743384,0
2020-08-18-170811,170811,7,0,5,559,4.333333333333333,5.1080713,1
2020-08-19-170811,170811,3,0,1,562,2.583333333333333,3.1024668,2
2020-08-20-170811,170811,1,0,1,563,3.25,1.0874712,3
2020-08-21-170811,170811,0,0,2,563,1.6666666666666667,0.62111133,4
2020-08-22-170811,170811,3,0,0,566,1.3333333333333333,3.000848,5
2020-08-23-170811,170811,0,0,1,566,0.5,0.24242973,6
2020-08-24-170811,170811,3,0,1,569,3.083333333333333,1.8923088,0
2020-08-25-170811,170811,2,0,1,571,1.0833333333333333,1.6095216,1
2020-08-26-170811,170811,4,0,1,575,2.75,2.238561,2
2020-08-27-170811,170811,4,0,1,579,1.1666666666666667,3.5451143,3
2020-08-28-170811,170811,1,0,0,580,2.0,0.9254651,4
2020-08-29-170811,170811,0,0,3,580,0.4166666666666667,0.31810278,5
2020-08-30-170811,170811,1,0,0,581,1.0,0.6816412,6
2020-08-31-170811,170811,1,0,4,582,2.6666666666666665,0.7656086,0
2020-09-01-170811,170811,5,1,0,587,2.333333333333333,2.8567421,1
2020-09-02-170811,170811,1,0,2,588,1.6666666666666667,0.88866293,2
2020-09-03-170811,170811,1,0,0,589,1.6666666666666667,1.873837,3
2020-09-04-170811,170811,2,0,3,591,2.6666666666666665,1.6452632,4
2020-09-05-170811,170811,0,0,0,591,1.0833333333333333,0.4341145,5
2020-09-06-170811,170811,1,0,5,592,1.0,0.7666446,6
2020-09-07-170811,170811,1,0,1,593,2.583333333333333,0.84908986,0
2020-09-08-170811,170811,1,0,1,594,0.9166666666666666,0.7818045,1
2020-09-09-170811,170811,1,0,5,595,1.9166666666666667,1.0111641,2
2020-09-10-170811,170811,1,1,5,596,1.6666666666666667,1.0570143,3
2020-09-11-170811,170811,0,0,1,596,2.4166666666666665,0.97701156,4
2020-09-12-170811,170811,3,0,3,599,1.1666666666666667,1.5266681,5
2020-09-13-170811,170811,0,0,0,599,1.0833333333333333,0.4270921,6
2020-09-14-170811,170811,4,0,2,603,3.333333333333333,1.376932,0
2020-09-15-170811,170811,0,0,0,603,3.0,0.41770542,1
2020-09-16-170811,170811,2,1,0,605,3.0,1.1831427,2
2020-09-17-170811,170811,0,0,1,605,2.0,0.49408734,3
2020-09-18-170811,170811,3,0,0,608,3.083333333333333,2.0679417,4
2020-09-19-170811,170811,0,0,0,608,0.3333333333333333,0.095089816,5
2020-09-20-170811,170811,5,0,0,613,1.0833333333333333,2.5436976,6
2020-09-21-170811,170811,1,0,2,614,2.5,1.0949153,0
2020-09-22-170811,170811,1,0,2,615,2.333333333333333,0.7224125,1
2020-09-23-170811,170811,5,1,1,620,1.9166666666666667,2.660809,2
2020-09-24-170811,170811,5,1,1,625,1.75,2.2349412,3
2020-09-25-170811,170811,1,0,3,626,1.0,1.1062218,4
2020-09-26-170811,170811,3,0,3,629,2.1666666666666665,2.1637495,5
2020-09-27-170811,170811,0,0,2,629,0.25,0.108313836,6
2020-09-28-170811,170811,2,1,3,631,1.4166666666666667,1.2642651,0
2020-09-29-170811,170811,0,0,4,631,0.75,0.12616503,1
2020-09-30-170811,170811,0,0,2,631,1.25,0.6183837,2
2020-10-01-170811,170811,1,0,5,632,0.4166666666666667,0.49768266,3
2020-10-02-170811,170811,0,0,16,632,1.0,0.09634755,4
2020-10-03-170811,170811,0,0,35,632,0.0,0.041608542,5
2020-10-04-170811,170811,0,0,1,632,0.25,0.17455567,6
2020-10-05-170811,170811,2,1,1,634,1.0833333333333333,0.97393984,0
2020-10-06-170811,170811,2,0,1,636,0.5833333333333334,0.9059999,1
2020-10-07-170811,170811,1,0,8,637,1.5,0.84492296,2
2020-10-08-170811,170811,1,0,6,638,1.3333333333333333,0.996498,3
2020-10-09-170811,170811,3,0,9,641,1.4166666666666667,1.8297124,4
2020-10-10-170811,170811,3,0,6,644,0.8333333333333334,2.1343079,5
2020-10-11-170811,170811,2,0,5,646,0.75,1.7062597,6
2020-10-12-170811,170811,3,0,7,649,0.25,1.6499574,0
2020-10-13-170811,170811,4,0,1,653,1.6666666666666667,2.8870628,1
2020-10-14-170811,170811,2,0,8,655,1.5833333333333333,1.1602085,2
2020-10-15-170811,170811,5,0,3,660,1.5833333333333333,2.3341992,3
2020-10-16-170811,170811,16,0,6,676,2.9166666666666665,7.9524975,4
2020-10-17-170811,170811,35,0,9,711,1.75,19.476292,5
2020-10-18-170811,170811,1,0,3,712,2.5,2.2555978,6
2020-10-19-170811,170811,1,1,2,713,2.4166666666666665,0.6268388,0
2020-10-20-170811,170811,1,1,5,714,2.333333333333333,1.4024324,1
2020-10-21-170811,170811,8,2,2,722,2.333333333333333,3.5298924,2
2020-10-22-170811,170811,6,0,6,728,2.4166666666666665,3.0050275,3
2020-10-23-170811,170811,9,0,11,737,3.6666666666666665,2.8023293,4
2020-10-24-170811,170811,6,0,3,743,3.4166666666666665,3.9493778,5
2020-10-25-170811,170811,5,0,14,748,3.1666666666666665,2.0740786,6
2020-10-26-170811,170811,7,0,3,755,3.1666666666666665,3.8222833,0
2020-10-27-170811,170811,1,0,4,756,2.333333333333333,1.1886337,1
2020-10-28-170811,170811,8,1,5,764,2.833333333333333,4.878219,2
2020-10-29-170811,170811,3,0,6,767,3.4166666666666665,1.7472094,3
2020-10-30-170811,170811,6,0,2,773,4.75,3.1963992,4
2020-10-31-170811,170811,9,2,0,782,2.5,4.6293483,5
2020-11-01-170811,170811,3,1,0,785,2.25,1.4743991,6
2020-11-02-170811,170811,2,0,0,787,2.0,2.0107958,0
2020-11-03-170811,170811,5,0,0,792,4.583333333333333,2.85237,1
2020-11-04-170811,170811,2,0,0,794,3.6666666666666665,1.8414327,2
2020-11-05-170811,170811,6,1,0,800,5.166666666666667,4.356618,3
2020-11-06-170811,170811,11,1,0,811,3.583333333333333,2.6676545,4
2020-11-07-170811,170811,3,1,0,814,4.0,2.0958588,5
2020-11-08-170811,170811,14,1,0,828,5.833333333333332,5.541288,6
2020-11-09-170811,170811,3,0,0,831,3.9166666666666665,1.9119679,0
2020-11-10-170811,170811,4,0,0,835,4.583333333333333,1.8592266,1
2020-11-11-170811,170811,5,0,0,840,5.083333333333333,3.141942,2
2020-11-12-170811,170811,6,0,0,846,4.75,3.2248385,3
2020-11-13-170811,170811,2,0,0,848,5.333333333333333,1.1166052,4
2020-03-01-170812,170812,0,0,0,0,0.0,0.0,6
2020-03-02-170812,170812,0,0,2,0,0.0,7.818069e-08,0
2020-03-03-170812,170812,0,0,0,0,0.0,0.0002591247,1
2020-03-04-170812,170812,0,0,4,0,0.0,2.470149e-05,2
2020-03-05-170812,170812,0,0,0,0,0.5,0.074638546,3
2020-03-06-170812,170812,0,0,2,0,0.0,4.6951547e-05,4
2020-03-07-170812,170812,0,0,1,0,0.5,0.08531456,5
2020-03-08-170812,170812,0,0,0,0,0.0,7.41705e-05,6
2020-03-09-170812,170812,0,0,2,0,1.0,0.1673423,0
2020-03-10-170812,170812,0,1,2,0,0.0,0.0020633347,1
2020-03-11-170812,170812,0,0,0,0,1.0,0.1809233,2
2020-03-12-170812,170812,2,0,0,2,0.5,0.21615744,3
2020-03-13-170812,170812,1,0,1,3,0.0,0.07074943,4
2020-03-14-170812,170812,0,0,0,3,0.0,0.019780336,5
2020-03-15-170812,170812,0,0,0,3,0.5,0.07228054,6
2020-03-16-170812,170812,2,0,0,5,2.5,0.7027364,0
2020-03-17-170812,170812,0,0,0,5,4.0,0.6723778,1
2020-03-18-170812,170812,4,0,0,9,4.0,0.84470785,2
2020-03-19-170812,170812,0,1,1,9,2.5,0.29319006,3
2020-03-20-170812,170812,2,0,0,11,2.5,0.52570087,4
2020-03-21-170812,170812,1,0,1,12,2.0,0.21018451,5
2020-03-22-170812,170812,0,1,1,12,1.0,0.11724856,6
2020-03-23-170812,170812,2,0,0,14,4.5,1.0140517,0
2020-03-24-170812,170812,2,0,3,16,5.0,0.7708807,1
2020-03-25-170812,170812,0,0,0,16,3.5,0.47922236,2
2020-03-26-170812,170812,0,0,1,16,4.5,0.7315645,3
2020-03-27-170812,170812,1,0,0,17,7.0,0.9893001,4
2020-03-28-170812,170812,0,0,0,17,1.5,0.20260678,5
2020-03-29-170812,170812,0,0,0,17,0.5,0.029090466,6
2020-03-30-170812,170812,0,0,0,17,5.5,0.8060657,0
2020-03-31-170812,170812,0,0,0,17,5.0,0.6096575,1
2020-04-01-170812,170812,0,0,0,17,13.5,1.7800361,2
2020-04-02-170812,170812,1,0,0,18,3.5,0.48929045,3
2020-04-03-170812,170812,0,0,0,18,1.5,0.2789836,4
2020-04-04-170812,170812,1,0,0,19,1.5,0.24141282,5
2020-04-05-170812,170812,1,0,0,20,1.5,0.20188072,6
2020-04-06-170812,170812,0,0,1,20,5.5,0.80324495,0
2020-04-07-170812,170812,3,0,0,23,5.0,0.8022702,1
2020-04-08-170812,170812,0,0,0,23,5.0,0.823254,2
2020-04-09-170812,170812,1,1,0,24,4.0,0.47664365,3
2020-04-10-170812,170812,0,0,0,24,1.5,0.20307776,4
2020-04-11-170812,170812,0,0,0,24,2.5,0.24595235,5
2020-04-12-170812,170812,0,0,0,24,1.0,0.11908239,6
2020-04-13-170812,170812,0,0,0,24,7.0,0.89411765,0
2020-04-14-170812,170812,0,0,0,24,10.0,1.4981401,1
2020-04-15-170812,170812,0,0,0,24,2.0,0.36198634,2
2020-04-16-170812,170812,0,0,1,24,11.0,2.0179572,3
2020-04-17-170812,170812,0,0,0,24,1.0,0.16801852,4
2020-04-18-170812,170812,0,0,0,24,6.0,0.7599197,5
2020-04-19-170812,170812,0,0,0,24,1.0,0.13679834,6
2020-04-20-170812,170812,1,0,0,25,20.0,3.6252456,0
2020-04-21-170812,170812,0,0,0,25,1.0,0.118264556,1
2020-04-22-170812,170812,0,0,0,25,3.5,0.5683416,2
2020-04-23-170812,170812,0,0,1,25,0.5,0.064286165,3
2020-04-24-170812,170812,0,0,0,25,3.0,0.68013364,4
2020-04-25-170812,170812,0,0,0,25,1.5,0.21809985,5
2020-04-26-170812,170812,0,0,0,25,0.0,0.12911035,6
2020-04-27-170812,170812,0,0,0,25,3.0,0.5117692,0
2020-04-28-170812,170812,0,0,0,25,2.5,0.37715504,1
2020-04-29-170812,170812,0,0,0,25,0.5,0.2193666,2
2020-04-30-170812,170812,1,0,0,26,1.5,0.30168015,3
2020-05-01-170812,170812,0,0,0,26,1.5,0.11944858,4
2020-05-02-170812,170812,0,0,0,26,1.5,0.2129303,5
2020-05-03-170812,170812,0,0,0,26,0.0,0.014446964,6
2020-05-04-170812,170812,0,0,0,26,5.0,0.823202,0
2020-05-05-170812,170812,0,0,0,26,3.5,0.7461351,1
2020-05-06-170812,170812,0,0,0,26,4.5,0.9335911,2
2020-05-07-170812,170812,1,0,0,27,2.5,0.556507,3
2020-05-08-170812,170812,0,0,1,27,2.0,0.44376603,4
2020-05-09-170812,170812,0,0,0,27,0.5,0.04407099,5
2020-05-10-170812,170812,0,0,0,27,0.0,0.012138672,6
2020-05-11-170812,170812,0,0,0,27,2.5,0.46518034,0
2020-05-12-170812,170812,0,1,0,27,5.5,0.392473,1
2020-05-13-170812,170812,0,1,0,27,4.5,0.7114441,2
2020-05-14-170812,170812,0,0,1,27,0.5,0.13566281,3
2020-05-15-170812,170812,0,0,0,27,2.5,0.35871902,4
2020-05-16-170812,170812,0,1,0,27,0.5,0.07654635,5
2020-05-17-170812,170812,0,0,0,27,0.0,0.0025062086,6
2020-05-18-170812,170812,0,0,0,27,2.0,0.3742055,0
2020-05-19-170812,170812,0,0,0,27,3.0,0.4573912,1
2020-05-20-170812,170812,0,0,0,27,0.5,0.10992743,2
2020-05-21-170812,170812,0,0,0,27,1.0,0.15702552,3
2020-05-22-170812,170812,1,0,0,28,0.0,0.13869672,4
2020-05-23-170812,170812,0,0,0,28,0.0,0.0054105213,5
2020-05-24-170812,170812,0,0,0,28,2.0,0.2487791,6
2020-05-25-170812,170812,0,0,0,28,2.5,0.4540327,0
2020-05-26-170812,170812,0,0,0,28,3.0,0.4917659,1
2020-05-27-170812,170812,0,0,0,28,0.0,0.031945653,2
2020-05-28-170812,170812,1,0,0,29,2.5,0.64277744,3
2020-05-29-170812,170812,0,0,0,29,1.0,0.19629765,4
2020-05-30-170812,170812,0,0,0,29,1.5,0.23295587,5
2020-05-31-170812,170812,0,0,0,29,0.5,0.022395259,6
2020-06-01-170812,170812,0,0,1,29,0.5,0.10348753,0
2020-06-02-170812,170812,0,0,0,29,1.5,0.26206177,1
2020-06-03-170812,170812,0,0,0,29,1.0,0.2105213,2
2020-06-04-170812,170812,0,0,0,29,0.5,0.14093137,3
2020-06-05-170812,170812,0,0,0,29,0.5,0.18622406,4
2020-06-06-170812,170812,0,0,0,29,0.5,0.10093919,5
2020-06-07-170812,170812,0,0,0,29,0.5,0.09580253,6
2020-06-08-170812,170812,0,0,0,29,1.5,0.18107216,0
2020-06-09-170812,170812,0,0,0,29,1.0,0.23866571,1
2020-06-10-170812,170812,0,0,0,29,2.0,0.40191644,2
2020-06-11-170812,170812,0,0,0,29,0.0,0.057492916,3
2020-06-12-170812,170812,0,0,2,29,1.0,0.19471082,4
2020-06-13-170812,170812,0,0,0,29,0.5,0.11684849,5
2020-06-14-170812,170812,0,0,0,29,0.5,0.0846947,6
2020-06-15-170812,170812,1,4,0,30,0.0,0.0952123,0
2020-06-16-170812,170812,0,0,0,30,1.5,0.3119847,1
2020-06-17-170812,170812,0,0,0,30,3.0,0.554994,2
2020-06-18-170812,170812,0,0,1,30,0.5,0.10516676,3
2020-06-19-170812,170812,0,0,0,30,1.0,0.20781615,4
2020-06-20-170812,170812,0,0,0,30,0.0,0.004600337,5
2020-06-21-170812,170812,0,0,0,30,0.0,0.019648422,6
2020-06-22-170812,170812,0,0,0,30,0.5,0.104607,0
2020-06-23-170812,170812,0,1,0,30,0.0,0.01607556,1
2020-06-24-170812,170812,0,1,0,30,0.0,0.002222298,2
2020-06-25-170812,170812,0,0,0,30,0.5,0.11814666,3
2020-06-26-170812,170812,2,0,0,32,0.5,0.31316695,4
2020-06-27-170812,170812,0,1,0,32,0.5,0.11415153,5
2020-06-28-170812,170812,0,0,0,32,1.0,0.22172709,6
2020-06-29-170812,170812,0,0,0,32,0.0,0.00040779685,0
2020-06-30-170812,170812,0,0,0,32,0.0,0.006277233,1
2020-07-01-170812,170812,0,0,0,32,0.5,0.111608036,2
2020-07-02-170812,170812,1,0,0,33,0.0,0.09202982,3
2020-07-03-170812,170812,0,0,0,33,0.5,0.031765204,4
2020-07-04-170812,170812,0,0,0,33,0.0,0.0063175196,5
2020-07-05-170812,170812,0,0,0,33,0.0,9.392163e-05,6
2020-07-06-170812,170812,0,0,0,33,0.0,0.011722443,0
2020-07-07-170812,170812,0,0,0,33,0.5,0.13450707,1
2020-07-08-170812,170812,0,3,1,33,0.5,0.14295377,2
2020-07-09-170812,170812,0,0,0,33,0.0,0.013757302,3
2020-07-10-170812,170812,0,0,0,33,0.5,0.0017702203,4
2020-07-11-170812,170812,0,0,1,33,0.0,0.00021418279,5
2020-07-12-170812,170812,0,0,0,33,0.0,0.013305039,6
2020-07-13-170812,170812,0,0,0,33,1.0,0.24522391,0
2020-07-14-170812,170812,0,0,0,33,0.5,0.12047753,1
2020-07-15-170812,170812,0,0,0,33,1.0,0.23235148,2
2020-07-16-170812,170812,0,0,0,33,1.5,0.36221865,3
2020-07-17-170812,170812,0,0,1,33,0.0,0.019185442,4
2020-07-18-170812,170812,0,0,0,33,0.0,0.013720416,5
2020-07-19-170812,170812,0,0,0,33,0.0,0.0022428161,6
2020-07-20-170812,170812,0,0,1,33,0.5,0.06053923,0
2020-07-21-170812,170812,0,0,0,33,0.5,0.12974374,1
2020-07-22-170812,170812,1,0,0,34,0.0,0.12962532,2
2020-07-23-170812,170812,0,0,0,34,0.5,0.38471097,3
2020-07-24-170812,170812,0,0,0,34,0.5,0.15747178,4
2020-07-25-170812,170812,1,0,0,35,0.0,0.13626719,5
2020-07-26-170812,170812,0,0,0,35,0.5,0.15427455,6
2020-07-27-170812,170812,0,0,0,35,0.0,0.023360927,0
2020-07-28-170812,170812,0,0,1,35,0.0,0.00122264,1
2020-07-29-170812,170812,0,0,3,35,1.0,0.2817292,2
2020-07-30-170812,170812,0,0,0,35,0.5,0.14215033,3
2020-07-31-170812,170812,1,0,4,36,1.0,0.40574098,4
2020-08-01-170812,170812,0,0,0,36,2.5,0.5793116,5
2020-08-02-170812,170812,0,0,2,36,0.0,0.0070875543,6
2020-08-03-170812,170812,1,0,0,37,0.0,0.16321202,0
2020-08-04-170812,170812,0,0,0,37,2.0,0.40602404,1
2020-08-05-170812,170812,0,0,0,37,6.5,1.8106991,2
2020-08-06-170812,170812,0,0,0,37,5.0,1.5221248,3
2020-08-07-170812,170812,0,1,0,37,1.0,0.2843188,4
2020-08-08-170812,170812,0,0,0,37,1.5,0.4931104,5
2020-08-09-170812,170812,0,0,0,37,0.0,0.19988447,6
2020-08-10-170812,170812,0,0,0,37,0.5,0.36979583,0
2020-08-11-170812,170812,1,0,0,38,2.0,0.7213066,1
2020-08-12-170812,170812,3,0,1,41,1.0,0.7568185,2
2020-08-13-170812,170812,0,0,2,41,3.0,0.47033468,3
2020-08-14-170812,170812,4,0,0,45,7.5,1.2813001,4
2020-08-15-170812,170812,0,0,0,45,0.5,0.19641608,5
2020-08-16-170812,170812,2,0,0,47,1.0,0.49883923,6
2020-08-17-170812,170812,0,0,0,47,0.5,0.15311095,0
2020-08-18-170812,170812,0,0,0,47,4.5,1.3682477,1
2020-08-19-170812,170812,0,0,0,47,2.0,0.7575025,2
2020-08-20-170812,170812,0,0,0,47,0.5,0.1850817,3
2020-08-21-170812,170812,0,0,1,47,0.5,0.09330849,4
2020-08-22-170812,170812,0,0,1,47,1.5,0.60699844,5
2020-08-23-170812,170812,0,0,0,47,0.0,0.035859797,6
2020-08-24-170812,170812,0,0,0,47,1.5,0.40562665,0
2020-08-25-170812,170812,0,0,0,47,1.0,0.2885536,1
2020-08-26-170812,170812,1,0,0,48,2.0,0.42767584,2
2020-08-27-170812,170812,2,0,1,50,2.5,0.845559,3
2020-08-28-170812,170812,0,0,1,50,1.0,0.14967296,4
2020-08-29-170812,170812,0,0,0,50,0.5,0.03788223,5
2020-08-30-170812,170812,0,0,0,50,1.0,0.13287865,6
2020-08-31-170812,170812,0,0,0,50,1.5,0.20081061,0
2020-09-01-170812,170812,0,0,0,50,2.5,0.5978157,1
2020-09-02-170812,170812,0,0,0,50,1.0,0.16267547,2
2020-09-03-170812,170812,0,0,1,50,0.5,0.2897745,3
2020-09-04-170812,170812,1,0,1,51,1.5,0.29275802,4
2020-09-05-170812,170812,1,0,0,52,0.5,0.051840924,5
2020-09-06-170812,170812,0,0,0,52,0.5,0.14633349,6
2020-09-07-170812,170812,0,0,3,52,0.5,0.1452617,0
2020-09-08-170812,170812,0,0,0,52,0.5,0.12387096,1
2020-09-09-170812,170812,0,0,0,52,1.0,0.24076617,2
2020-09-10-170812,170812,1,0,0,53,1.0,0.23165743,3
2020-09-11-170812,170812,1,0,0,54,0.0,0.1830295,4
2020-09-12-170812,170812,0,0,0,54,1.5,0.30142483,5
2020-09-13-170812,170812,0,0,0,54,0.0,0.026837772,6
2020-09-14-170812,170812,0,0,0,54,2.0,0.3368543,0
2020-09-15-170812,170812,0,0,0,54,0.0,0.038748387,1
2020-09-16-170812,170812,0,0,2,54,1.0,0.22040509,2
2020-09-17-170812,170812,1,0,0,55,0.0,0.09943791,3
2020-09-18-170812,170812,1,0,0,56,1.5,0.39057243,4
2020-09-19-170812,170812,0,0,0,56,0.0,0.004690518,5
2020-09-20-170812,170812,0,0,0,56,2.5,0.5868737,6
2020-09-21-170812,170812,3,0,0,59,0.5,0.2787052,0
2020-09-22-170812,170812,0,0,0,59,0.5,0.15891524,1
2020-09-23-170812,170812,0,0,0,59,2.5,0.523147,2
2020-09-24-170812,170812,0,0,0,59,2.5,0.45905963,3
2020-09-25-170812,170812,0,1,0,59,1.5,0.18564452,4
2020-09-26-170812,170812,0,1,0,59,2.5,0.40083757,5
2020-09-27-170812,170812,0,0,0,59,0.0,0.0054930807,6
2020-09-28-170812,170812,0,0,0,59,1.0,0.1908235,0
2020-09-29-170812,170812,0,0,1,59,0.0,0.018617293,1
2020-09-30-170812,170812,2,0,0,61,0.0,0.19002718,2
2020-10-01-170812,170812,0,0,0,61,0.5,0.100868024,3
2020-10-02-170812,170812,0,0,3,61,0.5,0.0009898457,4
2020-10-03-170812,170812,0,0,1,61,0.0,0.0011796941,5
2020-10-04-170812,170812,0,0,0,61,0.0,0.008511418,6
2020-10-05-170812,170812,0,0,0,61,2.5,0.24506736,0
2020-10-06-170812,170812,0,0,0,61,1.0,0.2301722,1
2020-10-07-170812,170812,0,0,0,61,1.0,0.15229355,2
2020-10-08-170812,170812,0,0,0,61,1.0,0.19043297,3
2020-10-09-170812,170812,0,0,0,61,1.5,0.36163944,4
2020-10-10-170812,170812,0,0,0,61,2.0,0.38041398,5
2020-10-11-170812,170812,0,0,0,61,1.0,0.27189067,6
2020-10-12-170812,170812,0,0,0,61,1.5,0.34038478,0
2020-10-13-170812,170812,1,0,1,62,2.0,0.54163444,1
2020-10-14-170812,170812,0,0,1,62,1.5,0.22153105,2
2020-10-15-170812,170812,0,0,0,62,3.0,0.43586868,3
2020-10-16-170812,170812,3,0,0,65,10.5,1.7034559,4
2020-10-17-170812,170812,1,0,0,66,19.5,3.6448,5
2020-10-18-170812,170812,0,0,0,66,1.0,0.31787848,6
2020-10-19-170812,170812,0,0,1,66,1.0,0.16796657,0
2020-10-20-170812,170812,0,0,0,66,0.5,0.30846575,1
2020-10-21-170812,170812,0,0,2,66,4.0,0.8494992,2
2020-10-22-170812,170812,0,0,1,66,4.5,0.7445379,3
2020-10-23-170812,170812,0,0,0,66,6.0,0.5242069,4
2020-10-24-170812,170812,0,0,1,66,4.5,0.70058143,5
2020-10-25-170812,170812,0,0,0,66,3.0,0.47576052,6
2020-10-26-170812,170812,0,0,0,66,4.0,0.7799616,0
2020-10-27-170812,170812,1,0,1,67,1.0,0.3124146,1
2020-10-28-170812,170812,1,0,4,68,6.5,1.1977239,2
2020-10-29-170812,170812,0,0,0,68,2.0,0.41291687,3
2020-10-30-170812,170812,0,0,0,68,5.0,0.6633936,4
2020-10-31-170812,170812,0,0,0,68,5.0,0.92655975,5
2020-11-01-170812,170812,0,0,0,68,2.0,0.31683114,6
2020-11-02-170812,170812,1,0,0,69,1.5,0.5487798,0
2020-11-03-170812,170812,0,0,0,69,3.0,0.6172446,1
2020-11-04-170812,170812,2,0,0,71,1.0,0.39964354,2
2020-11-05-170812,170812,1,0,0,72,3.0,0.97534996,3
2020-11-06-170812,170812,0,1,0,72,5.5,0.53325,4
2020-11-07-170812,170812,1,0,0,73,2.5,0.47512752,5
2020-11-08-170812,170812,0,0,0,73,7.0,1.1005229,6
2020-11-09-170812,170812,0,0,0,73,2.5,0.47966477,0
2020-11-10-170812,170812,1,0,0,74,2.5,0.46344516,1
2020-11-11-170812,170812,4,0,0,78,2.5,0.7639541,2
2020-11-12-170812,170812,0,0,0,78,5.0,0.7426,3
2020-11-13-170812,170812,0,0,0,78,3.5,0.25836843,4
2020-03-01-170902,170902,0,0,4,0,0.0,0.0021723807,6
2020-03-02-170902,170902,0,0,6,0,0.2,0.0040035783,0
2020-03-03-170902,170902,0,1,10,0,0.0,0.0010750958,1
2020-03-04-170902,170902,0,0,11,0,0.4,0.00046495334,2
2020-03-05-170902,170902,0,0,13,0,0.2,0.0034166756,3
2020-03-06-170902,170902,0,0,13,0,0.2,0.019342639,4
2020-03-07-170902,170902,0,0,6,0,0.6,0.004007338,5
2020-03-08-170902,170902,0,1,2,0,0.4,0.0014574204,6
2020-03-09-170902,170902,2,0,27,2,0.8,0.015748657,0
2020-03-10-170902,170902,0,0,19,2,0.8,0.011024427,1
2020-03-11-170902,170902,0,0,29,2,1.0,0.014263652,2
2020-03-12-170902,170902,2,0,16,4,2.4,0.017941032,3
2020-03-13-170902,170902,2,0,11,6,4.2,0.056140978,4
2020-03-14-170902,170902,1,0,73,7,1.8,0.012199102,5
2020-03-15-170902,170902,4,0,3,11,3.4,0.01593926,6
2020-03-16-170902,170902,6,0,10,17,11.8,0.15210825,0
2020-03-17-170902,170902,10,0,18,27,7.2,0.10644927,1
2020-03-18-170902,170902,11,0,7,38,14.8,0.16808048,2
2020-03-19-170902,170902,13,0,6,51,16.0,0.19746365,3
2020-03-20-170902,170902,13,0,8,64,14.4,0.15582845,4
2020-03-21-170902,170902,6,0,3,70,5.4,0.03298432,5
2020-03-22-170902,170902,2,1,3,72,6.2,0.023659153,6
2020-03-23-170902,170902,27,0,9,99,29.0,0.2764944,0
2020-03-24-170902,170902,19,0,11,118,28.4,0.1869581,1
2020-03-25-170902,170902,29,0,9,147,18.4,0.1868701,2
2020-03-26-170902,170902,16,0,7,163,17.2,0.20465092,3
2020-03-27-170902,170902,11,0,12,174,20.6,0.16851112,4
2020-03-28-170902,170902,73,0,3,247,6.0,0.031882335,5
2020-03-29-170902,170902,3,0,2,250,5.6,0.038635105,6
2020-03-30-170902,170902,10,0,16,260,19.8,0.14950426,0
2020-03-31-170902,170902,18,0,12,278,14.6,0.089704074,1
2020-04-01-170902,170902,7,0,8,285,11.8,0.1245811,2
2020-04-02-170902,170902,6,0,6,291,10.6,0.12784316,3
2020-04-03-170902,170902,8,0,6,299,8.6,0.15508528,4
2020-04-04-170902,170902,3,0,2,302,3.6,0.016195295,5
2020-04-05-170902,170902,3,0,1,305,1.8,0.0337554,6
2020-04-06-170902,170902,9,0,8,314,13.4,0.13910167,0
2020-04-07-170902,170902,11,2,5,325,27.0,0.17163986,1
2020-04-08-170902,170902,9,5,5,334,13.0,0.10655151,2
2020-04-09-170902,170902,7,0,0,341,7.4,0.05758265,3
2020-04-10-170902,170902,12,0,9,353,6.2,0.02992284,4
2020-04-11-170902,170902,3,0,0,356,5.4,0.099075325,5
2020-04-12-170902,170902,2,0,1,358,4.2,0.03273662,6
2020-04-13-170902,170902,16,0,4,374,59.0,0.13349636,0
2020-04-14-170902,170902,12,0,1,386,17.8,0.12289889,1
2020-04-15-170902,170902,8,0,2,394,12.2,0.10821046,2
2020-04-16-170902,170902,6,0,6,400,11.6,0.1102481,3
2020-04-17-170902,170902,6,0,1,406,7.6,0.08387803,4
2020-04-18-170902,170902,2,0,0,408,1.6,0.021883423,5
2020-04-19-170902,170902,1,0,0,409,0.8,0.0047035776,6
2020-04-20-170902,170902,8,0,4,417,8.0,0.10078958,0
2020-04-21-170902,170902,5,0,2,422,6.6,0.09727189,1
2020-04-22-170902,170902,5,0,2,427,10.6,0.06449062,2
2020-04-23-170902,170902,0,0,8,427,1.0,0.002824923,3
2020-04-24-170902,170902,9,0,10,436,4.0,0.07522521,4
2020-04-25-170902,170902,0,0,0,436,0.4,0.014452438,5
2020-04-26-170902,170902,1,0,0,437,0.2,0.017750243,6
2020-04-27-170902,170902,4,3,7,441,6.6,0.08346231,0
2020-04-28-170902,170902,1,0,3,442,4.2,0.08149736,1
2020-04-29-170902,170902,2,0,0,444,4.4,0.10753045,2
2020-04-30-170902,170902,6,0,0,450,7.0,0.06338823,3
2020-05-01-170902,170902,1,0,3,451,1.2,0.0035325494,4
2020-05-02-170902,170902,0,0,0,451,0.2,0.009496613,5
2020-05-03-170902,170902,0,0,0,451,0.2,0.0067950473,6
2020-05-04-170902,170902,4,0,6,455,9.6,0.09416979,0
2020-05-05-170902,170902,2,0,6,457,8.6,0.07883045,1
2020-05-06-170902,170902,2,0,7,459,7.0,0.12824905,2
2020-05-07-170902,170902,8,0,0,467,7.8,0.085276484,3
2020-05-08-170902,170902,10,0,7,477,9.4,0.07855598,4
2020-05-09-170902,170902,0,0,1,477,0.2,0.014904372,5
2020-05-10-170902,170902,0,2,0,477,0.2,0.010158806,6
2020-05-11-170902,170902,7,0,4,484,7.6,0.0737857,0
2020-05-12-170902,170902,3,0,2,487,6.8,0.06698117,1
2020-05-13-170902,170902,0,0,4,487,0.6,0.070407964,2
2020-05-14-170902,170902,0,0,5,487,6.0,0.07955235,3
2020-05-15-170902,170902,3,0,4,490,7.4,0.055994865,4
2020-05-16-170902,170902,0,0,0,490,0.2,0.016568147,5
2020-05-17-170902,170902,0,1,0,490,0.4,0.002738485,6
2020-05-18-170902,170902,6,0,3,496,4.4,0.08588478,0
2020-05-19-170902,170902,6,0,5,502,3.6,0.07939732,1
2020-05-20-170902,170902,7,0,1,509,5.2,0.053873923,2
2020-05-21-170902,170902,0,0,1,509,2.4,0.07824207,3
2020-05-22-170902,170902,7,0,4,516,2.2,0.058647875,4
2020-05-23-170902,170902,1,0,0,517,0.4,0.0030694432,5
2020-05-24-170902,170902,0,0,0,517,0.2,0.0015025529,6
2020-05-25-170902,170902,4,0,0,521,6.4,0.10368977,0
2020-05-26-170902,170902,2,0,1,523,6.4,0.06298058,1
2020-05-27-170902,170902,4,0,0,527,2.6,0.06888844,2
2020-05-28-170902,170902,5,1,0,532,3.4,0.07450533,3
2020-05-29-170902,170902,4,2,0,536,4.6,0.10236173,4
2020-05-30-170902,170902,0,0,0,536,0.4,0.013589735,5
2020-05-31-170902,170902,0,0,0,536,0.2,0.014732667,6
2020-06-01-170902,170902,3,0,0,539,5.2,0.13034594,0
2020-06-02-170902,170902,5,1,1,544,3.4,0.064293645,1
2020-06-03-170902,170902,1,0,1,545,3.2,0.08036132,2
2020-06-04-170902,170902,1,0,1,546,1.8,0.055783704,3
2020-06-05-170902,170902,4,0,1,550,3.2,0.043881357,4
2020-06-06-170902,170902,0,0,0,550,0.0,0.0024019345,5
2020-06-07-170902,170902,0,0,0,550,0.4,0.004859129,6
2020-06-08-170902,170902,0,0,1,550,2.2,0.08084969,0
2020-06-09-170902,170902,1,0,0,551,2.4,0.07478422,1
2020-06-10-170902,170902,0,0,0,551,2.4,0.09197479,2
2020-06-11-170902,170902,0,0,1,551,1.6,0.0844028,3
2020-06-12-170902,170902,0,0,0,551,1.8,0.058810215,4
2020-06-13-170902,170902,0,0,0,551,0.0,0.0089847315,5
2020-06-14-170902,170902,0,0,0,551,0.4,0.002950797,6
2020-06-15-170902,170902,0,0,0,551,1.8,0.0656305,0
2020-06-16-170902,170902,1,0,2,552,2.6,0.10731633,1
2020-06-17-170902,170902,1,0,3,553,1.6,0.06069256,2
2020-06-18-170902,170902,1,0,0,554,1.8,0.059503064,3
2020-06-19-170902,170902,1,0,0,555,1.8,0.08223885,4
2020-06-20-170902,170902,0,0,0,555,0.0,0.011465238,5
2020-06-21-170902,170902,0,0,0,555,0.0,0.0031758102,6
2020-06-22-170902,170902,1,0,2,556,2.6,0.048454896,0
2020-06-23-170902,170902,0,0,0,556,1.8,0.05758852,1
2020-06-24-170902,170902,0,0,0,556,1.6,0.029936772,2
2020-06-25-170902,170902,1,2,0,557,1.2,0.03799879,3
2020-06-26-170902,170902,0,1,1,557,1.8,0.034900565,4
2020-06-27-170902,170902,0,0,0,557,0.6,0.009942052,5
2020-06-28-170902,170902,0,0,0,557,0.2,0.005796483,6
2020-06-29-170902,170902,0,0,2,557,2.2,0.050422378,0
2020-06-30-170902,170902,2,0,0,559,0.6,0.027644651,1
2020-07-01-170902,170902,3,0,0,562,0.2,0.039139107,2
2020-07-02-170902,170902,0,0,0,562,1.2,0.026212422,3
2020-07-03-170902,170902,0,0,0,562,0.8,0.026609367,4
2020-07-04-170902,170902,0,0,0,562,0.6,0.004061209,5
2020-07-05-170902,170902,0,0,1,562,0.2,0.007866984,6
2020-07-06-170902,170902,2,0,0,564,0.6,0.03261614,0
2020-07-07-170902,170902,0,0,0,564,0.8,0.018791089,1
2020-07-08-170902,170902,0,0,1,564,1.0,0.01576385,2
2020-07-09-170902,170902,0,0,1,564,1.6,0.016464595,3
2020-07-10-170902,170902,1,0,2,565,0.2,0.030269548,4
2020-07-11-170902,170902,0,0,0,565,1.6,0.0076701576,5
2020-07-12-170902,170902,0,0,0,565,1.0,0.00477301,6
2020-07-13-170902,170902,2,0,0,567,0.6,0.029311927,0
2020-07-14-170902,170902,0,0,2,567,0.6,0.023088863,1
2020-07-15-170902,170902,0,0,0,567,1.2,0.023008332,2
2020-07-16-170902,170902,0,0,0,567,0.2,0.018157111,3
2020-07-17-170902,170902,0,0,0,567,1.2,0.048268206,4
2020-07-18-170902,170902,0,0,0,567,0.8,0.001637354,5
2020-07-19-170902,170902,1,0,1,568,0.2,0.0098895375,6
2020-07-20-170902,170902,0,0,0,568,0.6,0.02646697,0
2020-07-21-170902,170902,0,0,1,568,0.2,0.065905094,1
2020-07-22-170902,170902,1,0,0,569,0.8,0.024280956,2
2020-07-23-170902,170902,1,0,0,570,0.8,0.061430942,3
2020-07-24-170902,170902,2,0,0,572,0.6,0.037285686,4
2020-07-25-170902,170902,0,0,1,572,0.2,0.0060189324,5
2020-07-26-170902,170902,0,1,1,572,0.4,0.0024238378,6
2020-07-27-170902,170902,0,0,1,572,0.6,0.07948353,0
2020-07-28-170902,170902,2,0,2,574,1.2,0.033043075,1
2020-07-29-170902,170902,0,0,0,574,0.6,0.036068883,2
2020-07-30-170902,170902,0,0,1,574,2.0,0.047035497,3
2020-07-31-170902,170902,0,0,7,574,0.4,0.04567769,4
2020-08-01-170902,170902,0,0,1,574,2.0,0.008965723,5
2020-08-02-170902,170902,1,0,1,575,0.4,0.022931755,6
2020-08-03-170902,170902,0,0,3,575,1.6,0.032484528,0
2020-08-04-170902,170902,1,0,4,576,2.0,0.038838472,1
2020-08-05-170902,170902,0,0,9,576,1.4,0.08522608,2
2020-08-06-170902,170902,0,0,2,576,2.2,0.038867887,3
2020-08-07-170902,170902,0,0,0,576,1.4,0.05092959,4
2020-08-08-170902,170902,1,1,0,577,6.0,0.045665774,5
2020-08-09-170902,170902,1,0,0,578,2.0,0.02279913,6
2020-08-10-170902,170902,1,0,0,579,2.8,0.065407515,0
2020-08-11-170902,170902,2,0,7,581,2.4,0.10682179,1
2020-08-12-170902,170902,0,0,14,581,2.2,0.05412104,2
2020-08-13-170902,170902,1,0,9,582,4.0,0.10840569,3
2020-08-14-170902,170902,7,0,6,589,5.2,0.09383058,4
2020-08-15-170902,170902,1,0,2,590,1.0,0.05117836,5
2020-08-16-170902,170902,1,0,0,591,3.4,0.03559815,6
2020-08-17-170902,170902,3,0,14,594,2.0,0.11026793,0
2020-08-18-170902,170902,4,0,8,598,4.4,0.11362585,1
2020-08-19-170902,170902,9,0,3,607,3.8,0.15265934,2
2020-08-20-170902,170902,2,0,6,609,5.8,0.18837352,3
2020-08-21-170902,170902,0,0,13,609,2.8,0.1587919,4
2020-08-22-170902,170902,0,0,0,609,1.2,0.06790391,5
2020-08-23-170902,170902,0,0,3,609,1.4,0.04431949,6
2020-08-24-170902,170902,0,0,12,609,6.4,0.17631397,0
2020-08-25-170902,170902,7,0,3,616,13.8,0.26965472,1
2020-08-26-170902,170902,14,0,10,630,10.6,0.19671646,2
2020-08-27-170902,170902,9,0,6,639,11.4,0.2530125,3
2020-08-28-170902,170902,6,0,7,645,10.6,0.31453285,4
2020-08-29-170902,170902,2,0,0,647,1.6,0.08520897,5
2020-08-30-170902,170902,0,0,4,647,1.0,0.10983475,6
2020-08-31-170902,170902,14,0,8,661,12.6,0.13329019,0
2020-09-01-170902,170902,8,0,13,669,6.4,0.11119383,1
2020-09-02-170902,170902,3,0,8,672,9.8,0.20828606,2
2020-09-03-170902,170902,6,1,3,678,9.2,0.16238667,3
2020-09-04-170902,170902,13,0,10,691,11.0,0.19496065,4
2020-09-05-170902,170902,0,1,3,691,1.0,0.08909456,5
2020-09-06-170902,170902,3,0,1,694,2.2,0.10496024,6
2020-09-07-170902,170902,12,1,8,706,9.0,0.26761714,0
2020-09-08-170902,170902,3,0,12,709,1.8,0.1716635,1
2020-09-09-170902,170902,10,0,11,719,9.6,0.2217305,2
2020-09-10-170902,170902,6,1,7,725,8.0,0.30142197,3
2020-09-11-170902,170902,7,0,16,732,8.2,0.32555178,4
2020-09-12-170902,170902,0,0,0,732,1.0,0.11707037,5
2020-09-13-170902,170902,4,0,0,736,1.2,0.08185792,6
2020-09-14-170902,170902,8,0,13,744,12.6,0.30249462,0
2020-09-15-170902,170902,13,0,5,757,7.8,0.3179814,1
2020-09-16-170902,170902,8,0,6,765,14.8,0.36338985,2
2020-09-17-170902,170902,3,0,7,768,14.8,0.51802665,3
2020-09-18-170902,170902,10,0,12,778,6.4,0.49096164,4
2020-09-19-170902,170902,3,0,0,781,1.4,0.2459569,5
2020-09-20-170902,170902,1,0,0,782,1.8,0.084115006,6
2020-09-21-170902,170902,8,0,11,790,12.8,0.27036926,0
2020-09-22-170902,170902,12,1,10,802,11.0,0.2697801,1
2020-09-23-170902,170902,11,0,14,813,11.0,0.29825288,2
2020-09-24-170902,170902,7,0,1,820,7.2,0.40410483,3
2020-09-25-170902,170902,16,0,5,836,15.0,0.34274846,4
2020-09-26-170902,170902,0,0,0,836,4.4,0.24359715,5
2020-09-27-170902,170902,0,0,0,836,3.2,0.08582003,6
2020-09-28-170902,170902,13,0,0,849,7.8,0.1881402,0
2020-09-29-170902,170902,5,0,12,854,7.2,0.18665281,1
2020-09-30-170902,170902,6,0,8,860,7.2,0.18178284,2
2020-10-01-170902,170902,7,0,21,867,8.4,0.33262944,3
2020-10-02-170902,170902,12,0,11,879,9.4,0.35915062,4
2020-10-03-170902,170902,0,0,1,879,1.4,0.15063484,5
2020-10-04-170902,170902,0,0,1,879,1.2,0.047860388,6
2020-10-05-170902,170902,11,1,19,890,15.6,0.2699155,0
2020-10-06-170902,170902,10,2,13,900,10.6,0.41142526,1
2020-10-07-170902,170902,14,1,18,914,11.2,0.3285241,2
2020-10-08-170902,170902,1,0,18,915,9.8,0.6303605,3
2020-10-09-170902,170902,5,1,12,920,9.4,0.49126104,4
2020-10-10-170902,170902,0,0,1,920,1.0,0.15953888,5
2020-10-11-170902,170902,0,0,1,920,0.4,0.13421237,6
2020-10-12-170902,170902,0,0,38,920,1.8,0.08074995,0
2020-10-13-170902,170902,12,0,17,932,12.0,0.3002171,1
2020-10-14-170902,170902,8,0,21,940,9.2,0.38072693,2
2020-10-15-170902,170902,21,0,58,961,11.6,0.2832957,3
2020-10-16-170902,170902,11,0,35,972,8.8,0.38146916,4
2020-10-17-170902,170902,1,0,3,973,2.8,0.20370126,5
2020-10-18-170902,170902,1,0,25,974,3.4,0.118997335,6
2020-10-19-170902,170902,19,0,3,993,16.8,0.28481457,0
2020-10-20-170902,170902,13,1,14,1006,14.0,0.48667094,1
2020-10-21-170902,170902,18,0,36,1024,20.8,0.42937055,2
2020-10-22-170902,170902,18,0,21,1042,22.4,0.39018372,3
2020-10-23-170902,170902,12,0,37,1054,35.0,0.6831513,4
2020-10-24-170902,170902,1,1,4,1055,1.4,0.20322244,5
2020-10-25-170902,170902,1,2,5,1056,3.0,0.089103885,6
2020-10-26-170902,170902,38,1,12,1094,26.8,0.5159125,0
2020-10-27-170902,170902,17,2,27,1111,18.4,0.5266868,1
2020-10-28-170902,170902,21,0,29,1132,21.2,0.69133,2
2020-10-29-170902,170902,58,0,22,1190,36.6,0.55039746,3
2020-10-30-170902,170902,35,0,21,1225,33.0,0.7127883,4
2020-10-31-170902,170902,3,0,0,1228,5.2,0.26907697,5
2020-11-01-170902,170902,25,1,0,1253,5.2,0.15658507,6
2020-11-02-170902,170902,3,0,0,1256,2.6,0.1330024,0
2020-11-03-170902,170902,14,0,0,1270,25.8,0.4575539,1
2020-11-04-170902,170902,36,2,0,1306,22.2,0.62683785,2
2020-11-05-170902,170902,21,0,0,1327,31.8,0.70595324,3
2020-11-06-170902,170902,37,0,0,1364,28.4,0.661914,4
2020-11-07-170902,170902,4,1,0,1368,3.2,0.20141281,5
2020-11-08-170902,170902,5,1,0,1373,3.2,0.097684905,6
2020-11-09-170902,170902,12,2,0,1385,26.6,0.34165034,0
2020-11-10-170902,170902,27,4,0,1412,18.6,0.40115738,1
2020-11-11-170902,170902,29,1,0,1441,21.4,0.4792623,2
2020-11-12-170902,170902,22,1,0,1463,17.4,0.43373412,3
2020-11-13-170902,170902,21,1,0,1484,26.0,0.37437427,4
2020-03-01-170903,170903,0,0,2,0,0.0,0.0025511151,6
2020-03-02-170903,170903,0,0,7,0,0.25,0.007132704,0
2020-03-03-170903,170903,0,0,2,0,0.0,0.0029346482,1
2020-03-04-170903,170903,0,0,11,0,0.25,0.0018196708,2
2020-03-05-170903,170903,0,0,9,0,0.0,0.0050600716,3
2020-03-06-170903,170903,0,0,16,0,0.0,0.014582837,4
2020-03-07-170903,170903,0,0,4,0,0.5,0.0025930293,5
2020-03-08-170903,170903,0,1,1,0,0.25,0.00055611954,6
2020-03-09-170903,170903,2,0,20,2,0.25,0.020761237,0
2020-03-10-170903,170903,1,0,12,3,1.0,0.011978906,1
2020-03-11-170903,170903,0,0,11,3,0.75,0.017965313,2
2020-03-12-170903,170903,2,0,9,5,1.25,0.0123240175,3
2020-03-13-170903,170903,3,0,12,8,2.75,0.03916038,4
2020-03-14-170903,170903,0,0,2,8,1.75,0.007139331,5
2020-03-15-170903,170903,2,0,5,10,2.75,0.020115735,6
2020-03-16-170903,170903,7,0,16,17,6.75,0.11667193,0
2020-03-17-170903,170903,2,0,6,19,8.25,0.05648902,1
2020-03-18-170903,170903,11,0,4,30,13.5,0.082547486,2
2020-03-19-170903,170903,9,0,4,39,17.25,0.1726487,3
2020-03-20-170903,170903,16,0,3,55,15.25,0.1255525,4
2020-03-21-170903,170903,4,0,0,59,4.25,0.018560028,5
2020-03-22-170903,170903,1,0,1,60,6.0,0.0081339935,6
2020-03-23-170903,170903,20,0,6,80,35.75,0.20213832,0
2020-03-24-170903,170903,12,0,3,92,28.75,0.09981564,1
2020-03-25-170903,170903,11,0,8,103,23.0,0.116882384,2
2020-03-26-170903,170903,9,0,5,112,23.5,0.08781417,3
2020-03-27-170903,170903,12,0,3,124,22.25,0.14406224,4
2020-03-28-170903,170903,2,0,0,126,6.0,0.012573386,5
2020-03-29-170903,170903,5,0,1,131,3.75,0.012270934,6
2020-03-30-170903,170903,16,0,6,147,24.0,0.07132229,0
2020-03-31-170903,170903,6,0,4,153,11.25,0.045786902,1
2020-04-01-170903,170903,4,0,5,157,14.5,0.05568408,2
2020-04-02-170903,170903,4,0,7,161,15.0,0.06725984,3
2020-04-03-170903,170903,3,0,2,164,14.5,0.0922438,4
2020-04-04-170903,170903,0,0,2,164,4.25,0.005640652,5
2020-04-05-170903,170903,1,1,0,165,1.5,0.0043936768,6
2020-04-06-170903,170903,6,1,4,171,18.0,0.0584572,0
2020-04-07-170903,170903,3,0,6,174,13.5,0.08036565,1
2020-04-08-170903,170903,8,3,3,182,11.0,0.121956766,2
2020-04-09-170903,170903,5,0,0,187,8.75,0.03696785,3
2020-04-10-170903,170903,3,1,2,190,8.0,0.011447987,4
2020-04-11-170903,170903,0,0,1,190,4.5,0.016479276,5
2020-04-12-170903,170903,1,0,0,191,4.0,0.018316759,6
2020-04-13-170903,170903,6,0,5,197,60.75,0.09575667,0
2020-04-14-170903,170903,4,0,9,201,11.0,0.061824337,1
2020-04-15-170903,170903,5,0,6,206,14.5,0.09256956,2
2020-04-16-170903,170903,7,0,4,213,8.25,0.058486745,3
2020-04-17-170903,170903,2,0,1,215,7.5,0.05821822,4
2020-04-18-170903,170903,2,0,0,217,1.75,0.0059057954,5
2020-04-19-170903,170903,0,0,0,217,1.5,0.00062952976,6
2020-04-20-170903,170903,4,0,6,221,7.0,0.06293067,0
2020-04-21-170903,170903,6,0,10,227,7.0,0.069336876,1
2020-04-22-170903,170903,3,0,3,230,9.0,0.03921317,2
2020-04-23-170903,170903,0,0,5,230,0.25,0.004883669,3
2020-04-24-170903,170903,2,0,1,232,5.5,0.05767085,4
2020-04-25-170903,170903,1,0,0,233,0.5,0.004463274,5
2020-04-26-170903,170903,0,0,0,233,0.25,0.0039538867,6
2020-04-27-170903,170903,5,0,6,238,7.5,0.035231236,0
2020-04-28-170903,170903,9,0,6,247,2.0,0.044427678,1
2020-04-29-170903,170903,6,0,0,253,6.5,0.05105339,2
2020-04-30-170903,170903,4,0,1,257,8.25,0.054223415,3
2020-05-01-170903,170903,1,0,0,258,1.0,0.0015796369,4
2020-05-02-170903,170903,0,0,0,258,0.0,0.0042710556,5
2020-05-03-170903,170903,0,0,0,258,0.25,0.0010996782,6
2020-05-04-170903,170903,6,0,1,264,7.5,0.044465274,0
2020-05-05-170903,170903,10,0,4,274,7.75,0.05229101,1
2020-05-06-170903,170903,3,0,2,277,6.75,0.07260349,2
2020-05-07-170903,170903,5,0,4,282,7.5,0.06445581,3
2020-05-08-170903,170903,1,0,3,283,8.0,0.05249263,4
2020-05-09-170903,170903,0,2,0,283,0.5,0.005153712,5
2020-05-10-170903,170903,0,0,1,283,0.25,0.0039303508,6
2020-05-11-170903,170903,6,0,5,289,4.75,0.059646096,0
2020-05-12-170903,170903,6,0,6,295,4.75,0.033508494,1
2020-05-13-170903,170903,0,0,5,295,0.5,0.03564173,2
2020-05-14-170903,170903,1,0,2,296,4.0,0.055395875,3
2020-05-15-170903,170903,0,0,7,296,4.5,0.05126988,4
2020-05-16-170903,170903,0,0,0,296,0.25,0.0051836446,5
2020-05-17-170903,170903,0,0,0,296,0.5,0.00073058,6
2020-05-18-170903,170903,1,0,2,297,4.25,0.06482917,0
2020-05-19-170903,170903,4,0,4,301,3.75,0.060563345,1
2020-05-20-170903,170903,2,0,4,303,5.5,0.043068107,2
2020-05-21-170903,170903,4,0,6,307,3.0,0.05936819,3
2020-05-22-170903,170903,3,0,3,310,3.25,0.04236928,4
2020-05-23-170903,170903,0,0,0,310,0.75,0.0004243038,5
2020-05-24-170903,170903,1,0,0,311,0.0,0.0026372066,6
2020-05-25-170903,170903,5,0,1,316,5.0,0.09181944,0
2020-05-26-170903,170903,6,0,2,322,2.5,0.046691865,1
2020-05-27-170903,170903,5,0,1,327,2.0,0.043235406,2
2020-05-28-170903,170903,2,0,0,329,3.25,0.055727344,3
2020-05-29-170903,170903,7,1,0,336,3.25,0.0679257,4
2020-05-30-170903,170903,0,0,0,336,0.0,0.007357524,5
2020-05-31-170903,170903,0,0,0,336,0.25,0.013244685,6
2020-06-01-170903,170903,2,0,4,338,4.25,0.10762919,0
2020-06-02-170903,170903,4,0,0,342,3.75,0.057487197,1
2020-06-03-170903,170903,4,0,0,346,4.0,0.06555117,2
2020-06-04-170903,170903,6,0,1,352,2.25,0.03480317,3
2020-06-05-170903,170903,3,0,0,355,3.25,0.0361835,4
2020-06-06-170903,170903,0,0,0,355,0.25,0.001702028,5
2020-06-07-170903,170903,0,0,0,355,0.25,0.0024480058,6
2020-06-08-170903,170903,1,0,2,356,3.5,0.07372981,0
2020-06-09-170903,170903,2,0,0,358,2.5,0.06188929,1
2020-06-10-170903,170903,1,0,1,359,2.25,0.081209,2
2020-06-11-170903,170903,0,0,1,359,1.25,0.06586473,3
2020-06-12-170903,170903,0,0,2,359,1.75,0.03869755,4
2020-06-13-170903,170903,0,2,0,359,0.25,0.004651637,5
2020-06-14-170903,170903,0,0,0,359,0.5,0.004731599,6
2020-06-15-170903,170903,4,0,2,363,1.5,0.072857484,0
2020-06-16-170903,170903,0,0,1,363,2.5,0.07459231,1
2020-06-17-170903,170903,0,1,0,363,1.75,0.057245664,2
2020-06-18-170903,170903,1,0,0,364,1.75,0.048539963,3
2020-06-19-170903,170903,0,0,0,364,2.5,0.07296566,4
2020-06-20-170903,170903,0,0,0,364,0.0,0.009090426,5
2020-06-21-170903,170903,0,0,0,364,0.0,0.0027700942,6
2020-06-22-170903,170903,2,0,0,366,2.0,0.040200077,0
2020-06-23-170903,170903,0,1,1,366,2.5,0.049539853,1
2020-06-24-170903,170903,1,0,0,367,2.0,0.025549114,2
2020-06-25-170903,170903,1,0,0,368,2.0,0.030151937,3
2020-06-26-170903,170903,2,0,0,370,4.5,0.020905564,4
2020-06-27-170903,170903,0,0,0,370,0.25,0.008894904,5
2020-06-28-170903,170903,0,0,0,370,0.5,0.003224652,6
2020-06-29-170903,170903,2,0,0,372,1.75,0.045574307,0
2020-06-30-170903,170903,1,0,0,373,0.5,0.020585729,1
2020-07-01-170903,170903,0,0,0,373,0.75,0.030544955,2
2020-07-02-170903,170903,0,0,0,373,1.25,0.02092076,3
2020-07-03-170903,170903,0,0,0,373,1.0,0.023253396,4
2020-07-04-170903,170903,0,0,0,373,0.5,0.002990557,5
2020-07-05-170903,170903,0,0,0,373,0.25,0.0046464726,6
2020-07-06-170903,170903,0,0,0,373,0.75,0.032634504,0
2020-07-07-170903,170903,1,0,0,374,0.5,0.02431288,1
2020-07-08-170903,170903,0,0,2,374,0.75,0.011940211,2
2020-07-09-170903,170903,0,0,0,374,2.5,0.012687229,3
2020-07-10-170903,170903,0,0,0,374,1.5,0.021239031,4
2020-07-11-170903,170903,0,0,0,374,0.25,0.0032261298,5
2020-07-12-170903,170903,0,1,0,374,0.0,0.0046748947,6
2020-07-13-170903,170903,0,0,0,374,0.75,0.02194304,0
2020-07-14-170903,170903,0,0,0,374,0.5,0.020963028,1
2020-07-15-170903,170903,0,0,0,374,1.25,0.022586942,2
2020-07-16-170903,170903,0,0,0,374,1.0,0.023970023,3
2020-07-17-170903,170903,0,0,0,374,0.25,0.04958972,4
2020-07-18-170903,170903,0,0,0,374,0.75,0.0029940251,5
2020-07-19-170903,170903,0,0,0,374,0.0,0.008214232,6
2020-07-20-170903,170903,0,0,0,374,0.25,0.029112643,0
2020-07-21-170903,170903,0,0,1,374,1.0,0.050446533,1
2020-07-22-170903,170903,2,0,4,376,1.5,0.018317094,2
2020-07-23-170903,170903,0,0,0,376,1.25,0.06630669,3
2020-07-24-170903,170903,0,0,5,376,2.25,0.034445297,4
2020-07-25-170903,170903,0,0,0,376,0.25,0.0053368732,5
2020-07-26-170903,170903,0,0,0,376,0.5,0.0021713816,6
2020-07-27-170903,170903,0,0,1,376,1.0,0.06517556,0
2020-07-28-170903,170903,0,0,0,376,0.5,0.019067565,1
2020-07-29-170903,170903,0,0,3,376,0.75,0.03399167,2
2020-07-30-170903,170903,0,0,0,376,1.75,0.065626636,3
2020-07-31-170903,170903,0,0,7,376,0.75,0.037664272,4
2020-08-01-170903,170903,0,0,3,376,1.0,0.008661558,5
2020-08-02-170903,170903,0,0,2,376,0.0,0.030221874,6
2020-08-03-170903,170903,0,0,4,376,1.75,0.030800547,0
2020-08-04-170903,170903,1,0,0,377,2.5,0.03675784,1
2020-08-05-170903,170903,4,0,3,381,2.25,0.07683446,2
2020-08-06-170903,170903,0,0,4,381,2.5,0.0455637,3
2020-08-07-170903,170903,5,0,5,386,1.75,0.059720952,4
2020-08-08-170903,170903,0,0,0,386,3.0,0.043350313,5
2020-08-09-170903,170903,0,0,1,386,0.75,0.018184073,6
2020-08-10-170903,170903,1,2,1,387,2.25,0.055510394,0
2020-08-11-170903,170903,0,0,4,387,1.75,0.078695156,1
2020-08-12-170903,170903,3,0,3,390,1.75,0.043468133,2
2020-08-13-170903,170903,0,0,7,390,4.25,0.09495128,3
2020-08-14-170903,170903,7,0,5,397,3.75,0.08942103,4
2020-08-15-170903,170903,3,1,5,400,2.5,0.0594963,5
2020-08-16-170903,170903,2,0,0,402,2.25,0.04432608,6
2020-08-17-170903,170903,4,0,6,406,4.5,0.100760095,0
2020-08-18-170903,170903,0,0,7,406,4.0,0.13966791,1
2020-08-19-170903,170903,3,0,2,409,3.0,0.15398441,2
2020-08-20-170903,170903,4,0,2,413,6.25,0.163308,3
2020-08-21-170903,170903,5,0,3,418,3.0,0.15776081,4
2020-08-22-170903,170903,0,0,3,418,2.0,0.04739665,5
2020-08-23-170903,170903,1,1,0,419,2.0,0.037116013,6
2020-08-24-170903,170903,1,0,7,420,5.5,0.17331256,0
2020-08-25-170903,170903,4,0,0,424,12.0,0.23595978,1
2020-08-26-170903,170903,3,0,7,427,9.0,0.1481808,2
2020-08-27-170903,170903,7,0,3,434,14.0,0.2104803,3
2020-08-28-170903,170903,5,0,5,439,12.5,0.28224376,4
2020-08-29-170903,170903,5,0,1,444,3.0,0.05877545,5
2020-08-30-170903,170903,0,0,0,444,3.25,0.12565431,6
2020-08-31-170903,170903,6,0,5,450,11.25,0.12945092,0
2020-09-01-170903,170903,7,0,2,457,5.5,0.09979264,1
2020-09-02-170903,170903,2,0,3,459,9.0,0.14229324,2
2020-09-03-170903,170903,2,0,3,461,8.0,0.15485519,3
2020-09-04-170903,170903,3,0,2,464,9.75,0.14534298,4
2020-09-05-170903,170903,3,0,1,467,2.5,0.082439154,5
2020-09-06-170903,170903,0,0,0,467,2.25,0.09657898,6
2020-09-07-170903,170903,7,0,3,474,14.5,0.24327181,0
2020-09-08-170903,170903,0,0,1,474,1.25,0.13918643,1
2020-09-09-170903,170903,7,0,4,481,11.0,0.24588457,2
2020-09-10-170903,170903,3,0,0,484,8.75,0.251724,3
2020-09-11-170903,170903,5,0,4,489,14.0,0.23357373,4
2020-09-12-170903,170903,1,0,3,490,2.5,0.101593345,5
2020-09-13-170903,170903,0,0,0,490,1.75,0.07307826,6
2020-09-14-170903,170903,5,0,10,495,15.25,0.3262812,0
2020-09-15-170903,170903,2,1,3,497,8.25,0.3193499,1
2020-09-16-170903,170903,3,0,5,500,16.5,0.30015275,2
2020-09-17-170903,170903,3,0,8,503,14.5,0.36367458,3
2020-09-18-170903,170903,2,1,4,505,7.0,0.40151447,4
2020-09-19-170903,170903,1,0,0,506,1.5,0.21306762,5
2020-09-20-170903,170903,0,1,0,506,1.0,0.08143489,6
2020-09-21-170903,170903,3,0,6,509,12.5,0.2181247,0
2020-09-22-170903,170903,1,3,1,510,6.0,0.22108969,1
2020-09-23-170903,170903,4,1,6,514,11.5,0.3030584,2
2020-09-24-170903,170903,0,0,2,514,10.25,0.41172144,3
2020-09-25-170903,170903,4,0,2,518,16.5,0.30775213,4
2020-09-26-170903,170903,3,0,1,521,2.25,0.2210804,5
2020-09-27-170903,170903,0,0,0,521,3.5,0.09306883,6
2020-09-28-170903,170903,10,0,1,531,9.25,0.16650817,0
2020-09-29-170903,170903,3,0,3,534,7.75,0.15736508,1
2020-09-30-170903,170903,5,0,6,539,8.0,0.19756563,2
2020-10-01-170903,170903,8,0,2,547,6.0,0.31979266,3
2020-10-02-170903,170903,4,0,6,551,8.5,0.28353772,4
2020-10-03-170903,170903,0,1,0,551,1.25,0.12868571,5
2020-10-04-170903,170903,0,1,1,551,5.0,0.047114767,6
2020-10-05-170903,170903,6,0,10,557,12.75,0.20404664,0
2020-10-06-170903,170903,1,0,5,558,12.75,0.36822066,1
2020-10-07-170903,170903,6,0,9,564,9.5,0.2787571,2
2020-10-08-170903,170903,2,1,8,566,7.25,0.51869345,3
2020-10-09-170903,170903,2,1,19,568,11.0,0.45190883,4
2020-10-10-170903,170903,1,0,2,569,2.25,0.10983969,5
2020-10-11-170903,170903,0,0,1,569,1.0,0.14967057,6
2020-10-12-170903,170903,1,0,20,570,2.25,0.091462635,0
2020-10-13-170903,170903,3,0,10,573,11.25,0.26571402,1
2020-10-14-170903,170903,6,0,14,579,9.75,0.33987495,2
2020-10-15-170903,170903,2,0,16,581,12.5,0.29170224,3
2020-10-16-170903,170903,6,0,14,587,12.5,0.3239452,4
2020-10-17-170903,170903,0,0,1,587,3.5,0.1861608,5
2020-10-18-170903,170903,1,0,6,588,1.75,0.13752748,6
2020-10-19-170903,170903,10,0,0,598,15.75,0.2645585,0
2020-10-20-170903,170903,5,1,15,603,15.0,0.4249824,1
2020-10-21-170903,170903,9,0,14,612,19.0,0.3737074,2
2020-10-22-170903,170903,8,0,18,620,20.75,0.32138327,3
2020-10-23-170903,170903,19,0,17,639,28.0,0.75581145,4
2020-10-24-170903,170903,2,0,2,641,2.5,0.18503945,5
2020-10-25-170903,170903,1,0,3,642,2.25,0.115277365,6
2020-10-26-170903,170903,20,0,12,662,26.5,0.4694127,0
2020-10-27-170903,170903,10,0,10,672,13.75,0.47936514,1
2020-10-28-170903,170903,14,0,6,686,25.0,0.5285537,2
2020-10-29-170903,170903,16,0,13,702,35.75,0.57459396,3
2020-10-30-170903,170903,14,1,11,716,40.5,0.5494378,4
2020-10-31-170903,170903,1,0,0,717,8.25,0.2357563,5
2020-11-01-170903,170903,6,0,0,723,2.0,0.13242394,6
2020-11-02-170903,170903,0,1,0,723,4.0,0.13096437,0
2020-11-03-170903,170903,15,0,0,738,27.75,0.39749175,1
2020-11-04-170903,170903,14,0,0,752,23.75,0.5509673,2
2020-11-05-170903,170903,18,2,0,770,30.25,0.6248834,3
2020-11-06-170903,170903,17,0,0,787,23.25,0.49263152,4
2020-11-07-170903,170903,2,2,0,789,5.75,0.22183166,5
2020-11-08-170903,170903,3,0,0,792,3.5,0.07702179,6
2020-11-09-170903,170903,12,0,0,804,25.25,0.33631763,0
2020-11-10-170903,170903,10,0,0,814,21.25,0.36147386,1
2020-11-11-170903,170903,6,0,0,820,24.0,0.38495544,2
2020-11-12-170903,170903,13,0,0,833,18.75,0.4527423,3
2020-11-13-170903,170903,11,4,0,844,23.5,0.34202448,4
2020-03-01-170906,170906,0,0,0,0,0.0,0.0010945655,6
2020-03-02-170906,170906,0,0,5,0,0.2,0.0024352975,0
2020-03-03-170906,170906,0,0,5,0,0.0,0.00064706773,1
2020-03-04-170906,170906,0,0,16,0,0.2,0.00024298254,2
2020-03-05-170906,170906,0,0,10,0,0.0,0.0022119726,3
2020-03-06-170906,170906,0,0,7,0,0.0,0.010118056,4
2020-03-07-170906,170906,2,0,6,2,0.0,0.00230951,5
2020-03-08-170906,170906,1,0,5,3,0.2,0.00051539566,6
2020-03-09-170906,170906,0,0,26,3,1.0,0.008228543,0
2020-03-10-170906,170906,1,0,21,4,0.8,0.0053739385,1
2020-03-11-170906,170906,0,0,19,4,0.8,0.0082765445,2
2020-03-12-170906,170906,2,0,17,6,1.6,0.009956003,3
2020-03-13-170906,170906,2,0,18,8,3.0,0.031046191,4
2020-03-14-170906,170906,1,0,6,9,1.6,0.0069729444,5
2020-03-15-170906,170906,0,0,2,9,4.0,0.00914562,6
2020-03-16-170906,170906,5,1,10,14,8.8,0.077042386,0
2020-03-17-170906,170906,5,0,8,19,8.6,0.05680525,1
2020-03-18-170906,170906,16,0,13,35,12.2,0.091777556,2
2020-03-19-170906,170906,10,0,8,45,17.4,0.11291499,3
2020-03-20-170906,170906,7,0,8,52,16.8,0.08212454,4
2020-03-21-170906,170906,6,1,4,58,4.4,0.018705554,5
2020-03-22-170906,170906,5,0,1,63,3.4,0.013888059,6
2020-03-23-170906,170906,26,0,10,89,26.8,0.14956622,0
2020-03-24-170906,170906,21,0,9,110,20.6,0.0999997,1
2020-03-25-170906,170906,19,0,7,129,19.8,0.100220226,2
2020-03-26-170906,170906,17,0,4,146,17.6,0.10451559,3
2020-03-27-170906,170906,18,0,9,164,19.0,0.09031177,4
2020-03-28-170906,170906,6,0,1,170,17.8,0.018326491,5
2020-03-29-170906,170906,2,0,1,172,5.6,0.019359851,6
2020-03-30-170906,170906,10,0,13,182,20.4,0.08051739,0
2020-03-31-170906,170906,8,0,11,190,13.2,0.053004403,1
2020-04-01-170906,170906,13,0,8,203,11.6,0.06536342,2
2020-04-02-170906,170906,8,0,9,211,11.2,0.061279543,3
2020-04-03-170906,170906,8,0,6,219,10.6,0.08378814,4
2020-04-04-170906,170906,4,0,2,223,3.8,0.009468837,5
2020-04-05-170906,170906,1,0,3,224,1.8,0.01897644,6
2020-04-06-170906,170906,10,1,3,234,12.2,0.06895194,0
2020-04-07-170906,170906,9,0,3,243,10.0,0.09645307,1
2020-04-08-170906,170906,7,0,15,250,11.0,0.05533011,2
2020-04-09-170906,170906,4,0,0,254,7.0,0.030491767,3
2020-04-10-170906,170906,9,1,3,263,7.4,0.016552486,4
2020-04-11-170906,170906,1,0,1,264,2.8,0.059891503,5
2020-04-12-170906,170906,1,0,0,265,3.2,0.016316349,6
2020-04-13-170906,170906,13,0,8,278,44.6,0.073608465,0
2020-04-14-170906,170906,11,0,3,289,10.4,0.06338745,1
2020-04-15-170906,170906,8,0,5,297,11.6,0.05943859,2
2020-04-16-170906,170906,9,0,5,306,8.8,0.05355346,3
2020-04-17-170906,170906,6,0,2,312,6.2,0.043316703,4
2020-04-18-170906,170906,2,0,0,314,1.6,0.010582399,5
2020-04-19-170906,170906,3,0,0,317,0.6,0.0026048943,6
2020-04-20-170906,170906,3,0,5,320,7.2,0.053318147,0
2020-04-21-170906,170906,3,0,11,323,7.4,0.047871705,1
2020-04-22-170906,170906,15,0,8,338,7.6,0.03419505,2
2020-04-23-170906,170906,0,0,9,338,0.4,0.0015002049,3
2020-04-24-170906,170906,3,0,5,341,5.0,0.04017511,4
2020-04-25-170906,170906,1,0,0,342,0.2,0.007485734,5
2020-04-26-170906,170906,0,0,0,342,0.4,0.009176201,6
2020-04-27-170906,170906,8,2,2,350,5.4,0.04481395,0
2020-04-28-170906,170906,3,0,5,353,4.6,0.042020053,1
2020-04-29-170906,170906,5,0,1,358,5.0,0.0551405,2
2020-04-30-170906,170906,5,0,4,363,6.6,0.037671145,3
2020-05-01-170906,170906,2,0,6,365,0.8,0.0018389169,4
2020-05-02-170906,170906,0,0,0,365,0.0,0.00573299,5
2020-05-03-170906,170906,0,0,0,365,0.2,0.003950647,6
2020-05-04-170906,170906,5,0,1,370,7.4,0.05025669,0
2020-05-05-170906,170906,11,1,5,381,5.4,0.042751394,1
2020-05-06-170906,170906,8,0,7,389,5.2,0.06225507,2
2020-05-07-170906,170906,9,0,4,398,6.6,0.045327146,3
2020-05-08-170906,170906,5,0,3,403,7.8,0.04317002,4
2020-05-09-170906,170906,0,0,0,403,0.4,0.008543991,5
2020-05-10-170906,170906,0,0,0,403,0.2,0.0046754926,6
2020-05-11-170906,170906,2,0,6,405,6.4,0.04156333,0
2020-05-12-170906,170906,5,0,3,410,4.8,0.037685607,1
2020-05-13-170906,170906,1,0,1,411,0.2,0.034947023,2
2020-05-14-170906,170906,4,0,5,415,3.4,0.043188024,3
2020-05-15-170906,170906,6,2,7,421,4.0,0.031767566,4
2020-05-16-170906,170906,0,0,0,421,0.2,0.006953579,5
2020-05-17-170906,170906,0,0,0,421,0.4,0.0016048334,6
2020-05-18-170906,170906,1,0,8,422,4.2,0.046303604,0
2020-05-19-170906,170906,5,0,6,427,4.0,0.043078557,1
2020-05-20-170906,170906,7,0,7,434,5.6,0.03170092,2
2020-05-21-170906,170906,4,0,3,438,2.2,0.04264184,3
2020-05-22-170906,170906,3,0,3,441,3.4,0.03206322,4
2020-05-23-170906,170906,0,0,0,441,0.4,0.0017912157,5
2020-05-24-170906,170906,0,0,1,441,0.2,0.0007462946,6
2020-05-25-170906,170906,6,0,6,447,5.2,0.05427256,0
2020-05-26-170906,170906,3,0,2,450,4.2,0.034118418,1
2020-05-27-170906,170906,1,1,4,451,3.4,0.037328165,2
2020-05-28-170906,170906,5,0,1,456,3.4,0.042642828,3
2020-05-29-170906,170906,7,2,0,463,3.4,0.053453878,4
2020-05-30-170906,170906,0,0,0,463,0.0,0.0064220037,5
2020-05-31-170906,170906,0,0,1,463,0.2,0.008628477,6
2020-06-01-170906,170906,8,0,3,471,1.8,0.0632593,0
2020-06-02-170906,170906,6,0,0,477,3.0,0.033166803,1
2020-06-03-170906,170906,7,0,2,484,2.2,0.040317614,2
2020-06-04-170906,170906,3,0,1,487,2.0,0.030752972,3
2020-06-05-170906,170906,3,0,5,490,3.8,0.02228392,4
2020-06-06-170906,170906,0,0,0,490,0.0,0.0013782822,5
2020-06-07-170906,170906,1,0,0,491,0.0,0.0025494408,6
2020-06-08-170906,170906,6,0,4,497,1.4,0.04387546,0
2020-06-09-170906,170906,2,0,1,499,1.8,0.038180247,1
2020-06-10-170906,170906,4,0,4,503,1.4,0.050320927,2
2020-06-11-170906,170906,1,0,3,504,1.0,0.045593627,3
2020-06-12-170906,170906,0,0,4,504,1.6,0.031708416,4
2020-06-13-170906,170906,0,0,1,504,0.2,0.0053791255,5
2020-06-14-170906,170906,1,0,0,505,0.2,0.0015562411,6
2020-06-15-170906,170906,3,0,1,508,1.4,0.03506671,0
2020-06-16-170906,170906,0,0,0,508,1.2,0.05574761,1
2020-06-17-170906,170906,2,0,0,510,1.4,0.033260025,2
2020-06-18-170906,170906,1,0,2,511,1.4,0.03150555,3
2020-06-19-170906,170906,5,0,1,516,1.0,0.0469739,4
2020-06-20-170906,170906,0,0,2,516,0.0,0.006672316,5
2020-06-21-170906,170906,0,0,0,516,0.0,0.0018965757,6
2020-06-22-170906,170906,4,0,1,520,1.6,0.024798336,0
2020-06-23-170906,170906,1,0,0,521,1.6,0.031768855,1
2020-06-24-170906,170906,4,0,1,525,1.2,0.017576123,2
2020-06-25-170906,170906,3,0,4,528,0.6,0.020874964,3
2020-06-26-170906,170906,4,0,0,532,1.6,0.02036024,4
2020-06-27-170906,170906,1,1,0,533,0.0,0.005752169,5
2020-06-28-170906,170906,0,0,0,533,0.2,0.0032506692,6
2020-06-29-170906,170906,1,0,2,534,1.6,0.028214505,0
2020-06-30-170906,170906,0,0,0,534,1.0,0.016121686,1
2020-07-01-170906,170906,0,0,1,534,1.0,0.019924512,2
2020-07-02-170906,170906,2,0,0,536,0.6,0.013748638,3
2020-07-03-170906,170906,1,0,0,537,0.2,0.015481257,4
2020-07-04-170906,170906,2,0,3,539,0.0,0.0023728616,5
2020-07-05-170906,170906,0,0,0,539,0.0,0.0039352453,6
2020-07-06-170906,170906,1,0,0,540,0.4,0.017840309,0
2020-07-07-170906,170906,0,0,0,540,0.4,0.010352586,1
2020-07-08-170906,170906,1,0,0,541,0.4,0.009651092,2
2020-07-09-170906,170906,4,0,1,545,0.8,0.008312414,3
2020-07-10-170906,170906,0,1,3,545,1.0,0.016860012,4
2020-07-11-170906,170906,0,0,0,545,1.8,0.004544641,5
2020-07-12-170906,170906,0,0,0,545,1.0,0.0025997756,6
2020-07-13-170906,170906,2,0,2,547,0.4,0.017537644,0
2020-07-14-170906,170906,0,0,1,547,0.4,0.01247292,1
2020-07-15-170906,170906,1,0,1,548,0.8,0.013304851,2
2020-07-16-170906,170906,0,0,0,548,0.2,0.010815081,3
2020-07-17-170906,170906,0,0,0,548,0.6,0.026360493,4
2020-07-18-170906,170906,3,0,3,551,0.2,0.0009527579,5
2020-07-19-170906,170906,0,0,0,551,0.4,0.0054990053,6
2020-07-20-170906,170906,0,0,1,551,0.2,0.015328661,0
2020-07-21-170906,170906,0,0,4,551,0.2,0.034892738,1
2020-07-22-170906,170906,0,0,4,551,1.2,0.013296591,2
2020-07-23-170906,170906,1,0,6,552,0.8,0.033272326,3
2020-07-24-170906,170906,3,0,2,555,0.8,0.02144942,4
2020-07-25-170906,170906,0,0,6,555,0.2,0.0036461928,5
2020-07-26-170906,170906,0,0,2,555,0.4,0.0014316109,6
2020-07-27-170906,170906,2,0,4,557,0.0,0.043101825,0
2020-07-28-170906,170906,1,0,3,558,0.6,0.019483993,1
2020-07-29-170906,170906,1,0,6,559,0.4,0.02111646,2
2020-07-30-170906,170906,0,0,5,559,2.0,0.027571708,3
2020-07-31-170906,170906,0,0,8,559,0.8,0.024843138,4
2020-08-01-170906,170906,3,0,4,562,1.6,0.005393874,5
2020-08-02-170906,170906,0,0,2,562,0.6,0.012775542,6
2020-08-03-170906,170906,1,0,2,563,1.2,0.01818255,0
2020-08-04-170906,170906,4,0,4,567,1.6,0.019825567,1
2020-08-05-170906,170906,4,0,1,571,1.0,0.04433234,2
2020-08-06-170906,170906,6,0,3,577,1.4,0.020134553,3
2020-08-07-170906,170906,2,0,3,579,2.6,0.027923351,4
2020-08-08-170906,170906,6,0,1,585,4.0,0.024053894,5
2020-08-09-170906,170906,2,0,1,587,1.4,0.012462489,6
2020-08-10-170906,170906,4,0,6,591,2.4,0.032012932,0
2020-08-11-170906,170906,3,0,14,594,1.2,0.059295207,1
2020-08-12-170906,170906,6,0,11,600,1.4,0.02838871,2
2020-08-13-170906,170906,5,0,18,605,3.2,0.058053963,3
2020-08-14-170906,170906,8,0,5,613,5.8,0.05063271,4
2020-08-15-170906,170906,4,1,1,617,0.8,0.029872125,5
2020-08-16-170906,170906,2,0,3,619,2.8,0.01865605,6
2020-08-17-170906,170906,2,0,15,621,4.6,0.05835598,0
2020-08-18-170906,170906,4,0,7,625,3.2,0.062056676,1
2020-08-19-170906,170906,1,0,3,626,5.4,0.084383145,2
2020-08-20-170906,170906,3,0,9,629,5.2,0.1011498,3
2020-08-21-170906,170906,3,0,7,632,2.6,0.09205211,4
2020-08-22-170906,170906,1,0,0,633,1.0,0.039116357,5
2020-08-23-170906,170906,1,0,0,634,1.2,0.02334009,6
2020-08-24-170906,170906,6,0,4,640,4.0,0.095234685,0
2020-08-25-170906,170906,14,0,2,654,10.0,0.14733061,1
2020-08-26-170906,170906,11,0,8,665,9.8,0.114199,2
2020-08-27-170906,170906,18,0,9,683,10.2,0.14434253,3
2020-08-28-170906,170906,5,0,8,688,11.2,0.166534,4
2020-08-29-170906,170906,1,0,1,689,2.8,0.048152674,5
2020-08-30-170906,170906,3,0,1,692,0.4,0.058194537,6
2020-08-31-170906,170906,15,0,7,707,12.6,0.07813551,0
2020-09-01-170906,170906,7,1,5,714,7.0,0.06402356,1
2020-09-02-170906,170906,3,0,17,717,10.0,0.112342134,2
2020-09-03-170906,170906,9,0,18,726,9.2,0.09402422,3
2020-09-04-170906,170906,7,0,5,733,9.8,0.10577197,4
2020-09-05-170906,170906,0,0,0,733,1.6,0.051550206,5
2020-09-06-170906,170906,0,0,0,733,2.2,0.055210575,6
2020-09-07-170906,170906,4,0,16,737,11.2,0.15077972,0
2020-09-08-170906,170906,2,0,8,739,1.0,0.09361826,1
2020-09-09-170906,170906,8,0,10,747,9.8,0.12359092,2
2020-09-10-170906,170906,9,0,6,756,7.6,0.17495471,3
2020-09-11-170906,170906,8,0,20,764,10.6,0.17865042,4
2020-09-12-170906,170906,1,0,1,765,1.0,0.06873996,5
2020-09-13-170906,170906,1,1,1,766,1.6,0.04407501,6
2020-09-14-170906,170906,7,1,8,773,12.4,0.16528375,0
2020-09-15-170906,170906,5,0,5,778,8.0,0.17858833,1
2020-09-16-170906,170906,17,0,6,795,13.2,0.2003891,2
2020-09-17-170906,170906,18,0,6,813,11.4,0.27097583,3
2020-09-18-170906,170906,5,0,10,818,7.4,0.2589237,4
2020-09-19-170906,170906,0,0,0,818,2.2,0.13697399,5
2020-09-20-170906,170906,0,1,2,818,2.2,0.043973148,6
2020-09-21-170906,170906,16,0,12,834,10.4,0.1491416,0
2020-09-22-170906,170906,8,0,8,842,11.0,0.1447738,1
2020-09-23-170906,170906,10,0,11,852,10.2,0.16917999,2
2020-09-24-170906,170906,6,0,5,858,8.0,0.23063882,3
2020-09-25-170906,170906,20,0,9,878,15.0,0.1821974,4
2020-09-26-170906,170906,1,0,1,879,4.8,0.13690557,5
2020-09-27-170906,170906,1,0,0,880,2.6,0.045411058,6
2020-09-28-170906,170906,8,1,4,888,11.2,0.10116055,0
2020-09-29-170906,170906,5,0,7,893,6.8,0.10435584,1
2020-09-30-170906,170906,6,0,9,899,8.6,0.10457678,2
2020-10-01-170906,170906,6,0,16,905,9.4,0.17866325,3
2020-10-02-170906,170906,10,1,13,915,10.8,0.1979078,4
2020-10-03-170906,170906,0,0,2,915,1.2,0.08678084,5
2020-10-04-170906,170906,2,0,3,917,3.6,0.026596088,6
2020-10-05-170906,170906,12,0,26,929,13.6,0.13874727,0
2020-10-06-170906,170906,8,0,12,937,11.6,0.22759259,1
2020-10-07-170906,170906,11,0,14,948,9.2,0.1823275,2
2020-10-08-170906,170906,5,1,20,953,6.2,0.312629,3
2020-10-09-170906,170906,9,0,26,962,6.4,0.2559057,4
2020-10-10-170906,170906,1,0,0,963,0.6,0.0844266,5
2020-10-11-170906,170906,0,0,2,963,0.2,0.07429904,6
2020-10-12-170906,170906,4,0,27,967,0.4,0.043602426,0
2020-10-13-170906,170906,7,0,10,974,9.0,0.16435003,1
2020-10-14-170906,170906,9,0,16,983,8.0,0.20336042,2
2020-10-15-170906,170906,16,0,52,999,9.6,0.15850745,3
2020-10-16-170906,170906,13,0,49,1012,10.0,0.20640604,4
2020-10-17-170906,170906,2,0,10,1014,2.2,0.11386715,5
2020-10-18-170906,170906,3,0,1,1017,2.0,0.064830415,6
2020-10-19-170906,170906,26,0,4,1043,13.8,0.15861455,0
2020-10-20-170906,170906,12,0,30,1055,14.0,0.273927,1
2020-10-21-170906,170906,14,0,21,1069,16.6,0.2281711,2
2020-10-22-170906,170906,20,0,20,1089,18.6,0.20665862,3
2020-10-23-170906,170906,26,1,22,1115,23.2,0.3809207,4
2020-10-24-170906,170906,0,0,1,1115,1.4,0.118519366,5
2020-10-25-170906,170906,2,1,1,1117,1.8,0.046461634,6
2020-10-26-170906,170906,27,0,18,1144,28.6,0.281914,0
2020-10-27-170906,170906,10,2,24,1154,15.2,0.28407487,1
2020-10-28-170906,170906,16,3,29,1170,20.0,0.38092977,2
2020-10-29-170906,170906,52,1,10,1222,35.2,0.32574743,3
2020-10-30-170906,170906,49,2,21,1271,27.2,0.39318815,4
2020-10-31-170906,170906,10,0,0,1281,2.6,0.15163392,5
2020-11-01-170906,170906,1,1,0,1282,8.0,0.085895635,6
2020-11-02-170906,170906,4,2,0,1286,3.0,0.07447768,0
2020-11-03-170906,170906,30,0,0,1316,23.0,0.25891545,1
2020-11-04-170906,170906,21,1,0,1337,21.6,0.3450132,2
2020-11-05-170906,170906,20,0,0,1357,26.2,0.4032322,3
2020-11-06-170906,170906,22,2,0,1379,25.2,0.3594867,4
2020-11-07-170906,170906,1,0,0,1380,3.0,0.107080705,5
2020-11-08-170906,170906,1,0,0,1381,3.6,0.05170239,6
2020-11-09-170906,170906,18,4,0,1399,21.8,0.18117343,0
2020-11-10-170906,170906,24,2,0,1423,17.0,0.21738173,1
2020-11-11-170906,170906,29,2,0,1452,19.2,0.25152224,2
2020-11-12-170906,170906,10,1,0,1462,18.6,0.228828,3
2020-11-13-170906,170906,21,2,0,1483,20.8,0.20501988,4
2020-03-01-170907,170907,0,0,8,0,0.0,0.007946126,6
2020-03-02-170907,170907,1,0,15,1,0.0,0.009460241,0
2020-03-03-170907,170907,0,2,11,1,0.0,0.0027317298,1
2020-03-04-170907,170907,1,1,18,2,0.0,0.0017480548,2
2020-03-05-170907,170907,0,0,30,2,0.1111111111111111,0.006520805,3
2020-03-06-170907,170907,0,0,22,2,0.3333333333333333,0.06375712,4
2020-03-07-170907,170907,0,0,7,2,0.3333333333333333,0.010744991,5
2020-03-08-170907,170907,0,0,5,2,0.1111111111111111,0.007868722,6
2020-03-09-170907,170907,1,0,47,3,0.6666666666666666,0.053698406,0
2020-03-10-170907,170907,2,0,35,5,0.5555555555555556,0.041819867,1
2020-03-11-170907,170907,3,0,18,8,0.4444444444444444,0.038344763,2
2020-03-12-170907,170907,2,0,27,10,1.3333333333333333,0.053010676,3
2020-03-13-170907,170907,4,0,28,14,2.6666666666666665,0.16560821,4
2020-03-14-170907,170907,4,0,9,18,1.0,0.03319528,5
2020-03-15-170907,170907,8,0,8,26,1.6666666666666667,0.043429803,6
2020-03-16-170907,170907,15,0,29,41,7.222222222222222,0.52949595,0
2020-03-17-170907,170907,11,0,14,52,5.4444444444444455,0.33459854,1
2020-03-18-170907,170907,18,0,14,70,11.333333333333336,0.50238407,2
2020-03-19-170907,170907,30,0,18,100,10.222222222222221,0.53760403,3
2020-03-20-170907,170907,22,0,10,122,12.111111111111109,0.50710547,4
2020-03-21-170907,170907,7,0,5,129,4.5555555555555545,0.09035579,5
2020-03-22-170907,170907,5,0,1,134,4.5555555555555545,0.058958065,6
2020-03-23-170907,170907,47,1,18,181,25.11111111111111,0.84666294,0
2020-03-24-170907,170907,35,0,15,216,20.11111111111111,0.5850208,1
2020-03-25-170907,170907,18,0,16,234,19.555555555555557,0.5809503,2
2020-03-26-170907,170907,27,1,15,261,14.555555555555555,0.6972582,3
2020-03-27-170907,170907,28,0,5,289,13.444444444444445,0.5305803,4
2020-03-28-170907,170907,9,0,6,298,11.333333333333336,0.08433432,5
2020-03-29-170907,170907,8,0,8,306,3.4444444444444446,0.13483866,6
2020-03-30-170907,170907,29,0,182,335,16.444444444444443,0.45828012,0
2020-03-31-170907,170907,14,0,12,349,9.111111111111109,0.21931314,1
2020-04-01-170907,170907,14,0,14,363,6.777777777777778,0.4034944,2
2020-04-02-170907,170907,18,0,12,381,6.5555555555555545,0.4849233,3
2020-04-03-170907,170907,10,0,13,391,7.222222222222222,0.48047766,4
2020-04-04-170907,170907,5,0,2,396,2.4444444444444446,0.040874075,5
2020-04-05-170907,170907,1,3,0,397,2.333333333333333,0.09220099,6
2020-04-06-170907,170907,18,0,10,415,11.333333333333336,0.49823287,0
2020-04-07-170907,170907,15,0,9,430,26.88888888888889,0.47892338,1
2020-04-08-170907,170907,16,4,8,446,8.555555555555555,0.3584362,2
2020-04-09-170907,170907,15,0,1,461,5.666666666666668,0.18494715,3
2020-04-10-170907,170907,5,0,4,466,5.888888888888888,0.08678911,4
2020-04-11-170907,170907,6,0,0,472,2.2222222222222223,0.22155584,5
2020-04-12-170907,170907,8,0,0,480,1.8888888888888888,0.11622585,6
2020-04-13-170907,170907,182,0,6,662,16.11111111111111,0.3938131,0
2020-04-14-170907,170907,12,0,2,674,9.444444444444443,0.41084617,1
2020-04-15-170907,170907,14,0,4,688,7.333333333333332,0.32292694,2
2020-04-16-170907,170907,12,0,7,700,6.222222222222222,0.40740624,3
2020-04-17-170907,170907,13,0,1,713,4.0,0.28094837,4
2020-04-18-170907,170907,2,0,0,715,1.8888888888888888,0.08025086,5
2020-04-19-170907,170907,0,0,0,715,0.7777777777777778,0.013384571,6
2020-04-20-170907,170907,10,0,6,725,5.222222222222221,0.32430252,0
2020-04-21-170907,170907,9,0,9,734,5.111111111111111,0.35419106,1
2020-04-22-170907,170907,8,0,7,742,5.777777777777778,0.2054498,2
2020-04-23-170907,170907,1,0,6,743,0.1111111111111111,0.009342356,3
2020-04-24-170907,170907,4,0,12,747,4.5555555555555545,0.23827526,4
2020-04-25-170907,170907,0,0,1,747,0.5555555555555556,0.0473525,5
2020-04-26-170907,170907,0,0,0,747,0.2222222222222222,0.05856474,6
2020-04-27-170907,170907,6,2,7,753,4.333333333333333,0.25876752,0
2020-04-28-170907,170907,2,0,8,755,3.0,0.27340847,1
2020-04-29-170907,170907,4,0,0,759,4.333333333333333,0.36447752,2
2020-04-30-170907,170907,7,0,3,766,4.4444444444444455,0.15471965,3
2020-05-01-170907,170907,1,0,6,767,0.8888888888888888,0.011956265,4
2020-05-02-170907,170907,0,0,1,767,0.4444444444444444,0.022014352,5
2020-05-03-170907,170907,0,0,2,767,0.1111111111111111,0.017072577,6
2020-05-04-170907,170907,6,0,4,773,6.4444444444444455,0.294055,0
2020-05-05-170907,170907,9,0,2,782,5.777777777777778,0.23995826,1
2020-05-06-170907,170907,7,0,5,789,4.888888888888889,0.47677878,2
2020-05-07-170907,170907,6,0,3,795,5.777777777777778,0.27184412,3
2020-05-08-170907,170907,12,0,2,807,6.5555555555555545,0.2336657,4
2020-05-09-170907,170907,1,0,1,808,0.1111111111111111,0.03962401,5
2020-05-10-170907,170907,0,0,0,808,0.3333333333333333,0.04033493,6
2020-05-11-170907,170907,7,1,5,815,5.0,0.2081374,0
2020-05-12-170907,170907,8,2,3,823,3.0,0.18673821,1
2020-05-13-170907,170907,0,0,1,823,1.0,0.25169685,2
2020-05-14-170907,170907,3,0,4,826,3.111111111111111,0.2431483,3
2020-05-15-170907,170907,6,0,3,832,3.555555555555556,0.15577921,4
2020-05-16-170907,170907,1,0,0,833,0.2222222222222222,0.07371757,5
2020-05-17-170907,170907,2,0,1,835,0.1111111111111111,0.0068393294,6
2020-05-18-170907,170907,4,0,1,839,3.6666666666666665,0.2663863,0
2020-05-19-170907,170907,2,0,2,841,3.333333333333333,0.2428874,1
2020-05-20-170907,170907,5,0,3,846,3.0,0.13620211,2
2020-05-21-170907,170907,3,0,0,849,2.333333333333333,0.23630244,3
2020-05-22-170907,170907,2,0,1,851,2.555555555555556,0.17715646,4
2020-05-23-170907,170907,1,0,0,852,0.8888888888888888,0.007653765,5
2020-05-24-170907,170907,0,0,0,852,0.2222222222222222,0.0055525317,6
2020-05-25-170907,170907,5,0,3,857,3.6666666666666665,0.3421312,0
2020-05-26-170907,170907,3,0,2,860,4.111111111111111,0.19299635,1
2020-05-27-170907,170907,1,0,1,861,2.2222222222222223,0.21057288,2
2020-05-28-170907,170907,4,0,1,865,1.7777777777777777,0.20121793,3
2020-05-29-170907,170907,3,0,2,868,4.4444444444444455,0.33750996,4
2020-05-30-170907,170907,0,0,0,868,0.4444444444444444,0.05241447,5
2020-05-31-170907,170907,1,0,1,869,0.0,0.037766002,6
2020-06-01-170907,170907,1,0,1,870,5.333333333333333,0.48809797,0
2020-06-02-170907,170907,2,0,0,872,3.555555555555556,0.21878904,1
2020-06-03-170907,170907,3,0,3,875,2.7777777777777777,0.2853388,2
2020-06-04-170907,170907,0,0,1,875,2.7777777777777777,0.16405164,3
2020-06-05-170907,170907,1,0,1,876,3.0,0.1524689,4
2020-06-06-170907,170907,0,0,0,876,0.2222222222222222,0.006500386,5
2020-06-07-170907,170907,0,0,0,876,0.2222222222222222,0.015787167,6
2020-06-08-170907,170907,3,0,1,879,1.8888888888888888,0.2484747,0
2020-06-09-170907,170907,2,0,4,881,1.8888888888888888,0.25845864,1
2020-06-10-170907,170907,1,0,1,882,1.2222222222222223,0.27904087,2
2020-06-11-170907,170907,1,0,0,883,1.1111111111111112,0.26170236,3
2020-06-12-170907,170907,2,0,4,885,0.7777777777777778,0.18163136,4
2020-06-13-170907,170907,0,0,0,885,0.2222222222222222,0.021177884,5
2020-06-14-170907,170907,1,0,1,886,0.1111111111111111,0.009809044,6
2020-06-15-170907,170907,1,0,4,887,1.6666666666666667,0.21124116,0
2020-06-16-170907,170907,0,0,1,887,2.6666666666666665,0.3590353,1
2020-06-17-170907,170907,3,0,0,890,1.1111111111111112,0.18406855,2
2020-06-18-170907,170907,1,0,2,891,1.5555555555555556,0.19282049,3
2020-06-19-170907,170907,1,0,0,892,1.4444444444444444,0.22685951,4
2020-06-20-170907,170907,0,0,0,892,0.0,0.03018608,5
2020-06-21-170907,170907,0,0,0,892,0.0,0.0076740896,6
2020-06-22-170907,170907,1,0,0,893,1.8888888888888888,0.16684538,0
2020-06-23-170907,170907,4,0,1,897,1.3333333333333333,0.1717653,1
2020-06-24-170907,170907,1,0,0,898,1.5555555555555556,0.075744644,2
2020-06-25-170907,170907,0,5,2,898,1.6666666666666667,0.1133498,3
2020-06-26-170907,170907,4,0,0,902,1.7777777777777777,0.089947924,4
2020-06-27-170907,170907,0,0,0,902,0.1111111111111111,0.026724685,5
2020-06-28-170907,170907,1,0,0,903,0.1111111111111111,0.016482005,6
2020-06-29-170907,170907,4,0,0,907,1.0,0.14566347,0
2020-06-30-170907,170907,1,0,0,908,0.6666666666666666,0.07187836,1
2020-07-01-170907,170907,0,0,2,908,0.7777777777777778,0.13604905,2
2020-07-02-170907,170907,2,0,0,910,0.5555555555555556,0.086345665,3
2020-07-03-170907,170907,0,0,1,910,0.8888888888888888,0.070240065,4
2020-07-04-170907,170907,0,0,0,910,0.3333333333333333,0.0104813455,5
2020-07-05-170907,170907,0,0,0,910,0.1111111111111111,0.027989857,6
2020-07-06-170907,170907,0,0,0,910,1.3333333333333333,0.0997025,0
2020-07-07-170907,170907,1,0,1,911,0.6666666666666666,0.057392195,1
2020-07-08-170907,170907,0,0,0,911,0.8888888888888888,0.035323355,2
2020-07-09-170907,170907,2,0,0,913,1.1111111111111112,0.057828825,3
2020-07-10-170907,170907,0,0,0,913,0.8888888888888888,0.08782307,4
2020-07-11-170907,170907,0,0,1,913,0.0,0.018621026,5
2020-07-12-170907,170907,0,0,2,913,0.0,0.014675739,6
2020-07-13-170907,170907,0,0,0,913,0.7777777777777778,0.07078212,0
2020-07-14-170907,170907,0,0,0,913,0.2222222222222222,0.07208261,1
2020-07-15-170907,170907,2,0,0,915,0.5555555555555556,0.061501518,2
2020-07-16-170907,170907,0,0,0,915,0.5555555555555556,0.045440443,3
2020-07-17-170907,170907,1,0,0,916,0.4444444444444444,0.14803308,4
2020-07-18-170907,170907,0,0,0,916,0.3333333333333333,0.004399872,5
2020-07-19-170907,170907,0,0,0,916,0.1111111111111111,0.028902205,6
2020-07-20-170907,170907,0,0,4,916,0.5555555555555556,0.070953056,0
2020-07-21-170907,170907,1,0,3,917,0.8888888888888888,0.21295254,1
2020-07-22-170907,170907,0,0,0,917,1.1111111111111112,0.07336027,2
2020-07-23-170907,170907,0,0,1,917,0.8888888888888888,0.19181353,3
2020-07-24-170907,170907,0,0,1,917,1.6666666666666667,0.10161859,4
2020-07-25-170907,170907,1,0,4,918,0.1111111111111111,0.014136997,5
2020-07-26-170907,170907,2,0,0,920,0.0,0.006128744,6
2020-07-27-170907,170907,0,0,0,920,0.7777777777777778,0.24515294,0
2020-07-28-170907,170907,0,0,1,920,0.6666666666666666,0.08300063,1
2020-07-29-170907,170907,0,0,1,920,0.5555555555555556,0.09322915,2
2020-07-30-170907,170907,0,0,1,920,1.0,0.12296019,3
2020-07-31-170907,170907,0,0,2,920,0.7777777777777778,0.14055583,4
2020-08-01-170907,170907,0,0,0,920,0.3333333333333333,0.02138205,5
2020-08-02-170907,170907,0,0,1,920,0.1111111111111111,0.06708858,6
2020-08-03-170907,170907,4,0,1,924,0.8888888888888888,0.09473443,0
2020-08-04-170907,170907,3,0,6,927,1.1111111111111112,0.13521692,1
2020-08-05-170907,170907,0,0,1,927,2.1111111111111107,0.2876316,2
2020-08-06-170907,170907,1,0,8,928,1.1111111111111112,0.13134947,3
2020-08-07-170907,170907,1,0,1,929,1.1111111111111112,0.15443033,4
2020-08-08-170907,170907,4,0,2,933,1.6666666666666667,0.14933674,5
2020-08-09-170907,170907,0,0,1,933,0.7777777777777778,0.069101304,6
2020-08-10-170907,170907,0,0,5,933,2.7777777777777777,0.2420173,0
2020-08-11-170907,170907,1,0,9,934,2.1111111111111107,0.3131515,1
2020-08-12-170907,170907,1,0,2,935,2.2222222222222223,0.17992702,2
2020-08-13-170907,170907,1,0,6,936,2.6666666666666665,0.34321928,3
2020-08-14-170907,170907,2,0,13,938,3.888888888888889,0.29457924,4
2020-08-15-170907,170907,0,0,4,938,1.7777777777777777,0.13276586,5
2020-08-16-170907,170907,1,0,1,939,1.3333333333333333,0.11818325,6
2020-08-17-170907,170907,1,0,12,940,3.0,0.35770246,0
2020-08-18-170907,170907,6,0,3,946,2.6666666666666665,0.35025707,1
2020-08-19-170907,170907,1,0,15,947,3.6666666666666665,0.4555621,2
2020-08-20-170907,170907,8,0,11,955,4.222222222222221,0.59262824,3
2020-08-21-170907,170907,1,0,13,956,2.888888888888889,0.4246127,4
2020-08-22-170907,170907,2,0,2,958,1.2222222222222223,0.18035841,5
2020-08-23-170907,170907,1,0,1,959,1.6666666666666667,0.14359184,6
2020-08-24-170907,170907,5,0,19,964,3.555555555555556,0.54949707,0
2020-08-25-170907,170907,9,0,2,973,6.666666666666668,0.8182205,1
2020-08-26-170907,170907,2,0,10,975,7.0,0.51554877,2
2020-08-27-170907,170907,6,0,8,981,10.111111111111109,0.6941924,3
2020-08-28-170907,170907,13,0,14,994,7.222222222222222,1.0177642,4
2020-08-29-170907,170907,4,0,2,998,2.6666666666666665,0.23859908,5
2020-08-30-170907,170907,1,0,2,999,2.2222222222222223,0.3583417,6
2020-08-31-170907,170907,12,0,26,1011,6.777777777777778,0.3413511,0
2020-09-01-170907,170907,3,0,7,1014,4.5555555555555545,0.2989658,1
2020-09-02-170907,170907,15,0,26,1029,4.888888888888889,0.64442813,2
2020-09-03-170907,170907,11,0,21,1040,6.333333333333332,0.43100053,3
2020-09-04-170907,170907,13,1,9,1053,6.888888888888888,0.59565663,4
2020-09-05-170907,170907,2,0,2,1055,2.4444444444444446,0.23786177,5
2020-09-06-170907,170907,1,0,0,1056,2.6666666666666665,0.34366563,6
2020-09-07-170907,170907,19,0,14,1075,9.222222222222221,0.75672245,0
2020-09-08-170907,170907,2,0,11,1077,2.2222222222222223,0.52327293,1
2020-09-09-170907,170907,10,0,17,1087,7.222222222222222,0.6504195,2
2020-09-10-170907,170907,8,0,18,1095,5.222222222222221,0.7943394,3
2020-09-11-170907,170907,14,0,16,1109,7.777777777777778,0.9742323,4
2020-09-12-170907,170907,2,0,1,1111,1.6666666666666667,0.2991532,5
2020-09-13-170907,170907,2,0,11,1113,2.1111111111111107,0.2557597,6
2020-09-14-170907,170907,26,0,15,1139,7.111111111111112,0.92841005,0
2020-09-15-170907,170907,7,1,13,1146,5.5555555555555545,0.91637254,1
2020-09-16-170907,170907,26,1,12,1172,7.666666666666668,1.0771027,2
2020-09-17-170907,170907,21,0,10,1193,9.111111111111109,1.7094346,3
2020-09-18-170907,170907,9,0,7,1202,5.111111111111111,1.5999287,4
2020-09-19-170907,170907,2,1,1,1204,2.333333333333333,0.7146558,5
2020-09-20-170907,170907,0,0,2,1204,1.2222222222222223,0.27854574,6
2020-09-21-170907,170907,14,0,19,1218,8.222222222222221,0.80166173,0
2020-09-22-170907,170907,11,0,19,1229,5.888888888888888,0.84976757,1
2020-09-23-170907,170907,17,2,10,1246,7.4444444444444455,0.83744407,2
2020-09-24-170907,170907,18,0,12,1264,4.888888888888889,1.1210213,3
2020-09-25-170907,170907,16,0,17,1280,8.777777777777779,1.1072265,4
2020-09-26-170907,170907,1,0,1,1281,2.2222222222222223,0.69722396,5
2020-09-27-170907,170907,11,0,1,1292,0.6666666666666666,0.27998826,6
2020-09-28-170907,170907,15,0,1,1307,7.111111111111112,0.5903235,0
2020-09-29-170907,170907,13,0,18,1320,4.888888888888889,0.5368218,1
2020-09-30-170907,170907,12,0,15,1332,4.333333333333333,0.49588114,2
2020-10-01-170907,170907,10,0,13,1342,6.5555555555555545,1.0486889,3
2020-10-02-170907,170907,7,0,18,1349,7.333333333333332,1.0620809,4
2020-10-03-170907,170907,1,0,5,1350,1.1111111111111112,0.40307042,5
2020-10-04-170907,170907,2,1,2,1352,1.2222222222222223,0.14059831,6
2020-10-05-170907,170907,19,1,15,1371,8.888888888888891,0.91639537,0
2020-10-06-170907,170907,19,0,22,1390,6.333333333333332,1.2156175,1
2020-10-07-170907,170907,10,1,32,1400,8.444444444444445,0.9677513,2
2020-10-08-170907,170907,12,0,21,1412,8.888888888888891,2.2885869,3
2020-10-09-170907,170907,17,3,28,1429,7.0,1.6358601,4
2020-10-10-170907,170907,1,0,2,1430,3.2222222222222223,0.51764315,5
2020-10-11-170907,170907,1,0,3,1431,0.4444444444444444,0.3988656,6
2020-10-12-170907,170907,1,0,34,1432,1.8888888888888888,0.25403395,0
2020-10-13-170907,170907,18,0,14,1450,7.111111111111112,0.9112636,1
2020-10-14-170907,170907,15,0,27,1465,7.111111111111112,1.2141849,2
2020-10-15-170907,170907,13,0,35,1478,8.222222222222221,0.8193608,3
2020-10-16-170907,170907,18,0,34,1496,7.666666666666668,1.1825453,4
2020-10-17-170907,170907,5,0,4,1501,2.0,0.5887349,5
2020-10-18-170907,170907,2,0,5,1503,1.6666666666666667,0.366353,6
2020-10-19-170907,170907,15,0,3,1518,11.666666666666664,0.82848334,0
2020-10-20-170907,170907,22,0,20,1540,8.666666666666666,1.3779031,1
2020-10-21-170907,170907,32,0,21,1572,12.0,1.3784354,2
2020-10-22-170907,170907,21,0,29,1593,12.111111111111109,1.2562071,3
2020-10-23-170907,170907,28,0,20,1621,19.88888888888889,1.9961967,4
2020-10-24-170907,170907,2,1,2,1623,4.0,0.5294217,5
2020-10-25-170907,170907,3,1,4,1626,3.555555555555556,0.30037206,6
2020-10-26-170907,170907,34,0,40,1660,19.555555555555557,1.5658749,0
2020-10-27-170907,170907,14,0,20,1674,16.11111111111111,1.644808,1
2020-10-28-170907,170907,27,0,21,1701,17.11111111111111,2.0495746,2
2020-10-29-170907,170907,35,0,21,1736,24.777777777777782,1.3763366,3
2020-10-30-170907,170907,34,1,24,1770,27.33333333333333,2.1172621,4
2020-10-31-170907,170907,4,2,0,1774,7.777777777777778,0.7605012,5
2020-11-01-170907,170907,5,1,0,1779,7.4444444444444455,0.47084126,6
2020-11-02-170907,170907,3,0,0,1782,2.6666666666666665,0.38276768,0
2020-11-03-170907,170907,20,1,0,1802,16.22222222222222,1.280679,1
2020-11-04-170907,170907,21,0,0,1823,20.0,1.8710293,2
2020-11-05-170907,170907,29,0,0,1852,20.444444444444443,1.9341072,3
2020-11-06-170907,170907,20,3,0,1872,20.33333333333333,2.0240412,4
2020-11-07-170907,170907,2,0,0,1874,5.888888888888888,0.6502955,5
2020-11-08-170907,170907,4,0,0,1878,3.888888888888889,0.31487343,6
2020-11-09-170907,170907,40,0,0,1918,15.333333333333336,1.1052098,0
2020-11-10-170907,170907,20,0,0,1938,15.777777777777779,1.2392092,1
2020-11-11-170907,170907,21,1,0,1959,18.11111111111111,1.5703394,2
2020-11-12-170907,170907,21,0,0,1980,13.444444444444445,1.430215,3
2020-11-13-170907,170907,24,0,0,2004,18.666666666666668,1.1304164,4
2020-03-01-170909,170909,0,0,6,0,0.14285714285714285,0.006989762,6
2020-03-02-170909,170909,0,1,10,0,0.0,0.028359402,0
2020-03-03-170909,170909,0,1,5,0,0.0,0.017102027,1
2020-03-04-170909,170909,0,0,19,0,0.14285714285714285,0.0024563447,2
2020-03-05-170909,170909,0,0,10,0,0.14285714285714285,0.04697811,3
2020-03-06-170909,170909,2,0,16,2,0.0,0.124039724,4
2020-03-07-170909,170909,0,0,7,2,0.0,0.0045490703,5
2020-03-08-170909,170909,0,0,5,2,0.14285714285714285,0.0029547277,6
2020-03-09-170909,170909,0,0,10,2,0.14285714285714285,0.060616873,0
2020-03-10-170909,170909,0,0,13,2,0.2857142857142857,0.03155064,1
2020-03-11-170909,170909,1,0,16,3,0.2857142857142857,0.08456552,2
2020-03-12-170909,170909,0,0,17,3,0.42857142857142855,0.054916944,3
2020-03-13-170909,170909,3,0,10,6,2.142857142857143,0.3640262,4
2020-03-14-170909,170909,2,0,3,8,0.5714285714285714,0.113534205,5
2020-03-15-170909,170909,6,0,7,14,1.5714285714285714,0.2642322,6
2020-03-16-170909,170909,10,0,15,24,5.571428571428571,1.0154296,0
2020-03-17-170909,170909,5,1,4,29,5.7142857142857135,0.74427706,1
2020-03-18-170909,170909,19,0,15,48,8.142857142857142,1.4690511,2
2020-03-19-170909,170909,10,0,7,58,11.142857142857142,1.2381294,3
2020-03-20-170909,170909,16,0,5,74,10.857142857142858,1.4077648,4
2020-03-21-170909,170909,7,0,1,81,2.2857142857142856,0.49572447,5
2020-03-22-170909,170909,5,0,3,86,4.0,0.537838,6
2020-03-23-170909,170909,10,0,11,96,14.571428571428573,1.6786653,0
2020-03-24-170909,170909,13,0,7,109,14.285714285714285,1.4937383,1
2020-03-25-170909,170909,16,0,4,125,12.0,1.3549795,2
2020-03-26-170909,170909,17,0,3,142,12.0,1.4621296,3
2020-03-27-170909,170909,10,0,6,152,14.0,1.1283282,4
2020-03-28-170909,170909,3,0,4,155,2.8571428571428568,0.26393119,5
2020-03-29-170909,170909,7,0,2,162,2.7142857142857144,0.2770852,6
2020-03-30-170909,170909,15,0,11,177,12.142857142857142,1.2669183,0
2020-03-31-170909,170909,4,0,11,181,9.571428571428571,0.8349652,1
2020-04-01-170909,170909,15,0,5,196,9.285714285714286,1.2157967,2
2020-04-02-170909,170909,7,0,4,203,8.857142857142858,0.94313675,3
2020-04-03-170909,170909,5,0,7,208,12.857142857142858,1.1511178,4
2020-04-04-170909,170909,1,0,4,209,3.0,0.102236435,5
2020-04-05-170909,170909,3,0,2,212,1.0,0.12404797,6
2020-04-06-170909,170909,11,0,6,223,9.142857142857142,1.0289716,0
2020-04-07-170909,170909,7,0,7,230,7.857142857142858,0.8921866,1
2020-04-08-170909,170909,4,0,3,234,9.857142857142858,0.7169191,2
2020-04-09-170909,170909,3,0,1,237,5.285714285714286,0.4961948,3
2020-04-10-170909,170909,6,0,5,243,5.428571428571429,0.43992013,4
2020-04-11-170909,170909,4,0,1,247,6.2857142857142865,0.75688344,5
2020-04-12-170909,170909,2,0,2,249,4.857142857142857,0.5240747,6
2020-04-13-170909,170909,11,0,4,260,16.0,1.057597,0
2020-04-14-170909,170909,11,0,7,271,12.285714285714285,0.9831069,1
2020-04-15-170909,170909,5,0,4,276,9.142857142857142,0.64982295,2
2020-04-16-170909,170909,4,0,3,280,6.7142857142857135,0.5829667,3
2020-04-17-170909,170909,7,0,0,287,4.285714285714286,0.67535156,4
2020-04-18-170909,170909,4,0,0,291,0.7142857142857143,0.2362575,5
2020-04-19-170909,170909,2,1,1,293,0.2857142857142857,0.078026496,6
2020-04-20-170909,170909,6,0,6,299,7.2857142857142865,0.74019057,0
2020-04-21-170909,170909,7,0,7,306,5.571428571428571,0.68667203,1
2020-04-22-170909,170909,3,1,4,309,5.142857142857143,0.32396236,2
2020-04-23-170909,170909,1,0,9,310,0.5714285714285714,0.049990963,3
2020-04-24-170909,170909,5,0,4,315,4.428571428571429,0.6091697,4
2020-04-25-170909,170909,1,0,0,316,0.2857142857142857,0.05967532,5
2020-04-26-170909,170909,2,0,1,318,0.7142857142857143,0.13626443,6
2020-04-27-170909,170909,4,0,1,322,4.714285714285714,0.5691385,0
2020-04-28-170909,170909,7,0,4,329,3.4285714285714284,0.57410175,1
2020-04-29-170909,170909,4,0,0,333,3.2857142857142856,0.51088876,2
2020-04-30-170909,170909,3,0,2,336,5.571428571428571,0.5394802,3
2020-05-01-170909,170909,0,0,4,336,0.5714285714285714,0.04590782,4
2020-05-02-170909,170909,0,0,0,336,0.8571428571428571,0.1339316,5
2020-05-03-170909,170909,1,0,0,337,0.2857142857142857,0.066428974,6
2020-05-04-170909,170909,6,0,7,343,5.428571428571429,0.58252174,0
2020-05-05-170909,170909,7,0,6,350,3.4285714285714284,0.58852243,1
2020-05-06-170909,170909,4,0,5,354,5.7142857142857135,0.8119489,2
2020-05-07-170909,170909,9,0,6,363,3.4285714285714284,0.7527643,3
2020-05-08-170909,170909,4,0,11,367,4.714285714285714,0.5714288,4
2020-05-09-170909,170909,0,1,0,367,0.5714285714285714,0.05094408,5
2020-05-10-170909,170909,1,0,1,368,0.2857142857142857,0.020664975,6
2020-05-11-170909,170909,1,0,6,369,5.428571428571429,0.67139244,0
2020-05-12-170909,170909,4,0,3,373,4.142857142857143,0.49986917,1
2020-05-13-170909,170909,0,0,8,373,2.571428571428572,0.3666906,2
2020-05-14-170909,170909,2,0,2,375,4.857142857142857,0.41444612,3
2020-05-15-170909,170909,4,0,6,379,4.285714285714286,0.3831459,4
2020-05-16-170909,170909,0,0,0,379,0.14285714285714285,0.04615806,5
2020-05-17-170909,170909,0,0,1,379,0.42857142857142855,0.0076752687,6
2020-05-18-170909,170909,7,0,5,386,3.2857142857142856,0.63765174,0
2020-05-19-170909,170909,6,0,2,392,2.142857142857143,0.5496637,1
2020-05-20-170909,170909,5,0,1,397,3.4285714285714284,0.5806887,2
2020-05-21-170909,170909,6,0,2,403,1.7142857142857142,0.5433018,3
2020-05-22-170909,170909,11,0,3,414,2.0,0.72019154,4
2020-05-23-170909,170909,0,0,0,414,0.14285714285714285,0.009061447,5
2020-05-24-170909,170909,1,0,1,415,0.14285714285714285,0.04587,6
2020-05-25-170909,170909,6,0,1,421,3.2857142857142856,0.5489393,0
2020-05-26-170909,170909,3,0,2,424,3.2857142857142856,0.38233578,1
2020-05-27-170909,170909,8,1,2,432,3.0,0.67904264,2
2020-05-28-170909,170909,2,0,2,434,1.8571428571428568,0.31557873,3
2020-05-29-170909,170909,6,0,3,440,1.2857142857142858,0.590533,4
2020-05-30-170909,170909,0,0,0,440,0.2857142857142857,0.02310791,5
2020-05-31-170909,170909,1,0,1,441,0.2857142857142857,0.124255195,6
2020-06-01-170909,170909,5,0,4,446,1.8571428571428568,0.6559488,0
2020-06-02-170909,170909,2,0,3,448,2.142857142857143,0.33904794,1
2020-06-03-170909,170909,1,0,3,449,1.1428571428571428,0.2600475,2
2020-06-04-170909,170909,2,0,3,451,1.5714285714285714,0.28798217,3
2020-06-05-170909,170909,3,1,3,454,2.0,0.22279826,4
2020-06-06-170909,170909,0,1,2,454,0.14285714285714285,0.010042471,5
2020-06-07-170909,170909,1,1,1,455,0.0,0.055405594,6
2020-06-08-170909,170909,1,0,1,456,1.4285714285714286,0.42947724,0
2020-06-09-170909,170909,2,0,2,458,1.1428571428571428,0.3774147,1
2020-06-10-170909,170909,2,0,2,460,2.142857142857143,0.3641675,2
2020-06-11-170909,170909,2,0,2,462,2.0,0.39226288,3
2020-06-12-170909,170909,3,0,0,465,1.2857142857142858,0.30130124,4
2020-06-13-170909,170909,0,1,0,465,0.14285714285714285,0.013630547,5
2020-06-14-170909,170909,1,0,0,466,0.0,0.04803032,6
2020-06-15-170909,170909,4,0,3,470,1.8571428571428568,0.43851155,0
2020-06-16-170909,170909,3,0,2,473,2.142857142857143,0.4835767,1
2020-06-17-170909,170909,3,0,1,476,1.0,0.33850345,2
2020-06-18-170909,170909,3,0,0,479,1.2857142857142858,0.3255579,3
2020-06-19-170909,170909,3,0,0,482,2.142857142857143,0.52763444,4
2020-06-20-170909,170909,2,0,1,484,0.14285714285714285,0.14076915,5
2020-06-21-170909,170909,1,0,0,485,0.0,0.05442708,6
2020-06-22-170909,170909,1,0,0,486,1.2857142857142858,0.2056607,0
2020-06-23-170909,170909,2,0,0,488,1.2857142857142858,0.38095734,1
2020-06-24-170909,170909,2,0,3,490,0.8571428571428571,0.20159945,2
2020-06-25-170909,170909,2,0,1,492,0.2857142857142857,0.17905772,3
2020-06-26-170909,170909,0,0,2,492,0.7142857142857143,0.16321608,4
2020-06-27-170909,170909,0,0,1,492,0.42857142857142855,0.039525136,5
2020-06-28-170909,170909,0,0,0,492,0.14285714285714285,0.022707,6
2020-06-29-170909,170909,3,0,2,495,1.1428571428571428,0.32124755,0
2020-06-30-170909,170909,2,0,1,497,0.5714285714285714,0.2709065,1
2020-07-01-170909,170909,1,0,5,498,0.5714285714285714,0.15219015,2
2020-07-02-170909,170909,0,0,3,498,0.14285714285714285,0.06303591,3
2020-07-03-170909,170909,0,0,1,498,1.2857142857142858,0.21621685,4
2020-07-04-170909,170909,1,0,0,499,0.14285714285714285,0.085971355,5
2020-07-05-170909,170909,0,0,0,499,0.14285714285714285,0.023401182,6
2020-07-06-170909,170909,0,0,2,499,0.5714285714285714,0.15896289,0
2020-07-07-170909,170909,0,0,0,499,0.42857142857142855,0.086925074,1
2020-07-08-170909,170909,3,2,1,502,0.7142857142857143,0.26248255,2
2020-07-09-170909,170909,1,0,0,503,0.42857142857142855,0.099416636,3
2020-07-10-170909,170909,2,0,3,505,1.0,0.19881432,4
2020-07-11-170909,170909,1,0,0,506,1.2857142857142858,0.012596443,5
2020-07-12-170909,170909,0,0,0,506,0.8571428571428571,0.02323383,6
2020-07-13-170909,170909,2,0,4,508,0.2857142857142857,0.19102721,0
2020-07-14-170909,170909,1,0,2,509,0.7142857142857143,0.10632967,1
2020-07-15-170909,170909,5,0,3,514,0.5714285714285714,0.22865398,2
2020-07-16-170909,170909,3,0,3,517,0.5714285714285714,0.068837866,3
2020-07-17-170909,170909,1,0,3,518,1.5714285714285714,0.3097694,4
2020-07-18-170909,170909,0,0,0,518,0.14285714285714285,0.009495349,5
2020-07-19-170909,170909,0,0,0,518,0.5714285714285714,0.106070355,6
2020-07-20-170909,170909,2,0,0,520,0.5714285714285714,0.21921691,0
2020-07-21-170909,170909,0,0,1,520,0.8571428571428571,0.25931728,1
2020-07-22-170909,170909,1,0,1,521,0.8571428571428571,0.13434,2
2020-07-23-170909,170909,0,0,0,521,0.8571428571428571,0.19423626,3
2020-07-24-170909,170909,3,0,3,524,0.7142857142857143,0.23288947,4
2020-07-25-170909,170909,0,0,0,524,0.14285714285714285,0.024569301,5
2020-07-26-170909,170909,0,0,0,524,0.14285714285714285,0.041644838,6
2020-07-27-170909,170909,4,0,3,528,0.5714285714285714,0.42139715,0
2020-07-28-170909,170909,2,0,7,530,0.7142857142857143,0.28812426,1
2020-07-29-170909,170909,3,0,1,533,0.7142857142857143,0.29047883,2
2020-07-30-170909,170909,3,0,3,536,2.0,0.150033,3
2020-07-31-170909,170909,3,0,4,539,1.2857142857142858,0.20354271,4
2020-08-01-170909,170909,0,0,0,539,1.5714285714285714,0.1351439,5
2020-08-02-170909,170909,0,0,0,539,0.42857142857142855,0.0587137,6
2020-08-03-170909,170909,0,0,2,539,0.7142857142857143,0.14785914,0
2020-08-04-170909,170909,1,0,5,540,1.1428571428571428,0.1932678,1
2020-08-05-170909,170909,1,0,5,541,0.5714285714285714,0.35880795,2
2020-08-06-170909,170909,0,0,5,541,1.0,0.1304603,3
2020-08-07-170909,170909,3,0,8,544,1.4285714285714286,0.21494369,4
2020-08-08-170909,170909,0,0,3,544,3.1428571428571432,0.12308497,5
2020-08-09-170909,170909,0,0,4,544,1.4285714285714286,0.08279944,6
2020-08-10-170909,170909,3,0,13,547,1.7142857142857142,0.19846873,0
2020-08-11-170909,170909,7,0,10,554,2.2857142857142856,0.5456161,1
2020-08-12-170909,170909,1,0,10,555,0.42857142857142855,0.16424806,2
2020-08-13-170909,170909,3,1,21,558,2.8571428571428568,0.44779283,3
2020-08-14-170909,170909,4,0,19,562,2.7142857142857144,0.4387383,4
2020-08-15-170909,170909,0,0,3,562,0.42857142857142855,0.21881118,5
2020-08-16-170909,170909,0,0,1,562,2.2857142857142856,0.13756998,6
2020-08-17-170909,170909,2,0,6,564,2.571428571428572,0.3420659,0
2020-08-18-170909,170909,5,0,11,569,3.0,0.64985657,1
2020-08-19-170909,170909,5,0,12,574,3.2857142857142856,0.73346883,2
2020-08-20-170909,170909,5,0,7,579,4.857142857142857,1.0601157,3
2020-08-21-170909,170909,8,0,5,587,3.8571428571428568,1.1090584,4
2020-08-22-170909,170909,3,0,0,590,1.0,0.42852718,5
2020-08-23-170909,170909,4,0,2,594,2.0,0.345251,6
2020-08-24-170909,170909,13,0,8,607,4.142857142857143,1.0682273,0
2020-08-25-170909,170909,10,0,1,617,9.857142857142858,1.4537495,1
2020-08-26-170909,170909,10,0,13,627,6.857142857142858,1.1935622,2
2020-08-27-170909,170909,21,0,17,648,9.714285714285714,1.7831234,3
2020-08-28-170909,170909,19,0,15,667,8.714285714285714,1.8777857,4
2020-08-29-170909,170909,3,0,7,670,0.5714285714285714,0.3481488,5
2020-08-30-170909,170909,1,0,3,671,1.1428571428571428,0.44619137,6
2020-08-31-170909,170909,6,0,17,677,7.0,0.74254066,0
2020-09-01-170909,170909,11,0,22,688,3.7142857142857135,0.7292296,1
2020-09-02-170909,170909,12,0,18,700,5.571428571428571,0.908906,2
2020-09-03-170909,170909,7,0,17,707,5.142857142857143,1.0262021,3
2020-09-04-170909,170909,5,0,23,712,4.571428571428571,0.7992758,4
2020-09-05-170909,170909,0,0,2,712,1.7142857142857142,0.47696927,5
2020-09-06-170909,170909,2,0,7,714,4.0,0.8802373,6
2020-09-07-170909,170909,8,0,18,722,5.7142857142857135,1.0895171,0
2020-09-08-170909,170909,1,0,21,723,2.4285714285714284,0.6890434,1
2020-09-09-170909,170909,13,0,15,736,5.857142857142858,1.4040546,2
2020-09-10-170909,170909,17,0,11,753,9.142857142857142,1.7611313,3
2020-09-11-170909,170909,15,0,15,768,6.2857142857142865,1.7349712,4
2020-09-12-170909,170909,7,0,13,775,1.1428571428571428,0.7419967,5
2020-09-13-170909,170909,3,0,0,778,0.7142857142857143,0.33804217,6
2020-09-14-170909,170909,17,0,3,795,7.571428571428571,1.498835,0
2020-09-15-170909,170909,22,0,11,817,10.0,2.2166936,1
2020-09-16-170909,170909,18,0,10,835,11.142857142857142,1.6029903,2
2020-09-17-170909,170909,17,0,12,852,7.142857142857142,1.7906096,3
2020-09-18-170909,170909,23,0,15,875,10.714285714285714,2.0375354,4
2020-09-19-170909,170909,2,2,1,877,9.285714285714286,1.0035307,5
2020-09-20-170909,170909,7,0,0,884,1.8571428571428568,0.49714392,6
2020-09-21-170909,170909,18,0,6,902,8.428571428571429,1.3986807,0
2020-09-22-170909,170909,21,1,11,923,9.142857142857142,1.792875,1
2020-09-23-170909,170909,15,0,11,938,7.0,1.4756985,2
2020-09-24-170909,170909,11,0,4,949,6.857142857142858,2.0228715,3
2020-09-25-170909,170909,15,0,11,964,10.0,1.5190868,4
2020-09-26-170909,170909,13,0,4,977,6.571428571428571,1.5573157,5
2020-09-27-170909,170909,0,0,1,977,0.42857142857142855,0.21277589,6
2020-09-28-170909,170909,3,0,2,980,4.285714285714286,0.8180902,0
2020-09-29-170909,170909,11,0,8,991,5.0,1.151444,1
2020-09-30-170909,170909,10,0,14,1001,6.0,1.1692095,2
2020-10-01-170909,170909,12,0,10,1013,8.285714285714286,1.7051388,3
2020-10-02-170909,170909,15,0,11,1028,8.428571428571429,1.61615,4
2020-10-03-170909,170909,1,1,1,1029,2.4285714285714284,0.65462977,5
2020-10-04-170909,170909,0,1,3,1029,2.8571428571428568,0.17967564,6
2020-10-05-170909,170909,6,0,9,1035,8.428571428571429,0.8898762,0
2020-10-06-170909,170909,11,0,52,1046,9.0,1.9827039,1
2020-10-07-170909,170909,11,0,23,1057,8.285714285714286,1.778162,2
2020-10-08-170909,170909,4,0,31,1061,5.428571428571429,1.6287705,3
2020-10-09-170909,170909,11,4,34,1072,4.428571428571429,1.9271629,4
2020-10-10-170909,170909,4,0,9,1076,1.5714285714285714,0.6308874,5
2020-10-11-170909,170909,1,0,3,1077,0.7142857142857143,0.34832618,6
2020-10-12-170909,170909,2,0,18,1079,1.2857142857142858,0.36171097,0
2020-10-13-170909,170909,8,0,24,1087,9.0,1.5091939,1
2020-10-14-170909,170909,14,0,30,1101,6.428571428571429,1.6303557,2
2020-10-15-170909,170909,10,0,45,1111,6.571428571428571,1.4746983,3
2020-10-16-170909,170909,11,0,29,1122,5.857142857142858,1.5555537,4
2020-10-17-170909,170909,1,0,16,1123,3.571428571428572,0.7194104,5
2020-10-18-170909,170909,3,0,45,1126,2.2857142857142856,0.4230977,6
2020-10-19-170909,170909,9,0,18,1135,8.0,2.423652,0
2020-10-20-170909,170909,52,0,26,1187,12.142857142857142,3.216069,1
2020-10-21-170909,170909,23,0,36,1210,11.142857142857142,2.2214015,2
2020-10-22-170909,170909,31,0,72,1241,14.857142857142858,1.6065046,3
2020-10-23-170909,170909,34,0,51,1275,19.0,3.3716886,4
2020-10-24-170909,170909,9,0,10,1284,3.2857142857142856,1.1814122,5
2020-10-25-170909,170909,3,1,43,1287,1.7142857142857142,0.45340678,6
2020-10-26-170909,170909,18,2,29,1305,14.857142857142858,2.4035594,0
2020-10-27-170909,170909,24,0,22,1329,12.857142857142858,2.8609054,1
2020-10-28-170909,170909,30,0,9,1359,15.714285714285715,3.5664008,2
2020-10-29-170909,170909,45,0,29,1404,19.0,3.6180866,3
2020-10-30-170909,170909,29,1,26,1433,18.428571428571427,4.0819373,4
2020-10-31-170909,170909,16,0,0,1449,5.7142857142857135,1.6922626,5
2020-11-01-170909,170909,45,0,0,1494,2.2857142857142856,2.3297427,6
2020-11-02-170909,170909,18,3,0,1512,2.8571428571428568,0.81762785,0
2020-11-03-170909,170909,26,2,0,1538,15.285714285714285,2.426711,1
2020-11-04-170909,170909,36,1,0,1574,17.428571428571427,3.6706238,2
2020-11-05-170909,170909,72,1,0,1646,21.428571428571427,4.613475,3
2020-11-06-170909,170909,51,7,0,1697,17.0,3.6340327,4
2020-11-07-170909,170909,10,6,0,1707,2.571428571428572,1.1259224,5
2020-11-08-170909,170909,43,2,0,1750,3.4285714285714284,2.1375716,6
2020-11-09-170909,170909,29,2,0,1779,14.285714285714285,2.4545054,0
2020-11-10-170909,170909,22,5,0,1801,11.285714285714285,2.4572365,1
2020-11-11-170909,170909,9,3,0,1810,11.428571428571427,1.8296683,2
2020-11-12-170909,170909,29,3,0,1839,11.285714285714285,2.6583698,3
2020-11-13-170909,170909,26,7,0,1865,12.142857142857142,2.3153436,4
2020-03-01-170910,170910,0,0,0,0,0.0,0.00021909294,6
2020-03-02-170910,170910,0,0,2,0,0.0,0.0005462665,0
2020-03-03-170910,170910,0,0,0,0,0.0,0.00010835473,1
2020-03-04-170910,170910,0,1,0,0,0.14285714285714285,0.0062056063,2
2020-03-05-170910,170910,0,0,0,0,0.0,0.0003609834,3
2020-03-06-170910,170910,0,0,0,0,0.0,0.00058127317,4
2020-03-07-170910,170910,0,0,0,0,0.0,0.0003230669,5
2020-03-08-170910,170910,0,0,0,0,0.0,0.00026231506,6
2020-03-09-170910,170910,0,0,1,0,0.14285714285714285,0.014174772,0
2020-03-10-170910,170910,0,0,2,0,0.0,0.021461572,1
2020-03-11-170910,170910,0,0,3,0,0.14285714285714285,0.13168469,2
2020-03-12-170910,170910,0,0,0,0,0.0,0.0064676874,3
2020-03-13-170910,170910,0,0,1,0,0.0,0.028903008,4
2020-03-14-170910,170910,0,0,0,0,0.0,0.002784778,5
2020-03-15-170910,170910,0,0,0,0,0.14285714285714285,0.09299426,6
2020-03-16-170910,170910,2,0,0,2,1.4285714285714286,0.37473074,0
2020-03-17-170910,170910,0,0,0,2,1.1428571428571428,0.21255808,1
2020-03-18-170910,170910,0,0,1,2,1.7142857142857142,0.19808096,2
2020-03-19-170910,170910,0,0,0,2,2.4285714285714284,0.3426193,3
2020-03-20-170910,170910,0,0,2,2,2.4285714285714284,0.31103557,4
2020-03-21-170910,170910,0,0,0,2,0.8571428571428571,0.15682647,5
2020-03-22-170910,170910,0,1,1,2,0.7142857142857143,0.1707459,6
2020-03-23-170910,170910,1,0,2,3,2.7142857142857144,0.52023643,0
2020-03-24-170910,170910,2,0,2,5,2.4285714285714284,0.56426984,1
2020-03-25-170910,170910,3,0,0,8,2.142857142857143,0.6328767,2
2020-03-26-170910,170910,0,0,0,8,1.5714285714285714,0.4596188,3
2020-03-27-170910,170910,1,0,1,9,1.5714285714285714,0.3883093,4
2020-03-28-170910,170910,0,0,0,9,0.5714285714285714,0.04517585,5
2020-03-29-170910,170910,0,0,1,9,0.14285714285714285,0.046887342,6
2020-03-30-170910,170910,0,0,3,9,1.0,0.13407266,0
2020-03-31-170910,170910,0,0,3,9,1.5714285714285714,0.17843258,1
2020-04-01-170910,170910,1,0,0,10,2.0,0.36236927,2
2020-04-02-170910,170910,0,0,0,10,0.2857142857142857,0.16052184,3
2020-04-03-170910,170910,2,0,1,12,1.0,0.30134195,4
2020-04-04-170910,170910,0,0,0,12,0.5714285714285714,0.1605746,5
2020-04-05-170910,170910,1,1,0,13,0.0,0.07788221,6
2020-04-06-170910,170910,2,1,0,15,1.1428571428571428,0.2791,0
2020-04-07-170910,170910,2,0,0,17,1.1428571428571428,0.38081154,1
2020-04-08-170910,170910,0,0,0,17,1.4285714285714286,0.1444229,2
2020-04-09-170910,170910,0,1,0,17,0.5714285714285714,0.055486158,3
2020-04-10-170910,170910,1,0,1,18,0.8571428571428571,0.13033019,4
2020-04-11-170910,170910,0,0,0,18,0.5714285714285714,0.036318023,5
2020-04-12-170910,170910,1,0,0,19,0.14285714285714285,0.082585685,6
2020-04-13-170910,170910,3,1,0,22,1.2857142857142858,0.62258744,0
2020-04-14-170910,170910,3,0,0,25,2.2857142857142856,0.4542043,1
2020-04-15-170910,170910,0,0,0,25,1.0,0.11972466,2
2020-04-16-170910,170910,0,0,0,25,1.1428571428571428,0.21939515,3
2020-04-17-170910,170910,1,0,0,26,0.8571428571428571,0.30431896,4
2020-04-18-170910,170910,0,0,0,26,0.2857142857142857,0.08127694,5
2020-04-19-170910,170910,0,0,0,26,0.0,0.01196466,6
2020-04-20-170910,170910,0,0,0,26,1.0,0.1425315,0
2020-04-21-170910,170910,0,0,0,26,2.571428571428572,0.5251958,1
2020-04-22-170910,170910,0,0,1,26,0.8571428571428571,0.22102387,2
2020-04-23-170910,170910,0,0,0,26,0.14285714285714285,0.008485971,3
2020-04-24-170910,170910,1,0,0,27,0.7142857142857143,0.4109086,4
2020-04-25-170910,170910,0,0,0,27,0.8571428571428571,0.1484191,5
2020-04-26-170910,170910,0,0,0,27,0.2857142857142857,0.02078048,6
2020-04-27-170910,170910,0,0,0,27,0.2857142857142857,0.048659235,0
2020-04-28-170910,170910,0,0,0,27,1.0,0.24514627,1
2020-04-29-170910,170910,0,0,1,27,0.42857142857142855,0.12113074,2
2020-04-30-170910,170910,0,0,0,27,0.14285714285714285,0.0455643,3
2020-05-01-170910,170910,0,0,0,27,0.0,0.0050159832,4
2020-05-02-170910,170910,0,0,0,27,0.14285714285714285,0.005955038,5
2020-05-03-170910,170910,0,0,0,27,0.14285714285714285,0.019369794,6
2020-05-04-170910,170910,0,0,0,27,0.2857142857142857,0.019629143,0
2020-05-05-170910,170910,0,0,0,27,0.8571428571428571,0.06813607,1
2020-05-06-170910,170910,1,0,1,28,0.8571428571428571,0.2448363,2
2020-05-07-170910,170910,0,0,0,28,1.0,0.32560945,3
2020-05-08-170910,170910,0,0,1,28,0.7142857142857143,0.09788092,4
2020-05-09-170910,170910,0,0,0,28,0.2857142857142857,0.03013104,5
2020-05-10-170910,170910,0,0,0,28,0.14285714285714285,0.09580417,6
2020-05-11-170910,170910,0,0,0,28,0.5714285714285714,0.20277864,0
2020-05-12-170910,170910,0,0,0,28,0.5714285714285714,0.15651746,1
2020-05-13-170910,170910,1,0,0,29,0.8571428571428571,0.26562575,2
2020-05-14-170910,170910,0,0,1,29,1.2857142857142858,0.15735288,3
2020-05-15-170910,170910,0,0,1,29,0.14285714285714285,0.027784694,4
2020-05-16-170910,170910,0,0,0,29,0.14285714285714285,0.012682591,5
2020-05-17-170910,170910,0,0,1,29,0.14285714285714285,0.007884351,6
2020-05-18-170910,170910,0,0,0,29,0.42857142857142855,0.2791401,0
2020-05-19-170910,170910,0,0,0,29,0.42857142857142855,0.07314952,1
2020-05-20-170910,170910,1,0,0,30,0.2857142857142857,0.14723398,2
2020-05-21-170910,170910,0,0,0,30,0.2857142857142857,0.04483234,3
2020-05-22-170910,170910,1,0,0,31,0.42857142857142855,0.1824561,4
2020-05-23-170910,170910,0,0,0,31,0.14285714285714285,0.020865532,5
2020-05-24-170910,170910,0,0,0,31,0.0,0.0016428255,6
2020-05-25-170910,170910,0,0,1,31,0.42857142857142855,0.07590436,0
2020-05-26-170910,170910,0,0,1,31,0.2857142857142857,0.03892096,1
2020-05-27-170910,170910,0,1,0,31,0.2857142857142857,0.10507466,2
2020-05-28-170910,170910,1,0,0,32,0.14285714285714285,0.20824726,3
2020-05-29-170910,170910,1,0,0,33,0.14285714285714285,0.18226643,4
2020-05-30-170910,170910,0,0,0,33,0.14285714285714285,0.016678827,5
2020-05-31-170910,170910,1,0,0,34,0.14285714285714285,0.2082198,6
2020-06-01-170910,170910,0,0,0,34,0.5714285714285714,0.1922666,0
2020-06-02-170910,170910,0,0,0,34,0.14285714285714285,0.053811528,1
2020-06-03-170910,170910,0,0,0,34,0.0,0.042149376,2
2020-06-04-170910,170910,0,0,0,34,0.0,0.019081192,3
2020-06-05-170910,170910,0,0,0,34,0.2857142857142857,0.049477145,4
2020-06-06-170910,170910,0,0,0,34,0.0,0.0017412817,5
2020-06-07-170910,170910,0,0,0,34,0.0,0.0014938953,6
2020-06-08-170910,170910,1,0,0,35,0.42857142857142855,0.17373657,0
2020-06-09-170910,170910,1,0,1,36,0.5714285714285714,0.1896282,1
2020-06-10-170910,170910,0,0,0,36,0.7142857142857143,0.14604144,2
2020-06-11-170910,170910,0,0,0,36,0.2857142857142857,0.047889933,3
2020-06-12-170910,170910,0,0,0,36,0.2857142857142857,0.037728786,4
2020-06-13-170910,170910,0,0,0,36,0.0,0.0033081854,5
2020-06-14-170910,170910,0,0,0,36,0.14285714285714285,0.1397168,6
2020-06-15-170910,170910,0,0,0,36,0.42857142857142855,0.051218875,0
2020-06-16-170910,170910,0,0,0,36,0.0,0.016692452,1
2020-06-17-170910,170910,0,0,0,36,0.0,0.016213804,2
2020-06-18-170910,170910,0,0,0,36,0.0,0.012128871,3
2020-06-19-170910,170910,0,0,0,36,0.0,0.010693296,4
2020-06-20-170910,170910,0,0,0,36,0.0,0.002126454,5
2020-06-21-170910,170910,0,0,0,36,0.0,0.0006760442,6
2020-06-22-170910,170910,0,0,1,36,0.14285714285714285,0.02123117,0
2020-06-23-170910,170910,1,0,0,37,0.2857142857142857,0.16298662,1
2020-06-24-170910,170910,0,0,0,37,0.2857142857142857,0.042845804,2
2020-06-25-170910,170910,0,0,0,37,0.42857142857142855,0.05432075,3
2020-06-26-170910,170910,0,0,0,37,0.14285714285714285,0.036804188,4
2020-06-27-170910,170910,0,0,1,37,0.0,0.0045588836,5
2020-06-28-170910,170910,0,0,0,37,0.0,9.413592e-06,6
2020-06-29-170910,170910,0,0,0,37,0.14285714285714285,0.04814842,0
2020-06-30-170910,170910,0,0,0,37,0.2857142857142857,0.08528105,1
2020-07-01-170910,170910,0,0,0,37,0.14285714285714285,0.024903996,2
2020-07-02-170910,170910,0,0,1,37,0.0,0.009660325,3
2020-07-03-170910,170910,0,0,0,37,0.14285714285714285,0.04378415,4
2020-07-04-170910,170910,0,0,0,37,0.0,0.0008197208,5
2020-07-05-170910,170910,0,0,1,37,0.0,0.007132047,6
2020-07-06-170910,170910,1,0,0,38,0.0,0.13815859,0
2020-07-07-170910,170910,0,0,1,38,0.0,0.0072309086,1
2020-07-08-170910,170910,0,0,1,38,0.2857142857142857,0.04032505,2
2020-07-09-170910,170910,0,0,0,38,0.14285714285714285,0.017941402,3
2020-07-10-170910,170910,0,0,0,38,0.2857142857142857,0.06829518,4
2020-07-11-170910,170910,1,0,0,39,0.14285714285714285,0.12506212,5
2020-07-12-170910,170910,0,0,0,39,0.0,0.0004210668,6
2020-07-13-170910,170910,0,0,1,39,0.0,0.0034635852,0
2020-07-14-170910,170910,0,0,2,39,0.0,0.014993502,1
2020-07-15-170910,170910,0,0,0,39,0.14285714285714285,0.029124632,2
2020-07-16-170910,170910,1,0,2,40,0.0,0.13772824,3
2020-07-17-170910,170910,0,0,1,40,0.2857142857142857,0.18123212,4
2020-07-18-170910,170910,0,0,0,40,0.0,0.0024529968,5
2020-07-19-170910,170910,1,0,0,41,0.14285714285714285,0.14029568,6
2020-07-20-170910,170910,0,0,0,41,0.0,0.014207199,0
2020-07-21-170910,170910,1,0,0,42,0.2857142857142857,0.21857564,1
2020-07-22-170910,170910,1,0,0,43,0.0,0.006163271,2
2020-07-23-170910,170910,0,0,0,43,0.2857142857142857,0.07552343,3
2020-07-24-170910,170910,0,0,0,43,0.0,0.014455951,4
2020-07-25-170910,170910,0,0,0,43,0.0,0.00037348527,5
2020-07-26-170910,170910,0,0,0,43,0.0,0.0012654891,6
2020-07-27-170910,170910,1,0,0,44,0.0,0.020030102,0
2020-07-28-170910,170910,2,0,1,46,0.0,0.15004696,1
2020-07-29-170910,170910,0,0,1,46,0.0,0.012840568,2
2020-07-30-170910,170910,2,0,1,48,0.0,0.014333116,3
2020-07-31-170910,170910,1,0,0,49,0.14285714285714285,0.02176713,4
2020-08-01-170910,170910,0,0,0,49,0.0,0.0033408226,5
2020-08-02-170910,170910,0,0,0,49,0.2857142857142857,0.05250786,6
2020-08-03-170910,170910,0,0,0,49,0.14285714285714285,0.058005486,0
2020-08-04-170910,170910,0,0,0,49,0.2857142857142857,0.0413205,1
2020-08-05-170910,170910,0,0,0,49,0.2857142857142857,0.055550516,2
2020-08-06-170910,170910,0,1,1,49,0.2857142857142857,0.06257113,3
2020-08-07-170910,170910,0,0,3,49,0.14285714285714285,0.08018599,4
2020-08-08-170910,170910,0,1,2,49,0.14285714285714285,0.026921602,5
2020-08-09-170910,170910,0,0,0,49,0.42857142857142855,0.063651636,6
2020-08-10-170910,170910,0,0,2,49,0.42857142857142855,0.09552254,0
2020-08-11-170910,170910,1,0,4,50,0.2857142857142857,0.28492743,1
2020-08-12-170910,170910,1,0,1,51,0.0,0.16234134,2
2020-08-13-170910,170910,1,0,6,52,0.5714285714285714,0.09304629,3
2020-08-14-170910,170910,0,0,2,52,0.14285714285714285,0.12396478,4
2020-08-15-170910,170910,0,0,0,52,0.0,0.040609702,5
2020-08-16-170910,170910,0,0,0,52,0.0,0.06303004,6
2020-08-17-170910,170910,0,0,0,52,0.2857142857142857,0.30445722,0
2020-08-18-170910,170910,0,0,0,52,0.0,0.09463788,1
2020-08-19-170910,170910,0,0,2,52,0.2857142857142857,0.19613422,2
2020-08-20-170910,170910,1,0,2,53,0.8571428571428571,0.21917169,3
2020-08-21-170910,170910,3,0,2,56,1.2857142857142858,0.43426427,4
2020-08-22-170910,170910,2,0,0,58,0.14285714285714285,0.28441647,5
2020-08-23-170910,170910,0,0,0,58,0.0,0.038399898,6
2020-08-24-170910,170910,2,0,5,60,0.14285714285714285,0.42262447,0
2020-08-25-170910,170910,4,0,2,64,2.2857142857142856,0.84598523,1
2020-08-26-170910,170910,1,0,4,65,1.4285714285714286,0.36998492,2
2020-08-27-170910,170910,6,0,0,71,1.2857142857142858,0.5834857,3
2020-08-28-170910,170910,2,0,3,73,0.7142857142857143,0.18944484,4
2020-08-29-170910,170910,0,0,0,73,1.2857142857142858,0.2375414,5
2020-08-30-170910,170910,0,0,0,73,0.5714285714285714,0.20442544,6
2020-08-31-170910,170910,0,0,0,73,1.0,0.2735086,0
2020-09-01-170910,170910,0,0,1,73,0.2857142857142857,0.22461775,1
2020-09-02-170910,170910,2,0,1,75,1.0,0.34129986,2
2020-09-03-170910,170910,2,0,0,77,0.5714285714285714,0.2607861,3
2020-09-04-170910,170910,2,0,2,79,1.8571428571428568,0.3597198,4
2020-09-05-170910,170910,0,0,0,79,0.0,0.04897592,5
2020-09-06-170910,170910,0,0,1,79,0.2857142857142857,0.035870936,6
2020-09-07-170910,170910,5,0,3,84,0.7142857142857143,0.7381936,0
2020-09-08-170910,170910,2,0,2,86,0.0,0.7235009,1
2020-09-09-170910,170910,4,0,9,90,2.8571428571428568,0.53874815,2
2020-09-10-170910,170910,0,0,2,90,1.8571428571428568,0.3092247,3
2020-09-11-170910,170910,3,0,44,93,1.7142857142857142,0.7173618,4
2020-09-12-170910,170910,0,0,3,93,0.8571428571428571,0.22143105,5
2020-09-13-170910,170910,0,0,0,93,0.2857142857142857,0.10497648,6
2020-09-14-170910,170910,0,0,0,93,1.1428571428571428,0.29830903,0
2020-09-15-170910,170910,1,0,2,94,0.7142857142857143,0.25472835,1
2020-09-16-170910,170910,1,0,8,95,1.5714285714285714,0.22523801,2
2020-09-17-170910,170910,0,0,1,95,3.0,0.7625368,3
2020-09-18-170910,170910,2,0,0,97,2.142857142857143,0.56033695,4
2020-09-19-170910,170910,0,0,1,97,0.7142857142857143,0.08055859,5
2020-09-20-170910,170910,1,1,3,98,0.2857142857142857,0.13248526,6
2020-09-21-170910,170910,3,0,2,101,2.7142857142857144,0.48601073,0
2020-09-22-170910,170910,2,1,1,103,2.8571428571428568,0.54077613,1
2020-09-23-170910,170910,9,0,6,112,3.4285714285714284,0.8559754,2
2020-09-24-170910,170910,2,0,2,114,10.428571428571429,0.853228,3
2020-09-25-170910,170910,44,1,1,158,2.7142857142857144,5.0461416,4
2020-09-26-170910,170910,3,0,2,161,0.2857142857142857,0.23788722,5
2020-09-27-170910,170910,0,0,0,161,0.7142857142857143,0.31183055,6
2020-09-28-170910,170910,0,0,0,161,1.2857142857142858,0.15795319,0
2020-09-29-170910,170910,2,1,1,163,2.8571428571428568,0.26991498,1
2020-09-30-170910,170910,8,0,0,171,2.2857142857142856,0.69261605,2
2020-10-01-170910,170910,1,0,1,172,2.8571428571428568,0.42387104,3
2020-10-02-170910,170910,0,1,2,172,4.0,0.5082944,4
2020-10-03-170910,170910,1,0,0,173,2.8571428571428568,0.16215204,5
2020-10-04-170910,170910,3,0,3,176,0.42857142857142855,0.32398072,6
2020-10-05-170910,170910,2,2,6,178,1.8571428571428568,0.29152536,0
2020-10-06-170910,170910,1,0,0,179,1.4285714285714286,0.32736835,1
2020-10-07-170910,170910,6,0,2,185,2.2857142857142856,0.93067735,2
2020-10-08-170910,170910,2,0,5,187,2.8571428571428568,0.9990393,3
2020-10-09-170910,170910,1,1,0,188,3.2857142857142856,0.55251193,4
2020-10-10-170910,170910,2,0,0,190,1.5714285714285714,0.49425328,5
2020-10-11-170910,170910,0,0,1,190,0.42857142857142855,0.479398,6
2020-10-12-170910,170910,0,0,0,190,1.8571428571428568,0.672153,0
2020-10-13-170910,170910,1,0,1,191,3.4285714285714284,1.120906,1
2020-10-14-170910,170910,0,0,1,191,3.7142857142857135,0.86963516,2
2020-10-15-170910,170910,1,0,4,192,8.571428571428571,1.7886548,3
2020-10-16-170910,170910,2,0,2,194,4.142857142857143,1.0018697,4
2020-10-17-170910,170910,0,0,0,194,3.8571428571428568,1.2189763,5
2020-10-18-170910,170910,3,1,0,197,2.2857142857142856,1.2611682,6
2020-10-19-170910,170910,6,0,0,203,4.0,1.9975958,0
2020-10-20-170910,170910,0,0,0,203,4.428571428571429,0.9086387,1
2020-10-21-170910,170910,2,1,2,205,6.2857142857142865,2.1134975,2
2020-10-22-170910,170910,5,0,2,210,3.8571428571428568,1.5869678,3
2020-10-23-170910,170910,0,0,4,210,9.571428571428571,2.099609,4
2020-10-24-170910,170910,0,0,0,210,0.7142857142857143,0.20896973,5
2020-10-25-170910,170910,1,2,0,211,3.0,0.829295,6
2020-10-26-170910,170910,0,0,1,211,4.142857142857143,0.72561884,0
2020-10-27-170910,170910,1,0,3,212,1.2857142857142858,0.60858893,1
2020-10-28-170910,170910,1,0,0,213,2.0,0.71,2
2020-10-29-170910,170910,4,0,1,217,4.428571428571429,0.9258346,3
2020-10-30-170910,170910,2,0,1,219,3.8571428571428568,1.3415334,4
2020-10-31-170910,170910,0,0,0,219,1.0,0.42977136,5
2020-11-01-170910,170910,0,0,0,219,3.4285714285714284,0.3696498,6
2020-11-02-170910,170910,0,0,0,219,1.2857142857142858,0.43095422,0
2020-11-03-170910,170910,0,0,0,219,3.4285714285714284,1.1444374,1
2020-11-04-170910,170910,2,0,0,221,2.2857142857142856,1.148186,2
2020-11-05-170910,170910,2,0,0,223,4.857142857142857,1.1249002,3
2020-11-06-170910,170910,4,1,0,227,7.2857142857142865,1.2495425,4
2020-11-07-170910,170910,0,0,0,227,2.8571428571428568,0.3489584,5
2020-11-08-170910,170910,0,0,0,227,1.0,0.11417232,6
2020-11-09-170910,170910,1,0,0,228,6.428571428571429,0.727592,0
2020-11-10-170910,170910,3,1,0,231,4.428571428571429,0.6580128,1
2020-11-11-170910,170910,0,1,0,231,4.428571428571429,0.7622916,2
2020-11-12-170910,170910,1,0,0,232,7.142857142857142,1.1012328,3
2020-11-13-170910,170910,1,0,0,233,7.7142857142857135,1.198569,4
2020-03-01-170913,170913,0,0,2,0,0.0,0.000304335,6
2020-03-02-170913,170913,0,0,0,0,0.0,0.0019979707,0
2020-03-03-170913,170913,0,2,2,0,0.0,2.4262957e-07,1
2020-03-04-170913,170913,0,0,2,0,0.0,0.016232498,2
2020-03-05-170913,170913,0,0,1,0,0.0,0.00022658365,3
2020-03-06-170913,170913,0,0,7,0,0.14285714285714285,0.00801279,4
2020-03-07-170913,170913,0,0,3,0,0.0,0.003142564,5
2020-03-08-170913,170913,0,0,2,0,0.0,0.0009141887,6
2020-03-09-170913,170913,0,0,7,0,0.14285714285714285,0.01925752,0
2020-03-10-170913,170913,1,0,6,1,0.14285714285714285,0.086697266,1
2020-03-11-170913,170913,0,0,5,1,0.14285714285714285,0.12221135,2
2020-03-12-170913,170913,0,0,5,1,0.14285714285714285,0.021071786,3
2020-03-13-170913,170913,1,0,3,2,0.2857142857142857,0.11607399,4
2020-03-14-170913,170913,0,0,0,2,0.14285714285714285,0.012083812,5
2020-03-15-170913,170913,2,0,1,4,0.2857142857142857,0.09508978,6
2020-03-16-170913,170913,0,0,3,4,2.7142857142857144,0.3585519,0
2020-03-17-170913,170913,2,0,4,6,1.2857142857142858,0.2765281,1
2020-03-18-170913,170913,2,4,4,8,2.4285714285714284,0.31162906,2
2020-03-19-170913,170913,1,0,1,9,2.571428571428572,0.40067726,3
2020-03-20-170913,170913,7,0,4,16,2.4285714285714284,0.6099335,4
2020-03-21-170913,170913,3,0,3,19,1.0,0.2572425,5
2020-03-22-170913,170913,2,0,3,21,0.8571428571428571,0.16727109,6
2020-03-23-170913,170913,7,0,2,28,4.571428571428571,0.7975695,0
2020-03-24-170913,170913,6,0,5,34,2.142857142857143,0.64881605,1
2020-03-25-170913,170913,5,0,2,39,2.8571428571428568,0.6114086,2
2020-03-26-170913,170913,5,0,1,44,3.571428571428572,0.7918254,3
2020-03-27-170913,170913,3,0,2,47,3.4285714285714284,0.57597935,4
2020-03-28-170913,170913,0,0,0,47,1.1428571428571428,0.05872844,5
2020-03-29-170913,170913,1,0,1,48,1.7142857142857142,0.15706764,6
2020-03-30-170913,170913,3,0,3,51,2.2857142857142856,0.42441714,0
2020-03-31-170913,170913,4,0,3,55,1.5714285714285714,0.4428147,1
2020-04-01-170913,170913,4,0,2,59,3.0,0.44818294,2
2020-04-02-170913,170913,1,0,2,60,5.285714285714286,0.40129852,3
2020-04-03-170913,170913,4,0,3,64,1.8571428571428568,0.45502445,4
2020-04-04-170913,170913,3,0,0,67,0.2857142857142857,0.17008573,5
2020-04-05-170913,170913,3,0,1,70,0.5714285714285714,0.16870134,6
2020-04-06-170913,170913,2,0,2,72,2.8571428571428568,0.4161436,0
2020-04-07-170913,170913,5,0,2,77,5.0,0.8710978,1
2020-04-08-170913,170913,2,0,1,79,2.2857142857142856,0.27114677,2
2020-04-09-170913,170913,1,4,1,80,3.0,0.16801523,3
2020-04-10-170913,170913,2,0,1,82,1.5714285714285714,0.1665197,4
2020-04-11-170913,170913,0,0,0,82,0.2857142857142857,0.05146697,5
2020-04-12-170913,170913,1,0,0,83,0.42857142857142855,0.07589435,6
2020-04-13-170913,170913,3,0,0,86,2.142857142857143,0.7714271,0
2020-04-14-170913,170913,3,0,0,89,1.7142857142857142,0.51778114,1
2020-04-15-170913,170913,2,0,1,91,2.7142857142857144,0.36103073,2
2020-04-16-170913,170913,2,0,1,93,1.8571428571428568,0.41928804,3
2020-04-17-170913,170913,3,0,0,96,1.2857142857142858,0.5436797,4
2020-04-18-170913,170913,0,0,0,96,0.5714285714285714,0.059643496,5
2020-04-19-170913,170913,1,0,0,97,0.14285714285714285,0.039504975,6
2020-04-20-170913,170913,2,0,0,99,1.2857142857142858,0.35958382,0
2020-04-21-170913,170913,2,0,0,101,3.7142857142857135,1.4493347,1
2020-04-22-170913,170913,1,0,3,102,1.0,0.31376827,2
2020-04-23-170913,170913,1,1,2,103,0.0,0.01605234,3
2020-04-24-170913,170913,1,0,1,104,1.4285714285714286,0.32700652,4
2020-04-25-170913,170913,0,0,1,104,0.42857142857142855,0.08186543,5
2020-04-26-170913,170913,0,0,0,104,0.14285714285714285,0.007913086,6
2020-04-27-170913,170913,0,0,3,104,1.0,0.119740024,0
2020-04-28-170913,170913,0,0,1,104,1.4285714285714286,0.3960316,1
2020-04-29-170913,170913,1,0,0,105,2.142857142857143,0.35722512,2
2020-04-30-170913,170913,1,0,1,106,1.1428571428571428,0.16510992,3
2020-05-01-170913,170913,0,0,0,106,0.2857142857142857,0.01601842,4
2020-05-02-170913,170913,0,0,0,106,0.0,0.013059603,5
2020-05-03-170913,170913,0,0,0,106,0.2857142857142857,0.020274375,6
2020-05-04-170913,170913,0,0,0,106,1.5714285714285714,0.17944504,0
2020-05-05-170913,170913,0,0,0,106,0.7142857142857143,0.081793785,1
2020-05-06-170913,170913,3,0,0,109,2.571428571428572,0.61930096,2
2020-05-07-170913,170913,2,0,0,111,1.4285714285714286,0.5206131,3
2020-05-08-170913,170913,1,0,0,112,1.1428571428571428,0.29430342,4
2020-05-09-170913,170913,1,1,0,113,0.2857142857142857,0.06873728,5
2020-05-10-170913,170913,0,0,0,113,0.42857142857142855,0.056106355,6
2020-05-11-170913,170913,3,0,0,116,0.7142857142857143,0.35241163,0
2020-05-12-170913,170913,1,1,0,117,1.0,0.51361406,1
2020-05-13-170913,170913,0,0,0,117,1.5714285714285714,0.5896737,2
2020-05-14-170913,170913,1,1,1,118,0.8571428571428571,0.39874965,3
2020-05-15-170913,170913,0,0,0,118,0.2857142857142857,0.06242088,4
2020-05-16-170913,170913,0,0,0,118,0.2857142857142857,0.011096564,5
2020-05-17-170913,170913,0,0,0,118,0.0,0.00067600084,6
2020-05-18-170913,170913,0,1,1,118,1.2857142857142858,0.35102677,0
2020-05-19-170913,170913,0,0,0,118,0.7142857142857143,0.16700768,1
2020-05-20-170913,170913,0,0,1,118,0.14285714285714285,0.13957532,2
2020-05-21-170913,170913,0,0,0,118,0.5714285714285714,0.07044994,3
2020-05-22-170913,170913,0,0,0,118,0.7142857142857143,0.2725275,4
2020-05-23-170913,170913,0,1,0,118,0.0,0.00068111136,5
2020-05-24-170913,170913,0,0,0,118,0.14285714285714285,0.010462914,6
2020-05-25-170913,170913,0,0,0,118,1.2857142857142858,0.2569833,0
2020-05-26-170913,170913,0,0,0,118,0.42857142857142855,0.046733644,1
2020-05-27-170913,170913,0,0,0,118,0.5714285714285714,0.093352854,2
2020-05-28-170913,170913,1,2,0,119,0.5714285714285714,0.466681,3
2020-05-29-170913,170913,0,0,0,119,1.0,0.3052538,4
2020-05-30-170913,170913,0,0,0,119,0.42857142857142855,0.026430823,5
2020-05-31-170913,170913,0,1,0,119,0.2857142857142857,0.11873264,6
2020-06-01-170913,170913,1,0,0,120,2.2857142857142856,0.7096698,0
2020-06-02-170913,170913,0,0,0,120,0.7142857142857143,0.14599562,1
2020-06-03-170913,170913,1,0,0,121,1.1428571428571428,0.1956792,2
2020-06-04-170913,170913,0,0,0,121,0.42857142857142855,0.063772716,3
2020-06-05-170913,170913,0,0,0,121,0.7142857142857143,0.14961344,4
2020-06-06-170913,170913,0,0,0,121,0.0,0.0028985315,5
2020-06-07-170913,170913,0,0,0,121,0.14285714285714285,0.01246595,6
2020-06-08-170913,170913,0,0,0,121,0.5714285714285714,0.19032633,0
2020-06-09-170913,170913,0,0,0,121,1.2857142857142858,0.25717798,1
2020-06-10-170913,170913,0,0,0,121,1.0,0.35900176,2
2020-06-11-170913,170913,0,0,0,121,0.7142857142857143,0.109780855,3
2020-06-12-170913,170913,0,0,0,121,1.0,0.09790228,4
2020-06-13-170913,170913,0,1,0,121,0.14285714285714285,0.017822638,5
2020-06-14-170913,170913,0,0,0,121,0.14285714285714285,0.07040724,6
2020-06-15-170913,170913,0,0,0,121,1.0,0.109839275,0
2020-06-16-170913,170913,0,0,0,121,1.4285714285714286,0.16495375,1
2020-06-17-170913,170913,0,0,0,121,0.8571428571428571,0.0975512,2
2020-06-18-170913,170913,0,0,0,121,0.8571428571428571,0.08894139,3
2020-06-19-170913,170913,0,0,0,121,0.7142857142857143,0.0949407,4
2020-06-20-170913,170913,0,0,0,121,0.14285714285714285,0.020680197,5
2020-06-21-170913,170913,0,0,0,121,0.0,0.0024469977,6
2020-06-22-170913,170913,0,0,0,121,0.5714285714285714,0.049972914,0
2020-06-23-170913,170913,0,0,0,121,0.5714285714285714,0.13220002,1
2020-06-24-170913,170913,0,0,0,121,0.2857142857142857,0.052513223,2
2020-06-25-170913,170913,0,0,0,121,0.14285714285714285,0.041718487,3
2020-06-26-170913,170913,0,0,0,121,0.0,0.03413948,4
2020-06-27-170913,170913,0,0,0,121,0.0,0.0061552497,5
2020-06-28-170913,170913,0,0,0,121,0.0,0.0017115781,6
2020-06-29-170913,170913,0,0,0,121,0.5714285714285714,0.14013638,0
2020-06-30-170913,170913,0,0,0,121,0.42857142857142855,0.15322092,1
2020-07-01-170913,170913,0,0,0,121,0.42857142857142855,0.05207808,2
2020-07-02-170913,170913,0,0,1,121,0.14285714285714285,0.02099724,3
2020-07-03-170913,170913,0,0,0,121,0.0,0.01723067,4
2020-07-04-170913,170913,0,0,0,121,0.0,0.0010828797,5
2020-07-05-170913,170913,0,0,0,121,0.14285714285714285,0.07350536,6
2020-07-06-170913,170913,0,0,0,121,0.2857142857142857,0.11775286,0
2020-07-07-170913,170913,0,0,0,121,0.14285714285714285,0.005658389,1
2020-07-08-170913,170913,0,0,0,121,0.0,0.02927111,2
2020-07-09-170913,170913,0,0,0,121,0.14285714285714285,0.013681999,3
2020-07-10-170913,170913,0,1,0,121,0.14285714285714285,0.05417777,4
2020-07-11-170913,170913,0,0,0,121,0.0,0.061291255,5
2020-07-12-170913,170913,0,0,0,121,0.0,0.0014868061,6
2020-07-13-170913,170913,0,0,0,121,0.14285714285714285,0.030624613,0
2020-07-14-170913,170913,0,0,0,121,0.14285714285714285,0.026031153,1
2020-07-15-170913,170913,0,0,0,121,0.42857142857142855,0.06448816,2
2020-07-16-170913,170913,1,0,0,122,0.14285714285714285,0.08011874,3
2020-07-17-170913,170913,0,0,0,122,0.5714285714285714,0.17273434,4
2020-07-18-170913,170913,0,1,0,122,0.0,0.0010541299,5
2020-07-19-170913,170913,0,0,0,122,0.0,0.068817325,6
2020-07-20-170913,170913,0,0,0,122,0.14285714285714285,0.033414945,0
2020-07-21-170913,170913,0,0,0,122,0.8571428571428571,0.43249303,1
2020-07-22-170913,170913,0,0,0,122,0.2857142857142857,0.03649905,2
2020-07-23-170913,170913,0,0,0,122,1.0,0.50563294,3
2020-07-24-170913,170913,0,0,1,122,0.14285714285714285,0.04713481,4
2020-07-25-170913,170913,0,0,0,122,0.0,0.0019874892,5
2020-07-26-170913,170913,0,0,0,122,0.0,0.0016429959,6
2020-07-27-170913,170913,0,0,1,122,0.7142857142857143,0.090503275,0
2020-07-28-170913,170913,0,0,1,122,0.7142857142857143,0.13242266,1
2020-07-29-170913,170913,0,0,0,122,0.42857142857142855,0.07860836,2
2020-07-30-170913,170913,0,0,0,122,0.5714285714285714,0.089515075,3
2020-07-31-170913,170913,0,0,2,122,0.42857142857142855,0.13888054,4
2020-08-01-170913,170913,0,0,0,122,0.0,0.01034819,5
2020-08-02-170913,170913,0,0,2,122,0.42857142857142855,0.06453257,6
2020-08-03-170913,170913,0,0,8,122,0.14285714285714285,0.17677677,0
2020-08-04-170913,170913,0,0,2,122,0.42857142857142855,0.037629515,1
2020-08-05-170913,170913,0,0,2,122,1.5714285714285714,0.18802522,2
2020-08-06-170913,170913,0,0,1,122,0.14285714285714285,0.09871688,3
2020-08-07-170913,170913,1,0,0,123,0.2857142857142857,0.26963142,4
2020-08-08-170913,170913,0,0,0,123,0.5714285714285714,0.038816605,5
2020-08-09-170913,170913,0,0,0,123,0.0,0.07104113,6
2020-08-10-170913,170913,1,0,0,124,0.7142857142857143,0.07132863,0
2020-08-11-170913,170913,1,0,2,125,1.1428571428571428,0.41492176,1
2020-08-12-170913,170913,0,0,0,125,0.2857142857142857,0.18335438,2
2020-08-13-170913,170913,0,0,1,125,0.7142857142857143,0.2031651,3
2020-08-14-170913,170913,2,0,0,127,1.1428571428571428,0.37378857,4
2020-08-15-170913,170913,0,0,0,127,0.2857142857142857,0.06410565,5
2020-08-16-170913,170913,2,0,1,129,0.2857142857142857,0.1971631,6
2020-08-17-170913,170913,8,0,4,137,0.7142857142857143,0.49150115,0
2020-08-18-170913,170913,2,0,3,139,0.8571428571428571,0.24536459,1
2020-08-19-170913,170913,2,0,1,141,0.7142857142857143,0.3738712,2
2020-08-20-170913,170913,1,0,1,142,2.8571428571428568,0.6020536,3
2020-08-21-170913,170913,0,0,4,142,1.1428571428571428,0.17894329,4
2020-08-22-170913,170913,0,0,0,142,0.7142857142857143,0.20081285,5
2020-08-23-170913,170913,0,0,0,142,0.2857142857142857,0.0724694,6
2020-08-24-170913,170913,0,0,6,142,2.0,0.5319006,0
2020-08-25-170913,170913,2,0,1,144,3.4285714285714284,0.8513083,1
2020-08-26-170913,170913,0,0,0,144,2.8571428571428568,0.659277,2
2020-08-27-170913,170913,1,0,0,145,1.7142857142857142,0.68835527,3
2020-08-28-170913,170913,0,0,0,145,3.571428571428572,0.4953957,4
2020-08-29-170913,170913,0,0,4,145,1.7142857142857142,0.27821657,5
2020-08-30-170913,170913,1,0,0,146,2.8571428571428568,0.31676495,6
2020-08-31-170913,170913,4,0,0,150,0.8571428571428571,0.49039713,0
2020-09-01-170913,170913,3,0,1,153,1.4285714285714286,0.5872066,1
2020-09-02-170913,170913,1,0,0,154,3.0,0.46009865,2
2020-09-03-170913,170913,1,0,2,155,1.8571428571428568,0.43974277,3
2020-09-04-170913,170913,4,0,1,159,2.0,0.44281644,4
2020-09-05-170913,170913,0,0,0,159,0.2857142857142857,0.11884057,5
2020-09-06-170913,170913,0,0,0,159,1.1428571428571428,0.08265314,6
2020-09-07-170913,170913,6,0,1,165,1.8571428571428568,1.095646,0
2020-09-08-170913,170913,1,0,8,166,1.7142857142857142,0.5701313,1
2020-09-09-170913,170913,0,0,5,166,1.4285714285714286,0.6725332,2
2020-09-10-170913,170913,0,0,1,166,0.8571428571428571,0.41221103,3
2020-09-11-170913,170913,0,0,2,166,2.2857142857142856,0.5654835,4
2020-09-12-170913,170913,4,0,1,170,1.0,0.73920953,5
2020-09-13-170913,170913,0,0,2,170,0.42857142857142855,0.21611667,6
2020-09-14-170913,170913,0,0,1,170,3.4285714285714284,0.80755955,0
2020-09-15-170913,170913,1,0,0,171,1.1428571428571428,0.3048904,1
2020-09-16-170913,170913,0,0,1,171,2.571428571428572,0.40267935,2
2020-09-17-170913,170913,2,0,2,173,4.714285714285714,1.3850682,3
2020-09-18-170913,170913,1,0,3,174,2.2857142857142856,0.749267,4
2020-09-19-170913,170913,0,0,0,174,2.4285714285714284,0.15780722,5
2020-09-20-170913,170913,0,0,0,174,1.1428571428571428,0.14792442,6
2020-09-21-170913,170913,1,1,1,175,2.0,0.5652524,0
2020-09-22-170913,170913,8,0,3,183,2.8571428571428568,0.9017084,1
2020-09-23-170913,170913,5,0,0,188,1.2857142857142858,0.955074,2
2020-09-24-170913,170913,1,0,4,189,3.0,0.76306427,3
2020-09-25-170913,170913,2,1,1,191,2.7142857142857144,3.025685,4
2020-09-26-170913,170913,1,0,1,192,1.7142857142857142,0.42964026,5
2020-09-27-170913,170913,2,0,9,194,0.5714285714285714,0.87919205,6
2020-09-28-170913,170913,1,0,1,195,1.1428571428571428,0.22748375,0
2020-09-29-170913,170913,0,0,8,195,1.0,0.30879685,1
2020-09-30-170913,170913,1,0,3,196,1.1428571428571428,0.7433694,2
2020-10-01-170913,170913,2,0,4,198,3.0,0.4913533,3
2020-10-02-170913,170913,3,0,6,201,3.571428571428572,1.2894641,4
2020-10-03-170913,170913,0,0,6,201,2.4285714285714284,0.26650682,5
2020-10-04-170913,170913,0,0,7,201,0.42857142857142855,0.17801991,6
2020-10-05-170913,170913,1,0,31,202,3.0,0.36975512,0
2020-10-06-170913,170913,3,0,14,205,3.4285714285714284,0.84294516,1
2020-10-07-170913,170913,0,1,37,205,2.8571428571428568,1.1961153,2
2020-10-08-170913,170913,4,0,34,209,9.571428571428571,2.3982158,3
2020-10-09-170913,170913,1,0,31,210,2.7142857142857144,0.9869896,4
2020-10-10-170913,170913,1,0,5,211,2.142857142857143,0.8505227,5
2020-10-11-170913,170913,9,0,5,220,2.7142857142857144,1.2829472,6
2020-10-12-170913,170913,1,0,18,221,1.0,0.5227373,0
2020-10-13-170913,170913,8,0,13,229,2.2857142857142856,1.3153563,1
2020-10-14-170913,170913,3,0,20,232,8.142857142857142,1.8326753,2
2020-10-15-170913,170913,4,0,9,236,1.8571428571428568,2.3328104,3
2020-10-16-170913,170913,6,0,22,242,4.714285714285714,1.4107751,4
2020-10-17-170913,170913,6,0,4,248,2.8571428571428568,1.3681087,5
2020-10-18-170913,170913,7,0,0,255,2.142857142857143,1.4638222,6
2020-10-19-170913,170913,31,1,0,286,2.142857142857143,3.0166395,0
2020-10-20-170913,170913,14,0,12,300,4.0,1.7518564,1
2020-10-21-170913,170913,37,1,12,337,5.857142857142858,4.2631755,2
2020-10-22-170913,170913,34,0,13,371,2.2857142857142856,3.10871,3
2020-10-23-170913,170913,31,0,12,402,3.7142857142857135,4.3492913,4
2020-10-24-170913,170913,5,0,3,407,2.2857142857142856,0.5410082,5
2020-10-25-170913,170913,5,1,2,412,2.7142857142857144,1.2605307,6
2020-10-26-170913,170913,18,1,10,430,3.1428571428571432,1.7350206,0
2020-10-27-170913,170913,13,0,3,443,6.0,1.6137605,1
2020-10-28-170913,170913,20,2,4,463,6.142857142857142,2.5395446,2
2020-10-29-170913,170913,9,1,4,472,3.7142857142857135,1.6044662,3
2020-10-30-170913,170913,22,0,1,494,4.285714285714286,2.3411248,4
2020-10-31-170913,170913,4,1,0,498,2.571428571428572,0.8998962,5
2020-11-01-170913,170913,0,3,0,498,0.7142857142857143,0.51172674,6
2020-11-02-170913,170913,0,0,0,498,1.0,0.38406536,0
2020-11-03-170913,170913,12,0,0,510,3.8571428571428568,2.5346057,1
2020-11-04-170913,170913,12,0,0,522,3.571428571428572,1.88033,2
2020-11-05-170913,170913,13,1,0,535,4.142857142857143,1.9269423,3
2020-11-06-170913,170913,12,3,0,547,5.7142857142857135,1.842243,4
2020-11-07-170913,170913,3,0,0,550,3.571428571428572,0.6111734,5
2020-11-08-170913,170913,2,1,0,552,0.8571428571428571,0.25175807,6
2020-11-09-170913,170913,10,1,0,562,2.2857142857142856,0.9531046,0
2020-11-10-170913,170913,3,4,0,565,3.4285714285714284,0.8539544,1
2020-11-11-170913,170913,4,0,0,569,5.285714285714286,1.1353222,2
2020-11-12-170913,170913,4,0,0,573,3.571428571428572,1.7246644,3
2020-11-13-170913,170913,1,1,0,574,4.142857142857143,1.4825158,4
2020-03-01-170914,170914,0,0,0,0,0.0,0.00042133516,6
2020-03-02-170914,170914,0,0,2,0,0.0,0.0038412816,0
2020-03-03-170914,170914,0,0,1,0,0.0,1.0277677e-06,1
2020-03-04-170914,170914,0,0,0,0,0.16666666666666666,0.005284234,2
2020-03-05-170914,170914,0,0,0,0,0.0,0.0005286224,3
2020-03-06-170914,170914,0,0,0,0,0.0,0.0046131173,4
2020-03-07-170914,170914,0,0,0,0,0.0,0.005527447,5
2020-03-08-170914,170914,0,0,0,0,0.0,9.308145e-05,6
2020-03-09-170914,170914,0,0,0,0,0.0,0.008515598,0
2020-03-10-170914,170914,0,0,1,0,0.16666666666666666,0.022786824,1
2020-03-11-170914,170914,0,0,0,0,0.16666666666666666,0.030538697,2
2020-03-12-170914,170914,0,0,0,0,0.0,0.011038496,3
2020-03-13-170914,170914,0,0,1,0,0.3333333333333333,0.07538735,4
2020-03-14-170914,170914,0,0,0,0,0.0,0.009536926,5
2020-03-15-170914,170914,0,0,1,0,0.8333333333333334,0.02227702,6
2020-03-16-170914,170914,2,0,4,2,1.1666666666666667,0.25679916,0
2020-03-17-170914,170914,1,0,4,3,1.0,0.20581073,1
2020-03-18-170914,170914,0,0,0,3,2.833333333333333,0.29647025,2
2020-03-19-170914,170914,0,0,0,3,2.1666666666666665,0.36892676,3
2020-03-20-170914,170914,0,0,1,3,3.6666666666666665,0.33830535,4
2020-03-21-170914,170914,0,0,0,3,2.1666666666666665,0.19181874,5
2020-03-22-170914,170914,0,0,0,3,1.1666666666666667,0.08418934,6
2020-03-23-170914,170914,0,0,0,3,6.5,0.648005,0
2020-03-24-170914,170914,1,0,3,4,2.333333333333333,0.34010115,1
2020-03-25-170914,170914,0,0,0,4,4.333333333333333,0.39810446,2
2020-03-26-170914,170914,0,0,0,4,3.0,0.3203423,3
2020-03-27-170914,170914,1,0,0,5,2.833333333333333,0.41890457,4
2020-03-28-170914,170914,0,0,0,5,0.6666666666666666,0.105997875,5
2020-03-29-170914,170914,1,0,0,6,1.0,0.14736296,6
2020-03-30-170914,170914,4,0,3,10,3.5,0.52118087,0
2020-03-31-170914,170914,4,0,0,14,2.5,0.36128792,1
2020-04-01-170914,170914,0,0,0,14,3.6666666666666665,0.33167768,2
2020-04-02-170914,170914,0,0,1,14,1.3333333333333333,0.23270479,3
2020-04-03-170914,170914,1,0,0,15,2.6666666666666665,0.3200732,4
2020-04-04-170914,170914,0,0,0,15,0.6666666666666666,0.051235106,5
2020-04-05-170914,170914,0,1,0,15,0.8333333333333334,0.05736805,6
2020-04-06-170914,170914,0,0,0,15,3.1666666666666665,0.24802203,0
2020-04-07-170914,170914,3,0,1,18,5.666666666666668,0.8021374,1
2020-04-08-170914,170914,0,1,0,18,2.0,0.21737237,2
2020-04-09-170914,170914,0,0,0,18,3.5,0.2492209,3
2020-04-10-170914,170914,0,0,1,18,3.333333333333333,0.15886043,4
2020-04-11-170914,170914,0,0,0,18,1.8333333333333333,0.07162403,5
2020-04-12-170914,170914,0,0,0,18,0.6666666666666666,0.048183624,6
2020-04-13-170914,170914,3,0,1,21,3.5,0.5187981,0
2020-04-14-170914,170914,0,0,0,21,3.0,0.23473,1
2020-04-15-170914,170914,0,0,2,21,3.333333333333333,0.42719212,2
2020-04-16-170914,170914,1,0,0,22,1.8333333333333333,0.17215267,3
2020-04-17-170914,170914,0,0,0,22,2.5,0.16913642,4
2020-04-18-170914,170914,0,0,0,22,0.5,0.03481506,5
2020-04-19-170914,170914,0,0,0,22,0.5,0.0140562095,6
2020-04-20-170914,170914,0,0,0,22,2.0,0.18851958,0
2020-04-21-170914,170914,1,1,0,23,3.1666666666666665,0.33173773,1
2020-04-22-170914,170914,0,0,0,23,1.3333333333333333,0.1283062,2
2020-04-23-170914,170914,0,0,0,23,0.5,0.01452394,3
2020-04-24-170914,170914,1,0,0,24,2.833333333333333,0.32365343,4
2020-04-25-170914,170914,0,0,0,24,0.3333333333333333,0.03979962,5
2020-04-26-170914,170914,0,0,0,24,0.16666666666666666,0.007325923,6
2020-04-27-170914,170914,1,2,1,25,1.1666666666666667,0.120184906,0
2020-04-28-170914,170914,0,0,0,25,1.0,0.14817691,1
2020-04-29-170914,170914,2,0,0,27,2.0,0.30107477,2
2020-04-30-170914,170914,0,0,0,27,2.0,0.19523945,3
2020-05-01-170914,170914,0,0,0,27,0.16666666666666666,0.014705851,4
2020-05-02-170914,170914,0,0,0,27,0.16666666666666666,0.016607406,5
2020-05-03-170914,170914,0,0,0,27,0.3333333333333333,0.034287233,6
2020-05-04-170914,170914,0,0,2,27,2.833333333333333,0.25854987,0
2020-05-05-170914,170914,0,0,1,27,1.1666666666666667,0.10264451,1
2020-05-06-170914,170914,0,0,0,27,13.5,0.6676108,2
2020-05-07-170914,170914,0,0,0,27,4.333333333333333,0.35257095,3
2020-05-08-170914,170914,0,0,0,27,4.0,0.32636496,4
2020-05-09-170914,170914,0,1,0,27,0.3333333333333333,0.04623215,5
2020-05-10-170914,170914,0,0,0,27,0.0,0.009250098,6
2020-05-11-170914,170914,1,0,0,28,1.8333333333333333,0.2200799,0
2020-05-12-170914,170914,0,0,0,28,4.333333333333333,0.24680062,1
2020-05-13-170914,170914,0,0,0,28,1.8333333333333333,0.17396057,2
2020-05-14-170914,170914,0,1,1,28,1.0,0.13541108,3
2020-05-15-170914,170914,0,0,0,28,1.0,0.0711417,4
2020-05-16-170914,170914,0,0,0,28,0.0,0.013826909,5
2020-05-17-170914,170914,0,0,0,28,0.0,0.00048902095,6
2020-05-18-170914,170914,2,0,2,30,1.6666666666666667,0.2863871,0
2020-05-19-170914,170914,1,0,1,31,1.8333333333333333,0.18483713,1
2020-05-20-170914,170914,0,0,0,31,2.1666666666666665,0.12548406,2
2020-05-21-170914,170914,0,0,0,31,1.5,0.095959835,3
2020-05-22-170914,170914,0,0,1,31,1.8333333333333333,0.11962888,4
2020-05-23-170914,170914,0,0,0,31,0.0,0.000738577,5
2020-05-24-170914,170914,0,0,0,31,0.16666666666666666,0.033345908,6
2020-05-25-170914,170914,0,0,1,31,0.6666666666666666,0.17425443,0
2020-05-26-170914,170914,0,0,2,31,0.3333333333333333,0.056535073,1
2020-05-27-170914,170914,0,0,2,31,0.16666666666666666,0.041913085,2
2020-05-28-170914,170914,1,0,0,32,2.333333333333333,0.29464766,3
2020-05-29-170914,170914,0,1,0,32,0.6666666666666666,0.15652947,4
2020-05-30-170914,170914,0,0,0,32,0.3333333333333333,0.041417025,5
2020-05-31-170914,170914,0,0,0,32,0.16666666666666666,0.035969015,6
2020-06-01-170914,170914,2,0,0,34,0.6666666666666666,0.21813454,0
2020-06-02-170914,170914,1,0,1,35,0.8333333333333334,0.21460362,1
2020-06-03-170914,170914,0,0,0,35,0.8333333333333334,0.18750478,2
2020-06-04-170914,170914,0,0,0,35,1.0,0.12123315,3
2020-06-05-170914,170914,1,0,0,36,0.3333333333333333,0.16756982,4
2020-06-06-170914,170914,0,0,0,36,0.16666666666666666,0.009251801,5
2020-06-07-170914,170914,0,0,0,36,0.16666666666666666,0.026059242,6
2020-06-08-170914,170914,1,0,0,37,0.16666666666666666,0.1654024,0
2020-06-09-170914,170914,2,0,0,39,0.3333333333333333,0.2847652,1
2020-06-10-170914,170914,2,0,0,41,1.0,0.21844484,2
2020-06-11-170914,170914,0,0,0,41,0.5,0.13257146,3
2020-06-12-170914,170914,0,0,0,41,0.6666666666666666,0.1451204,4
2020-06-13-170914,170914,0,0,0,41,0.16666666666666666,0.034609646,5
2020-06-14-170914,170914,0,0,0,41,0.0,0.008260135,6
2020-06-15-170914,170914,0,0,1,41,0.16666666666666666,0.034015615,0
2020-06-16-170914,170914,1,0,0,42,0.3333333333333333,0.15262994,1
2020-06-17-170914,170914,0,0,0,42,0.8333333333333334,0.18296795,2
2020-06-18-170914,170914,0,0,0,42,0.5,0.12880497,3
2020-06-19-170914,170914,0,0,0,42,0.6666666666666666,0.15552934,4
2020-06-20-170914,170914,0,0,0,42,0.16666666666666666,0.03803361,5
2020-06-21-170914,170914,0,0,1,42,0.0,0.001034906,6
2020-06-22-170914,170914,0,0,0,42,0.3333333333333333,0.05955075,0
2020-06-23-170914,170914,0,0,0,42,0.5,0.14456458,1
2020-06-24-170914,170914,0,0,0,42,0.3333333333333333,0.08743852,2
2020-06-25-170914,170914,0,0,0,42,0.16666666666666666,0.033743456,3
2020-06-26-170914,170914,0,0,0,42,0.0,0.031789515,4
2020-06-27-170914,170914,0,0,0,42,0.0,0.0036142925,5
2020-06-28-170914,170914,0,0,0,42,0.0,0.0012722462,6
2020-06-29-170914,170914,1,0,0,43,0.3333333333333333,0.1700293,0
2020-06-30-170914,170914,0,0,0,43,0.5,0.0617281,1
2020-07-01-170914,170914,0,0,0,43,0.16666666666666666,0.054432098,2
2020-07-02-170914,170914,0,0,0,43,0.0,0.026242416,3
2020-07-03-170914,170914,0,0,0,43,0.0,0.0063218717,4
2020-07-04-170914,170914,0,0,0,43,0.0,0.00295184,5
2020-07-05-170914,170914,1,0,0,44,0.0,0.0954321,6
2020-07-06-170914,170914,0,0,0,44,0.3333333333333333,0.09976426,0
2020-07-07-170914,170914,0,0,2,44,0.0,0.003813299,1
2020-07-08-170914,170914,0,1,0,44,0.0,0.0061329254,2
2020-07-09-170914,170914,0,0,7,44,0.0,0.013157914,3
2020-07-10-170914,170914,0,0,0,44,0.3333333333333333,0.032463744,4
2020-07-11-170914,170914,0,0,0,44,0.0,0.0061042346,5
2020-07-12-170914,170914,0,0,0,44,0.0,0.0015812214,6
2020-07-13-170914,170914,0,0,0,44,0.16666666666666666,0.048823144,0
2020-07-14-170914,170914,0,0,0,44,0.16666666666666666,0.0343888,1
2020-07-15-170914,170914,0,0,0,44,0.3333333333333333,0.08624578,2
2020-07-16-170914,170914,0,0,0,44,0.3333333333333333,0.022595672,3
2020-07-17-170914,170914,0,0,1,44,0.3333333333333333,0.111717805,4
2020-07-18-170914,170914,0,0,0,44,0.0,0.001049433,5
2020-07-19-170914,170914,0,0,0,44,0.0,0.009107227,6
2020-07-20-170914,170914,0,0,1,44,0.16666666666666666,0.055339225,0
2020-07-21-170914,170914,2,0,0,46,0.3333333333333333,0.2466275,1
2020-07-22-170914,170914,0,0,0,46,0.16666666666666666,0.04853543,2
2020-07-23-170914,170914,7,0,0,53,0.16666666666666666,0.5846207,3
2020-07-24-170914,170914,0,0,1,53,0.3333333333333333,0.08271907,4
2020-07-25-170914,170914,0,0,0,53,0.0,0.0008418676,5
2020-07-26-170914,170914,0,0,0,53,0.0,0.00045972294,6
2020-07-27-170914,170914,0,0,0,53,0.16666666666666666,0.12436936,0
2020-07-28-170914,170914,0,0,3,53,0.5,0.08910573,1
2020-07-29-170914,170914,0,0,0,53,0.6666666666666666,0.13682695,2
2020-07-30-170914,170914,0,0,1,53,0.6666666666666666,0.16252151,3
2020-07-31-170914,170914,1,0,0,54,0.3333333333333333,0.16968136,4
2020-08-01-170914,170914,0,0,0,54,0.0,0.0038550762,5
2020-08-02-170914,170914,0,0,0,54,0.5,0.11491797,6
2020-08-03-170914,170914,1,0,0,55,0.0,0.11932868,0
2020-08-04-170914,170914,0,0,0,55,0.16666666666666666,0.027220799,1
2020-08-05-170914,170914,0,0,0,55,0.16666666666666666,0.07709759,2
2020-08-06-170914,170914,0,0,0,55,0.0,0.012639643,3
2020-08-07-170914,170914,1,0,1,56,0.3333333333333333,0.17411782,4
2020-08-08-170914,170914,0,0,1,56,0.0,0.0246947,5
2020-08-09-170914,170914,0,0,0,56,0.5,0.035739228,6
2020-08-10-170914,170914,0,0,1,56,0.16666666666666666,0.04995554,0
2020-08-11-170914,170914,3,0,1,59,0.6666666666666666,0.30031157,1
2020-08-12-170914,170914,0,0,0,59,0.5,0.07934425,2
2020-08-13-170914,170914,1,0,0,60,0.16666666666666666,0.22524312,3
2020-08-14-170914,170914,0,0,1,60,0.5,0.1408268,4
2020-08-15-170914,170914,0,0,0,60,0.5,0.08868499,5
2020-08-16-170914,170914,0,0,0,60,0.3333333333333333,0.047963604,6
2020-08-17-170914,170914,0,0,0,60,1.3333333333333333,0.17345689,0
2020-08-18-170914,170914,0,0,1,60,0.5,0.119523644,1
2020-08-19-170914,170914,0,0,1,60,0.6666666666666666,0.26006946,2
2020-08-20-170914,170914,0,0,0,60,2.5,0.5930321,3
2020-08-21-170914,170914,1,0,1,61,0.8333333333333334,0.15172409,4
2020-08-22-170914,170914,1,0,0,62,0.6666666666666666,0.16576618,5
2020-08-23-170914,170914,0,0,0,62,0.3333333333333333,0.11154049,6
2020-08-24-170914,170914,1,0,1,63,2.0,0.5637762,0
2020-08-25-170914,170914,1,0,0,64,3.8333333333333335,0.76797223,1
2020-08-26-170914,170914,0,0,0,64,4.166666666666667,0.8663108,2
2020-08-27-170914,170914,0,0,1,64,2.5,0.5211729,3
2020-08-28-170914,170914,1,0,1,65,1.1666666666666667,0.45251027,4
2020-08-29-170914,170914,0,0,0,65,3.333333333333333,0.48310614,5
2020-08-30-170914,170914,0,0,0,65,2.6666666666666665,0.46310464,6
2020-08-31-170914,170914,0,0,0,65,1.6666666666666667,0.22790487,0
2020-09-01-170914,170914,1,0,0,66,1.6666666666666667,0.27347514,1
2020-09-02-170914,170914,1,0,0,67,2.1666666666666665,0.3643901,2
2020-09-03-170914,170914,0,0,0,67,1.5,0.41320512,3
2020-09-04-170914,170914,1,0,0,68,2.0,0.24086855,4
2020-09-05-170914,170914,0,0,0,68,0.5,0.20907716,5
2020-09-06-170914,170914,0,0,0,68,0.3333333333333333,0.09537918,6
2020-09-07-170914,170914,1,0,0,69,2.5,0.53978306,0
2020-09-08-170914,170914,0,0,1,69,1.5,0.25697392,1
2020-09-09-170914,170914,0,0,1,69,0.6666666666666666,0.18988976,2
2020-09-10-170914,170914,1,0,2,70,1.1666666666666667,0.48093802,3
2020-09-11-170914,170914,1,0,1,71,0.6666666666666666,0.39448786,4
2020-09-12-170914,170914,0,0,1,71,1.6666666666666667,0.35712093,5
2020-09-13-170914,170914,0,0,0,71,0.5,0.1225148,6
2020-09-14-170914,170914,0,0,0,71,2.1666666666666665,0.5330428,0
2020-09-15-170914,170914,0,0,0,71,1.3333333333333333,0.3052006,1
2020-09-16-170914,170914,0,0,1,71,2.333333333333333,0.54738706,2
2020-09-17-170914,170914,0,0,0,71,11.833333333333336,0.7222399,3
2020-09-18-170914,170914,0,0,8,71,3.5,0.6372053,4
2020-09-19-170914,170914,0,1,0,71,0.8333333333333334,0.2052676,5
2020-09-20-170914,170914,0,0,0,71,0.8333333333333334,0.13085693,6
2020-09-21-170914,170914,0,0,0,71,1.5,0.2686536,0
2020-09-22-170914,170914,1,0,5,72,2.833333333333333,0.40479535,1
2020-09-23-170914,170914,1,1,6,73,2.833333333333333,0.48588854,2
2020-09-24-170914,170914,2,1,13,75,4.333333333333333,1.1380801,3
2020-09-25-170914,170914,1,0,7,76,5.833333333333332,1.075409,4
2020-09-26-170914,170914,1,0,10,77,1.6666666666666667,0.41691825,5
2020-09-27-170914,170914,0,1,8,77,1.5,0.38585874,6
2020-09-28-170914,170914,0,0,0,77,1.8333333333333333,0.22504632,0
2020-09-29-170914,170914,0,0,2,77,2.333333333333333,0.29499158,1
2020-09-30-170914,170914,1,0,0,78,2.833333333333333,0.46892193,2
2020-10-01-170914,170914,0,0,2,78,3.0,0.5822922,3
2020-10-02-170914,170914,8,0,0,86,2.6666666666666665,0.90381336,4
2020-10-03-170914,170914,0,0,2,86,2.333333333333333,0.560088,5
2020-10-04-170914,170914,0,0,1,86,1.5,0.10685374,6
2020-10-05-170914,170914,0,0,0,86,1.8333333333333333,0.25119123,0
2020-10-06-170914,170914,5,0,0,91,5.0,1.0083565,1
2020-10-07-170914,170914,6,0,1,97,1.3333333333333333,0.9946996,2
2020-10-08-170914,170914,13,0,0,110,5.5,1.7854686,3
2020-10-09-170914,170914,7,0,0,117,2.6666666666666665,1.022385,4
2020-10-10-170914,170914,10,0,0,127,1.0,0.80793524,5
2020-10-11-170914,170914,8,0,0,135,3.0,0.90535927,6
2020-10-12-170914,170914,0,0,0,135,0.6666666666666666,0.121045835,0
2020-10-13-170914,170914,2,0,1,137,2.1666666666666665,0.45329496,1
2020-10-14-170914,170914,0,0,0,137,3.0,0.5271685,2
2020-10-15-170914,170914,2,0,0,139,4.166666666666667,0.89103526,3
2020-10-16-170914,170914,0,0,0,139,7.0,0.9700903,4
2020-10-17-170914,170914,2,0,0,141,4.166666666666667,0.6974669,5
2020-10-18-170914,170914,1,0,0,142,2.5,0.51160216,6
2020-10-19-170914,170914,0,1,0,142,6.833333333333332,0.7038418,0
2020-10-20-170914,170914,0,0,1,142,8.166666666666666,1.0238152,1
2020-10-21-170914,170914,1,0,0,143,11.5,1.1728213,2
2020-10-22-170914,170914,0,0,0,143,10.166666666666666,1.2215569,3
2020-10-23-170914,170914,0,0,2,143,10.333333333333334,1.2635694,4
2020-10-24-170914,170914,0,0,0,143,3.0,0.45269322,5
2020-10-25-170914,170914,0,0,0,143,3.5,0.3326131,6
2020-10-26-170914,170914,0,0,0,143,6.333333333333332,0.9415347,0
2020-10-27-170914,170914,1,0,0,144,5.5,0.9975601,1
2020-10-28-170914,170914,0,0,0,144,7.333333333333332,1.0049185,2
2020-10-29-170914,170914,0,0,0,144,5.333333333333333,1.1398482,3
2020-10-30-170914,170914,0,0,0,144,7.666666666666668,1.210379,4
2020-10-31-170914,170914,0,0,0,144,1.6666666666666667,0.5215259,5
2020-11-01-170914,170914,0,0,0,144,1.3333333333333333,0.23991074,6
2020-11-02-170914,170914,0,0,0,144,1.0,0.4083701,0
2020-11-03-170914,170914,1,0,0,145,6.833333333333332,1.0435846,1
2020-11-04-170914,170914,0,0,0,145,4.166666666666667,0.80452067,2
2020-11-05-170914,170914,0,0,0,145,5.166666666666667,1.0111129,3
2020-11-06-170914,170914,2,0,0,147,4.166666666666667,1.070717,4
2020-11-07-170914,170914,0,0,0,147,2.833333333333333,0.48568913,5
2020-11-08-170914,170914,0,0,0,147,1.6666666666666667,0.14995812,6
2020-11-09-170914,170914,0,1,0,147,2.333333333333333,0.42689362,0
2020-11-10-170914,170914,0,0,0,147,3.5,0.5121178,1
2020-11-11-170914,170914,0,0,0,147,3.1666666666666665,0.66192824,2
2020-11-12-170914,170914,0,0,0,147,2.833333333333333,0.8534762,3
2020-11-13-170914,170914,0,0,0,147,3.5,0.6473011,4
2020-03-01-170915,170915,0,0,4,0,0.0,0.0051255603,6
2020-03-02-170915,170915,0,0,17,0,0.2,0.006072102,0
2020-03-03-170915,170915,0,0,6,0,0.0,0.0016978593,1
2020-03-04-170915,170915,0,0,19,0,0.4,0.0010381187,2
2020-03-05-170915,170915,1,0,14,1,0.0,0.004089334,3
2020-03-06-170915,170915,1,0,18,2,0.4,0.042529486,4
2020-03-07-170915,170915,1,0,8,3,0.0,0.0070749824,5
2020-03-08-170915,170915,0,0,11,3,0.0,0.005207172,6
2020-03-09-170915,170915,2,0,33,5,0.8,0.034884945,0
2020-03-10-170915,170915,0,0,45,5,0.6,0.027484847,1
2020-03-11-170915,170915,1,0,17,6,0.8,0.024815496,2
2020-03-12-170915,170915,6,0,16,12,1.2,0.034832347,3
2020-03-13-170915,170915,4,0,21,16,2.6,0.11002021,4
2020-03-14-170915,170915,2,0,4,18,1.2,0.022027483,5
2020-03-15-170915,170915,4,0,7,22,3.2,0.028732855,6
2020-03-16-170915,170915,17,0,33,39,8.6,0.35609013,0
2020-03-17-170915,170915,6,0,21,45,7.6,0.2256021,1
2020-03-18-170915,170915,19,0,8,64,13.2,0.3389362,2
2020-03-19-170915,170915,14,0,9,78,14.8,0.3577618,3
2020-03-20-170915,170915,18,1,12,96,13.6,0.33907643,4
2020-03-21-170915,170915,8,0,2,104,4.4,0.060933147,5
2020-03-22-170915,170915,11,0,5,115,3.8,0.04007867,6
2020-03-23-170915,170915,33,0,21,148,25.8,0.56960803,0
2020-03-24-170915,170915,45,0,91,193,20.6,0.39406702,1
2020-03-25-170915,170915,17,0,11,210,18.6,0.39141533,2
2020-03-26-170915,170915,16,0,7,226,16.8,0.47147384,3
2020-03-27-170915,170915,21,0,3,247,14.2,0.35426554,4
2020-03-28-170915,170915,4,0,3,251,19.8,0.05682065,5
2020-03-29-170915,170915,7,0,4,258,4.8,0.09181746,6
2020-03-30-170915,170915,33,0,29,291,15.4,0.31041828,0
2020-03-31-170915,170915,21,0,10,312,12.0,0.14831197,1
2020-04-01-170915,170915,8,0,11,320,8.8,0.27291828,2
2020-04-02-170915,170915,9,0,13,329,9.2,0.32725534,3
2020-04-03-170915,170915,12,0,6,341,8.6,0.3220624,4
2020-04-04-170915,170915,2,0,3,343,2.6,0.027620532,5
2020-04-05-170915,170915,5,0,1,348,3.8,0.06340089,6
2020-04-06-170915,170915,21,0,9,369,10.2,0.3375904,0
2020-04-07-170915,170915,91,0,8,460,12.8,0.3241265,1
2020-04-08-170915,170915,11,0,7,471,11.0,0.23889324,2
2020-04-09-170915,170915,7,0,0,478,7.8,0.12463435,3
2020-04-10-170915,170915,3,0,1,481,6.4,0.058851123,4
2020-04-11-170915,170915,3,2,1,484,12.6,0.15208903,5
2020-04-12-170915,170915,4,0,0,488,4.6,0.07907285,6
2020-04-13-170915,170915,29,0,6,517,56.0,0.26372918,0
2020-04-14-170915,170915,10,0,2,527,16.6,0.27789605,1
2020-04-15-170915,170915,11,0,6,538,10.2,0.2158041,2
2020-04-16-170915,170915,13,0,9,551,9.0,0.2761148,3
2020-04-17-170915,170915,6,0,3,557,8.0,0.18946783,4
2020-04-18-170915,170915,3,0,1,560,1.6,0.05507368,5
2020-04-19-170915,170915,1,0,1,561,0.4,0.009163473,6
2020-04-20-170915,170915,9,0,20,570,8.8,0.21743695,0
2020-04-21-170915,170915,8,0,10,578,7.0,0.23847866,1
2020-04-22-170915,170915,7,0,7,585,5.6,0.13833873,2
2020-04-23-170915,170915,0,0,14,585,0.8,0.006061328,3
2020-04-24-170915,170915,1,0,17,586,5.2,0.15913285,4
2020-04-25-170915,170915,1,0,0,587,0.8,0.0323384,5
2020-04-26-170915,170915,0,0,1,587,1.4,0.039935358,6
2020-04-27-170915,170915,6,0,12,593,5.4,0.17451458,0
2020-04-28-170915,170915,2,0,4,595,3.6,0.18448699,1
2020-04-29-170915,170915,6,0,0,601,4.2,0.24569348,2
2020-04-30-170915,170915,9,0,7,610,5.8,0.10327187,3
2020-05-01-170915,170915,3,0,7,613,0.4,0.007978774,4
2020-05-02-170915,170915,1,0,0,614,0.2,0.014816379,5
2020-05-03-170915,170915,1,0,0,615,0.4,0.011706747,6
2020-05-04-170915,170915,20,0,9,635,5.4,0.19905168,0
2020-05-05-170915,170915,10,1,6,645,5.8,0.16138837,1
2020-05-06-170915,170915,7,0,7,652,5.2,0.3217082,2
2020-05-07-170915,170915,14,0,3,666,4.8,0.1820409,3
2020-05-08-170915,170915,17,0,1,683,6.0,0.1564276,4
2020-05-09-170915,170915,0,1,0,683,0.8,0.026802177,5
2020-05-10-170915,170915,1,1,1,684,0.4,0.027562175,6
2020-05-11-170915,170915,12,0,5,696,5.6,0.13877226,0
2020-05-12-170915,170915,4,1,11,700,6.4,0.12599544,1
2020-05-13-170915,170915,0,0,4,700,2.2,0.17068918,2
2020-05-14-170915,170915,7,2,0,707,3.4,0.16267417,3
2020-05-15-170915,170915,7,0,10,714,5.0,0.10337285,4
2020-05-16-170915,170915,0,1,1,714,0.8,0.05027531,5
2020-05-17-170915,170915,0,0,0,714,0.6,0.0046188654,6
2020-05-18-170915,170915,9,0,14,723,3.8,0.1779673,0
2020-05-19-170915,170915,6,0,3,729,3.8,0.16232231,1
2020-05-20-170915,170915,7,1,2,736,3.6,0.09046144,2
2020-05-21-170915,170915,3,0,2,739,2.6,0.158643,3
2020-05-22-170915,170915,1,0,4,740,2.6,0.11814011,4
2020-05-23-170915,170915,0,0,0,740,0.8,0.0052348785,5
2020-05-24-170915,170915,1,0,1,741,0.0,0.0036462082,6
2020-05-25-170915,170915,5,0,0,746,5.4,0.22798859,0
2020-05-26-170915,170915,11,0,3,757,3.8,0.12904556,1
2020-05-27-170915,170915,4,0,1,761,3.2,0.1410413,2
2020-05-28-170915,170915,0,0,0,761,4.0,0.13415346,3
2020-05-29-170915,170915,10,0,3,771,3.2,0.22589837,4
2020-05-30-170915,170915,1,0,0,772,0.4,0.03542419,5
2020-05-31-170915,170915,0,0,0,772,0.6,0.024927005,6
2020-06-01-170915,170915,14,0,0,786,3.4,0.3270066,0
2020-06-02-170915,170915,3,0,6,789,3.2,0.14548929,1
2020-06-03-170915,170915,2,0,0,791,2.6,0.19087921,2
2020-06-04-170915,170915,2,0,3,793,2.0,0.11004794,3
2020-06-05-170915,170915,4,1,1,797,2.0,0.10199631,4
2020-06-06-170915,170915,0,0,0,797,0.0,0.0042959973,5
2020-06-07-170915,170915,1,0,0,798,0.0,0.01061422,6
2020-06-08-170915,170915,0,0,2,798,1.8,0.16521275,0
2020-06-09-170915,170915,3,0,1,801,1.6,0.17227997,1
2020-06-10-170915,170915,1,0,1,802,2.4,0.184938,2
2020-06-11-170915,170915,0,0,2,802,2.0,0.1742678,3
2020-06-12-170915,170915,3,0,0,805,1.4,0.12164446,4
2020-06-13-170915,170915,0,1,0,805,0.2,0.014205735,5
2020-06-14-170915,170915,0,0,0,805,0.2,0.006402465,6
2020-06-15-170915,170915,0,0,2,805,2.0,0.13890241,0
2020-06-16-170915,170915,6,0,1,811,2.2,0.23943128,1
2020-06-17-170915,170915,0,0,1,811,1.2,0.12154629,2
2020-06-18-170915,170915,3,0,2,814,1.2,0.12802286,3
2020-06-19-170915,170915,1,0,0,815,1.2,0.14916356,4
2020-06-20-170915,170915,0,0,1,815,0.0,0.019818606,5
2020-06-21-170915,170915,0,0,0,815,0.0,0.0050771097,6
2020-06-22-170915,170915,2,0,1,817,1.4,0.11114857,0
2020-06-23-170915,170915,1,0,3,818,1.0,0.113635235,1
2020-06-24-170915,170915,1,0,1,819,0.4,0.050315455,2
2020-06-25-170915,170915,2,1,2,821,1.0,0.0754937,3
2020-06-26-170915,170915,0,0,1,821,1.4,0.05971523,4
2020-06-27-170915,170915,0,0,0,821,0.6,0.017464511,5
2020-06-28-170915,170915,0,0,0,821,0.2,0.011037155,6
2020-06-29-170915,170915,2,0,1,823,1.8,0.09621939,0
2020-06-30-170915,170915,1,0,1,824,0.8,0.047434345,1
2020-07-01-170915,170915,1,0,1,825,1.0,0.09062749,2
2020-07-02-170915,170915,2,0,0,827,0.8,0.057365805,3
2020-07-03-170915,170915,0,0,1,827,0.8,0.046064604,4
2020-07-04-170915,170915,1,0,0,828,0.0,0.0069223084,5
2020-07-05-170915,170915,0,0,0,828,0.2,0.018755514,6
2020-07-06-170915,170915,1,0,2,829,0.6,0.06565646,0
2020-07-07-170915,170915,3,0,0,832,0.4,0.03733459,1
2020-07-08-170915,170915,1,2,2,833,0.4,0.02331512,2
2020-07-09-170915,170915,2,0,2,835,0.6,0.03865649,3
2020-07-10-170915,170915,1,0,0,836,0.6,0.058352973,4
2020-07-11-170915,170915,0,0,0,836,0.4,0.01252351,5
2020-07-12-170915,170915,0,0,0,836,0.0,0.009735411,6
2020-07-13-170915,170915,1,0,1,837,1.0,0.046738483,0
2020-07-14-170915,170915,1,0,2,838,0.6,0.047600083,1
2020-07-15-170915,170915,1,0,1,839,0.4,0.040374186,2
2020-07-16-170915,170915,0,0,1,839,0.2,0.029327197,3
2020-07-17-170915,170915,1,2,0,840,0.8,0.097499,4
2020-07-18-170915,170915,0,0,0,840,0.0,0.0028350067,5
2020-07-19-170915,170915,0,0,0,840,0.2,0.01910757,6
2020-07-20-170915,170915,2,0,1,842,0.2,0.046340793,0
2020-07-21-170915,170915,0,0,0,842,1.0,0.1417368,1
2020-07-22-170915,170915,2,0,3,844,0.8,0.048570707,2
2020-07-23-170915,170915,2,1,1,846,0.2,0.1261471,3
2020-07-24-170915,170915,0,2,0,846,0.4,0.06635387,4
2020-07-25-170915,170915,0,0,4,846,0.2,0.009252178,5
2020-07-26-170915,170915,0,0,1,846,0.4,0.00400685,6
2020-07-27-170915,170915,1,0,2,847,0.4,0.16278976,0
2020-07-28-170915,170915,2,0,3,849,1.0,0.054801386,1
2020-07-29-170915,170915,1,0,1,850,0.2,0.061227836,2
2020-07-30-170915,170915,1,0,3,851,0.2,0.07970535,3
2020-07-31-170915,170915,0,0,4,851,0.2,0.09296961,4
2020-08-01-170915,170915,0,0,1,851,0.0,0.014025145,5
2020-08-02-170915,170915,0,0,1,851,0.2,0.044209335,6
2020-08-03-170915,170915,1,0,2,852,0.8,0.062015396,0
2020-08-04-170915,170915,0,0,6,852,1.2,0.0895613,1
2020-08-05-170915,170915,3,0,5,855,0.0,0.18974116,2
2020-08-06-170915,170915,1,0,2,856,0.6,0.08727911,3
2020-08-07-170915,170915,0,0,0,856,0.6,0.10176999,4
2020-08-08-170915,170915,4,0,0,860,1.8,0.0992919,5
2020-08-09-170915,170915,1,0,1,861,0.4,0.045777343,6
2020-08-10-170915,170915,2,0,5,863,1.4,0.16176222,0
2020-08-11-170915,170915,3,0,15,866,2.0,0.20731282,1
2020-08-12-170915,170915,1,0,18,867,0.8,0.11851064,2
2020-08-13-170915,170915,3,0,11,870,1.2,0.22761863,3
2020-08-14-170915,170915,4,1,10,874,2.2,0.19417593,4
2020-08-15-170915,170915,1,0,2,875,2.4,0.087429844,5
2020-08-16-170915,170915,1,0,0,876,1.4,0.078097574,6
2020-08-17-170915,170915,2,0,12,878,1.8,0.2373693,0
2020-08-18-170915,170915,6,0,11,884,3.4,0.22937684,1
2020-08-19-170915,170915,5,0,14,889,4.0,0.2994894,2
2020-08-20-170915,170915,2,0,5,891,6.4,0.39345396,3
2020-08-21-170915,170915,0,0,18,891,2.0,0.27726656,4
2020-08-22-170915,170915,0,0,1,891,2.0,0.12026632,5
2020-08-23-170915,170915,1,0,4,892,0.8,0.09622036,6
2020-08-24-170915,170915,5,0,9,897,3.8,0.36408815,0
2020-08-25-170915,170915,15,0,2,912,8.0,0.5436937,1
2020-08-26-170915,170915,18,0,12,930,5.6,0.34129238,2
2020-08-27-170915,170915,11,0,7,941,7.6,0.46066552,3
2020-08-28-170915,170915,10,0,8,951,8.6,0.6765182,4
2020-08-29-170915,170915,2,0,0,953,1.2,0.15824862,5
2020-08-30-170915,170915,0,0,1,953,0.2,0.23621535,6
2020-08-31-170915,170915,12,0,9,965,7.2,0.22533065,0
2020-09-01-170915,170915,11,0,6,976,3.4,0.19726062,1
2020-09-02-170915,170915,14,0,8,990,7.2,0.4305403,2
2020-09-03-170915,170915,5,0,14,995,4.6,0.28392947,3
2020-09-04-170915,170915,18,0,8,1013,9.2,0.39825824,4
2020-09-05-170915,170915,1,0,1,1014,1.0,0.15603222,5
2020-09-06-170915,170915,4,0,0,1018,2.2,0.2285348,6
2020-09-07-170915,170915,9,0,14,1027,10.8,0.5014845,0
2020-09-08-170915,170915,2,0,3,1029,3.6,0.34697443,1
2020-09-09-170915,170915,12,0,11,1041,6.6,0.42708737,2
2020-09-10-170915,170915,7,0,5,1048,5.0,0.5237269,3
2020-09-11-170915,170915,8,0,10,1056,8.4,0.64825803,4
2020-09-12-170915,170915,0,0,1,1056,0.6,0.19690606,5
2020-09-13-170915,170915,1,0,2,1057,2.2,0.16982889,6
2020-09-14-170915,170915,9,0,7,1066,10.8,0.6092918,0
2020-09-15-170915,170915,6,0,8,1072,8.0,0.60165,1
2020-09-16-170915,170915,8,0,4,1080,12.4,0.716158,2
2020-09-17-170915,170915,14,0,7,1094,12.8,1.1392899,3
2020-09-18-170915,170915,8,0,5,1102,6.0,1.0632819,4
2020-09-19-170915,170915,1,0,0,1103,1.8,0.47389883,5
2020-09-20-170915,170915,0,0,1,1103,0.6,0.185375,6
2020-09-21-170915,170915,14,1,15,1117,8.4,0.5326055,0
2020-09-22-170915,170915,3,1,9,1120,9.4,0.5641962,1
2020-09-23-170915,170915,11,0,5,1131,9.0,0.5502216,2
2020-09-24-170915,170915,5,0,8,1136,7.0,0.7341404,3
2020-09-25-170915,170915,10,0,7,1146,10.2,0.7310019,4
2020-09-26-170915,170915,1,0,1,1147,2.8,0.4591432,5
2020-09-27-170915,170915,2,0,0,1149,2.6,0.18461064,6
2020-09-28-170915,170915,7,0,2,1156,9.0,0.3917894,0
2020-09-29-170915,170915,8,0,6,1164,5.8,0.35627082,1
2020-09-30-170915,170915,4,1,8,1168,6.0,0.32365754,2
2020-10-01-170915,170915,7,0,10,1175,6.6,0.69465345,3
2020-10-02-170915,170915,5,0,3,1180,8.6,0.7084213,4
2020-10-03-170915,170915,0,0,1,1180,1.2,0.26657766,5
2020-10-04-170915,170915,1,1,2,1181,0.6,0.09264708,6
2020-10-05-170915,170915,15,1,16,1196,11.6,0.6137432,0
2020-10-06-170915,170915,9,1,13,1205,9.2,0.8055137,1
2020-10-07-170915,170915,5,2,18,1210,10.8,0.63814145,2
2020-10-08-170915,170915,8,0,16,1218,12.6,1.5255574,3
2020-10-09-170915,170915,7,0,46,1225,7.2,1.0900187,4
2020-10-10-170915,170915,1,0,3,1226,1.2,0.34314933,5
2020-10-11-170915,170915,0,0,7,1226,0.8,0.26223773,6
2020-10-12-170915,170915,2,0,26,1228,1.6,0.16691141,0
2020-10-13-170915,170915,6,0,25,1234,13.4,0.6023083,1
2020-10-14-170915,170915,8,0,19,1242,10.6,0.80429125,2
2020-10-15-170915,170915,10,0,40,1252,11.6,0.5406279,3
2020-10-16-170915,170915,3,0,49,1255,8.2,0.7845917,4
2020-10-17-170915,170915,1,0,4,1256,2.8,0.38934326,5
2020-10-18-170915,170915,2,0,13,1258,1.8,0.24102673,6
2020-10-19-170915,170915,16,0,2,1274,12.4,0.5490926,0
2020-10-20-170915,170915,13,1,39,1287,11.6,0.91479254,1
2020-10-21-170915,170915,18,0,37,1305,21.0,0.9161879,2
2020-10-22-170915,170915,16,1,44,1321,18.0,0.838146,3
2020-10-23-170915,170915,46,0,43,1367,26.0,1.3144447,4
2020-10-24-170915,170915,3,0,9,1370,2.4,0.34824088,5
2020-10-25-170915,170915,7,0,8,1377,1.4,0.1975307,6
2020-10-26-170915,170915,26,2,42,1403,26.2,1.0391062,0
2020-10-27-170915,170915,25,0,26,1428,15.8,1.0906218,1
2020-10-28-170915,170915,19,3,24,1447,25.4,1.364643,2
2020-10-29-170915,170915,40,1,19,1487,27.6,0.9050441,3
2020-10-30-170915,170915,49,0,37,1536,27.2,1.4052192,4
2020-10-31-170915,170915,4,0,0,1540,4.6,0.50398576,5
2020-11-01-170915,170915,13,0,0,1553,7.8,0.3123046,6
2020-11-02-170915,170915,2,0,0,1555,2.4,0.25289568,0
2020-11-03-170915,170915,39,0,0,1594,15.0,0.8487884,1
2020-11-04-170915,170915,37,0,0,1631,21.8,1.2418872,2
2020-11-05-170915,170915,44,0,0,1675,27.4,1.2787485,3
2020-11-06-170915,170915,43,1,0,1718,31.0,1.3486775,4
2020-11-07-170915,170915,9,0,0,1727,3.0,0.42958134,5
2020-11-08-170915,170915,8,2,0,1735,2.4,0.21010025,6
2020-11-09-170915,170915,42,0,0,1777,19.6,0.732328,0
2020-11-10-170915,170915,26,2,0,1803,17.8,0.8224458,1
2020-11-11-170915,170915,24,3,0,1827,22.2,1.0480919,2
2020-11-12-170915,170915,19,0,0,1846,16.8,0.93972814,3
2020-11-13-170915,170915,37,1,0,1883,19.2,0.7495656,4
2020-03-01-170916,170916,0,0,2,0,0.0,0.0046769725,6
2020-03-02-170916,170916,0,0,7,0,0.0,0.016078874,0
2020-03-03-170916,170916,0,0,10,0,0.0,0.0045232237,1
2020-03-04-170916,170916,0,0,22,0,0.2,0.008305588,2
2020-03-05-170916,170916,0,0,19,0,0.2,0.006086368,3
2020-03-06-170916,170916,1,0,16,1,0.4,0.087067634,4
2020-03-07-170916,170916,0,0,7,1,0.2,0.019559173,5
2020-03-08-170916,170916,0,0,7,1,0.0,0.0018819226,6
2020-03-09-170916,170916,0,0,24,1,0.6,0.03909288,0
2020-03-10-170916,170916,0,0,20,1,0.2,0.028720457,1
2020-03-11-170916,170916,1,0,25,2,0.2,0.07471098,2
2020-03-12-170916,170916,1,0,18,3,1.4,0.07618309,3
2020-03-13-170916,170916,1,0,12,4,2.2,0.18468748,4
2020-03-14-170916,170916,1,0,9,5,0.4,0.063602865,5
2020-03-15-170916,170916,2,0,9,7,1.4,0.12721717,6
2020-03-16-170916,170916,7,0,23,14,7.2,0.7854793,0
2020-03-17-170916,170916,10,0,12,24,3.2,0.65932614,1
2020-03-18-170916,170916,22,0,11,46,8.6,1.1957182,2
2020-03-19-170916,170916,19,0,8,65,7.4,1.3005577,3
2020-03-20-170916,170916,16,0,13,81,8.8,1.015767,4
2020-03-21-170916,170916,7,0,3,88,3.0,0.35767296,5
2020-03-22-170916,170916,7,0,14,95,3.6,0.29666397,6
2020-03-23-170916,170916,24,0,9,119,16.2,1.8247387,0
2020-03-24-170916,170916,20,0,23,139,16.4,1.2881021,1
2020-03-25-170916,170916,25,0,5,164,9.6,1.4721115,2
2020-03-26-170916,170916,18,0,6,182,9.2,1.41764,3
2020-03-27-170916,170916,12,0,5,194,9.8,1.0168599,4
2020-03-28-170916,170916,9,0,39,203,3.4,0.3617204,5
2020-03-29-170916,170916,9,0,4,212,2.8,0.41102052,6
2020-03-30-170916,170916,23,0,16,235,10.6,1.3032697,0
2020-03-31-170916,170916,12,0,8,247,8.2,0.77622896,1
2020-04-01-170916,170916,11,0,10,258,6.0,0.83234215,2
2020-04-02-170916,170916,8,0,8,266,5.2,0.65493596,3
2020-04-03-170916,170916,13,0,8,279,5.6,0.8770606,4
2020-04-04-170916,170916,3,0,2,282,1.0,0.15028618,5
2020-04-05-170916,170916,14,0,1,296,1.4,0.47228378,6
2020-04-06-170916,170916,9,1,9,305,8.8,0.76647645,0
2020-04-07-170916,170916,23,0,6,328,25.6,1.4817816,1
2020-04-08-170916,170916,5,0,6,333,8.4,0.5030736,2
2020-04-09-170916,170916,6,1,0,339,6.4,0.46521485,3
2020-04-10-170916,170916,5,0,3,344,4.4,0.3197848,4
2020-04-11-170916,170916,39,0,3,383,4.4,1.4333135,5
2020-04-12-170916,170916,4,0,4,387,2.8,0.22828326,6
2020-04-13-170916,170916,16,0,7,403,23.0,1.1955533,0
2020-04-14-170916,170916,8,0,4,411,13.2,0.66080403,1
2020-04-15-170916,170916,10,0,9,421,9.6,0.8788104,2
2020-04-16-170916,170916,8,0,6,429,7.2,0.64383435,3
2020-04-17-170916,170916,8,0,0,437,4.8,0.53812546,4
2020-04-18-170916,170916,2,0,1,439,1.2,0.17542702,5
2020-04-19-170916,170916,1,0,2,440,0.2,0.041921675,6
2020-04-20-170916,170916,9,0,6,449,6.4,0.62762576,0
2020-04-21-170916,170916,6,0,5,455,5.4,0.60060495,1
2020-04-22-170916,170916,6,0,3,461,3.6,0.4398166,2
2020-04-23-170916,170916,0,0,4,461,0.6,0.022739938,3
2020-04-24-170916,170916,3,0,4,464,3.6,0.46729463,4
2020-04-25-170916,170916,3,0,3,467,1.0,0.15832235,5
2020-04-26-170916,170916,4,0,1,471,0.4,0.17080845,6
2020-04-27-170916,170916,7,0,3,478,3.8,0.4971327,0
2020-04-28-170916,170916,4,0,6,482,3.0,0.4740886,1
2020-04-29-170916,170916,9,0,5,491,3.0,0.69677687,2
2020-04-30-170916,170916,6,0,5,497,4.8,0.41871974,3
2020-05-01-170916,170916,0,0,4,497,0.6,0.014223228,4
2020-05-02-170916,170916,1,0,1,498,0.4,0.051518492,5
2020-05-03-170916,170916,2,0,1,500,0.6,0.10666957,6
2020-05-04-170916,170916,6,0,3,506,7.4,0.55292946,0
2020-05-05-170916,170916,5,0,8,511,5.0,0.45750454,1
2020-05-06-170916,170916,3,0,4,514,6.0,0.7559196,2
2020-05-07-170916,170916,4,0,7,518,4.8,0.47034168,3
2020-05-08-170916,170916,4,0,0,522,5.6,0.457379,4
2020-05-09-170916,170916,3,0,1,525,0.4,0.14789268,5
2020-05-10-170916,170916,1,0,0,526,0.4,0.07597858,6
2020-05-11-170916,170916,3,0,4,529,5.2,0.3990626,0
2020-05-12-170916,170916,6,0,5,535,4.2,0.41578776,1
2020-05-13-170916,170916,5,0,4,540,1.6,0.51628983,2
2020-05-14-170916,170916,5,0,5,545,4.4,0.39765647,3
2020-05-15-170916,170916,4,0,4,549,4.0,0.30037236,4
2020-05-16-170916,170916,1,0,0,550,0.4,0.104364656,5
2020-05-17-170916,170916,1,0,2,551,0.0,0.04019924,6
2020-05-18-170916,170916,3,0,2,554,3.4,0.46048394,0
2020-05-19-170916,170916,8,0,3,562,1.8,0.57185996,1
2020-05-20-170916,170916,4,0,3,566,1.8,0.23923698,2
2020-05-21-170916,170916,7,0,4,573,1.2,0.42680484,3
2020-05-22-170916,170916,0,0,1,573,1.0,0.20355967,4
2020-05-23-170916,170916,1,0,0,574,0.2,0.037700024,5
2020-05-24-170916,170916,0,0,0,574,0.4,0.01452853,6
2020-05-25-170916,170916,4,0,3,578,4.4,0.55067724,0
2020-05-26-170916,170916,5,0,1,583,4.0,0.36742902,1
2020-05-27-170916,170916,4,0,4,587,3.0,0.32177216,2
2020-05-28-170916,170916,5,0,3,592,1.4,0.49923804,3
2020-05-29-170916,170916,4,0,2,596,3.4,0.5066628,4
2020-05-30-170916,170916,0,0,1,596,1.0,0.06474382,5
2020-05-31-170916,170916,2,0,0,598,0.2,0.120256715,6
2020-06-01-170916,170916,2,0,2,600,5.4,0.577616,0
2020-06-02-170916,170916,3,0,3,603,2.2,0.3624479,1
2020-06-03-170916,170916,3,0,0,606,2.6,0.47670665,2
2020-06-04-170916,170916,4,0,2,610,1.8,0.32644796,3
2020-06-05-170916,170916,1,0,1,611,2.0,0.28171834,4
2020-06-06-170916,170916,0,0,0,611,0.0,0.0056718043,5
2020-06-07-170916,170916,0,0,0,611,0.4,0.029774383,6
2020-06-08-170916,170916,3,0,1,614,0.8,0.42350838,0
2020-06-09-170916,170916,1,0,0,615,1.8,0.4082306,1
2020-06-10-170916,170916,4,0,1,619,2.0,0.50065345,2
2020-06-11-170916,170916,3,0,2,622,1.8,0.4165779,3
2020-06-12-170916,170916,2,0,3,624,2.0,0.30300197,4
2020-06-13-170916,170916,1,2,1,625,0.2,0.06786783,5
2020-06-14-170916,170916,0,0,0,625,0.0,0.0077202166,6
2020-06-15-170916,170916,2,0,2,627,1.4,0.23478103,0
2020-06-16-170916,170916,3,0,1,630,3.0,0.48376772,1
2020-06-17-170916,170916,0,1,0,630,1.4,0.26625195,2
2020-06-18-170916,170916,2,0,1,632,1.6,0.25935915,3
2020-06-19-170916,170916,1,0,1,633,1.4,0.35400707,4
2020-06-20-170916,170916,0,0,0,633,0.2,0.055070404,5
2020-06-21-170916,170916,0,0,0,633,0.0,0.008822153,6
2020-06-22-170916,170916,1,0,0,634,1.4,0.2195762,0
2020-06-23-170916,170916,0,0,0,634,1.0,0.23845854,1
2020-06-24-170916,170916,1,0,1,635,0.6,0.17156234,2
2020-06-25-170916,170916,2,0,0,637,0.8,0.19774897,3
2020-06-26-170916,170916,3,0,2,640,0.0,0.19067328,4
2020-06-27-170916,170916,1,0,2,641,0.4,0.065761074,5
2020-06-28-170916,170916,0,0,0,641,0.0,0.025233265,6
2020-06-29-170916,170916,2,0,3,643,1.4,0.2601458,0
2020-06-30-170916,170916,1,0,0,644,0.4,0.1335143,1
2020-07-01-170916,170916,0,0,0,644,0.8,0.17400724,2
2020-07-02-170916,170916,1,0,1,645,0.6,0.13898611,3
2020-07-03-170916,170916,1,0,0,646,0.6,0.0941103,4
2020-07-04-170916,170916,0,0,0,646,0.2,0.016413637,5
2020-07-05-170916,170916,0,0,0,646,0.2,0.06699981,6
2020-07-06-170916,170916,0,0,1,646,0.8,0.15426919,0
2020-07-07-170916,170916,0,0,2,646,0.8,0.043270573,1
2020-07-08-170916,170916,1,1,0,647,0.4,0.06938313,2
2020-07-09-170916,170916,0,0,0,647,0.8,0.06825466,3
2020-07-10-170916,170916,2,0,0,649,0.2,0.13907295,4
2020-07-11-170916,170916,2,0,0,651,0.0,0.070547216,5
2020-07-12-170916,170916,0,0,0,651,0.0,0.012813751,6
2020-07-13-170916,170916,3,0,1,654,0.4,0.15098737,0
2020-07-14-170916,170916,0,0,1,654,0.8,0.10341874,1
2020-07-15-170916,170916,0,0,1,654,0.6,0.10724201,2
2020-07-16-170916,170916,1,0,0,655,0.2,0.0953838,3
2020-07-17-170916,170916,0,0,0,655,1.2,0.1791189,4
2020-07-18-170916,170916,0,0,0,655,0.0,0.012348083,5
2020-07-19-170916,170916,0,0,0,655,0.2,0.02779734,6
2020-07-20-170916,170916,1,0,0,656,0.6,0.113364995,0
2020-07-21-170916,170916,2,0,0,658,0.6,0.34826145,1
2020-07-22-170916,170916,0,0,0,658,1.2,0.1066337,2
2020-07-23-170916,170916,0,0,1,658,0.4,0.31905428,3
2020-07-24-170916,170916,0,0,1,658,0.2,0.15355758,4
2020-07-25-170916,170916,0,0,0,658,0.0,0.014722297,5
2020-07-26-170916,170916,0,0,0,658,0.0,0.009698783,6
2020-07-27-170916,170916,1,0,1,659,0.6,0.26256993,0
2020-07-28-170916,170916,1,0,3,660,1.4,0.16310601,1
2020-07-29-170916,170916,1,0,3,661,0.8,0.15036967,2
2020-07-30-170916,170916,0,0,1,661,1.2,0.24331073,3
2020-07-31-170916,170916,0,0,2,661,0.4,0.2146813,4
2020-08-01-170916,170916,0,0,11,661,0.0,0.034498755,5
2020-08-02-170916,170916,0,0,0,661,0.6,0.11474946,6
2020-08-03-170916,170916,0,0,3,661,0.2,0.1312346,0
2020-08-04-170916,170916,0,0,3,661,0.4,0.117693976,1
2020-08-05-170916,170916,0,0,7,661,0.6,0.27636948,2
2020-08-06-170916,170916,1,0,3,662,0.4,0.13616608,3
2020-08-07-170916,170916,1,0,2,663,0.2,0.2515128,4
2020-08-08-170916,170916,0,0,6,663,1.6,0.16687614,5
2020-08-09-170916,170916,0,0,0,663,0.6,0.081584916,6
2020-08-10-170916,170916,1,0,4,664,1.4,0.28916642,0
2020-08-11-170916,170916,3,0,7,667,2.2,0.49844238,1
2020-08-12-170916,170916,3,0,5,670,0.2,0.24787141,2
2020-08-13-170916,170916,1,0,10,671,1.2,0.48618266,3
2020-08-14-170916,170916,2,0,2,673,1.0,0.275813,4
2020-08-15-170916,170916,11,0,0,684,0.4,0.34332475,5
2020-08-16-170916,170916,0,0,0,684,1.2,0.09992578,6
2020-08-17-170916,170916,3,0,5,687,0.8,0.49276835,0
2020-08-18-170916,170916,3,0,4,690,2.2,0.4609571,1
2020-08-19-170916,170916,7,0,8,697,2.2,0.80887157,2
2020-08-20-170916,170916,3,0,1,700,6.4,0.8658628,3
2020-08-21-170916,170916,2,0,9,702,2.2,0.5401891,4
2020-08-22-170916,170916,6,0,2,708,1.0,0.41956356,5
2020-08-23-170916,170916,0,1,3,708,1.4,0.18294987,6
2020-08-24-170916,170916,4,0,11,712,4.8,0.91904557,0
2020-08-25-170916,170916,7,0,7,719,10.4,1.175109,1
2020-08-26-170916,170916,5,0,5,724,9.0,1.104282,2
2020-08-27-170916,170916,10,0,4,734,6.8,1.1314104,3
2020-08-28-170916,170916,2,0,6,736,7.8,1.122141,4
2020-08-29-170916,170916,0,0,1,736,2.8,0.5270029,5
2020-08-30-170916,170916,0,0,4,736,2.6,0.45993957,6
2020-08-31-170916,170916,5,0,7,741,5.4,0.62256134,0
2020-09-01-170916,170916,4,0,7,745,4.0,0.5357641,1
2020-09-02-170916,170916,8,0,12,753,7.0,1.0986829,2
2020-09-03-170916,170916,1,0,9,754,3.6,0.7090185,3
2020-09-04-170916,170916,9,0,7,763,7.4,0.89408165,4
2020-09-05-170916,170916,2,0,2,765,1.2,0.48242244,5
2020-09-06-170916,170916,3,0,2,768,1.8,0.5113433,6
2020-09-07-170916,170916,11,0,7,779,5.6,1.4121417,0
2020-09-08-170916,170916,7,0,12,786,3.0,0.93450797,1
2020-09-09-170916,170916,5,0,9,791,4.8,0.7739153,2
2020-09-10-170916,170916,4,0,2,795,4.8,1.2668227,3
2020-09-11-170916,170916,6,0,4,801,6.0,1.4675606,4
2020-09-12-170916,170916,1,0,6,802,0.8,0.6107576,5
2020-09-13-170916,170916,4,0,2,806,0.6,0.40574673,6
2020-09-14-170916,170916,7,0,9,813,7.0,1.2863889,0
2020-09-15-170916,170916,7,0,5,820,5.0,1.3145435,1
2020-09-16-170916,170916,12,0,7,832,7.8,1.6504757,2
2020-09-17-170916,170916,9,0,5,841,10.2,2.3222983,3
2020-09-18-170916,170916,7,0,10,848,4.2,2.1852756,4
2020-09-19-170916,170916,2,0,2,850,0.8,0.9535569,5
2020-09-20-170916,170916,2,1,1,852,0.6,0.32387,6
2020-09-21-170916,170916,7,0,4,859,7.2,1.18098,0
2020-09-22-170916,170916,12,0,10,871,4.2,1.2370713,1
2020-09-23-170916,170916,9,0,7,880,4.4,1.4236038,2
2020-09-24-170916,170916,2,0,6,882,6.2,1.853928,3
2020-09-25-170916,170916,4,1,3,886,8.0,1.7091072,4
2020-09-26-170916,170916,6,0,1,892,2.6,1.4173,5
2020-09-27-170916,170916,2,0,1,894,1.0,0.37423176,6
2020-09-28-170916,170916,9,0,4,903,3.4,0.93183935,0
2020-09-29-170916,170916,5,0,9,908,3.0,0.84754074,1
2020-09-30-170916,170916,7,0,13,915,3.2,1.0279877,2
2020-10-01-170916,170916,5,0,8,920,6.8,1.3898379,3
2020-10-02-170916,170916,10,0,5,930,5.4,1.7685565,4
2020-10-03-170916,170916,2,1,3,932,3.2,0.86144817,5
2020-10-04-170916,170916,1,0,2,933,0.8,0.16834581,6
2020-10-05-170916,170916,4,0,9,937,10.0,1.1709872,0
2020-10-06-170916,170916,10,0,7,947,6.4,2.002946,1
2020-10-07-170916,170916,7,0,15,954,7.8,1.6562915,2
2020-10-08-170916,170916,6,0,13,960,14.0,3.183229,3
2020-10-09-170916,170916,3,0,27,963,5.0,2.5278096,4
2020-10-10-170916,170916,1,0,6,964,1.0,0.8498651,5
2020-10-11-170916,170916,1,0,1,965,2.0,0.9213443,6
2020-10-12-170916,170916,4,0,20,969,1.0,0.3649136,0
2020-10-13-170916,170916,9,0,15,978,8.0,1.1929883,1
2020-10-14-170916,170916,13,0,28,991,8.0,1.6742694,2
2020-10-15-170916,170916,8,0,17,999,7.8,1.4624057,3
2020-10-16-170916,170916,5,0,30,1004,6.4,1.886686,4
2020-10-17-170916,170916,3,0,7,1007,3.0,1.1148896,5
2020-10-18-170916,170916,2,0,5,1009,2.8,0.5242959,6
2020-10-19-170916,170916,9,0,5,1018,8.8,1.2938133,0
2020-10-20-170916,170916,7,0,19,1025,12.0,2.0154676,1
2020-10-21-170916,170916,15,0,21,1040,14.0,2.096856,2
2020-10-22-170916,170916,13,0,32,1053,13.2,1.8411893,3
2020-10-23-170916,170916,27,0,43,1080,22.6,3.0552902,4
2020-10-24-170916,170916,6,0,4,1086,3.8,0.93751794,5
2020-10-25-170916,170916,1,0,3,1087,2.6,0.3911849,6
2020-10-26-170916,170916,20,0,12,1107,13.8,2.4826527,0
2020-10-27-170916,170916,15,0,19,1122,15.0,2.2454634,1
2020-10-28-170916,170916,28,1,28,1150,16.2,2.9163287,2
2020-10-29-170916,170916,17,1,14,1167,18.4,2.5893128,3
2020-10-30-170916,170916,30,0,27,1197,19.6,3.03151,4
2020-10-31-170916,170916,7,0,0,1204,4.2,1.302075,5
2020-11-01-170916,170916,5,0,0,1209,3.4,0.6316391,6
2020-11-02-170916,170916,5,0,0,1214,1.4,0.87329453,0
2020-11-03-170916,170916,19,1,0,1233,14.8,2.152492,1
2020-11-04-170916,170916,21,1,0,1254,17.0,2.8412075,2
2020-11-05-170916,170916,32,0,0,1286,25.0,3.4669352,3
2020-11-06-170916,170916,43,1,0,1329,22.2,3.5144594,4
2020-11-07-170916,170916,4,0,0,1333,4.6,0.8853442,5
2020-11-08-170916,170916,3,1,0,1336,2.6,0.38957328,6
2020-11-09-170916,170916,12,0,0,1348,18.4,1.5203559,0
2020-11-10-170916,170916,19,0,0,1367,12.2,1.7344184,1
2020-11-11-170916,170916,28,1,0,1395,13.6,2.3041995,2
2020-11-12-170916,170916,14,0,0,1409,11.6,1.9168364,3
2020-11-13-170916,170916,27,0,0,1436,15.0,1.7016108,4
2020-03-01-170919,170919,0,0,2,0,0.0,0.004577073,6
2020-03-02-170919,170919,0,0,8,0,0.0,0.010502875,0
2020-03-03-170919,170919,0,0,5,0,0.0,0.0027801935,1
2020-03-04-170919,170919,1,0,11,1,0.0,0.0010209687,2
2020-03-05-170919,170919,0,0,10,1,0.16666666666666666,0.009625415,3
2020-03-06-170919,170919,0,0,15,1,0.6666666666666666,0.04269084,4
2020-03-07-170919,170919,0,0,2,1,0.16666666666666666,0.00990305,5
2020-03-08-170919,170919,0,0,5,1,0.16666666666666666,0.0019911767,6
2020-03-09-170919,170919,1,0,23,2,0.6666666666666666,0.034572188,0
2020-03-10-170919,170919,1,0,22,3,0.0,0.022333823,1
2020-03-11-170919,170919,0,0,15,3,0.6666666666666666,0.035476424,2
2020-03-12-170919,170919,1,0,14,4,1.6666666666666667,0.042398643,3
2020-03-13-170919,170919,5,0,16,9,2.6666666666666665,0.13202596,4
2020-03-14-170919,170919,0,0,8,9,1.3333333333333333,0.029857112,5
2020-03-15-170919,170919,2,0,1,11,3.1666666666666665,0.03908876,6
2020-03-16-170919,170919,8,0,10,19,9.166666666666666,0.3226019,0
2020-03-17-170919,170919,5,1,16,24,6.666666666666668,0.24024667,1
2020-03-18-170919,170919,11,0,8,35,13.666666666666664,0.39003295,2
2020-03-19-170919,170919,10,1,11,45,12.333333333333336,0.4827045,3
2020-03-20-170919,170919,15,0,8,60,12.666666666666664,0.34641677,4
2020-03-21-170919,170919,2,0,2,62,5.333333333333333,0.08006991,5
2020-03-22-170919,170919,5,0,0,67,5.0,0.05971641,6
2020-03-23-170919,170919,23,1,10,90,18.666666666666668,0.6340402,0
2020-03-24-170919,170919,22,0,13,112,20.33333333333333,0.42343032,1
2020-03-25-170919,170919,15,0,22,127,18.5,0.42482603,2
2020-03-26-170919,170919,14,0,9,141,13.5,0.4390234,3
2020-03-27-170919,170919,16,0,9,157,12.833333333333336,0.3820497,4
2020-03-28-170919,170919,8,0,15,165,15.5,0.07864415,5
2020-03-29-170919,170919,1,0,7,166,6.0,0.08127399,6
2020-03-30-170919,170919,10,0,65,176,16.333333333333332,0.3416594,0
2020-03-31-170919,170919,16,0,45,192,11.666666666666664,0.22814244,1
2020-04-01-170919,170919,8,0,18,200,9.666666666666666,0.27585158,2
2020-04-02-170919,170919,11,0,11,211,6.333333333333332,0.25413135,3
2020-04-03-170919,170919,8,0,9,219,7.333333333333332,0.3539977,4
2020-04-04-170919,170919,2,0,0,221,2.5,0.04069039,5
2020-04-05-170919,170919,0,0,0,221,4.5,0.08133584,6
2020-04-06-170919,170919,10,0,13,231,10.0,0.2878361,0
2020-04-07-170919,170919,13,1,8,244,23.33333333333333,0.4117986,1
2020-04-08-170919,170919,22,1,8,266,6.833333333333332,0.23241544,2
2020-04-09-170919,170919,9,0,3,275,4.333333333333333,0.12846537,3
2020-04-10-170919,170919,9,0,8,284,5.333333333333333,0.07046565,4
2020-04-11-170919,170919,15,0,0,299,9.0,0.25957757,5
2020-04-12-170919,170919,7,0,1,306,2.333333333333333,0.06806284,6
2020-04-13-170919,170919,65,0,8,371,15.666666666666664,0.31333184,0
2020-04-14-170919,170919,45,0,6,416,9.0,0.26671574,1
2020-04-15-170919,170919,18,0,2,434,7.833333333333332,0.25259486,2
2020-04-16-170919,170919,11,0,10,445,8.0,0.222904,3
2020-04-17-170919,170919,9,0,0,454,5.5,0.18221334,4
2020-04-18-170919,170919,0,0,0,454,2.0,0.044138663,5
2020-04-19-170919,170919,0,0,0,454,0.8333333333333334,0.011121338,6
2020-04-20-170919,170919,13,0,7,467,6.5,0.22515257,0
2020-04-21-170919,170919,8,0,10,475,5.666666666666668,0.19984709,1
2020-04-22-170919,170919,8,0,7,483,6.0,0.14454843,2
2020-04-23-170919,170919,3,0,4,486,0.3333333333333333,0.006338939,3
2020-04-24-170919,170919,8,0,3,494,4.0,0.16996612,4
2020-04-25-170919,170919,0,0,0,494,1.1666666666666667,0.03163062,5
2020-04-26-170919,170919,1,0,0,495,1.1666666666666667,0.03870266,6
2020-04-27-170919,170919,8,0,11,503,4.833333333333333,0.18981619,0
2020-04-28-170919,170919,6,0,14,509,3.6666666666666665,0.17673507,1
2020-04-29-170919,170919,2,0,2,511,4.333333333333333,0.23182477,2
2020-04-30-170919,170919,10,0,7,521,4.666666666666667,0.16203198,3
2020-05-01-170919,170919,0,0,11,521,0.6666666666666666,0.00767059,4
2020-05-02-170919,170919,0,0,0,521,0.5,0.024678241,5
2020-05-03-170919,170919,0,1,0,521,0.6666666666666666,0.017029306,6
2020-05-04-170919,170919,7,0,4,528,8.166666666666666,0.21282215,0
2020-05-05-170919,170919,10,0,1,538,4.5,0.18135466,1
2020-05-06-170919,170919,7,0,2,545,4.0,0.2589856,2
2020-05-07-170919,170919,4,0,2,549,6.833333333333332,0.19161887,3
2020-05-08-170919,170919,3,0,3,552,7.5,0.18339038,4
2020-05-09-170919,170919,0,6,1,552,0.6666666666666666,0.036590066,5
2020-05-10-170919,170919,0,0,0,552,0.5,0.019257644,6
2020-05-11-170919,170919,11,0,10,563,5.0,0.17723432,0
2020-05-12-170919,170919,14,0,7,577,3.333333333333333,0.16089565,1
2020-05-13-170919,170919,2,0,5,579,0.8333333333333334,0.14587642,2
2020-05-14-170919,170919,7,0,6,586,4.5,0.18306376,3
2020-05-15-170919,170919,11,0,1,597,4.166666666666667,0.13565949,4
2020-05-16-170919,170919,0,0,1,597,0.16666666666666666,0.028150013,5
2020-05-17-170919,170919,0,0,0,597,0.16666666666666666,0.006920591,6
2020-05-18-170919,170919,4,0,1,601,5.0,0.19624752,0
2020-05-19-170919,170919,1,0,4,602,5.0,0.18288341,1
2020-05-20-170919,170919,2,0,2,604,4.666666666666667,0.13597775,2
2020-05-21-170919,170919,2,0,4,606,2.6666666666666665,0.18090852,3
2020-05-22-170919,170919,3,0,2,609,3.5,0.13602322,4
2020-05-23-170919,170919,1,0,0,610,0.3333333333333333,0.0077146925,5
2020-05-24-170919,170919,0,0,0,610,0.3333333333333333,0.0031165865,6
2020-05-25-170919,170919,10,0,1,620,4.166666666666667,0.22889498,0
2020-05-26-170919,170919,7,0,1,627,4.833333333333333,0.14481723,1
2020-05-27-170919,170919,5,3,5,632,4.333333333333333,0.1584498,2
2020-05-28-170919,170919,6,0,4,638,2.333333333333333,0.18262105,3
2020-05-29-170919,170919,1,0,2,639,4.333333333333333,0.22544098,4
2020-05-30-170919,170919,1,0,0,640,0.16666666666666666,0.026608735,5
2020-05-31-170919,170919,0,0,0,640,0.5,0.037113518,6
2020-06-01-170919,170919,1,0,5,641,4.5,0.26303402,0
2020-06-02-170919,170919,4,0,3,645,2.5,0.13942577,1
2020-06-03-170919,170919,2,0,1,647,1.6666666666666667,0.16876967,2
2020-06-04-170919,170919,4,0,1,651,1.5,0.1308451,3
2020-06-05-170919,170919,2,1,2,653,3.0,0.09353742,4
2020-06-06-170919,170919,0,0,0,653,0.0,0.005896732,5
2020-06-07-170919,170919,0,0,0,653,0.3333333333333333,0.010773116,6
2020-06-08-170919,170919,1,0,2,654,0.8333333333333334,0.18614249,0
2020-06-09-170919,170919,1,0,0,655,1.8333333333333333,0.16030987,1
2020-06-10-170919,170919,5,0,0,660,1.3333333333333333,0.21357006,2
2020-06-11-170919,170919,4,1,1,664,1.1666666666666667,0.19318502,3
2020-06-12-170919,170919,2,0,0,666,1.6666666666666667,0.13448682,4
2020-06-13-170919,170919,0,1,2,666,0.16666666666666666,0.02322403,5
2020-06-14-170919,170919,0,0,0,666,0.16666666666666666,0.00656298,6
2020-06-15-170919,170919,5,0,3,671,1.0,0.14811118,0
2020-06-16-170919,170919,3,0,0,674,2.833333333333333,0.23471771,1
2020-06-17-170919,170919,1,0,0,675,1.0,0.14118077,2
2020-06-18-170919,170919,1,1,0,676,2.0,0.13301843,3
2020-06-19-170919,170919,2,0,3,678,1.0,0.20079386,4
2020-06-20-170919,170919,0,0,0,678,0.3333333333333333,0.028599687,5
2020-06-21-170919,170919,0,0,1,678,0.16666666666666666,0.008170862,6
2020-06-22-170919,170919,2,0,1,680,1.5,0.10412997,0
2020-06-23-170919,170919,0,0,0,680,1.0,0.13500145,1
2020-06-24-170919,170919,0,0,1,680,1.0,0.075559616,2
2020-06-25-170919,170919,1,0,0,681,1.1666666666666667,0.08879787,3
2020-06-26-170919,170919,0,0,0,681,0.6666666666666666,0.08743561,4
2020-06-27-170919,170919,2,0,0,683,0.16666666666666666,0.024640398,5
2020-06-28-170919,170919,0,0,0,683,0.0,0.013830976,6
2020-06-29-170919,170919,3,0,0,686,1.3333333333333333,0.12023673,0
2020-06-30-170919,170919,0,0,2,686,1.1666666666666667,0.069173954,1
2020-07-01-170919,170919,0,0,0,686,0.8333333333333334,0.08358406,2
2020-07-02-170919,170919,0,0,0,686,0.5,0.058028605,3
2020-07-03-170919,170919,3,0,2,689,0.16666666666666666,0.066309996,4
2020-07-04-170919,170919,0,0,0,689,0.3333333333333333,0.010196263,5
2020-07-05-170919,170919,1,0,0,690,0.0,0.016493106,6
2020-07-06-170919,170919,1,0,0,691,0.5,0.07568232,0
2020-07-07-170919,170919,0,0,0,691,0.5,0.043863006,1
2020-07-08-170919,170919,1,0,2,692,1.1666666666666667,0.0417352,2
2020-07-09-170919,170919,0,0,0,692,0.6666666666666666,0.034841824,3
2020-07-10-170919,170919,0,1,0,692,1.0,0.07181795,4
2020-07-11-170919,170919,0,1,0,692,1.8333333333333333,0.019601539,5
2020-07-12-170919,170919,0,0,0,692,0.8333333333333334,0.010988131,6
2020-07-13-170919,170919,0,0,0,692,1.3333333333333333,0.075501695,0
2020-07-14-170919,170919,2,0,2,694,0.3333333333333333,0.052892156,1
2020-07-15-170919,170919,0,0,0,694,1.3333333333333333,0.05701982,2
2020-07-16-170919,170919,0,0,1,694,0.8333333333333334,0.04654601,3
2020-07-17-170919,170919,2,0,0,696,0.6666666666666666,0.11176745,4
2020-07-18-170919,170919,0,0,0,696,0.16666666666666666,0.004087053,5
2020-07-19-170919,170919,0,0,0,696,0.5,0.023433398,6
2020-07-20-170919,170919,0,0,0,696,1.0,0.065646514,0
2020-07-21-170919,170919,0,1,1,696,0.3333333333333333,0.14741266,1
2020-07-22-170919,170919,2,0,0,698,0.6666666666666666,0.056521885,2
2020-07-23-170919,170919,0,0,0,698,0.6666666666666666,0.14099443,3
2020-07-24-170919,170919,0,1,0,698,0.8333333333333334,0.091810785,4
2020-07-25-170919,170919,0,0,2,698,0.0,0.015701573,5
2020-07-26-170919,170919,0,0,1,698,0.0,0.0061596963,6
2020-07-27-170919,170919,0,1,1,698,1.0,0.18263423,0
2020-07-28-170919,170919,2,0,3,700,1.3333333333333333,0.08383202,1
2020-07-29-170919,170919,0,0,0,700,1.0,0.090620205,2
2020-07-30-170919,170919,1,0,1,701,2.0,0.11827773,3
2020-07-31-170919,170919,0,0,0,701,0.8333333333333334,0.105354965,4
2020-08-01-170919,170919,0,0,0,701,1.1666666666666667,0.023273092,5
2020-08-02-170919,170919,0,0,5,701,0.5,0.054389164,6
2020-08-03-170919,170919,0,1,0,701,0.5,0.07741694,0
2020-08-04-170919,170919,1,0,3,702,0.6666666666666666,0.08314198,1
2020-08-05-170919,170919,0,0,2,702,0.6666666666666666,0.1865957,2
2020-08-06-170919,170919,0,0,12,702,0.8333333333333334,0.08464255,3
2020-08-07-170919,170919,0,0,6,702,1.3333333333333333,0.118640594,4
2020-08-08-170919,170919,2,0,1,704,3.1666666666666665,0.10142674,5
2020-08-09-170919,170919,1,0,3,705,1.5,0.05294538,6
2020-08-10-170919,170919,1,0,6,706,2.333333333333333,0.13340564,0
2020-08-11-170919,170919,3,0,14,709,3.5,0.2525853,1
2020-08-12-170919,170919,0,0,7,709,1.3333333333333333,0.11973178,2
2020-08-13-170919,170919,1,0,10,710,3.0,0.2457992,3
2020-08-14-170919,170919,0,0,9,710,5.0,0.21436763,4
2020-08-15-170919,170919,0,1,0,710,2.1666666666666665,0.12831897,5
2020-08-16-170919,170919,5,0,0,715,1.6666666666666667,0.07861103,6
2020-08-17-170919,170919,0,0,5,715,2.5,0.2464453,0
2020-08-18-170919,170919,3,0,2,718,3.5,0.2632458,1
2020-08-19-170919,170919,2,0,1,720,6.166666666666668,0.3590906,2
2020-08-20-170919,170919,12,2,2,732,2.6666666666666665,0.42839736,3
2020-08-21-170919,170919,6,0,6,738,2.333333333333333,0.3941911,4
2020-08-22-170919,170919,1,0,1,739,1.8333333333333333,0.16766788,5
2020-08-23-170919,170919,3,0,1,742,1.1666666666666667,0.098546684,6
2020-08-24-170919,170919,6,0,8,748,5.333333333333333,0.4036129,0
2020-08-25-170919,170919,14,0,3,762,9.333333333333334,0.6250612,1
2020-08-26-170919,170919,7,0,6,769,10.333333333333334,0.4899264,2
2020-08-27-170919,170919,10,1,7,779,10.666666666666666,0.6167262,3
2020-08-28-170919,170919,9,0,4,788,8.833333333333334,0.70315087,4
2020-08-29-170919,170919,0,0,0,788,1.3333333333333333,0.20591919,5
2020-08-30-170919,170919,0,0,1,788,0.3333333333333333,0.24553339,6
2020-08-31-170919,170919,5,0,10,793,10.166666666666666,0.33552283,0
2020-09-01-170919,170919,2,0,11,795,7.333333333333332,0.27426624,1
2020-09-02-170919,170919,1,1,9,796,8.833333333333334,0.4765242,2
2020-09-03-170919,170919,2,0,6,798,6.333333333333332,0.40295678,3
2020-09-04-170919,170919,6,0,2,804,9.833333333333334,0.4488026,4
2020-09-05-170919,170919,1,0,1,805,1.0,0.22104639,5
2020-09-06-170919,170919,1,0,0,806,2.833333333333333,0.23313151,6
2020-09-07-170919,170919,8,0,6,814,7.833333333333332,0.64379233,0
2020-09-08-170919,170919,3,0,5,817,2.1666666666666665,0.3975518,1
2020-09-09-170919,170919,6,0,6,823,8.833333333333334,0.52605224,2
2020-09-10-170919,170919,7,0,3,830,8.0,0.74989337,3
2020-09-11-170919,170919,4,0,10,834,7.833333333333332,0.7596648,4
2020-09-12-170919,170919,0,0,3,834,1.6666666666666667,0.29539725,5
2020-09-13-170919,170919,1,0,0,835,2.1666666666666665,0.18685435,6
2020-09-14-170919,170919,10,0,2,845,9.333333333333334,0.7015932,0
2020-09-15-170919,170919,11,0,3,856,10.166666666666666,0.76124674,1
2020-09-16-170919,170919,9,0,5,865,11.166666666666664,0.85247296,2
2020-09-17-170919,170919,6,0,1,871,9.666666666666666,1.1429845,3
2020-09-18-170919,170919,2,0,7,873,9.333333333333334,1.0933741,4
2020-09-19-170919,170919,1,0,2,874,1.8333333333333333,0.5835957,5
2020-09-20-170919,170919,0,0,0,874,3.1666666666666665,0.18533076,6
2020-09-21-170919,170919,6,1,11,880,11.0,0.63443637,0
2020-09-22-170919,170919,5,0,3,885,13.333333333333336,0.6131302,1
2020-09-23-170919,170919,6,1,18,891,9.5,0.72266364,2
2020-09-24-170919,170919,3,0,10,894,5.5,0.98601305,3
2020-09-25-170919,170919,10,1,9,904,11.5,0.770323,4
2020-09-26-170919,170919,3,0,1,907,6.666666666666668,0.58470243,5
2020-09-27-170919,170919,0,0,1,907,1.0,0.19182672,6
2020-09-28-170919,170919,2,0,2,909,6.5,0.42862877,0
2020-09-29-170919,170919,3,0,22,912,6.0,0.44497472,1
2020-09-30-170919,170919,5,1,9,917,6.333333333333332,0.44771895,2
2020-10-01-170919,170919,1,0,15,918,9.166666666666666,0.7564038,3
2020-10-02-170919,170919,7,0,1,925,10.166666666666666,0.8422642,4
2020-10-03-170919,170919,2,2,3,927,1.1666666666666667,0.37207326,5
2020-10-04-170919,170919,0,1,4,927,0.5,0.11324944,6
2020-10-05-170919,170919,11,0,16,938,11.0,0.5832772,0
2020-10-06-170919,170919,3,0,11,941,9.333333333333334,0.968486,1
2020-10-07-170919,170919,18,0,32,959,9.333333333333334,0.7765012,2
2020-10-08-170919,170919,10,0,35,969,5.666666666666668,1.3061435,3
2020-10-09-170919,170919,9,1,53,978,5.333333333333333,1.0783348,4
2020-10-10-170919,170919,1,0,2,979,1.1666666666666667,0.356861,5
2020-10-11-170919,170919,1,0,0,980,0.5,0.3164501,6
2020-10-12-170919,170919,2,0,27,982,1.3333333333333333,0.18467343,0
2020-10-13-170919,170919,22,0,23,1004,7.5,0.6976645,1
2020-10-14-170919,170919,9,0,35,1013,9.0,0.8601652,2
2020-10-15-170919,170919,15,0,26,1028,9.833333333333334,0.67549765,3
2020-10-16-170919,170919,1,0,24,1029,6.833333333333332,0.8749678,4
2020-10-17-170919,170919,3,0,7,1032,1.5,0.48542672,5
2020-10-18-170919,170919,4,0,3,1036,2.833333333333333,0.2751358,6
2020-10-19-170919,170919,16,1,1,1052,11.833333333333336,0.67571896,0
2020-10-20-170919,170919,11,0,17,1063,19.0,1.168639,1
2020-10-21-170919,170919,32,0,20,1095,14.5,0.96471035,2
2020-10-22-170919,170919,35,2,43,1130,17.0,0.8731283,3
2020-10-23-170919,170919,53,0,38,1183,23.5,1.622008,4
2020-10-24-170919,170919,2,0,1,1185,3.6666666666666665,0.50869656,5
2020-10-25-170919,170919,0,2,0,1185,3.0,0.19568565,6
2020-10-26-170919,170919,27,2,23,1212,20.33333333333333,1.1967605,0
2020-10-27-170919,170919,23,2,15,1235,17.5,1.2033788,1
2020-10-28-170919,170919,35,2,18,1270,18.33333333333333,1.6202801,2
2020-10-29-170919,170919,26,2,24,1296,32.833333333333336,1.4008912,3
2020-10-30-170919,170919,24,2,17,1320,25.83333333333333,1.6717597,4
2020-10-31-170919,170919,7,1,0,1327,5.666666666666668,0.64747864,5
2020-11-01-170919,170919,3,2,0,1330,15.333333333333336,0.36519065,6
2020-11-02-170919,170919,1,1,0,1331,5.5,0.31792116,0
2020-11-03-170919,170919,17,3,0,1348,21.166666666666668,1.1057179,1
2020-11-04-170919,170919,20,2,0,1368,26.0,1.4666784,2
2020-11-05-170919,170919,43,1,0,1411,34.833333333333336,1.725174,3
2020-11-06-170919,170919,38,0,0,1449,32.333333333333336,1.5262495,4
2020-11-07-170919,170919,1,1,0,1450,5.0,0.45259163,5
2020-11-08-170919,170919,0,0,0,1450,10.666666666666666,0.21860044,6
2020-11-09-170919,170919,23,0,0,1473,19.83333333333333,0.7655956,0
2020-11-10-170919,170919,15,0,0,1488,18.0,0.9216354,1
2020-11-11-170919,170919,18,1,0,1506,17.833333333333332,1.0611647,2
2020-11-12-170919,170919,24,2,0,1530,17.0,0.9656934,3
2020-11-13-170919,170919,17,1,0,1547,24.66666666666667,0.87110084,4
2020-03-01-170920,170920,0,0,1,0,0.0,0.0013359925,6
2020-03-02-170920,170920,0,0,3,0,0.0,0.017323634,0
2020-03-03-170920,170920,0,0,3,0,0.0,0.001152547,1
2020-03-04-170920,170920,0,0,8,0,0.0,0.005239998,2
2020-03-05-170920,170920,0,0,9,0,0.0,0.0057386076,3
2020-03-06-170920,170920,0,0,6,0,0.25,0.016099129,4
2020-03-07-170920,170920,0,0,5,0,0.0,0.01319526,5
2020-03-08-170920,170920,0,0,2,0,0.0,0.0006098404,6
2020-03-09-170920,170920,0,0,15,0,0.0,0.06876563,0
2020-03-10-170920,170920,0,0,2,0,0.125,0.031332433,1
2020-03-11-170920,170920,0,0,9,0,0.375,0.11790776,2
2020-03-12-170920,170920,0,0,5,0,0.125,0.046603244,3
2020-03-13-170920,170920,1,0,5,1,0.5,0.60641384,4
2020-03-14-170920,170920,0,0,4,1,0.125,0.04042536,5
2020-03-15-170920,170920,1,0,3,2,0.75,0.053007096,6
2020-03-16-170920,170920,3,0,5,5,2.5,1.4858098,0
2020-03-17-170920,170920,3,0,3,8,2.125,1.1400859,1
2020-03-18-170920,170920,8,0,9,16,4.25,2.1914763,2
2020-03-19-170920,170920,9,0,2,25,4.0,3.209727,3
2020-03-20-170920,170920,6,0,3,31,4.625,2.006104,4
2020-03-21-170920,170920,5,0,0,36,2.375,1.4631717,5
2020-03-22-170920,170920,2,0,1,38,1.875,0.58105165,6
2020-03-23-170920,170920,15,0,6,53,8.125,4.5054426,0
2020-03-24-170920,170920,2,0,21,55,5.875,1.3047372,1
2020-03-25-170920,170920,9,0,3,64,6.125,2.786812,2
2020-03-26-170920,170920,5,0,13,69,5.5,1.8965862,3
2020-03-27-170920,170920,5,0,8,74,4.375,2.410966,4
2020-03-28-170920,170920,4,0,1,78,1.375,1.0110706,5
2020-03-29-170920,170920,3,0,0,81,2.0,0.63731486,6
2020-03-30-170920,170920,5,0,4,86,5.875,2.012506,0
2020-03-31-170920,170920,3,0,3,89,3.375,1.4263929,1
2020-04-01-170920,170920,9,0,15,98,3.5,2.4246821,2
2020-04-02-170920,170920,2,0,0,100,2.25,0.7353498,3
2020-04-03-170920,170920,3,0,3,103,4.125,1.4439664,4
2020-04-04-170920,170920,0,0,1,103,1.25,0.26529557,5
2020-04-05-170920,170920,1,0,0,104,2.25,0.21414629,6
2020-04-06-170920,170920,6,0,4,110,3.375,1.9175897,0
2020-04-07-170920,170920,21,0,1,131,5.375,5.7276,1
2020-04-08-170920,170920,3,1,2,134,2.5,1.4751092,2
2020-04-09-170920,170920,13,0,0,147,2.0,2.3149834,3
2020-04-10-170920,170920,8,0,5,155,2.25,1.5353332,4
2020-04-11-170920,170920,1,0,1,156,6.375,0.41546604,5
2020-04-12-170920,170920,0,0,0,156,1.875,0.27596623,6
2020-04-13-170920,170920,4,1,0,160,6.875,2.7014298,0
2020-04-14-170920,170920,3,0,2,163,3.875,1.3209524,1
2020-04-15-170920,170920,15,0,3,178,2.375,3.7065842,2
2020-04-16-170920,170920,0,0,5,178,3.625,0.3794079,3
2020-04-17-170920,170920,3,1,0,181,2.75,0.86766654,4
2020-04-18-170920,170920,1,0,0,182,0.625,0.23726076,5
2020-04-19-170920,170920,0,0,2,182,0.375,0.018189523,6
2020-04-20-170920,170920,4,0,3,186,2.625,1.3422183,0
2020-04-21-170920,170920,1,0,2,187,2.75,0.6875802,1
2020-04-22-170920,170920,2,0,7,189,1.625,0.8064599,2
2020-04-23-170920,170920,0,0,4,189,0.375,0.114745304,3
2020-04-24-170920,170920,5,0,7,194,2.75,2.1265948,4
2020-04-25-170920,170920,1,0,1,195,0.875,0.2762111,5
2020-04-26-170920,170920,0,1,0,195,0.75,0.015766962,6
2020-04-27-170920,170920,0,0,2,195,2.625,0.46494988,0
2020-04-28-170920,170920,2,0,2,197,1.5,0.8271321,1
2020-04-29-170920,170920,3,0,2,200,3.0,1.3963324,2
2020-04-30-170920,170920,5,0,2,205,1.625,1.2529948,3
2020-05-01-170920,170920,0,0,1,205,0.0,0.020865798,4
2020-05-02-170920,170920,0,0,0,205,0.375,0.03623653,5
2020-05-03-170920,170920,2,0,0,207,0.25,0.513015,6
2020-05-04-170920,170920,3,0,1,210,3.375,1.5149059,0
2020-05-05-170920,170920,2,0,0,212,1.75,0.9643109,1
2020-05-06-170920,170920,7,0,0,219,10.625,3.1514,2
2020-05-07-170920,170920,4,0,0,223,3.625,1.8069416,3
2020-05-08-170920,170920,7,0,0,230,2.75,2.734627,4
2020-05-09-170920,170920,1,0,0,231,0.625,0.31420624,5
2020-05-10-170920,170920,0,0,1,231,0.25,0.008444171,6
2020-05-11-170920,170920,2,1,3,233,1.75,1.0910879,0
2020-05-12-170920,170920,2,0,0,235,3.5,0.9693624,1
2020-05-13-170920,170920,2,0,0,237,1.875,1.0153937,2
2020-05-14-170920,170920,2,2,1,239,1.75,0.8766266,3
2020-05-15-170920,170920,1,0,2,240,1.375,0.54058534,4
2020-05-16-170920,170920,0,0,2,240,0.375,0.017528279,5
2020-05-17-170920,170920,0,0,1,240,0.125,0.0015935805,6
2020-05-18-170920,170920,1,0,1,241,2.25,1.107038,0
2020-05-19-170920,170920,0,0,2,241,3.0,0.6791829,1
2020-05-20-170920,170920,0,0,4,241,2.125,0.30032626,2
2020-05-21-170920,170920,0,0,2,241,2.25,0.4089404,3
2020-05-22-170920,170920,0,0,2,241,1.5,0.5173594,4
2020-05-23-170920,170920,0,0,0,241,0.125,0.0033291327,5
2020-05-24-170920,170920,1,0,1,242,0.0,0.30712435,6
2020-05-25-170920,170920,3,0,1,245,1.25,1.6069146,0
2020-05-26-170920,170920,0,0,2,245,1.375,0.29967344,1
2020-05-27-170920,170920,0,0,2,245,1.375,0.1903097,2
2020-05-28-170920,170920,1,2,3,246,2.875,1.6710398,3
2020-05-29-170920,170920,2,1,4,248,1.375,1.418708,4
2020-05-30-170920,170920,2,0,1,250,0.125,0.4083845,5
2020-05-31-170920,170920,1,0,0,251,0.25,0.361104,6
2020-06-01-170920,170920,1,0,0,252,2.125,0.8727285,0
2020-06-02-170920,170920,2,0,2,254,1.125,1.1125826,1
2020-06-03-170920,170920,4,0,5,258,1.25,1.8811586,2
2020-06-04-170920,170920,2,0,3,260,1.25,1.1183403,3
2020-06-05-170920,170920,2,1,3,262,0.5,1.1179286,4
2020-06-06-170920,170920,0,0,1,262,0.125,0.020102898,5
2020-06-07-170920,170920,1,0,0,263,0.0,0.36190522,6
2020-06-08-170920,170920,1,0,1,264,1.0,0.98527974,0
2020-06-09-170920,170920,2,0,3,266,0.875,1.2869675,1
2020-06-10-170920,170920,2,0,2,268,1.375,1.2898223,2
2020-06-11-170920,170920,3,0,0,271,0.75,1.4160004,3
2020-06-12-170920,170920,4,0,0,275,0.375,1.7228932,4
2020-06-13-170920,170920,1,1,0,276,0.125,0.45151865,5
2020-06-14-170920,170920,0,0,0,276,0.0,0.006311,6
2020-06-15-170920,170920,0,0,2,276,0.625,0.07880605,0
2020-06-16-170920,170920,2,0,1,278,1.0,0.70284724,1
2020-06-17-170920,170920,5,0,1,283,0.125,2.0742538,2
2020-06-18-170920,170920,3,0,0,286,0.375,1.3296148,3
2020-06-19-170920,170920,3,0,0,289,0.5,1.6578346,4
2020-06-20-170920,170920,1,0,0,290,0.0,0.43193552,5
2020-06-21-170920,170920,0,0,0,290,0.0,0.0032587168,6
2020-06-22-170920,170920,1,0,2,291,0.625,0.5348739,0
2020-06-23-170920,170920,3,0,0,294,0.125,1.4923298,1
2020-06-24-170920,170920,2,0,0,296,0.125,0.908511,2
2020-06-25-170920,170920,0,0,0,296,0.625,0.25242138,3
2020-06-26-170920,170920,0,0,0,296,0.5,0.28907886,4
2020-06-27-170920,170920,0,0,0,296,0.125,0.013291292,5
2020-06-28-170920,170920,0,0,0,296,0.0,0.0144321965,6
2020-06-29-170920,170920,2,0,1,298,0.375,1.0907117,0
2020-06-30-170920,170920,1,0,0,299,0.25,0.5191272,1
2020-07-01-170920,170920,1,0,2,300,0.25,0.5029409,2
2020-07-02-170920,170920,0,0,1,300,0.375,0.22012705,3
2020-07-03-170920,170920,0,1,2,300,0.125,0.04058241,4
2020-07-04-170920,170920,0,0,0,300,0.0,0.0152500225,5
2020-07-05-170920,170920,0,0,0,300,0.125,0.17345846,6
2020-07-06-170920,170920,2,0,1,302,0.0,0.9899602,0
2020-07-07-170920,170920,0,0,1,302,0.125,0.014857389,1
2020-07-08-170920,170920,0,0,1,302,0.125,0.020511054,2
2020-07-09-170920,170920,0,0,0,302,0.25,0.04826682,3
2020-07-10-170920,170920,0,0,1,302,0.25,0.06276446,4
2020-07-11-170920,170920,0,0,0,302,0.25,0.013767462,5
2020-07-12-170920,170920,0,0,0,302,0.0,0.00735537,6
2020-07-13-170920,170920,1,0,1,303,0.375,0.48058918,0
2020-07-14-170920,170920,0,0,3,303,0.375,0.27289194,1
2020-07-15-170920,170920,2,0,3,305,0.125,0.90136224,2
2020-07-16-170920,170920,1,0,4,306,0.625,0.22299863,3
2020-07-17-170920,170920,2,0,1,308,0.125,0.97985417,4
2020-07-18-170920,170920,0,0,0,308,0.0,0.008202284,5
2020-07-19-170920,170920,0,0,3,308,0.125,0.04275935,6
2020-07-20-170920,170920,1,0,0,309,0.25,0.6757017,0
2020-07-21-170920,170920,1,0,0,310,0.75,0.877088,1
2020-07-22-170920,170920,1,0,0,311,0.125,0.48030955,2
2020-07-23-170920,170920,0,0,0,311,0.875,1.0369098,3
2020-07-24-170920,170920,1,0,0,312,0.375,0.93154216,4
2020-07-25-170920,170920,0,0,0,312,0.0,0.0047043664,5
2020-07-26-170920,170920,0,0,0,312,0.0,0.008346146,6
2020-07-27-170920,170920,1,0,0,313,0.375,1.161097,0
2020-07-28-170920,170920,3,0,0,316,0.125,0.9276041,1
2020-07-29-170920,170920,3,2,0,319,0.25,1.356534,2
2020-07-30-170920,170920,4,0,0,323,0.25,1.5716997,3
2020-07-31-170920,170920,1,0,0,324,0.5,0.7348092,4
2020-08-01-170920,170920,0,0,1,324,0.0,0.031179074,5
2020-08-02-170920,170920,3,0,0,327,0.0,1.2775538,6
2020-08-03-170920,170920,0,0,0,327,0.125,0.2373185,0
2020-08-04-170920,170920,0,0,1,327,0.25,0.090214066,1
2020-08-05-170920,170920,0,0,2,327,0.25,0.8281312,2
2020-08-06-170920,170920,0,0,11,327,0.25,0.06743289,3
2020-08-07-170920,170920,0,0,4,327,0.75,0.5320196,4
2020-08-08-170920,170920,0,0,3,327,0.25,0.054050837,5
2020-08-09-170920,170920,0,0,2,327,0.125,0.09027703,6
2020-08-10-170920,170920,0,0,9,327,0.75,0.1108753,0
2020-08-11-170920,170920,0,0,20,327,1.5,0.5956556,1
2020-08-12-170920,170920,0,0,20,327,0.75,0.15857004,2
2020-08-13-170920,170920,0,0,9,327,0.75,0.86861223,3
2020-08-14-170920,170920,0,0,7,327,0.875,0.5011769,4
2020-08-15-170920,170920,1,0,12,328,1.625,0.5673155,5
2020-08-16-170920,170920,0,0,13,328,0.25,0.08145435,6
2020-08-17-170920,170920,0,0,5,328,1.875,0.58985496,0
2020-08-18-170920,170920,1,0,6,329,1.0,0.47002032,1
2020-08-19-170920,170920,2,0,11,331,2.375,2.7957869,2
2020-08-20-170920,170920,11,1,8,342,1.625,4.393439,3
2020-08-21-170920,170920,4,0,5,346,0.75,1.3839936,4
2020-08-22-170920,170920,3,0,2,349,1.0,1.4056292,5
2020-08-23-170920,170920,2,0,1,351,0.375,1.1829284,6
2020-08-24-170920,170920,9,0,5,360,1.5,4.6328073,0
2020-08-25-170920,170920,20,0,7,380,1.875,6.815387,1
2020-08-26-170920,170920,20,0,3,400,1.0,8.815767,2
2020-08-27-170920,170920,9,0,5,409,2.5,4.438025,3
2020-08-28-170920,170920,7,0,3,416,2.125,3.4157405,4
2020-08-29-170920,170920,12,0,4,428,0.25,4.6565394,5
2020-08-30-170920,170920,13,0,1,441,0.25,4.9702206,6
2020-08-31-170920,170920,5,0,9,446,2.375,1.7404572,0
2020-09-01-170920,170920,6,0,3,452,1.375,1.8500242,1
2020-09-02-170920,170920,11,0,8,463,2.5,3.616036,2
2020-09-03-170920,170920,8,0,6,471,1.0,4.021939,3
2020-09-04-170920,170920,5,0,9,476,2.75,1.7943027,4
2020-09-05-170920,170920,2,0,1,478,1.375,2.6180809,5
2020-09-06-170920,170920,1,0,3,479,1.125,0.7933062,6
2020-09-07-170920,170920,5,0,4,484,4.625,4.324992,0
2020-09-08-170920,170920,7,0,2,491,2.0,1.9814787,1
2020-09-09-170920,170920,3,0,3,494,1.625,1.6798528,2
2020-09-10-170920,170920,5,0,14,499,1.875,3.5785692,3
2020-09-11-170920,170920,3,0,10,502,3.5,2.772977,4
2020-09-12-170920,170920,4,0,1,506,1.625,3.3706985,5
2020-09-13-170920,170920,1,0,3,507,1.125,1.2662365,6
2020-09-14-170920,170920,9,0,2,516,3.75,6.0216475,0
2020-09-15-170920,170920,3,0,1,519,3.125,3.3660002,1
2020-09-16-170920,170920,8,0,5,527,4.625,6.4701366,2
2020-09-17-170920,170920,6,0,10,533,5.875,4.3562326,3
2020-09-18-170920,170920,9,0,7,542,3.0,5.2736106,4
2020-09-19-170920,170920,1,0,13,543,2.0,1.9016063,5
2020-09-20-170920,170920,3,0,3,546,0.875,1.3395956,6
2020-09-21-170920,170920,4,0,2,550,2.875,2.3488348,0
2020-09-22-170920,170920,2,1,14,552,4.75,1.5475996,1
2020-09-23-170920,170920,3,1,4,555,4.875,3.4957774,2
2020-09-24-170920,170920,14,1,17,569,5.125,9.687269,3
2020-09-25-170920,170920,10,1,6,579,6.875,8.707731,4
2020-09-26-170920,170920,1,0,0,580,5.25,3.0748959,5
2020-09-27-170920,170920,3,0,7,583,0.875,1.5802735,6
2020-09-28-170920,170920,2,0,0,585,3.75,1.7337238,0
2020-09-29-170920,170920,1,0,3,586,2.75,2.0483356,1
2020-09-30-170920,170920,5,0,9,591,3.375,3.3147748,2
2020-10-01-170920,170920,10,0,7,601,4.25,5.0951834,3
2020-10-02-170920,170920,7,0,20,608,5.25,5.2620106,4
2020-10-03-170920,170920,13,1,9,621,1.25,5.6313066,5
2020-10-04-170920,170920,3,0,5,624,1.125,0.9392502,6
2020-10-05-170920,170920,2,0,2,626,4.375,1.6506886,0
2020-10-06-170920,170920,14,0,14,640,6.125,8.512438,1
2020-10-07-170920,170920,4,1,7,644,4.625,4.4917026,2
2020-10-08-170920,170920,17,1,8,661,8.25,9.991789,3
2020-10-09-170920,170920,6,2,4,667,4.0,6.507646,4
2020-10-10-170920,170920,0,0,10,667,2.375,1.7702321,5
2020-10-11-170920,170920,7,0,1,674,2.75,3.9128044,6
2020-10-12-170920,170920,0,0,4,674,1.0,0.28508294,0
2020-10-13-170920,170920,3,0,13,677,4.125,2.409209,1
2020-10-14-170920,170920,9,0,8,686,4.5,4.476026,2
2020-10-15-170920,170920,7,0,17,693,3.625,4.6719155,3
2020-10-16-170920,170920,20,0,9,713,3.125,9.222776,4
2020-10-17-170920,170920,9,0,5,722,2.125,4.6266236,5
2020-10-18-170920,170920,5,0,0,727,2.125,2.4174376,6
2020-10-19-170920,170920,2,0,2,729,7.25,1.9644434,0
2020-10-20-170920,170920,14,0,7,743,7.125,6.992129,1
2020-10-21-170920,170920,7,0,3,750,8.875,4.3723407,2
2020-10-22-170920,170920,8,0,9,758,9.625,5.0982537,3
2020-10-23-170920,170920,4,0,12,762,10.25,4.6294165,4
2020-10-24-170920,170920,10,0,9,772,2.375,4.1835337,5
2020-10-25-170920,170920,1,0,3,773,1.5,0.6400489,6
2020-10-26-170920,170920,4,0,2,777,11.5,6.046094,0
2020-10-27-170920,170920,13,0,6,790,6.5,6.8222876,1
2020-10-28-170920,170920,8,2,9,798,10.625,5.3695636,2
2020-10-29-170920,170920,17,2,7,815,5.75,10.169003,3
2020-10-30-170920,170920,9,0,8,824,11.5,6.9025073,4
2020-10-31-170920,170920,5,1,0,829,4.75,4.4909196,5
2020-11-01-170920,170920,0,0,0,829,2.25,2.0050085,6
2020-11-02-170920,170920,2,0,0,831,3.875,2.584377,0
2020-11-03-170920,170920,7,0,0,838,8.25,5.4444203,1
2020-11-04-170920,170920,3,0,0,841,9.5,4.2144,2
2020-11-05-170920,170920,9,0,0,850,11.0,7.3860326,3
2020-11-06-170920,170920,12,1,0,862,10.0,6.632971,4
2020-11-07-170920,170920,9,0,0,871,3.0,4.2158504,5
2020-11-08-170920,170920,3,0,0,874,1.0,0.92575014,6
2020-11-09-170920,170920,2,0,0,876,6.875,2.2885232,0
2020-11-10-170920,170920,6,0,0,882,6.5,3.8747368,1
2020-11-11-170920,170920,9,1,0,891,7.375,4.956319,2
2020-11-12-170920,170920,7,0,0,898,4.875,5.2083197,3
2020-11-13-170920,170920,8,1,0,906,6.0,4.085048,4
2020-03-01-170924,170924,0,0,0,0,0.0,1.975954e-05,6
2020-03-02-170924,170924,0,0,0,0,0.0,0.00016884066,0
2020-03-03-170924,170924,0,0,0,0,0.0,1.4821707e-07,1
2020-03-04-170924,170924,0,0,0,0,0.2,0.016296597,2
2020-03-05-170924,170924,0,0,0,0,0.0,6.641088e-05,3
2020-03-06-170924,170924,0,0,0,0,0.0,0.0014464207,4
2020-03-07-170924,170924,0,0,0,0,0.0,0.0015829353,5
2020-03-08-170924,170924,0,0,0,0,0.0,6.587348e-05,6
2020-03-09-170924,170924,0,0,0,0,0.0,0.0043022283,0
2020-03-10-170924,170924,0,0,0,0,0.2,0.049370456,1
2020-03-11-170924,170924,0,0,2,0,0.2,0.050295133,2
2020-03-12-170924,170924,0,0,1,0,0.0,0.0043206927,3
2020-03-13-170924,170924,0,0,0,0,0.2,0.063963465,4
2020-03-14-170924,170924,0,0,0,0,0.0,0.002691601,5
2020-03-15-170924,170924,0,0,0,0,0.6,0.052812066,6
2020-03-16-170924,170924,0,0,0,0,0.8,0.17676467,0
2020-03-17-170924,170924,0,0,0,0,0.8,0.14111283,1
2020-03-18-170924,170924,0,2,0,0,0.4,0.12600541,2
2020-03-19-170924,170924,0,0,0,0,0.4,0.14156151,3
2020-03-20-170924,170924,0,0,0,0,1.6,0.28720275,4
2020-03-21-170924,170924,0,0,0,0,0.6,0.121781275,5
2020-03-22-170924,170924,0,0,0,0,0.8,0.106529735,6
2020-03-23-170924,170924,0,0,1,0,2.0,0.3645269,0
2020-03-24-170924,170924,0,0,2,0,2.0,0.33192065,1
2020-03-25-170924,170924,2,0,1,2,1.6,0.33530304,2
2020-03-26-170924,170924,1,0,0,3,1.4,0.35461825,3
2020-03-27-170924,170924,0,0,0,3,1.0,0.23738414,4
2020-03-28-170924,170924,0,1,0,3,0.0,0.016766518,5
2020-03-29-170924,170924,0,0,0,3,0.4,0.085080005,6
2020-03-30-170924,170924,0,0,1,3,1.8,0.21896903,0
2020-03-31-170924,170924,0,0,1,3,2.2,0.25101548,1
2020-04-01-170924,170924,0,0,0,3,1.6,0.22902958,2
2020-04-02-170924,170924,0,0,1,3,0.6,0.103085026,3
2020-04-03-170924,170924,0,0,1,3,1.8,0.2123074,4
2020-04-04-170924,170924,0,0,0,3,0.8,0.09367648,5
2020-04-05-170924,170924,0,1,0,3,0.8,0.07927886,6
2020-04-06-170924,170924,1,0,1,4,0.8,0.18175404,0
2020-04-07-170924,170924,2,0,14,6,2.0,0.38436285,1
2020-04-08-170924,170924,1,0,1,7,0.6,0.11404464,2
2020-04-09-170924,170924,0,0,0,7,0.2,0.061447613,3
2020-04-10-170924,170924,0,0,0,7,0.8,0.09927252,4
2020-04-11-170924,170924,0,0,0,7,0.4,0.046822533,5
2020-04-12-170924,170924,0,0,0,7,0.4,0.040098593,6
2020-04-13-170924,170924,1,0,0,8,2.2,0.39243796,0
2020-04-14-170924,170924,1,0,2,9,1.2,0.22210583,1
2020-04-15-170924,170924,0,0,0,9,0.6,0.12152318,2
2020-04-16-170924,170924,1,0,0,10,1.2,0.18299827,3
2020-04-17-170924,170924,1,0,0,11,1.4,0.27751744,4
2020-04-18-170924,170924,0,0,0,11,0.2,0.03705415,5
2020-04-19-170924,170924,0,0,0,11,0.2,0.02626409,6
2020-04-20-170924,170924,1,0,0,12,0.6,0.15024166,0
2020-04-21-170924,170924,14,0,0,26,0.6,0.6810409,1
2020-04-22-170924,170924,1,0,0,27,0.4,0.13112102,2
2020-04-23-170924,170924,0,1,0,27,0.4,0.014314835,3
2020-04-24-170924,170924,0,0,0,27,1.0,0.17334369,4
2020-04-25-170924,170924,0,0,0,27,0.2,0.059405535,5
2020-04-26-170924,170924,0,0,0,27,0.0,0.0057072896,6
2020-04-27-170924,170924,0,0,0,27,0.2,0.04281901,0
2020-04-28-170924,170924,2,0,3,29,0.2,0.15859371,1
2020-04-29-170924,170924,0,0,3,29,0.6,0.14643656,2
2020-04-30-170924,170924,0,0,2,29,0.2,0.057623807,3
2020-05-01-170924,170924,0,0,0,29,0.0,0.006531899,4
2020-05-02-170924,170924,0,0,0,29,0.0,0.0034552636,5
2020-05-03-170924,170924,0,0,0,29,0.0,0.006852327,6
2020-05-04-170924,170924,0,0,0,29,0.0,0.03712355,0
2020-05-05-170924,170924,0,0,0,29,0.0,0.020989705,1
2020-05-06-170924,170924,0,0,0,29,1.0,0.27381206,2
2020-05-07-170924,170924,0,0,0,29,0.6,0.26641282,3
2020-05-08-170924,170924,0,0,1,29,0.8,0.18043102,4
2020-05-09-170924,170924,0,0,0,29,0.2,0.030918011,5
2020-05-10-170924,170924,0,0,0,29,0.2,0.03373828,6
2020-05-11-170924,170924,0,0,1,29,1.0,0.1540657,0
2020-05-12-170924,170924,3,1,0,32,0.2,0.21728048,1
2020-05-13-170924,170924,3,0,0,35,0.4,0.23149149,2
2020-05-14-170924,170924,2,0,1,37,0.2,0.14824887,3
2020-05-15-170924,170924,0,0,1,37,0.0,0.014163857,4
2020-05-16-170924,170924,0,0,0,37,0.0,0.0038343638,5
2020-05-17-170924,170924,0,0,0,37,0.0,0.0004098556,6
2020-05-18-170924,170924,0,1,2,37,0.8,0.19157787,0
2020-05-19-170924,170924,0,0,0,37,0.2,0.065776885,1
2020-05-20-170924,170924,0,0,0,37,0.4,0.0828084,2
2020-05-21-170924,170924,0,0,0,37,0.0,0.0149496775,3
2020-05-22-170924,170924,1,0,0,38,0.2,0.109934665,4
2020-05-23-170924,170924,0,1,0,38,0.0,3.7357775e-05,5
2020-05-24-170924,170924,0,0,0,38,0.0,0.0032690116,6
2020-05-25-170924,170924,1,1,0,39,0.0,0.095423326,0
2020-05-26-170924,170924,0,0,0,39,0.2,0.0218258,1
2020-05-27-170924,170924,0,1,1,39,0.0,0.017201928,2
2020-05-28-170924,170924,1,0,0,40,0.6,0.19700962,3
2020-05-29-170924,170924,1,0,0,41,0.2,0.10442007,4
2020-05-30-170924,170924,0,0,0,41,0.0,0.009874104,5
2020-05-31-170924,170924,0,0,0,41,0.4,0.078109935,6
2020-06-01-170924,170924,2,0,0,43,0.6,0.27748278,0
2020-06-02-170924,170924,0,0,0,43,0.2,0.053636607,1
2020-06-03-170924,170924,0,0,0,43,0.2,0.08448907,2
2020-06-04-170924,170924,0,0,0,43,0.0,0.019703047,3
2020-06-05-170924,170924,0,0,0,43,0.2,0.05473584,4
2020-06-06-170924,170924,0,0,0,43,0.0,0.0014851376,5
2020-06-07-170924,170924,0,0,0,43,0.0,0.0037228104,6
2020-06-08-170924,170924,0,0,0,43,0.4,0.0822378,0
2020-06-09-170924,170924,0,0,0,43,0.8,0.10518217,1
2020-06-10-170924,170924,1,0,0,44,0.4,0.13505848,2
2020-06-11-170924,170924,0,0,0,44,0.0,0.03444893,3
2020-06-12-170924,170924,0,0,0,44,0.0,0.02608421,4
2020-06-13-170924,170924,0,0,0,44,0.0,0.0041642375,5
2020-06-14-170924,170924,0,1,0,44,0.2,0.049718913,6
2020-06-15-170924,170924,0,1,0,44,0.0,0.023633515,0
2020-06-16-170924,170924,0,0,0,44,0.2,0.045578167,1
2020-06-17-170924,170924,0,0,0,44,0.0,0.024948504,2
2020-06-18-170924,170924,0,0,0,44,0.0,0.021288922,3
2020-06-19-170924,170924,0,0,0,44,0.0,0.023494655,4
2020-06-20-170924,170924,0,0,0,44,0.0,0.005775065,5
2020-06-21-170924,170924,0,0,0,44,0.0,0.0006586871,6
2020-06-22-170924,170924,0,0,0,44,0.0,0.011312466,0
2020-06-23-170924,170924,0,0,0,44,0.2,0.05980166,1
2020-06-24-170924,170924,0,0,0,44,0.0,0.021946229,2
2020-06-25-170924,170924,0,0,0,44,0.0,0.013135985,3
2020-06-26-170924,170924,0,0,0,44,0.0,0.017100828,4
2020-06-27-170924,170924,0,0,0,44,0.0,0.0042042937,5
2020-06-28-170924,170924,0,0,0,44,0.0,1.0837134e-06,6
2020-06-29-170924,170924,0,0,0,44,0.2,0.05595889,0
2020-06-30-170924,170924,0,0,0,44,0.2,0.083779454,1
2020-07-01-170924,170924,0,0,0,44,0.0,0.017731892,2
2020-07-02-170924,170924,0,0,0,44,0.0,0.0060835946,3
2020-07-03-170924,170924,0,0,0,44,0.0,0.0048634913,4
2020-07-04-170924,170924,0,0,0,44,0.0,0.00031468624,5
2020-07-05-170924,170924,0,0,0,44,0.2,0.034866337,6
2020-07-06-170924,170924,0,0,0,44,0.2,0.052544497,0
2020-07-07-170924,170924,0,0,1,44,0.0,0.0009834726,1
2020-07-08-170924,170924,0,1,0,44,0.0,0.014792459,2
2020-07-09-170924,170924,0,0,0,44,0.0,0.0046780417,3
2020-07-10-170924,170924,0,0,0,44,0.0,0.046211973,4
2020-07-11-170924,170924,0,0,0,44,0.2,0.034399267,5
2020-07-12-170924,170924,0,0,0,44,0.0,0.00024781236,6
2020-07-13-170924,170924,0,0,0,44,0.0,0.006478271,0
2020-07-14-170924,170924,0,0,0,44,0.0,0.005976478,1
2020-07-15-170924,170924,0,0,0,44,0.0,0.019290198,2
2020-07-16-170924,170924,0,0,0,44,0.4,0.041911818,3
2020-07-17-170924,170924,0,0,0,44,0.2,0.072099015,4
2020-07-18-170924,170924,0,0,0,44,0.0,0.00024327914,5
2020-07-19-170924,170924,0,0,0,44,0.2,0.046994735,6
2020-07-20-170924,170924,0,0,0,44,0.0,0.009972424,0
2020-07-21-170924,170924,1,0,0,45,0.6,0.19044904,1
2020-07-22-170924,170924,0,0,0,45,0.2,0.007902159,2
2020-07-23-170924,170924,0,0,0,45,1.6,0.24797165,3
2020-07-24-170924,170924,0,0,0,45,0.0,0.008699995,4
2020-07-25-170924,170924,0,0,0,45,0.0,0.001416342,5
2020-07-26-170924,170924,0,0,0,45,0.0,0.0006565856,6
2020-07-27-170924,170924,0,0,0,45,0.2,0.02202596,0
2020-07-28-170924,170924,0,0,0,45,0.4,0.069841795,1
2020-07-29-170924,170924,0,0,0,45,0.0,0.020998143,2
2020-07-30-170924,170924,0,0,0,45,0.4,0.027229033,3
2020-07-31-170924,170924,0,0,0,45,0.4,0.050939392,4
2020-08-01-170924,170924,0,0,0,45,0.0,0.0023743059,5
2020-08-02-170924,170924,0,0,0,45,0.0,0.026654413,6
2020-08-03-170924,170924,0,1,0,45,0.2,0.10050834,0
2020-08-04-170924,170924,0,0,0,45,0.0,0.008667818,1
2020-08-05-170924,170924,0,0,0,45,0.2,0.04231102,2
2020-08-06-170924,170924,0,0,1,45,0.0,0.030491002,3
2020-08-07-170924,170924,0,0,0,45,0.6,0.19909109,4
2020-08-08-170924,170924,0,0,0,45,0.0,0.007983607,5
2020-08-09-170924,170924,0,0,0,45,0.4,0.11498144,6
2020-08-10-170924,170924,0,0,0,45,0.2,0.02467323,0
2020-08-11-170924,170924,0,0,0,45,1.0,0.19168866,1
2020-08-12-170924,170924,0,0,0,45,0.2,0.1092021,2
2020-08-13-170924,170924,0,0,0,45,0.4,0.06145685,3
2020-08-14-170924,170924,0,0,0,45,0.4,0.18217626,4
2020-08-15-170924,170924,0,0,0,45,0.0,0.01642619,5
2020-08-16-170924,170924,0,0,0,45,0.4,0.12141193,6
2020-08-17-170924,170924,0,0,1,45,1.8,0.31389865,0
2020-08-18-170924,170924,0,0,1,45,0.4,0.13719925,1
2020-08-19-170924,170924,0,0,0,45,0.4,0.19291252,2
2020-08-20-170924,170924,1,0,0,46,0.6,0.27491406,3
2020-08-21-170924,170924,0,0,3,46,1.0,0.08637449,4
2020-08-22-170924,170924,0,0,0,46,0.6,0.12920372,5
2020-08-23-170924,170924,0,0,0,46,0.0,0.018655466,6
2020-08-24-170924,170924,0,0,0,46,0.6,0.22004446,0
2020-08-25-170924,170924,0,0,0,46,1.4,0.40757352,1
2020-08-26-170924,170924,0,0,0,46,0.8,0.3451773,2
2020-08-27-170924,170924,0,0,0,46,1.4,0.41014203,3
2020-08-28-170924,170924,0,0,0,46,0.6,0.17137033,4
2020-08-29-170924,170924,0,0,2,46,0.0,0.15483412,5
2020-08-30-170924,170924,0,0,1,46,0.8,0.16605832,6
2020-08-31-170924,170924,1,0,3,47,0.8,0.2752648,0
2020-09-01-170924,170924,1,0,0,48,0.8,0.30945143,1
2020-09-02-170924,170924,0,0,0,48,0.8,0.2241824,2
2020-09-03-170924,170924,0,0,1,48,0.6,0.19371776,3
2020-09-04-170924,170924,3,0,0,51,1.4,0.19810216,4
2020-09-05-170924,170924,0,0,0,51,0.0,0.0350449,5
2020-09-06-170924,170924,0,0,0,51,0.0,0.023630004,6
2020-09-07-170924,170924,0,0,1,51,2.4,0.6585212,0
2020-09-08-170924,170924,0,0,0,51,0.6,0.39324826,1
2020-09-09-170924,170924,0,0,0,51,0.8,0.24056228,2
2020-09-10-170924,170924,0,0,0,51,0.4,0.14762907,3
2020-09-11-170924,170924,0,0,1,51,0.8,0.26659223,4
2020-09-12-170924,170924,2,0,0,53,0.8,0.36465883,5
2020-09-13-170924,170924,1,0,0,54,0.0,0.10799196,6
2020-09-14-170924,170924,3,0,0,57,0.0,0.30053362,0
2020-09-15-170924,170924,0,0,0,57,0.4,0.1461784,1
2020-09-16-170924,170924,0,0,0,57,0.2,0.1463147,2
2020-09-17-170924,170924,1,0,0,58,0.4,0.8065802,3
2020-09-18-170924,170924,0,0,0,58,1.2,0.33645687,4
2020-09-19-170924,170924,0,0,0,58,0.2,0.08896907,5
2020-09-20-170924,170924,0,0,0,58,0.4,0.08178065,6
2020-09-21-170924,170924,1,1,1,59,0.8,0.19578314,0
2020-09-22-170924,170924,0,0,0,59,3.0,0.6449528,1
2020-09-23-170924,170924,0,0,0,59,3.6,0.5948238,2
2020-09-24-170924,170924,0,0,0,59,1.0,0.32037562,3
2020-09-25-170924,170924,1,0,0,60,9.4,1.6370199,4
2020-09-26-170924,170924,0,0,0,60,1.0,0.23236671,5
2020-09-27-170924,170924,0,0,0,60,0.8,0.75519395,6
2020-09-28-170924,170924,0,0,0,60,0.2,0.0874458,0
2020-09-29-170924,170924,0,0,0,60,1.2,0.18957494,1
2020-09-30-170924,170924,0,0,0,60,2.0,0.34763733,2
2020-10-01-170924,170924,0,0,0,60,1.0,0.23326659,3
2020-10-02-170924,170924,0,0,0,60,2.2,0.8013591,4
2020-10-03-170924,170924,0,1,0,60,0.4,0.12295896,5
2020-10-04-170924,170924,0,0,1,60,0.8,0.12571079,6
2020-10-05-170924,170924,1,0,1,61,0.8,0.18394393,0
2020-10-06-170924,170924,0,0,0,61,2.2,0.36886373,1
2020-10-07-170924,170924,0,0,2,61,2.8,0.5648301,2
2020-10-08-170924,170924,0,0,0,61,5.2,1.1530796,3
2020-10-09-170924,170924,0,0,7,61,2.4,0.5270124,4
2020-10-10-170924,170924,0,0,1,61,3.2,0.59567326,5
2020-10-11-170924,170924,0,0,9,61,4.0,0.77938163,6
2020-10-12-170924,170924,0,0,2,61,1.6,0.329883,0
2020-10-13-170924,170924,0,0,2,61,2.8,0.8311937,1
2020-10-14-170924,170924,0,0,1,61,1.8,0.77158767,2
2020-10-15-170924,170924,0,0,4,61,4.6,1.5141453,3
2020-10-16-170924,170924,0,0,1,61,4.8,0.88678175,4
2020-10-17-170924,170924,0,0,1,61,4.8,1.0941412,5
2020-10-18-170924,170924,1,0,1,62,3.0,0.84269947,6
2020-10-19-170924,170924,1,0,0,63,9.2,1.8399997,0
2020-10-20-170924,170924,0,0,7,63,5.8,1.1475531,1
2020-10-21-170924,170924,2,0,0,65,15.0,2.9769466,2
2020-10-22-170924,170924,0,0,2,65,9.0,2.0182025,3
2020-10-23-170924,170924,7,0,1,72,8.8,2.6417007,4
2020-10-24-170924,170924,1,0,0,73,1.0,0.29911277,5
2020-10-25-170924,170924,9,0,1,82,2.2,0.67075604,6
2020-10-26-170924,170924,2,0,0,84,4.4,1.0677514,0
2020-10-27-170924,170924,2,0,1,86,3.2,0.82542783,1
2020-10-28-170924,170924,1,0,1,87,5.2,1.3224139,2
2020-10-29-170924,170924,4,0,3,91,2.8,0.84739053,3
2020-10-30-170924,170924,1,1,5,92,5.0,1.5246263,4
2020-10-31-170924,170924,1,0,0,93,1.2,0.44137323,5
2020-11-01-170924,170924,1,0,0,94,0.0,0.2681594,6
2020-11-02-170924,170924,0,0,0,94,0.8,0.1918595,0
2020-11-03-170924,170924,7,0,0,101,3.4,1.2157482,1
2020-11-04-170924,170924,0,0,0,101,3.4,1.0107757,2
2020-11-05-170924,170924,2,0,0,103,4.0,1.0644237,3
2020-11-06-170924,170924,1,0,0,104,3.8,0.95466185,4
2020-11-07-170924,170924,0,0,0,104,1.2,0.3254324,5
2020-11-08-170924,170924,1,0,0,105,0.6,0.122794785,6
2020-11-09-170924,170924,0,0,0,105,2.2,0.510999,0
2020-11-10-170924,170924,1,0,0,106,2.0,0.38278,1
2020-11-11-170924,170924,1,0,0,107,1.6,0.5323613,2
2020-11-12-170924,170924,3,0,0,110,2.0,0.64444405,3
2020-11-13-170924,170924,5,0,0,115,0.8,0.67005473,4
2020-03-01-170925,170925,0,0,1,0,0.0,0.00019112215,6
2020-03-02-170925,170925,0,0,0,0,0.0,0.00046546714,0
2020-03-03-170925,170925,0,0,1,0,0.0,4.1518337e-08,1
2020-03-04-170925,170925,0,1,0,0,0.0,0.0077823917,2
2020-03-05-170925,170925,0,0,1,0,0.0,0.00032009667,3
2020-03-06-170925,170925,0,0,0,0,0.0,0.00069168076,4
2020-03-07-170925,170925,0,0,0,0,0.0,0.0005207551,5
2020-03-08-170925,170925,0,0,2,0,0.0,0.00022180479,6
2020-03-09-170925,170925,0,0,2,0,0.0,0.007817433,0
2020-03-10-170925,170925,0,0,1,0,0.16666666666666666,0.02599356,1
2020-03-11-170925,170925,1,0,0,1,0.0,0.11990769,2
2020-03-12-170925,170925,0,0,2,1,0.0,0.0052423673,3
2020-03-13-170925,170925,0,0,0,1,0.3333333333333333,0.03381851,4
2020-03-14-170925,170925,0,0,0,1,0.0,0.0019171939,5
2020-03-15-170925,170925,1,0,0,2,0.5,0.0848847,6
2020-03-16-170925,170925,0,0,0,2,1.1666666666666667,0.2973016,0
2020-03-17-170925,170925,1,0,0,3,0.6666666666666666,0.16393055,1
2020-03-18-170925,170925,0,2,1,3,1.0,0.13314907,2
2020-03-19-170925,170925,1,0,1,4,0.6666666666666666,0.23136614,3
2020-03-20-170925,170925,0,0,0,4,3.1666666666666665,0.23736209,4
2020-03-21-170925,170925,0,0,1,4,1.1666666666666667,0.13668704,5
2020-03-22-170925,170925,2,1,0,6,1.0,0.15305355,6
2020-03-23-170925,170925,2,0,0,8,3.5,0.41849822,0
2020-03-24-170925,170925,1,0,0,9,2.1666666666666665,0.46262562,1
2020-03-25-170925,170925,0,0,0,9,2.5,0.5066035,2
2020-03-26-170925,170925,2,0,0,11,2.0,0.4108539,3
2020-03-27-170925,170925,0,0,0,11,2.1666666666666665,0.3153699,4
2020-03-28-170925,170925,0,0,0,11,0.3333333333333333,0.020733535,5
2020-03-29-170925,170925,0,0,0,11,0.8333333333333334,0.046386678,6
2020-03-30-170925,170925,0,0,1,11,1.8333333333333333,0.11831667,0
2020-03-31-170925,170925,0,1,0,11,1.8333333333333333,0.15160398,1
2020-04-01-170925,170925,1,0,0,12,1.6666666666666667,0.28539553,2
2020-04-02-170925,170925,1,0,1,13,0.5,0.1424189,3
2020-04-03-170925,170925,0,0,1,13,1.5,0.25862005,4
2020-04-04-170925,170925,1,0,1,14,1.0,0.13408718,5
2020-04-05-170925,170925,0,0,0,14,0.8333333333333334,0.07608765,6
2020-04-06-170925,170925,0,1,0,14,1.1666666666666667,0.22627471,0
2020-04-07-170925,170925,0,0,0,14,2.333333333333333,0.34490275,1
2020-04-08-170925,170925,0,0,1,14,1.3333333333333333,0.10149857,2
2020-04-09-170925,170925,0,0,0,14,0.16666666666666666,0.04130423,3
2020-04-10-170925,170925,0,0,1,14,0.8333333333333334,0.09634745,4
2020-04-11-170925,170925,0,0,1,14,0.5,0.029415613,5
2020-04-12-170925,170925,0,1,0,14,0.5,0.071337245,6
2020-04-13-170925,170925,1,1,0,15,1.6666666666666667,0.5537377,0
2020-04-14-170925,170925,0,0,1,15,1.5,0.34459698,1
2020-04-15-170925,170925,0,0,0,15,0.8333333333333334,0.08508134,2
2020-04-16-170925,170925,1,0,0,16,0.8333333333333334,0.1899782,3
2020-04-17-170925,170925,1,0,0,17,1.1666666666666667,0.28814387,4
2020-04-18-170925,170925,1,0,0,18,0.0,0.0713743,5
2020-04-19-170925,170925,0,1,0,18,0.16666666666666666,0.013588785,6
2020-04-20-170925,170925,0,0,0,18,0.8333333333333334,0.12414163,0
2020-04-21-170925,170925,0,0,0,18,3.1666666666666665,0.53479666,1
2020-04-22-170925,170925,1,0,0,19,0.5,0.18357731,2
2020-04-23-170925,170925,0,0,1,19,0.16666666666666666,0.008345859,3
2020-04-24-170925,170925,1,0,0,20,0.3333333333333333,0.35464093,4
2020-04-25-170925,170925,1,0,0,21,0.3333333333333333,0.119653314,5
2020-04-26-170925,170925,0,0,1,21,0.16666666666666666,0.011900476,6
2020-04-27-170925,170925,0,0,1,21,0.0,0.03512455,0
2020-04-28-170925,170925,1,0,0,22,0.6666666666666666,0.21020392,1
2020-04-29-170925,170925,0,0,0,22,0.6666666666666666,0.112301365,2
2020-04-30-170925,170925,0,0,0,22,0.16666666666666666,0.040299084,3
2020-05-01-170925,170925,0,0,0,22,0.0,0.0045682266,4
2020-05-02-170925,170925,0,0,0,22,0.0,0.0011080424,5
2020-05-03-170925,170925,0,0,0,22,0.0,0.01225053,6
2020-05-04-170925,170925,0,0,1,22,0.16666666666666666,0.011823642,0
2020-05-05-170925,170925,0,0,0,22,0.0,0.030595917,1
2020-05-06-170925,170925,0,0,0,22,1.1666666666666667,0.22464126,2
2020-05-07-170925,170925,1,0,0,23,0.6666666666666666,0.282702,3
2020-05-08-170925,170925,0,0,0,23,0.5,0.09643577,4
2020-05-09-170925,170925,0,0,0,23,0.3333333333333333,0.021428632,5
2020-05-10-170925,170925,1,1,0,24,0.0,0.0851386,6
2020-05-11-170925,170925,1,0,0,25,0.5,0.18007894,0
2020-05-12-170925,170925,0,0,1,25,0.8333333333333334,0.16123734,1
2020-05-13-170925,170925,0,0,0,25,0.8333333333333334,0.24923794,2
2020-05-14-170925,170925,0,0,0,25,0.5,0.12365912,3
2020-05-15-170925,170925,0,0,0,25,0.16666666666666666,0.022937987,4
2020-05-16-170925,170925,0,1,0,25,0.0,0.0062210234,5
2020-05-17-170925,170925,0,0,1,25,0.0,0.0029713616,6
2020-05-18-170925,170925,1,0,0,26,0.3333333333333333,0.25933847,0
2020-05-19-170925,170925,0,0,0,26,0.0,0.05522915,1
2020-05-20-170925,170925,0,0,0,26,0.3333333333333333,0.12569192,2
2020-05-21-170925,170925,0,0,0,26,0.0,0.02480386,3
2020-05-22-170925,170925,0,0,0,26,0.3333333333333333,0.15950844,4
2020-05-23-170925,170925,0,0,0,26,0.16666666666666666,0.011471582,5
2020-05-24-170925,170925,0,0,0,26,0.0,0.0014140494,6
2020-05-25-170925,170925,0,0,0,26,0.16666666666666666,0.068833895,0
2020-05-26-170925,170925,1,0,1,27,0.16666666666666666,0.026019106,1
2020-05-27-170925,170925,0,0,0,27,0.3333333333333333,0.054109033,2
2020-05-28-170925,170925,0,3,0,27,0.6666666666666666,0.20031449,3
2020-05-29-170925,170925,0,0,0,27,0.5,0.16646212,4
2020-05-30-170925,170925,0,1,0,27,0.0,0.009428299,5
2020-05-31-170925,170925,1,0,1,28,0.16666666666666666,0.18813998,6
2020-06-01-170925,170925,0,0,0,28,0.8333333333333334,0.1907791,0
2020-06-02-170925,170925,0,0,0,28,0.3333333333333333,0.039354168,1
2020-06-03-170925,170925,0,0,0,28,0.16666666666666666,0.04524147,2
2020-06-04-170925,170925,0,0,0,28,0.0,0.015952699,3
2020-06-05-170925,170925,0,0,0,28,0.3333333333333333,0.03998044,4
2020-06-06-170925,170925,0,0,0,28,0.0,0.0010325746,5
2020-06-07-170925,170925,0,0,0,28,0.0,0.0013172629,6
2020-06-08-170925,170925,0,0,0,28,0.3333333333333333,0.14129968,0
2020-06-09-170925,170925,1,0,0,29,0.16666666666666666,0.1544639,1
2020-06-10-170925,170925,0,0,0,29,0.5,0.11371144,2
2020-06-11-170925,170925,0,0,0,29,0.0,0.03425227,3
2020-06-12-170925,170925,0,0,0,29,0.0,0.023814773,4
2020-06-13-170925,170925,0,0,0,29,0.16666666666666666,0.0031115836,5
2020-06-14-170925,170925,1,0,0,30,0.0,0.12684882,6
2020-06-15-170925,170925,0,0,0,30,0.16666666666666666,0.033024333,0
2020-06-16-170925,170925,0,2,0,30,0.0,0.018881127,1
2020-06-17-170925,170925,0,0,0,30,0.0,0.014062885,2
2020-06-18-170925,170925,0,0,0,30,0.0,0.0112572415,3
2020-06-19-170925,170925,0,0,0,30,0.0,0.01205486,4
2020-06-20-170925,170925,0,0,0,30,0.0,0.0026827273,5
2020-06-21-170925,170925,0,0,0,30,0.0,0.00067124225,6
2020-06-22-170925,170925,0,0,0,30,0.0,0.012916301,0
2020-06-23-170925,170925,0,0,0,30,0.3333333333333333,0.13222472,1
2020-06-24-170925,170925,0,0,0,30,0.0,0.025875047,2
2020-06-25-170925,170925,0,3,0,30,0.0,0.03375681,3
2020-06-26-170925,170925,0,0,0,30,0.3333333333333333,0.03202955,4
2020-06-27-170925,170925,0,0,0,30,0.0,0.004349094,5
2020-06-28-170925,170925,0,0,0,30,0.0,5.479565e-07,6
2020-06-29-170925,170925,0,0,0,30,0.16666666666666666,0.04846811,0
2020-06-30-170925,170925,0,0,0,30,0.3333333333333333,0.08285436,1
2020-07-01-170925,170925,0,0,0,30,0.0,0.023069153,2
2020-07-02-170925,170925,0,0,0,30,0.0,0.008328956,3
2020-07-03-170925,170925,0,0,1,30,0.3333333333333333,0.030802611,4
2020-07-04-170925,170925,0,0,0,30,0.0,0.0007317889,5
2020-07-05-170925,170925,0,0,0,30,0.0,0.011469423,6
2020-07-06-170925,170925,0,0,0,30,0.16666666666666666,0.11990355,0
2020-07-07-170925,170925,0,0,0,30,0.0,0.004935681,1
2020-07-08-170925,170925,0,1,0,30,0.0,0.03397646,2
2020-07-09-170925,170925,0,0,0,30,0.0,0.008150711,3
2020-07-10-170925,170925,0,0,0,30,0.3333333333333333,0.057261523,4
2020-07-11-170925,170925,0,0,0,30,0.16666666666666666,0.110294074,5
2020-07-12-170925,170925,0,0,0,30,0.0,0.00024398189,6
2020-07-13-170925,170925,0,0,0,30,0.0,0.0032891054,0
2020-07-14-170925,170925,0,0,0,30,0.0,0.012198589,1
2020-07-15-170925,170925,0,0,0,30,0.0,0.026535705,2
2020-07-16-170925,170925,0,0,0,30,0.3333333333333333,0.120717056,3
2020-07-17-170925,170925,1,0,0,31,0.0,0.15596904,4
2020-07-18-170925,170925,0,0,0,31,0.0,0.0005655784,5
2020-07-19-170925,170925,0,0,0,31,0.16666666666666666,0.123993926,6
2020-07-20-170925,170925,0,0,0,31,0.16666666666666666,0.012549166,0
2020-07-21-170925,170925,0,0,0,31,0.3333333333333333,0.2046696,1
2020-07-22-170925,170925,0,0,0,31,0.16666666666666666,0.0054767393,2
2020-07-23-170925,170925,0,0,0,31,0.0,0.09503239,3
2020-07-24-170925,170925,0,0,0,31,0.0,0.010168194,4
2020-07-25-170925,170925,0,0,0,31,0.0,0.0005129938,5
2020-07-26-170925,170925,0,0,0,31,0.0,0.000980434,6
2020-07-27-170925,170925,0,0,0,31,0.3333333333333333,0.01954414,0
2020-07-28-170925,170925,0,0,0,31,0.6666666666666666,0.12931912,1
2020-07-29-170925,170925,0,0,0,31,0.0,0.013706841,2
2020-07-30-170925,170925,0,0,0,31,0.3333333333333333,0.014552387,3
2020-07-31-170925,170925,0,0,0,31,0.3333333333333333,0.023715287,4
2020-08-01-170925,170925,0,0,0,31,0.0,0.002923136,5
2020-08-02-170925,170925,0,0,0,31,0.16666666666666666,0.041476004,6
2020-08-03-170925,170925,0,0,1,31,0.0,0.06230997,0
2020-08-04-170925,170925,0,0,0,31,0.0,0.020470614,1
2020-08-05-170925,170925,0,0,0,31,0.16666666666666666,0.045163322,2
2020-08-06-170925,170925,0,0,0,31,0.16666666666666666,0.043114446,3
2020-08-07-170925,170925,0,0,0,31,0.16666666666666666,0.09727291,4
2020-08-08-170925,170925,0,0,0,31,0.0,0.016312094,5
2020-08-09-170925,170925,0,0,0,31,0.0,0.05984963,6
2020-08-10-170925,170925,0,0,0,31,0.5,0.06670079,0
2020-08-11-170925,170925,0,0,0,31,0.6666666666666666,0.2537471,1
2020-08-12-170925,170925,0,0,0,31,0.16666666666666666,0.15047063,2
2020-08-13-170925,170925,0,0,0,31,0.5,0.06625754,3
2020-08-14-170925,170925,0,0,0,31,0.5,0.12601107,4
2020-08-15-170925,170925,0,0,0,31,0.0,0.034155633,5
2020-08-16-170925,170925,0,0,1,31,0.6666666666666666,0.069095604,6
2020-08-17-170925,170925,1,0,0,32,1.5,0.29813057,0
2020-08-18-170925,170925,0,0,0,32,0.3333333333333333,0.0966849,1
2020-08-19-170925,170925,0,0,0,32,0.6666666666666666,0.17483339,2
2020-08-20-170925,170925,0,0,0,32,0.6666666666666666,0.2076963,3
2020-08-21-170925,170925,0,0,0,32,1.8333333333333333,0.31901184,4
2020-08-22-170925,170925,0,0,0,32,0.3333333333333333,0.24240619,5
2020-08-23-170925,170925,0,0,0,32,0.0,0.026567735,6
2020-08-24-170925,170925,0,0,0,32,1.0,0.34935433,0
2020-08-25-170925,170925,0,0,0,32,1.6666666666666667,0.6872318,1
2020-08-26-170925,170925,0,1,0,32,1.1666666666666667,0.29669842,2
2020-08-27-170925,170925,0,0,0,32,2.1666666666666665,0.5054892,3
2020-08-28-170925,170925,0,0,0,32,0.8333333333333334,0.15615846,4
2020-08-29-170925,170925,0,0,0,32,0.8333333333333334,0.16593602,5
2020-08-30-170925,170925,1,0,0,33,0.3333333333333333,0.19016245,6
2020-08-31-170925,170925,0,0,0,33,1.3333333333333333,0.22230667,0
2020-09-01-170925,170925,0,0,0,33,1.3333333333333333,0.22172171,1
2020-09-02-170925,170925,0,0,0,33,0.6666666666666666,0.28149107,2
2020-09-03-170925,170925,0,0,0,33,0.8333333333333334,0.24088813,3
2020-09-04-170925,170925,0,0,1,33,2.0,0.2840883,4
2020-09-05-170925,170925,0,0,0,33,0.16666666666666666,0.038040146,5
2020-09-06-170925,170925,0,0,0,33,0.0,0.019818207,6
2020-09-07-170925,170925,0,0,0,33,2.1666666666666665,0.69972175,0
2020-09-08-170925,170925,0,0,0,33,0.5,0.66578966,1
2020-09-09-170925,170925,0,0,0,33,2.5,0.40426308,2
2020-09-10-170925,170925,0,0,0,33,0.5,0.20688738,3
2020-09-11-170925,170925,0,0,0,33,0.6666666666666666,0.5448058,4
2020-09-12-170925,170925,0,0,0,33,1.1666666666666667,0.22677583,5
2020-09-13-170925,170925,0,0,0,33,0.3333333333333333,0.0964068,6
2020-09-14-170925,170925,0,0,0,33,0.5,0.26823786,0
2020-09-15-170925,170925,0,0,0,33,0.5,0.20932901,1
2020-09-16-170925,170925,0,0,0,33,0.3333333333333333,0.15377615,2
2020-09-17-170925,170925,0,0,0,33,0.5,0.6879445,3
2020-09-18-170925,170925,1,0,0,34,0.6666666666666666,0.48537144,4
2020-09-19-170925,170925,0,0,0,34,0.0,0.07179764,5
2020-09-20-170925,170925,0,0,0,34,0.16666666666666666,0.12069415,6
2020-09-21-170925,170925,0,0,0,34,1.3333333333333333,0.37756664,0
2020-09-22-170925,170925,0,0,0,34,2.5,0.4862522,1
2020-09-23-170925,170925,0,0,0,34,2.333333333333333,0.7350667,2
2020-09-24-170925,170925,0,0,0,34,0.5,0.4734304,3
2020-09-25-170925,170925,0,0,0,34,8.0,4.409713,4
2020-09-26-170925,170925,0,0,0,34,0.6666666666666666,0.21567485,5
2020-09-27-170925,170925,0,0,2,34,0.3333333333333333,0.36941522,6
2020-09-28-170925,170925,0,0,5,34,0.3333333333333333,0.09770435,0
2020-09-29-170925,170925,0,0,2,34,0.3333333333333333,0.20209506,1
2020-09-30-170925,170925,0,0,3,34,1.6666666666666667,0.5622042,2
2020-10-01-170925,170925,0,0,3,34,0.6666666666666666,0.28952718,3
2020-10-02-170925,170925,0,0,2,34,0.8333333333333334,0.4579914,4
2020-10-03-170925,170925,0,0,7,34,0.16666666666666666,0.10178498,5
2020-10-04-170925,170925,0,0,3,34,0.6666666666666666,0.27632424,6
2020-10-05-170925,170925,0,0,8,34,0.6666666666666666,0.21442229,0
2020-10-06-170925,170925,0,0,1,34,0.6666666666666666,0.27983737,1
2020-10-07-170925,170925,0,0,17,34,1.3333333333333333,0.79335433,2
2020-10-08-170925,170925,0,0,4,34,1.6666666666666667,0.95828557,3
2020-10-09-170925,170925,0,1,1,34,0.6666666666666666,0.4360486,4
2020-10-10-170925,170925,0,0,0,34,0.6666666666666666,0.4750346,5
2020-10-11-170925,170925,2,0,5,36,1.5,0.52332234,6
2020-10-12-170925,170925,5,0,0,41,0.6666666666666666,0.59370464,0
2020-10-13-170925,170925,2,0,1,43,1.6666666666666667,0.98246247,1
2020-10-14-170925,170925,3,0,0,46,5.833333333333332,0.7477013,2
2020-10-15-170925,170925,3,0,0,49,1.1666666666666667,1.555368,3
2020-10-16-170925,170925,2,0,1,51,1.5,0.8709215,4
2020-10-17-170925,170925,7,0,2,58,1.1666666666666667,1.1441301,5
2020-10-18-170925,170925,3,0,0,61,2.0,1.1536113,6
2020-10-19-170925,170925,8,0,4,69,6.5,1.8759992,0
2020-10-20-170925,170925,1,0,3,70,3.0,0.87684906,1
2020-10-21-170925,170925,17,0,2,87,7.333333333333332,2.2376127,2
2020-10-22-170925,170925,4,0,2,91,6.833333333333332,1.5461127,3
2020-10-23-170925,170925,1,0,1,92,7.833333333333332,2.0182118,4
2020-10-24-170925,170925,0,0,0,92,1.5,0.19541237,5
2020-10-25-170925,170925,5,0,0,97,2.833333333333333,0.78693265,6
2020-10-26-170925,170925,0,0,0,97,4.333333333333333,0.6631961,0
2020-10-27-170925,170925,1,1,1,98,3.0,0.60263157,1
2020-10-28-170925,170925,0,0,2,98,6.166666666666668,0.76683927,2
2020-10-29-170925,170925,0,0,5,98,3.8333333333333335,0.8255316,3
2020-10-30-170925,170925,1,0,0,99,4.666666666666667,1.2627221,4
2020-10-31-170925,170925,2,0,0,101,1.3333333333333333,0.41572034,5
2020-11-01-170925,170925,0,0,0,101,0.8333333333333334,0.3251058,6
2020-11-02-170925,170925,4,0,0,105,0.3333333333333333,0.37116352,0
2020-11-03-170925,170925,3,0,0,108,3.1666666666666665,1.0506085,1
2020-11-04-170925,170925,2,0,0,110,3.8333333333333335,1.0358579,2
2020-11-05-170925,170925,2,0,0,112,3.333333333333333,1.0092529,3
2020-11-06-170925,170925,1,0,0,113,3.5,1.0980802,4
2020-11-07-170925,170925,0,0,0,113,1.5,0.30020463,5
2020-11-08-170925,170925,0,1,0,113,1.3333333333333333,0.09536166,6
2020-11-09-170925,170925,0,0,0,113,2.5,0.47219798,0
2020-11-10-170925,170925,1,1,0,114,1.8333333333333333,0.51066095,1
2020-11-11-170925,170925,2,0,0,116,2.5,0.60813487,2
2020-11-12-170925,170925,5,1,0,121,2.0,0.9375233,3
2020-11-13-170925,170925,0,0,0,121,2.0,1.0076343,4
2020-03-01-170926,170926,0,0,0,0,0.0,0.0057858992,6
2020-03-02-170926,170926,0,0,7,0,0.14285714285714285,0.008869523,0
2020-03-03-170926,170926,0,0,2,0,0.0,0.0044178977,1
2020-03-04-170926,170926,0,0,4,0,0.14285714285714285,0.006955485,2
2020-03-05-170926,170926,0,0,2,0,0.14285714285714285,0.0039178077,3
2020-03-06-170926,170926,1,0,2,1,0.2857142857142857,0.042114757,4
2020-03-07-170926,170926,0,0,0,1,0.14285714285714285,0.015621855,5
2020-03-08-170926,170926,0,0,0,1,0.0,0.0026009246,6
2020-03-09-170926,170926,0,0,8,1,0.5714285714285714,0.053939123,0
2020-03-10-170926,170926,0,0,7,1,0.8571428571428571,0.06023216,1
2020-03-11-170926,170926,0,0,6,1,1.1428571428571428,0.038792904,2
2020-03-12-170926,170926,0,0,9,1,1.4285714285714286,0.051229473,3
2020-03-13-170926,170926,1,0,4,2,2.2857142857142856,0.13064155,4
2020-03-14-170926,170926,0,0,0,2,1.7142857142857142,0.03806966,5
2020-03-15-170926,170926,0,0,3,2,2.8571428571428568,0.037100576,6
2020-03-16-170926,170926,7,1,5,9,8.428571428571429,0.54384995,0
2020-03-17-170926,170926,2,0,0,11,5.7142857142857135,0.34340006,1
2020-03-18-170926,170926,4,2,4,15,13.0,0.47948325,2
2020-03-19-170926,170926,2,0,3,17,13.428571428571427,0.5592083,3
2020-03-20-170926,170926,2,0,4,19,14.0,0.60176384,4
2020-03-21-170926,170926,0,0,0,19,5.285714285714286,0.15889877,5
2020-03-22-170926,170926,0,0,1,19,4.571428571428571,0.08911359,6
2020-03-23-170926,170926,8,0,5,27,23.142857142857146,0.9446729,0
2020-03-24-170926,170926,7,1,2,34,18.571428571428573,0.65932894,1
2020-03-25-170926,170926,6,0,3,40,15.285714285714285,0.65473896,2
2020-03-26-170926,170926,9,0,2,49,13.571428571428573,0.8077752,3
2020-03-27-170926,170926,4,0,1,53,13.857142857142858,0.6893624,4
2020-03-28-170926,170926,0,0,0,53,5.142857142857143,0.14290792,5
2020-03-29-170926,170926,3,0,2,56,4.714285714285714,0.20551538,6
2020-03-30-170926,170926,5,0,1,61,16.571428571428573,0.5834068,0
2020-03-31-170926,170926,0,0,6,61,8.714285714285714,0.39400053,1
2020-04-01-170926,170926,4,0,1,65,8.428571428571429,0.5153875,2
2020-04-02-170926,170926,3,0,8,68,10.714285714285714,0.69236416,3
2020-04-03-170926,170926,4,0,4,72,7.7142857142857135,0.61067814,4
2020-04-04-170926,170926,0,0,2,72,2.7142857142857144,0.06637638,5
2020-04-05-170926,170926,1,0,0,73,4.571428571428571,0.13454586,6
2020-04-06-170926,170926,5,0,4,78,11.0,0.49921194,0
2020-04-07-170926,170926,2,0,7,80,23.57142857142857,0.78261805,1
2020-04-08-170926,170926,3,0,1,83,7.428571428571429,0.48586947,2
2020-04-09-170926,170926,2,0,0,85,6.857142857142858,0.3385415,3
2020-04-10-170926,170926,1,0,2,86,4.142857142857143,0.16751054,4
2020-04-11-170926,170926,0,0,1,86,7.7142857142857135,0.22083032,5
2020-04-12-170926,170926,2,0,1,88,2.571428571428572,0.11812913,6
2020-04-13-170926,170926,1,0,2,89,34.857142857142854,0.5843541,0
2020-04-14-170926,170926,6,0,5,95,6.142857142857142,0.43252686,1
2020-04-15-170926,170926,1,0,4,96,8.857142857142858,0.44516215,2
2020-04-16-170926,170926,8,0,0,104,5.428571428571429,0.39427522,3
2020-04-17-170926,170926,4,0,0,108,5.428571428571429,0.30334598,4
2020-04-18-170926,170926,2,0,0,110,1.5714285714285714,0.083409734,5
2020-04-19-170926,170926,0,0,0,110,0.7142857142857143,0.029879622,6
2020-04-20-170926,170926,4,0,4,114,5.571428571428571,0.30524662,0
2020-04-21-170926,170926,7,0,3,121,4.428571428571429,0.41495126,1
2020-04-22-170926,170926,1,0,7,122,4.714285714285714,0.20240714,2
2020-04-23-170926,170926,0,0,2,122,0.42857142857142855,0.00794313,3
2020-04-24-170926,170926,2,0,1,124,2.7142857142857144,0.304679,4
2020-04-25-170926,170926,1,0,0,125,0.7142857142857143,0.06131924,5
2020-04-26-170926,170926,1,0,1,126,0.5714285714285714,0.05331655,6
2020-04-27-170926,170926,2,2,0,128,3.2857142857142856,0.2701659,0
2020-04-28-170926,170926,5,0,1,133,1.8571428571428568,0.2617097,1
2020-04-29-170926,170926,4,0,4,137,4.142857142857143,0.4429383,2
2020-04-30-170926,170926,0,0,2,137,5.142857142857143,0.21186557,3
2020-05-01-170926,170926,0,0,1,137,1.0,0.02969752,4
2020-05-02-170926,170926,0,0,2,137,0.42857142857142855,0.031246647,5
2020-05-03-170926,170926,0,0,0,137,0.7142857142857143,0.027972925,6
2020-05-04-170926,170926,4,0,2,141,6.0,0.33815014,0
2020-05-05-170926,170926,3,0,2,144,4.142857142857143,0.19546263,1
2020-05-06-170926,170926,7,0,0,151,5.0,0.6913812,2
2020-05-07-170926,170926,2,0,1,153,5.285714285714286,0.39747834,3
2020-05-08-170926,170926,1,0,1,154,6.7142857142857135,0.27875927,4
2020-05-09-170926,170926,0,0,0,154,1.1428571428571428,0.06709064,5
2020-05-10-170926,170926,1,1,0,155,0.5714285714285714,0.054373775,6
2020-05-11-170926,170926,0,0,4,155,4.571428571428571,0.26139027,0
2020-05-12-170926,170926,1,1,2,156,3.2857142857142856,0.24789497,1
2020-05-13-170926,170926,4,0,2,160,1.5714285714285714,0.33248442,2
2020-05-14-170926,170926,2,0,0,162,3.1428571428571432,0.20912388,3
2020-05-15-170926,170926,1,0,4,163,2.7142857142857144,0.1352732,4
2020-05-16-170926,170926,2,0,1,165,0.2857142857142857,0.06325917,5
2020-05-17-170926,170926,0,0,0,165,0.5714285714285714,0.0064993734,6
2020-05-18-170926,170926,2,0,10,167,3.4285714285714284,0.32969746,0
2020-05-19-170926,170926,2,0,2,169,2.571428571428572,0.27341145,1
2020-05-20-170926,170926,0,0,4,169,2.4285714285714284,0.113951154,2
2020-05-21-170926,170926,1,0,1,170,2.4285714285714284,0.23332271,3
2020-05-22-170926,170926,1,0,2,171,1.0,0.2071927,4
2020-05-23-170926,170926,0,0,0,171,0.7142857142857143,0.007989172,5
2020-05-24-170926,170926,0,0,0,171,0.2857142857142857,0.015927892,6
2020-05-25-170926,170926,4,0,2,175,2.8571428571428568,0.2831036,0
2020-05-26-170926,170926,2,0,3,177,3.1428571428571432,0.1452873,1
2020-05-27-170926,170926,2,1,2,179,1.5714285714285714,0.17292637,2
2020-05-28-170926,170926,0,0,2,179,1.8571428571428568,0.24304025,3
2020-05-29-170926,170926,4,0,1,183,3.0,0.2746954,4
2020-05-30-170926,170926,1,0,0,184,0.5714285714285714,0.051989943,5
2020-05-31-170926,170926,0,0,0,184,0.5714285714285714,0.03620681,6
2020-06-01-170926,170926,10,0,2,194,2.8571428571428568,0.44616467,0
2020-06-02-170926,170926,2,0,4,196,1.7142857142857142,0.23664972,1
2020-06-03-170926,170926,4,0,1,200,1.8571428571428568,0.26797214,2
2020-06-04-170926,170926,1,0,1,201,1.7142857142857142,0.15130068,3
2020-06-05-170926,170926,2,1,1,203,1.5714285714285714,0.18598168,4
2020-06-06-170926,170926,0,0,0,203,0.0,0.007789543,5
2020-06-07-170926,170926,0,0,0,203,0.2857142857142857,0.015187312,6
2020-06-08-170926,170926,2,0,2,205,1.2857142857142858,0.26374486,0
2020-06-09-170926,170926,3,0,1,208,1.2857142857142858,0.3223241,1
2020-06-10-170926,170926,2,0,0,210,1.2857142857142858,0.3067236,2
2020-06-11-170926,170926,2,0,1,212,1.1428571428571428,0.23101708,3
2020-06-12-170926,170926,1,0,0,213,2.142857142857143,0.21231133,4
2020-06-13-170926,170926,0,0,0,213,0.42857142857142855,0.027081858,5
2020-06-14-170926,170926,0,0,0,213,0.14285714285714285,0.00716086,6
2020-06-15-170926,170926,2,0,0,215,1.2857142857142858,0.22274128,0
2020-06-16-170926,170926,4,0,0,219,2.2857142857142856,0.3521566,1
2020-06-17-170926,170926,1,0,2,220,1.2857142857142858,0.20834333,2
2020-06-18-170926,170926,1,0,1,221,1.7142857142857142,0.20250267,3
2020-06-19-170926,170926,1,0,0,222,1.1428571428571428,0.23360573,4
2020-06-20-170926,170926,0,0,0,222,0.14285714285714285,0.045795042,5
2020-06-21-170926,170926,0,0,0,222,0.0,0.007679267,6
2020-06-22-170926,170926,2,0,0,224,1.0,0.17250973,0
2020-06-23-170926,170926,1,0,1,225,1.5714285714285714,0.19393654,1
2020-06-24-170926,170926,0,0,0,225,1.2857142857142858,0.104572475,2
2020-06-25-170926,170926,1,0,1,226,0.8571428571428571,0.120468,3
2020-06-26-170926,170926,0,0,0,226,1.1428571428571428,0.105392575,4
2020-06-27-170926,170926,0,0,0,226,0.14285714285714285,0.04296815,5
2020-06-28-170926,170926,0,0,0,226,0.14285714285714285,0.010670821,6
2020-06-29-170926,170926,0,0,0,226,1.8571428571428568,0.22200052,0
2020-06-30-170926,170926,0,0,1,226,0.5714285714285714,0.10271653,1
2020-07-01-170926,170926,2,0,0,228,0.2857142857142857,0.12149972,2
2020-07-02-170926,170926,1,0,0,229,0.7142857142857143,0.08837207,3
2020-07-03-170926,170926,0,0,1,229,0.5714285714285714,0.084439255,4
2020-07-04-170926,170926,0,0,0,229,0.14285714285714285,0.016728152,5
2020-07-05-170926,170926,0,0,0,229,0.0,0.07624644,6
2020-07-06-170926,170926,0,0,0,229,0.7142857142857143,0.14516515,0
2020-07-07-170926,170926,1,0,2,230,0.5714285714285714,0.044419594,1
2020-07-08-170926,170926,0,0,1,230,0.2857142857142857,0.038850468,2
2020-07-09-170926,170926,1,0,0,231,0.5714285714285714,0.051484644,3
2020-07-10-170926,170926,0,0,0,231,0.5714285714285714,0.10566346,4
2020-07-11-170926,170926,0,0,0,231,0.2857142857142857,0.031927355,5
2020-07-12-170926,170926,0,0,0,231,0.0,0.008241088,6
2020-07-13-170926,170926,0,0,1,231,0.7142857142857143,0.0856483,0
2020-07-14-170926,170926,1,0,0,232,0.14285714285714285,0.08088805,1
2020-07-15-170926,170926,0,0,0,232,0.8571428571428571,0.07846055,2
2020-07-16-170926,170926,0,0,0,232,0.42857142857142855,0.065416574,3
2020-07-17-170926,170926,1,0,1,233,0.8571428571428571,0.16120383,4
2020-07-18-170926,170926,0,0,0,233,0.0,0.009982679,5
2020-07-19-170926,170926,0,0,0,233,0.0,0.016441708,6
2020-07-20-170926,170926,0,0,0,233,0.5714285714285714,0.085514,0
2020-07-21-170926,170926,2,0,1,235,0.7142857142857143,0.31717467,1
2020-07-22-170926,170926,1,0,0,236,0.42857142857142855,0.07417794,2
2020-07-23-170926,170926,0,0,1,236,0.42857142857142855,0.4204968,3
2020-07-24-170926,170926,0,0,1,236,0.2857142857142857,0.123127535,4
2020-07-25-170926,170926,0,0,2,236,0.14285714285714285,0.02040125,5
2020-07-26-170926,170926,0,0,0,236,0.2857142857142857,0.0020171374,6
2020-07-27-170926,170926,1,0,4,237,0.8571428571428571,0.263637,0
2020-07-28-170926,170926,0,0,1,237,1.0,0.12714326,1
2020-07-29-170926,170926,0,0,0,237,0.7142857142857143,0.15118484,2
2020-07-30-170926,170926,0,0,2,237,1.0,0.22153121,3
2020-07-31-170926,170926,1,0,0,238,0.2857142857142857,0.20567624,4
2020-08-01-170926,170926,0,0,0,238,0.0,0.04841127,5
2020-08-02-170926,170926,0,0,0,238,0.42857142857142855,0.08800528,6
2020-08-03-170926,170926,0,0,2,238,1.0,0.18159507,0
2020-08-04-170926,170926,1,0,1,239,0.7142857142857143,0.15087521,1
2020-08-05-170926,170926,0,0,1,239,2.4285714285714284,0.40065014,2
2020-08-06-170926,170926,1,0,7,240,0.5714285714285714,0.14195192,3
2020-08-07-170926,170926,1,0,1,241,0.5714285714285714,0.26001713,4
2020-08-08-170926,170926,2,0,1,243,1.4285714285714286,0.17872764,5
2020-08-09-170926,170926,0,0,0,243,0.2857142857142857,0.04776676,6
2020-08-10-170926,170926,4,1,4,247,0.8571428571428571,0.26176214,0
2020-08-11-170926,170926,1,0,3,248,2.571428571428572,0.4657797,1
2020-08-12-170926,170926,0,2,0,248,1.8571428571428568,0.20914066,2
2020-08-13-170926,170926,2,1,3,250,1.4285714285714286,0.4403448,3
2020-08-14-170926,170926,0,0,13,250,2.8571428571428568,0.4002491,4
2020-08-15-170926,170926,0,0,0,250,2.0,0.107495606,5
2020-08-16-170926,170926,0,0,0,250,0.7142857142857143,0.08018499,6
2020-08-17-170926,170926,2,0,0,252,2.571428571428572,0.4730819,0
2020-08-18-170926,170926,1,0,0,253,3.7142857142857135,0.46160078,1
2020-08-19-170926,170926,1,0,9,254,3.0,0.57186574,2
2020-08-20-170926,170926,7,0,3,261,4.142857142857143,0.76711017,3
2020-08-21-170926,170926,1,0,5,262,2.4285714285714284,0.48750952,4
2020-08-22-170926,170926,1,0,0,263,1.5714285714285714,0.30021808,5
2020-08-23-170926,170926,0,0,3,263,1.2857142857142858,0.09553188,6
2020-08-24-170926,170926,4,0,4,267,3.571428571428572,0.76153564,0
2020-08-25-170926,170926,3,0,3,270,8.142857142857142,0.9651338,1
2020-08-26-170926,170926,0,0,2,270,6.7142857142857135,0.8452582,2
2020-08-27-170926,170926,3,0,0,273,6.7142857142857135,0.84060323,3
2020-08-28-170926,170926,13,0,11,286,5.285714285714286,0.99498475,4
2020-08-29-170926,170926,0,0,0,286,2.571428571428572,0.55728024,5
2020-08-30-170926,170926,0,0,0,286,3.2857142857142856,0.3579611,6
2020-08-31-170926,170926,0,0,3,286,6.0,0.49685943,0
2020-09-01-170926,170926,0,0,2,286,4.142857142857143,0.49853685,1
2020-09-02-170926,170926,9,0,7,295,7.428571428571429,0.7713971,2
2020-09-03-170926,170926,3,0,25,298,4.285714285714286,0.57037723,3
2020-09-04-170926,170926,5,0,2,303,7.571428571428571,0.5977886,4
2020-09-05-170926,170926,0,0,1,303,2.0,0.41486567,5
2020-09-06-170926,170926,3,0,0,306,2.571428571428572,0.3411451,6
2020-09-07-170926,170926,4,0,7,310,8.571428571428571,1.034856,0
2020-09-08-170926,170926,3,0,7,313,3.4285714285714284,0.6022132,1
2020-09-09-170926,170926,2,1,2,315,4.857142857142857,0.5922216,2
2020-09-10-170926,170926,0,0,5,315,4.285714285714286,0.7921756,3
2020-09-11-170926,170926,11,0,5,326,5.428571428571429,0.93637353,4
2020-09-12-170926,170926,0,0,4,326,1.7142857142857142,0.6479296,5
2020-09-13-170926,170926,0,0,0,326,2.0,0.13477252,6
2020-09-14-170926,170926,3,0,6,329,9.714285714285714,1.1100738,0
2020-09-15-170926,170926,2,0,3,331,4.714285714285714,0.8848985,1
2020-09-16-170926,170926,7,0,0,338,8.714285714285714,1.0430477,2
2020-09-17-170926,170926,25,0,10,363,8.714285714285714,1.577337,3
2020-09-18-170926,170926,2,0,7,365,6.428571428571429,1.6372293,4
2020-09-19-170926,170926,1,0,1,366,3.571428571428572,1.2589295,5
2020-09-20-170926,170926,0,0,0,366,1.8571428571428568,0.235894,6
2020-09-21-170926,170926,7,1,13,373,7.2857142857142865,0.8030424,0
2020-09-22-170926,170926,7,0,4,380,8.285714285714286,0.8595104,1
2020-09-23-170926,170926,2,0,5,382,7.2857142857142865,0.89780915,2
2020-09-24-170926,170926,5,1,34,387,7.0,1.5108818,3
2020-09-25-170926,170926,5,0,2,392,7.0,1.5106909,4
2020-09-26-170926,170926,4,0,3,396,2.4285714285714284,1.297802,5
2020-09-27-170926,170926,0,0,1,396,3.0,0.31086585,6
2020-09-28-170926,170926,6,1,1,402,6.428571428571429,0.6215137,0
2020-09-29-170926,170926,3,0,6,405,5.142857142857143,0.58404505,1
2020-09-30-170926,170926,0,0,8,405,4.857142857142857,0.6040284,2
2020-10-01-170926,170926,10,1,1,415,6.142857142857142,0.9923889,3
2020-10-02-170926,170926,7,1,6,422,5.857142857142858,1.4581898,4
2020-10-03-170926,170926,1,1,2,423,2.7142857142857144,0.9464316,5
2020-10-04-170926,170926,0,0,0,423,1.4285714285714286,0.10760686,6
2020-10-05-170926,170926,13,0,3,436,7.2857142857142865,0.80167294,0
2020-10-06-170926,170926,4,1,5,440,8.857142857142858,1.3116546,1
2020-10-07-170926,170926,5,1,8,445,5.428571428571429,1.2309214,2
2020-10-08-170926,170926,34,0,3,479,8.428571428571429,2.4426496,3
2020-10-09-170926,170926,2,1,10,481,7.0,1.7948735,4
2020-10-10-170926,170926,3,0,1,484,2.7142857142857144,1.0304301,5
2020-10-11-170926,170926,1,0,2,485,2.7142857142857144,0.9776841,6
2020-10-12-170926,170926,1,0,12,486,1.7142857142857142,0.20097977,0
2020-10-13-170926,170926,6,0,10,492,8.142857142857142,0.9346267,1
2020-10-14-170926,170926,8,0,16,500,9.857142857142858,1.1467403,2
2020-10-15-170926,170926,1,0,2,501,6.7142857142857135,1.1257175,3
2020-10-16-170926,170926,6,0,13,507,9.142857142857142,1.4220934,4
2020-10-17-170926,170926,2,0,2,509,3.4285714285714284,1.1016798,5
2020-10-18-170926,170926,0,2,1,509,3.7142857142857135,0.51412106,6
2020-10-19-170926,170926,3,2,0,512,11.857142857142858,1.0326113,0
2020-10-20-170926,170926,5,0,5,517,13.142857142857142,1.564345,1
2020-10-21-170926,170926,8,0,11,525,17.571428571428573,1.7247981,2
2020-10-22-170926,170926,3,1,12,528,15.571428571428573,1.4810715,3
2020-10-23-170926,170926,10,3,17,538,22.142857142857146,2.3928463,4
2020-10-24-170926,170926,1,3,4,539,4.571428571428571,0.8908932,5
2020-10-25-170926,170926,2,1,0,541,3.4285714285714284,0.463816,6
2020-10-26-170926,170926,12,1,11,553,17.714285714285715,1.6139605,0
2020-10-27-170926,170926,10,2,8,563,16.285714285714285,1.7196783,1
2020-10-28-170926,170926,16,0,15,579,18.857142857142858,1.9482305,2
2020-10-29-170926,170926,2,1,3,581,19.285714285714285,1.6913482,3
2020-10-30-170926,170926,13,0,7,594,24.857142857142854,2.2427988,4
2020-10-31-170926,170926,2,0,0,596,6.0,1.1789379,5
2020-11-01-170926,170926,1,0,0,597,4.714285714285714,0.33330494,6
2020-11-02-170926,170926,0,0,0,597,2.571428571428572,0.6945887,0
2020-11-03-170926,170926,5,0,0,602,16.142857142857142,1.4721729,1
2020-11-04-170926,170926,11,0,0,613,16.857142857142858,2.0699768,2
2020-11-05-170926,170926,12,0,0,625,21.428571428571427,2.2889988,3
2020-11-06-170926,170926,17,2,0,642,23.0,1.947664,4
2020-11-07-170926,170926,4,1,0,646,4.857142857142857,0.6714295,5
2020-11-08-170926,170926,0,0,0,646,3.4285714285714284,0.17609818,6
2020-11-09-170926,170926,11,0,0,657,17.714285714285715,0.8940317,0
2020-11-10-170926,170926,8,0,0,665,13.428571428571427,1.0616997,1
2020-11-11-170926,170926,15,0,0,680,15.571428571428573,1.2428837,2
2020-11-12-170926,170926,3,0,0,683,12.571428571428573,1.7174708,3
2020-11-13-170926,170926,7,2,0,690,17.0,1.0037231,4
2020-03-01-170927,170927,0,0,3,0,0.0,0.010578741,6
2020-03-02-170927,170927,0,0,2,0,0.0,0.022244666,0
2020-03-03-170927,170927,0,1,11,0,0.0,0.008714436,1
2020-03-04-170927,170927,0,0,11,0,0.2222222222222222,0.0029924633,2
2020-03-05-170927,170927,0,0,19,0,0.1111111111111111,0.022806393,3
2020-03-06-170927,170927,0,0,23,0,0.2222222222222222,0.058823854,4
2020-03-07-170927,170927,0,0,1,0,0.3333333333333333,0.009277635,5
2020-03-08-170927,170927,0,0,4,0,0.3333333333333333,0.006093156,6
2020-03-09-170927,170927,0,0,24,0,0.3333333333333333,0.1546182,0
2020-03-10-170927,170927,1,0,18,1,0.2222222222222222,0.06005056,1
2020-03-11-170927,170927,0,0,18,1,0.3333333333333333,0.066363886,2
2020-03-12-170927,170927,1,0,24,2,0.5555555555555556,0.08654379,3
2020-03-13-170927,170927,0,0,24,2,2.333333333333333,0.41171747,4
2020-03-14-170927,170927,1,0,2,3,0.7777777777777778,0.05930686,5
2020-03-15-170927,170927,3,0,2,6,1.7777777777777777,0.19579792,6
2020-03-16-170927,170927,2,0,30,8,8.11111111111111,1.3868624,0
2020-03-17-170927,170927,11,0,14,19,7.333333333333332,0.9922873,1
2020-03-18-170927,170927,11,0,17,30,10.777777777777779,1.2799033,2
2020-03-19-170927,170927,19,0,21,49,11.222222222222221,1.8893167,3
2020-03-20-170927,170927,23,0,27,72,11.333333333333336,1.5458915,4
2020-03-21-170927,170927,1,0,6,73,4.222222222222221,0.27411348,5
2020-03-22-170927,170927,4,0,2,77,5.777777777777778,0.3719563,6
2020-03-23-170927,170927,24,0,20,101,19.444444444444443,2.2613263,0
2020-03-24-170927,170927,18,0,14,119,17.88888888888889,1.4509567,1
2020-03-25-170927,170927,18,0,13,137,17.11111111111111,1.0831103,2
2020-03-26-170927,170927,24,0,6,161,16.11111111111111,1.6074303,3
2020-03-27-170927,170927,24,0,12,185,13.777777777777779,1.4731797,4
2020-03-28-170927,170927,2,0,3,187,3.2222222222222223,0.218476,5
2020-03-29-170927,170927,2,0,4,189,3.888888888888889,0.12410481,6
2020-03-30-170927,170927,30,0,13,219,15.777777777777779,0.9777078,0
2020-03-31-170927,170927,14,0,13,233,8.666666666666666,0.7393052,1
2020-04-01-170927,170927,17,0,21,250,10.555555555555557,1.0480158,2
2020-04-02-170927,170927,21,0,6,271,7.777777777777778,1.1161673,3
2020-04-03-170927,170927,27,0,6,298,10.333333333333334,2.84204,4
2020-04-04-170927,170927,6,0,1,304,2.333333333333333,0.16821377,5
2020-04-05-170927,170927,2,0,2,306,1.5555555555555556,0.056519166,6
2020-04-06-170927,170927,20,0,9,326,12.111111111111109,1.323328,0
2020-04-07-170927,170927,14,2,12,340,7.666666666666668,1.4705981,1
2020-04-08-170927,170927,13,1,7,353,7.666666666666668,1.161604,2
2020-04-09-170927,170927,6,2,0,359,6.333333333333332,1.0315282,3
2020-04-10-170927,170927,12,0,6,371,4.777777777777779,0.42057037,4
2020-04-11-170927,170927,3,0,0,374,2.4444444444444446,0.2096386,5
2020-04-12-170927,170927,4,0,1,378,2.333333333333333,0.55114585,6
2020-04-13-170927,170927,13,0,7,391,10.777777777777779,1.060538,0
2020-04-14-170927,170927,13,0,3,404,7.5555555555555545,0.8199128,1
2020-04-15-170927,170927,21,0,8,425,7.5555555555555545,0.98395103,2
2020-04-16-170927,170927,6,0,12,431,6.5555555555555545,0.6544878,3
2020-04-17-170927,170927,6,0,1,437,4.222222222222221,0.6552272,4
2020-04-18-170927,170927,1,0,0,438,1.4444444444444444,0.047071524,5
2020-04-19-170927,170927,2,0,1,440,0.7777777777777778,0.022823457,6
2020-04-20-170927,170927,9,0,11,449,4.777777777777779,0.90923905,0
2020-04-21-170927,170927,12,0,3,461,4.4444444444444455,0.39829582,1
2020-04-22-170927,170927,7,0,8,468,6.111111111111112,0.45813116,2
2020-04-23-170927,170927,0,0,8,468,0.3333333333333333,0.018817944,3
2020-04-24-170927,170927,6,0,6,474,4.0,0.5879496,4
2020-04-25-170927,170927,0,0,1,474,0.4444444444444444,0.02086749,5
2020-04-26-170927,170927,1,0,1,475,0.5555555555555556,0.10054951,6
2020-04-27-170927,170927,7,1,6,482,4.888888888888889,0.71986336,0
2020-04-28-170927,170927,3,0,4,485,4.222222222222221,0.601135,1
2020-04-29-170927,170927,8,0,1,493,4.111111111111111,0.67630136,2
2020-04-30-170927,170927,12,0,4,505,4.222222222222221,0.6136871,3
2020-05-01-170927,170927,1,0,4,506,0.7777777777777778,0.13409248,4
2020-05-02-170927,170927,0,0,0,506,0.3333333333333333,0.17395847,5
2020-05-03-170927,170927,1,0,0,507,0.1111111111111111,0.014548831,6
2020-05-04-170927,170927,11,0,6,518,4.666666666666667,0.5016612,0
2020-05-05-170927,170927,3,0,4,521,6.0,0.58095527,1
2020-05-06-170927,170927,8,0,9,529,4.333333333333333,0.8957693,2
2020-05-07-170927,170927,8,0,4,537,4.777777777777779,0.58289576,3
2020-05-08-170927,170927,6,0,3,543,5.5555555555555545,0.7838676,4
2020-05-09-170927,170927,1,0,0,544,0.2222222222222222,0.15328334,5
2020-05-10-170927,170927,1,1,0,545,0.4444444444444444,0.07046928,6
2020-05-11-170927,170927,6,0,6,551,3.555555555555556,0.7584051,0
2020-05-12-170927,170927,4,0,2,555,3.111111111111111,0.490989,1
2020-05-13-170927,170927,1,0,5,556,1.2222222222222223,0.74324995,2
2020-05-14-170927,170927,4,1,4,560,3.888888888888889,0.7384898,3
2020-05-15-170927,170927,4,0,1,564,2.6666666666666665,0.43289587,4
2020-05-16-170927,170927,0,0,0,564,0.0,0.017690983,5
2020-05-17-170927,170927,0,0,0,564,0.0,0.0069520925,6
2020-05-18-170927,170927,6,0,1,570,3.333333333333333,0.5452765,0
2020-05-19-170927,170927,4,0,2,574,3.555555555555556,0.45037037,1
2020-05-20-170927,170927,9,0,1,583,3.888888888888889,0.683095,2
2020-05-21-170927,170927,4,0,3,587,2.555555555555556,0.66888845,3
2020-05-22-170927,170927,3,0,5,590,3.111111111111111,0.58772624,4
2020-05-23-170927,170927,0,0,0,590,0.3333333333333333,0.009112347,5
2020-05-24-170927,170927,0,0,0,590,0.2222222222222222,0.012379609,6
2020-05-25-170927,170927,6,0,2,596,3.555555555555556,0.46598002,0
2020-05-26-170927,170927,2,0,0,598,2.888888888888889,0.26860046,1
2020-05-27-170927,170927,5,1,4,603,2.555555555555556,0.33713913,2
2020-05-28-170927,170927,4,0,2,607,1.5555555555555556,0.3591908,3
2020-05-29-170927,170927,1,1,4,608,3.555555555555556,0.45923173,4
2020-05-30-170927,170927,0,0,1,608,0.0,0.02966363,5
2020-05-31-170927,170927,0,0,0,608,0.1111111111111111,0.045233335,6
2020-06-01-170927,170927,1,0,2,609,3.6666666666666665,0.67946446,0
2020-06-02-170927,170927,2,1,1,611,3.0,0.42762086,1
2020-06-03-170927,170927,1,0,1,612,3.2222222222222223,0.3885011,2
2020-06-04-170927,170927,3,0,1,615,2.4444444444444446,0.3600065,3
2020-06-05-170927,170927,5,0,3,620,2.555555555555556,0.16809852,4
2020-06-06-170927,170927,0,0,0,620,0.2222222222222222,0.013916964,5
2020-06-07-170927,170927,0,0,0,620,0.2222222222222222,0.019059608,6
2020-06-08-170927,170927,2,0,0,622,1.6666666666666667,0.4219173,0
2020-06-09-170927,170927,0,0,1,622,2.1111111111111107,0.3698739,1
2020-06-10-170927,170927,4,0,2,626,1.7777777777777777,0.7476518,2
2020-06-11-170927,170927,2,0,1,628,1.7777777777777777,0.59739655,3
2020-06-12-170927,170927,4,0,1,632,0.7777777777777778,0.22897418,4
2020-06-13-170927,170927,1,0,0,633,0.0,0.014763007,5
2020-06-14-170927,170927,0,0,0,633,0.2222222222222222,0.011357201,6
2020-06-15-170927,170927,2,0,1,635,2.0,0.55243236,0
2020-06-16-170927,170927,1,0,0,636,2.2222222222222223,0.624937,1
2020-06-17-170927,170927,1,0,2,637,1.5555555555555556,0.46293187,2
2020-06-18-170927,170927,1,0,1,638,1.5555555555555556,0.40774915,3
2020-06-19-170927,170927,3,0,1,641,1.5555555555555556,0.61276233,4
2020-06-20-170927,170927,0,0,0,641,0.3333333333333333,0.11247584,5
2020-06-21-170927,170927,0,0,0,641,0.1111111111111111,0.014189201,6
2020-06-22-170927,170927,0,0,0,641,1.8888888888888888,0.24796586,0
2020-06-23-170927,170927,1,0,0,642,1.5555555555555556,0.46878248,1
2020-06-24-170927,170927,2,1,0,644,1.1111111111111112,0.12354351,2
2020-06-25-170927,170927,1,1,2,645,1.1111111111111112,0.14065059,3
2020-06-26-170927,170927,1,0,4,646,2.2222222222222223,0.19174159,4
2020-06-27-170927,170927,0,0,1,646,0.2222222222222222,0.081705764,5
2020-06-28-170927,170927,0,0,0,646,0.2222222222222222,0.08237716,6
2020-06-29-170927,170927,1,1,0,647,1.4444444444444444,0.3548893,0
2020-06-30-170927,170927,0,0,2,647,0.6666666666666666,0.20840624,1
2020-07-01-170927,170927,2,0,0,649,0.5555555555555556,0.20536797,2
2020-07-02-170927,170927,1,0,0,650,0.2222222222222222,0.0910567,3
2020-07-03-170927,170927,1,0,0,651,0.6666666666666666,0.2730397,4
2020-07-04-170927,170927,0,0,0,651,0.4444444444444444,0.021594455,5
2020-07-05-170927,170927,0,0,0,651,0.1111111111111111,0.021243684,6
2020-07-06-170927,170927,0,0,0,651,0.5555555555555556,0.27658692,0
2020-07-07-170927,170927,0,0,0,651,0.6666666666666666,0.23268393,1
2020-07-08-170927,170927,0,0,3,651,1.2222222222222223,0.10605299,2
2020-07-09-170927,170927,2,0,2,653,0.7777777777777778,0.061845593,3
2020-07-10-170927,170927,4,0,2,657,0.5555555555555556,0.2091475,4
2020-07-11-170927,170927,1,0,0,658,1.0,0.012743298,5
2020-07-12-170927,170927,0,0,0,658,0.6666666666666666,0.07668105,6
2020-07-13-170927,170927,0,0,0,658,1.0,0.25826243,0
2020-07-14-170927,170927,2,0,0,660,0.4444444444444444,0.08604395,1
2020-07-15-170927,170927,0,0,1,660,1.2222222222222223,0.13177167,2
2020-07-16-170927,170927,0,0,2,660,1.3333333333333333,0.077679805,3
2020-07-17-170927,170927,0,0,2,660,0.8888888888888888,0.42272195,4
2020-07-18-170927,170927,0,0,1,660,0.4444444444444444,0.0059050685,5
2020-07-19-170927,170927,0,0,0,660,0.1111111111111111,0.04514072,6
2020-07-20-170927,170927,0,0,0,660,0.8888888888888888,0.2063749,0
2020-07-21-170927,170927,0,0,1,660,0.8888888888888888,0.3733039,1
2020-07-22-170927,170927,3,0,1,663,0.7777777777777778,0.09536425,2
2020-07-23-170927,170927,2,0,3,665,0.7777777777777778,0.37308717,3
2020-07-24-170927,170927,2,0,3,667,1.3333333333333333,0.24306658,4
2020-07-25-170927,170927,0,0,1,667,0.1111111111111111,0.067143865,5
2020-07-26-170927,170927,0,0,0,667,0.0,0.013638234,6
2020-07-27-170927,170927,0,0,3,667,1.6666666666666667,0.595948,0
2020-07-28-170927,170927,0,0,1,667,1.0,0.15229107,1
2020-07-29-170927,170927,1,0,0,668,1.0,0.24719577,2
2020-07-30-170927,170927,2,0,4,670,2.333333333333333,0.2917028,3
2020-07-31-170927,170927,2,0,1,672,1.2222222222222223,0.33374092,4
2020-08-01-170927,170927,1,0,0,673,1.1111111111111112,0.037251003,5
2020-08-02-170927,170927,0,0,2,673,0.5555555555555556,0.10820089,6
2020-08-03-170927,170927,0,0,10,673,0.7777777777777778,0.27804717,0
2020-08-04-170927,170927,1,0,3,674,1.3333333333333333,0.23037504,1
2020-08-05-170927,170927,1,0,4,675,2.888888888888889,0.47485098,2
2020-08-06-170927,170927,3,0,8,678,1.6666666666666667,0.19876823,3
2020-08-07-170927,170927,3,0,3,681,2.6666666666666665,0.19631286,4
2020-08-08-170927,170927,1,0,1,682,2.888888888888889,0.27926442,5
2020-08-09-170927,170927,0,0,3,682,1.1111111111111112,0.08401709,6
2020-08-10-170927,170927,3,0,4,685,2.4444444444444446,0.19211324,0
2020-08-11-170927,170927,1,0,13,686,2.888888888888889,0.49500057,1
2020-08-12-170927,170927,0,0,15,686,2.1111111111111107,0.26502872,2
2020-08-13-170927,170927,4,0,17,690,4.777777777777779,0.4156862,3
2020-08-14-170927,170927,1,0,16,691,4.777777777777779,0.59003264,4
2020-08-15-170927,170927,0,0,2,691,2.1111111111111107,0.10677346,5
2020-08-16-170927,170927,2,0,0,693,2.888888888888889,0.12300576,6
2020-08-17-170927,170927,10,0,12,703,3.555555555555556,0.541834,0
2020-08-18-170927,170927,3,0,8,706,3.111111111111111,0.70240897,1
2020-08-19-170927,170927,4,0,14,710,4.666666666666667,0.71610504,2
2020-08-20-170927,170927,8,0,8,718,5.111111111111111,0.8781036,3
2020-08-21-170927,170927,3,0,9,721,5.333333333333333,1.267323,4
2020-08-22-170927,170927,1,0,2,722,2.333333333333333,0.34034455,5
2020-08-23-170927,170927,3,0,2,725,2.4444444444444446,0.18428184,6
2020-08-24-170927,170927,4,0,13,729,5.5555555555555545,0.9675414,0
2020-08-25-170927,170927,13,0,0,742,9.777777777777779,2.1772285,1
2020-08-26-170927,170927,15,0,10,757,7.777777777777778,1.0895177,2
2020-08-27-170927,170927,17,0,12,774,10.888888888888891,2.1893907,3
2020-08-28-170927,170927,16,0,20,790,9.666666666666666,1.8001643,4
2020-08-29-170927,170927,2,0,0,792,2.333333333333333,0.23133841,5
2020-08-30-170927,170927,0,0,1,792,2.888888888888889,0.76769066,6
2020-08-31-170927,170927,12,0,12,804,6.5555555555555545,0.72598636,0
2020-09-01-170927,170927,8,0,8,812,5.5555555555555545,0.5269273,1
2020-09-02-170927,170927,14,0,15,826,5.333333333333333,0.7496918,2
2020-09-03-170927,170927,8,0,15,834,5.333333333333333,0.89741576,3
2020-09-04-170927,170927,9,0,8,843,4.777777777777779,0.9180348,4
2020-09-05-170927,170927,2,0,2,845,2.555555555555556,0.40291804,5
2020-09-06-170927,170927,2,0,1,847,3.333333333333333,0.4008681,6
2020-09-07-170927,170927,13,0,13,860,7.4444444444444455,1.1132118,0
2020-09-08-170927,170927,0,0,3,860,2.7777777777777777,0.8969482,1
2020-09-09-170927,170927,10,0,8,870,8.555555555555555,1.4171991,2
2020-09-10-170927,170927,12,0,11,882,8.222222222222221,2.0718458,3
2020-09-11-170927,170927,20,0,20,902,7.4444444444444455,1.3830887,4
2020-09-12-170927,170927,0,0,4,902,3.555555555555556,0.5834621,5
2020-09-13-170927,170927,1,0,0,903,2.2222222222222223,0.24664783,6
2020-09-14-170927,170927,12,0,11,915,8.333333333333334,1.6143686,0
2020-09-15-170927,170927,8,0,6,923,9.555555555555557,2.276524,1
2020-09-16-170927,170927,15,0,11,938,10.888888888888891,1.7516444,2
2020-09-17-170927,170927,15,0,4,953,8.333333333333334,2.0056796,3
2020-09-18-170927,170927,8,0,13,961,8.666666666666666,2.0482197,4
2020-09-19-170927,170927,2,1,1,963,3.0,1.061256,5
2020-09-20-170927,170927,1,1,15,964,4.0,0.36823705,6
2020-09-21-170927,170927,13,0,11,977,9.444444444444443,1.4231492,0
2020-09-22-170927,170927,3,1,14,980,8.222222222222221,1.3393377,1
2020-09-23-170927,170927,8,0,4,988,9.444444444444443,1.6833242,2
2020-09-24-170927,170927,11,1,2,999,5.111111111111111,2.4099286,3
2020-09-25-170927,170927,20,0,3,1019,9.333333333333334,1.5864199,4
2020-09-26-170927,170927,4,0,0,1023,5.0,0.7661387,5
2020-09-27-170927,170927,0,0,0,1023,1.3333333333333333,0.2492843,6
2020-09-28-170927,170927,11,1,0,1034,4.666666666666667,0.763662,0
2020-09-29-170927,170927,6,1,5,1040,5.777777777777778,0.87489307,1
2020-09-30-170927,170927,11,0,6,1051,5.888888888888888,1.0941278,2
2020-10-01-170927,170927,4,0,8,1055,6.888888888888888,1.699485,3
2020-10-02-170927,170927,13,0,6,1068,8.11111111111111,1.2337213,4
2020-10-03-170927,170927,1,0,2,1069,1.7777777777777777,0.45543304,5
2020-10-04-170927,170927,15,0,0,1084,1.4444444444444444,0.19087727,6
2020-10-05-170927,170927,11,0,14,1095,7.5555555555555545,1.158683,0
2020-10-06-170927,170927,14,0,18,1109,6.5555555555555545,2.2391727,1
2020-10-07-170927,170927,4,0,16,1113,7.666666666666668,1.636944,2
2020-10-08-170927,170927,2,1,26,1115,5.222222222222221,2.104009,3
2020-10-09-170927,170927,3,3,35,1118,8.11111111111111,1.9452004,4
2020-10-10-170927,170927,0,0,2,1118,3.6666666666666665,0.689849,5
2020-10-11-170927,170927,0,0,1,1118,1.4444444444444444,0.33964816,6
2020-10-12-170927,170927,0,0,31,1118,2.333333333333333,0.45262453,0
2020-10-13-170927,170927,5,0,15,1123,7.0,2.082727,1
2020-10-14-170927,170927,6,0,29,1129,8.333333333333334,2.006294,2
2020-10-15-170927,170927,8,0,37,1137,7.0,1.7306023,3
2020-10-16-170927,170927,6,0,44,1143,9.888888888888891,2.271294,4
2020-10-17-170927,170927,2,0,4,1145,4.0,1.0462154,5
2020-10-18-170927,170927,0,0,0,1145,2.0,0.43431515,6
2020-10-19-170927,170927,14,0,6,1159,8.777777777777779,1.5012494,0
2020-10-20-170927,170927,18,0,43,1177,13.888888888888891,2.9299421,1
2020-10-21-170927,170927,16,0,25,1193,10.111111111111109,1.9434224,2
2020-10-22-170927,170927,26,0,40,1219,14.111111111111109,1.9488829,3
2020-10-23-170927,170927,35,0,33,1254,22.11111111111111,3.9116344,4
2020-10-24-170927,170927,2,1,4,1256,3.7777777777777777,0.926314,5
2020-10-25-170927,170927,1,0,3,1257,3.7777777777777777,0.30266932,6
2020-10-26-170927,170927,31,0,35,1288,16.666666666666668,3.2618861,0
2020-10-27-170927,170927,15,2,20,1303,13.222222222222221,3.0881686,1
2020-10-28-170927,170927,29,1,25,1332,17.555555555555557,3.396285,2
2020-10-29-170927,170927,37,0,24,1369,22.222222222222218,2.767186,3
2020-10-30-170927,170927,44,2,17,1413,22.0,4.8777514,4
2020-10-31-170927,170927,4,0,0,1417,8.444444444444445,1.201863,5
2020-11-01-170927,170927,0,2,0,1417,9.444444444444443,0.8062675,6
2020-11-02-170927,170927,6,1,0,1423,3.888888888888889,0.39410886,0
2020-11-03-170927,170927,43,0,0,1466,18.666666666666668,2.6140966,1
2020-11-04-170927,170927,25,1,0,1491,17.444444444444443,3.6787505,2
2020-11-05-170927,170927,40,0,0,1531,21.66666666666667,3.53383,3
2020-11-06-170927,170927,33,3,0,1564,19.222222222222218,2.8155682,4
2020-11-07-170927,170927,4,0,0,1568,8.444444444444445,0.84341544,5
2020-11-08-170927,170927,3,0,0,1571,8.333333333333334,0.51454914,6
2020-11-09-170927,170927,35,0,0,1606,12.222222222222221,1.5553552,0
2020-11-10-170927,170927,20,0,0,1626,14.0,2.3877552,1
2020-11-11-170927,170927,25,1,0,1651,12.333333333333336,2.2323825,2
2020-11-12-170927,170927,24,2,0,1675,13.777777777777779,2.266456,3
2020-11-13-170927,170927,17,1,0,1692,17.0,1.7648079,4
2020-03-01-170928,170928,0,0,3,0,0.0,0.008333108,6
2020-03-02-170928,170928,0,0,14,0,0.0,0.018593298,0
2020-03-03-170928,170928,0,0,9,0,0.0,0.0060028005,1
2020-03-04-170928,170928,0,0,10,0,0.2,0.0021042547,2
2020-03-05-170928,170928,0,0,16,0,0.0,0.018040612,3
2020-03-06-170928,170928,0,0,10,0,0.4,0.062987566,4
2020-03-07-170928,170928,0,0,4,0,0.4,0.013053668,5
2020-03-08-170928,170928,1,0,5,1,0.2,0.0040496737,6
2020-03-09-170928,170928,0,0,16,1,0.6,0.09151214,0
2020-03-10-170928,170928,0,0,19,1,0.6,0.043741602,1
2020-03-11-170928,170928,1,0,23,2,0.2,0.059131403,2
2020-03-12-170928,170928,1,0,12,3,1.2,0.07330834,3
2020-03-13-170928,170928,6,0,20,9,2.4,0.28353044,4
2020-03-14-170928,170928,2,0,3,11,1.0,0.051304027,5
2020-03-15-170928,170928,3,0,10,14,3.0,0.11231648,6
2020-03-16-170928,170928,14,0,17,28,6.2,0.835952,0
2020-03-17-170928,170928,9,0,14,37,7.2,0.6081251,1
2020-03-18-170928,170928,10,0,16,47,13.6,0.8619622,2
2020-03-19-170928,170928,16,1,7,63,12.4,1.185673,3
2020-03-20-170928,170928,10,1,5,73,14.8,0.9207971,4
2020-03-21-170928,170928,4,0,5,77,4.4,0.18184187,5
2020-03-22-170928,170928,5,0,2,82,4.2,0.20003399,6
2020-03-23-170928,170928,16,0,8,98,22.0,1.4693869,0
2020-03-24-170928,170928,19,0,7,117,18.6,0.9587977,1
2020-03-25-170928,170928,23,0,9,140,19.4,0.8183074,2
2020-03-26-170928,170928,12,0,2,152,17.6,1.0316484,3
2020-03-27-170928,170928,20,0,5,172,15.8,0.9271684,4
2020-03-28-170928,170928,3,0,2,175,18.4,0.15904182,5
2020-03-29-170928,170928,10,0,1,185,3.0,0.12430707,6
2020-03-30-170928,170928,17,0,6,202,15.0,0.69996417,0
2020-03-31-170928,170928,14,0,11,216,12.0,0.5027562,1
2020-04-01-170928,170928,16,0,10,232,12.0,0.663798,2
2020-04-02-170928,170928,7,0,13,239,10.6,0.6662486,3
2020-04-03-170928,170928,5,0,4,244,11.2,1.4263271,4
2020-04-04-170928,170928,5,0,1,249,3.2,0.10352537,5
2020-04-05-170928,170928,2,0,0,251,1.8,0.09951956,6
2020-04-06-170928,170928,8,0,5,259,12.0,0.7790285,0
2020-04-07-170928,170928,7,0,5,266,10.8,0.95769036,1
2020-04-08-170928,170928,9,0,15,275,11.0,0.6641738,2
2020-04-09-170928,170928,2,0,1,277,5.8,0.51784956,3
2020-04-10-170928,170928,5,0,4,282,9.6,0.22857124,4
2020-04-11-170928,170928,2,0,0,284,5.2,0.33059722,5
2020-04-12-170928,170928,1,0,0,285,3.2,0.27564788,6
2020-04-13-170928,170928,6,1,5,291,23.6,0.70493495,0
2020-04-14-170928,170928,11,0,8,302,18.4,0.56684524,1
2020-04-15-170928,170928,10,0,5,312,12.0,0.6165988,2
2020-04-16-170928,170928,13,0,4,325,7.2,0.4603425,3
2020-04-17-170928,170928,4,0,0,329,6.8,0.4235969,4
2020-04-18-170928,170928,1,0,0,330,1.8,0.059590064,5
2020-04-19-170928,170928,0,0,0,330,1.6,0.019407587,6
2020-04-20-170928,170928,5,0,10,335,7.8,0.5622252,0
2020-04-21-170928,170928,5,0,3,340,7.0,0.3401926,1
2020-04-22-170928,170928,15,1,6,355,7.6,0.3130198,2
2020-04-23-170928,170928,1,0,6,356,0.8,0.0132211745,3
2020-04-24-170928,170928,4,0,10,360,6.2,0.38641882,4
2020-04-25-170928,170928,0,0,0,360,0.4,0.03801059,5
2020-04-26-170928,170928,0,0,0,360,1.0,0.0753289,6
2020-04-27-170928,170928,5,0,6,365,6.2,0.45667535,0
2020-04-28-170928,170928,8,0,3,373,4.0,0.39785856,1
2020-04-29-170928,170928,5,0,0,378,4.2,0.4785873,2
2020-04-30-170928,170928,4,0,9,382,7.2,0.3908726,3
2020-05-01-170928,170928,0,1,7,382,0.8,0.058679342,4
2020-05-02-170928,170928,0,0,0,382,0.0,0.09057703,5
2020-05-03-170928,170928,0,0,0,382,0.4,0.021916345,6
2020-05-04-170928,170928,10,0,4,392,6.6,0.39442205,0
2020-05-05-170928,170928,3,0,4,395,6.6,0.39517805,1
2020-05-06-170928,170928,6,0,5,401,5.8,0.58632284,2
2020-05-07-170928,170928,6,0,0,407,7.6,0.40555257,3
2020-05-08-170928,170928,10,0,2,417,5.6,0.4749304,4
2020-05-09-170928,170928,0,0,0,417,0.2,0.09388408,5
2020-05-10-170928,170928,0,0,0,417,0.4,0.044954974,6
2020-05-11-170928,170928,6,1,6,423,5.4,0.45950213,0
2020-05-12-170928,170928,3,0,8,426,6.0,0.34185812,1
2020-05-13-170928,170928,0,0,2,426,0.8,0.42231083,2
2020-05-14-170928,170928,9,0,2,435,3.4,0.45734563,3
2020-05-15-170928,170928,7,0,2,442,5.6,0.29551497,4
2020-05-16-170928,170928,0,0,0,442,0.0,0.032723725,5
2020-05-17-170928,170928,0,0,0,442,0.0,0.009315043,6
2020-05-18-170928,170928,4,0,2,446,4.8,0.39502034,0
2020-05-19-170928,170928,4,1,2,450,4.4,0.34651816,1
2020-05-20-170928,170928,5,0,2,455,6.0,0.39205763,2
2020-05-21-170928,170928,0,0,0,455,3.2,0.42877218,3
2020-05-22-170928,170928,2,0,6,457,5.4,0.3547704,4
2020-05-23-170928,170928,0,0,0,457,0.4,0.01091216,5
2020-05-24-170928,170928,0,0,0,457,0.2,0.0076738135,6
2020-05-25-170928,170928,6,0,1,463,6.4,0.39420256,0
2020-05-26-170928,170928,8,0,4,471,3.4,0.24015674,1
2020-05-27-170928,170928,2,0,1,473,4.6,0.27967024,2
2020-05-28-170928,170928,2,3,2,475,4.4,0.3117923,3
2020-05-29-170928,170928,2,0,2,477,3.8,0.38921565,4
2020-05-30-170928,170928,0,0,0,477,0.2,0.03617686,5
2020-05-31-170928,170928,0,0,0,477,0.2,0.052874815,6
2020-06-01-170928,170928,2,0,0,479,3.6,0.50678134,0
2020-06-02-170928,170928,2,0,4,481,3.8,0.29525545,1
2020-06-03-170928,170928,2,0,2,483,2.4,0.30763295,2
2020-06-04-170928,170928,0,0,3,483,2.6,0.26246345,3
2020-06-05-170928,170928,6,0,0,489,3.4,0.15224373,4
2020-06-06-170928,170928,0,0,0,489,0.0,0.010960007,5
2020-06-07-170928,170928,0,0,0,489,0.4,0.017510382,6
2020-06-08-170928,170928,1,0,4,490,2.0,0.33817333,0
2020-06-09-170928,170928,4,1,3,494,1.2,0.29307282,1
2020-06-10-170928,170928,1,0,2,495,3.0,0.48950517,2
2020-06-11-170928,170928,2,0,0,497,1.8,0.41221687,3
2020-06-12-170928,170928,2,0,1,499,1.8,0.21539587,4
2020-06-13-170928,170928,0,1,0,499,0.2,0.027945476,5
2020-06-14-170928,170928,0,0,0,499,0.4,0.010545637,6
2020-06-15-170928,170928,0,0,1,499,2.8,0.35127795,0
2020-06-16-170928,170928,4,0,1,503,1.6,0.4614938,1
2020-06-17-170928,170928,2,0,0,505,1.6,0.3115814,2
2020-06-18-170928,170928,3,0,0,508,1.4,0.28199735,3
2020-06-19-170928,170928,0,0,0,508,2.8,0.426508,4
2020-06-20-170928,170928,0,1,0,508,0.4,0.07057689,5
2020-06-21-170928,170928,0,0,0,508,0.2,0.013310276,6
2020-06-22-170928,170928,4,0,0,512,1.6,0.19319472,0
2020-06-23-170928,170928,3,0,0,515,0.8,0.30807617,1
2020-06-24-170928,170928,2,0,2,517,1.6,0.11963296,2
2020-06-25-170928,170928,0,0,0,517,1.6,0.13828711,3
2020-06-26-170928,170928,1,0,0,518,1.0,0.15702583,4
2020-06-27-170928,170928,0,0,8,518,0.6,0.05488228,5
2020-06-28-170928,170928,0,0,5,518,0.0,0.044808295,6
2020-06-29-170928,170928,1,0,0,519,1.6,0.25060174,0
2020-06-30-170928,170928,1,0,0,520,0.8,0.14580731,1
2020-07-01-170928,170928,0,0,2,520,1.2,0.15739146,2
2020-07-02-170928,170928,0,0,1,520,0.6,0.08966371,3
2020-07-03-170928,170928,0,0,2,520,1.0,0.16815585,4
2020-07-04-170928,170928,0,0,1,520,0.6,0.018050203,5
2020-07-05-170928,170928,0,0,1,520,0.2,0.023508001,6
2020-07-06-170928,170928,0,0,1,520,0.8,0.17762645,0
2020-07-07-170928,170928,0,0,0,520,0.0,0.13065512,1
2020-07-08-170928,170928,2,0,0,522,1.0,0.080873266,2
2020-07-09-170928,170928,0,0,1,522,1.4,0.05655231,3
2020-07-10-170928,170928,0,0,0,522,1.4,0.14847067,4
2020-07-11-170928,170928,8,0,0,530,0.4,0.023682028,5
2020-07-12-170928,170928,5,0,0,535,0.0,0.03984922,6
2020-07-13-170928,170928,0,0,0,535,1.2,0.17151272,0
2020-07-14-170928,170928,0,0,1,535,1.0,0.08308044,1
2020-07-15-170928,170928,2,0,1,537,1.2,0.10499115,2
2020-07-16-170928,170928,1,0,8,538,0.6,0.07430269,3
2020-07-17-170928,170928,2,0,2,540,0.6,0.26803783,4
2020-07-18-170928,170928,1,0,7,541,0.6,0.0061529484,5
2020-07-19-170928,170928,1,0,2,542,0.2,0.03958308,6
2020-07-20-170928,170928,1,0,2,543,0.4,0.14172661,0
2020-07-21-170928,170928,0,0,2,543,0.0,0.28262243,1
2020-07-22-170928,170928,0,0,0,543,1.4,0.09025085,2
2020-07-23-170928,170928,1,0,3,544,0.8,0.27583665,3
2020-07-24-170928,170928,0,0,4,544,2.0,0.18058492,4
2020-07-25-170928,170928,0,0,14,544,0.0,0.04083195,5
2020-07-26-170928,170928,0,0,6,544,0.0,0.011147364,6
2020-07-27-170928,170928,0,0,7,544,1.2,0.40167198,0
2020-07-28-170928,170928,1,0,2,545,1.4,0.1383821,1
2020-07-29-170928,170928,1,0,3,546,1.0,0.18150799,2
2020-07-30-170928,170928,8,0,10,554,1.2,0.22464554,3
2020-07-31-170928,170928,2,0,12,556,1.0,0.22787505,4
2020-08-01-170928,170928,7,0,0,563,0.8,0.036590945,5
2020-08-02-170928,170928,2,0,8,565,0.2,0.09323449,6
2020-08-03-170928,170928,2,0,5,567,0.2,0.180126,0
2020-08-04-170928,170928,2,0,3,569,1.6,0.16646677,1
2020-08-05-170928,170928,0,0,10,569,1.2,0.3575548,2
2020-08-06-170928,170928,3,0,4,572,1.8,0.15607637,3
2020-08-07-170928,170928,4,0,4,576,1.6,0.18777402,4
2020-08-08-170928,170928,14,0,2,590,2.0,0.2029637,5
2020-08-09-170928,170928,6,0,1,596,0.8,0.08262066,6
2020-08-10-170928,170928,7,0,10,603,2.4,0.19849883,0
2020-08-11-170928,170928,2,0,17,605,3.2,0.4295878,1
2020-08-12-170928,170928,3,0,15,608,1.4,0.21461025,2
2020-08-13-170928,170928,10,0,12,618,2.8,0.3920426,3
2020-08-14-170928,170928,12,0,16,630,4.0,0.42963505,4
2020-08-15-170928,170928,0,0,1,630,1.0,0.16333045,5
2020-08-16-170928,170928,8,0,1,638,2.0,0.12131845,6
2020-08-17-170928,170928,5,0,19,643,3.4,0.4403589,0
2020-08-18-170928,170928,3,0,9,646,3.8,0.51783097,1
2020-08-19-170928,170928,10,0,16,656,4.2,0.61573035,2
2020-08-20-170928,170928,4,0,19,660,6.0,0.7422989,3
2020-08-21-170928,170928,4,0,11,664,4.0,0.8630773,4
2020-08-22-170928,170928,2,0,1,666,1.2,0.29092333,5
2020-08-23-170928,170928,1,0,5,667,2.2,0.16381025,6
2020-08-24-170928,170928,10,0,5,677,5.8,0.75364393,0
2020-08-25-170928,170928,17,0,0,694,11.6,1.4281285,1
2020-08-26-170928,170928,15,0,12,709,11.4,0.8858918,2
2020-08-27-170928,170928,12,1,9,721,15.0,1.4286082,3
2020-08-28-170928,170928,16,1,7,737,11.0,1.3564562,4
2020-08-29-170928,170928,1,0,2,738,1.6,0.28518564,5
2020-08-30-170928,170928,1,0,1,739,0.8,0.52588594,6
2020-08-31-170928,170928,19,1,11,758,10.4,0.59900475,0
2020-09-01-170928,170928,9,0,10,767,7.2,0.4634813,1
2020-09-02-170928,170928,16,0,14,783,6.6,0.73904896,2
2020-09-03-170928,170928,19,0,15,802,6.4,0.7283303,3
2020-09-04-170928,170928,11,0,8,813,8.0,0.776354,4
2020-09-05-170928,170928,1,0,3,814,0.6,0.36543334,5
2020-09-06-170928,170928,5,1,9,819,1.6,0.37336597,6
2020-09-07-170928,170928,5,0,14,824,9.0,1.0398695,0
2020-09-08-170928,170928,0,0,28,824,1.8,0.71998197,1
2020-09-09-170928,170928,12,0,11,836,9.4,1.0434728,2
2020-09-10-170928,170928,9,0,4,845,10.2,1.508195,3
2020-09-11-170928,170928,7,0,19,852,10.8,1.251451,4
2020-09-12-170928,170928,2,1,16,854,1.6,0.5060235,5
2020-09-13-170928,170928,1,0,2,855,2.0,0.271887,6
2020-09-14-170928,170928,11,0,7,866,10.8,1.2841825,0
2020-09-15-170928,170928,10,0,7,876,11.8,1.5967857,1
2020-09-16-170928,170928,14,0,9,890,13.4,1.4810086,2
2020-09-17-170928,170928,15,0,18,905,11.8,1.849697,3
2020-09-18-170928,170928,8,0,18,913,9.6,1.8191895,4
2020-09-19-170928,170928,3,0,4,916,1.6,0.95980495,5
2020-09-20-170928,170928,9,2,1,925,1.8,0.31620803,6
2020-09-21-170928,170928,14,0,21,939,12.2,1.1488024,0
2020-09-22-170928,170928,28,0,14,967,9.8,1.0939649,1
2020-09-23-170928,170928,11,1,12,978,10.0,1.332339,2
2020-09-24-170928,170928,4,1,14,982,7.6,1.8626312,3
2020-09-25-170928,170928,19,0,5,1001,16.2,1.336084,4
2020-09-26-170928,170928,16,1,1,1017,4.2,0.84953994,5
2020-09-27-170928,170928,2,0,0,1019,0.2,0.2758097,6
2020-09-28-170928,170928,7,0,0,1026,7.4,0.69752276,0
2020-09-29-170928,170928,7,1,7,1033,6.0,0.7593721,1
2020-09-30-170928,170928,9,0,5,1042,7.6,0.84613115,2
2020-10-01-170928,170928,18,0,4,1060,6.0,1.3656851,3
2020-10-02-170928,170928,18,0,9,1078,11.4,1.2745578,4
2020-10-03-170928,170928,4,0,3,1082,0.8,0.52959275,5
2020-10-04-170928,170928,1,0,6,1083,3.4,0.18048449,6
2020-10-05-170928,170928,21,0,11,1104,10.2,0.9935761,0
2020-10-06-170928,170928,14,0,12,1118,9.2,1.7759053,1
2020-10-07-170928,170928,12,0,8,1130,11.6,1.3654329,2
2020-10-08-170928,170928,14,0,20,1144,4.4,2.0314686,3
2020-10-09-170928,170928,5,0,22,1149,7.4,1.7628998,4
2020-10-10-170928,170928,1,0,0,1150,1.2,0.60177565,5
2020-10-11-170928,170928,0,0,3,1150,0.4,0.43019578,6
2020-10-12-170928,170928,0,0,20,1150,1.6,0.348196,0
2020-10-13-170928,170928,7,0,20,1157,10.8,1.4598356,1
2020-10-14-170928,170928,5,0,9,1162,9.2,1.5847994,2
2020-10-15-170928,170928,4,0,30,1166,14.0,1.3037001,3
2020-10-16-170928,170928,9,0,9,1175,8.4,1.6987987,4
2020-10-17-170928,170928,3,1,1,1178,1.8,0.86343306,5
2020-10-18-170928,170928,6,0,4,1184,2.2,0.4262588,6
2020-10-19-170928,170928,11,1,3,1195,16.8,1.2180437,0
2020-10-20-170928,170928,12,1,23,1207,21.2,2.2366884,1
2020-10-21-170928,170928,8,1,12,1215,20.6,1.6568534,2
2020-10-22-170928,170928,20,0,23,1235,26.0,1.5705845,3
2020-10-23-170928,170928,22,0,19,1257,32.0,3.038165,4
2020-10-24-170928,170928,0,0,3,1257,2.8,0.8414154,5
2020-10-25-170928,170928,3,1,3,1260,1.4,0.29949802,6
2020-10-26-170928,170928,20,0,10,1280,28.2,2.3887017,0
2020-10-27-170928,170928,20,1,8,1300,17.8,2.3247945,1
2020-10-28-170928,170928,9,3,15,1309,26.2,2.8434536,2
2020-10-29-170928,170928,30,1,13,1339,43.6,2.3999135,3
2020-10-30-170928,170928,9,0,31,1348,36.2,3.4599407,4
2020-10-31-170928,170928,1,1,0,1349,8.0,1.0776572,5
2020-11-01-170928,170928,4,1,0,1353,14.8,0.65757835,6
2020-11-02-170928,170928,3,1,0,1356,6.4,0.4532329,0
2020-11-03-170928,170928,23,1,0,1379,26.0,2.0556915,1
2020-11-04-170928,170928,12,2,0,1391,27.6,2.8023973,2
2020-11-05-170928,170928,23,0,0,1414,39.2,2.9993658,3
2020-11-06-170928,170928,19,1,0,1433,36.2,2.5290341,4
2020-11-07-170928,170928,3,0,0,1436,4.0,0.75142395,5
2020-11-08-170928,170928,3,2,0,1439,10.4,0.40492332,6
2020-11-09-170928,170928,10,0,0,1449,23.4,1.3214163,0
2020-11-10-170928,170928,8,2,0,1457,21.6,1.7890656,1
2020-11-11-170928,170928,15,3,0,1472,22.0,1.859243,2
2020-11-12-170928,170928,13,1,0,1485,21.8,1.7788087,3
2020-11-13-170928,170928,31,0,0,1516,20.4,1.5041586,4
2020-03-01-171001,171001,0,0,0,0,0.0,0.0020436,6
2020-03-02-171001,171001,0,0,7,0,0.0,0.0021453253,0
2020-03-03-171001,171001,0,0,2,0,0.4,0.0005052882,1
2020-03-04-171001,171001,0,0,4,0,0.2,0.00039506136,2
2020-03-05-171001,171001,0,1,7,0,0.0,0.0014345857,3
2020-03-06-171001,171001,0,0,2,0,0.0,0.0066645746,4
2020-03-07-171001,171001,0,0,2,0,0.0,0.0010470194,5
2020-03-08-171001,171001,0,0,6,0,0.0,0.0013438792,6
2020-03-09-171001,171001,1,0,5,1,0.4,0.01727082,0
2020-03-10-171001,171001,1,0,7,2,0.4,0.009039286,1
2020-03-11-171001,171001,0,0,4,2,1.0,0.007972313,2
2020-03-12-171001,171001,1,0,5,3,0.8,0.0121023,3
2020-03-13-171001,171001,2,0,4,5,2.2,0.0347938,4
2020-03-14-171001,171001,2,0,2,7,1.2,0.0103206355,5
2020-03-15-171001,171001,0,0,1,7,1.6,0.007327744,6
2020-03-16-171001,171001,7,0,2,14,5.6,0.092443325,0
2020-03-17-171001,171001,2,0,2,16,6.6,0.06583437,1
2020-03-18-171001,171001,4,0,4,20,12.0,0.088437244,2
2020-03-19-171001,171001,7,0,5,27,18.0,0.12763427,3
2020-03-20-171001,171001,2,0,4,29,15.4,0.10491347,4
2020-03-21-171001,171001,2,0,2,31,3.6,0.017789323,5
2020-03-22-171001,171001,6,0,1,37,4.2,0.013200397,6
2020-03-23-171001,171001,5,0,2,42,21.0,0.1587996,0
2020-03-24-171001,171001,7,0,1,49,14.0,0.091532804,1
2020-03-25-171001,171001,4,0,3,53,19.2,0.0906295,2
2020-03-26-171001,171001,5,0,9,58,16.4,0.11132481,3
2020-03-27-171001,171001,4,0,2,62,13.8,0.094476946,4
2020-03-28-171001,171001,2,0,0,64,3.8,0.019122986,5
2020-03-29-171001,171001,1,0,0,65,2.8,0.010968358,6
2020-03-30-171001,171001,2,0,5,67,11.2,0.08741826,0
2020-03-31-171001,171001,2,0,2,69,6.4,0.04775092,1
2020-04-01-171001,171001,4,0,1,73,8.8,0.07547073,2
2020-04-02-171001,171001,5,0,1,78,5.2,0.11432934,3
2020-04-03-171001,171001,4,0,1,82,14.0,0.14507587,4
2020-04-04-171001,171001,2,0,1,84,2.6,0.009109511,5
2020-04-05-171001,171001,1,0,0,85,2.2,0.009063996,6
2020-04-06-171001,171001,2,0,2,87,8.4,0.076355524,0
2020-04-07-171001,171001,1,0,1,88,9.8,0.09833982,1
2020-04-08-171001,171001,3,0,4,91,8.8,0.07605836,2
2020-04-09-171001,171001,9,0,0,100,5.6,0.048359625,3
2020-04-10-171001,171001,2,0,4,102,4.4,0.01861996,4
2020-04-11-171001,171001,0,0,1,102,1.2,0.020989839,5
2020-04-12-171001,171001,0,0,1,102,2.8,0.019835759,6
2020-04-13-171001,171001,5,0,1,107,8.2,0.076738656,0
2020-04-14-171001,171001,2,1,3,109,8.2,0.060349897,1
2020-04-15-171001,171001,1,0,1,110,5.8,0.07454906,2
2020-04-16-171001,171001,1,0,1,111,3.6,0.04574356,3
2020-04-17-171001,171001,1,0,0,112,4.8,0.03905103,4
2020-04-18-171001,171001,1,0,0,113,0.8,0.003925317,5
2020-04-19-171001,171001,0,1,0,113,0.8,0.0040225964,6
2020-04-20-171001,171001,2,0,0,115,5.8,0.05319006,0
2020-04-21-171001,171001,1,0,0,116,3.2,0.036943696,1
2020-04-22-171001,171001,4,0,2,120,4.2,0.040639233,2
2020-04-23-171001,171001,0,0,0,120,0.2,0.0021733118,3
2020-04-24-171001,171001,4,0,1,124,3.4,0.044050843,4
2020-04-25-171001,171001,1,0,0,125,0.4,0.0027398597,5
2020-04-26-171001,171001,1,0,0,126,0.4,0.0052096974,6
2020-04-27-171001,171001,1,0,2,127,4.8,0.04627501,0
2020-04-28-171001,171001,3,0,3,130,2.4,0.03601041,1
2020-04-29-171001,171001,1,0,1,131,3.0,0.05946835,2
2020-04-30-171001,171001,1,0,1,132,3.6,0.03914212,3
2020-05-01-171001,171001,0,0,3,132,0.6,0.0049852426,4
2020-05-02-171001,171001,0,0,2,132,0.8,0.0090358155,5
2020-05-03-171001,171001,0,0,0,132,0.4,0.0019406016,6
2020-05-04-171001,171001,0,0,2,132,3.2,0.037645236,0
2020-05-05-171001,171001,0,0,4,132,3.2,0.03244685,1
2020-05-06-171001,171001,2,0,1,134,3.8,0.07048975,2
2020-05-07-171001,171001,0,0,3,134,3.8,0.045988053,3
2020-05-08-171001,171001,1,0,0,135,4.6,0.0462765,4
2020-05-09-171001,171001,0,1,0,135,0.6,0.009045717,5
2020-05-10-171001,171001,0,0,0,135,0.8,0.0050425185,6
2020-05-11-171001,171001,2,0,0,137,5.0,0.047715217,0
2020-05-12-171001,171001,3,2,0,140,3.0,0.040277928,1
2020-05-13-171001,171001,1,0,0,141,2.4,0.044583686,2
2020-05-14-171001,171001,1,1,0,142,3.0,0.039909862,3
2020-05-15-171001,171001,3,1,2,145,2.4,0.0351642,4
2020-05-16-171001,171001,2,0,0,147,0.8,0.0032679182,5
2020-05-17-171001,171001,0,0,0,147,0.2,0.001018609,6
2020-05-18-171001,171001,2,0,0,149,4.0,0.052076302,0
2020-05-19-171001,171001,4,0,0,153,1.2,0.039200354,1
2020-05-20-171001,171001,1,0,0,154,2.6,0.034359496,2
2020-05-21-171001,171001,3,0,0,157,1.6,0.049605597,3
2020-05-22-171001,171001,0,0,0,157,2.2,0.044784848,4
2020-05-23-171001,171001,0,0,0,157,1.2,0.00079605624,5
2020-05-24-171001,171001,0,0,0,157,0.0,0.001153622,6
2020-05-25-171001,171001,0,0,0,157,3.2,0.049467873,0
2020-05-26-171001,171001,0,0,0,157,2.6,0.028353801,1
2020-05-27-171001,171001,0,1,0,157,1.2,0.03255452,2
2020-05-28-171001,171001,0,0,0,157,1.2,0.037179366,3
2020-05-29-171001,171001,2,1,4,159,1.8,0.042490788,4
2020-05-30-171001,171001,0,0,0,159,0.2,0.0052110236,5
2020-05-31-171001,171001,0,0,0,159,0.0,0.0065736836,6
2020-06-01-171001,171001,0,0,1,159,1.8,0.06132244,0
2020-06-02-171001,171001,0,0,1,159,3.0,0.034288347,1
2020-06-03-171001,171001,0,0,2,159,1.6,0.03434062,2
2020-06-04-171001,171001,0,0,1,159,2.0,0.03030608,3
2020-06-05-171001,171001,0,0,0,159,1.4,0.018382203,4
2020-06-06-171001,171001,0,0,0,159,0.0,0.0025593205,5
2020-06-07-171001,171001,0,0,0,159,0.0,0.001876771,6
2020-06-08-171001,171001,0,0,0,159,1.6,0.040579747,0
2020-06-09-171001,171001,0,0,0,159,0.4,0.03371624,1
2020-06-10-171001,171001,0,0,0,159,2.0,0.051797718,2
2020-06-11-171001,171001,0,0,1,159,1.6,0.04850026,3
2020-06-12-171001,171001,4,0,0,163,1.2,0.028436659,4
2020-06-13-171001,171001,0,0,0,163,0.2,0.0020634984,5
2020-06-14-171001,171001,0,0,0,163,0.0,0.002447512,6
2020-06-15-171001,171001,1,1,0,164,2.0,0.04954974,0
2020-06-16-171001,171001,1,0,0,165,3.6,0.060625833,1
2020-06-17-171001,171001,2,0,0,167,1.4,0.033188995,2
2020-06-18-171001,171001,1,0,0,168,1.2,0.035211563,3
2020-06-19-171001,171001,0,0,1,168,1.8,0.05092539,4
2020-06-20-171001,171001,0,0,0,168,0.2,0.0069328435,5
2020-06-21-171001,171001,0,0,0,168,0.0,0.0016358129,6
2020-06-22-171001,171001,0,0,0,168,0.6,0.02757511,0
2020-06-23-171001,171001,0,0,0,168,1.6,0.041797627,1
2020-06-24-171001,171001,0,1,0,168,1.0,0.012592551,2
2020-06-25-171001,171001,1,0,0,169,0.4,0.01555602,3
2020-06-26-171001,171001,0,0,0,169,2.0,0.019282002,4
2020-06-27-171001,171001,0,0,0,169,0.2,0.0070632133,5
2020-06-28-171001,171001,0,0,0,169,0.2,0.0049709817,6
2020-06-29-171001,171001,0,0,0,169,3.4,0.034207154,0
2020-06-30-171001,171001,0,0,0,169,1.2,0.016363163,1
2020-07-01-171001,171001,0,0,0,169,0.2,0.020614708,2
2020-07-02-171001,171001,0,0,0,169,0.4,0.013028567,3
2020-07-03-171001,171001,1,0,0,170,1.2,0.02093324,4
2020-07-04-171001,171001,0,0,0,170,0.0,0.0015590452,5
2020-07-05-171001,171001,0,0,0,170,0.0,0.004447942,6
2020-07-06-171001,171001,0,0,0,170,1.2,0.022599656,0
2020-07-07-171001,171001,0,0,0,170,1.0,0.020006958,1
2020-07-08-171001,171001,0,0,0,170,0.4,0.005918569,2
2020-07-09-171001,171001,0,1,0,170,0.4,0.0074438085,3
2020-07-10-171001,171001,0,0,0,170,0.6,0.019718807,4
2020-07-11-171001,171001,0,0,0,170,0.0,0.0016412432,5
2020-07-12-171001,171001,0,0,0,170,0.2,0.0046413504,6
2020-07-13-171001,171001,0,0,0,170,0.8,0.019362565,0
2020-07-14-171001,171001,0,0,0,170,0.4,0.009147789,1
2020-07-15-171001,171001,0,0,0,170,0.4,0.010282965,2
2020-07-16-171001,171001,0,0,0,170,0.4,0.010067609,3
2020-07-17-171001,171001,0,0,0,170,1.2,0.02990702,4
2020-07-18-171001,171001,0,0,0,170,0.0,0.0013042989,5
2020-07-19-171001,171001,0,0,0,170,0.2,0.0055870144,6
2020-07-20-171001,171001,0,0,0,170,0.6,0.017659644,0
2020-07-21-171001,171001,0,0,0,170,0.8,0.033589058,1
2020-07-22-171001,171001,0,0,1,170,0.0,0.009789245,2
2020-07-23-171001,171001,0,0,0,170,1.0,0.043713685,3
2020-07-24-171001,171001,0,0,0,170,0.8,0.023698373,4
2020-07-25-171001,171001,0,0,0,170,0.2,0.00527208,5
2020-07-26-171001,171001,0,0,0,170,0.0,0.001142742,6
2020-07-27-171001,171001,0,0,0,170,0.8,0.054465294,0
2020-07-28-171001,171001,0,0,0,170,0.2,0.012083189,1
2020-07-29-171001,171001,0,0,0,170,0.4,0.017418116,2
2020-07-30-171001,171001,0,0,1,170,1.6,0.029713519,3
2020-07-31-171001,171001,0,0,0,170,1.2,0.027202103,4
2020-08-01-171001,171001,0,0,0,170,0.0,0.0031632197,5
2020-08-02-171001,171001,0,0,0,170,0.2,0.009826432,6
2020-08-03-171001,171001,0,0,0,170,1.6,0.023324778,0
2020-08-04-171001,171001,0,0,3,170,0.8,0.028204793,1
2020-08-05-171001,171001,1,0,3,171,1.8,0.07322834,2
2020-08-06-171001,171001,0,0,2,171,2.0,0.02601865,3
2020-08-07-171001,171001,0,0,2,171,1.8,0.023269456,4
2020-08-08-171001,171001,0,0,0,171,1.6,0.029902223,5
2020-08-09-171001,171001,0,0,0,171,1.8,0.019204622,6
2020-08-10-171001,171001,0,0,1,171,1.2,0.035707206,0
2020-08-11-171001,171001,0,0,1,171,2.6,0.06794445,1
2020-08-12-171001,171001,0,0,2,171,3.6,0.037274763,2
2020-08-13-171001,171001,1,0,5,172,1.8,0.054574836,3
2020-08-14-171001,171001,0,0,1,172,1.4,0.06971334,4
2020-08-15-171001,171001,0,0,3,172,0.4,0.019708298,5
2020-08-16-171001,171001,0,0,0,172,3.6,0.02968159,6
2020-08-17-171001,171001,0,0,4,172,1.8,0.054929182,0
2020-08-18-171001,171001,3,0,5,175,3.8,0.07380468,1
2020-08-19-171001,171001,3,0,3,178,3.4,0.07504871,2
2020-08-20-171001,171001,2,0,3,180,5.0,0.08522946,3
2020-08-21-171001,171001,2,0,3,182,6.2,0.111170076,4
2020-08-22-171001,171001,0,0,11,182,3.2,0.035675224,5
2020-08-23-171001,171001,0,0,7,182,2.4,0.028182488,6
2020-08-24-171001,171001,1,0,2,183,4.4,0.09387618,0
2020-08-25-171001,171001,1,0,0,184,7.6,0.16457239,1
2020-08-26-171001,171001,2,0,1,186,3.2,0.100679405,2
2020-08-27-171001,171001,5,0,5,191,9.0,0.16441849,3
2020-08-28-171001,171001,1,0,13,192,5.0,0.1639256,4
2020-08-29-171001,171001,3,0,2,195,3.8,0.036587153,5
2020-08-30-171001,171001,0,0,1,195,2.6,0.082528636,6
2020-08-31-171001,171001,4,0,5,199,4.6,0.07601145,0
2020-09-01-171001,171001,5,1,3,204,3.4,0.05391694,1
2020-09-02-171001,171001,3,0,4,207,4.2,0.08637255,2
2020-09-03-171001,171001,3,0,7,210,2.8,0.09045796,3
2020-09-04-171001,171001,3,0,4,213,5.8,0.09714344,4
2020-09-05-171001,171001,11,0,4,224,5.4,0.053229388,5
2020-09-06-171001,171001,7,0,2,231,7.2,0.0655293,6
2020-09-07-171001,171001,2,0,1,233,10.0,0.12624566,0
2020-09-08-171001,171001,0,0,6,233,2.4,0.107124895,1
2020-09-09-171001,171001,1,0,5,234,6.0,0.13521907,2
2020-09-10-171001,171001,5,0,5,239,13.8,0.19113871,3
2020-09-11-171001,171001,13,0,4,252,6.4,0.15833627,4
2020-09-12-171001,171001,2,0,0,254,2.2,0.07571573,5
2020-09-13-171001,171001,1,0,1,255,3.6,0.04133265,6
2020-09-14-171001,171001,5,0,0,260,8.6,0.18625969,0
2020-09-15-171001,171001,3,0,1,263,8.4,0.22760399,1
2020-09-16-171001,171001,4,0,2,267,8.6,0.20061204,2
2020-09-17-171001,171001,7,1,0,274,10.2,0.24508375,3
2020-09-18-171001,171001,4,0,1,278,7.0,0.23663403,4
2020-09-19-171001,171001,4,0,0,282,3.2,0.19773553,5
2020-09-20-171001,171001,2,1,0,284,2.4,0.054598738,6
2020-09-21-171001,171001,1,0,0,285,5.4,0.14925602,0
2020-09-22-171001,171001,6,0,5,291,5.8,0.15253048,1
2020-09-23-171001,171001,5,1,0,296,6.6,0.18687408,2
2020-09-24-171001,171001,5,1,5,301,6.8,0.2284772,3
2020-09-25-171001,171001,4,0,2,305,6.8,0.19219743,4
2020-09-26-171001,171001,0,0,2,305,1.6,0.12839624,5
2020-09-27-171001,171001,1,0,0,306,1.2,0.07413676,6
2020-09-28-171001,171001,0,0,1,306,3.4,0.10038172,0
2020-09-29-171001,171001,1,0,1,307,4.2,0.11366132,1
2020-09-30-171001,171001,2,0,3,309,3.4,0.09987364,2
2020-10-01-171001,171001,0,0,4,309,5.0,0.18383603,3
2020-10-02-171001,171001,1,1,3,310,6.0,0.13750756,4
2020-10-03-171001,171001,0,0,2,310,2.2,0.068729416,5
2020-10-04-171001,171001,0,0,2,310,2.2,0.033930253,6
2020-10-05-171001,171001,0,0,2,310,4.0,0.13694575,0
2020-10-06-171001,171001,5,0,6,315,6.2,0.22160408,1
2020-10-07-171001,171001,0,0,5,315,5.2,0.17055768,2
2020-10-08-171001,171001,5,0,10,320,6.8,0.28945634,3
2020-10-09-171001,171001,2,0,12,322,8.4,0.22407228,4
2020-10-10-171001,171001,2,0,0,324,6.8,0.09282526,5
2020-10-11-171001,171001,0,0,6,324,1.8,0.07342051,6
2020-10-12-171001,171001,1,0,7,325,2.6,0.06736148,0
2020-10-13-171001,171001,1,0,9,326,6.4,0.1896687,1
2020-10-14-171001,171001,3,0,5,329,7.4,0.21561666,2
2020-10-15-171001,171001,4,0,10,333,4.8,0.16878296,3
2020-10-16-171001,171001,3,0,7,336,9.8,0.2377876,4
2020-10-17-171001,171001,2,0,1,338,4.0,0.104903445,5
2020-10-18-171001,171001,2,0,0,340,1.8,0.08808199,6
2020-10-19-171001,171001,2,0,1,342,5.6,0.13704534,0
2020-10-20-171001,171001,6,0,12,348,11.0,0.2849821,1
2020-10-21-171001,171001,5,0,8,353,10.0,0.19687279,2
2020-10-22-171001,171001,10,0,10,363,12.2,0.23081113,3
2020-10-23-171001,171001,12,0,11,375,18.2,0.35339558,4
2020-10-24-171001,171001,0,0,12,375,5.4,0.1097861,5
2020-10-25-171001,171001,6,0,3,381,4.2,0.06884259,6
2020-10-26-171001,171001,7,0,6,388,18.8,0.30848235,0
2020-10-27-171001,171001,9,0,0,397,11.6,0.3135138,1
2020-10-28-171001,171001,5,0,2,402,16.8,0.33194724,2
2020-10-29-171001,171001,10,0,8,412,13.2,0.28521243,3
2020-10-30-171001,171001,7,0,1,419,24.0,0.4304284,4
2020-10-31-171001,171001,1,0,0,420,9.0,0.14084345,5
2020-11-01-171001,171001,0,0,0,420,5.6,0.094378136,6
2020-11-02-171001,171001,1,0,0,421,1.6,0.07363956,0
2020-11-03-171001,171001,12,0,0,433,10.4,0.24476251,1
2020-11-04-171001,171001,8,0,0,441,15.4,0.33215085,2
2020-11-05-171001,171001,10,0,0,451,16.4,0.3419521,3
2020-11-06-171001,171001,11,0,0,462,16.2,0.3031727,4
2020-11-07-171001,171001,12,0,0,474,9.0,0.11851233,5
2020-11-08-171001,171001,3,0,0,477,5.2,0.06255466,6
2020-11-09-171001,171001,6,0,0,483,10.8,0.16314255,0
2020-11-10-171001,171001,0,0,0,483,10.2,0.23913078,1
2020-11-11-171001,171001,2,0,0,485,15.6,0.23966143,2
2020-11-12-171001,171001,8,0,0,493,10.4,0.32483935,3
2020-11-13-171001,171001,1,0,0,494,15.4,0.20041004,4
2020-03-01-171002,171002,0,0,0,0,0.14285714285714285,0.008833607,6
2020-03-02-171002,171002,0,0,1,0,0.0,0.00045573962,0
2020-03-03-171002,171002,0,0,1,0,0.0,0.00032840157,1
2020-03-04-171002,171002,0,0,0,0,0.0,2.4671383e-05,2
2020-03-05-171002,171002,0,0,0,0,0.0,0.0015358704,3
2020-03-06-171002,171002,0,0,0,0,0.0,0.0009011762,4
2020-03-07-171002,171002,0,0,0,0,0.0,0.0005685806,5
2020-03-08-171002,171002,0,0,0,0,0.14285714285714285,0.0016560261,6
2020-03-09-171002,171002,0,0,1,0,0.42857142857142855,0.073932044,0
2020-03-10-171002,171002,0,0,0,0,0.2857142857142857,0.0707776,1
2020-03-11-171002,171002,0,0,2,0,0.14285714285714285,0.0144548705,2
2020-03-12-171002,171002,0,0,1,0,0.42857142857142855,0.013958292,3
2020-03-13-171002,171002,1,0,1,1,0.5714285714285714,0.15772733,4
2020-03-14-171002,171002,0,0,0,1,0.42857142857142855,0.024501609,5
2020-03-15-171002,171002,0,0,0,1,1.4285714285714286,0.008925152,6
2020-03-16-171002,171002,1,0,0,2,4.285714285714286,0.24795124,0
2020-03-17-171002,171002,1,2,1,3,3.7142857142857135,0.22138537,1
2020-03-18-171002,171002,0,1,1,3,4.857142857142857,0.29863942,2
2020-03-19-171002,171002,0,0,0,3,6.428571428571429,0.19197416,3
2020-03-20-171002,171002,0,0,0,3,6.142857142857142,0.50325465,4
2020-03-21-171002,171002,0,0,1,3,2.571428571428572,0.080650434,5
2020-03-22-171002,171002,0,2,0,3,2.7142857142857144,0.16126408,6
2020-03-23-171002,171002,1,0,0,4,9.142857142857142,1.00382,0
2020-03-24-171002,171002,0,0,0,4,6.0,0.5284808,1
2020-03-25-171002,171002,2,0,0,6,5.142857142857143,0.47840926,2
2020-03-26-171002,171002,1,0,0,7,7.0,0.48345885,3
2020-03-27-171002,171002,1,0,0,8,8.428571428571429,0.64822364,4
2020-03-28-171002,171002,0,0,1,8,2.8571428571428568,0.15330677,5
2020-03-29-171002,171002,0,0,1,8,2.7142857142857144,0.06994621,6
2020-03-30-171002,171002,0,0,1,8,5.0,0.3405023,0
2020-03-31-171002,171002,1,0,0,9,2.7142857142857144,0.24262077,1
2020-04-01-171002,171002,1,0,2,10,5.428571428571429,0.37627858,2
2020-04-02-171002,171002,0,0,0,10,8.285714285714286,0.37653622,3
2020-04-03-171002,171002,0,0,0,10,8.0,0.27280584,4
2020-04-04-171002,171002,1,0,0,11,1.5714285714285714,0.14209338,5
2020-04-05-171002,171002,0,2,1,11,2.2857142857142856,0.17347778,6
2020-04-06-171002,171002,0,0,0,11,4.857142857142857,0.21481515,0
2020-04-07-171002,171002,0,0,0,11,4.857142857142857,0.29793695,1
2020-04-08-171002,171002,0,0,0,11,4.714285714285714,0.2789445,2
2020-04-09-171002,171002,0,0,0,11,5.142857142857143,0.19464694,3
2020-04-10-171002,171002,0,0,0,11,1.7142857142857142,0.02496004,4
2020-04-11-171002,171002,1,0,0,12,1.8571428571428568,0.17624539,5
2020-04-12-171002,171002,1,0,0,13,1.8571428571428568,0.081132516,6
2020-04-13-171002,171002,1,0,0,14,3.4285714285714284,0.3531216,0
2020-04-14-171002,171002,0,0,0,14,2.142857142857143,0.24384402,1
2020-04-15-171002,171002,2,0,0,16,3.1428571428571432,0.48543182,2
2020-04-16-171002,171002,0,0,0,16,2.571428571428572,0.1803248,3
2020-04-17-171002,171002,0,0,0,16,1.4285714285714286,0.12229551,4
2020-04-18-171002,171002,0,0,0,16,0.2857142857142857,0.008451828,5
2020-04-19-171002,171002,1,1,0,17,0.42857142857142855,0.08975387,6
2020-04-20-171002,171002,0,0,0,17,3.571428571428572,0.22040115,0
2020-04-21-171002,171002,0,0,0,17,1.4285714285714286,0.14643162,1
2020-04-22-171002,171002,0,0,0,17,2.571428571428572,0.27478144,2
2020-04-23-171002,171002,0,0,0,17,0.42857142857142855,0.03630372,3
2020-04-24-171002,171002,0,0,0,17,2.7142857142857144,0.34562454,4
2020-04-25-171002,171002,0,0,0,17,0.14285714285714285,0.0017881066,5
2020-04-26-171002,171002,0,1,0,17,2.571428571428572,0.75640315,6
2020-04-27-171002,171002,0,1,1,17,2.0,0.19110705,0
2020-04-28-171002,171002,0,0,0,17,1.7142857142857142,0.13747501,1
2020-04-29-171002,171002,0,0,0,17,2.142857142857143,0.17186487,2
2020-04-30-171002,171002,0,1,0,17,1.5714285714285714,0.05338715,3
2020-05-01-171002,171002,0,0,0,17,0.7142857142857143,0.009246041,4
2020-05-02-171002,171002,0,0,0,17,0.5714285714285714,0.016890092,5
2020-05-03-171002,171002,0,0,0,17,0.2857142857142857,0.011923818,6
2020-05-04-171002,171002,0,1,0,17,1.5714285714285714,0.16238986,0
2020-05-05-171002,171002,0,0,0,17,1.7142857142857142,0.15939797,1
2020-05-06-171002,171002,0,0,0,17,2.571428571428572,0.15765125,2
2020-05-07-171002,171002,0,0,0,17,2.142857142857143,0.13898014,3
2020-05-08-171002,171002,0,0,0,17,2.0,0.1813225,4
2020-05-09-171002,171002,0,0,0,17,0.5714285714285714,0.0125350505,5
2020-05-10-171002,171002,0,0,0,17,0.5714285714285714,0.0076584094,6
2020-05-11-171002,171002,1,0,1,18,2.142857142857143,0.19075777,0
2020-05-12-171002,171002,0,0,0,18,1.4285714285714286,0.051293734,1
2020-05-13-171002,171002,0,0,0,18,2.2857142857142856,0.10484277,2
2020-05-14-171002,171002,0,0,0,18,1.5714285714285714,0.12515248,3
2020-05-15-171002,171002,0,0,0,18,1.7142857142857142,0.20287125,4
2020-05-16-171002,171002,0,0,0,18,0.7142857142857143,0.005321941,5
2020-05-17-171002,171002,0,0,0,18,0.5714285714285714,0.01695235,6
2020-05-18-171002,171002,0,0,0,18,1.8571428571428568,0.083948456,0
2020-05-19-171002,171002,0,0,0,18,1.1428571428571428,0.07683058,1
2020-05-20-171002,171002,0,1,0,18,1.4285714285714286,0.10556832,2
2020-05-21-171002,171002,0,0,0,18,1.8571428571428568,0.08610983,3
2020-05-22-171002,171002,0,0,0,18,1.5714285714285714,0.06803077,4
2020-05-23-171002,171002,0,0,0,18,0.0,0.00011803222,5
2020-05-24-171002,171002,0,0,0,18,0.14285714285714285,0.0052067786,6
2020-05-25-171002,171002,1,0,2,19,0.8571428571428571,0.15811417,0
2020-05-26-171002,171002,0,0,0,19,1.1428571428571428,0.12451772,1
2020-05-27-171002,171002,0,2,0,19,0.7142857142857143,0.07015493,2
2020-05-28-171002,171002,0,0,0,19,0.7142857142857143,0.03560788,3
2020-05-29-171002,171002,0,1,0,19,0.5714285714285714,0.20928974,4
2020-05-30-171002,171002,0,0,0,19,0.14285714285714285,0.012189874,5
2020-05-31-171002,171002,0,1,0,19,0.14285714285714285,0.005095728,6
2020-06-01-171002,171002,0,1,0,19,1.0,0.058116186,0
2020-06-02-171002,171002,0,0,0,19,1.2857142857142858,0.111550376,1
2020-06-03-171002,171002,0,0,0,19,0.42857142857142855,0.037560638,2
2020-06-04-171002,171002,0,0,0,19,0.42857142857142855,0.03841627,3
2020-06-05-171002,171002,0,0,0,19,0.14285714285714285,0.02050521,4
2020-06-06-171002,171002,0,0,0,19,0.14285714285714285,0.019044371,5
2020-06-07-171002,171002,0,0,0,19,0.0,0.00048017316,6
2020-06-08-171002,171002,2,0,0,21,0.2857142857142857,0.29273555,0
2020-06-09-171002,171002,0,0,0,21,0.14285714285714285,0.031643275,1
2020-06-10-171002,171002,0,0,0,21,0.7142857142857143,0.03335079,2
2020-06-11-171002,171002,0,0,0,21,0.8571428571428571,0.03561102,3
2020-06-12-171002,171002,0,0,0,21,0.5714285714285714,0.030472698,4
2020-06-13-171002,171002,0,0,0,21,0.0,0.000820615,5
2020-06-14-171002,171002,0,0,0,21,0.0,0.000159622,6
2020-06-15-171002,171002,0,0,0,21,1.1428571428571428,0.051483415,0
2020-06-16-171002,171002,0,0,0,21,1.2857142857142858,0.13161428,1
2020-06-17-171002,171002,0,0,0,21,0.7142857142857143,0.020991541,2
2020-06-18-171002,171002,0,0,0,21,0.8571428571428571,0.053256202,3
2020-06-19-171002,171002,0,0,0,21,1.4285714285714286,0.07804317,4
2020-06-20-171002,171002,0,0,0,21,0.2857142857142857,0.013549905,5
2020-06-21-171002,171002,0,0,0,21,0.0,0.00044511573,6
2020-06-22-171002,171002,0,0,0,21,0.5714285714285714,0.035419982,0
2020-06-23-171002,171002,0,0,0,21,0.5714285714285714,0.038082957,1
2020-06-24-171002,171002,0,0,0,21,0.42857142857142855,0.013621751,2
2020-06-25-171002,171002,0,0,0,21,0.14285714285714285,0.07681583,3
2020-06-26-171002,171002,0,0,0,21,0.5714285714285714,0.09012695,4
2020-06-27-171002,171002,0,0,0,21,0.2857142857142857,0.008593339,5
2020-06-28-171002,171002,0,0,0,21,0.14285714285714285,0.003123165,6
2020-06-29-171002,171002,0,0,0,21,0.5714285714285714,0.031140225,0
2020-06-30-171002,171002,0,0,0,21,0.42857142857142855,0.015631916,1
2020-07-01-171002,171002,0,0,0,21,0.2857142857142857,0.024056192,2
2020-07-02-171002,171002,0,0,0,21,0.2857142857142857,0.07936271,3
2020-07-03-171002,171002,0,0,0,21,0.2857142857142857,0.018888922,4
2020-07-04-171002,171002,0,0,0,21,0.14285714285714285,0.0020844478,5
2020-07-05-171002,171002,0,0,0,21,0.0,0.0012643246,6
2020-07-06-171002,171002,0,0,0,21,0.5714285714285714,0.023119738,0
2020-07-07-171002,171002,0,0,0,21,0.7142857142857143,0.033804484,1
2020-07-08-171002,171002,0,0,0,21,0.0,0.0076170084,2
2020-07-09-171002,171002,0,0,0,21,0.2857142857142857,0.010443991,3
2020-07-10-171002,171002,0,0,0,21,0.42857142857142855,0.030349381,4
2020-07-11-171002,171002,0,0,0,21,0.14285714285714285,0.0010690349,5
2020-07-12-171002,171002,0,0,0,21,0.14285714285714285,0.009021375,6
2020-07-13-171002,171002,0,0,0,21,0.2857142857142857,0.01666392,0
2020-07-14-171002,171002,0,0,0,21,0.42857142857142855,0.01494296,1
2020-07-15-171002,171002,0,0,0,21,1.0,0.011188387,2
2020-07-16-171002,171002,0,0,0,21,0.7142857142857143,0.013733629,3
2020-07-17-171002,171002,0,0,0,21,0.5714285714285714,0.02088368,4
2020-07-18-171002,171002,0,0,0,21,0.0,0.001507298,5
2020-07-19-171002,171002,0,0,0,21,0.0,0.010890564,6
2020-07-20-171002,171002,0,0,0,21,0.14285714285714285,0.029455509,0
2020-07-21-171002,171002,0,0,0,21,0.5714285714285714,0.046695355,1
2020-07-22-171002,171002,0,0,0,21,0.0,0.009601086,2
2020-07-23-171002,171002,0,0,0,21,0.42857142857142855,0.03686047,3
2020-07-24-171002,171002,0,0,0,21,0.5714285714285714,0.042498615,4
2020-07-25-171002,171002,0,0,0,21,0.14285714285714285,0.010806598,5
2020-07-26-171002,171002,0,0,0,21,0.14285714285714285,0.0021495447,6
2020-07-27-171002,171002,0,0,0,21,1.2857142857142858,0.061624546,0
2020-07-28-171002,171002,0,0,2,21,0.42857142857142855,0.03217611,1
2020-07-29-171002,171002,0,0,0,21,0.42857142857142855,0.02146404,2
2020-07-30-171002,171002,0,0,2,21,0.7142857142857143,0.052227344,3
2020-07-31-171002,171002,0,0,0,21,1.1428571428571428,0.050384477,4
2020-08-01-171002,171002,0,0,0,21,0.14285714285714285,0.017000081,5
2020-08-02-171002,171002,0,0,0,21,0.14285714285714285,0.0098734535,6
2020-08-03-171002,171002,0,0,0,21,0.5714285714285714,0.05352369,0
2020-08-04-171002,171002,0,0,0,21,0.8571428571428571,0.074528135,1
2020-08-05-171002,171002,0,0,0,21,1.7142857142857142,0.20047931,2
2020-08-06-171002,171002,0,0,0,21,0.8571428571428571,0.09873468,3
2020-08-07-171002,171002,0,0,0,21,0.2857142857142857,0.07916283,4
2020-08-08-171002,171002,0,0,0,21,1.2857142857142858,0.24469037,5
2020-08-09-171002,171002,0,0,0,21,0.42857142857142855,0.06545086,6
2020-08-10-171002,171002,0,0,0,21,0.2857142857142857,0.1917359,0
2020-08-11-171002,171002,2,0,0,23,1.5714285714285714,0.47381878,1
2020-08-12-171002,171002,0,0,1,23,1.7142857142857142,0.22359039,2
2020-08-13-171002,171002,2,0,0,25,1.7142857142857142,0.47033542,3
2020-08-14-171002,171002,0,0,0,25,2.2857142857142856,0.31245056,4
2020-08-15-171002,171002,0,1,0,25,1.2857142857142858,0.1876367,5
2020-08-16-171002,171002,0,0,2,25,0.7142857142857143,0.23005562,6
2020-08-17-171002,171002,0,0,0,25,1.8571428571428568,0.22603415,0
2020-08-18-171002,171002,0,0,0,25,2.8571428571428568,0.24224892,1
2020-08-19-171002,171002,0,0,0,25,1.2857142857142858,0.30158263,2
2020-08-20-171002,171002,0,0,0,25,3.4285714285714284,0.6109392,3
2020-08-21-171002,171002,0,0,4,25,3.1428571428571432,0.45462212,4
2020-08-22-171002,171002,0,0,0,25,0.42857142857142855,0.11105761,5
2020-08-23-171002,171002,0,0,0,25,1.4285714285714286,0.10220439,6
2020-08-24-171002,171002,0,0,0,25,2.0,0.31909144,0
2020-08-25-171002,171002,0,0,0,25,4.285714285714286,0.35143775,1
2020-08-26-171002,171002,1,0,0,26,2.142857142857143,0.71457374,2
2020-08-27-171002,171002,0,0,0,26,5.285714285714286,0.47523135,3
2020-08-28-171002,171002,0,0,0,26,4.142857142857143,0.633981,4
2020-08-29-171002,171002,0,0,1,26,2.0,0.53079706,5
2020-08-30-171002,171002,2,0,0,28,2.571428571428572,0.39788166,6
2020-08-31-171002,171002,0,0,1,28,2.0,0.5143409,0
2020-09-01-171002,171002,0,0,4,28,1.1428571428571428,0.057486054,1
2020-09-02-171002,171002,0,0,2,28,1.5714285714285714,0.14093122,2
2020-09-03-171002,171002,0,0,8,28,3.571428571428572,0.15448856,3
2020-09-04-171002,171002,4,0,0,32,2.571428571428572,0.4290424,4
2020-09-05-171002,171002,0,0,2,32,1.0,0.40175003,5
2020-09-06-171002,171002,0,0,0,32,4.285714285714286,0.30355352,6
2020-09-07-171002,171002,0,0,1,32,2.4285714285714284,0.193459,0
2020-09-08-171002,171002,0,0,1,32,4.428571428571429,1.0463443,1
2020-09-09-171002,171002,0,0,3,32,5.0,1.6982925,2
2020-09-10-171002,171002,0,0,0,32,6.142857142857142,1.068965,3
2020-09-11-171002,171002,0,0,8,32,4.428571428571429,1.0854821,4
2020-09-12-171002,171002,1,0,1,33,2.4285714285714284,0.5074642,5
2020-09-13-171002,171002,0,0,0,33,1.0,0.10535564,6
2020-09-14-171002,171002,1,0,0,34,4.714285714285714,0.37345734,0
2020-09-15-171002,171002,4,0,3,38,7.2857142857142865,1.6974409,1
2020-09-16-171002,171002,2,0,0,40,7.7142857142857135,0.7622501,2
2020-09-17-171002,171002,8,0,0,48,4.142857142857143,1.3179452,3
2020-09-18-171002,171002,0,0,0,48,12.714285714285715,0.44910946,4
2020-09-19-171002,171002,2,0,0,50,11.428571428571427,0.91495043,5
2020-09-20-171002,171002,0,0,0,50,2.571428571428572,0.13112493,6
2020-09-21-171002,171002,1,0,1,51,3.571428571428572,0.5497334,0
2020-09-22-171002,171002,1,0,0,52,4.428571428571429,0.18046154,1
2020-09-23-171002,171002,3,1,0,55,4.714285714285714,0.64192885,2
2020-09-24-171002,171002,0,0,0,55,4.0,0.18121362,3
2020-09-25-171002,171002,8,0,2,63,3.0,0.6377317,4
2020-09-26-171002,171002,1,0,0,64,1.8571428571428568,0.27975833,5
2020-09-27-171002,171002,0,0,0,64,1.0,0.10781403,6
2020-09-28-171002,171002,0,0,0,64,2.142857142857143,0.30503896,0
2020-09-29-171002,171002,3,0,0,67,4.714285714285714,0.6853149,1
2020-09-30-171002,171002,0,1,0,67,2.8571428571428568,0.28551164,2
2020-10-01-171002,171002,0,0,0,67,4.857142857142857,0.48504436,3
2020-10-02-171002,171002,0,0,0,67,3.1428571428571432,0.15677962,4
2020-10-03-171002,171002,0,0,0,67,1.4285714285714286,0.08995561,5
2020-10-04-171002,171002,0,0,0,67,0.14285714285714285,0.040487066,6
2020-10-05-171002,171002,1,0,1,68,2.571428571428572,0.60805464,0
2020-10-06-171002,171002,0,0,3,68,4.857142857142857,0.42945212,1
2020-10-07-171002,171002,0,0,0,68,3.1428571428571432,0.69167125,2
2020-10-08-171002,171002,0,0,0,68,3.571428571428572,0.60743105,3
2020-10-09-171002,171002,2,0,1,70,4.857142857142857,0.62154245,4
2020-10-10-171002,171002,0,0,2,70,3.0,0.21244134,5
2020-10-11-171002,171002,0,0,1,70,1.1428571428571428,0.24697694,6
2020-10-12-171002,171002,0,0,0,70,1.2857142857142858,0.0896448,0
2020-10-13-171002,171002,0,0,4,70,3.2857142857142856,0.33512643,1
2020-10-14-171002,171002,0,0,1,70,5.857142857142858,0.6136356,2
2020-10-15-171002,171002,0,0,1,70,3.1428571428571432,0.7631766,3
2020-10-16-171002,171002,0,0,2,70,6.2857142857142865,0.6650146,4
2020-10-17-171002,171002,0,0,0,70,2.7142857142857144,0.17605202,5
2020-10-18-171002,171002,0,0,0,70,2.0,0.26065964,6
2020-10-19-171002,171002,1,0,0,71,2.571428571428572,0.54860586,0
2020-10-20-171002,171002,3,0,0,74,7.2857142857142865,0.81388134,1
2020-10-21-171002,171002,0,0,2,74,5.285714285714286,0.4923632,2
2020-10-22-171002,171002,0,0,1,74,3.4285714285714284,0.29525542,3
2020-10-23-171002,171002,1,0,1,75,9.857142857142858,0.87653315,4
2020-10-24-171002,171002,2,0,0,77,6.142857142857142,0.5562043,5
2020-10-25-171002,171002,1,0,0,78,1.7142857142857142,0.17342937,6
2020-10-26-171002,171002,0,0,0,78,6.2857142857142865,0.56618005,0
2020-10-27-171002,171002,4,0,1,82,8.0,1.140556,1
2020-10-28-171002,171002,1,0,1,83,9.0,1.0168489,2
2020-10-29-171002,171002,1,0,0,84,6.2857142857142865,0.7997088,3
2020-10-30-171002,171002,2,0,3,86,11.857142857142858,0.91690177,4
2020-10-31-171002,171002,0,0,0,86,6.0,0.3578556,5
2020-11-01-171002,171002,0,1,0,86,3.0,0.15511934,6
2020-11-02-171002,171002,0,0,0,86,1.0,0.07422936,0
2020-11-03-171002,171002,0,0,0,86,6.2857142857142865,0.6197231,1
2020-11-04-171002,171002,2,0,0,88,9.0,0.86475056,2
2020-11-05-171002,171002,1,0,0,89,9.142857142857142,1.4090447,3
2020-11-06-171002,171002,1,0,0,90,9.142857142857142,0.9527562,4
2020-11-07-171002,171002,0,0,0,90,5.857142857142858,0.3641147,5
2020-11-08-171002,171002,0,0,0,90,2.7142857142857144,0.17729262,6
2020-11-09-171002,171002,0,0,0,90,2.7142857142857144,0.2706258,0
2020-11-10-171002,171002,1,1,0,91,6.571428571428571,0.48846367,1
2020-11-11-171002,171002,1,1,0,92,5.142857142857143,0.5463257,2
2020-11-12-171002,171002,0,0,0,92,4.428571428571429,0.6795388,3
2020-11-13-171002,171002,3,0,0,95,6.142857142857142,0.9761915,4
2020-03-01-171003,171003,0,0,1,0,0.0,0.021932997,6
2020-03-02-171003,171003,0,1,6,0,0.0,0.021229137,0
2020-03-03-171003,171003,2,0,6,2,0.0,0.011098961,1
2020-03-04-171003,171003,1,0,8,3,0.0,0.0045144903,2
2020-03-05-171003,171003,0,0,17,3,0.2,0.017304635,3
2020-03-06-171003,171003,0,0,24,3,0.0,0.06260089,4
2020-03-07-171003,171003,0,0,4,3,0.2,0.011709793,5
2020-03-08-171003,171003,0,0,5,3,0.0,0.00842662,6
2020-03-09-171003,171003,1,0,24,4,0.2,0.1747542,0
2020-03-10-171003,171003,0,0,11,4,0.2,0.08520342,1
2020-03-11-171003,171003,0,0,20,4,0.2,0.08267398,2
2020-03-12-171003,171003,2,0,16,6,0.4,0.11535128,3
2020-03-13-171003,171003,0,0,11,6,1.2,0.3915882,4
2020-03-14-171003,171003,0,0,4,6,0.6,0.105425835,5
2020-03-15-171003,171003,1,0,1,7,0.6,0.09686252,6
2020-03-16-171003,171003,6,0,8,13,5.4,1.0424585,0
2020-03-17-171003,171003,6,0,9,19,5.6,0.75614625,1
2020-03-18-171003,171003,8,0,10,27,9.0,0.9910011,2
2020-03-19-171003,171003,17,0,2,44,13.8,1.4475099,3
2020-03-20-171003,171003,24,0,14,68,10.2,1.1697234,4
2020-03-21-171003,171003,4,0,1,72,4.2,0.19639249,5
2020-03-22-171003,171003,5,0,2,77,4.4,0.17875817,6
2020-03-23-171003,171003,24,0,9,101,15.6,1.7905277,0
2020-03-24-171003,171003,11,0,11,112,12.0,1.0318491,1
2020-03-25-171003,171003,20,0,13,132,9.4,0.9381774,2
2020-03-26-171003,171003,16,0,6,148,13.2,1.2466124,3
2020-03-27-171003,171003,11,0,3,159,9.8,1.0917212,4
2020-03-28-171003,171003,4,0,1,163,2.8,0.16968983,5
2020-03-29-171003,171003,1,0,1,164,2.2,0.10612319,6
2020-03-30-171003,171003,8,0,6,172,9.0,0.79518116,0
2020-03-31-171003,171003,9,0,9,181,5.4,0.5382423,1
2020-04-01-171003,171003,10,0,4,191,7.4,0.7850047,2
2020-04-02-171003,171003,2,0,4,193,6.8,1.1339892,3
2020-04-03-171003,171003,14,0,8,207,12.0,1.6699893,4
2020-04-04-171003,171003,1,0,1,208,1.8,0.108536415,5
2020-04-05-171003,171003,2,0,1,210,0.8,0.06809809,6
2020-04-06-171003,171003,9,0,6,219,8.0,0.89976007,0
2020-04-07-171003,171003,11,0,3,230,7.0,0.99471515,1
2020-04-08-171003,171003,13,1,5,243,8.2,0.81753796,2
2020-04-09-171003,171003,6,3,0,249,7.4,0.57740533,3
2020-04-10-171003,171003,3,0,4,252,3.8,0.21341945,4
2020-04-11-171003,171003,1,0,1,253,0.6,0.19651018,5
2020-04-12-171003,171003,1,0,1,254,3.0,0.25923103,6
2020-04-13-171003,171003,6,0,10,260,7.8,0.8174664,0
2020-04-14-171003,171003,9,0,3,269,7.4,0.65875214,1
2020-04-15-171003,171003,4,0,5,273,5.0,0.7632996,2
2020-04-16-171003,171003,4,0,2,277,4.8,0.49347568,3
2020-04-17-171003,171003,8,0,0,285,2.6,0.45903704,4
2020-04-18-171003,171003,1,0,1,286,0.6,0.035697784,5
2020-04-19-171003,171003,1,0,0,287,0.4,0.02952413,6
2020-04-20-171003,171003,6,0,6,293,4.0,0.607067,0
2020-04-21-171003,171003,3,0,5,296,2.8,0.3921283,1
2020-04-22-171003,171003,5,0,3,301,2.8,0.39943597,2
2020-04-23-171003,171003,0,0,4,301,0.0,0.0211399,3
2020-04-24-171003,171003,4,0,3,305,3.8,0.44767722,4
2020-04-25-171003,171003,1,0,0,306,0.4,0.02588897,5
2020-04-26-171003,171003,1,0,0,307,1.0,0.06838761,6
2020-04-27-171003,171003,10,0,3,317,3.4,0.48844385,0
2020-04-28-171003,171003,3,0,5,320,2.2,0.40582073,1
2020-04-29-171003,171003,5,0,0,325,2.2,0.5986515,2
2020-04-30-171003,171003,2,0,2,327,2.0,0.4148214,3
2020-05-01-171003,171003,0,1,3,327,1.0,0.08404063,4
2020-05-02-171003,171003,1,0,2,328,0.2,0.097767174,5
2020-05-03-171003,171003,0,0,0,328,0.4,0.019385582,6
2020-05-04-171003,171003,6,0,3,334,1.8,0.39136127,0
2020-05-05-171003,171003,5,0,3,339,2.8,0.41113636,1
2020-05-06-171003,171003,3,0,2,342,3.0,0.76115894,2
2020-05-07-171003,171003,4,0,2,346,1.6,0.49380744,3
2020-05-08-171003,171003,3,0,2,349,3.8,0.55176926,4
2020-05-09-171003,171003,0,0,2,349,0.6,0.10642426,5
2020-05-10-171003,171003,0,0,0,349,0.2,0.05375737,6
2020-05-11-171003,171003,3,0,5,352,3.0,0.5826215,0
2020-05-12-171003,171003,5,0,2,357,2.2,0.4160132,1
2020-05-13-171003,171003,0,0,2,357,2.2,0.4991556,2
2020-05-14-171003,171003,2,0,2,359,3.2,0.5111374,3
2020-05-15-171003,171003,3,0,3,362,2.2,0.3732767,4
2020-05-16-171003,171003,2,2,0,364,1.0,0.030514855,5
2020-05-17-171003,171003,0,0,0,364,0.0,0.017168816,6
2020-05-18-171003,171003,3,0,2,367,3.6,0.49317813,0
2020-05-19-171003,171003,3,0,4,370,1.6,0.40133047,1
2020-05-20-171003,171003,2,0,4,372,3.8,0.44126284,2
2020-05-21-171003,171003,2,0,0,374,2.4,0.56180686,3
2020-05-22-171003,171003,2,0,0,376,2.2,0.47004792,4
2020-05-23-171003,171003,2,0,0,378,0.2,0.0073983157,5
2020-05-24-171003,171003,0,0,0,378,0.0,0.01040525,6
2020-05-25-171003,171003,5,0,1,383,1.8,0.49671078,0
2020-05-26-171003,171003,2,0,0,385,1.4,0.29585102,1
2020-05-27-171003,171003,2,0,2,387,1.4,0.33441108,2
2020-05-28-171003,171003,2,0,2,389,1.0,0.3628191,3
2020-05-29-171003,171003,3,0,0,392,2.2,0.45619455,4
2020-05-30-171003,171003,0,0,0,392,0.0,0.056707926,5
2020-05-31-171003,171003,0,0,0,392,0.0,0.06085915,6
2020-06-01-171003,171003,2,0,3,394,1.8,0.6395419,0
2020-06-02-171003,171003,4,0,2,398,1.6,0.39293575,1
2020-06-03-171003,171003,4,0,1,402,1.4,0.37356573,2
2020-06-04-171003,171003,0,0,1,402,2.6,0.31166783,3
2020-06-05-171003,171003,0,0,0,402,0.6,0.16902463,4
2020-06-06-171003,171003,0,0,0,402,0.0,0.02738069,5
2020-06-07-171003,171003,0,0,0,402,0.0,0.021975799,6
2020-06-08-171003,171003,1,0,0,403,0.4,0.42631188,0
2020-06-09-171003,171003,0,0,1,403,1.2,0.34604108,1
2020-06-10-171003,171003,2,0,1,405,2.2,0.5563137,2
2020-06-11-171003,171003,2,0,0,407,1.2,0.54638577,3
2020-06-12-171003,171003,0,0,3,407,1.4,0.26895303,4
2020-06-13-171003,171003,0,0,0,407,0.0,0.022222858,5
2020-06-14-171003,171003,0,0,0,407,0.0,0.018431716,6
2020-06-15-171003,171003,3,3,2,410,1.8,0.5082309,0
2020-06-16-171003,171003,2,1,3,412,3.4,0.61564356,1
2020-06-17-171003,171003,1,0,0,413,2.0,0.38770425,2
2020-06-18-171003,171003,1,0,2,414,2.4,0.3838201,3
2020-06-19-171003,171003,0,0,0,414,1.4,0.56860864,4
2020-06-20-171003,171003,0,0,0,414,0.2,0.08251008,5
2020-06-21-171003,171003,0,0,0,414,0.0,0.017166601,6
2020-06-22-171003,171003,0,0,2,414,0.6,0.2689397,0
2020-06-23-171003,171003,1,0,1,415,1.0,0.4105393,1
2020-06-24-171003,171003,1,0,1,416,0.4,0.120977126,2
2020-06-25-171003,171003,0,0,1,416,0.6,0.15164545,3
2020-06-26-171003,171003,3,0,1,419,0.8,0.19911191,4
2020-06-27-171003,171003,0,0,0,419,0.2,0.07893152,5
2020-06-28-171003,171003,0,0,0,419,0.2,0.05807582,6
2020-06-29-171003,171003,2,0,1,421,1.8,0.34736237,0
2020-06-30-171003,171003,3,0,0,424,0.6,0.18092968,1
2020-07-01-171003,171003,0,0,1,424,0.6,0.20675915,2
2020-07-02-171003,171003,2,0,1,426,0.0,0.122432,3
2020-07-03-171003,171003,0,0,0,426,1.0,0.22759391,4
2020-07-04-171003,171003,0,0,0,426,0.0,0.019422913,5
2020-07-05-171003,171003,0,0,0,426,0.0,0.044316195,6
2020-07-06-171003,171003,2,0,1,428,0.6,0.25059167,0
2020-07-07-171003,171003,1,0,0,429,1.0,0.21695626,1
2020-07-08-171003,171003,1,0,0,430,0.8,0.06953236,2
2020-07-09-171003,171003,1,0,1,431,0.8,0.06645466,3
2020-07-10-171003,171003,1,0,1,432,0.6,0.20169887,4
2020-07-11-171003,171003,0,0,0,432,0.0,0.016400607,5
2020-07-12-171003,171003,0,0,0,432,0.2,0.052324515,6
2020-07-13-171003,171003,1,0,0,433,1.0,0.21871148,0
2020-07-14-171003,171003,0,0,1,433,0.2,0.08768131,1
2020-07-15-171003,171003,1,0,0,434,1.2,0.11173096,2
2020-07-16-171003,171003,1,0,3,435,0.4,0.084860876,3
2020-07-17-171003,171003,0,0,1,435,1.2,0.35006657,4
2020-07-18-171003,171003,0,0,0,435,0.0,0.012400064,5
2020-07-19-171003,171003,0,0,0,435,0.0,0.057892438,6
2020-07-20-171003,171003,1,0,3,436,0.2,0.19477998,0
2020-07-21-171003,171003,0,0,1,436,0.8,0.35284448,1
2020-07-22-171003,171003,0,1,4,436,0.2,0.10194302,2
2020-07-23-171003,171003,1,0,2,437,0.6,0.38263488,3
2020-07-24-171003,171003,1,0,6,438,0.2,0.24210604,4
2020-07-25-171003,171003,0,0,5,438,0.2,0.06208598,5
2020-07-26-171003,171003,0,0,8,438,0.0,0.013891772,6
2020-07-27-171003,171003,0,0,3,438,1.0,0.5874505,0
2020-07-28-171003,171003,1,0,0,439,0.4,0.14079346,1
2020-07-29-171003,171003,0,0,8,439,0.6,0.19328468,2
2020-07-30-171003,171003,3,0,4,442,0.4,0.28688413,3
2020-07-31-171003,171003,1,0,1,443,1.2,0.32295084,4
2020-08-01-171003,171003,0,0,0,443,0.0,0.04117621,5
2020-08-02-171003,171003,0,0,11,443,0.4,0.13317452,6
2020-08-03-171003,171003,3,1,2,446,2.0,0.25128412,0
2020-08-04-171003,171003,1,0,0,447,0.4,0.28626353,1
2020-08-05-171003,171003,4,0,1,451,0.8,0.6469513,2
2020-08-06-171003,171003,2,0,14,453,1.0,0.26358816,3
2020-08-07-171003,171003,6,0,6,459,2.0,0.21474288,4
2020-08-08-171003,171003,5,0,12,464,0.8,0.32815516,5
2020-08-09-171003,171003,8,0,1,472,1.0,0.16682543,6
2020-08-10-171003,171003,3,0,5,475,1.2,0.31021225,0
2020-08-11-171003,171003,0,0,6,475,2.4,0.65037924,1
2020-08-12-171003,171003,8,0,4,483,0.8,0.3429154,2
2020-08-13-171003,171003,4,0,11,487,2.2,0.56813186,3
2020-08-14-171003,171003,1,0,5,488,2.2,0.67184085,4
2020-08-15-171003,171003,0,0,9,488,1.0,0.20583743,5
2020-08-16-171003,171003,11,0,1,499,3.2,0.27734017,6
2020-08-17-171003,171003,2,0,3,501,1.6,0.61835515,0
2020-08-18-171003,171003,0,0,3,501,2.4,0.7744712,1
2020-08-19-171003,171003,1,0,4,502,3.4,0.8248602,2
2020-08-20-171003,171003,14,0,1,516,5.0,0.9008987,3
2020-08-21-171003,171003,6,0,8,522,5.0,1.159452,4
2020-08-22-171003,171003,12,0,1,534,2.2,0.3690318,5
2020-08-23-171003,171003,1,0,4,535,3.2,0.28713268,6
2020-08-24-171003,171003,5,0,12,540,2.6,0.96912307,0
2020-08-25-171003,171003,6,0,1,546,7.0,1.8554314,1
2020-08-26-171003,171003,4,0,14,550,5.8,1.0246811,2
2020-08-27-171003,171003,11,0,24,561,5.8,1.7510608,3
2020-08-28-171003,171003,5,1,14,566,6.2,1.743904,4
2020-08-29-171003,171003,9,0,3,575,2.2,0.36246058,5
2020-08-30-171003,171003,1,0,5,576,2.8,0.86081326,6
2020-08-31-171003,171003,3,0,24,579,3.0,0.808551,0
2020-09-01-171003,171003,3,0,16,582,4.0,0.5486376,1
2020-09-02-171003,171003,4,0,23,586,3.0,0.86068964,2
2020-09-03-171003,171003,1,0,24,587,1.6,0.93791944,3
2020-09-04-171003,171003,8,0,12,595,4.4,0.99144036,4
2020-09-05-171003,171003,1,0,5,596,6.4,0.5219337,5
2020-09-06-171003,171003,4,0,0,600,6.8,0.6896452,6
2020-09-07-171003,171003,12,0,5,612,6.6,1.2197051,0
2020-09-08-171003,171003,1,0,4,613,4.0,1.183275,1
2020-09-09-171003,171003,14,0,6,627,3.2,1.5352044,2
2020-09-10-171003,171003,24,0,9,651,6.8,2.2307003,3
2020-09-11-171003,171003,14,0,13,665,7.2,1.6278826,4
2020-09-12-171003,171003,3,0,2,668,3.6,0.6972237,5
2020-09-13-171003,171003,5,0,2,673,1.4,0.43885663,6
2020-09-14-171003,171003,24,0,4,697,4.6,1.7567261,0
2020-09-15-171003,171003,16,0,6,713,6.8,2.3322678,1
2020-09-16-171003,171003,23,0,6,736,7.8,2.1476107,2
2020-09-17-171003,171003,24,0,6,760,5.6,2.4140189,3
2020-09-18-171003,171003,12,0,12,772,6.6,2.3109784,4
2020-09-19-171003,171003,5,0,2,777,4.6,2.1053524,5
2020-09-20-171003,171003,0,0,3,777,1.8,0.52633554,6
2020-09-21-171003,171003,5,0,5,782,5.6,1.5174123,0
2020-09-22-171003,171003,4,1,8,786,4.4,1.44508,1
2020-09-23-171003,171003,6,0,7,792,10.2,1.773265,2
2020-09-24-171003,171003,9,0,10,801,3.8,2.3631215,3
2020-09-25-171003,171003,13,0,14,814,4.6,1.8735902,4
2020-09-26-171003,171003,2,0,9,816,1.8,1.1558243,5
2020-09-27-171003,171003,2,0,4,818,0.6,0.61139435,6
2020-09-28-171003,171003,4,0,3,822,1.6,1.0141793,0
2020-09-29-171003,171003,6,0,5,828,2.2,1.1322751,1
2020-09-30-171003,171003,6,0,11,834,3.8,1.1222656,2
2020-10-01-171003,171003,6,0,5,840,2.6,1.8843609,3
2020-10-02-171003,171003,12,0,10,852,4.8,1.3596007,4
2020-10-03-171003,171003,2,0,1,854,0.4,0.6076395,5
2020-10-04-171003,171003,3,1,3,857,2.2,0.32783997,6
2020-10-05-171003,171003,5,0,7,862,1.6,1.3538767,0
2020-10-06-171003,171003,8,0,13,870,4.0,2.3062325,1
2020-10-07-171003,171003,7,0,18,877,2.8,1.706224,2
2020-10-08-171003,171003,10,0,25,887,3.6,2.6779222,3
2020-10-09-171003,171003,14,0,19,901,5.0,2.1371658,4
2020-10-10-171003,171003,9,0,3,910,3.0,0.919518,5
2020-10-11-171003,171003,4,0,8,914,2.2,0.65610355,6
2020-10-12-171003,171003,3,0,17,917,2.4,0.6482404,0
2020-10-13-171003,171003,5,0,10,922,4.6,1.9818307,1
2020-10-14-171003,171003,11,0,15,933,6.4,2.2595444,2
2020-10-15-171003,171003,5,0,14,938,4.8,1.6708323,3
2020-10-16-171003,171003,10,0,25,948,9.8,2.3133698,4
2020-10-17-171003,171003,1,0,10,949,4.4,1.067347,5
2020-10-18-171003,171003,3,0,6,952,1.6,0.81358653,6
2020-10-19-171003,171003,7,0,3,959,3.4,1.5410686,0
2020-10-20-171003,171003,13,0,19,972,10.8,2.8531876,1
2020-10-21-171003,171003,18,0,24,990,7.4,2.1709948,2
2020-10-22-171003,171003,25,0,28,1015,8.8,2.1560638,3
2020-10-23-171003,171003,19,0,22,1034,16.6,3.683159,4
2020-10-24-171003,171003,3,0,27,1037,4.0,1.1467712,5
2020-10-25-171003,171003,8,0,16,1045,5.8,0.60522234,6
2020-10-26-171003,171003,17,0,13,1062,15.2,3.0371604,0
2020-10-27-171003,171003,10,0,13,1072,9.0,3.3743255,1
2020-10-28-171003,171003,15,0,25,1087,13.4,3.6023264,2
2020-10-29-171003,171003,14,0,12,1101,12.8,2.8506677,3
2020-10-30-171003,171003,25,0,31,1126,14.4,4.8487263,4
2020-10-31-171003,171003,10,1,0,1136,6.4,1.4255251,5
2020-11-01-171003,171003,6,1,0,1142,3.8,0.92539454,6
2020-11-02-171003,171003,3,0,0,1145,1.4,0.75344765,0
2020-11-03-171003,171003,19,0,0,1164,11.2,2.6247213,1
2020-11-04-171003,171003,24,0,0,1188,10.4,3.7149005,2
2020-11-05-171003,171003,28,1,0,1216,10.8,3.555313,3
2020-11-06-171003,171003,22,1,0,1238,12.8,3.137523,4
2020-11-07-171003,171003,27,0,0,1265,10.0,1.087913,5
2020-11-08-171003,171003,16,0,0,1281,3.4,0.62106276,6
2020-11-09-171003,171003,13,1,0,1294,6.6,1.5998414,0
2020-11-10-171003,171003,13,1,0,1307,7.0,2.4518254,1
2020-11-11-171003,171003,25,1,0,1332,8.6,2.443007,2
2020-11-12-171003,171003,12,0,0,1344,9.2,2.8289292,3
2020-11-13-171003,171003,31,1,0,1375,7.0,2.0463545,4
2020-03-01-171006,171006,0,0,2,0,0.0,0.010260059,6
2020-03-02-171006,171006,0,0,1,0,0.5,0.0354085,0
2020-03-03-171006,171006,0,0,8,0,0.0,0.00017046134,1
2020-03-04-171006,171006,0,0,0,0,0.0,4.4815533e-05,2
2020-03-05-171006,171006,0,0,9,0,0.5,0.03157894,3
2020-03-06-171006,171006,0,0,5,0,0.0,0.004282055,4
2020-03-07-171006,171006,0,0,1,0,0.0,0.0016137765,5
2020-03-08-171006,171006,0,0,4,0,0.0,1.677221e-05,6
2020-03-09-171006,171006,0,0,14,0,0.0,0.010082833,0
2020-03-10-171006,171006,0,0,7,0,0.0,0.022026768,1
2020-03-11-171006,171006,0,0,8,0,0.0,0.0073348563,2
2020-03-12-171006,171006,0,0,7,0,0.0,0.019235983,3
2020-03-13-171006,171006,0,0,4,0,0.5,0.04993817,4
2020-03-14-171006,171006,0,0,1,0,0.0,0.0066916742,5
2020-03-15-171006,171006,2,0,3,2,0.25,0.061970413,6
2020-03-16-171006,171006,1,0,5,3,3.5,0.17723894,0
2020-03-17-171006,171006,8,0,7,11,6.75,0.38958028,1
2020-03-18-171006,171006,0,0,5,11,7.5,0.22464508,2
2020-03-19-171006,171006,9,0,5,20,5.75,0.60611856,3
2020-03-20-171006,171006,5,0,3,25,10.5,0.42035413,4
2020-03-21-171006,171006,1,0,5,26,4.0,0.10154636,5
2020-03-22-171006,171006,4,0,3,30,7.25,0.22302787,6
2020-03-23-171006,171006,14,0,5,44,13.0,0.91172993,0
2020-03-24-171006,171006,7,0,5,51,9.0,0.5731943,1
2020-03-25-171006,171006,8,0,4,59,10.0,0.56573856,2
2020-03-26-171006,171006,7,0,1,66,9.25,0.64155227,3
2020-03-27-171006,171006,4,0,2,70,10.5,0.5545789,4
2020-03-28-171006,171006,1,0,0,71,4.25,0.19244874,5
2020-03-29-171006,171006,3,0,0,74,2.75,0.22756654,6
2020-03-30-171006,171006,5,0,1,79,5.75,0.4809658,0
2020-03-31-171006,171006,7,0,0,86,6.5,0.4506701,1
2020-04-01-171006,171006,5,0,3,91,8.5,0.38257268,2
2020-04-02-171006,171006,5,0,4,96,5.5,0.43725955,3
2020-04-03-171006,171006,3,0,3,99,5.0,0.32488945,4
2020-04-04-171006,171006,5,0,0,104,3.0,0.25570008,5
2020-04-05-171006,171006,3,0,0,107,4.0,0.12172856,6
2020-04-06-171006,171006,5,0,5,112,13.0,0.5994009,0
2020-04-07-171006,171006,5,0,1,117,3.75,0.3598929,1
2020-04-08-171006,171006,4,0,2,121,5.0,0.3505191,2
2020-04-09-171006,171006,1,0,2,122,2.75,0.17568153,3
2020-04-10-171006,171006,2,0,1,124,3.0,0.16782185,4
2020-04-11-171006,171006,0,0,1,124,4.25,0.071003735,5
2020-04-12-171006,171006,0,0,0,124,4.0,0.06131708,6
2020-04-13-171006,171006,1,0,3,125,5.5,0.31044766,0
2020-04-14-171006,171006,0,0,6,125,3.5,0.29182988,1
2020-04-15-171006,171006,3,1,2,128,3.0,0.3894199,2
2020-04-16-171006,171006,4,0,1,132,3.5,0.2734386,3
2020-04-17-171006,171006,3,0,0,135,5.0,0.306513,4
2020-04-18-171006,171006,0,0,0,135,1.5,0.10983406,5
2020-04-19-171006,171006,0,1,0,135,1.0,0.031206157,6
2020-04-20-171006,171006,5,0,4,140,8.5,0.62524885,0
2020-04-21-171006,171006,1,0,1,141,2.75,0.1711414,1
2020-04-22-171006,171006,2,0,3,143,2.0,0.4236839,2
2020-04-23-171006,171006,2,0,7,145,1.0,0.12949081,3
2020-04-24-171006,171006,1,0,1,146,3.5,0.22456384,4
2020-04-25-171006,171006,1,0,0,147,0.75,0.0670012,5
2020-04-26-171006,171006,0,0,0,147,0.5,0.043532796,6
2020-04-27-171006,171006,3,0,3,150,3.75,0.33281407,0
2020-04-28-171006,171006,6,0,1,156,3.0,0.29657456,1
2020-04-29-171006,171006,2,0,2,158,2.5,0.23823065,2
2020-04-30-171006,171006,1,0,2,159,3.0,0.09591085,3
2020-05-01-171006,171006,0,0,0,159,1.25,0.014714922,4
2020-05-02-171006,171006,0,0,1,159,2.75,0.06305209,5
2020-05-03-171006,171006,0,0,0,159,1.75,0.021826595,6
2020-05-04-171006,171006,4,0,1,163,4.75,0.23647277,0
2020-05-05-171006,171006,1,0,0,164,3.25,0.20558095,1
2020-05-06-171006,171006,3,0,3,167,5.25,0.33869952,2
2020-05-07-171006,171006,7,0,1,174,3.0,0.444822,3
2020-05-08-171006,171006,1,0,4,175,2.75,0.2522823,4
2020-05-09-171006,171006,0,0,0,175,0.25,0.013948514,5
2020-05-10-171006,171006,0,1,0,175,0.25,0.019901117,6
2020-05-11-171006,171006,3,0,3,178,3.75,0.3020365,0
2020-05-12-171006,171006,1,0,1,179,2.5,0.17523424,1
2020-05-13-171006,171006,2,0,2,181,2.0,0.1704931,2
2020-05-14-171006,171006,2,0,3,183,3.75,0.28500843,3
2020-05-15-171006,171006,0,0,1,183,1.0,0.076864325,4
2020-05-16-171006,171006,1,0,0,184,1.75,0.09040041,5
2020-05-17-171006,171006,0,0,0,184,1.25,0.010395436,6
2020-05-18-171006,171006,1,0,5,185,4.25,0.30317736,0
2020-05-19-171006,171006,0,0,1,185,3.75,0.17797647,1
2020-05-20-171006,171006,3,0,2,188,3.75,0.2887579,2
2020-05-21-171006,171006,1,0,2,189,3.75,0.2343557,3
2020-05-22-171006,171006,4,0,2,193,1.5,0.25810114,4
2020-05-23-171006,171006,0,0,0,193,2.0,0.08368526,5
2020-05-24-171006,171006,0,0,1,193,0.75,0.028273812,6
2020-05-25-171006,171006,3,0,1,196,3.5,0.32569498,0
2020-05-26-171006,171006,1,0,1,197,2.0,0.18265355,1
2020-05-27-171006,171006,2,0,1,199,3.75,0.27174383,2
2020-05-28-171006,171006,3,0,8,202,1.0,0.21763866,3
2020-05-29-171006,171006,1,0,0,203,1.25,0.12459685,4
2020-05-30-171006,171006,0,0,0,203,0.25,0.020179646,5
2020-05-31-171006,171006,0,0,0,203,0.5,0.0037207312,6
2020-06-01-171006,171006,5,0,5,208,2.0,0.30528733,0
2020-06-02-171006,171006,1,0,1,209,0.75,0.1602883,1
2020-06-03-171006,171006,2,0,1,211,1.0,0.19701979,2
2020-06-04-171006,171006,2,0,3,213,0.25,0.15280105,3
2020-06-05-171006,171006,2,2,3,215,1.25,0.14371489,4
2020-06-06-171006,171006,0,0,1,215,0.0,0.013369684,5
2020-06-07-171006,171006,1,0,0,216,0.5,0.040251117,6
2020-06-08-171006,171006,1,0,2,217,1.75,0.13731588,0
2020-06-09-171006,171006,1,0,1,218,2.0,0.10275117,1
2020-06-10-171006,171006,1,0,1,219,0.75,0.12344333,2
2020-06-11-171006,171006,8,0,1,227,1.25,0.3256153,3
2020-06-12-171006,171006,0,0,2,227,0.5,0.04510928,4
2020-06-13-171006,171006,0,0,0,227,0.0,0.015359207,5
2020-06-14-171006,171006,0,0,0,227,0.0,0.00048913306,6
2020-06-15-171006,171006,5,0,1,232,0.75,0.29386055,0
2020-06-16-171006,171006,1,0,1,233,1.25,0.12770428,1
2020-06-17-171006,171006,1,0,4,234,1.0,0.10026888,2
2020-06-18-171006,171006,3,0,1,237,0.0,0.15282507,3
2020-06-19-171006,171006,3,0,1,240,2.5,0.25778413,4
2020-06-20-171006,171006,1,0,0,241,0.0,0.05795321,5
2020-06-21-171006,171006,0,0,0,241,0.5,0.027638238,6
2020-06-22-171006,171006,2,0,2,243,0.75,0.13202377,0
2020-06-23-171006,171006,1,0,1,244,0.75,0.088493876,1
2020-06-24-171006,171006,1,0,1,245,1.75,0.17383932,2
2020-06-25-171006,171006,1,0,0,246,1.25,0.14901884,3
2020-06-26-171006,171006,2,0,0,248,0.75,0.24010073,4
2020-06-27-171006,171006,0,0,0,248,0.25,0.05562101,5
2020-06-28-171006,171006,0,0,0,248,0.0,0.03070675,6
2020-06-29-171006,171006,1,0,0,249,1.25,0.09183424,0
2020-06-30-171006,171006,1,0,0,250,0.5,0.07199289,1
2020-07-01-171006,171006,4,0,1,254,0.25,0.27946067,2
2020-07-02-171006,171006,1,0,5,255,0.5,0.09566931,3
2020-07-03-171006,171006,1,0,1,256,2.0,0.08859309,4
2020-07-04-171006,171006,0,0,0,256,0.5,0.021796267,5
2020-07-05-171006,171006,0,0,0,256,0.0,0.0009854267,6
2020-07-06-171006,171006,2,0,2,258,1.25,0.14139597,0
2020-07-07-171006,171006,1,0,3,259,0.5,0.040686876,1
2020-07-08-171006,171006,1,0,0,260,1.5,0.10188901,2
2020-07-09-171006,171006,0,0,1,260,0.75,0.099390775,3
2020-07-10-171006,171006,0,0,6,260,0.5,0.01566478,4
2020-07-11-171006,171006,0,0,1,260,0.0,0.004452257,5
2020-07-12-171006,171006,0,0,1,260,0.0,0.0021164552,6
2020-07-13-171006,171006,0,0,10,260,0.25,0.022564927,0
2020-07-14-171006,171006,0,0,14,260,0.75,0.06977244,1
2020-07-15-171006,171006,1,0,7,261,0.75,0.08061083,2
2020-07-16-171006,171006,5,0,12,266,1.0,0.41614398,3
2020-07-17-171006,171006,1,0,11,267,0.75,0.101231,4
2020-07-18-171006,171006,0,0,0,267,0.25,0.019902918,5
2020-07-19-171006,171006,0,0,0,267,0.75,0.0121613,6
2020-07-20-171006,171006,2,0,7,269,0.5,0.11912205,0
2020-07-21-171006,171006,3,0,9,272,1.25,0.16487841,1
2020-07-22-171006,171006,0,0,10,272,0.75,0.03939071,2
2020-07-23-171006,171006,1,0,7,273,1.25,0.15835905,3
2020-07-24-171006,171006,6,0,7,279,1.25,0.37572083,4
2020-07-25-171006,171006,1,0,2,280,0.5,0.096076466,5
2020-07-26-171006,171006,1,0,3,281,0.5,0.053454462,6
2020-07-27-171006,171006,10,0,1,291,0.5,0.5803137,0
2020-07-28-171006,171006,14,0,3,305,1.5,0.702722,1
2020-07-29-171006,171006,7,0,4,312,1.25,0.30967516,2
2020-07-30-171006,171006,12,0,2,324,1.25,0.68397295,3
2020-07-31-171006,171006,11,0,3,335,0.75,0.41690928,4
2020-08-01-171006,171006,0,0,1,335,0.75,0.025060812,5
2020-08-02-171006,171006,0,0,1,335,0.5,0.0205957,6
2020-08-03-171006,171006,7,0,2,342,2.25,0.34461236,0
2020-08-04-171006,171006,9,0,1,351,1.25,0.26720348,1
2020-08-05-171006,171006,10,0,3,361,1.5,0.46498764,2
2020-08-06-171006,171006,7,0,6,368,1.5,0.31904152,3
2020-08-07-171006,171006,7,0,1,375,1.75,0.31538478,4
2020-08-08-171006,171006,2,0,0,377,0.5,0.092183486,5
2020-08-09-171006,171006,3,0,0,380,1.0,0.107042566,6
2020-08-10-171006,171006,1,0,4,381,1.75,0.08050608,0
2020-08-11-171006,171006,3,0,2,384,2.0,0.2675803,1
2020-08-12-171006,171006,4,0,9,388,1.75,0.21239713,2
2020-08-13-171006,171006,2,0,2,390,2.0,0.13849963,3
2020-08-14-171006,171006,3,0,1,393,1.5,0.27448928,4
2020-08-15-171006,171006,1,0,0,394,1.5,0.20579909,5
2020-08-16-171006,171006,1,0,3,395,0.5,0.064816765,6
2020-08-17-171006,171006,2,0,1,397,1.25,0.31394783,0
2020-08-18-171006,171006,1,0,2,398,2.75,0.3385813,1
2020-08-19-171006,171006,3,0,9,401,3.25,0.57123315,2
2020-08-20-171006,171006,6,0,7,407,2.75,0.39564764,3
2020-08-21-171006,171006,1,0,3,408,5.75,0.72400516,4
2020-08-22-171006,171006,0,0,3,408,2.0,0.23166512,5
2020-08-23-171006,171006,0,1,0,408,1.25,0.11609369,6
2020-08-24-171006,171006,4,0,11,412,2.0,0.36426613,0
2020-08-25-171006,171006,2,0,11,414,4.0,0.42316237,1
2020-08-26-171006,171006,9,0,6,423,4.0,0.493133,2
2020-08-27-171006,171006,2,0,14,425,2.0,0.19039075,3
2020-08-28-171006,171006,1,0,9,426,5.0,0.43191803,4
2020-08-29-171006,171006,0,0,9,426,0.75,0.20722517,5
2020-08-30-171006,171006,3,0,5,429,0.5,0.16526498,6
2020-08-31-171006,171006,1,0,18,430,2.75,0.3814924,0
2020-09-01-171006,171006,2,0,18,432,2.75,0.37336028,1
2020-09-02-171006,171006,9,0,19,441,8.0,0.5496431,2
2020-09-03-171006,171006,7,0,21,448,5.5,0.8270917,3
2020-09-04-171006,171006,3,0,7,451,6.0,0.6765288,4
2020-09-05-171006,171006,3,0,11,454,4.5,0.58479214,5
2020-09-06-171006,171006,0,0,3,454,9.25,0.35254198,6
2020-09-07-171006,171006,11,0,11,465,6.0,1.2239319,0
2020-09-08-171006,171006,11,0,11,476,9.5,0.8331389,1
2020-09-09-171006,171006,6,0,20,482,6.75,0.84652114,2
2020-09-10-171006,171006,14,0,16,496,3.75,0.9389424,3
2020-09-11-171006,171006,9,0,16,505,10.25,1.0579307,4
2020-09-12-171006,171006,9,0,12,514,3.0,0.59592,5
2020-09-13-171006,171006,5,0,3,519,2.75,0.19454858,6
2020-09-14-171006,171006,18,0,10,537,5.0,0.9835997,0
2020-09-15-171006,171006,18,0,10,555,10.25,1.1945728,1
2020-09-16-171006,171006,19,0,7,574,4.75,0.97532606,2
2020-09-17-171006,171006,21,0,9,595,5.5,1.2045606,3
2020-09-18-171006,171006,7,0,12,602,5.25,0.9651941,4
2020-09-19-171006,171006,11,0,1,613,5.5,0.73064995,5
2020-09-20-171006,171006,3,0,10,616,3.5,0.20145999,6
2020-09-21-171006,171006,11,0,2,627,11.0,0.7373131,0
2020-09-22-171006,171006,11,0,17,638,10.25,0.6036626,1
2020-09-23-171006,171006,20,0,6,658,10.75,1.2640231,2
2020-09-24-171006,171006,16,0,6,674,6.75,1.4130759,3
2020-09-25-171006,171006,16,0,3,690,8.5,0.8176089,4
2020-09-26-171006,171006,12,0,1,702,9.75,0.84002316,5
2020-09-27-171006,171006,3,0,7,705,2.25,0.15471648,6
2020-09-28-171006,171006,10,0,4,715,3.25,0.70085657,0
2020-09-29-171006,171006,10,0,6,725,6.0,0.64623994,1
2020-09-30-171006,171006,7,0,6,732,5.25,0.6227791,2
2020-10-01-171006,171006,9,1,3,741,5.0,0.9332963,3
2020-10-02-171006,171006,12,0,12,753,7.75,0.7402086,4
2020-10-03-171006,171006,1,1,4,754,4.25,0.32850465,5
2020-10-04-171006,171006,10,1,5,764,1.25,0.48658755,6
2020-10-05-171006,171006,2,0,16,766,1.0,0.35721713,0
2020-10-06-171006,171006,17,0,10,783,7.25,1.3649749,1
2020-10-07-171006,171006,6,0,3,789,4.75,0.5954641,2
2020-10-08-171006,171006,6,0,7,795,11.5,0.7380133,3
2020-10-09-171006,171006,3,1,5,798,3.75,0.48607615,4
2020-10-10-171006,171006,1,0,6,799,4.25,0.31660664,5
2020-10-11-171006,171006,7,0,10,806,1.0,0.3058968,6
2020-10-12-171006,171006,4,0,16,810,2.25,0.16024013,0
2020-10-13-171006,171006,6,0,15,816,6.25,0.60821074,1
2020-10-14-171006,171006,6,0,15,822,3.25,0.6520833,2
2020-10-15-171006,171006,3,0,10,825,5.25,0.5872346,3
2020-10-16-171006,171006,12,0,7,837,6.5,0.4777415,4
2020-10-17-171006,171006,4,1,10,841,4.5,0.5359781,5
2020-10-18-171006,171006,5,1,4,846,3.5,0.31041837,6
2020-10-19-171006,171006,16,1,10,862,4.25,0.93290395,0
2020-10-20-171006,171006,10,0,8,872,7.0,0.9657411,1
2020-10-21-171006,171006,3,0,13,875,6.5,0.5187529,2
2020-10-22-171006,171006,7,0,10,882,6.25,0.6488999,3
2020-10-23-171006,171006,5,0,13,887,6.5,0.83539534,4
2020-10-24-171006,171006,6,0,10,893,9.5,0.9515887,5
2020-10-25-171006,171006,10,1,7,903,2.0,0.45375228,6
2020-10-26-171006,171006,16,0,11,919,6.0,1.1319646,0
2020-10-27-171006,171006,15,0,11,934,7.5,1.358557,1
2020-10-28-171006,171006,15,0,11,949,7.75,1.8219094,2
2020-10-29-171006,171006,10,0,5,959,7.75,1.6801937,3
2020-10-30-171006,171006,7,1,11,966,5.75,1.194665,4
2020-10-31-171006,171006,10,3,0,976,8.0,1.274761,5
2020-11-01-171006,171006,4,1,0,980,3.5,0.6230595,6
2020-11-02-171006,171006,10,1,0,990,4.25,0.6057089,0
2020-11-03-171006,171006,8,0,0,998,6.25,1.0150514,1
2020-11-04-171006,171006,13,0,0,1011,8.25,1.4121993,2
2020-11-05-171006,171006,10,0,0,1021,13.0,1.510269,3
2020-11-06-171006,171006,13,0,0,1034,10.0,1.5593978,4
2020-11-07-171006,171006,10,0,0,1044,3.75,0.86883545,5
2020-11-08-171006,171006,7,0,0,1051,4.5,0.42031202,6
2020-11-09-171006,171006,11,1,0,1062,7.75,0.8876739,0
2020-11-10-171006,171006,11,2,0,1073,12.75,1.1144674,1
2020-11-11-171006,171006,11,0,0,1084,6.25,1.0461799,2
2020-11-12-171006,171006,5,0,0,1089,6.5,0.78803504,3
2020-11-13-171006,171006,11,1,0,1100,10.25,1.052375,4
2020-03-01-171007,171007,0,0,0,0,0.0,0.0012372055,6
2020-03-02-171007,171007,0,0,0,0,0.0,0.0017871064,0
2020-03-03-171007,171007,0,1,5,0,0.3333333333333333,0.0009905699,1
2020-03-04-171007,171007,0,2,12,0,0.16666666666666666,0.0002789505,2
2020-03-05-171007,171007,0,0,24,0,0.0,0.0011545182,3
2020-03-06-171007,171007,0,0,7,0,0.16666666666666666,0.0045900997,4
2020-03-07-171007,171007,0,0,3,0,0.0,0.0014313105,5
2020-03-08-171007,171007,0,1,3,0,0.0,0.00046506833,6
2020-03-09-171007,171007,0,0,17,0,0.5,0.012509033,0
2020-03-10-171007,171007,0,0,11,0,0.3333333333333333,0.007031094,1
2020-03-11-171007,171007,1,0,13,1,0.16666666666666666,0.005352597,2
2020-03-12-171007,171007,1,0,17,2,0.6666666666666666,0.0077002645,3
2020-03-13-171007,171007,1,0,11,3,1.3333333333333333,0.024508849,4
2020-03-14-171007,171007,0,0,2,3,0.6666666666666666,0.0061948476,5
2020-03-15-171007,171007,0,0,2,3,0.6666666666666666,0.004485726,6
2020-03-16-171007,171007,0,0,10,3,4.833333333333333,0.0579194,0
2020-03-17-171007,171007,5,0,3,8,5.333333333333333,0.045026984,1
2020-03-18-171007,171007,12,3,7,20,8.666666666666666,0.060818486,2
2020-03-19-171007,171007,24,0,6,44,11.166666666666664,0.08443852,3
2020-03-20-171007,171007,7,0,3,51,12.833333333333336,0.06745093,4
2020-03-21-171007,171007,3,0,0,54,3.8333333333333335,0.012803041,5
2020-03-22-171007,171007,3,0,1,57,4.166666666666667,0.010548571,6
2020-03-23-171007,171007,17,0,3,74,18.33333333333333,0.11061344,0
2020-03-24-171007,171007,11,0,6,85,10.666666666666666,0.067534626,1
2020-03-25-171007,171007,13,0,3,98,15.0,0.06001962,2
2020-03-26-171007,171007,17,0,5,115,12.166666666666664,0.07569645,3
2020-03-27-171007,171007,11,1,2,126,11.166666666666664,0.06830614,4
2020-03-28-171007,171007,2,0,0,128,3.5,0.008628707,5
2020-03-29-171007,171007,2,0,3,130,3.0,0.00535184,6
2020-03-30-171007,171007,10,0,12,140,9.333333333333334,0.04323191,0
2020-03-31-171007,171007,3,0,16,143,6.833333333333332,0.0358074,1
2020-04-01-171007,171007,7,0,5,150,5.666666666666668,0.043223344,2
2020-04-02-171007,171007,6,0,1,156,4.833333333333333,0.070191175,3
2020-04-03-171007,171007,3,0,0,159,7.666666666666668,0.08781169,4
2020-04-04-171007,171007,0,0,0,159,2.333333333333333,0.007340732,5
2020-04-05-171007,171007,1,0,1,160,1.0,0.00342002,6
2020-04-06-171007,171007,3,0,2,163,6.333333333333332,0.05875919,0
2020-04-07-171007,171007,6,0,5,169,22.83333333333333,0.050893597,1
2020-04-08-171007,171007,3,0,1,172,11.0,0.048161548,2
2020-04-09-171007,171007,5,0,0,177,5.666666666666668,0.028225025,3
2020-04-10-171007,171007,2,0,2,179,5.0,0.010341696,4
2020-04-11-171007,171007,0,0,1,179,0.3333333333333333,0.0108667705,5
2020-04-12-171007,171007,3,0,0,182,1.3333333333333333,0.01370953,6
2020-04-13-171007,171007,12,0,4,194,11.5,0.047591988,0
2020-04-14-171007,171007,16,0,1,210,9.0,0.03658984,1
2020-04-15-171007,171007,5,0,3,215,4.666666666666667,0.04688878,2
2020-04-16-171007,171007,1,1,1,216,4.666666666666667,0.030239075,3
2020-04-17-171007,171007,0,0,0,216,3.5,0.03347354,4
2020-04-18-171007,171007,0,0,0,216,0.8333333333333334,0.0029578647,5
2020-04-19-171007,171007,1,0,2,217,0.5,0.0012475842,6
2020-04-20-171007,171007,2,0,2,219,5.5,0.037483376,0
2020-04-21-171007,171007,5,0,0,224,3.5,0.020260615,1
2020-04-22-171007,171007,1,0,0,225,4.166666666666667,0.025455302,2
2020-04-23-171007,171007,0,0,3,225,0.0,0.0011971394,3
2020-04-24-171007,171007,2,0,3,227,4.5,0.027104398,4
2020-04-25-171007,171007,1,0,0,228,0.3333333333333333,0.0013019622,5
2020-04-26-171007,171007,0,0,0,228,0.8333333333333334,0.0049507716,6
2020-04-27-171007,171007,4,0,0,232,4.166666666666667,0.026584286,0
2020-04-28-171007,171007,1,0,1,233,2.333333333333333,0.026410276,1
2020-04-29-171007,171007,3,0,1,236,2.333333333333333,0.036523074,2
2020-04-30-171007,171007,1,0,2,237,2.0,0.02229629,3
2020-05-01-171007,171007,0,0,1,237,0.3333333333333333,0.0036473742,4
2020-05-02-171007,171007,0,0,2,237,0.6666666666666666,0.004280951,5
2020-05-03-171007,171007,2,0,0,239,0.0,0.0014328337,6
2020-05-04-171007,171007,2,1,5,241,3.1666666666666665,0.025391784,0
2020-05-05-171007,171007,0,0,1,241,3.333333333333333,0.025414169,1
2020-05-06-171007,171007,0,0,2,241,3.8333333333333335,0.0465265,2
2020-05-07-171007,171007,3,0,1,244,2.5,0.031566177,3
2020-05-08-171007,171007,3,0,3,247,4.5,0.037766848,4
2020-05-09-171007,171007,0,0,1,247,0.16666666666666666,0.0068568666,5
2020-05-10-171007,171007,0,0,0,247,0.3333333333333333,0.0031538554,6
2020-05-11-171007,171007,0,0,1,247,5.666666666666668,0.03816971,0
2020-05-12-171007,171007,1,0,2,248,3.5,0.024088643,1
2020-05-13-171007,171007,1,0,0,249,0.5,0.03267612,2
2020-05-14-171007,171007,2,0,1,251,2.333333333333333,0.031540096,3
2020-05-15-171007,171007,1,0,2,252,4.666666666666667,0.022283131,4
2020-05-16-171007,171007,2,0,0,254,0.8333333333333334,0.0022031257,5
2020-05-17-171007,171007,0,0,0,254,0.0,0.00166037,6
2020-05-18-171007,171007,5,0,0,259,3.5,0.033046067,0
2020-05-19-171007,171007,1,0,1,260,2.1666666666666665,0.0247651,1
2020-05-20-171007,171007,2,0,0,262,2.333333333333333,0.027073244,2
2020-05-21-171007,171007,1,0,2,263,2.6666666666666665,0.03512545,3
2020-05-22-171007,171007,3,0,2,266,1.6666666666666667,0.02948492,4
2020-05-23-171007,171007,1,0,0,267,0.6666666666666666,0.00033227899,5
2020-05-24-171007,171007,0,0,0,267,0.0,0.0007187662,6
2020-05-25-171007,171007,1,0,0,268,3.1666666666666665,0.03223552,0
2020-05-26-171007,171007,2,0,1,270,3.1666666666666665,0.019921938,1
2020-05-27-171007,171007,0,0,3,270,2.0,0.024718748,2
2020-05-28-171007,171007,1,9,0,271,1.5,0.023053208,3
2020-05-29-171007,171007,2,1,1,273,2.0,0.032617334,4
2020-05-30-171007,171007,0,0,0,273,0.16666666666666666,0.0037827084,5
2020-05-31-171007,171007,0,0,0,273,0.0,0.0038776551,6
2020-06-01-171007,171007,0,0,1,273,2.333333333333333,0.038690493,0
2020-06-02-171007,171007,1,0,10,274,2.5,0.026038444,1
2020-06-03-171007,171007,0,0,1,274,1.6666666666666667,0.022645738,2
2020-06-04-171007,171007,2,0,1,276,2.333333333333333,0.019789035,3
2020-06-05-171007,171007,2,0,2,278,1.1666666666666667,0.012854583,4
2020-06-06-171007,171007,0,0,0,278,0.16666666666666666,0.0016398008,5
2020-06-07-171007,171007,0,1,0,278,0.0,0.0015059733,6
2020-06-08-171007,171007,0,0,0,278,1.5,0.02966988,0
2020-06-09-171007,171007,1,0,1,279,0.8333333333333334,0.02413596,1
2020-06-10-171007,171007,3,0,0,282,1.1666666666666667,0.032911006,2
2020-06-11-171007,171007,0,0,0,282,1.6666666666666667,0.034589153,3
2020-06-12-171007,171007,1,0,2,283,1.5,0.017842876,4
2020-06-13-171007,171007,0,0,0,283,0.16666666666666666,0.0017874659,5
2020-06-14-171007,171007,0,0,0,283,0.0,0.00093077915,6
2020-06-15-171007,171007,1,0,5,284,1.8333333333333333,0.032785185,0
2020-06-16-171007,171007,10,0,1,294,1.3333333333333333,0.03794653,1
2020-06-17-171007,171007,1,1,0,295,1.8333333333333333,0.022451645,2
2020-06-18-171007,171007,1,0,0,296,2.1666666666666665,0.026150258,3
2020-06-19-171007,171007,2,0,1,298,1.1666666666666667,0.037518207,4
2020-06-20-171007,171007,0,0,0,298,0.0,0.004968012,5
2020-06-21-171007,171007,0,0,0,298,0.0,0.0012986254,6
2020-06-22-171007,171007,0,0,0,298,0.6666666666666666,0.018215789,0
2020-06-23-171007,171007,1,0,1,299,0.6666666666666666,0.027515344,1
2020-06-24-171007,171007,0,0,1,299,1.0,0.008586204,2
2020-06-25-171007,171007,0,0,1,299,0.6666666666666666,0.010486528,3
2020-06-26-171007,171007,2,0,0,301,1.1666666666666667,0.014636368,4
2020-06-27-171007,171007,0,0,0,301,0.0,0.0052846465,5
2020-06-28-171007,171007,0,0,0,301,0.0,0.003976634,6
2020-06-29-171007,171007,5,0,1,306,1.6666666666666667,0.022795336,0
2020-06-30-171007,171007,1,0,1,307,1.0,0.0111983195,1
2020-07-01-171007,171007,0,0,1,307,0.0,0.0134353265,2
2020-07-02-171007,171007,0,0,0,307,0.3333333333333333,0.0092478,3
2020-07-03-171007,171007,1,0,0,308,0.6666666666666666,0.014918361,4
2020-07-04-171007,171007,0,0,0,308,0.0,0.0012893351,5
2020-07-05-171007,171007,0,0,0,308,0.0,0.0023042974,6
2020-07-06-171007,171007,0,0,0,308,1.1666666666666667,0.01632568,0
2020-07-07-171007,171007,1,0,0,309,0.5,0.013938889,1
2020-07-08-171007,171007,1,0,0,310,1.3333333333333333,0.0037237552,2
2020-07-09-171007,171007,1,0,0,311,0.8333333333333334,0.0045692,3
2020-07-10-171007,171007,0,0,0,311,1.3333333333333333,0.012364709,4
2020-07-11-171007,171007,0,1,0,311,0.0,0.0008658095,5
2020-07-12-171007,171007,0,0,0,311,0.0,0.003187395,6
2020-07-13-171007,171007,1,0,0,312,0.6666666666666666,0.012618271,0
2020-07-14-171007,171007,1,0,0,313,0.16666666666666666,0.006557187,1
2020-07-15-171007,171007,1,0,0,314,1.1666666666666667,0.00844248,2
2020-07-16-171007,171007,0,0,1,314,0.5,0.0058874097,3
2020-07-17-171007,171007,0,0,0,314,0.3333333333333333,0.021910958,4
2020-07-18-171007,171007,0,0,0,314,0.0,0.00085762265,5
2020-07-19-171007,171007,0,0,0,314,0.16666666666666666,0.0048146495,6
2020-07-20-171007,171007,0,0,0,314,0.6666666666666666,0.011787506,0
2020-07-21-171007,171007,0,0,1,314,0.5,0.021212375,1
2020-07-22-171007,171007,0,0,0,314,0.3333333333333333,0.007141725,2
2020-07-23-171007,171007,0,0,2,314,0.6666666666666666,0.024822671,3
2020-07-24-171007,171007,0,0,0,314,1.1666666666666667,0.015277688,4
2020-07-25-171007,171007,0,0,0,314,0.16666666666666666,0.004079388,5
2020-07-26-171007,171007,0,0,0,314,0.0,0.0008855128,6
2020-07-27-171007,171007,0,0,2,314,0.16666666666666666,0.04078794,0
2020-07-28-171007,171007,0,0,1,314,0.16666666666666666,0.00837997,1
2020-07-29-171007,171007,0,0,1,314,0.6666666666666666,0.012433545,2
2020-07-30-171007,171007,1,0,2,315,0.8333333333333334,0.019096093,3
2020-07-31-171007,171007,0,0,0,315,1.3333333333333333,0.021736553,4
2020-08-01-171007,171007,0,0,1,315,0.0,0.0025274963,5
2020-08-02-171007,171007,0,0,3,315,0.16666666666666666,0.008258288,6
2020-08-03-171007,171007,0,0,2,315,2.333333333333333,0.016535204,0
2020-08-04-171007,171007,1,0,1,316,0.5,0.018555444,1
2020-08-05-171007,171007,0,0,2,316,1.3333333333333333,0.040904976,2
2020-08-06-171007,171007,2,0,2,318,1.3333333333333333,0.018123055,3
2020-08-07-171007,171007,0,0,3,318,2.1666666666666665,0.0151444515,4
2020-08-08-171007,171007,0,0,0,318,1.1666666666666667,0.020404961,5
2020-08-09-171007,171007,0,0,1,318,2.333333333333333,0.009123916,6
2020-08-10-171007,171007,2,0,0,320,2.6666666666666665,0.01853704,0
2020-08-11-171007,171007,1,0,3,321,1.8333333333333333,0.044684827,1
2020-08-12-171007,171007,1,0,1,322,3.0,0.022432476,2
2020-08-13-171007,171007,2,0,0,324,1.8333333333333333,0.038044315,3
2020-08-14-171007,171007,0,0,5,324,1.5,0.044361636,4
2020-08-15-171007,171007,1,0,4,325,0.3333333333333333,0.014066911,5
2020-08-16-171007,171007,3,0,2,328,4.666666666666667,0.018573105,6
2020-08-17-171007,171007,2,0,6,330,1.8333333333333333,0.054146893,0
2020-08-18-171007,171007,1,0,9,331,2.833333333333333,0.04793773,1
2020-08-19-171007,171007,2,0,5,333,3.8333333333333335,0.059924703,2
2020-08-20-171007,171007,2,0,1,335,6.5,0.057463087,3
2020-08-21-171007,171007,3,0,13,338,4.0,0.079231955,4
2020-08-22-171007,171007,0,0,6,338,4.166666666666667,0.022091681,5
2020-08-23-171007,171007,1,0,7,339,2.1666666666666665,0.019159196,6
2020-08-24-171007,171007,0,0,12,339,4.333333333333333,0.069991685,0
2020-08-25-171007,171007,3,0,0,342,3.6666666666666665,0.11729563,1
2020-08-26-171007,171007,1,0,1,343,4.166666666666667,0.071328714,2
2020-08-27-171007,171007,0,0,5,343,6.666666666666668,0.11144381,3
2020-08-28-171007,171007,5,0,4,348,4.833333333333333,0.11744909,4
2020-08-29-171007,171007,4,0,1,352,4.833333333333333,0.027824372,5
2020-08-30-171007,171007,2,0,1,354,1.5,0.053808287,6
2020-08-31-171007,171007,6,0,2,360,3.333333333333333,0.04725081,0
2020-09-01-171007,171007,9,0,2,369,2.6666666666666665,0.040519305,1
2020-09-02-171007,171007,5,0,6,374,3.333333333333333,0.05826345,2
2020-09-03-171007,171007,1,0,11,375,5.5,0.06385469,3
2020-09-04-171007,171007,13,0,4,388,3.1666666666666665,0.06651944,4
2020-09-05-171007,171007,6,0,3,394,6.5,0.033336017,5
2020-09-06-171007,171007,7,0,0,401,7.166666666666668,0.039911065,6
2020-09-07-171007,171007,12,2,1,413,9.833333333333334,0.08270973,0
2020-09-08-171007,171007,0,0,3,413,1.8333333333333333,0.07508858,1
2020-09-09-171007,171007,1,0,10,414,5.833333333333332,0.119953305,2
2020-09-10-171007,171007,5,0,2,419,11.833333333333336,0.144414,3
2020-09-11-171007,171007,4,0,5,423,9.166666666666666,0.11438666,4
2020-09-12-171007,171007,1,0,1,424,3.333333333333333,0.04591844,5
2020-09-13-171007,171007,1,0,0,425,3.5,0.030021066,6
2020-09-14-171007,171007,2,0,0,427,8.5,0.11922456,0
2020-09-15-171007,171007,2,0,3,429,6.0,0.15882154,1
2020-09-16-171007,171007,6,0,1,435,10.333333333333334,0.15736201,2
2020-09-17-171007,171007,11,0,2,446,7.666666666666668,0.15602519,3
2020-09-18-171007,171007,4,0,4,450,5.666666666666668,0.15983926,4
2020-09-19-171007,171007,3,0,1,453,3.333333333333333,0.12908162,5
2020-09-20-171007,171007,0,0,1,453,2.6666666666666665,0.034980122,6
2020-09-21-171007,171007,1,1,0,454,4.833333333333333,0.099031806,0
2020-09-22-171007,171007,3,0,2,457,4.5,0.09973159,1
2020-09-23-171007,171007,10,1,2,467,7.833333333333332,0.11822019,2
2020-09-24-171007,171007,2,0,0,469,4.166666666666667,0.16354592,3
2020-09-25-171007,171007,5,0,0,474,7.0,0.14566366,4
2020-09-26-171007,171007,1,0,0,475,2.5,0.0809237,5
2020-09-27-171007,171007,0,0,1,475,1.5,0.039490003,6
2020-09-28-171007,171007,0,0,1,475,2.6666666666666665,0.07674692,0
2020-09-29-171007,171007,3,0,3,478,3.6666666666666665,0.08122832,1
2020-09-30-171007,171007,1,0,3,479,4.333333333333333,0.08019897,2
2020-10-01-171007,171007,2,0,3,481,3.6666666666666665,0.12874842,3
2020-10-02-171007,171007,4,0,4,485,7.166666666666668,0.09378676,4
2020-10-03-171007,171007,1,0,1,486,2.5,0.041948263,5
2020-10-04-171007,171007,1,1,0,487,2.0,0.026736848,6
2020-10-05-171007,171007,0,0,3,487,3.8333333333333335,0.104161344,0
2020-10-06-171007,171007,2,0,10,489,5.666666666666668,0.16262117,1
2020-10-07-171007,171007,2,0,12,491,5.333333333333333,0.119797796,2
2020-10-08-171007,171007,0,0,5,491,7.5,0.19469425,3
2020-10-09-171007,171007,0,0,12,491,7.5,0.15693869,4
2020-10-10-171007,171007,0,0,12,491,4.0,0.05503569,5
2020-10-11-171007,171007,1,0,2,492,1.3333333333333333,0.04534428,6
2020-10-12-171007,171007,1,0,18,493,2.333333333333333,0.042722937,0
2020-10-13-171007,171007,3,0,1,496,2.5,0.14680357,1
2020-10-14-171007,171007,3,0,12,499,4.833333333333333,0.1402306,2
2020-10-15-171007,171007,3,0,13,502,5.333333333333333,0.11641234,3
2020-10-16-171007,171007,4,0,15,506,9.5,0.15972838,4
2020-10-17-171007,171007,1,0,8,507,4.333333333333333,0.07184994,5
2020-10-18-171007,171007,0,0,2,507,2.1666666666666665,0.05829023,6
2020-10-19-171007,171007,3,0,0,510,6.166666666666668,0.109592274,0
2020-10-20-171007,171007,10,0,4,520,6.666666666666668,0.18235222,1
2020-10-21-171007,171007,12,0,6,532,10.0,0.14250663,2
2020-10-22-171007,171007,5,0,11,537,11.333333333333336,0.14053597,3
2020-10-23-171007,171007,12,0,19,549,16.666666666666668,0.23999563,4
2020-10-24-171007,171007,12,0,3,561,4.666666666666667,0.07550501,5
2020-10-25-171007,171007,2,0,3,563,6.666666666666668,0.037105802,6
2020-10-26-171007,171007,18,0,8,581,17.333333333333332,0.22128953,0
2020-10-27-171007,171007,1,0,6,582,14.333333333333336,0.21682939,1
2020-10-28-171007,171007,12,0,11,594,13.166666666666664,0.2328158,2
2020-10-29-171007,171007,13,0,6,607,13.5,0.18892956,3
2020-10-30-171007,171007,15,0,10,622,16.333333333333332,0.29548386,4
2020-10-31-171007,171007,8,0,0,630,9.0,0.08205046,5
2020-11-01-171007,171007,2,0,0,632,5.166666666666667,0.052708082,6
2020-11-02-171007,171007,0,0,0,632,2.1666666666666665,0.053482093,0
2020-11-03-171007,171007,4,0,0,636,11.166666666666664,0.16542706,1
2020-11-04-171007,171007,6,1,0,642,12.5,0.23147087,2
2020-11-05-171007,171007,11,0,0,653,15.0,0.22646351,3
2020-11-06-171007,171007,19,0,0,672,10.666666666666666,0.20549367,4
2020-11-07-171007,171007,3,0,0,675,13.0,0.06486166,5
2020-11-08-171007,171007,3,1,0,678,6.333333333333332,0.040947404,6
2020-11-09-171007,171007,8,1,0,686,10.333333333333334,0.12252687,0
2020-11-10-171007,171007,6,1,0,692,7.833333333333332,0.14914756,1
2020-11-11-171007,171007,11,0,0,703,13.666666666666664,0.18041587,2
2020-11-12-171007,171007,6,0,0,709,11.0,0.18941358,3
2020-11-13-171007,171007,10,0,0,719,14.666666666666664,0.1674691,4
2020-03-01-171008,171008,0,0,0,0,0.0,0.0029756718,6
2020-03-02-171008,171008,0,0,6,0,0.0,0.0022232933,0
2020-03-03-171008,171008,0,0,7,0,0.3333333333333333,0.0017448902,1
2020-03-04-171008,171008,0,2,5,0,0.5,0.000619489,2
2020-03-05-171008,171008,1,0,8,1,0.0,0.002392712,3
2020-03-06-171008,171008,0,0,11,1,0.0,0.0067936564,4
2020-03-07-171008,171008,1,0,6,2,0.0,0.0009914534,5
2020-03-08-171008,171008,0,0,6,2,0.16666666666666666,0.0005854656,6
2020-03-09-171008,171008,0,0,11,2,0.3333333333333333,0.02051475,0
2020-03-10-171008,171008,0,0,22,2,0.16666666666666666,0.00857938,1
2020-03-11-171008,171008,0,0,10,2,0.16666666666666666,0.010388302,2
2020-03-12-171008,171008,0,0,13,2,0.5,0.0133058345,3
2020-03-13-171008,171008,0,0,3,2,0.5,0.052988783,4
2020-03-14-171008,171008,1,0,4,3,0.16666666666666666,0.013605844,5
2020-03-15-171008,171008,0,0,3,3,1.5,0.015824724,6
2020-03-16-171008,171008,6,1,14,9,6.5,0.1476385,0
2020-03-17-171008,171008,7,1,10,16,9.0,0.10580536,1
2020-03-18-171008,171008,5,0,10,21,10.166666666666666,0.13493282,2
2020-03-19-171008,171008,8,0,7,29,14.333333333333336,0.2023695,3
2020-03-20-171008,171008,11,0,5,40,16.333333333333332,0.16243888,4
2020-03-21-171008,171008,6,1,3,46,3.333333333333333,0.02584212,5
2020-03-22-171008,171008,6,0,1,52,5.333333333333333,0.027633041,6
2020-03-23-171008,171008,11,0,11,63,20.666666666666668,0.24409008,0
2020-03-24-171008,171008,22,0,3,85,12.0,0.13761476,1
2020-03-25-171008,171008,10,0,6,95,14.833333333333336,0.11865481,2
2020-03-26-171008,171008,13,0,3,108,17.833333333333332,0.17049721,3
2020-03-27-171008,171008,3,0,4,111,15.833333333333336,0.15069489,4
2020-03-28-171008,171008,4,1,2,115,2.5,0.020554591,5
2020-03-29-171008,171008,3,0,3,118,2.0,0.013919363,6
2020-03-30-171008,171008,14,0,6,132,15.333333333333336,0.09608393,0
2020-03-31-171008,171008,10,0,6,142,9.5,0.07123068,1
2020-04-01-171008,171008,10,0,8,152,9.333333333333334,0.10558137,2
2020-04-02-171008,171008,7,0,5,159,9.166666666666666,0.14019339,3
2020-04-03-171008,171008,5,0,1,164,17.5,0.24431492,4
2020-04-04-171008,171008,3,0,0,167,2.5,0.014819009,5
2020-04-05-171008,171008,1,2,0,168,1.5,0.0068538613,6
2020-04-06-171008,171008,11,0,1,179,13.0,0.12378491,0
2020-04-07-171008,171008,3,0,2,182,9.833333333333334,0.13441359,1
2020-04-08-171008,171008,6,0,1,188,11.666666666666664,0.10984691,2
2020-04-09-171008,171008,3,0,0,191,7.5,0.08818542,3
2020-04-10-171008,171008,4,0,4,195,5.0,0.031951707,4
2020-04-11-171008,171008,2,0,0,197,1.5,0.024177928,5
2020-04-12-171008,171008,3,0,0,200,2.6666666666666665,0.040664263,6
2020-04-13-171008,171008,6,0,3,206,7.833333333333332,0.10956522,0
2020-04-14-171008,171008,6,0,0,212,7.833333333333332,0.091304176,1
2020-04-15-171008,171008,8,0,1,220,7.833333333333332,0.09725184,2
2020-04-16-171008,171008,5,0,1,225,6.166666666666668,0.06552873,3
2020-04-17-171008,171008,1,0,1,226,5.333333333333333,0.060048383,4
2020-04-18-171008,171008,0,0,0,226,1.0,0.0034751238,5
2020-04-19-171008,171008,0,0,0,226,0.8333333333333334,0.003057022,6
2020-04-20-171008,171008,1,0,1,227,6.833333333333332,0.08359225,0
2020-04-21-171008,171008,2,0,4,229,5.5,0.054585904,1
2020-04-22-171008,171008,1,0,2,230,4.666666666666667,0.048426963,2
2020-04-23-171008,171008,0,0,1,230,0.16666666666666666,0.002664402,3
2020-04-24-171008,171008,4,0,3,234,4.0,0.057091203,4
2020-04-25-171008,171008,0,0,0,234,0.16666666666666666,0.0033297266,5
2020-04-26-171008,171008,0,1,0,234,1.3333333333333333,0.00959424,6
2020-04-27-171008,171008,3,1,2,237,5.166666666666667,0.06668577,0
2020-04-28-171008,171008,0,0,1,237,3.333333333333333,0.05426925,1
2020-04-29-171008,171008,1,0,0,238,3.6666666666666665,0.07547344,2
2020-04-30-171008,171008,1,0,2,239,4.666666666666667,0.057035822,3
2020-05-01-171008,171008,1,0,2,240,1.0,0.015297029,4
2020-05-02-171008,171008,0,0,0,240,0.6666666666666666,0.014470416,5
2020-05-03-171008,171008,0,0,0,240,0.16666666666666666,0.002209492,6
2020-05-04-171008,171008,1,0,1,241,4.5,0.049397927,0
2020-05-05-171008,171008,4,0,0,245,4.166666666666667,0.060198028,1
2020-05-06-171008,171008,2,0,5,247,4.666666666666667,0.1011026,2
2020-05-07-171008,171008,1,0,2,248,3.333333333333333,0.064168,3
2020-05-08-171008,171008,3,0,1,251,5.666666666666668,0.074898474,4
2020-05-09-171008,171008,0,0,0,251,0.6666666666666666,0.014685536,5
2020-05-10-171008,171008,0,0,0,251,0.6666666666666666,0.0071985717,6
2020-05-11-171008,171008,2,0,4,253,4.333333333333333,0.08162329,0
2020-05-12-171008,171008,1,1,2,254,3.1666666666666665,0.05457495,1
2020-05-13-171008,171008,0,0,2,254,1.8333333333333333,0.066258386,2
2020-05-14-171008,171008,2,0,0,256,3.8333333333333335,0.07533035,3
2020-05-15-171008,171008,2,1,4,258,2.333333333333333,0.049387746,4
2020-05-16-171008,171008,0,0,0,258,0.5,0.0033237312,5
2020-05-17-171008,171008,0,0,0,258,0.0,0.0023398644,6
2020-05-18-171008,171008,1,0,2,259,4.333333333333333,0.05650532,0
2020-05-19-171008,171008,0,0,3,259,3.0,0.051025663,1
2020-05-20-171008,171008,5,0,3,264,4.5,0.06527232,2
2020-05-21-171008,171008,2,0,2,266,2.5,0.07640476,3
2020-05-22-171008,171008,1,0,0,267,2.0,0.06051545,4
2020-05-23-171008,171008,0,0,0,267,0.5,0.0009718508,5
2020-05-24-171008,171008,0,0,0,267,0.0,0.0011193973,6
2020-05-25-171008,171008,4,0,0,271,2.6666666666666665,0.060814105,0
2020-05-26-171008,171008,2,0,1,273,1.5,0.03671363,1
2020-05-27-171008,171008,2,2,1,275,2.6666666666666665,0.039168674,2
2020-05-28-171008,171008,0,0,0,275,2.0,0.043759592,3
2020-05-29-171008,171008,4,0,0,279,1.6666666666666667,0.056343906,4
2020-05-30-171008,171008,0,0,0,279,0.0,0.007282464,5
2020-05-31-171008,171008,0,0,0,279,0.0,0.006983454,6
2020-06-01-171008,171008,2,0,2,281,2.333333333333333,0.08315485,0
2020-06-02-171008,171008,3,0,1,284,2.0,0.052647352,1
2020-06-03-171008,171008,3,0,1,287,2.333333333333333,0.05005534,2
2020-06-04-171008,171008,2,0,0,289,2.6666666666666665,0.039295744,3
2020-06-05-171008,171008,0,0,1,289,1.6666666666666667,0.017550837,4
2020-06-06-171008,171008,0,0,0,289,0.16666666666666666,0.0036203905,5
2020-06-07-171008,171008,0,2,0,289,0.0,0.0029423286,6
2020-06-08-171008,171008,0,0,1,289,1.1666666666666667,0.05240753,0
2020-06-09-171008,171008,1,0,0,290,1.0,0.0417847,1
2020-06-10-171008,171008,1,1,0,291,2.6666666666666665,0.07463151,2
2020-06-11-171008,171008,0,0,0,291,2.6666666666666665,0.0737063,3
2020-06-12-171008,171008,0,0,0,291,1.1666666666666667,0.030891543,4
2020-06-13-171008,171008,0,1,0,291,0.16666666666666666,0.0025805123,5
2020-06-14-171008,171008,0,0,0,291,0.0,0.0018503987,6
2020-06-15-171008,171008,2,0,1,293,2.0,0.06348388,0
2020-06-16-171008,171008,1,0,0,294,1.3333333333333333,0.077783294,1
2020-06-17-171008,171008,1,0,2,295,1.6666666666666667,0.05535107,2
2020-06-18-171008,171008,0,0,0,295,2.0,0.049037088,3
2020-06-19-171008,171008,1,0,0,296,1.3333333333333333,0.074931934,4
2020-06-20-171008,171008,0,0,0,296,0.16666666666666666,0.011761543,5
2020-06-21-171008,171008,0,0,0,296,0.0,0.0020196077,6
2020-06-22-171008,171008,1,0,0,297,0.5,0.031472247,0
2020-06-23-171008,171008,0,0,1,297,1.1666666666666667,0.048630856,1
2020-06-24-171008,171008,0,0,0,297,0.8333333333333334,0.0136392275,2
2020-06-25-171008,171008,0,1,0,297,0.5,0.017564608,3
2020-06-26-171008,171008,0,0,0,297,1.5,0.02348287,4
2020-06-27-171008,171008,0,0,0,297,0.16666666666666666,0.010339411,5
2020-06-28-171008,171008,0,0,0,297,0.16666666666666666,0.007781731,6
2020-06-29-171008,171008,1,0,0,298,1.3333333333333333,0.04270247,0
2020-06-30-171008,171008,0,0,0,298,0.8333333333333334,0.024317954,1
2020-07-01-171008,171008,2,0,0,300,0.5,0.025289902,2
2020-07-02-171008,171008,0,0,0,300,0.5,0.013029098,3
2020-07-03-171008,171008,0,1,0,300,0.8333333333333334,0.029528549,4
2020-07-04-171008,171008,0,0,0,300,0.16666666666666666,0.0027390884,5
2020-07-05-171008,171008,0,0,0,300,0.0,0.0058585126,6
2020-07-06-171008,171008,0,1,0,300,0.8333333333333334,0.033050258,0
2020-07-07-171008,171008,1,0,2,301,0.8333333333333334,0.028299274,1
2020-07-08-171008,171008,0,0,0,301,1.1666666666666667,0.010234295,2
2020-07-09-171008,171008,0,0,0,301,1.0,0.0070842127,3
2020-07-10-171008,171008,0,0,0,301,1.3333333333333333,0.025675543,4
2020-07-11-171008,171008,0,0,0,301,0.16666666666666666,0.002168011,5
2020-07-12-171008,171008,0,0,0,301,0.16666666666666666,0.007178281,6
2020-07-13-171008,171008,0,0,1,301,1.1666666666666667,0.03059096,0
2020-07-14-171008,171008,0,1,2,301,0.8333333333333334,0.009598437,1
2020-07-15-171008,171008,0,0,1,301,1.1666666666666667,0.013557867,2
2020-07-16-171008,171008,0,0,0,301,1.0,0.008420489,3
2020-07-17-171008,171008,0,0,1,301,1.1666666666666667,0.04865584,4
2020-07-18-171008,171008,0,1,0,301,0.0,0.0013959678,5
2020-07-19-171008,171008,0,0,0,301,0.0,0.006375137,6
2020-07-20-171008,171008,0,0,0,301,0.8333333333333334,0.02634157,0
2020-07-21-171008,171008,2,0,0,303,0.5,0.046235874,1
2020-07-22-171008,171008,0,0,1,303,0.8333333333333334,0.012417413,2
2020-07-23-171008,171008,0,0,1,303,1.1666666666666667,0.04112856,3
2020-07-24-171008,171008,0,0,3,303,0.8333333333333334,0.030423997,4
2020-07-25-171008,171008,0,0,0,303,0.16666666666666666,0.008484304,5
2020-07-26-171008,171008,0,0,0,303,0.0,0.0019615968,6
2020-07-27-171008,171008,1,0,1,304,1.0,0.07377161,0
2020-07-28-171008,171008,2,0,4,306,0.5,0.019879883,1
2020-07-29-171008,171008,1,0,0,307,0.6666666666666666,0.025674634,2
2020-07-30-171008,171008,0,0,5,307,1.6666666666666667,0.033545047,3
2020-07-31-171008,171008,1,0,2,308,1.5,0.04394167,4
2020-08-01-171008,171008,0,0,4,308,0.16666666666666666,0.0061165406,5
2020-08-02-171008,171008,0,0,2,308,0.6666666666666666,0.020113423,6
2020-08-03-171008,171008,0,0,3,308,2.1666666666666665,0.03233123,0
2020-08-04-171008,171008,0,0,2,308,0.6666666666666666,0.035330772,1
2020-08-05-171008,171008,1,0,5,309,3.1666666666666665,0.070944384,2
2020-08-06-171008,171008,1,0,11,310,1.8333333333333333,0.031590585,3
2020-08-07-171008,171008,3,0,6,313,3.5,0.023351677,4
2020-08-08-171008,171008,0,0,1,313,2.0,0.04369693,5
2020-08-09-171008,171008,0,0,12,313,2.333333333333333,0.019140301,6
2020-08-10-171008,171008,1,0,4,314,2.1666666666666665,0.034337386,0
2020-08-11-171008,171008,4,0,8,318,2.5,0.07414898,1
2020-08-12-171008,171008,0,0,17,318,2.833333333333333,0.038605075,2
2020-08-13-171008,171008,5,0,0,323,4.0,0.07048848,3
2020-08-14-171008,171008,2,0,13,325,2.333333333333333,0.07865873,4
2020-08-15-171008,171008,4,0,2,329,0.3333333333333333,0.025332766,5
2020-08-16-171008,171008,2,0,6,331,5.333333333333333,0.031239286,6
2020-08-17-171008,171008,3,0,2,334,4.0,0.070666686,0
2020-08-18-171008,171008,2,0,1,336,2.6666666666666665,0.10010575,1
2020-08-19-171008,171008,5,0,1,341,3.5,0.102821685,2
2020-08-20-171008,171008,11,0,1,352,7.166666666666668,0.115763165,3
2020-08-21-171008,171008,6,0,2,358,5.333333333333333,0.14304805,4
2020-08-22-171008,171008,1,0,4,359,5.0,0.047803275,5
2020-08-23-171008,171008,12,0,9,371,1.1666666666666667,0.035045862,6
2020-08-24-171008,171008,4,0,1,375,3.5,0.115396194,0
2020-08-25-171008,171008,8,0,16,383,8.0,0.2506082,1
2020-08-26-171008,171008,17,0,5,400,5.166666666666667,0.12278878,2
2020-08-27-171008,171008,0,0,4,400,9.333333333333334,0.22662765,3
2020-08-28-171008,171008,13,0,6,413,6.666666666666668,0.21991163,4
2020-08-29-171008,171008,2,0,9,415,2.833333333333333,0.040165693,5
2020-08-30-171008,171008,6,0,2,421,1.1666666666666667,0.110307895,6
2020-08-31-171008,171008,2,0,3,423,3.5,0.10786929,0
2020-09-01-171008,171008,1,0,13,424,4.166666666666667,0.06378161,1
2020-09-02-171008,171008,1,0,12,425,5.0,0.10268575,2
2020-09-03-171008,171008,1,0,6,426,2.5,0.11527079,3
2020-09-04-171008,171008,2,0,13,428,4.166666666666667,0.121087,4
2020-09-05-171008,171008,4,0,10,432,3.6666666666666665,0.06297576,5
2020-09-06-171008,171008,9,0,4,441,4.0,0.091524005,6
2020-09-07-171008,171008,1,0,15,442,10.0,0.14142725,0
2020-09-08-171008,171008,16,0,6,458,1.0,0.15695505,1
2020-09-09-171008,171008,5,0,17,463,7.5,0.18873492,2
2020-09-10-171008,171008,4,0,1,467,11.833333333333336,0.30471888,3
2020-09-11-171008,171008,6,0,5,473,9.5,0.19564146,4
2020-09-12-171008,171008,9,0,2,482,2.0,0.078223154,5
2020-09-13-171008,171008,2,0,1,484,3.1666666666666665,0.054733492,6
2020-09-14-171008,171008,3,0,2,487,10.166666666666666,0.19906713,0
2020-09-15-171008,171008,13,0,5,500,8.5,0.2838089,1
2020-09-16-171008,171008,12,0,9,512,13.0,0.2608906,2
2020-09-17-171008,171008,6,0,3,518,8.833333333333334,0.29116324,3
2020-09-18-171008,171008,13,0,9,531,7.833333333333332,0.26803237,4
2020-09-19-171008,171008,10,0,0,541,3.0,0.27501145,5
2020-09-20-171008,171008,4,1,7,545,2.6666666666666665,0.06140456,6
2020-09-21-171008,171008,15,0,3,560,6.0,0.18712962,0
2020-09-22-171008,171008,6,1,0,566,3.0,0.16309911,1
2020-09-23-171008,171008,17,0,6,583,7.333333333333332,0.20385645,2
2020-09-24-171008,171008,1,0,3,584,6.5,0.28787214,3
2020-09-25-171008,171008,5,0,11,589,8.5,0.20330775,4
2020-09-26-171008,171008,2,0,5,591,2.833333333333333,0.12271161,5
2020-09-27-171008,171008,1,0,4,592,1.5,0.06120588,6
2020-09-28-171008,171008,2,0,2,594,4.833333333333333,0.115412876,0
2020-09-29-171008,171008,5,0,3,599,4.666666666666667,0.13088797,1
2020-09-30-171008,171008,9,0,10,608,5.333333333333333,0.14329746,2
2020-10-01-171008,171008,3,1,1,611,4.0,0.22905426,3
2020-10-02-171008,171008,9,0,12,620,7.833333333333332,0.15968034,4
2020-10-03-171008,171008,0,0,3,620,1.8333333333333333,0.06379804,5
2020-10-04-171008,171008,7,0,2,627,3.6666666666666665,0.034133367,6
2020-10-05-171008,171008,3,0,5,630,4.833333333333333,0.14976035,0
2020-10-06-171008,171008,0,0,13,630,7.0,0.27960286,1
2020-10-07-171008,171008,6,0,8,636,4.0,0.20064586,2
2020-10-08-171008,171008,3,0,13,639,4.833333333333333,0.28700003,3
2020-10-09-171008,171008,11,0,19,650,7.333333333333332,0.23482652,4
2020-10-10-171008,171008,5,0,0,655,4.333333333333333,0.11507577,5
2020-10-11-171008,171008,4,0,12,659,2.0,0.06954781,6
2020-10-12-171008,171008,2,0,7,661,2.6666666666666665,0.07576164,0
2020-10-13-171008,171008,3,0,12,664,5.5,0.23525555,1
2020-10-14-171008,171008,10,0,12,674,8.333333333333334,0.2914189,2
2020-10-15-171008,171008,1,0,11,675,6.833333333333332,0.19542702,3
2020-10-16-171008,171008,12,0,7,687,10.0,0.2674977,4
2020-10-17-171008,171008,3,0,6,690,5.333333333333333,0.1299721,5
2020-10-18-171008,171008,2,0,7,692,1.3333333333333333,0.08748701,6
2020-10-19-171008,171008,5,0,4,697,6.166666666666668,0.19735588,0
2020-10-20-171008,171008,13,0,16,710,11.166666666666664,0.35077196,1
2020-10-21-171008,171008,8,0,9,718,9.666666666666666,0.2841425,2
2020-10-22-171008,171008,13,0,9,731,13.5,0.24685007,3
2020-10-23-171008,171008,19,0,14,750,21.83333333333333,0.46414292,4
2020-10-24-171008,171008,0,1,22,750,4.0,0.14377327,5
2020-10-25-171008,171008,12,0,7,762,4.666666666666667,0.06695457,6
2020-10-26-171008,171008,7,0,10,769,20.5,0.34550083,0
2020-10-27-171008,171008,12,0,13,781,10.666666666666666,0.4375579,1
2020-10-28-171008,171008,12,0,6,793,19.33333333333333,0.46912736,2
2020-10-29-171008,171008,11,0,18,804,16.5,0.34418648,3
2020-10-30-171008,171008,7,1,11,811,22.83333333333333,0.66321677,4
2020-10-31-171008,171008,6,0,0,817,8.5,0.18427832,5
2020-11-01-171008,171008,7,0,0,824,5.333333333333333,0.117197886,6
2020-11-02-171008,171008,4,0,0,828,2.333333333333333,0.08954271,0
2020-11-03-171008,171008,16,0,0,844,19.5,0.3423895,1
2020-11-04-171008,171008,9,1,0,853,16.5,0.50140697,2
2020-11-05-171008,171008,9,0,0,862,18.0,0.45120054,3
2020-11-06-171008,171008,14,0,0,876,17.0,0.39192107,4
2020-11-07-171008,171008,22,0,0,898,10.666666666666666,0.12747358,5
2020-11-08-171008,171008,7,1,0,905,5.833333333333332,0.07472285,6
2020-11-09-171008,171008,10,1,0,915,13.166666666666664,0.17632715,0
2020-11-10-171008,171008,13,0,0,928,11.5,0.31358498,1
2020-11-11-171008,171008,6,0,0,934,15.0,0.284272,2
2020-11-12-171008,171008,18,0,0,952,11.666666666666664,0.29696742,3
2020-11-13-171008,171008,11,0,0,963,13.5,0.22453421,4
2020-03-01-171009,171009,0,0,0,0,0.0,0.0013932692,6
2020-03-02-171009,171009,0,0,5,0,0.0,0.0020741415,0
2020-03-03-171009,171009,0,0,5,0,0.4,0.0012789508,1
2020-03-04-171009,171009,0,0,15,0,0.6,0.00032273942,2
2020-03-05-171009,171009,0,0,12,0,0.2,0.0013650517,3
2020-03-06-171009,171009,0,0,18,0,0.2,0.005160533,4
2020-03-07-171009,171009,0,0,7,0,0.2,0.0017347644,5
2020-03-08-171009,171009,0,0,3,0,0.2,0.00040861004,6
2020-03-09-171009,171009,0,0,30,0,0.2,0.014324629,0
2020-03-10-171009,171009,0,0,10,0,0.0,0.008037644,1
2020-03-11-171009,171009,0,0,13,0,0.4,0.0060826577,2
2020-03-12-171009,171009,0,0,16,0,0.6,0.008585439,3
2020-03-13-171009,171009,1,0,18,1,0.4,0.028397664,4
2020-03-14-171009,171009,0,0,5,1,0.2,0.006939388,5
2020-03-15-171009,171009,0,0,4,1,0.4,0.0052769235,6
2020-03-16-171009,171009,5,0,11,6,4.0,0.06633789,0
2020-03-17-171009,171009,5,0,7,11,6.6,0.05221175,1
2020-03-18-171009,171009,15,0,6,26,8.8,0.070292406,2
2020-03-19-171009,171009,12,0,8,38,14.4,0.097380966,3
2020-03-20-171009,171009,18,0,10,56,13.8,0.077301756,4
2020-03-21-171009,171009,7,0,2,63,3.6,0.0148359565,5
2020-03-22-171009,171009,3,0,1,66,5.4,0.012711187,6
2020-03-23-171009,171009,30,0,10,96,17.6,0.12821321,0
2020-03-24-171009,171009,10,0,10,106,14.2,0.07863235,1
2020-03-25-171009,171009,13,0,17,119,15.4,0.068250924,2
2020-03-26-171009,171009,16,0,3,135,13.8,0.08734415,3
2020-03-27-171009,171009,18,0,5,153,11.2,0.07966337,4
2020-03-28-171009,171009,5,0,0,158,3.0,0.008950875,5
2020-03-29-171009,171009,4,0,1,162,2.0,0.0057356996,6
2020-03-30-171009,171009,11,0,8,173,13.0,0.045986816,0
2020-03-31-171009,171009,7,0,8,180,8.4,0.041810382,1
2020-04-01-171009,171009,6,0,5,186,7.2,0.048283547,2
2020-04-02-171009,171009,8,0,12,194,6.6,0.078565754,3
2020-04-03-171009,171009,10,0,5,204,7.4,0.100569524,4
2020-04-04-171009,171009,2,0,2,206,2.0,0.008683945,5
2020-04-05-171009,171009,1,0,1,207,1.2,0.0032632523,6
2020-04-06-171009,171009,10,0,8,217,8.2,0.06911876,0
2020-04-07-171009,171009,10,0,5,227,7.4,0.055723064,1
2020-04-08-171009,171009,17,3,4,244,7.8,0.0548223,2
2020-04-09-171009,171009,3,1,0,247,7.4,0.032424867,3
2020-04-10-171009,171009,5,1,5,252,3.4,0.011716683,4
2020-04-11-171009,171009,0,0,0,252,1.2,0.011733061,5
2020-04-12-171009,171009,1,0,3,253,2.4,0.016272373,6
2020-04-13-171009,171009,8,0,4,261,10.2,0.053908154,0
2020-04-14-171009,171009,8,0,3,269,13.0,0.041497216,1
2020-04-15-171009,171009,5,0,2,274,5.6,0.052910134,2
2020-04-16-171009,171009,12,0,2,286,3.6,0.034582343,3
2020-04-17-171009,171009,5,0,2,291,2.6,0.039701995,4
2020-04-18-171009,171009,2,0,0,293,0.6,0.0033644962,5
2020-04-19-171009,171009,1,0,0,294,0.6,0.0010969628,6
2020-04-20-171009,171009,8,0,4,302,4.0,0.043504052,0
2020-04-21-171009,171009,5,0,6,307,5.2,0.022513606,1
2020-04-22-171009,171009,4,0,5,311,3.2,0.02853033,2
2020-04-23-171009,171009,0,0,2,311,0.0,0.0013096336,3
2020-04-24-171009,171009,5,0,7,316,3.6,0.030419981,4
2020-04-25-171009,171009,0,0,1,316,0.4,0.0013800985,5
2020-04-26-171009,171009,3,0,0,319,0.4,0.005989102,6
2020-04-27-171009,171009,4,1,6,323,4.6,0.029754302,0
2020-04-28-171009,171009,3,3,3,326,1.6,0.030734103,1
2020-04-29-171009,171009,2,0,0,328,2.8,0.04091269,2
2020-04-30-171009,171009,2,0,5,330,1.8,0.024982959,3
2020-05-01-171009,171009,2,0,4,332,0.4,0.0045464747,4
2020-05-02-171009,171009,0,0,1,332,0.8,0.0046867076,5
2020-05-03-171009,171009,0,0,0,332,0.4,0.0016436395,6
2020-05-04-171009,171009,4,0,7,336,2.4,0.028946515,0
2020-05-05-171009,171009,6,0,2,342,2.8,0.03024456,1
2020-05-06-171009,171009,5,0,6,347,3.4,0.05320123,2
2020-05-07-171009,171009,2,0,3,349,2.6,0.036218017,3
2020-05-08-171009,171009,7,0,4,356,4.0,0.044701613,4
2020-05-09-171009,171009,1,0,0,357,0.0,0.0080566695,5
2020-05-10-171009,171009,0,0,0,357,0.2,0.0035820457,6
2020-05-11-171009,171009,6,0,3,363,3.0,0.04527434,0
2020-05-12-171009,171009,3,0,3,366,2.6,0.027040852,1
2020-05-13-171009,171009,0,0,5,366,0.4,0.038021035,2
2020-05-14-171009,171009,5,0,3,371,2.6,0.03760448,3
2020-05-15-171009,171009,4,2,2,375,2.6,0.025287746,4
2020-05-16-171009,171009,1,0,0,376,0.8,0.0024663128,5
2020-05-17-171009,171009,0,0,0,376,0.0,0.0020948588,6
2020-05-18-171009,171009,7,0,4,383,3.0,0.036866777,0
2020-05-19-171009,171009,2,1,1,385,2.6,0.02791719,1
2020-05-20-171009,171009,6,1,2,391,2.6,0.032316804,2
2020-05-21-171009,171009,3,0,7,394,2.2,0.040805034,3
2020-05-22-171009,171009,4,0,1,398,1.4,0.03357287,4
2020-05-23-171009,171009,0,0,0,398,1.2,0.00034168136,5
2020-05-24-171009,171009,0,0,0,398,0.0,0.00079389045,6
2020-05-25-171009,171009,3,0,1,401,2.8,0.03635842,0
2020-05-26-171009,171009,3,0,4,404,2.2,0.022815935,1
2020-05-27-171009,171009,5,0,3,409,1.2,0.028492618,2
2020-05-28-171009,171009,3,0,2,412,1.2,0.02574962,3
2020-05-29-171009,171009,2,0,2,414,2.6,0.0378173,4
2020-05-30-171009,171009,0,0,0,414,0.0,0.0043717874,5
2020-05-31-171009,171009,0,0,0,414,0.0,0.0042592725,6
2020-06-01-171009,171009,4,0,2,418,1.2,0.043715704,0
2020-06-02-171009,171009,1,0,2,419,2.2,0.030426977,1
2020-06-03-171009,171009,2,0,3,421,2.0,0.025885748,2
2020-06-04-171009,171009,7,0,8,428,2.0,0.022441112,3
2020-06-05-171009,171009,1,0,1,429,1.6,0.014455174,4
2020-06-06-171009,171009,0,0,0,429,0.0,0.0018669992,5
2020-06-07-171009,171009,0,0,0,429,0.0,0.0017733754,6
2020-06-08-171009,171009,1,0,1,430,0.8,0.034155753,0
2020-06-09-171009,171009,4,0,1,434,0.8,0.027595919,1
2020-06-10-171009,171009,3,0,2,437,1.4,0.0373984,2
2020-06-11-171009,171009,2,0,2,439,1.4,0.04011776,3
2020-06-12-171009,171009,2,0,1,441,0.4,0.019852689,4
2020-06-13-171009,171009,0,0,0,441,0.2,0.0020969857,5
2020-06-14-171009,171009,0,0,0,441,0.0,0.0008875447,6
2020-06-15-171009,171009,2,0,1,443,1.6,0.0372006,0
2020-06-16-171009,171009,2,0,1,445,2.8,0.042631503,1
2020-06-17-171009,171009,3,0,0,448,1.6,0.026026841,2
2020-06-18-171009,171009,8,0,0,456,0.6,0.030296288,3
2020-06-19-171009,171009,1,0,1,457,0.6,0.043576244,4
2020-06-20-171009,171009,0,0,0,457,0.0,0.0058092396,5
2020-06-21-171009,171009,0,0,0,457,0.0,0.0015081277,6
2020-06-22-171009,171009,1,0,1,458,0.4,0.020496124,0
2020-06-23-171009,171009,1,0,1,459,0.4,0.031009242,1
2020-06-24-171009,171009,2,0,3,461,0.2,0.0096910335,2
2020-06-25-171009,171009,2,1,3,463,0.0,0.011827717,3
2020-06-26-171009,171009,1,1,2,464,1.2,0.016880002,4
2020-06-27-171009,171009,0,0,0,464,0.0,0.006151229,5
2020-06-28-171009,171009,0,0,0,464,0.0,0.0046889097,6
2020-06-29-171009,171009,1,0,2,465,1.8,0.025845425,0
2020-06-30-171009,171009,1,0,0,466,0.8,0.012891933,1
2020-07-01-171009,171009,0,0,5,466,0.4,0.015142451,2
2020-07-02-171009,171009,0,0,1,466,0.4,0.010443552,3
2020-07-03-171009,171009,1,0,2,467,0.6,0.017217211,4
2020-07-04-171009,171009,0,0,0,467,0.0,0.0015337165,5
2020-07-05-171009,171009,0,0,0,467,0.0,0.0025066661,6
2020-07-06-171009,171009,1,0,0,468,0.6,0.018909086,0
2020-07-07-171009,171009,1,0,0,469,0.8,0.016045801,1
2020-07-08-171009,171009,3,0,1,472,1.4,0.004287663,2
2020-07-09-171009,171009,3,0,1,475,0.4,0.0050188615,3
2020-07-10-171009,171009,2,0,0,477,0.6,0.013928025,4
2020-07-11-171009,171009,0,0,0,477,0.0,0.00094457436,5
2020-07-12-171009,171009,0,0,0,477,0.0,0.0036881352,6
2020-07-13-171009,171009,2,0,0,479,1.0,0.014513023,0
2020-07-14-171009,171009,0,0,0,479,0.8,0.007423977,1
2020-07-15-171009,171009,5,0,1,484,0.6,0.00986854,2
2020-07-16-171009,171009,1,0,0,485,0.6,0.0063629476,3
2020-07-17-171009,171009,2,0,2,487,0.2,0.025611289,4
2020-07-18-171009,171009,0,0,0,487,0.0,0.0009628607,5
2020-07-19-171009,171009,0,0,1,487,0.0,0.0056221914,6
2020-07-20-171009,171009,0,0,8,487,0.8,0.013530681,0
2020-07-21-171009,171009,0,0,0,487,0.6,0.023986714,1
2020-07-22-171009,171009,1,0,2,488,0.4,0.008198184,2
2020-07-23-171009,171009,1,0,1,489,0.6,0.026864253,3
2020-07-24-171009,171009,0,0,6,489,1.2,0.0172495,4
2020-07-25-171009,171009,0,0,1,489,0.0,0.004802641,5
2020-07-26-171009,171009,0,0,5,489,0.0,0.0010442908,6
2020-07-27-171009,171009,0,0,3,489,0.8,0.04727672,0
2020-07-28-171009,171009,0,0,6,489,0.8,0.009712713,1
2020-07-29-171009,171009,1,0,3,490,0.6,0.014377247,2
2020-07-30-171009,171009,0,0,3,490,1.4,0.021392692,3
2020-07-31-171009,171009,2,0,6,492,1.0,0.025645662,4
2020-08-01-171009,171009,0,0,0,492,0.0,0.003018968,5
2020-08-02-171009,171009,1,0,11,493,0.2,0.009973189,6
2020-08-03-171009,171009,8,0,1,501,0.8,0.019029273,0
2020-08-04-171009,171009,0,0,2,501,0.4,0.020995816,1
2020-08-05-171009,171009,2,0,4,503,3.0,0.04423479,2
2020-08-06-171009,171009,1,0,8,504,2.0,0.020669961,3
2020-08-07-171009,171009,6,0,6,510,2.8,0.016876744,4
2020-08-08-171009,171009,1,0,7,511,1.6,0.023480218,5
2020-08-09-171009,171009,5,0,3,516,1.8,0.009536878,6
2020-08-10-171009,171009,3,0,3,519,2.2,0.019698959,0
2020-08-11-171009,171009,6,0,6,525,1.4,0.050128285,1
2020-08-12-171009,171009,3,0,6,528,3.6,0.02465625,2
2020-08-13-171009,171009,3,0,3,531,4.0,0.04348033,3
2020-08-14-171009,171009,6,0,6,537,1.2,0.0495991,4
2020-08-15-171009,171009,0,0,2,537,1.4,0.01613884,5
2020-08-16-171009,171009,11,0,0,548,4.2,0.020648306,6
2020-08-17-171009,171009,1,0,1,549,1.8,0.06448981,0
2020-08-18-171009,171009,2,0,3,551,2.0,0.054409888,1
2020-08-19-171009,171009,4,0,2,555,2.6,0.06993484,2
2020-08-20-171009,171009,8,0,0,563,8.4,0.06553984,3
2020-08-21-171009,171009,6,0,3,569,4.8,0.09084645,4
2020-08-22-171009,171009,7,1,10,576,3.6,0.024902308,5
2020-08-23-171009,171009,3,0,10,579,3.6,0.02181098,6
2020-08-24-171009,171009,3,0,15,582,3.0,0.080541335,0
2020-08-25-171009,171009,6,0,0,588,3.6,0.1360807,1
2020-08-26-171009,171009,6,0,5,594,5.4,0.081499346,2
2020-08-27-171009,171009,3,0,9,597,6.0,0.12759969,3
2020-08-28-171009,171009,6,0,11,603,6.6,0.13513625,4
2020-08-29-171009,171009,2,1,4,605,3.8,0.03190261,5
2020-08-30-171009,171009,0,0,3,605,2.8,0.06111065,6
2020-08-31-171009,171009,1,0,9,606,2.6,0.05351056,0
2020-09-01-171009,171009,3,0,6,609,4.2,0.04655637,1
2020-09-02-171009,171009,2,0,14,611,3.6,0.065894715,2
2020-09-03-171009,171009,0,0,2,611,5.0,0.07309771,3
2020-09-04-171009,171009,3,0,6,614,5.6,0.07573889,4
2020-09-05-171009,171009,10,0,2,624,3.0,0.03725465,5
2020-09-06-171009,171009,10,0,2,634,5.0,0.044989422,6
2020-09-07-171009,171009,15,0,6,649,8.8,0.092854604,0
2020-09-08-171009,171009,0,0,3,649,4.0,0.086663775,1
2020-09-09-171009,171009,5,0,13,654,6.2,0.14189872,2
2020-09-10-171009,171009,9,0,1,663,9.8,0.16929887,3
2020-09-11-171009,171009,11,0,7,674,7.6,0.13108064,4
2020-09-12-171009,171009,4,0,4,678,3.0,0.050659154,5
2020-09-13-171009,171009,3,0,1,681,2.4,0.034577187,6
2020-09-14-171009,171009,9,0,5,690,8.8,0.13293971,0
2020-09-15-171009,171009,6,0,2,696,7.6,0.18128467,1
2020-09-16-171009,171009,14,0,4,710,13.0,0.18296596,2
2020-09-17-171009,171009,2,0,3,712,10.4,0.17479745,3
2020-09-18-171009,171009,6,0,9,718,8.2,0.18026873,4
2020-09-19-171009,171009,2,0,0,720,4.0,0.14717452,5
2020-09-20-171009,171009,2,1,2,722,3.0,0.03918019,6
2020-09-21-171009,171009,6,0,2,728,6.6,0.11223416,0
2020-09-22-171009,171009,3,0,5,731,3.8,0.111577824,1
2020-09-23-171009,171009,13,2,3,744,9.4,0.13174485,2
2020-09-24-171009,171009,1,1,8,745,4.8,0.18732393,3
2020-09-25-171009,171009,7,1,7,752,7.4,0.16655579,4
2020-09-26-171009,171009,4,0,3,756,2.8,0.08941176,5
2020-09-27-171009,171009,1,0,3,757,1.4,0.0418648,6
2020-09-28-171009,171009,5,0,5,762,1.8,0.08833371,0
2020-09-29-171009,171009,2,0,3,764,5.0,0.09266252,1
2020-09-30-171009,171009,4,0,11,768,5.6,0.093930766,2
2020-10-01-171009,171009,3,0,11,771,3.6,0.14697011,3
2020-10-02-171009,171009,9,1,19,780,8.6,0.10614792,4
2020-10-03-171009,171009,0,0,7,780,2.2,0.046002183,5
2020-10-04-171009,171009,2,0,4,782,3.2,0.030718694,6
2020-10-05-171009,171009,2,0,6,784,3.4,0.11951321,0
2020-10-06-171009,171009,5,0,13,789,4.2,0.18706867,1
2020-10-07-171009,171009,3,0,9,792,5.0,0.13622452,2
2020-10-08-171009,171009,8,0,11,800,5.8,0.2177999,3
2020-10-09-171009,171009,7,0,21,807,8.6,0.17742506,4
2020-10-10-171009,171009,3,0,2,810,5.0,0.061094247,5
2020-10-11-171009,171009,3,0,9,813,2.0,0.049929366,6
2020-10-12-171009,171009,5,0,31,818,1.6,0.047760006,0
2020-10-13-171009,171009,3,0,12,821,3.6,0.16989727,1
2020-10-14-171009,171009,11,0,23,832,6.8,0.15918007,2
2020-10-15-171009,171009,11,0,21,843,3.6,0.1320848,3
2020-10-16-171009,171009,19,0,13,862,8.4,0.1801951,4
2020-10-17-171009,171009,7,0,10,869,3.6,0.081693515,5
2020-10-18-171009,171009,4,0,6,873,1.4,0.06517561,6
2020-10-19-171009,171009,6,0,2,879,4.6,0.12841257,0
2020-10-20-171009,171009,13,0,15,892,8.4,0.20531134,1
2020-10-21-171009,171009,9,1,13,901,10.6,0.16481058,2
2020-10-22-171009,171009,11,0,19,912,11.4,0.15552987,3
2020-10-23-171009,171009,21,0,15,933,17.0,0.27357116,4
2020-10-24-171009,171009,2,0,11,935,5.8,0.08624014,5
2020-10-25-171009,171009,9,1,4,944,6.8,0.03982055,6
2020-10-26-171009,171009,31,0,8,975,13.6,0.25217327,0
2020-10-27-171009,171009,12,0,8,987,10.8,0.24898283,1
2020-10-28-171009,171009,23,1,15,1010,14.6,0.267986,2
2020-10-29-171009,171009,21,0,13,1031,14.0,0.21362987,3
2020-10-30-171009,171009,13,1,12,1044,15.8,0.34134388,4
2020-10-31-171009,171009,10,0,0,1054,9.6,0.09128901,5
2020-11-01-171009,171009,6,0,0,1060,5.4,0.05793772,6
2020-11-02-171009,171009,2,0,0,1062,2.6,0.06133644,0
2020-11-03-171009,171009,15,1,0,1077,12.4,0.18937825,1
2020-11-04-171009,171009,13,1,0,1090,11.8,0.2674836,2
2020-11-05-171009,171009,19,0,0,1109,13.4,0.25727355,3
2020-11-06-171009,171009,15,1,0,1124,15.6,0.2338846,4
2020-11-07-171009,171009,11,1,0,1135,14.2,0.07024872,5
2020-11-08-171009,171009,4,2,0,1139,8.0,0.04619136,6
2020-11-09-171009,171009,8,0,0,1147,10.8,0.1401503,0
2020-11-10-171009,171009,8,2,0,1155,10.6,0.16793194,1
2020-11-11-171009,171009,15,0,0,1170,11.4,0.20750865,2
2020-11-12-171009,171009,13,0,0,1183,10.6,0.20564902,3
2020-11-13-171009,171009,12,0,0,1195,15.4,0.19474466,4
2020-03-01-171010,171010,0,0,1,0,0.0,0.0006229301,6
2020-03-02-171010,171010,0,0,4,0,0.0,0.00077491865,0
2020-03-03-171010,171010,0,1,11,0,0.0,0.0005022439,1
2020-03-04-171010,171010,2,0,10,2,0.0,0.00013927689,2
2020-03-05-171010,171010,0,2,12,2,0.16666666666666666,0.00057561666,3
2020-03-06-171010,171010,0,0,12,2,0.16666666666666666,0.0020250375,4
2020-03-07-171010,171010,0,0,3,2,0.16666666666666666,0.0005923803,5
2020-03-08-171010,171010,1,0,7,3,0.0,0.0001640204,6
2020-03-09-171010,171010,0,0,18,3,0.16666666666666666,0.005719834,0
2020-03-10-171010,171010,0,0,18,3,0.16666666666666666,0.0030098886,1
2020-03-11-171010,171010,1,0,20,4,0.0,0.002543544,2
2020-03-12-171010,171010,0,0,15,4,0.16666666666666666,0.003501153,3
2020-03-13-171010,171010,0,0,19,4,1.1666666666666667,0.01217729,4
2020-03-14-171010,171010,0,0,3,4,0.5,0.0030087228,5
2020-03-15-171010,171010,1,0,2,5,0.6666666666666666,0.002666536,6
2020-03-16-171010,171010,4,1,17,9,5.833333333333332,0.030054681,0
2020-03-17-171010,171010,11,0,13,20,7.5,0.022913042,1
2020-03-18-171010,171010,10,0,9,30,9.5,0.03036306,2
2020-03-19-171010,171010,12,0,12,42,11.333333333333336,0.043091055,3
2020-03-20-171010,171010,12,1,9,54,14.0,0.03431794,4
2020-03-21-171010,171010,3,0,4,57,3.5,0.006221307,5
2020-03-22-171010,171010,7,0,2,64,6.333333333333332,0.0057023065,6
2020-03-23-171010,171010,18,0,13,82,23.66666666666667,0.055196907,0
2020-03-24-171010,171010,18,0,7,100,17.5,0.033046883,1
2020-03-25-171010,171010,20,0,10,120,17.166666666666668,0.028613511,2
2020-03-26-171010,171010,15,0,11,135,18.0,0.0379001,3
2020-03-27-171010,171010,19,0,4,154,14.333333333333336,0.034242235,4
2020-03-28-171010,171010,3,0,2,157,3.333333333333333,0.004089859,5
2020-03-29-171010,171010,2,0,2,159,2.6666666666666665,0.002671321,6
2020-03-30-171010,171010,17,0,5,176,19.33333333333333,0.020371582,0
2020-03-31-171010,171010,13,0,6,189,9.333333333333334,0.01742107,1
2020-04-01-171010,171010,9,0,6,198,8.5,0.02173509,2
2020-04-02-171010,171010,12,0,7,210,9.833333333333334,0.033170387,3
2020-04-03-171010,171010,9,0,2,219,11.333333333333336,0.046884786,4
2020-04-04-171010,171010,4,0,1,223,2.5,0.003619386,5
2020-04-05-171010,171010,2,1,1,225,1.3333333333333333,0.0014511943,6
2020-04-06-171010,171010,13,0,6,238,13.666666666666664,0.029209642,0
2020-04-07-171010,171010,7,3,11,245,9.166666666666666,0.025934985,1
2020-04-08-171010,171010,10,0,5,255,9.333333333333334,0.023978971,2
2020-04-09-171010,171010,11,0,0,266,6.0,0.015750969,3
2020-04-10-171010,171010,4,0,2,270,5.166666666666667,0.005698581,4
2020-04-11-171010,171010,2,0,0,272,2.6666666666666665,0.0051795174,5
2020-04-12-171010,171010,2,0,1,274,2.333333333333333,0.0076648123,6
2020-04-13-171010,171010,5,0,3,279,15.166666666666664,0.023684619,0
2020-04-14-171010,171010,6,0,2,285,11.5,0.018697722,1
2020-04-15-171010,171010,6,0,0,291,9.833333333333334,0.022550603,2
2020-04-16-171010,171010,7,0,4,298,5.5,0.014881835,3
2020-04-17-171010,171010,2,0,1,300,4.0,0.01602837,4
2020-04-18-171010,171010,1,0,1,301,1.1666666666666667,0.0012511301,5
2020-04-19-171010,171010,1,0,0,302,0.6666666666666666,0.0005374442,6
2020-04-20-171010,171010,6,0,0,308,5.666666666666668,0.018793939,0
2020-04-21-171010,171010,11,0,2,319,4.833333333333333,0.0105026765,1
2020-04-22-171010,171010,5,1,6,324,4.166666666666667,0.011877923,2
2020-04-23-171010,171010,0,0,3,324,0.16666666666666666,0.00057467556,3
2020-04-24-171010,171010,2,0,6,326,5.5,0.013046788,4
2020-04-25-171010,171010,0,0,0,326,0.16666666666666666,0.0006422596,5
2020-04-26-171010,171010,1,0,1,327,0.8333333333333334,0.0024526336,6
2020-04-27-171010,171010,3,0,3,330,4.666666666666667,0.013502648,0
2020-04-28-171010,171010,2,0,4,332,2.1666666666666665,0.012950797,1
2020-04-29-171010,171010,0,0,0,332,4.666666666666667,0.0174521,2
2020-04-30-171010,171010,4,0,3,336,4.666666666666667,0.011419247,3
2020-05-01-171010,171010,1,0,2,337,0.6666666666666666,0.002408416,4
2020-05-02-171010,171010,1,0,0,338,0.5,0.0023971226,5
2020-05-03-171010,171010,0,0,0,338,0.16666666666666666,0.0006442826,6
2020-05-04-171010,171010,0,0,4,338,5.166666666666667,0.012084564,0
2020-05-05-171010,171010,2,0,7,340,4.833333333333333,0.013212592,1
2020-05-06-171010,171010,6,0,4,346,4.166666666666667,0.022901297,2
2020-05-07-171010,171010,3,0,1,349,3.5,0.015280802,3
2020-05-08-171010,171010,6,0,0,355,6.166666666666668,0.018559601,4
2020-05-09-171010,171010,0,0,1,355,0.3333333333333333,0.0034213904,5
2020-05-10-171010,171010,1,0,0,356,0.3333333333333333,0.0015661056,6
2020-05-11-171010,171010,3,0,1,359,4.666666666666667,0.019213812,0
2020-05-12-171010,171010,4,0,0,363,2.0,0.01186921,1
2020-05-13-171010,171010,0,0,2,363,0.5,0.015944604,2
2020-05-14-171010,171010,3,0,2,366,3.8333333333333335,0.016461076,3
2020-05-15-171010,171010,2,0,2,368,2.833333333333333,0.010987232,4
2020-05-16-171010,171010,0,0,0,368,0.16666666666666666,0.00096832967,5
2020-05-17-171010,171010,0,0,0,368,0.0,0.0007876246,6
2020-05-18-171010,171010,4,0,1,372,4.166666666666667,0.01496046,0
2020-05-19-171010,171010,7,0,1,379,2.1666666666666665,0.011893321,1
2020-05-20-171010,171010,4,0,2,383,3.6666666666666665,0.014190303,2
2020-05-21-171010,171010,1,0,3,384,2.833333333333333,0.017498873,3
2020-05-22-171010,171010,0,0,3,384,2.333333333333333,0.014244454,4
2020-05-23-171010,171010,1,0,0,385,0.6666666666666666,0.00016912303,5
2020-05-24-171010,171010,0,0,0,385,0.0,0.00031488523,6
2020-05-25-171010,171010,1,2,1,386,3.1666666666666665,0.015125127,0
2020-05-26-171010,171010,0,0,2,386,2.6666666666666665,0.009387747,1
2020-05-27-171010,171010,2,0,1,388,2.5,0.011261161,2
2020-05-28-171010,171010,2,0,5,390,1.3333333333333333,0.010759531,3
2020-05-29-171010,171010,2,0,1,392,2.0,0.015264389,4
2020-05-30-171010,171010,0,0,0,392,0.0,0.0018139407,5
2020-05-31-171010,171010,0,0,0,392,0.0,0.0017583594,6
2020-06-01-171010,171010,1,0,2,393,3.0,0.018871259,0
2020-06-02-171010,171010,1,0,0,394,2.333333333333333,0.012762433,1
2020-06-03-171010,171010,2,0,2,396,2.5,0.011244518,2
2020-06-04-171010,171010,3,0,0,399,3.1666666666666665,0.009456951,3
2020-06-05-171010,171010,3,0,0,402,2.333333333333333,0.0055559226,4
2020-06-06-171010,171010,0,2,0,402,0.3333333333333333,0.0008083008,5
2020-06-07-171010,171010,0,0,0,402,0.0,0.0007345462,6
2020-06-08-171010,171010,1,0,1,403,1.5,0.013890697,0
2020-06-09-171010,171010,2,0,0,405,1.8333333333333333,0.011182156,1
2020-06-10-171010,171010,1,0,0,406,1.6666666666666667,0.016392747,2
2020-06-11-171010,171010,5,0,0,411,1.0,0.017139543,3
2020-06-12-171010,171010,1,0,1,412,1.1666666666666667,0.008103439,4
2020-06-13-171010,171010,0,0,0,412,0.3333333333333333,0.00080962956,5
2020-06-14-171010,171010,0,0,0,412,0.0,0.0003940717,6
2020-06-15-171010,171010,2,4,1,414,1.0,0.015547342,0
2020-06-16-171010,171010,0,0,0,414,2.333333333333333,0.018176557,1
2020-06-17-171010,171010,2,0,0,416,1.5,0.011648161,2
2020-06-18-171010,171010,0,0,0,416,2.333333333333333,0.012484832,3
2020-06-19-171010,171010,0,0,1,416,1.1666666666666667,0.01826467,4
2020-06-20-171010,171010,0,0,0,416,0.0,0.0025575953,5
2020-06-21-171010,171010,0,0,0,416,0.0,0.00059069425,6
2020-06-22-171010,171010,1,0,0,417,0.8333333333333334,0.008323913,0
2020-06-23-171010,171010,0,0,1,417,1.1666666666666667,0.012668036,1
2020-06-24-171010,171010,0,0,3,417,0.8333333333333334,0.0038677256,2
2020-06-25-171010,171010,0,0,0,417,1.1666666666666667,0.004785494,3
2020-06-26-171010,171010,1,0,0,418,2.1666666666666665,0.0067035775,4
2020-06-27-171010,171010,0,0,0,418,0.0,0.0025585003,5
2020-06-28-171010,171010,0,0,0,418,0.16666666666666666,0.001941348,6
2020-06-29-171010,171010,1,0,2,419,0.8333333333333334,0.010716533,0
2020-06-30-171010,171010,0,0,3,419,0.3333333333333333,0.0055520665,1
2020-07-01-171010,171010,0,0,0,419,0.8333333333333334,0.006302408,2
2020-07-02-171010,171010,0,0,2,419,0.16666666666666666,0.0040456695,3
2020-07-03-171010,171010,1,0,1,420,0.8333333333333334,0.007211036,4
2020-07-04-171010,171010,0,0,0,420,0.16666666666666666,0.00064947986,5
2020-07-05-171010,171010,0,0,0,420,0.16666666666666666,0.0011553493,6
2020-07-06-171010,171010,0,0,3,420,0.6666666666666666,0.00796376,0
2020-07-07-171010,171010,1,0,1,421,0.5,0.0067702658,1
2020-07-08-171010,171010,3,0,1,424,1.1666666666666667,0.001999486,2
2020-07-09-171010,171010,0,0,1,424,1.1666666666666667,0.0020026662,3
2020-07-10-171010,171010,0,0,1,424,1.6666666666666667,0.005962117,4
2020-07-11-171010,171010,0,0,0,424,0.16666666666666666,0.0004355607,5
2020-07-12-171010,171010,0,0,0,424,0.0,0.0015986953,6
2020-07-13-171010,171010,2,0,2,426,0.6666666666666666,0.006463496,0
2020-07-14-171010,171010,3,0,1,429,0.3333333333333333,0.0028996258,1
2020-07-15-171010,171010,0,0,1,429,1.5,0.003908964,2
2020-07-16-171010,171010,2,0,3,431,1.0,0.0024976693,3
2020-07-17-171010,171010,1,0,1,432,0.3333333333333333,0.011051298,4
2020-07-18-171010,171010,0,0,0,432,0.0,0.00038709556,5
2020-07-19-171010,171010,0,0,1,432,0.0,0.0021263012,6
2020-07-20-171010,171010,3,0,0,435,0.16666666666666666,0.0058851554,0
2020-07-21-171010,171010,1,0,0,436,0.8333333333333334,0.010408237,1
2020-07-22-171010,171010,1,0,10,437,1.3333333333333333,0.0033269557,2
2020-07-23-171010,171010,1,0,4,438,1.0,0.010942114,3
2020-07-24-171010,171010,1,0,5,439,1.6666666666666667,0.007296287,4
2020-07-25-171010,171010,0,0,2,439,0.0,0.0020249116,5
2020-07-26-171010,171010,0,0,1,439,0.0,0.00044878008,6
2020-07-27-171010,171010,2,0,3,441,0.6666666666666666,0.019297248,0
2020-07-28-171010,171010,1,0,2,442,0.6666666666666666,0.004300446,1
2020-07-29-171010,171010,1,0,6,443,0.8333333333333334,0.0061086565,2
2020-07-30-171010,171010,3,0,8,446,1.3333333333333333,0.008771742,3
2020-07-31-171010,171010,1,0,1,447,1.3333333333333333,0.010753134,4
2020-08-01-171010,171010,0,0,2,447,0.16666666666666666,0.0013300402,5
2020-08-02-171010,171010,1,0,4,448,0.3333333333333333,0.0043800995,6
2020-08-03-171010,171010,0,0,2,448,1.8333333333333333,0.007946837,0
2020-08-04-171010,171010,0,0,6,448,0.6666666666666666,0.008756174,1
2020-08-05-171010,171010,10,0,3,458,1.6666666666666667,0.018195912,2
2020-08-06-171010,171010,4,0,9,462,1.0,0.008442441,3
2020-08-07-171010,171010,5,0,7,467,2.1666666666666665,0.006701447,4
2020-08-08-171010,171010,2,1,1,469,0.6666666666666666,0.010066545,5
2020-08-09-171010,171010,1,0,0,470,1.0,0.00417916,6
2020-08-10-171010,171010,3,0,2,473,2.0,0.008309519,0
2020-08-11-171010,171010,2,0,1,475,3.0,0.020200506,1
2020-08-12-171010,171010,6,0,2,481,1.0,0.010093894,2
2020-08-13-171010,171010,8,0,3,489,4.166666666666667,0.017984586,3
2020-08-14-171010,171010,1,0,3,490,2.833333333333333,0.02036134,4
2020-08-15-171010,171010,2,0,1,492,1.6666666666666667,0.0066113723,5
2020-08-16-171010,171010,4,0,0,496,4.0,0.008361137,6
2020-08-17-171010,171010,2,0,2,498,4.333333333333333,0.024291104,0
2020-08-18-171010,171010,6,0,7,504,2.0,0.023290787,1
2020-08-19-171010,171010,3,0,5,507,4.5,0.028199801,2
2020-08-20-171010,171010,9,0,2,516,6.833333333333332,0.027756685,3
2020-08-21-171010,171010,7,0,3,523,4.0,0.03721849,4
2020-08-22-171010,171010,1,0,1,524,3.8333333333333335,0.010798471,5
2020-08-23-171010,171010,0,0,4,524,4.166666666666667,0.008957552,6
2020-08-24-171010,171010,2,0,13,526,4.0,0.032228995,0
2020-08-25-171010,171010,1,0,1,527,7.333333333333332,0.058204044,1
2020-08-26-171010,171010,2,0,10,529,8.333333333333334,0.033059753,2
2020-08-27-171010,171010,3,0,9,532,8.666666666666666,0.05405093,3
2020-08-28-171010,171010,3,0,8,535,10.333333333333334,0.055854395,4
2020-08-29-171010,171010,1,0,2,536,2.833333333333333,0.012391885,5
2020-08-30-171010,171010,0,0,2,536,3.333333333333333,0.025923237,6
2020-08-31-171010,171010,2,0,8,538,3.6666666666666665,0.023531929,0
2020-09-01-171010,171010,7,0,6,545,3.1666666666666665,0.018443825,1
2020-09-02-171010,171010,5,0,17,550,4.166666666666667,0.026956629,2
2020-09-03-171010,171010,2,0,8,552,5.666666666666668,0.02996721,3
2020-09-04-171010,171010,3,0,9,555,4.5,0.031151963,4
2020-09-05-171010,171010,1,0,0,556,5.333333333333333,0.015574624,5
2020-09-06-171010,171010,4,0,11,560,5.166666666666667,0.019790517,6
2020-09-07-171010,171010,13,0,5,573,10.166666666666666,0.037715998,0
2020-09-08-171010,171010,1,0,3,574,3.1666666666666665,0.036812175,1
2020-09-09-171010,171010,10,0,9,584,6.5,0.055638634,2
2020-09-10-171010,171010,9,0,7,593,7.333333333333332,0.07189894,3
2020-09-11-171010,171010,8,0,5,601,9.833333333333334,0.05304161,4
2020-09-12-171010,171010,2,0,5,603,3.5,0.02070593,5
2020-09-13-171010,171010,2,0,4,605,3.1666666666666665,0.014153239,6
2020-09-14-171010,171010,8,0,2,613,8.5,0.053777117,0
2020-09-15-171010,171010,6,0,7,619,7.666666666666668,0.074078806,1
2020-09-16-171010,171010,17,0,6,636,10.333333333333334,0.07310476,2
2020-09-17-171010,171010,8,0,3,644,5.333333333333333,0.07281291,3
2020-09-18-171010,171010,9,0,8,653,7.0,0.07281762,4
2020-09-19-171010,171010,0,0,5,653,3.8333333333333335,0.063150436,5
2020-09-20-171010,171010,11,1,1,664,1.8333333333333333,0.016003242,6
2020-09-21-171010,171010,5,0,8,669,8.333333333333334,0.04669846,0
2020-09-22-171010,171010,3,0,6,672,3.0,0.04486973,1
2020-09-23-171010,171010,9,0,3,681,9.333333333333334,0.053761393,2
2020-09-24-171010,171010,7,0,6,688,4.166666666666667,0.076236755,3
2020-09-25-171010,171010,5,2,13,693,9.166666666666666,0.06415799,4
2020-09-26-171010,171010,5,0,8,698,2.833333333333333,0.035472676,5
2020-09-27-171010,171010,4,0,1,702,1.0,0.016780686,6
2020-09-28-171010,171010,2,0,2,704,4.666666666666667,0.03453447,0
2020-09-29-171010,171010,7,0,4,711,5.166666666666667,0.036917247,1
2020-09-30-171010,171010,6,0,10,717,5.833333333333332,0.03810078,2
2020-10-01-171010,171010,3,0,7,720,3.5,0.060043734,3
2020-10-02-171010,171010,8,0,13,728,8.166666666666666,0.04302152,4
2020-10-03-171010,171010,5,1,6,733,1.5,0.018336179,5
2020-10-04-171010,171010,1,0,1,734,4.833333333333333,0.011572558,6
2020-10-05-171010,171010,8,0,4,742,4.333333333333333,0.046347897,0
2020-10-06-171010,171010,6,1,4,748,5.833333333333332,0.07559732,1
2020-10-07-171010,171010,3,1,5,751,6.166666666666668,0.05486928,2
2020-10-08-171010,171010,6,0,8,757,5.666666666666668,0.08546092,3
2020-10-09-171010,171010,13,0,24,770,7.166666666666668,0.069702454,4
2020-10-10-171010,171010,8,0,1,778,3.1666666666666665,0.026333636,5
2020-10-11-171010,171010,1,0,8,779,1.8333333333333333,0.019833928,6
2020-10-12-171010,171010,2,0,18,781,2.333333333333333,0.01954908,0
2020-10-13-171010,171010,4,0,11,785,5.333333333333333,0.067340784,1
2020-10-14-171010,171010,10,0,20,795,7.166666666666668,0.06792486,2
2020-10-15-171010,171010,7,0,14,802,6.666666666666668,0.053303596,3
2020-10-16-171010,171010,13,0,15,815,9.0,0.07271021,4
2020-10-17-171010,171010,6,0,11,821,5.166666666666667,0.033520944,5
2020-10-18-171010,171010,1,0,6,822,1.5,0.025604181,6
2020-10-19-171010,171010,4,0,2,826,7.0,0.052268326,0
2020-10-20-171010,171010,4,0,15,830,10.166666666666666,0.08599931,1
2020-10-21-171010,171010,5,0,13,835,10.666666666666666,0.06928464,2
2020-10-22-171010,171010,8,0,11,843,13.0,0.06387183,3
2020-10-23-171010,171010,24,0,21,867,20.33333333333333,0.114384815,4
2020-10-24-171010,171010,1,0,13,868,5.5,0.035871062,5
2020-10-25-171010,171010,8,0,8,876,5.166666666666667,0.016565606,6
2020-10-26-171010,171010,18,0,14,894,17.333333333333332,0.099712394,0
2020-10-27-171010,171010,11,0,14,905,13.333333333333336,0.10504119,1
2020-10-28-171010,171010,20,1,6,925,20.0,0.1129417,2
2020-10-29-171010,171010,14,0,11,939,18.33333333333333,0.08810121,3
2020-10-30-171010,171010,15,0,16,954,21.0,0.1484414,4
2020-10-31-171010,171010,11,1,0,965,9.5,0.04016032,5
2020-11-01-171010,171010,6,0,0,971,5.166666666666667,0.025466809,6
2020-11-02-171010,171010,2,1,0,973,3.333333333333333,0.024585776,0
2020-11-03-171010,171010,15,1,0,988,19.33333333333333,0.08062893,1
2020-11-04-171010,171010,13,0,0,1001,15.0,0.11503048,2
2020-11-05-171010,171010,11,1,0,1012,18.83333333333333,0.10868317,3
2020-11-06-171010,171010,21,2,0,1033,14.666666666666664,0.09737282,4
2020-11-07-171010,171010,13,0,0,1046,11.0,0.029935714,5
2020-11-08-171010,171010,8,0,0,1054,5.0,0.018984873,6
2020-11-09-171010,171010,14,0,0,1068,13.0,0.05440441,0
2020-11-10-171010,171010,14,1,0,1082,12.5,0.07213131,1
2020-11-11-171010,171010,6,1,0,1088,14.333333333333336,0.082013175,2
2020-11-12-171010,171010,11,0,0,1099,15.0,0.08225729,3
2020-11-13-171010,171010,16,0,0,1115,14.166666666666664,0.07405783,4
2020-03-01-171011,171011,0,0,2,0,0.0,0.00024604524,6
2020-03-02-171011,171011,0,0,4,0,0.2,0.00021786086,0
2020-03-03-171011,171011,0,0,8,0,0.0,5.9683825e-05,1
2020-03-04-171011,171011,0,0,4,0,0.2,4.9080212e-05,2
2020-03-05-171011,171011,0,0,6,0,0.0,0.00016467081,3
2020-03-06-171011,171011,0,0,7,0,0.2,0.0007865205,4
2020-03-07-171011,171011,0,0,6,0,0.0,0.00013268266,5
2020-03-08-171011,171011,0,0,1,0,0.0,0.00015508693,6
2020-03-09-171011,171011,0,0,16,0,0.4,0.0018502059,0
2020-03-10-171011,171011,1,0,8,1,0.8,0.001017001,1
2020-03-11-171011,171011,0,0,13,1,1.6,0.0009248195,2
2020-03-12-171011,171011,0,0,12,1,0.8,0.0013856259,3
2020-03-13-171011,171011,1,0,6,2,2.8,0.0037633933,4
2020-03-14-171011,171011,0,0,2,2,2.0,0.0010985442,5
2020-03-15-171011,171011,2,0,3,4,2.4,0.0007811449,6
2020-03-16-171011,171011,4,0,10,8,6.4,0.0097926315,0
2020-03-17-171011,171011,8,0,7,16,6.6,0.006958365,1
2020-03-18-171011,171011,4,0,4,20,14.0,0.009361736,2
2020-03-19-171011,171011,6,0,4,26,19.2,0.013479966,3
2020-03-20-171011,171011,7,0,4,33,15.4,0.011250215,4
2020-03-21-171011,171011,6,0,3,39,4.0,0.0018688474,5
2020-03-22-171011,171011,1,0,1,40,4.6,0.0013420383,6
2020-03-23-171011,171011,16,0,9,56,26.2,0.016403383,0
2020-03-24-171011,171011,8,0,94,64,18.6,0.009884564,1
2020-03-25-171011,171011,13,0,17,77,20.2,0.009663389,2
2020-03-26-171011,171011,12,0,4,89,17.2,0.01197996,3
2020-03-27-171011,171011,6,0,10,95,17.0,0.010208719,4
2020-03-28-171011,171011,2,0,0,97,5.0,0.0020274918,5
2020-03-29-171011,171011,3,0,1,100,4.4,0.0012128358,6
2020-03-30-171011,171011,10,0,18,110,17.0,0.009119677,0
2020-03-31-171011,171011,7,0,1,117,7.8,0.004863009,1
2020-04-01-171011,171011,4,0,6,121,7.6,0.00791178,2
2020-04-02-171011,171011,4,0,4,125,8.0,0.011919703,3
2020-04-03-171011,171011,4,0,0,129,6.8,0.015187914,4
2020-04-04-171011,171011,3,0,0,132,3.4,0.0009568741,5
2020-04-05-171011,171011,1,0,0,133,2.0,0.0009312212,6
2020-04-06-171011,171011,9,0,3,142,8.4,0.008192502,0
2020-04-07-171011,171011,94,0,4,236,9.6,0.010133725,1
2020-04-08-171011,171011,17,0,4,253,8.4,0.007899879,2
2020-04-09-171011,171011,4,0,0,257,6.4,0.005008765,3
2020-04-10-171011,171011,10,0,5,267,4.4,0.0019383556,4
2020-04-11-171011,171011,0,0,0,267,2.2,0.002152529,5
2020-04-12-171011,171011,1,0,0,268,3.2,0.0019997566,6
2020-04-13-171011,171011,18,0,2,286,46.2,0.008223308,0
2020-04-14-171011,171011,1,0,2,287,13.4,0.006489003,1
2020-04-15-171011,171011,6,0,0,293,7.6,0.00778017,2
2020-04-16-171011,171011,4,0,1,297,4.4,0.0049481397,3
2020-04-17-171011,171011,0,0,0,297,5.0,0.0041861413,4
2020-04-18-171011,171011,0,0,0,297,1.2,0.0004052088,5
2020-04-19-171011,171011,0,0,0,297,0.6,0.0004025902,6
2020-04-20-171011,171011,3,0,4,300,6.2,0.005855574,0
2020-04-21-171011,171011,4,1,2,304,5.2,0.0042034863,1
2020-04-22-171011,171011,4,0,2,308,4.8,0.004244901,2
2020-04-23-171011,171011,0,0,1,308,0.4,0.0002485004,3
2020-04-24-171011,171011,5,0,5,313,3.8,0.004812045,4
2020-04-25-171011,171011,0,0,0,313,0.2,0.0003129276,5
2020-04-26-171011,171011,0,0,0,313,0.0,0.00057640753,6
2020-04-27-171011,171011,2,0,3,315,3.6,0.005004732,0
2020-04-28-171011,171011,2,0,3,317,1.8,0.0038846957,1
2020-04-29-171011,171011,0,0,1,317,3.0,0.0065357215,2
2020-04-30-171011,171011,1,0,1,318,3.8,0.0040303105,3
2020-05-01-171011,171011,0,0,7,318,0.4,0.00052294316,4
2020-05-02-171011,171011,0,0,0,318,0.8,0.0009171943,5
2020-05-03-171011,171011,0,0,0,318,0.4,0.0001996674,6
2020-05-04-171011,171011,4,0,2,322,3.4,0.004071066,0
2020-05-05-171011,171011,2,0,1,324,3.8,0.0035075133,1
2020-05-06-171011,171011,2,0,2,326,4.6,0.0076318625,2
2020-05-07-171011,171011,1,0,2,327,4.2,0.0050008628,3
2020-05-08-171011,171011,5,0,1,332,6.4,0.004974842,4
2020-05-09-171011,171011,0,0,0,332,0.4,0.00095053884,5
2020-05-10-171011,171011,0,0,0,332,0.6,0.0005170157,6
2020-05-11-171011,171011,3,0,1,335,6.2,0.005031063,0
2020-05-12-171011,171011,3,0,3,338,3.4,0.0042003663,1
2020-05-13-171011,171011,1,0,2,339,0.8,0.0046230513,2
2020-05-14-171011,171011,1,0,2,340,2.8,0.0043663173,3
2020-05-15-171011,171011,7,0,2,347,3.8,0.0037920952,4
2020-05-16-171011,171011,0,0,1,347,0.6,0.00040126775,5
2020-05-17-171011,171011,0,0,0,347,0.6,0.000112605034,6
2020-05-18-171011,171011,2,0,3,349,4.0,0.0056182155,0
2020-05-19-171011,171011,1,0,3,350,1.2,0.0043276567,1
2020-05-20-171011,171011,2,0,1,352,2.2,0.0035882937,2
2020-05-21-171011,171011,2,0,2,354,2.2,0.0051317643,3
2020-05-22-171011,171011,1,1,1,355,1.8,0.0047530043,4
2020-05-23-171011,171011,0,0,1,355,1.4,8.6305015e-05,5
2020-05-24-171011,171011,0,0,0,355,0.0,0.00012577613,6
2020-05-25-171011,171011,1,0,1,356,3.6,0.005572547,0
2020-05-26-171011,171011,3,0,0,359,3.8,0.0031255637,1
2020-05-27-171011,171011,2,0,2,361,1.0,0.0035874695,2
2020-05-28-171011,171011,2,1,5,363,1.6,0.004008089,3
2020-05-29-171011,171011,2,0,0,365,2.0,0.004872971,4
2020-05-30-171011,171011,1,0,0,366,0.2,0.0005847297,5
2020-05-31-171011,171011,0,0,0,366,0.2,0.0007346176,6
2020-06-01-171011,171011,3,0,4,369,1.2,0.006885573,0
2020-06-02-171011,171011,3,0,1,372,2.4,0.0039111883,1
2020-06-03-171011,171011,1,0,1,373,1.2,0.0039100577,2
2020-06-04-171011,171011,2,0,1,375,2.2,0.003226902,3
2020-06-05-171011,171011,1,4,3,376,2.2,0.0020994956,4
2020-06-06-171011,171011,1,0,0,377,0.0,0.0002683609,5
2020-06-07-171011,171011,0,4,0,377,0.0,0.00021562411,6
2020-06-08-171011,171011,1,0,2,378,2.2,0.004498484,0
2020-06-09-171011,171011,0,0,2,378,0.8,0.0039363396,1
2020-06-10-171011,171011,2,0,3,380,1.0,0.005764696,2
2020-06-11-171011,171011,5,0,1,385,0.6,0.0053294715,3
2020-06-12-171011,171011,0,0,0,385,1.6,0.003161611,4
2020-06-13-171011,171011,0,0,0,385,0.4,0.0002366218,5
2020-06-14-171011,171011,0,0,0,385,0.2,0.0002655166,6
2020-06-15-171011,171011,4,9,1,389,1.0,0.0053884047,0
2020-06-16-171011,171011,1,1,1,390,2.8,0.0068815327,1
2020-06-17-171011,171011,1,0,0,391,1.8,0.0037588398,2
2020-06-18-171011,171011,1,0,0,392,1.0,0.0039407276,3
2020-06-19-171011,171011,3,1,1,395,1.4,0.0056939716,4
2020-06-20-171011,171011,0,0,0,395,0.0,0.0007758771,5
2020-06-21-171011,171011,0,0,0,395,0.0,0.00017808947,6
2020-06-22-171011,171011,2,0,3,397,0.6,0.0031012394,0
2020-06-23-171011,171011,2,0,0,399,1.6,0.004524414,1
2020-06-24-171011,171011,3,0,2,402,1.0,0.0013685467,2
2020-06-25-171011,171011,1,0,1,403,0.4,0.0017659537,3
2020-06-26-171011,171011,0,0,2,403,2.0,0.0021275105,4
2020-06-27-171011,171011,0,0,0,403,0.0,0.00077245355,5
2020-06-28-171011,171011,0,0,0,403,0.2,0.000522402,6
2020-06-29-171011,171011,1,0,0,404,3.4,0.0037455375,0
2020-06-30-171011,171011,1,0,0,405,0.6,0.0018203893,1
2020-07-01-171011,171011,0,0,0,405,0.0,0.0023655212,2
2020-07-02-171011,171011,0,0,1,405,0.4,0.0015076014,3
2020-07-03-171011,171011,1,0,0,406,1.0,0.002270067,4
2020-07-04-171011,171011,0,0,0,406,0.0,0.00018274799,5
2020-07-05-171011,171011,0,0,0,406,0.0,0.00050681765,6
2020-07-06-171011,171011,3,0,2,409,0.6,0.0025132855,0
2020-07-07-171011,171011,0,0,2,409,0.6,0.002148618,1
2020-07-08-171011,171011,2,0,0,411,0.6,0.00067437737,2
2020-07-09-171011,171011,1,0,0,412,0.6,0.00085907057,3
2020-07-10-171011,171011,2,2,1,414,0.6,0.0021453602,4
2020-07-11-171011,171011,0,0,1,414,0.0,0.00019201024,5
2020-07-12-171011,171011,0,1,0,414,0.0,0.00048356835,6
2020-07-13-171011,171011,0,0,0,414,0.4,0.002076974,0
2020-07-14-171011,171011,0,0,0,414,0.4,0.0011053381,1
2020-07-15-171011,171011,0,0,1,414,0.8,0.0011646429,2
2020-07-16-171011,171011,1,1,1,415,0.0,0.0011455793,3
2020-07-17-171011,171011,0,0,2,415,0.6,0.0033374277,4
2020-07-18-171011,171011,0,0,0,415,0.0,0.00013646272,5
2020-07-19-171011,171011,0,0,0,415,0.2,0.0006304722,6
2020-07-20-171011,171011,2,0,1,417,0.2,0.0019492393,0
2020-07-21-171011,171011,2,0,1,419,0.6,0.0038166626,1
2020-07-22-171011,171011,0,0,0,419,0.2,0.0011472665,2
2020-07-23-171011,171011,0,0,0,419,0.6,0.004835482,3
2020-07-24-171011,171011,1,0,0,420,1.2,0.0026695943,4
2020-07-25-171011,171011,1,0,0,421,0.2,0.00054999976,5
2020-07-26-171011,171011,0,0,1,421,0.4,0.00013508441,6
2020-07-27-171011,171011,0,0,8,421,0.2,0.0058393627,0
2020-07-28-171011,171011,0,0,1,421,0.0,0.0014782707,1
2020-07-29-171011,171011,1,0,1,422,0.4,0.0019798044,2
2020-07-30-171011,171011,1,1,2,423,0.8,0.0032441693,3
2020-07-31-171011,171011,2,0,0,425,0.8,0.0030491587,4
2020-08-01-171011,171011,0,0,1,425,0.0,0.00036577153,5
2020-08-02-171011,171011,0,0,1,425,0.0,0.0010431542,6
2020-08-03-171011,171011,1,0,7,426,1.6,0.0026238267,0
2020-08-04-171011,171011,1,0,1,427,1.0,0.003123645,1
2020-08-05-171011,171011,0,0,4,427,1.0,0.007929585,2
2020-08-06-171011,171011,0,0,5,427,1.8,0.0027648648,3
2020-08-07-171011,171011,0,0,2,427,0.6,0.0026089633,4
2020-08-08-171011,171011,0,0,1,427,1.0,0.0032113197,5
2020-08-09-171011,171011,1,0,0,428,0.2,0.0020240522,6
2020-08-10-171011,171011,8,0,3,436,1.0,0.00397604,0
2020-08-11-171011,171011,1,0,1,437,2.6,0.007558871,1
2020-08-12-171011,171011,1,0,4,438,2.8,0.00434813,2
2020-08-13-171011,171011,2,0,2,440,1.4,0.0061962325,3
2020-08-14-171011,171011,0,0,2,440,1.4,0.007690526,4
2020-08-15-171011,171011,1,0,6,441,0.4,0.0021853035,5
2020-08-16-171011,171011,1,0,1,442,1.8,0.003149985,6
2020-08-17-171011,171011,7,0,4,449,1.2,0.0062122326,0
2020-08-18-171011,171011,1,0,2,450,4.4,0.008263397,1
2020-08-19-171011,171011,4,0,3,454,3.2,0.0086733345,2
2020-08-20-171011,171011,5,0,4,459,4.6,0.009810962,3
2020-08-21-171011,171011,2,0,0,461,4.0,0.0123794405,4
2020-08-22-171011,171011,1,0,2,462,1.4,0.0038151436,5
2020-08-23-171011,171011,0,0,2,462,3.2,0.0029718415,6
2020-08-24-171011,171011,3,0,10,465,4.2,0.010492779,0
2020-08-25-171011,171011,1,0,4,466,4.8,0.017920498,1
2020-08-26-171011,171011,4,0,6,470,2.8,0.011021419,2
2020-08-27-171011,171011,2,0,3,472,7.0,0.017499931,3
2020-08-28-171011,171011,2,0,5,474,6.8,0.018216088,4
2020-08-29-171011,171011,6,0,6,480,3.4,0.004185454,5
2020-08-30-171011,171011,1,0,3,481,2.4,0.008922482,6
2020-08-31-171011,171011,4,0,1,485,6.0,0.008210144,0
2020-09-01-171011,171011,2,0,2,487,3.2,0.0061418856,1
2020-09-02-171011,171011,3,0,7,490,6.2,0.00994544,2
2020-09-03-171011,171011,4,0,4,494,8.2,0.009986421,3
2020-09-04-171011,171011,0,0,3,494,7.0,0.010601779,4
2020-09-05-171011,171011,2,0,7,496,6.0,0.0060219374,5
2020-09-06-171011,171011,2,0,4,498,6.6,0.007155598,6
2020-09-07-171011,171011,10,0,3,508,12.0,0.014110004,0
2020-09-08-171011,171011,4,0,5,512,2.2,0.011856575,1
2020-09-09-171011,171011,6,0,10,518,4.6,0.015167082,2
2020-09-10-171011,171011,3,0,1,521,9.8,0.020774929,3
2020-09-11-171011,171011,5,0,0,526,7.2,0.017791381,4
2020-09-12-171011,171011,6,0,3,532,1.6,0.008221994,5
2020-09-13-171011,171011,3,0,1,535,3.4,0.0046332525,6
2020-09-14-171011,171011,1,0,5,536,9.6,0.02086969,0
2020-09-15-171011,171011,2,0,3,538,4.8,0.02500701,1
2020-09-16-171011,171011,7,0,5,545,10.0,0.021943692,2
2020-09-17-171011,171011,4,0,5,549,9.8,0.028271608,3
2020-09-18-171011,171011,3,0,6,552,5.8,0.027356,4
2020-09-19-171011,171011,7,0,3,559,2.2,0.020834237,5
2020-09-20-171011,171011,4,0,0,563,2.2,0.005885936,6
2020-09-21-171011,171011,3,0,8,566,7.6,0.016400784,0
2020-09-22-171011,171011,5,2,4,571,7.0,0.017270703,1
2020-09-23-171011,171011,10,0,8,581,8.6,0.020752491,2
2020-09-24-171011,171011,1,0,0,582,7.6,0.025866752,3
2020-09-25-171011,171011,0,0,6,582,8.8,0.022289729,4
2020-09-26-171011,171011,3,0,0,585,1.8,0.014516081,5
2020-09-27-171011,171011,1,0,0,586,3.0,0.008024039,6
2020-09-28-171011,171011,5,0,2,591,5.6,0.011118305,0
2020-09-29-171011,171011,3,0,2,594,6.4,0.0123097375,1
2020-09-30-171011,171011,5,0,1,599,5.2,0.011412227,2
2020-10-01-171011,171011,5,0,4,604,5.6,0.020557549,3
2020-10-02-171011,171011,6,0,6,610,6.8,0.015623239,4
2020-10-03-171011,171011,3,0,0,613,2.4,0.0077428548,5
2020-10-04-171011,171011,0,0,1,613,2.6,0.0037101994,6
2020-10-05-171011,171011,8,1,10,621,6.4,0.015115918,0
2020-10-06-171011,171011,4,0,3,625,7.8,0.024450697,1
2020-10-07-171011,171011,8,1,9,633,6.6,0.019673495,2
2020-10-08-171011,171011,0,0,6,633,8.8,0.03378189,3
2020-10-09-171011,171011,6,0,14,639,9.0,0.025148205,4
2020-10-10-171011,171011,0,0,7,639,4.8,0.010644796,5
2020-10-11-171011,171011,0,0,7,639,0.6,0.00811303,6
2020-10-12-171011,171011,2,0,13,641,1.6,0.0073043513,0
2020-10-13-171011,171011,2,0,18,643,7.0,0.020969426,1
2020-10-14-171011,171011,1,0,3,644,7.2,0.02406449,2
2020-10-15-171011,171011,4,0,3,648,5.8,0.01847344,3
2020-10-16-171011,171011,6,0,10,654,9.8,0.026023079,4
2020-10-17-171011,171011,0,0,11,654,4.4,0.011848245,5
2020-10-18-171011,171011,1,0,5,655,1.8,0.009570762,6
2020-10-19-171011,171011,10,0,3,665,7.8,0.015241921,0
2020-10-20-171011,171011,3,0,5,668,10.8,0.030891046,1
2020-10-21-171011,171011,9,0,9,677,14.2,0.022739569,2
2020-10-22-171011,171011,6,0,8,683,11.6,0.024870861,3
2020-10-23-171011,171011,14,0,3,697,18.4,0.039741106,4
2020-10-24-171011,171011,7,0,10,704,6.6,0.012242067,5
2020-10-25-171011,171011,7,0,4,711,4.0,0.0075333053,6
2020-10-26-171011,171011,13,0,10,724,21.2,0.033418823,0
2020-10-27-171011,171011,18,0,7,742,14.2,0.034543443,1
2020-10-28-171011,171011,3,0,14,745,19.0,0.037065927,2
2020-10-29-171011,171011,3,0,11,748,19.2,0.030888364,3
2020-10-30-171011,171011,10,0,15,758,23.2,0.047461733,4
2020-10-31-171011,171011,11,0,0,769,9.0,0.015547347,5
2020-11-01-171011,171011,5,2,0,774,5.8,0.010491802,6
2020-11-02-171011,171011,3,0,0,777,2.4,0.008014749,0
2020-11-03-171011,171011,5,1,0,782,10.4,0.026916888,1
2020-11-04-171011,171011,9,1,0,791,13.0,0.036849957,2
2020-11-05-171011,171011,8,1,0,799,17.2,0.038433813,3
2020-11-06-171011,171011,3,0,0,802,15.2,0.034469817,4
2020-11-07-171011,171011,10,1,0,812,4.8,0.013247695,5
2020-11-08-171011,171011,4,0,0,816,4.0,0.0067535844,6
2020-11-09-171011,171011,10,1,0,826,17.8,0.018485732,0
2020-11-10-171011,171011,7,0,0,833,11.4,0.026134502,1
2020-11-11-171011,171011,14,0,0,847,14.8,0.026713556,2
2020-11-12-171011,171011,11,1,0,858,13.2,0.036620576,3
2020-11-13-171011,171011,15,1,0,873,15.6,0.022223063,4
2020-03-01-171012,171012,0,0,1,0,0.0,0.00033728295,6
2020-03-02-171012,171012,0,0,3,0,0.0,0.0003526771,0
2020-03-03-171012,171012,0,0,7,0,0.0,8.148944e-05,1
2020-03-04-171012,171012,0,1,12,0,0.0,6.509099e-05,2
2020-03-05-171012,171012,0,0,14,0,0.0,0.00023595411,3
2020-03-06-171012,171012,0,0,11,0,0.0,0.0010970779,4
2020-03-07-171012,171012,0,0,2,0,0.0,0.0001703853,5
2020-03-08-171012,171012,0,0,4,0,0.0,0.0002226586,6
2020-03-09-171012,171012,1,0,17,1,0.25,0.0028451278,0
2020-03-10-171012,171012,0,0,19,1,1.0,0.001487309,1
2020-03-11-171012,171012,1,0,26,2,1.0,0.0013140691,2
2020-03-12-171012,171012,1,0,16,3,0.5,0.001996115,3
2020-03-13-171012,171012,3,0,16,6,2.25,0.0057316613,4
2020-03-14-171012,171012,2,0,6,8,1.5,0.0017036373,5
2020-03-15-171012,171012,1,0,7,9,1.25,0.0012086832,6
2020-03-16-171012,171012,3,0,9,12,5.25,0.015244774,0
2020-03-17-171012,171012,7,0,9,19,5.25,0.010847769,1
2020-03-18-171012,171012,12,1,10,31,9.75,0.01456937,2
2020-03-19-171012,171012,14,1,4,45,13.5,0.021042742,3
2020-03-20-171012,171012,11,0,8,56,9.5,0.017299924,4
2020-03-21-171012,171012,2,0,4,58,4.25,0.002929463,5
2020-03-22-171012,171012,4,0,1,62,3.75,0.002171147,6
2020-03-23-171012,171012,17,0,3,79,17.5,0.02615901,0
2020-03-24-171012,171012,19,1,11,98,11.25,0.015064573,1
2020-03-25-171012,171012,26,0,9,124,15.0,0.014934618,2
2020-03-26-171012,171012,16,0,0,140,13.0,0.018340057,3
2020-03-27-171012,171012,16,0,6,156,9.75,0.015555675,4
2020-03-28-171012,171012,6,0,0,162,3.0,0.0031636492,5
2020-03-29-171012,171012,7,0,2,169,2.25,0.001810429,6
2020-03-30-171012,171012,9,0,10,178,10.75,0.014449134,0
2020-03-31-171012,171012,9,0,6,187,4.5,0.007860157,1
2020-04-01-171012,171012,10,0,7,197,5.5,0.012457888,2
2020-04-02-171012,171012,4,1,6,201,5.25,0.01886368,3
2020-04-03-171012,171012,8,0,5,209,4.5,0.023945043,4
2020-04-04-171012,171012,4,0,0,213,2.75,0.0014981411,5
2020-04-05-171012,171012,1,0,1,214,2.5,0.001499467,6
2020-04-06-171012,171012,3,0,9,217,6.75,0.012559531,0
2020-04-07-171012,171012,11,0,3,228,26.75,0.016249357,1
2020-04-08-171012,171012,9,0,4,237,7.5,0.012544066,2
2020-04-09-171012,171012,0,0,0,237,4.5,0.007983793,3
2020-04-10-171012,171012,6,0,3,243,4.75,0.003074904,4
2020-04-11-171012,171012,0,0,0,243,1.0,0.0034640138,5
2020-04-12-171012,171012,2,0,0,245,1.0,0.0032674023,6
2020-04-13-171012,171012,10,0,5,255,10.0,0.012657972,0
2020-04-14-171012,171012,6,0,1,261,6.0,0.009953326,1
2020-04-15-171012,171012,7,0,1,268,4.75,0.01229699,2
2020-04-16-171012,171012,6,0,5,274,2.0,0.0075340928,3
2020-04-17-171012,171012,5,0,0,279,1.5,0.0064131403,4
2020-04-18-171012,171012,0,0,1,279,1.0,0.00064388337,5
2020-04-19-171012,171012,1,0,0,280,0.5,0.0006671783,6
2020-04-20-171012,171012,9,0,2,289,3.0,0.008759571,0
2020-04-21-171012,171012,3,0,4,292,3.5,0.006095457,1
2020-04-22-171012,171012,4,1,5,296,4.0,0.0067027356,2
2020-04-23-171012,171012,0,0,6,296,0.25,0.00035897936,3
2020-04-24-171012,171012,3,0,6,299,3.75,0.007266376,4
2020-04-25-171012,171012,0,0,0,299,0.5,0.00045185492,5
2020-04-26-171012,171012,0,1,2,299,0.25,0.0008534798,6
2020-04-27-171012,171012,5,0,13,304,1.75,0.0076380465,0
2020-04-28-171012,171012,1,0,5,305,2.25,0.005925554,1
2020-04-29-171012,171012,1,0,0,306,1.5,0.009808171,2
2020-04-30-171012,171012,5,0,1,311,2.0,0.0064634443,3
2020-05-01-171012,171012,0,0,6,311,0.25,0.00082125136,4
2020-05-02-171012,171012,1,0,0,312,0.25,0.0014949034,5
2020-05-03-171012,171012,0,0,0,312,0.5,0.00031920802,6
2020-05-04-171012,171012,2,0,5,314,2.5,0.006200339,0
2020-05-05-171012,171012,4,0,1,318,1.25,0.005334969,1
2020-05-06-171012,171012,5,0,3,323,2.25,0.011615415,2
2020-05-07-171012,171012,6,0,1,329,2.0,0.007576101,3
2020-05-08-171012,171012,6,0,2,335,3.75,0.007608488,4
2020-05-09-171012,171012,0,2,0,335,0.25,0.0014888697,5
2020-05-10-171012,171012,2,0,0,337,0.25,0.00083114585,6
2020-05-11-171012,171012,13,0,7,350,2.25,0.007848267,0
2020-05-12-171012,171012,5,0,6,355,2.0,0.006646849,1
2020-05-13-171012,171012,0,0,3,355,1.25,0.0073392526,2
2020-05-14-171012,171012,1,0,1,356,2.0,0.0065631564,3
2020-05-15-171012,171012,6,0,1,362,3.0,0.00579991,4
2020-05-16-171012,171012,0,0,0,362,1.0,0.0005365599,5
2020-05-17-171012,171012,0,0,0,362,0.25,0.00016513545,6
2020-05-18-171012,171012,5,0,4,367,3.25,0.008587942,0
2020-05-19-171012,171012,1,0,5,368,1.5,0.006463444,1
2020-05-20-171012,171012,3,0,2,371,1.5,0.0056531127,2
2020-05-21-171012,171012,1,1,2,372,1.75,0.008170937,3
2020-05-22-171012,171012,2,0,2,374,1.25,0.0073843384,4
2020-05-23-171012,171012,0,0,0,374,1.0,0.00013162431,5
2020-05-24-171012,171012,0,0,0,374,0.0,0.00019029732,6
2020-05-25-171012,171012,7,0,4,381,1.0,0.008152525,0
2020-05-26-171012,171012,6,0,1,387,2.0,0.004668916,1
2020-05-27-171012,171012,3,1,0,390,0.75,0.0053559244,2
2020-05-28-171012,171012,1,0,1,391,1.0,0.0061323997,3
2020-05-29-171012,171012,1,0,3,392,2.0,0.0069876066,4
2020-05-30-171012,171012,0,0,0,392,0.5,0.00085714576,5
2020-05-31-171012,171012,0,0,0,392,0.0,0.0010847647,6
2020-06-01-171012,171012,4,0,1,396,0.75,0.010107394,0
2020-06-02-171012,171012,5,0,1,401,1.5,0.005641384,1
2020-06-03-171012,171012,2,0,1,403,0.25,0.005657085,2
2020-06-04-171012,171012,2,0,1,405,2.0,0.004995919,3
2020-06-05-171012,171012,2,0,3,407,1.5,0.0030261818,4
2020-06-06-171012,171012,0,0,0,407,0.25,0.00042224317,5
2020-06-07-171012,171012,0,0,0,407,0.0,0.00030842287,6
2020-06-08-171012,171012,4,0,1,411,0.75,0.006679952,0
2020-06-09-171012,171012,1,0,0,412,0.25,0.005549823,1
2020-06-10-171012,171012,0,0,0,412,1.5,0.0085415635,2
2020-06-11-171012,171012,1,0,0,413,1.5,0.007987346,3
2020-06-12-171012,171012,3,0,3,416,1.75,0.004688842,4
2020-06-13-171012,171012,0,0,0,416,0.25,0.00033861652,5
2020-06-14-171012,171012,0,0,0,416,0.0,0.00040543434,6
2020-06-15-171012,171012,1,1,6,417,2.0,0.008169185,0
2020-06-16-171012,171012,1,0,1,418,3.5,0.009997775,1
2020-06-17-171012,171012,1,0,0,419,1.25,0.005469061,2
2020-06-18-171012,171012,1,0,0,420,1.0,0.005795967,3
2020-06-19-171012,171012,3,0,0,423,1.5,0.0083852215,4
2020-06-20-171012,171012,0,0,0,423,0.0,0.0011419514,5
2020-06-21-171012,171012,0,0,0,423,0.0,0.00026907472,6
2020-06-22-171012,171012,1,0,0,424,0.75,0.0045446428,0
2020-06-23-171012,171012,0,0,1,424,1.5,0.006891676,1
2020-06-24-171012,171012,0,1,0,424,1.75,0.0020746419,2
2020-06-25-171012,171012,0,0,0,424,1.0,0.0025625525,3
2020-06-26-171012,171012,3,0,1,427,0.75,0.0031735555,4
2020-06-27-171012,171012,0,1,0,427,0.0,0.0011629455,5
2020-06-28-171012,171012,0,0,0,427,0.0,0.0008178113,6
2020-06-29-171012,171012,6,0,0,433,2.0,0.005639234,0
2020-06-30-171012,171012,1,0,1,434,0.5,0.0026966883,1
2020-07-01-171012,171012,0,0,0,434,0.0,0.0033976366,2
2020-07-02-171012,171012,0,0,0,434,0.0,0.0021452399,3
2020-07-03-171012,171012,0,0,0,434,1.5,0.00344895,4
2020-07-04-171012,171012,0,0,0,434,0.0,0.000256203,5
2020-07-05-171012,171012,0,0,1,434,0.0,0.0007347678,6
2020-07-06-171012,171012,0,0,1,434,1.25,0.0037221066,0
2020-07-07-171012,171012,1,0,1,435,0.25,0.0032975483,1
2020-07-08-171012,171012,0,0,0,435,0.75,0.00097598135,2
2020-07-09-171012,171012,0,0,1,435,0.5,0.0012273313,3
2020-07-10-171012,171012,1,0,1,436,0.5,0.0032527284,4
2020-07-11-171012,171012,0,0,0,436,0.0,0.00027079214,5
2020-07-12-171012,171012,0,0,0,436,0.0,0.0007650529,6
2020-07-13-171012,171012,0,0,0,436,0.25,0.0031931875,0
2020-07-14-171012,171012,1,0,0,437,0.25,0.0015057098,1
2020-07-15-171012,171012,0,0,1,437,0.25,0.0016902575,2
2020-07-16-171012,171012,0,0,1,437,0.25,0.0016619255,3
2020-07-17-171012,171012,0,0,1,437,0.5,0.0049242247,4
2020-07-18-171012,171012,0,0,0,437,0.0,0.0002150932,5
2020-07-19-171012,171012,1,0,0,438,0.0,0.0009178823,6
2020-07-20-171012,171012,1,0,1,439,0.5,0.0029114145,0
2020-07-21-171012,171012,1,0,1,440,0.75,0.005538178,1
2020-07-22-171012,171012,0,0,1,440,0.0,0.0016110564,2
2020-07-23-171012,171012,1,0,4,441,0.25,0.0072181355,3
2020-07-24-171012,171012,1,0,1,442,0.5,0.0039082686,4
2020-07-25-171012,171012,0,0,0,442,0.25,0.0008678518,5
2020-07-26-171012,171012,0,0,0,442,0.0,0.00018800987,6
2020-07-27-171012,171012,0,0,0,442,0.0,0.008965992,0
2020-07-28-171012,171012,0,0,4,442,0.0,0.00199007,1
2020-07-29-171012,171012,1,0,3,443,0.25,0.0028685988,2
2020-07-30-171012,171012,1,0,0,444,1.0,0.0049005686,3
2020-07-31-171012,171012,1,0,0,445,0.75,0.004473673,4
2020-08-01-171012,171012,0,0,1,445,0.0,0.00052006444,5
2020-08-02-171012,171012,0,0,4,445,0.0,0.0016143696,6
2020-08-03-171012,171012,1,0,1,446,0.75,0.0038427075,0
2020-08-04-171012,171012,1,0,10,447,0.5,0.0046498524,1
2020-08-05-171012,171012,1,0,9,448,1.25,0.012094564,2
2020-08-06-171012,171012,4,0,4,452,0.75,0.004286397,3
2020-08-07-171012,171012,1,0,6,453,0.25,0.0038352434,4
2020-08-08-171012,171012,0,0,1,453,0.0,0.004927416,5
2020-08-09-171012,171012,0,0,5,453,0.5,0.0031764768,6
2020-08-10-171012,171012,0,0,10,453,2.75,0.0058978405,0
2020-08-11-171012,171012,4,0,8,457,2.25,0.01120185,1
2020-08-12-171012,171012,3,0,6,460,2.0,0.0061509665,2
2020-08-13-171012,171012,0,0,3,460,2.0,0.0089886105,3
2020-08-14-171012,171012,0,0,8,460,0.75,0.011498487,4
2020-08-15-171012,171012,1,0,6,461,0.5,0.0032448128,5
2020-08-16-171012,171012,4,0,2,465,1.0,0.0048967227,6
2020-08-17-171012,171012,1,0,8,466,2.75,0.009002956,0
2020-08-18-171012,171012,10,0,2,476,2.25,0.012169475,1
2020-08-19-171012,171012,9,0,5,485,2.75,0.012340573,2
2020-08-20-171012,171012,4,0,5,489,3.0,0.014040957,3
2020-08-21-171012,171012,6,0,3,495,3.75,0.018314764,4
2020-08-22-171012,171012,1,0,12,496,0.25,0.005884815,5
2020-08-23-171012,171012,5,0,19,501,1.5,0.0046440703,6
2020-08-24-171012,171012,10,1,14,511,1.5,0.015450496,0
2020-08-25-171012,171012,8,0,4,519,2.25,0.027105467,1
2020-08-26-171012,171012,6,2,8,525,2.25,0.016582899,2
2020-08-27-171012,171012,3,0,23,528,4.25,0.027100008,3
2020-08-28-171012,171012,8,0,6,536,2.25,0.026990429,4
2020-08-29-171012,171012,6,0,5,542,3.25,0.006019353,5
2020-08-30-171012,171012,2,0,7,544,1.25,0.0136082955,6
2020-08-31-171012,171012,8,0,5,552,4.5,0.012539611,0
2020-09-01-171012,171012,2,0,8,554,4.25,0.008873631,1
2020-09-02-171012,171012,5,0,7,559,3.5,0.014227566,2
2020-09-03-171012,171012,5,0,6,564,3.0,0.014901171,3
2020-09-04-171012,171012,3,0,6,567,5.0,0.016003245,4
2020-09-05-171012,171012,12,0,0,579,6.5,0.008780788,5
2020-09-06-171012,171012,19,0,8,598,5.25,0.010810895,6
2020-09-07-171012,171012,14,0,7,612,8.25,0.020808758,0
2020-09-08-171012,171012,4,0,6,616,1.75,0.017647646,1
2020-09-09-171012,171012,8,0,8,624,2.75,0.022207312,2
2020-09-10-171012,171012,23,0,4,647,4.75,0.03146406,3
2020-09-11-171012,171012,6,0,9,653,7.0,0.026067922,4
2020-09-12-171012,171012,5,0,2,658,2.25,0.012495433,5
2020-09-13-171012,171012,7,0,4,665,2.5,0.0068043834,6
2020-09-14-171012,171012,5,0,1,670,4.0,0.030715168,0
2020-09-15-171012,171012,8,0,6,678,3.25,0.03750414,1
2020-09-16-171012,171012,7,1,3,685,5.25,0.032999046,2
2020-09-17-171012,171012,6,0,4,691,7.5,0.040400807,3
2020-09-18-171012,171012,6,0,5,697,4.5,0.03898456,4
2020-09-19-171012,171012,0,0,7,697,4.5,0.032609057,5
2020-09-20-171012,171012,8,0,3,705,2.25,0.009003067,6
2020-09-21-171012,171012,7,2,7,712,3.5,0.024601044,0
2020-09-22-171012,171012,6,0,7,718,6.5,0.025143977,1
2020-09-23-171012,171012,8,0,7,726,7.0,0.030823398,2
2020-09-24-171012,171012,4,0,12,730,4.25,0.037630323,3
2020-09-25-171012,171012,9,0,11,739,3.5,0.031627163,4
2020-09-26-171012,171012,2,0,7,741,1.25,0.02117472,5
2020-09-27-171012,171012,4,0,1,745,0.5,0.012250299,6
2020-09-28-171012,171012,1,0,3,746,4.0,0.016515788,0
2020-09-29-171012,171012,6,0,1,752,3.25,0.018720655,1
2020-09-30-171012,171012,3,0,3,755,3.0,0.016425196,2
2020-10-01-171012,171012,4,0,6,759,3.75,0.030280214,3
2020-10-02-171012,171012,5,0,16,764,4.75,0.022646576,4
2020-10-03-171012,171012,7,0,9,771,1.0,0.011337329,5
2020-10-04-171012,171012,3,0,2,774,1.0,0.005582391,6
2020-10-05-171012,171012,7,0,8,781,3.25,0.02252903,0
2020-10-06-171012,171012,7,0,3,788,4.25,0.03648222,1
2020-10-07-171012,171012,7,0,9,795,4.25,0.028092718,2
2020-10-08-171012,171012,12,0,10,807,3.75,0.04767761,3
2020-10-09-171012,171012,11,0,23,818,5.0,0.0368951,4
2020-10-10-171012,171012,7,0,3,825,3.75,0.015317476,5
2020-10-11-171012,171012,1,0,6,826,0.25,0.012110785,6
2020-10-12-171012,171012,3,0,28,829,1.75,0.011111998,0
2020-10-13-171012,171012,1,0,17,830,4.0,0.031208346,1
2020-10-14-171012,171012,3,0,19,833,5.5,0.035545018,2
2020-10-15-171012,171012,6,0,15,839,4.0,0.027810557,3
2020-10-16-171012,171012,16,0,26,855,5.25,0.039191097,4
2020-10-17-171012,171012,9,0,9,864,0.75,0.017283866,5
2020-10-18-171012,171012,2,0,8,866,1.75,0.014522236,6
2020-10-19-171012,171012,8,0,0,874,6.0,0.022534115,0
2020-10-20-171012,171012,3,0,8,877,9.0,0.046995617,1
2020-10-21-171012,171012,9,0,14,886,8.5,0.032406215,2
2020-10-22-171012,171012,10,0,17,896,9.25,0.03807701,3
2020-10-23-171012,171012,23,0,11,919,14.0,0.058230724,4
2020-10-24-171012,171012,3,0,12,922,5.5,0.018090453,5
2020-10-25-171012,171012,6,0,5,928,5.0,0.0113729825,6
2020-10-26-171012,171012,28,0,16,956,14.0,0.05080278,0
2020-10-27-171012,171012,17,0,12,973,11.75,0.051651947,1
2020-10-28-171012,171012,19,1,17,992,10.75,0.054669432,2
2020-10-29-171012,171012,15,0,16,1007,10.25,0.04701648,3
2020-10-30-171012,171012,26,1,20,1033,14.0,0.07092477,4
2020-10-31-171012,171012,9,2,0,1042,7.75,0.02324574,5
2020-11-01-171012,171012,8,1,0,1050,3.75,0.015584388,6
2020-11-02-171012,171012,0,0,0,1050,2.25,0.012125387,0
2020-11-03-171012,171012,8,0,0,1058,8.25,0.040335804,1
2020-11-04-171012,171012,14,0,0,1072,10.0,0.054713316,2
2020-11-05-171012,171012,17,1,0,1089,12.5,0.056360576,3
2020-11-06-171012,171012,11,0,0,1100,14.25,0.049945068,4
2020-11-07-171012,171012,12,0,0,1112,6.5,0.01957132,5
2020-11-08-171012,171012,5,0,0,1117,3.0,0.010312698,6
2020-11-09-171012,171012,16,2,0,1133,10.0,0.0268431,0
2020-11-10-171012,171012,12,1,0,1145,6.25,0.039442267,1
2020-11-11-171012,171012,17,1,0,1162,10.75,0.039433427,2
2020-11-12-171012,171012,16,1,0,1178,10.5,0.05362492,3
2020-11-13-171012,171012,20,0,0,1198,10.25,0.032935943,4
2020-03-01-171013,171013,0,0,1,0,0.0,0.0003902323,6
2020-03-02-171013,171013,0,0,13,0,0.0,0.00082445086,0
2020-03-03-171013,171013,0,0,12,0,0.0,0.00032380826,1
2020-03-04-171013,171013,0,0,8,0,0.5,0.00011104852,2
2020-03-05-171013,171013,0,2,8,0,0.25,0.0008481676,3
2020-03-06-171013,171013,0,0,8,0,0.0,0.0021778985,4
2020-03-07-171013,171013,0,0,2,0,0.25,0.00034477445,5
2020-03-08-171013,171013,0,0,9,0,0.25,0.00022117891,6
2020-03-09-171013,171013,1,0,13,1,0.0,0.005729243,0
2020-03-10-171013,171013,0,0,5,1,0.25,0.00221395,1
2020-03-11-171013,171013,0,0,11,1,0.25,0.002440268,2
2020-03-12-171013,171013,0,0,21,1,0.25,0.0031937445,3
2020-03-13-171013,171013,0,0,10,1,1.25,0.015344194,4
2020-03-14-171013,171013,0,0,0,1,0.75,0.0022058808,5
2020-03-15-171013,171013,1,0,2,2,1.0,0.007299793,6
2020-03-16-171013,171013,13,0,18,15,4.25,0.05180394,0
2020-03-17-171013,171013,12,0,9,27,8.75,0.03704827,1
2020-03-18-171013,171013,8,2,4,35,8.75,0.047782093,2
2020-03-19-171013,171013,8,0,4,43,12.25,0.070578255,3
2020-03-20-171013,171013,8,0,7,51,13.75,0.057753045,4
2020-03-21-171013,171013,2,0,0,53,3.25,0.0102602625,5
2020-03-22-171013,171013,9,0,2,62,6.75,0.013936567,6
2020-03-23-171013,171013,13,0,12,75,24.75,0.08443702,0
2020-03-24-171013,171013,5,0,2,80,24.75,0.05423337,1
2020-03-25-171013,171013,11,0,5,91,21.25,0.040352833,2
2020-03-26-171013,171013,21,0,2,112,19.5,0.060100127,3
2020-03-27-171013,171013,10,0,0,122,16.25,0.05499374,4
2020-03-28-171013,171013,0,0,2,122,4.0,0.00816199,5
2020-03-29-171013,171013,2,0,0,124,2.5,0.00462533,6
2020-03-30-171013,171013,18,0,7,142,22.0,0.036535427,0
2020-03-31-171013,171013,9,0,6,151,11.5,0.02765981,1
2020-04-01-171013,171013,4,0,5,155,12.5,0.039197184,2
2020-04-02-171013,171013,4,1,3,159,13.25,0.04172762,3
2020-04-03-171013,171013,7,0,5,166,13.5,0.10641876,4
2020-04-04-171013,171013,0,0,1,166,3.75,0.006297095,5
2020-04-05-171013,171013,2,0,0,168,1.75,0.0021101183,6
2020-04-06-171013,171013,12,1,5,180,17.0,0.049536016,0
2020-04-07-171013,171013,2,1,1,182,10.0,0.05503653,1
2020-04-08-171013,171013,5,0,3,187,9.25,0.04332734,2
2020-04-09-171013,171013,2,0,1,189,7.5,0.038668368,3
2020-04-10-171013,171013,0,0,3,189,6.5,0.015749715,4
2020-04-11-171013,171013,2,0,0,191,3.75,0.007837451,5
2020-04-12-171013,171013,0,0,1,191,3.0,0.020655222,6
2020-04-13-171013,171013,7,0,2,198,14.75,0.039606933,0
2020-04-14-171013,171013,6,0,5,204,8.25,0.030615004,1
2020-04-15-171013,171013,5,0,3,209,12.5,0.036664322,2
2020-04-16-171013,171013,3,0,3,212,6.0,0.024442406,3
2020-04-17-171013,171013,5,0,0,217,3.5,0.024472365,4
2020-04-18-171013,171013,1,0,1,218,1.0,0.001749067,5
2020-04-19-171013,171013,0,1,0,218,1.0,0.00085296767,6
2020-04-20-171013,171013,5,0,4,223,5.5,0.033986405,0
2020-04-21-171013,171013,1,0,5,224,7.25,0.014784192,1
2020-04-22-171013,171013,3,0,0,227,4.75,0.017131887,2
2020-04-23-171013,171013,1,0,1,228,0.0,0.0007000221,3
2020-04-24-171013,171013,3,0,7,231,5.25,0.021920647,4
2020-04-25-171013,171013,0,0,0,231,0.25,0.0007775049,5
2020-04-26-171013,171013,1,0,1,232,0.5,0.0037684802,6
2020-04-27-171013,171013,2,0,3,234,5.5,0.02693047,0
2020-04-28-171013,171013,5,0,0,239,1.25,0.022464171,1
2020-04-29-171013,171013,3,0,1,242,4.5,0.025262356,2
2020-04-30-171013,171013,3,0,3,245,6.5,0.022933498,3
2020-05-01-171013,171013,0,0,0,245,0.75,0.0050260453,4
2020-05-02-171013,171013,1,0,0,246,0.25,0.006526153,5
2020-05-03-171013,171013,0,0,0,246,0.25,0.0005401956,6
2020-05-04-171013,171013,4,0,3,250,5.0,0.018696012,0
2020-05-05-171013,171013,5,0,1,255,4.25,0.021678599,1
2020-05-06-171013,171013,0,0,1,255,5.0,0.033427745,2
2020-05-07-171013,171013,1,0,2,256,4.75,0.021761145,3
2020-05-08-171013,171013,7,0,0,263,6.0,0.02927296,4
2020-05-09-171013,171013,0,0,0,263,0.25,0.0057459013,5
2020-05-10-171013,171013,1,0,0,264,0.5,0.0026329367,6
2020-05-11-171013,171013,3,1,0,267,3.75,0.028301185,0
2020-05-12-171013,171013,0,0,2,267,2.75,0.01832421,1
2020-05-13-171013,171013,1,0,2,268,0.25,0.027809048,2
2020-05-14-171013,171013,3,0,0,271,3.5,0.027607804,3
2020-05-15-171013,171013,0,0,1,271,2.5,0.016149871,4
2020-05-16-171013,171013,0,0,0,271,0.0,0.00065517466,5
2020-05-17-171013,171013,0,0,0,271,0.0,0.000260171,6
2020-05-18-171013,171013,3,0,3,274,4.25,0.020280097,0
2020-05-19-171013,171013,1,1,1,275,3.75,0.016782552,1
2020-05-20-171013,171013,1,0,3,276,4.75,0.025506048,2
2020-05-21-171013,171013,2,0,1,278,2.0,0.02499674,3
2020-05-22-171013,171013,0,0,1,278,2.25,0.02193447,4
2020-05-23-171013,171013,0,0,1,278,0.75,0.00034126523,5
2020-05-24-171013,171013,0,0,0,278,0.0,0.0004600272,6
2020-05-25-171013,171013,0,0,1,278,3.5,0.017217435,0
2020-05-26-171013,171013,2,0,0,280,1.5,0.009937739,1
2020-05-27-171013,171013,2,0,2,282,2.5,0.0125115765,2
2020-05-28-171013,171013,0,0,1,282,1.5,0.013323991,3
2020-05-29-171013,171013,1,0,0,283,2.25,0.017053189,4
2020-05-30-171013,171013,0,0,0,283,0.0,0.0010898304,5
2020-05-31-171013,171013,0,0,0,283,0.0,0.0016728252,6
2020-06-01-171013,171013,3,0,0,286,2.75,0.025265487,0
2020-06-02-171013,171013,1,0,0,287,2.75,0.015905619,1
2020-06-03-171013,171013,3,0,0,290,2.75,0.014444466,2
2020-06-04-171013,171013,1,0,0,291,2.75,0.013409044,3
2020-06-05-171013,171013,1,0,1,292,3.0,0.0062040063,4
2020-06-06-171013,171013,1,0,0,293,0.25,0.0005168943,5
2020-06-07-171013,171013,0,0,0,293,0.0,0.0007063405,6
2020-06-08-171013,171013,1,0,0,294,1.5,0.015661154,0
2020-06-09-171013,171013,0,0,1,294,2.25,0.013767064,1
2020-06-10-171013,171013,2,0,0,296,1.5,0.027883977,2
2020-06-11-171013,171013,1,0,0,297,2.0,0.022253815,3
2020-06-12-171013,171013,0,0,2,297,1.5,0.008489333,4
2020-06-13-171013,171013,0,2,0,297,0.25,0.00054099725,5
2020-06-14-171013,171013,0,0,0,297,0.0,0.00041671473,6
2020-06-15-171013,171013,0,0,1,297,1.5,0.020516014,0
2020-06-16-171013,171013,0,0,0,297,2.75,0.023278514,1
2020-06-17-171013,171013,0,0,0,297,1.25,0.017246677,2
2020-06-18-171013,171013,0,0,0,297,1.25,0.015163391,3
2020-06-19-171013,171013,1,0,0,298,1.25,0.022825615,4
2020-06-20-171013,171013,0,0,1,298,0.0,0.004202986,5
2020-06-21-171013,171013,0,0,0,298,0.0,0.00052715605,6
2020-06-22-171013,171013,0,0,0,298,1.25,0.009215685,0
2020-06-23-171013,171013,1,0,0,299,1.25,0.017471436,1
2020-06-24-171013,171013,0,0,0,299,0.75,0.004574671,2
2020-06-25-171013,171013,0,2,0,299,1.25,0.005204397,3
2020-06-26-171013,171013,2,0,0,301,2.75,0.007120564,4
2020-06-27-171013,171013,0,0,0,301,0.0,0.0030488402,5
2020-06-28-171013,171013,0,0,0,301,0.25,0.0030847944,6
2020-06-29-171013,171013,1,0,0,302,1.0,0.01322133,0
2020-06-30-171013,171013,0,0,0,302,0.25,0.0077358643,1
2020-07-01-171013,171013,0,0,1,302,1.25,0.0076281056,2
2020-07-02-171013,171013,0,0,1,302,0.25,0.0033629222,3
2020-07-03-171013,171013,0,0,0,302,1.0,0.010197401,4
2020-07-04-171013,171013,1,0,0,303,0.0,0.0008010922,5
2020-07-05-171013,171013,0,0,0,303,0.25,0.00077154493,6
2020-07-06-171013,171013,0,0,0,303,0.5,0.010287331,0
2020-07-07-171013,171013,0,0,0,303,0.75,0.008667655,1
2020-07-08-171013,171013,0,0,0,303,1.25,0.0039506885,2
2020-07-09-171013,171013,0,0,0,303,1.0,0.002294934,3
2020-07-10-171013,171013,0,0,0,303,1.5,0.0077811833,4
2020-07-11-171013,171013,0,0,0,303,0.25,0.0004686222,5
2020-07-12-171013,171013,0,0,0,303,0.0,0.0028689164,6
2020-07-13-171013,171013,0,0,0,303,0.75,0.009639304,0
2020-07-14-171013,171013,0,0,1,303,1.25,0.0031783946,1
2020-07-15-171013,171013,1,0,0,304,0.5,0.004894003,2
2020-07-16-171013,171013,1,0,1,305,1.5,0.0028729807,3
2020-07-17-171013,171013,0,0,0,305,0.25,0.015749108,4
2020-07-18-171013,171013,0,0,0,305,0.0,0.00021706033,5
2020-07-19-171013,171013,0,0,1,305,0.0,0.001672582,6
2020-07-20-171013,171013,0,0,0,305,1.0,0.007675805,0
2020-07-21-171013,171013,0,0,1,305,1.5,0.013891396,1
2020-07-22-171013,171013,0,0,2,305,1.75,0.003531285,2
2020-07-23-171013,171013,0,0,0,305,1.25,0.013793185,3
2020-07-24-171013,171013,0,0,0,305,1.75,0.009017316,4
2020-07-25-171013,171013,0,0,0,305,0.0,0.0025083737,5
2020-07-26-171013,171013,0,0,0,305,0.0,0.00050843536,6
2020-07-27-171013,171013,0,0,1,305,1.25,0.02218987,0
2020-07-28-171013,171013,1,0,5,306,1.0,0.005616217,1
2020-07-29-171013,171013,0,0,0,306,1.0,0.009200611,2
2020-07-30-171013,171013,1,0,5,307,2.5,0.0108246375,3
2020-07-31-171013,171013,0,0,2,307,1.25,0.012428111,4
2020-08-01-171013,171013,0,0,0,307,0.25,0.0013770076,5
2020-08-02-171013,171013,1,0,4,308,0.25,0.0040185302,6
2020-08-03-171013,171013,0,0,7,308,0.5,0.010351872,0
2020-08-04-171013,171013,1,0,1,309,0.75,0.008553395,1
2020-08-05-171013,171013,2,0,6,311,4.0,0.01759305,2
2020-08-06-171013,171013,0,0,2,311,2.0,0.0073864018,3
2020-08-07-171013,171013,0,0,2,311,3.0,0.0072548348,4
2020-08-08-171013,171013,0,0,6,311,1.0,0.010393785,5
2020-08-09-171013,171013,0,0,0,311,0.5,0.0031227963,6
2020-08-10-171013,171013,1,0,2,312,2.25,0.0070790052,0
2020-08-11-171013,171013,5,0,5,317,2.25,0.018324418,1
2020-08-12-171013,171013,0,0,1,317,1.5,0.009830973,2
2020-08-13-171013,171013,5,0,1,322,6.0,0.015380686,3
2020-08-14-171013,171013,2,0,4,324,2.0,0.021966739,4
2020-08-15-171013,171013,0,0,3,324,3.0,0.0038856308,5
2020-08-16-171013,171013,4,0,0,328,3.0,0.0045377524,6
2020-08-17-171013,171013,7,0,1,335,5.0,0.020076424,0
2020-08-18-171013,171013,1,0,2,336,3.5,0.025995368,1
2020-08-19-171013,171013,6,0,1,342,4.5,0.026563592,2
2020-08-20-171013,171013,2,0,1,344,8.5,0.032549966,3
2020-08-21-171013,171013,2,0,1,346,5.25,0.04726256,4
2020-08-22-171013,171013,6,1,7,352,1.75,0.0126660345,5
2020-08-23-171013,171013,0,0,3,352,4.5,0.0068193353,6
2020-08-24-171013,171013,2,0,4,354,4.25,0.035953935,0
2020-08-25-171013,171013,5,0,0,359,8.5,0.08114295,1
2020-08-26-171013,171013,1,0,2,360,10.5,0.040486105,2
2020-08-27-171013,171013,1,0,6,361,8.75,0.08169508,3
2020-08-28-171013,171013,4,0,2,365,12.0,0.06701159,4
2020-08-29-171013,171013,3,0,1,368,2.5,0.0085501345,5
2020-08-30-171013,171013,0,0,8,368,3.75,0.02852372,6
2020-08-31-171013,171013,1,0,4,369,5.5,0.026946258,0
2020-09-01-171013,171013,2,0,5,371,5.0,0.019500155,1
2020-09-02-171013,171013,1,0,6,372,6.0,0.027722832,2
2020-09-03-171013,171013,1,0,2,373,3.75,0.03326501,3
2020-09-04-171013,171013,1,0,6,374,6.0,0.0339385,4
2020-09-05-171013,171013,7,0,5,381,3.25,0.014932298,5
2020-09-06-171013,171013,3,0,1,384,5.25,0.014773989,6
2020-09-07-171013,171013,4,0,2,388,12.25,0.041243967,0
2020-09-08-171013,171013,0,0,1,388,4.5,0.033215206,1
2020-09-09-171013,171013,2,0,2,390,10.25,0.05267041,2
2020-09-10-171013,171013,6,0,1,396,7.75,0.07684953,3
2020-09-11-171013,171013,2,0,4,398,12.0,0.05120259,4
2020-09-12-171013,171013,1,0,0,399,4.5,0.02162533,5
2020-09-13-171013,171013,8,0,2,407,2.0,0.009122834,6
2020-09-14-171013,171013,4,0,6,411,9.75,0.05989668,0
2020-09-15-171013,171013,5,0,7,416,10.0,0.084666766,1
2020-09-16-171013,171013,6,0,2,422,13.0,0.064957,2
2020-09-17-171013,171013,2,0,3,424,8.25,0.07439441,3
2020-09-18-171013,171013,6,0,4,430,9.0,0.07592112,4
2020-09-19-171013,171013,5,1,2,435,3.5,0.039126255,5
2020-09-20-171013,171013,1,0,0,436,4.75,0.013644101,6
2020-09-21-171013,171013,2,0,0,438,10.0,0.05289191,0
2020-09-22-171013,171013,1,1,1,439,3.5,0.049665585,1
2020-09-23-171013,171013,2,0,4,441,11.25,0.062395405,2
2020-09-24-171013,171013,1,0,1,442,6.25,0.089448795,3
2020-09-25-171013,171013,4,0,2,446,10.0,0.05876142,4
2020-09-26-171013,171013,0,0,1,446,3.5,0.028179668,5
2020-09-27-171013,171013,2,1,1,448,1.75,0.009081294,6
2020-09-28-171013,171013,6,0,3,454,4.5,0.02815718,0
2020-09-29-171013,171013,7,0,3,461,6.25,0.032491226,1
2020-09-30-171013,171013,2,0,7,463,7.25,0.04061632,2
2020-10-01-171013,171013,3,0,5,466,3.5,0.06285754,3
2020-10-02-171013,171013,4,0,1,470,8.5,0.04570785,4
2020-10-03-171013,171013,2,0,7,472,2.25,0.016782174,5
2020-10-04-171013,171013,0,0,0,472,6.0,0.007030824,6
2020-10-05-171013,171013,0,1,5,472,7.75,0.042930555,0
2020-10-06-171013,171013,1,0,7,473,7.5,0.08289821,1
2020-10-07-171013,171013,4,1,7,477,6.5,0.06071362,2
2020-10-08-171013,171013,1,0,6,478,5.25,0.07777035,3
2020-10-09-171013,171013,2,1,13,480,10.5,0.07197501,4
2020-10-10-171013,171013,1,0,10,481,5.0,0.025559938,5
2020-10-11-171013,171013,1,0,2,482,2.0,0.01242528,6
2020-10-12-171013,171013,3,0,13,485,2.0,0.016786635,0
2020-10-13-171013,171013,3,0,5,488,6.75,0.0774273,1
2020-10-14-171013,171013,7,0,14,495,8.75,0.074649744,2
2020-10-15-171013,171013,5,0,4,500,7.25,0.06410913,3
2020-10-16-171013,171013,1,0,10,501,11.0,0.08431731,4
2020-10-17-171013,171013,7,0,9,508,4.0,0.03891166,5
2020-10-18-171013,171013,0,0,10,508,1.25,0.015937617,6
2020-10-19-171013,171013,5,0,1,513,7.75,0.055661052,0
2020-10-20-171013,171013,7,0,16,520,10.75,0.10892995,1
2020-10-21-171013,171013,7,0,8,527,10.75,0.07196638,2
2020-10-22-171013,171013,6,0,5,533,15.75,0.07213391,3
2020-10-23-171013,171013,13,0,6,546,25.25,0.14492,4
2020-10-24-171013,171013,10,0,7,556,2.25,0.034332592,5
2020-10-25-171013,171013,2,0,4,558,6.0,0.011059553,6
2020-10-26-171013,171013,13,0,8,571,17.5,0.12156351,0
2020-10-27-171013,171013,5,1,6,576,13.5,0.11482756,1
2020-10-28-171013,171013,14,1,10,590,22.25,0.1262055,2
2020-10-29-171013,171013,4,0,9,594,20.25,0.10244313,3
2020-10-30-171013,171013,10,0,4,604,25.25,0.18166749,4
2020-10-31-171013,171013,9,0,0,613,9.0,0.04455241,5
2020-11-01-171013,171013,10,0,0,623,3.75,0.029998472,6
2020-11-02-171013,171013,1,0,0,624,3.75,0.014489233,0
2020-11-03-171013,171013,16,0,0,640,23.0,0.09712786,1
2020-11-04-171013,171013,8,0,0,648,18.75,0.13660862,2
2020-11-05-171013,171013,5,0,0,653,23.0,0.13102092,3
2020-11-06-171013,171013,6,1,0,659,21.5,0.1045107,4
2020-11-07-171013,171013,7,1,0,666,13.75,0.031219427,5
2020-11-08-171013,171013,4,0,0,670,6.0,0.019111097,6
2020-11-09-171013,171013,8,0,0,678,16.75,0.05772965,0
2020-11-10-171013,171013,6,1,0,684,17.0,0.08872994,1
2020-11-11-171013,171013,10,0,0,694,14.5,0.08292895,2
2020-11-12-171013,171013,9,0,0,703,18.25,0.08384939,3
2020-11-13-171013,171013,4,0,0,707,19.0,0.06548458,4
2020-03-01-171014,171014,0,0,0,0,0.0,0.004888267,6
2020-03-02-171014,171014,0,0,4,0,0.14285714285714285,0.0014785957,0
2020-03-03-171014,171014,0,1,4,0,0.0,0.0013853476,1
2020-03-04-171014,171014,0,3,9,0,0.42857142857142855,0.0011065698,2
2020-03-05-171014,171014,0,0,11,0,0.0,0.002784662,3
2020-03-06-171014,171014,1,0,15,1,0.0,0.014735442,4
2020-03-07-171014,171014,0,0,2,1,0.0,0.0034837206,5
2020-03-08-171014,171014,0,0,6,1,0.14285714285714285,0.0024343887,6
2020-03-09-171014,171014,0,0,18,1,0.14285714285714285,0.020275684,0
2020-03-10-171014,171014,0,0,9,1,0.7142857142857143,0.015482149,1
2020-03-11-171014,171014,0,0,14,1,1.1428571428571428,0.015960554,2
2020-03-12-171014,171014,0,0,8,1,0.42857142857142855,0.022299493,3
2020-03-13-171014,171014,1,0,12,2,2.4285714285714284,0.044105083,4
2020-03-14-171014,171014,0,0,2,2,1.2857142857142858,0.01090394,5
2020-03-15-171014,171014,0,0,2,2,2.0,0.007926876,6
2020-03-16-171014,171014,4,0,16,6,6.142857142857142,0.09465278,0
2020-03-17-171014,171014,4,0,7,10,7.428571428571429,0.067410044,1
2020-03-18-171014,171014,9,1,0,19,12.428571428571427,0.09217983,2
2020-03-19-171014,171014,11,0,6,30,15.857142857142858,0.12828279,3
2020-03-20-171014,171014,15,0,6,45,13.857142857142858,0.12097159,4
2020-03-21-171014,171014,2,1,2,47,5.0,0.01739131,5
2020-03-22-171014,171014,6,0,0,53,4.857142857142857,0.009057872,6
2020-03-23-171014,171014,18,0,5,71,29.42857142857143,0.12716085,0
2020-03-24-171014,171014,9,1,10,80,20.285714285714285,0.1160664,1
2020-03-25-171014,171014,14,0,7,94,20.571428571428573,0.10026209,2
2020-03-26-171014,171014,8,0,12,102,18.714285714285715,0.13444726,3
2020-03-27-171014,171014,12,0,4,114,17.0,0.11965359,4
2020-03-28-171014,171014,2,0,1,116,4.857142857142857,0.018297434,5
2020-03-29-171014,171014,2,0,3,118,3.571428571428572,0.015600532,6
2020-03-30-171014,171014,16,0,22,134,17.857142857142858,0.07117446,0
2020-03-31-171014,171014,7,0,28,141,8.428571428571429,0.032596342,1
2020-04-01-171014,171014,0,0,5,141,8.714285714285714,0.06761008,2
2020-04-02-171014,171014,6,0,1,147,9.571428571428571,0.09785769,3
2020-04-03-171014,171014,6,0,2,153,8.0,0.12933864,4
2020-04-04-171014,171014,2,0,1,155,3.1428571428571432,0.009210731,5
2020-04-05-171014,171014,0,0,0,155,2.142857142857143,0.0056582587,6
2020-04-06-171014,171014,5,0,5,160,12.857142857142858,0.09277832,0
2020-04-07-171014,171014,10,0,5,170,22.0,0.06898692,1
2020-04-08-171014,171014,7,0,4,177,11.142857142857142,0.06293114,2
2020-04-09-171014,171014,12,0,0,189,6.857142857142858,0.037573945,3
2020-04-10-171014,171014,4,0,6,193,5.285714285714286,0.015216721,4
2020-04-11-171014,171014,1,0,0,194,2.8571428571428568,0.013970922,5
2020-04-12-171014,171014,3,0,0,197,2.571428571428572,0.011162604,6
2020-04-13-171014,171014,22,2,3,219,37.857142857142854,0.08726463,0
2020-04-14-171014,171014,28,0,2,247,8.0,0.07057101,1
2020-04-15-171014,171014,5,0,5,252,8.285714285714286,0.06503537,2
2020-04-16-171014,171014,1,0,1,253,6.2857142857142865,0.05756401,3
2020-04-17-171014,171014,2,0,0,255,4.285714285714286,0.048563354,4
2020-04-18-171014,171014,1,0,2,256,1.4285714285714286,0.0033312738,5
2020-04-19-171014,171014,0,0,0,256,0.7142857142857143,0.0013230328,6
2020-04-20-171014,171014,5,0,3,261,5.7142857142857135,0.07733027,0
2020-04-21-171014,171014,5,0,3,266,6.0,0.064577475,1
2020-04-22-171014,171014,4,0,6,270,5.0,0.035817757,2
2020-04-23-171014,171014,0,0,2,270,0.2857142857142857,0.0038936993,3
2020-04-24-171014,171014,6,0,5,276,4.428571428571429,0.05876601,4
2020-04-25-171014,171014,0,0,0,276,0.2857142857142857,0.0048606186,5
2020-04-26-171014,171014,0,0,0,276,0.5714285714285714,0.008435941,6
2020-04-27-171014,171014,3,2,7,279,4.0,0.05616785,0
2020-04-28-171014,171014,2,0,2,281,1.8571428571428568,0.04529652,1
2020-04-29-171014,171014,5,0,1,286,2.8571428571428568,0.08316263,2
2020-04-30-171014,171014,1,0,4,287,4.142857142857143,0.027931182,3
2020-05-01-171014,171014,0,1,5,287,0.7142857142857143,0.0047974656,4
2020-05-02-171014,171014,2,0,0,289,0.2857142857142857,0.0048001865,5
2020-05-03-171014,171014,0,0,0,289,0.2857142857142857,0.0015259869,6
2020-05-04-171014,171014,3,0,2,292,4.0,0.04739923,0
2020-05-05-171014,171014,3,0,2,295,4.285714285714286,0.042166885,1
2020-05-06-171014,171014,6,0,0,301,4.142857142857143,0.08902947,2
2020-05-07-171014,171014,2,0,5,303,3.7142857142857135,0.060588736,3
2020-05-08-171014,171014,5,0,1,308,6.857142857142858,0.05791584,4
2020-05-09-171014,171014,0,1,2,308,0.42857142857142855,0.008998878,5
2020-05-10-171014,171014,0,0,0,308,0.2857142857142857,0.003546792,6
2020-05-11-171014,171014,7,0,3,315,3.8571428571428568,0.04994343,0
2020-05-12-171014,171014,2,0,5,317,3.1428571428571432,0.0343467,1
2020-05-13-171014,171014,1,0,0,318,0.5714285714285714,0.038096048,2
2020-05-14-171014,171014,4,0,1,322,3.2857142857142856,0.056846656,3
2020-05-15-171014,171014,5,2,2,327,3.2857142857142856,0.042420667,4
2020-05-16-171014,171014,0,0,0,327,0.5714285714285714,0.008778301,5
2020-05-17-171014,171014,0,0,0,327,0.42857142857142855,0.0019198427,6
2020-05-18-171014,171014,2,0,1,329,4.571428571428571,0.063137755,0
2020-05-19-171014,171014,2,0,2,331,2.4285714285714284,0.056969617,1
2020-05-20-171014,171014,0,0,1,331,3.0,0.032466043,2
2020-05-21-171014,171014,5,0,3,336,1.7142857142857142,0.040646225,3
2020-05-22-171014,171014,1,0,3,337,2.2857142857142856,0.047142923,4
2020-05-23-171014,171014,2,0,0,339,1.1428571428571428,0.000940522,5
2020-05-24-171014,171014,0,0,0,339,0.0,0.0015177662,6
2020-05-25-171014,171014,3,0,2,342,2.2857142857142856,0.08300677,0
2020-05-26-171014,171014,5,0,0,347,2.2857142857142856,0.04164014,1
2020-05-27-171014,171014,0,2,0,347,1.7142857142857142,0.048446164,2
2020-05-28-171014,171014,1,3,0,348,1.8571428571428568,0.044594515,3
2020-05-29-171014,171014,2,3,0,350,2.142857142857143,0.08169372,4
2020-05-30-171014,171014,0,0,1,350,0.2857142857142857,0.008719898,5
2020-05-31-171014,171014,0,0,0,350,0.14285714285714285,0.010280818,6
2020-06-01-171014,171014,1,0,0,351,2.2857142857142856,0.10036237,0
2020-06-02-171014,171014,2,1,1,353,2.142857142857143,0.063677125,1
2020-06-03-171014,171014,1,0,3,354,1.8571428571428568,0.06180609,2
2020-06-04-171014,171014,3,0,1,357,3.0,0.03293092,3
2020-06-05-171014,171014,3,1,0,360,2.142857142857143,0.03400221,4
2020-06-06-171014,171014,0,1,0,360,0.2857142857142857,0.002356868,5
2020-06-07-171014,171014,0,0,0,360,0.0,0.0036741227,6
2020-06-08-171014,171014,2,0,0,362,1.5714285714285714,0.062429264,0
2020-06-09-171014,171014,0,0,0,362,2.142857142857143,0.070719495,1
2020-06-10-171014,171014,0,0,0,362,1.5714285714285714,0.0797005,2
2020-06-11-171014,171014,0,0,0,362,2.142857142857143,0.06969232,3
2020-06-12-171014,171014,0,0,0,362,1.2857142857142858,0.04341537,4
2020-06-13-171014,171014,1,1,0,363,0.14285714285714285,0.0040594726,5
2020-06-14-171014,171014,0,0,0,363,0.14285714285714285,0.002842169,6
2020-06-15-171014,171014,0,0,0,363,1.7142857142857142,0.064636074,0
2020-06-16-171014,171014,1,0,0,364,3.4285714285714284,0.10592821,1
2020-06-17-171014,171014,3,0,0,367,1.7142857142857142,0.057868246,2
2020-06-18-171014,171014,1,0,0,368,2.2857142857142856,0.057856396,3
2020-06-19-171014,171014,0,0,1,368,1.2857142857142858,0.08293365,4
2020-06-20-171014,171014,0,0,0,368,0.0,0.011299652,5
2020-06-21-171014,171014,0,0,0,368,0.0,0.0022438269,6
2020-06-22-171014,171014,0,0,1,368,1.2857142857142858,0.045838267,0
2020-06-23-171014,171014,0,0,0,368,2.142857142857143,0.052451093,1
2020-06-24-171014,171014,0,0,2,368,1.5714285714285714,0.016498476,2
2020-06-25-171014,171014,0,0,0,368,1.2857142857142858,0.027561044,3
2020-06-26-171014,171014,0,0,2,368,2.571428571428572,0.028881479,4
2020-06-27-171014,171014,0,1,0,368,0.0,0.009877213,5
2020-06-28-171014,171014,0,1,0,368,0.2857142857142857,0.00502631,6
2020-06-29-171014,171014,0,0,1,368,2.142857142857143,0.047134597,0
2020-06-30-171014,171014,0,0,0,368,0.7142857142857143,0.025412615,1
2020-07-01-171014,171014,0,0,1,368,0.14285714285714285,0.03871178,2
2020-07-02-171014,171014,0,0,0,368,0.2857142857142857,0.025983859,3
2020-07-03-171014,171014,1,0,0,369,1.2857142857142858,0.027108725,4
2020-07-04-171014,171014,0,0,0,369,0.0,0.0034092185,5
2020-07-05-171014,171014,0,0,0,369,0.14285714285714285,0.0077593885,6
2020-07-06-171014,171014,1,0,0,370,1.1428571428571428,0.03537041,0
2020-07-07-171014,171014,0,0,0,370,0.7142857142857143,0.023750836,1
2020-07-08-171014,171014,2,1,1,372,1.5714285714285714,0.010596528,2
2020-07-09-171014,171014,0,0,1,372,1.2857142857142858,0.014345909,3
2020-07-10-171014,171014,2,0,4,374,0.8571428571428571,0.025543943,4
2020-07-11-171014,171014,0,0,0,374,0.0,0.0033643723,5
2020-07-12-171014,171014,0,1,0,374,0.0,0.0040718475,6
2020-07-13-171014,171014,1,0,1,375,0.8571428571428571,0.022419797,0
2020-07-14-171014,171014,0,0,0,375,0.5714285714285714,0.022759313,1
2020-07-15-171014,171014,1,0,1,376,1.4285714285714286,0.018563097,2
2020-07-16-171014,171014,0,0,0,376,1.1428571428571428,0.017657807,3
2020-07-17-171014,171014,0,0,2,376,0.8571428571428571,0.04806429,4
2020-07-18-171014,171014,0,0,0,376,0.0,0.0011842225,5
2020-07-19-171014,171014,0,0,0,376,0.0,0.009948889,6
2020-07-20-171014,171014,0,1,1,376,0.8571428571428571,0.02582077,0
2020-07-21-171014,171014,0,0,0,376,1.1428571428571428,0.059182964,1
2020-07-22-171014,171014,1,0,0,377,0.7142857142857143,0.021006448,2
2020-07-23-171014,171014,1,0,1,378,0.7142857142857143,0.063129514,3
2020-07-24-171014,171014,4,0,0,382,1.0,0.039576415,4
2020-07-25-171014,171014,0,0,1,382,0.2857142857142857,0.004881305,5
2020-07-26-171014,171014,0,0,0,382,0.2857142857142857,0.0025791177,6
2020-07-27-171014,171014,1,0,2,383,0.5714285714285714,0.06508717,0
2020-07-28-171014,171014,0,0,0,383,0.2857142857142857,0.03166488,1
2020-07-29-171014,171014,1,0,3,384,0.5714285714285714,0.031315323,2
2020-07-30-171014,171014,0,0,1,384,1.7142857142857142,0.039756108,3
2020-07-31-171014,171014,2,0,2,386,1.0,0.04578672,4
2020-08-01-171014,171014,0,0,0,386,0.0,0.0064024883,5
2020-08-02-171014,171014,0,0,1,386,0.2857142857142857,0.011174124,6
2020-08-03-171014,171014,1,0,0,387,2.4285714285714284,0.039210312,0
2020-08-04-171014,171014,0,0,1,387,1.0,0.042170297,1
2020-08-05-171014,171014,0,0,2,387,2.8571428571428568,0.08911072,2
2020-08-06-171014,171014,1,0,6,388,1.2857142857142858,0.02821356,3
2020-08-07-171014,171014,0,0,2,388,2.0,0.03785112,4
2020-08-08-171014,171014,1,0,4,389,1.1428571428571428,0.035450276,5
2020-08-09-171014,171014,0,0,4,389,1.2857142857142858,0.01738611,6
2020-08-10-171014,171014,2,1,4,391,2.7142857142857144,0.053514395,0
2020-08-11-171014,171014,0,0,0,391,2.8571428571428568,0.104807585,1
2020-08-12-171014,171014,3,0,3,394,2.571428571428572,0.07585508,2
2020-08-13-171014,171014,1,0,16,395,3.7142857142857135,0.09718304,3
2020-08-14-171014,171014,2,0,7,397,2.2857142857142856,0.10064899,4
2020-08-15-171014,171014,0,0,3,397,1.4285714285714286,0.030253058,5
2020-08-16-171014,171014,1,0,5,398,3.4285714285714284,0.030833071,6
2020-08-17-171014,171014,0,0,0,398,2.8571428571428568,0.10213323,0
2020-08-18-171014,171014,1,0,1,399,3.2857142857142856,0.11863377,1
2020-08-19-171014,171014,2,0,3,401,3.1428571428571432,0.15134487,2
2020-08-20-171014,171014,6,0,20,407,5.857142857142858,0.16387838,3
2020-08-21-171014,171014,2,1,2,409,4.571428571428571,0.17497961,4
2020-08-22-171014,171014,4,0,3,413,2.142857142857143,0.03982285,5
2020-08-23-171014,171014,4,0,1,417,1.8571428571428568,0.028152797,6
2020-08-24-171014,171014,4,0,6,421,3.1428571428571432,0.15316269,0
2020-08-25-171014,171014,0,0,2,421,5.142857142857143,0.22070087,1
2020-08-26-171014,171014,3,0,1,424,3.571428571428572,0.14045852,2
2020-08-27-171014,171014,16,0,7,440,5.571428571428571,0.17933278,3
2020-08-28-171014,171014,7,0,6,447,6.571428571428571,0.2554367,4
2020-08-29-171014,171014,3,0,0,450,3.1428571428571432,0.06913957,5
2020-08-30-171014,171014,5,0,2,455,2.142857142857143,0.10233582,6
2020-08-31-171014,171014,0,1,7,455,5.0,0.09259225,0
2020-09-01-171014,171014,1,0,1,456,4.142857142857143,0.099088565,1
2020-09-02-171014,171014,3,0,7,459,5.285714285714286,0.16644795,2
2020-09-03-171014,171014,20,0,3,479,3.7142857142857135,0.13402852,3
2020-09-04-171014,171014,2,0,3,481,6.571428571428571,0.13163179,4
2020-09-05-171014,171014,3,0,2,484,4.857142857142857,0.09095449,5
2020-09-06-171014,171014,1,0,0,485,5.0,0.08697667,6
2020-09-07-171014,171014,6,0,7,491,14.285714285714285,0.20115669,0
2020-09-08-171014,171014,2,0,3,493,1.5714285714285714,0.1613822,1
2020-09-09-171014,171014,1,1,5,494,7.2857142857142865,0.23337106,2
2020-09-10-171014,171014,7,0,5,501,6.571428571428571,0.25577483,3
2020-09-11-171014,171014,6,0,9,507,8.857142857142858,0.26587367,4
2020-09-12-171014,171014,0,0,4,507,3.1428571428571432,0.095872,5
2020-09-13-171014,171014,2,1,0,509,2.7142857142857144,0.068400666,6
2020-09-14-171014,171014,7,0,1,516,10.0,0.30022737,0
2020-09-15-171014,171014,1,0,4,517,6.0,0.32464218,1
2020-09-16-171014,171014,7,0,6,524,11.714285714285715,0.28464848,2
2020-09-17-171014,171014,3,1,4,527,8.285714285714286,0.47308552,3
2020-09-18-171014,171014,3,0,10,530,6.2857142857142865,0.4661198,4
2020-09-19-171014,171014,2,0,3,532,2.8571428571428568,0.19313753,5
2020-09-20-171014,171014,0,0,4,532,3.2857142857142856,0.065917514,6
2020-09-21-171014,171014,7,0,1,539,6.428571428571429,0.21135892,0
2020-09-22-171014,171014,3,0,5,542,5.571428571428571,0.26411188,1
2020-09-23-171014,171014,5,0,7,547,10.428571428571429,0.2826906,2
2020-09-24-171014,171014,5,0,10,552,6.2857142857142865,0.40090346,3
2020-09-25-171014,171014,9,0,5,561,6.857142857142858,0.39155233,4
2020-09-26-171014,171014,4,0,3,565,2.571428571428572,0.21895413,5
2020-09-27-171014,171014,0,0,0,565,2.7142857142857144,0.08899716,6
2020-09-28-171014,171014,1,0,0,566,5.857142857142858,0.15487355,0
2020-09-29-171014,171014,4,1,3,570,5.857142857142858,0.14607373,1
2020-09-30-171014,171014,6,1,0,576,5.0,0.18891305,2
2020-10-01-171014,171014,4,0,2,580,5.0,0.29732943,3
2020-10-02-171014,171014,10,0,3,590,6.571428571428571,0.24542694,4
2020-10-03-171014,171014,3,0,7,593,1.8571428571428568,0.11407707,5
2020-10-04-171014,171014,4,0,1,597,1.4285714285714286,0.04798077,6
2020-10-05-171014,171014,1,0,4,598,7.2857142857142865,0.20631441,0
2020-10-06-171014,171014,5,1,2,603,7.428571428571429,0.32990122,1
2020-10-07-171014,171014,7,2,10,610,6.571428571428571,0.333329,2
2020-10-08-171014,171014,10,0,6,620,6.571428571428571,0.600968,3
2020-10-09-171014,171014,5,0,11,625,10.0,0.37184465,4
2020-10-10-171014,171014,3,0,13,628,4.571428571428571,0.17120434,5
2020-10-11-171014,171014,0,0,4,628,1.2857142857142858,0.106891766,6
2020-10-12-171014,171014,0,0,8,628,2.571428571428572,0.08501935,0
2020-10-13-171014,171014,3,0,20,631,7.857142857142858,0.28931317,1
2020-10-14-171014,171014,0,0,14,631,9.142857142857142,0.3397124,2
2020-10-15-171014,171014,2,0,18,633,8.0,0.23371482,3
2020-10-16-171014,171014,3,0,17,636,11.571428571428573,0.3272439,4
2020-10-17-171014,171014,7,0,13,643,3.4285714285714284,0.18015657,5
2020-10-18-171014,171014,1,1,6,644,2.0,0.114121914,6
2020-10-19-171014,171014,4,0,4,648,7.857142857142858,0.21948959,0
2020-10-20-171014,171014,2,0,8,650,11.0,0.35997778,1
2020-10-21-171014,171014,10,0,7,660,12.714285714285715,0.38999158,2
2020-10-22-171014,171014,6,0,8,666,11.857142857142858,0.27471063,3
2020-10-23-171014,171014,11,0,2,677,20.0,0.5896108,4
2020-10-24-171014,171014,13,1,6,690,4.714285714285714,0.17347342,5
2020-10-25-171014,171014,4,1,6,694,5.285714285714286,0.09075469,6
2020-10-26-171014,171014,8,0,9,702,20.857142857142858,0.39791226,0
2020-10-27-171014,171014,20,1,7,722,13.0,0.45645353,1
2020-10-28-171014,171014,14,0,9,736,19.428571428571427,0.5321539,2
2020-10-29-171014,171014,18,0,6,754,17.142857142857142,0.36031502,3
2020-10-30-171014,171014,17,2,9,771,20.857142857142858,0.6289925,4
2020-10-31-171014,171014,13,0,0,784,10.0,0.20145299,5
2020-11-01-171014,171014,6,0,0,790,4.857142857142857,0.14097877,6
2020-11-02-171014,171014,4,0,0,794,2.571428571428572,0.098815314,0
2020-11-03-171014,171014,8,0,0,802,12.714285714285715,0.34984744,1
2020-11-04-171014,171014,7,0,0,809,15.285714285714285,0.5087262,2
2020-11-05-171014,171014,8,1,0,817,18.714285714285715,0.5662244,3
2020-11-06-171014,171014,2,0,0,819,17.142857142857142,0.5422081,4
2020-11-07-171014,171014,6,0,0,825,8.0,0.18356895,5
2020-11-08-171014,171014,6,0,0,831,4.428571428571429,0.076817535,6
2020-11-09-171014,171014,9,1,0,840,14.857142857142858,0.29078773,0
2020-11-10-171014,171014,7,0,0,847,12.571428571428573,0.32099128,1
2020-11-11-171014,171014,9,0,0,856,14.857142857142858,0.3849821,2
2020-11-12-171014,171014,6,0,0,862,14.142857142857142,0.5367526,3
2020-11-13-171014,171014,9,2,0,871,17.714285714285715,0.31747815,4
2020-03-01-171015,171015,0,0,0,0,0.14285714285714285,0.014811115,6
2020-03-02-171015,171015,0,0,1,0,0.0,0.0046334104,0
2020-03-03-171015,171015,0,0,1,0,0.0,0.003021495,1
2020-03-04-171015,171015,0,0,3,0,0.0,0.0014080568,2
2020-03-05-171015,171015,0,0,0,0,0.14285714285714285,0.01143394,3
2020-03-06-171015,171015,0,0,6,0,0.0,0.0044630803,4
2020-03-07-171015,171015,0,0,2,0,0.0,0.0029789861,5
2020-03-08-171015,171015,0,1,6,0,0.0,0.0007279426,6
2020-03-09-171015,171015,1,0,15,1,0.14285714285714285,0.35962027,0
2020-03-10-171015,171015,1,0,8,2,0.0,0.34338906,1
2020-03-11-171015,171015,0,0,2,2,0.2857142857142857,0.04154381,2
2020-03-12-171015,171015,0,0,5,2,0.0,0.04182662,3
2020-03-13-171015,171015,0,0,9,2,0.42857142857142855,0.37131876,4
2020-03-14-171015,171015,0,0,4,2,0.14285714285714285,0.056116432,5
2020-03-15-171015,171015,0,0,2,2,0.2857142857142857,0.0160075,6
2020-03-16-171015,171015,1,0,6,3,3.2857142857142856,0.7598052,0
2020-03-17-171015,171015,1,0,2,4,3.0,0.7251281,1
2020-03-18-171015,171015,3,0,6,7,5.285714285714286,1.0517701,2
2020-03-19-171015,171015,0,0,5,7,3.7142857142857135,0.5045358,3
2020-03-20-171015,171015,6,2,4,13,5.571428571428571,2.0277574,4
2020-03-21-171015,171015,2,0,1,15,2.0,0.4377794,5
2020-03-22-171015,171015,6,1,7,21,2.2857142857142856,1.0003283,6
2020-03-23-171015,171015,15,0,3,36,6.857142857142858,4.187213,0
2020-03-24-171015,171015,8,0,5,44,6.2857142857142865,2.2114773,1
2020-03-25-171015,171015,2,0,4,46,5.857142857142858,1.4985956,2
2020-03-26-171015,171015,5,0,7,51,5.142857142857143,1.8436328,3
2020-03-27-171015,171015,9,0,0,60,8.714285714285714,2.479425,4
2020-03-28-171015,171015,4,0,2,64,2.2857142857142856,0.8189527,5
2020-03-29-171015,171015,2,0,0,66,2.4285714285714284,0.326231,6
2020-03-30-171015,171015,6,0,4,72,5.0,1.5164973,0
2020-03-31-171015,171015,2,0,3,74,4.571428571428571,0.83180535,1
2020-04-01-171015,171015,6,0,6,80,5.0,1.6271206,2
2020-04-02-171015,171015,5,0,2,85,3.2857142857142856,1.3315492,3
2020-04-03-171015,171015,4,0,1,89,2.142857142857143,1.0923222,4
2020-04-04-171015,171015,1,0,0,90,1.5714285714285714,0.40286243,5
2020-04-05-171015,171015,7,0,0,97,2.2857142857142856,1.0040088,6
2020-04-06-171015,171015,3,0,2,100,3.2857142857142856,0.8378273,0
2020-04-07-171015,171015,5,0,2,105,2.571428571428572,1.4545114,1
2020-04-08-171015,171015,4,1,6,109,2.2857142857142856,1.1549257,2
2020-04-09-171015,171015,7,0,1,116,1.1428571428571428,1.1115125,3
2020-04-10-171015,171015,0,0,7,116,1.7142857142857142,0.06476469,4
2020-04-11-171015,171015,2,0,0,118,3.1428571428571432,0.5782653,5
2020-04-12-171015,171015,0,0,14,118,2.4285714285714284,0.18739004,6
2020-04-13-171015,171015,4,0,3,122,2.0,1.4926206,0
2020-04-14-171015,171015,3,0,2,125,2.142857142857143,1.042695,1
2020-04-15-171015,171015,6,0,2,131,2.2857142857142856,1.8426523,2
2020-04-16-171015,171015,2,0,0,133,2.2857142857142856,0.8565544,3
2020-04-17-171015,171015,1,0,0,134,1.1428571428571428,0.54925686,4
2020-04-18-171015,171015,0,0,0,134,0.8571428571428571,0.043128338,5
2020-04-19-171015,171015,0,1,0,134,0.42857142857142855,0.14128298,6
2020-04-20-171015,171015,2,0,2,136,2.2857142857142856,0.7881019,0
2020-04-21-171015,171015,2,0,2,138,3.7142857142857135,0.6626149,1
2020-04-22-171015,171015,6,0,1,144,1.1428571428571428,1.4633001,2
2020-04-23-171015,171015,1,0,1,145,0.5714285714285714,0.21661887,3
2020-04-24-171015,171015,7,0,2,152,2.2857142857142856,1.895505,4
2020-04-25-171015,171015,0,0,0,152,0.14285714285714285,0.006698736,5
2020-04-26-171015,171015,14,0,0,166,0.42857142857142855,3.9010112,6
2020-04-27-171015,171015,3,0,0,169,1.2857142857142858,0.83719534,0
2020-04-28-171015,171015,2,2,0,171,2.0,0.62728935,1
2020-04-29-171015,171015,2,0,0,173,1.7142857142857142,0.68574035,2
2020-04-30-171015,171015,0,0,1,173,1.5714285714285714,0.14721397,3
2020-05-01-171015,171015,0,0,0,173,0.7142857142857143,0.02840104,4
2020-05-02-171015,171015,0,0,0,173,0.8571428571428571,0.039729666,5
2020-05-03-171015,171015,0,0,0,173,0.7142857142857143,0.02707305,6
2020-05-04-171015,171015,2,0,0,175,2.142857142857143,0.8040032,0
2020-05-05-171015,171015,2,0,0,177,1.7142857142857142,0.6896873,1
2020-05-06-171015,171015,1,0,2,178,2.8571428571428568,0.5297707,2
2020-05-07-171015,171015,1,0,0,179,2.0,0.517207,3
2020-05-08-171015,171015,2,0,0,181,2.142857142857143,0.8188921,4
2020-05-09-171015,171015,0,0,0,181,0.14285714285714285,0.017624548,5
2020-05-10-171015,171015,0,0,0,181,0.2857142857142857,0.013307225,6
2020-05-11-171015,171015,0,0,0,181,2.0,0.5441792,0
2020-05-12-171015,171015,0,0,1,181,1.4285714285714286,0.15177196,1
2020-05-13-171015,171015,0,0,0,181,1.5714285714285714,0.2622722,2
2020-05-14-171015,171015,1,0,0,182,1.4285714285714286,0.4861531,3
2020-05-15-171015,171015,0,0,0,182,1.2857142857142858,0.43184695,4
2020-05-16-171015,171015,0,0,0,182,0.5714285714285714,0.027321763,5
2020-05-17-171015,171015,0,0,0,182,1.0,0.042203538,6
2020-05-18-171015,171015,0,0,0,182,1.7142857142857142,0.28190154,0
2020-05-19-171015,171015,0,0,2,182,2.2857142857142856,0.26733,1
2020-05-20-171015,171015,2,0,0,184,2.0,0.5637209,2
2020-05-21-171015,171015,0,0,0,184,1.8571428571428568,0.26758888,3
2020-05-22-171015,171015,0,0,0,184,1.0,0.13351277,4
2020-05-23-171015,171015,0,0,0,184,0.14285714285714285,0.013656972,5
2020-05-24-171015,171015,0,0,0,184,0.2857142857142857,0.013545158,6
2020-05-25-171015,171015,0,0,0,184,1.4285714285714286,0.5030855,0
2020-05-26-171015,171015,1,0,0,185,1.2857142857142858,0.49592492,1
2020-05-27-171015,171015,0,0,0,185,1.8571428571428568,0.22016564,2
2020-05-28-171015,171015,0,1,0,185,0.8571428571428571,0.15153633,3
2020-05-29-171015,171015,0,0,0,185,0.7142857142857143,0.4701958,4
2020-05-30-171015,171015,0,0,0,185,0.2857142857142857,0.02851494,5
2020-05-31-171015,171015,0,0,0,185,0.42857142857142855,0.02293689,6
2020-06-01-171015,171015,0,0,0,185,1.0,0.14943007,0
2020-06-02-171015,171015,2,0,1,187,0.7142857142857143,0.4402758,1
2020-06-03-171015,171015,0,0,0,187,0.2857142857142857,0.11625387,2
2020-06-04-171015,171015,0,0,0,187,0.2857142857142857,0.1153376,3
2020-06-05-171015,171015,0,0,0,187,0.5714285714285714,0.094171435,4
2020-06-06-171015,171015,0,1,0,187,0.14285714285714285,0.037922885,5
2020-06-07-171015,171015,0,0,0,187,0.2857142857142857,0.014765413,6
2020-06-08-171015,171015,0,0,0,187,1.2857142857142858,0.73163533,0
2020-06-09-171015,171015,0,0,0,187,0.7142857142857143,0.11397174,1
2020-06-10-171015,171015,0,0,0,187,0.2857142857142857,0.0759326,2
2020-06-11-171015,171015,0,0,0,187,0.8571428571428571,0.12575133,3
2020-06-12-171015,171015,0,0,0,187,0.2857142857142857,0.06748558,4
2020-06-13-171015,171015,0,0,0,187,0.0,0.0028487123,5
2020-06-14-171015,171015,0,2,0,187,0.0,0.00060145784,6
2020-06-15-171015,171015,0,0,0,187,0.42857142857142855,0.110261194,0
2020-06-16-171015,171015,1,0,0,188,0.8571428571428571,0.4729064,1
2020-06-17-171015,171015,0,0,0,188,0.2857142857142857,0.065138265,2
2020-06-18-171015,171015,0,0,1,188,0.7142857142857143,0.10230357,3
2020-06-19-171015,171015,0,0,0,188,2.0,0.24006484,4
2020-06-20-171015,171015,0,0,0,188,0.14285714285714285,0.030456314,5
2020-06-21-171015,171015,0,0,0,188,0.2857142857142857,0.013558541,6
2020-06-22-171015,171015,0,0,0,188,0.5714285714285714,0.09973062,0
2020-06-23-171015,171015,0,0,0,188,0.42857142857142855,0.1126209,1
2020-06-24-171015,171015,0,0,0,188,0.8571428571428571,0.098436564,2
2020-06-25-171015,171015,0,1,0,188,0.2857142857142857,0.38198838,3
2020-06-26-171015,171015,0,0,0,188,0.5714285714285714,0.43082333,4
2020-06-27-171015,171015,0,0,0,188,0.0,0.015879553,5
2020-06-28-171015,171015,0,0,0,188,0.0,0.0067552235,6
2020-06-29-171015,171015,0,0,0,188,0.5714285714285714,0.09444216,0
2020-06-30-171015,171015,0,0,1,188,0.42857142857142855,0.07516796,1
2020-07-01-171015,171015,0,0,1,188,0.2857142857142857,0.06617129,2
2020-07-02-171015,171015,1,0,3,189,0.14285714285714285,0.4337163,3
2020-07-03-171015,171015,0,0,0,189,1.1428571428571428,0.13917184,4
2020-07-04-171015,171015,0,0,0,189,0.14285714285714285,0.015978787,5
2020-07-05-171015,171015,0,0,0,189,0.0,0.003438639,6
2020-07-06-171015,171015,0,0,0,189,0.5714285714285714,0.09645765,0
2020-07-07-171015,171015,0,0,0,189,0.42857142857142855,0.089188516,1
2020-07-08-171015,171015,0,1,0,189,0.8571428571428571,0.08052847,2
2020-07-09-171015,171015,0,0,0,189,0.2857142857142857,0.055246353,3
2020-07-10-171015,171015,0,0,0,189,0.42857142857142855,0.093388595,4
2020-07-11-171015,171015,0,0,0,189,0.14285714285714285,0.003344019,5
2020-07-12-171015,171015,0,0,0,189,0.0,0.018587524,6
2020-07-13-171015,171015,0,0,0,189,0.0,0.034773692,0
2020-07-14-171015,171015,1,0,0,190,0.2857142857142857,0.057674818,1
2020-07-15-171015,171015,1,0,0,191,0.5714285714285714,0.061519705,2
2020-07-16-171015,171015,3,0,0,194,0.2857142857142857,0.066293605,3
2020-07-17-171015,171015,0,0,0,194,0.42857142857142855,0.08134305,4
2020-07-18-171015,171015,0,0,0,194,0.0,0.0057272497,5
2020-07-19-171015,171015,0,0,0,194,0.42857142857142855,0.055258982,6
2020-07-20-171015,171015,0,0,0,194,0.2857142857142857,0.091798216,0
2020-07-21-171015,171015,0,0,0,194,0.8571428571428571,0.15326218,1
2020-07-22-171015,171015,0,0,0,194,0.42857142857142855,0.08114493,2
2020-07-23-171015,171015,0,0,0,194,0.5714285714285714,0.13092783,3
2020-07-24-171015,171015,0,0,0,194,0.5714285714285714,0.14715205,4
2020-07-25-171015,171015,0,0,2,194,0.42857142857142855,0.05921163,5
2020-07-26-171015,171015,0,0,0,194,0.14285714285714285,0.0152953295,6
2020-07-27-171015,171015,0,0,0,194,0.14285714285714285,0.11498746,0
2020-07-28-171015,171015,0,0,2,194,0.42857142857142855,0.12724856,1
2020-07-29-171015,171015,0,0,1,194,0.7142857142857143,0.10614891,2
2020-07-30-171015,171015,0,0,2,194,0.7142857142857143,0.19030158,3
2020-07-31-171015,171015,0,0,2,194,0.5714285714285714,0.135032,4
2020-08-01-171015,171015,0,0,2,194,0.7142857142857143,0.100172564,5
2020-08-02-171015,171015,0,0,3,194,0.2857142857142857,0.0501266,6
2020-08-03-171015,171015,0,0,0,194,1.0,0.25734934,0
2020-08-04-171015,171015,0,0,1,194,1.0,0.35507032,1
2020-08-05-171015,171015,0,0,2,194,1.0,0.5721975,2
2020-08-06-171015,171015,0,0,9,194,1.0,0.559872,3
2020-08-07-171015,171015,0,0,3,194,1.1428571428571428,0.39117184,4
2020-08-08-171015,171015,2,0,0,196,0.5714285714285714,1.0492803,5
2020-08-09-171015,171015,0,0,2,196,1.0,0.16704084,6
2020-08-10-171015,171015,0,0,1,196,0.7142857142857143,0.8728707,0
2020-08-11-171015,171015,2,0,6,198,2.0,1.3843843,1
2020-08-12-171015,171015,1,0,6,199,1.8571428571428568,1.0047174,2
2020-08-13-171015,171015,2,0,3,201,2.2857142857142856,1.2645379,3
2020-08-14-171015,171015,2,0,8,203,0.8571428571428571,1.30332,4
2020-08-15-171015,171015,2,0,8,205,1.5714285714285714,0.8355891,5
2020-08-16-171015,171015,3,0,3,208,0.5714285714285714,1.3520337,6
2020-08-17-171015,171015,0,0,10,208,0.42857142857142855,0.64800566,0
2020-08-18-171015,171015,1,0,1,209,2.4285714285714284,0.8956911,1
2020-08-19-171015,171015,2,0,3,211,1.7142857142857142,1.4000611,2
2020-08-20-171015,171015,9,0,1,220,2.2857142857142856,2.9716055,3
2020-08-21-171015,171015,3,0,8,223,2.8571428571428568,2.1998024,4
2020-08-22-171015,171015,0,0,5,223,0.0,0.53811723,5
2020-08-23-171015,171015,2,1,3,225,1.4285714285714286,0.26648337,6
2020-08-24-171015,171015,1,0,0,226,1.4285714285714286,1.4414694,0
2020-08-25-171015,171015,6,0,12,232,2.0,1.4688447,1
2020-08-26-171015,171015,6,0,17,238,2.142857142857143,3.0752783,2
2020-08-27-171015,171015,3,0,9,241,2.0,2.1952536,3
2020-08-28-171015,171015,8,0,16,249,3.2857142857142856,3.009685,4
2020-08-29-171015,171015,8,0,5,257,0.8571428571428571,2.743329,5
2020-08-30-171015,171015,3,0,1,260,0.7142857142857143,1.2081288,6
2020-08-31-171015,171015,10,0,3,270,1.8571428571428568,2.4515848,0
2020-09-01-171015,171015,1,0,13,271,0.7142857142857143,0.13401005,1
2020-09-02-171015,171015,3,0,7,274,1.0,0.59186614,2
2020-09-03-171015,171015,1,0,5,275,4.0,0.66416067,3
2020-09-04-171015,171015,8,0,3,283,2.0,1.2542195,4
2020-09-05-171015,171015,5,0,4,288,1.2857142857142858,2.1525526,5
2020-09-06-171015,171015,3,0,1,291,6.2857142857142865,1.3694501,6
2020-09-07-171015,171015,0,0,7,291,2.2857142857142856,0.77010435,0
2020-09-08-171015,171015,12,0,9,303,4.0,5.457049,1
2020-09-09-171015,171015,17,0,8,320,3.2857142857142856,9.46706,2
2020-09-10-171015,171015,9,0,5,329,4.285714285714286,4.671186,3
2020-09-11-171015,171015,16,0,3,345,3.2857142857142856,5.183112,4
2020-09-12-171015,171015,5,1,0,350,2.0,2.3414176,5
2020-09-13-171015,171015,1,0,1,351,1.2857142857142858,0.46774563,6
2020-09-14-171015,171015,3,0,4,354,2.8571428571428568,1.3359149,0
2020-09-15-171015,171015,13,0,4,367,6.571428571428571,6.175498,1
2020-09-16-171015,171015,7,0,1,374,7.0,2.007795,2
2020-09-17-171015,171015,5,0,5,379,4.571428571428571,3.9876509,3
2020-09-18-171015,171015,3,0,3,382,8.857142857142858,1.92439,4
2020-09-19-171015,171015,4,0,0,386,9.285714285714286,2.3018718,5
2020-09-20-171015,171015,1,0,0,387,1.7142857142857142,0.46620026,6
2020-09-21-171015,171015,7,0,5,394,5.142857142857143,2.4906797,0
2020-09-22-171015,171015,9,1,1,403,5.7142857142857135,0.75368804,1
2020-09-23-171015,171015,8,0,5,411,5.571428571428571,1.9375529,2
2020-09-24-171015,171015,5,0,2,416,3.571428571428572,0.64166397,3
2020-09-25-171015,171015,3,0,8,419,6.2857142857142865,2.1115901,4
2020-09-26-171015,171015,0,0,1,419,4.571428571428571,0.90499324,5
2020-09-27-171015,171015,1,0,3,420,1.5714285714285714,0.49190006,6
2020-09-28-171015,171015,4,1,0,424,2.142857142857143,1.344662,0
2020-09-29-171015,171015,4,0,3,428,6.857142857142858,2.1235194,1
2020-09-30-171015,171015,1,0,4,429,3.1428571428571432,0.82452726,2
2020-10-01-171015,171015,5,0,4,434,4.0,1.6245795,3
2020-10-02-171015,171015,3,0,7,437,4.857142857142857,0.5567112,4
2020-10-03-171015,171015,0,2,1,437,1.5714285714285714,0.2369044,5
2020-10-04-171015,171015,0,1,3,437,0.7142857142857143,0.13340689,6
2020-10-05-171015,171015,5,1,4,442,1.0,2.7082152,0
2020-10-06-171015,171015,1,1,7,443,4.285714285714286,1.3408804,1
2020-10-07-171015,171015,5,0,9,448,3.1428571428571432,3.1736093,2
2020-10-08-171015,171015,2,0,1,450,6.142857142857142,2.8703856,3
2020-10-09-171015,171015,8,0,12,458,2.7142857142857144,2.420672,4
2020-10-10-171015,171015,1,0,2,459,1.2857142857142858,0.74836504,5
2020-10-11-171015,171015,3,0,0,462,0.2857142857142857,1.1527538,6
2020-10-12-171015,171015,0,0,5,462,1.0,0.2783127,0
2020-10-13-171015,171015,3,0,7,465,3.4285714285714284,1.4356067,1
2020-10-14-171015,171015,4,0,8,469,3.571428571428572,2.337489,2
2020-10-15-171015,171015,4,0,1,473,2.0,3.451643,3
2020-10-16-171015,171015,7,0,13,480,3.2857142857142856,1.9014827,4
2020-10-17-171015,171015,1,0,3,481,1.7142857142857142,0.5888477,5
2020-10-18-171015,171015,3,0,0,484,1.5714285714285714,1.097343,6
2020-10-19-171015,171015,4,0,0,488,2.8571428571428568,2.2329159,0
2020-10-20-171015,171015,7,0,3,495,4.285714285714286,3.0837965,1
2020-10-21-171015,171015,9,0,5,504,5.428571428571429,2.659054,2
2020-10-22-171015,171015,1,0,6,505,4.142857142857143,1.2723294,3
2020-10-23-171015,171015,12,0,5,517,3.8571428571428568,3.9194212,4
2020-10-24-171015,171015,2,0,3,519,5.142857142857143,1.7495446,5
2020-10-25-171015,171015,0,1,3,519,1.8571428571428568,0.40657952,6
2020-10-26-171015,171015,5,1,2,524,3.0,2.4324312,0
2020-10-27-171015,171015,7,0,2,531,4.714285714285714,3.7567134,1
2020-10-28-171015,171015,8,0,4,539,5.571428571428571,4.1194263,2
2020-10-29-171015,171015,1,0,5,540,5.428571428571429,3.1178572,3
2020-10-30-171015,171015,13,0,12,553,5.285714285714286,3.066237,4
2020-10-31-171015,171015,3,0,0,556,3.4285714285714284,1.4999042,5
2020-11-01-171015,171015,0,1,0,556,2.4285714285714284,0.43136883,6
2020-11-02-171015,171015,0,0,0,556,2.7142857142857144,0.43956947,0
2020-11-03-171015,171015,3,1,0,559,4.714285714285714,2.2007835,1
2020-11-04-171015,171015,5,0,0,564,6.7142857142857135,2.7554917,2
2020-11-05-171015,171015,6,2,0,570,10.0,4.8295684,3
2020-11-06-171015,171015,5,0,0,575,6.2857142857142865,3.357493,4
2020-11-07-171015,171015,3,0,0,578,3.1428571428571432,1.2484217,5
2020-11-08-171015,171015,3,0,0,581,3.571428571428572,0.9437542,6
2020-11-09-171015,171015,2,1,0,583,4.0,1.2359471,0
2020-11-10-171015,171015,2,0,0,585,8.857142857142858,1.6219673,1
2020-11-11-171015,171015,4,0,0,589,5.428571428571429,2.2328756,2
2020-11-12-171015,171015,5,0,0,594,4.571428571428571,1.8875457,3
2020-11-13-171015,171015,12,2,0,606,6.142857142857142,4.20932,4
2020-03-01-171016,171016,0,0,0,0,0.125,0.0071974993,6
2020-03-02-171016,171016,0,0,2,0,0.25,0.030401247,0
2020-03-03-171016,171016,0,0,4,0,0.0,0.021754416,1
2020-03-04-171016,171016,0,0,4,0,0.0,0.0024869267,2
2020-03-05-171016,171016,1,0,3,1,0.0,0.03711031,3
2020-03-06-171016,171016,0,0,8,1,0.25,0.015261615,4
2020-03-07-171016,171016,0,0,4,1,0.0,0.0022196784,5
2020-03-08-171016,171016,0,0,9,1,0.0,0.00029559294,6
2020-03-09-171016,171016,0,0,9,1,0.125,0.050573144,0
2020-03-10-171016,171016,0,0,16,1,0.125,0.049477525,1
2020-03-11-171016,171016,0,0,11,1,0.25,0.018643504,2
2020-03-12-171016,171016,0,0,7,1,0.0,0.021853521,3
2020-03-13-171016,171016,1,0,7,2,0.75,0.1625051,4
2020-03-14-171016,171016,0,0,2,2,0.375,0.038597938,5
2020-03-15-171016,171016,0,0,0,2,1.375,0.035446227,6
2020-03-16-171016,171016,2,0,10,4,4.625,0.452673,0
2020-03-17-171016,171016,4,1,12,8,5.0,0.5802467,1
2020-03-18-171016,171016,4,0,7,12,7.75,0.753483,2
2020-03-19-171016,171016,3,0,7,15,7.625,0.7011256,3
2020-03-20-171016,171016,8,1,8,23,9.5,0.81003684,4
2020-03-21-171016,171016,4,0,2,27,3.0,0.2954676,5
2020-03-22-171016,171016,9,0,0,36,3.0,0.387297,6
2020-03-23-171016,171016,9,0,4,45,11.625,1.1724609,0
2020-03-24-171016,171016,16,0,3,61,8.25,1.0664221,1
2020-03-25-171016,171016,11,0,6,72,7.375,0.8748661,2
2020-03-26-171016,171016,7,1,0,79,8.25,0.89709365,3
2020-03-27-171016,171016,7,0,2,86,9.125,0.7832841,4
2020-03-28-171016,171016,2,0,13,88,2.125,0.23413533,5
2020-03-29-171016,171016,0,0,11,88,3.25,0.100834444,6
2020-03-30-171016,171016,10,0,3,98,6.5,0.80337936,0
2020-03-31-171016,171016,12,0,6,110,4.375,0.5192161,1
2020-04-01-171016,171016,7,0,2,117,7.75,0.62773687,2
2020-04-02-171016,171016,7,0,5,124,4.875,0.4761338,3
2020-04-03-171016,171016,8,0,3,132,7.25,0.54971796,4
2020-04-04-171016,171016,2,0,2,134,2.25,0.16531022,5
2020-04-05-171016,171016,0,1,0,134,3.375,0.12878801,6
2020-04-06-171016,171016,4,0,4,138,10.375,0.6941793,0
2020-04-07-171016,171016,3,0,6,141,5.625,0.5492397,1
2020-04-08-171016,171016,6,0,1,147,4.625,0.4823258,2
2020-04-09-171016,171016,0,1,0,147,4.5,0.25579536,3
2020-04-10-171016,171016,2,0,5,149,3.375,0.27041498,4
2020-04-11-171016,171016,13,0,0,162,2.125,0.45773742,5
2020-04-12-171016,171016,11,0,1,173,1.875,0.58658713,6
2020-04-13-171016,171016,3,0,4,176,6.5,0.69564426,0
2020-04-14-171016,171016,6,0,1,182,3.875,0.56238633,1
2020-04-15-171016,171016,2,0,1,184,4.25,0.60620177,2
2020-04-16-171016,171016,5,0,7,189,3.625,0.44620913,3
2020-04-17-171016,171016,3,0,1,192,3.25,0.46441388,4
2020-04-18-171016,171016,2,0,3,194,0.875,0.08610638,5
2020-04-19-171016,171016,0,0,0,194,0.5,0.020710146,6
2020-04-20-171016,171016,4,0,5,198,4.125,0.37250698,0
2020-04-21-171016,171016,6,0,2,204,2.75,0.40517426,1
2020-04-22-171016,171016,1,0,8,205,2.625,0.23708995,2
2020-04-23-171016,171016,0,0,1,205,0.875,0.09463728,3
2020-04-24-171016,171016,5,0,3,210,3.625,0.4895549,4
2020-04-25-171016,171016,0,0,0,210,0.5,0.05726033,5
2020-04-26-171016,171016,1,0,0,211,2.375,0.29298687,6
2020-04-27-171016,171016,4,1,8,215,3.625,0.39973378,0
2020-04-28-171016,171016,1,0,3,216,3.625,0.27066925,1
2020-04-29-171016,171016,1,0,3,217,2.75,0.2710695,2
2020-04-30-171016,171016,7,0,1,224,1.75,0.2757765,3
2020-05-01-171016,171016,1,0,1,225,0.625,0.046835393,4
2020-05-02-171016,171016,3,1,0,228,0.75,0.08060931,5
2020-05-03-171016,171016,0,0,0,228,0.75,0.048440363,6
2020-05-04-171016,171016,5,0,3,233,3.5,0.3737792,0
2020-05-05-171016,171016,2,0,2,235,2.875,0.24520597,1
2020-05-06-171016,171016,8,0,3,243,3.875,0.44838217,2
2020-05-07-171016,171016,1,0,0,244,3.75,0.31776747,3
2020-05-08-171016,171016,3,0,0,247,2.75,0.33481628,4
2020-05-09-171016,171016,0,1,0,247,0.5,0.03206334,5
2020-05-10-171016,171016,0,0,0,247,0.375,0.0089875525,6
2020-05-11-171016,171016,8,0,0,255,1.75,0.4699587,0
2020-05-12-171016,171016,3,0,1,258,1.75,0.17755228,1
2020-05-13-171016,171016,3,0,3,261,2.375,0.30471873,2
2020-05-14-171016,171016,1,0,0,262,3.125,0.34014478,3
2020-05-15-171016,171016,1,1,2,263,1.5,0.120840535,4
2020-05-16-171016,171016,0,0,0,263,0.625,0.03955759,5
2020-05-17-171016,171016,0,0,2,263,1.0,0.03591677,6
2020-05-18-171016,171016,3,0,3,266,2.75,0.32020012,0
2020-05-19-171016,171016,2,0,1,268,2.75,0.2328787,1
2020-05-20-171016,171016,3,0,0,271,3.25,0.22816363,2
2020-05-21-171016,171016,0,0,1,271,2.625,0.16883479,3
2020-05-22-171016,171016,0,0,1,271,2.875,0.14969282,4
2020-05-23-171016,171016,0,0,0,271,0.125,0.0055450583,5
2020-05-24-171016,171016,0,0,0,271,0.375,0.011172069,6
2020-05-25-171016,171016,0,0,4,271,2.25,0.22332247,0
2020-05-26-171016,171016,1,0,3,272,1.5,0.17097916,1
2020-05-27-171016,171016,3,0,1,275,2.625,0.3348788,2
2020-05-28-171016,171016,0,1,1,275,1.0,0.20488049,3
2020-05-29-171016,171016,2,0,1,277,1.375,0.22654904,4
2020-05-30-171016,171016,0,0,0,277,0.25,0.022908507,5
2020-05-31-171016,171016,2,0,0,279,0.125,0.08157322,6
2020-06-01-171016,171016,3,0,3,282,2.25,0.26227838,0
2020-06-02-171016,171016,1,0,2,283,1.5,0.14048688,1
2020-06-03-171016,171016,0,1,0,283,1.0,0.1366738,2
2020-06-04-171016,171016,1,0,0,284,0.875,0.13538715,3
2020-06-05-171016,171016,1,0,4,285,1.0,0.09929757,4
2020-06-06-171016,171016,0,0,0,285,0.125,0.0111310175,5
2020-06-07-171016,171016,0,0,0,285,0.5,0.019621901,6
2020-06-08-171016,171016,4,0,1,289,0.75,0.2514416,0
2020-06-09-171016,171016,3,0,1,292,0.625,0.16807787,1
2020-06-10-171016,171016,1,0,2,293,1.0,0.13124232,2
2020-06-11-171016,171016,1,0,0,294,2.375,0.17119092,3
2020-06-12-171016,171016,1,0,1,295,0.5,0.10254297,4
2020-06-13-171016,171016,0,0,0,295,0.0,0.008206625,5
2020-06-14-171016,171016,0,0,0,295,0.125,0.004001437,6
2020-06-15-171016,171016,3,2,1,298,1.5,0.19817023,0
2020-06-16-171016,171016,2,0,2,300,1.5,0.20192991,1
2020-06-17-171016,171016,0,0,0,300,1.125,0.11845173,2
2020-06-18-171016,171016,0,0,0,300,1.25,0.10018845,3
2020-06-19-171016,171016,4,0,3,304,1.875,0.3045536,4
2020-06-20-171016,171016,0,0,1,304,0.5,0.032716885,5
2020-06-21-171016,171016,0,0,0,304,0.375,0.0107025,6
2020-06-22-171016,171016,1,0,1,305,0.75,0.094054796,0
2020-06-23-171016,171016,1,2,0,306,1.125,0.14786294,1
2020-06-24-171016,171016,2,0,2,308,0.75,0.13310239,2
2020-06-25-171016,171016,0,0,0,308,0.625,0.083173946,3
2020-06-26-171016,171016,1,0,2,309,0.625,0.13921021,4
2020-06-27-171016,171016,0,0,0,309,0.125,0.015004648,5
2020-06-28-171016,171016,0,0,0,309,0.125,0.008672571,6
2020-06-29-171016,171016,1,0,0,310,1.125,0.12956098,0
2020-06-30-171016,171016,2,0,1,312,0.5,0.113508016,1
2020-07-01-171016,171016,0,0,2,312,1.0,0.05588271,2
2020-07-02-171016,171016,0,0,2,312,0.375,0.07824235,3
2020-07-03-171016,171016,3,0,3,315,1.0,0.15425692,4
2020-07-04-171016,171016,1,0,0,316,0.125,0.037310258,5
2020-07-05-171016,171016,0,0,2,316,0.0,0.006521873,6
2020-07-06-171016,171016,1,0,2,317,0.875,0.106495194,0
2020-07-07-171016,171016,0,0,3,317,0.75,0.045198657,1
2020-07-08-171016,171016,2,1,1,319,1.0,0.117985904,2
2020-07-09-171016,171016,0,0,0,319,0.375,0.042380888,3
2020-07-10-171016,171016,2,0,0,321,0.375,0.096363224,4
2020-07-11-171016,171016,0,0,0,321,0.125,0.0052027376,5
2020-07-12-171016,171016,0,0,1,321,0.125,0.009628128,6
2020-07-13-171016,171016,0,0,0,321,0.5,0.038312618,0
2020-07-14-171016,171016,1,0,0,322,0.5,0.05612646,1
2020-07-15-171016,171016,2,0,1,324,1.0,0.11064151,2
2020-07-16-171016,171016,2,0,0,326,1.5,0.06692273,3
2020-07-17-171016,171016,3,0,0,329,0.75,0.18713903,4
2020-07-18-171016,171016,0,0,3,329,0.125,0.011642565,5
2020-07-19-171016,171016,2,0,0,331,0.25,0.15190974,6
2020-07-20-171016,171016,2,0,1,333,0.625,0.14554882,0
2020-07-21-171016,171016,3,0,3,336,1.0,0.15822555,1
2020-07-22-171016,171016,1,0,3,337,0.375,0.07274377,2
2020-07-23-171016,171016,0,1,0,337,1.125,0.12750949,3
2020-07-24-171016,171016,0,0,2,337,1.875,0.14513332,4
2020-07-25-171016,171016,0,0,1,337,0.5,0.023460891,5
2020-07-26-171016,171016,1,0,1,338,0.125,0.029614557,6
2020-07-27-171016,171016,0,0,1,338,2.375,0.13903812,0
2020-07-28-171016,171016,0,0,3,338,2.375,0.08834905,1
2020-07-29-171016,171016,1,0,0,339,1.875,0.11409885,2
2020-07-30-171016,171016,0,0,4,339,2.625,0.13482688,3
2020-07-31-171016,171016,0,0,1,339,2.625,0.10110236,4
2020-08-01-171016,171016,3,0,3,342,0.0,0.10554651,5
2020-08-02-171016,171016,0,0,1,342,0.375,0.04420323,6
2020-08-03-171016,171016,1,0,0,343,1.75,0.122792125,0
2020-08-04-171016,171016,3,0,6,346,1.625,0.18021499,1
2020-08-05-171016,171016,3,0,3,349,1.75,0.31989518,2
2020-08-06-171016,171016,0,0,6,349,1.625,0.075485304,3
2020-08-07-171016,171016,2,0,6,351,2.0,0.17277528,4
2020-08-08-171016,171016,1,0,0,352,1.125,0.1402269,5
2020-08-09-171016,171016,1,0,1,353,0.875,0.08357559,6
2020-08-10-171016,171016,1,0,2,354,1.125,0.16125971,0
2020-08-11-171016,171016,3,0,6,357,2.875,0.36893263,1
2020-08-12-171016,171016,0,0,8,357,1.5,0.12407715,2
2020-08-13-171016,171016,4,0,5,361,1.5,0.32761258,3
2020-08-14-171016,171016,1,0,12,362,2.0,0.30050132,4
2020-08-15-171016,171016,3,1,1,365,0.75,0.2212294,5
2020-08-16-171016,171016,1,0,1,366,0.625,0.15790197,6
2020-08-17-171016,171016,0,0,6,366,1.0,0.21373627,0
2020-08-18-171016,171016,6,0,3,372,2.125,0.37779507,1
2020-08-19-171016,171016,3,0,3,375,2.25,0.5436892,2
2020-08-20-171016,171016,6,0,4,381,3.5,0.68488944,3
2020-08-21-171016,171016,6,0,1,387,3.875,0.7193389,4
2020-08-22-171016,171016,0,0,4,387,0.875,0.15110762,5
2020-08-23-171016,171016,1,1,18,388,1.75,0.10245508,6
2020-08-24-171016,171016,2,0,4,390,3.5,0.4703848,0
2020-08-25-171016,171016,6,0,4,396,5.125,0.68696785,1
2020-08-26-171016,171016,8,0,5,404,4.25,0.7912843,2
2020-08-27-171016,171016,5,0,3,409,6.375,0.71016175,3
2020-08-28-171016,171016,12,0,4,421,5.0,0.82444924,4
2020-08-29-171016,171016,1,0,2,422,1.5,0.34107733,5
2020-08-30-171016,171016,1,0,0,423,1.625,0.26169524,6
2020-08-31-171016,171016,6,0,7,429,3.125,0.55449975,0
2020-09-01-171016,171016,3,0,17,432,2.5,0.2591505,1
2020-09-02-171016,171016,3,0,4,435,4.125,0.3249998,2
2020-09-03-171016,171016,4,1,8,439,3.375,0.4431813,3
2020-09-04-171016,171016,1,0,3,440,3.25,0.309488,4
2020-09-05-171016,171016,4,0,2,444,1.875,0.5315237,5
2020-09-06-171016,171016,18,0,2,462,2.0,0.8137114,6
2020-09-07-171016,171016,4,0,14,466,4.5,0.62650263,0
2020-09-08-171016,171016,4,0,20,470,6.5,0.77690923,1
2020-09-09-171016,171016,5,0,15,475,7.125,1.2212073,2
2020-09-10-171016,171016,3,0,10,478,10.0,1.1342671,3
2020-09-11-171016,171016,4,0,13,482,7.625,0.91945475,4
2020-09-12-171016,171016,2,0,17,484,3.875,0.5387356,5
2020-09-13-171016,171016,0,0,1,484,2.25,0.18026906,6
2020-09-14-171016,171016,7,1,7,491,7.5,0.8192428,0
2020-09-15-171016,171016,17,0,10,508,10.875,1.4065642,1
2020-09-16-171016,171016,4,0,4,512,10.5,0.936818,2
2020-09-17-171016,171016,8,0,10,520,7.25,0.891401,3
2020-09-18-171016,171016,3,0,15,523,11.625,0.7062222,4
2020-09-19-171016,171016,2,0,7,525,11.125,0.7745987,5
2020-09-20-171016,171016,2,0,3,527,2.0,0.16588667,6
2020-09-21-171016,171016,14,0,2,541,8.625,0.9783262,0
2020-09-22-171016,171016,20,3,10,561,8.25,0.77782524,1
2020-09-23-171016,171016,15,0,11,576,9.625,1.109398,2
2020-09-24-171016,171016,10,1,9,586,7.875,1.2529299,3
2020-09-25-171016,171016,13,0,4,599,7.375,0.78967917,4
2020-09-26-171016,171016,17,0,0,616,5.875,1.0746791,5
2020-09-27-171016,171016,1,1,0,617,1.5,0.16839336,6
2020-09-28-171016,171016,7,0,2,624,3.0,0.51777506,0
2020-09-29-171016,171016,10,0,10,634,5.375,0.67014587,1
2020-09-30-171016,171016,4,0,4,638,6.0,0.57989156,2
2020-10-01-171016,171016,10,1,6,648,7.5,0.9146243,3
2020-10-02-171016,171016,15,0,7,663,6.375,0.5671455,4
2020-10-03-171016,171016,7,1,5,670,1.75,0.5020058,5
2020-10-04-171016,171016,3,0,2,673,1.625,0.25407845,6
2020-10-05-171016,171016,2,0,6,675,3.625,0.65894073,0
2020-10-06-171016,171016,10,0,6,685,8.0,1.1581572,1
2020-10-07-171016,171016,11,0,9,696,5.25,1.0596974,2
2020-10-08-171016,171016,9,2,12,705,5.875,1.2063531,3
2020-10-09-171016,171016,4,2,3,709,4.625,0.8269365,4
2020-10-10-171016,171016,0,0,6,709,2.625,0.24340719,5
2020-10-11-171016,171016,0,0,4,709,2.0,0.2108751,6
2020-10-12-171016,171016,2,0,12,711,1.375,0.17933202,0
2020-10-13-171016,171016,10,0,13,721,5.875,0.7953511,1
2020-10-14-171016,171016,4,0,16,725,6.125,0.7777822,2
2020-10-15-171016,171016,6,0,14,731,4.375,0.9692866,3
2020-10-16-171016,171016,7,0,14,738,7.875,0.72847587,4
2020-10-17-171016,171016,5,0,12,743,3.5,0.52290756,5
2020-10-18-171016,171016,2,0,2,745,2.75,0.32106087,6
2020-10-19-171016,171016,6,0,6,751,5.875,0.7261432,0
2020-10-20-171016,171016,6,1,5,757,15.125,1.198331,1
2020-10-21-171016,171016,9,0,23,766,7.875,0.9412978,2
2020-10-22-171016,171016,12,0,11,778,7.625,0.88173616,3
2020-10-23-171016,171016,3,0,19,781,10.875,1.3186431,4
2020-10-24-171016,171016,6,2,3,787,7.625,0.5874553,5
2020-10-25-171016,171016,4,1,12,791,2.5,0.29829922,6
2020-10-26-171016,171016,12,1,15,803,7.25,1.2865771,0
2020-10-27-171016,171016,13,2,15,816,9.875,1.606305,1
2020-10-28-171016,171016,16,0,9,832,10.75,1.576412,2
2020-10-29-171016,171016,14,1,9,846,11.875,1.4864507,3
2020-10-30-171016,171016,14,0,13,860,11.75,1.5737329,4
2020-10-31-171016,171016,12,0,0,872,7.25,1.120202,5
2020-11-01-171016,171016,2,0,0,874,8.0,0.49871257,6
2020-11-02-171016,171016,6,1,0,880,5.25,0.6100486,0
2020-11-03-171016,171016,5,0,0,885,8.75,0.97778124,1
2020-11-04-171016,171016,23,1,0,908,13.0,1.4889696,2
2020-11-05-171016,171016,11,0,0,919,19.25,2.2671237,3
2020-11-06-171016,171016,19,0,0,938,12.125,1.469739,4
2020-11-07-171016,171016,3,0,0,941,5.125,0.5105345,5
2020-11-08-171016,171016,12,0,0,953,7.75,0.6321909,6
2020-11-09-171016,171016,15,1,0,968,8.875,1.0814848,0
2020-11-10-171016,171016,15,0,0,983,10.625,1.3842273,1
2020-11-11-171016,171016,9,1,0,992,6.375,1.0789859,2
2020-11-12-171016,171016,9,1,0,1001,7.625,1.1181915,3
2020-11-13-171016,171016,13,0,0,1014,9.375,1.0748591,4
2020-03-01-171017,171017,0,0,0,0,0.0,0.0022376655,6
2020-03-02-171017,171017,0,0,1,0,0.2857142857142857,0.042337008,0
2020-03-03-171017,171017,0,1,0,0,0.0,7.373399e-05,1
2020-03-04-171017,171017,0,0,1,0,0.14285714285714285,0.000449175,2
2020-03-05-171017,171017,0,2,2,0,0.14285714285714285,0.016394813,3
2020-03-06-171017,171017,0,0,3,0,0.42857142857142855,0.0052319164,4
2020-03-07-171017,171017,0,1,0,0,0.0,0.001065871,5
2020-03-08-171017,171017,0,1,0,0,0.0,0.00024201615,6
2020-03-09-171017,171017,0,0,2,0,0.14285714285714285,0.0047299387,0
2020-03-10-171017,171017,0,0,6,0,0.14285714285714285,0.0056090094,1
2020-03-11-171017,171017,0,1,1,0,0.2857142857142857,0.008923111,2
2020-03-12-171017,171017,0,0,2,0,0.2857142857142857,0.0071476367,3
2020-03-13-171017,171017,0,0,3,0,1.5714285714285714,0.06903447,4
2020-03-14-171017,171017,0,0,1,0,0.42857142857142855,0.006525998,5
2020-03-15-171017,171017,0,0,0,0,1.5714285714285714,0.005884847,6
2020-03-16-171017,171017,1,0,0,1,4.285714285714286,0.28058168,0
2020-03-17-171017,171017,0,0,1,1,4.0,0.2236693,1
2020-03-18-171017,171017,1,0,1,2,9.571428571428571,0.49320236,2
2020-03-19-171017,171017,2,0,1,4,8.285714285714286,0.81666356,3
2020-03-20-171017,171017,3,0,1,7,9.571428571428571,0.63252175,4
2020-03-21-171017,171017,0,1,1,7,4.142857142857143,0.36436313,5
2020-03-22-171017,171017,0,0,0,7,4.285714285714286,0.23532781,6
2020-03-23-171017,171017,2,0,2,9,12.142857142857142,1.0342813,0
2020-03-24-171017,171017,6,0,1,15,10.571428571428571,0.52003133,1
2020-03-25-171017,171017,1,0,3,16,11.285714285714285,0.5781707,2
2020-03-26-171017,171017,2,0,1,18,9.142857142857142,0.5998987,3
2020-03-27-171017,171017,3,0,1,21,7.428571428571429,0.5300524,4
2020-03-28-171017,171017,1,0,3,22,4.0,0.24012803,5
2020-03-29-171017,171017,0,0,1,22,3.0,0.0961273,6
2020-03-30-171017,171017,0,0,16,22,9.285714285714286,0.45282954,0
2020-03-31-171017,171017,1,0,2,23,7.142857142857142,0.48143396,1
2020-04-01-171017,171017,1,0,3,24,7.571428571428571,0.5351446,2
2020-04-02-171017,171017,1,0,4,25,5.142857142857143,0.26987937,3
2020-04-03-171017,171017,1,0,2,26,5.857142857142858,0.554202,4
2020-04-04-171017,171017,1,0,0,27,2.142857142857143,0.2785547,5
2020-04-05-171017,171017,0,1,0,27,2.571428571428572,0.031193726,6
2020-04-06-171017,171017,2,0,2,29,10.571428571428571,0.9349095,0
2020-04-07-171017,171017,1,0,3,30,10.571428571428571,1.0302763,1
2020-04-08-171017,171017,3,0,0,33,6.2857142857142865,0.51716805,2
2020-04-09-171017,171017,1,0,0,34,4.571428571428571,0.3305606,3
2020-04-10-171017,171017,1,0,2,35,4.714285714285714,0.31081805,4
2020-04-11-171017,171017,3,0,2,38,10.428571428571429,0.34047672,5
2020-04-12-171017,171017,1,0,0,39,4.0,0.2852533,6
2020-04-13-171017,171017,16,0,3,55,15.0,1.0881759,0
2020-04-14-171017,171017,2,0,0,57,10.857142857142858,0.4780734,1
2020-04-15-171017,171017,3,0,0,60,7.428571428571429,0.6816118,2
2020-04-16-171017,171017,4,0,0,64,4.0,0.22212848,3
2020-04-17-171017,171017,2,0,0,66,4.714285714285714,0.30062902,4
2020-04-18-171017,171017,0,0,1,66,1.2857142857142858,0.058104806,5
2020-04-19-171017,171017,0,0,0,66,0.42857142857142855,0.004995858,6
2020-04-20-171017,171017,2,0,3,68,5.142857142857143,0.27182633,0
2020-04-21-171017,171017,3,0,0,71,4.142857142857143,0.2609174,1
2020-04-22-171017,171017,0,0,2,71,3.1428571428571432,0.19423799,2
2020-04-23-171017,171017,0,0,0,71,0.7142857142857143,0.07158295,3
2020-04-24-171017,171017,2,0,0,73,4.142857142857143,0.5009813,4
2020-04-25-171017,171017,2,0,1,75,0.7142857142857143,0.08479937,5
2020-04-26-171017,171017,0,0,0,75,1.1428571428571428,0.015541983,6
2020-04-27-171017,171017,3,0,1,78,4.285714285714286,0.3865559,0
2020-04-28-171017,171017,0,0,0,78,3.0,0.17611423,1
2020-04-29-171017,171017,0,0,0,78,3.0,0.32238415,2
2020-04-30-171017,171017,0,0,4,78,4.714285714285714,0.22770083,3
2020-05-01-171017,171017,0,0,0,78,0.14285714285714285,0.024319923,4
2020-05-02-171017,171017,1,0,0,79,0.7142857142857143,0.055343844,5
2020-05-03-171017,171017,0,0,0,79,0.7142857142857143,0.04204768,6
2020-05-04-171017,171017,3,0,1,82,4.285714285714286,0.25380084,0
2020-05-05-171017,171017,0,0,0,82,3.8571428571428568,0.23054019,1
2020-05-06-171017,171017,2,0,0,84,4.571428571428571,0.49088502,2
2020-05-07-171017,171017,0,0,0,84,3.2857142857142856,0.27451545,3
2020-05-08-171017,171017,0,0,0,84,3.2857142857142856,0.4813343,4
2020-05-09-171017,171017,1,0,0,85,0.5714285714285714,0.0660027,5
2020-05-10-171017,171017,0,0,0,85,0.2857142857142857,0.0037071903,6
2020-05-11-171017,171017,1,0,0,86,3.7142857142857135,0.36315313,0
2020-05-12-171017,171017,0,0,0,86,4.142857142857143,0.13529499,1
2020-05-13-171017,171017,0,0,4,86,1.8571428571428568,0.26348758,2
2020-05-14-171017,171017,4,0,0,90,2.8571428571428568,0.3247915,3
2020-05-15-171017,171017,0,1,0,90,3.1428571428571432,0.1518781,4
2020-05-16-171017,171017,0,0,0,90,0.14285714285714285,0.013704415,5
2020-05-17-171017,171017,0,0,0,90,0.2857142857142857,0.012160277,6
2020-05-18-171017,171017,1,0,1,91,3.2857142857142856,0.42162588,0
2020-05-19-171017,171017,0,0,0,91,3.0,0.31239283,1
2020-05-20-171017,171017,0,0,1,91,2.0,0.07284045,2
2020-05-21-171017,171017,0,0,0,91,2.2857142857142856,0.14766821,3
2020-05-22-171017,171017,0,0,0,91,2.142857142857143,0.26672354,4
2020-05-23-171017,171017,0,0,0,91,0.2857142857142857,0.0009424926,5
2020-05-24-171017,171017,0,0,0,91,0.2857142857142857,0.025198676,6
2020-05-25-171017,171017,0,0,0,91,3.7142857142857135,0.41890615,0
2020-05-26-171017,171017,0,0,0,91,2.571428571428572,0.15510057,1
2020-05-27-171017,171017,4,0,0,95,2.8571428571428568,0.21058719,2
2020-05-28-171017,171017,0,1,0,95,2.7142857142857144,0.71861255,3
2020-05-29-171017,171017,0,1,0,95,2.4285714285714284,0.49193418,4
2020-05-30-171017,171017,0,0,0,95,0.42857142857142855,0.035598665,5
2020-05-31-171017,171017,0,0,0,95,0.8571428571428571,0.05845588,6
2020-06-01-171017,171017,1,0,0,96,1.8571428571428568,0.2679895,0
2020-06-02-171017,171017,0,0,0,96,1.7142857142857142,0.13064037,1
2020-06-03-171017,171017,1,0,0,97,1.7142857142857142,0.33612534,2
2020-06-04-171017,171017,0,0,0,97,2.0,0.22166379,3
2020-06-05-171017,171017,0,0,0,97,1.2857142857142858,0.1106167,4
2020-06-06-171017,171017,0,0,0,97,0.0,0.002123653,5
2020-06-07-171017,171017,0,0,0,97,0.2857142857142857,0.032130558,6
2020-06-08-171017,171017,0,0,0,97,1.7142857142857142,0.33985436,0
2020-06-09-171017,171017,0,0,0,97,1.2857142857142858,0.16226992,1
2020-06-10-171017,171017,0,0,0,97,2.142857142857143,0.2302088,2
2020-06-11-171017,171017,0,0,0,97,2.0,0.24711777,3
2020-06-12-171017,171017,0,0,0,97,1.7142857142857142,0.14604887,4
2020-06-13-171017,171017,0,0,0,97,0.2857142857142857,0.030096237,5
2020-06-14-171017,171017,0,1,0,97,0.14285714285714285,0.0007331568,6
2020-06-15-171017,171017,0,0,0,97,2.0,0.058980294,0
2020-06-16-171017,171017,0,0,0,97,1.8571428571428568,0.10758131,1
2020-06-17-171017,171017,0,0,0,97,1.2857142857142858,0.18994598,2
2020-06-18-171017,171017,0,0,0,97,1.2857142857142858,0.13459294,3
2020-06-19-171017,171017,0,0,0,97,2.0,0.30918503,4
2020-06-20-171017,171017,0,0,0,97,0.42857142857142855,0.040304054,5
2020-06-21-171017,171017,0,0,0,97,0.14285714285714285,0.0018223897,6
2020-06-22-171017,171017,0,0,0,97,0.8571428571428571,0.05725768,0
2020-06-23-171017,171017,0,0,0,97,1.0,0.16019739,1
2020-06-24-171017,171017,0,1,0,97,1.0,0.12131782,2
2020-06-25-171017,171017,0,0,1,97,0.8571428571428571,0.14685957,3
2020-06-26-171017,171017,0,0,0,97,0.7142857142857143,0.20512244,4
2020-06-27-171017,171017,0,0,0,97,0.42857142857142855,0.0067398055,5
2020-06-28-171017,171017,0,0,0,97,0.0,0.0035355447,6
2020-06-29-171017,171017,0,0,0,97,1.5714285714285714,0.13077545,0
2020-06-30-171017,171017,0,0,0,97,0.8571428571428571,0.07146032,1
2020-07-01-171017,171017,0,0,0,97,0.2857142857142857,0.051646806,2
2020-07-02-171017,171017,0,0,0,97,0.2857142857142857,0.14848639,3
2020-07-03-171017,171017,0,0,0,97,1.0,0.047886375,4
2020-07-04-171017,171017,0,0,0,97,0.2857142857142857,0.015470172,5
2020-07-05-171017,171017,0,0,1,97,0.14285714285714285,0.0164839,6
2020-07-06-171017,171017,0,0,0,97,0.5714285714285714,0.10493367,0
2020-07-07-171017,171017,0,0,0,97,0.0,0.008057597,1
2020-07-08-171017,171017,0,0,0,97,1.0,0.045608133,2
2020-07-09-171017,171017,1,0,0,98,0.14285714285714285,0.04438575,3
2020-07-10-171017,171017,0,0,0,98,0.8571428571428571,0.041001923,4
2020-07-11-171017,171017,0,0,0,98,0.42857142857142855,0.0023304296,5
2020-07-12-171017,171017,0,0,0,98,0.0,0.0014168865,6
2020-07-13-171017,171017,0,0,0,98,0.8571428571428571,0.04540564,0
2020-07-14-171017,171017,0,0,0,98,0.8571428571428571,0.16378018,1
2020-07-15-171017,171017,0,0,0,98,1.4285714285714286,0.10781317,2
2020-07-16-171017,171017,0,0,0,98,1.2857142857142858,0.14677118,3
2020-07-17-171017,171017,0,0,0,98,1.1428571428571428,0.1541205,4
2020-07-18-171017,171017,0,0,0,98,0.14285714285714285,0.021347623,5
2020-07-19-171017,171017,1,0,0,99,0.2857142857142857,0.08067842,6
2020-07-20-171017,171017,0,0,0,99,1.0,0.19902183,0
2020-07-21-171017,171017,0,0,0,99,1.0,0.1136792,1
2020-07-22-171017,171017,0,0,0,99,0.7142857142857143,0.05104609,2
2020-07-23-171017,171017,0,0,0,99,0.2857142857142857,0.15421796,3
2020-07-24-171017,171017,0,0,0,99,1.0,0.31125954,4
2020-07-25-171017,171017,0,0,0,99,0.0,0.0054578893,5
2020-07-26-171017,171017,0,0,1,99,0.14285714285714285,0.017002793,6
2020-07-27-171017,171017,0,0,0,99,1.0,0.21138318,0
2020-07-28-171017,171017,0,0,4,99,1.1428571428571428,0.09048987,1
2020-07-29-171017,171017,0,0,0,99,1.1428571428571428,0.12943949,2
2020-07-30-171017,171017,0,0,0,99,1.4285714285714286,0.24748208,3
2020-07-31-171017,171017,0,0,1,99,0.7142857142857143,0.082047254,4
2020-08-01-171017,171017,0,0,0,99,0.42857142857142855,0.037854124,5
2020-08-02-171017,171017,0,0,0,99,0.42857142857142855,0.101960965,6
2020-08-03-171017,171017,0,0,0,99,0.14285714285714285,0.038649663,0
2020-08-04-171017,171017,0,0,0,99,0.7142857142857143,0.055421293,1
2020-08-05-171017,171017,0,0,1,99,0.8571428571428571,0.41354704,2
2020-08-06-171017,171017,0,0,0,99,0.14285714285714285,0.020655157,3
2020-08-07-171017,171017,0,0,0,99,1.1428571428571428,0.16771689,4
2020-08-08-171017,171017,0,0,0,99,0.42857142857142855,0.013682554,5
2020-08-09-171017,171017,1,0,1,100,0.2857142857142857,0.05029041,6
2020-08-10-171017,171017,0,0,0,100,1.1428571428571428,0.037634503,0
2020-08-11-171017,171017,4,0,0,104,2.2857142857142856,0.23407508,1
2020-08-12-171017,171017,0,0,0,104,0.5714285714285714,0.025854196,2
2020-08-13-171017,171017,0,0,1,104,1.4285714285714286,0.31487453,3
2020-08-14-171017,171017,1,0,0,105,1.1428571428571428,0.18603233,4
2020-08-15-171017,171017,0,0,0,105,2.2857142857142856,0.08482568,5
2020-08-16-171017,171017,0,0,0,105,0.8571428571428571,0.029314965,6
2020-08-17-171017,171017,0,0,5,105,1.0,0.23572737,0
2020-08-18-171017,171017,0,0,1,105,3.2857142857142856,0.3033402,1
2020-08-19-171017,171017,1,1,0,106,4.0,1.0837315,2
2020-08-20-171017,171017,0,0,0,106,5.857142857142858,0.5738226,3
2020-08-21-171017,171017,0,0,3,106,4.142857142857143,0.56961596,4
2020-08-22-171017,171017,0,0,2,106,2.0,0.13103336,5
2020-08-23-171017,171017,1,0,0,107,1.7142857142857142,0.24626958,6
2020-08-24-171017,171017,0,0,2,107,5.142857142857143,0.50966465,0
2020-08-25-171017,171017,0,0,0,107,8.428571428571429,0.75166875,1
2020-08-26-171017,171017,0,0,1,107,7.7142857142857135,0.9996987,2
2020-08-27-171017,171017,1,0,5,108,8.0,0.5877099,3
2020-08-28-171017,171017,0,0,4,108,7.142857142857142,0.52023554,4
2020-08-29-171017,171017,0,0,0,108,2.571428571428572,0.52818906,5
2020-08-30-171017,171017,0,0,0,108,2.2857142857142856,0.42523497,6
2020-08-31-171017,171017,5,0,4,113,4.428571428571429,0.6026215,0
2020-09-01-171017,171017,1,0,3,114,4.142857142857143,0.38315532,1
2020-09-02-171017,171017,0,0,7,114,5.428571428571429,0.34938094,2
2020-09-03-171017,171017,0,0,0,114,3.571428571428572,0.88201535,3
2020-09-04-171017,171017,3,0,0,117,3.7142857142857135,0.32555807,4
2020-09-05-171017,171017,2,0,0,119,2.142857142857143,0.69085145,5
2020-09-06-171017,171017,0,0,0,119,3.8571428571428568,0.37144357,6
2020-09-07-171017,171017,2,0,5,121,7.0,1.2877712,0
2020-09-08-171017,171017,0,0,4,121,3.8571428571428568,0.3549561,1
2020-09-09-171017,171017,1,0,0,122,5.142857142857143,0.5570752,2
2020-09-10-171017,171017,5,0,4,127,5.571428571428571,1.007082,3
2020-09-11-171017,171017,4,0,5,131,5.571428571428571,0.83426124,4
2020-09-12-171017,171017,0,0,4,131,3.1428571428571432,0.9627549,5
2020-09-13-171017,171017,0,0,0,131,2.0,0.5560663,6
2020-09-14-171017,171017,4,0,0,135,9.571428571428571,1.9267037,0
2020-09-15-171017,171017,3,0,0,138,10.285714285714286,1.6077871,1
2020-09-16-171017,171017,7,0,2,145,8.857142857142858,1.8464293,2
2020-09-17-171017,171017,0,0,6,145,8.0,1.5792557,3
2020-09-18-171017,171017,0,0,1,145,7.571428571428571,1.5191967,4
2020-09-19-171017,171017,0,1,0,145,4.142857142857143,1.1559265,5
2020-09-20-171017,171017,0,0,0,145,2.7142857142857144,0.43073258,6
2020-09-21-171017,171017,5,0,9,150,8.285714285714286,1.0056187,0
2020-09-22-171017,171017,4,0,2,154,9.714285714285714,0.74857944,1
2020-09-23-171017,171017,0,0,7,154,11.0,2.1608038,2
2020-09-24-171017,171017,4,0,1,158,9.0,3.2737966,3
2020-09-25-171017,171017,5,0,1,163,10.714285714285714,1.497421,4
2020-09-26-171017,171017,4,0,0,167,8.142857142857142,1.712246,5
2020-09-27-171017,171017,0,0,1,167,1.1428571428571428,0.22496152,6
2020-09-28-171017,171017,0,0,0,167,4.142857142857143,0.6889837,0
2020-09-29-171017,171017,0,0,3,167,4.857142857142857,0.81947345,1
2020-09-30-171017,171017,2,0,6,169,6.7142857142857135,1.2424443,2
2020-10-01-171017,171017,6,0,6,175,7.428571428571429,1.304777,3
2020-10-02-171017,171017,1,0,2,176,9.428571428571429,1.0439514,4
2020-10-03-171017,171017,0,0,0,176,5.285714285714286,1.0540068,5
2020-10-04-171017,171017,0,0,3,176,1.2857142857142858,0.20135842,6
2020-10-05-171017,171017,9,0,7,185,4.142857142857143,0.66585815,0
2020-10-06-171017,171017,2,0,17,187,10.142857142857142,2.3183894,1
2020-10-07-171017,171017,7,1,5,194,9.0,1.4535735,2
2020-10-08-171017,171017,1,0,4,195,7.571428571428571,1.407203,3
2020-10-09-171017,171017,1,0,0,196,6.428571428571429,1.4889021,4
2020-10-10-171017,171017,0,0,3,196,1.8571428571428568,0.35499415,5
2020-10-11-171017,171017,1,0,3,197,1.5714285714285714,0.38438666,6
2020-10-12-171017,171017,0,0,0,197,1.5714285714285714,0.122244745,0
2020-10-13-171017,171017,3,0,4,200,8.428571428571429,0.79130274,1
2020-10-14-171017,171017,6,0,3,206,7.7142857142857135,0.76565945,2
2020-10-15-171017,171017,6,0,7,212,7.7142857142857135,1.1206857,3
2020-10-16-171017,171017,2,0,3,214,7.857142857142858,0.94461995,4
2020-10-17-171017,171017,0,0,3,214,4.714285714285714,0.8606202,5
2020-10-18-171017,171017,3,0,0,217,2.7142857142857144,0.44266367,6
2020-10-19-171017,171017,7,0,2,224,6.2857142857142865,0.5735251,0
2020-10-20-171017,171017,17,0,6,241,14.571428571428573,1.6158258,1
2020-10-21-171017,171017,5,0,14,246,12.714285714285715,0.82376677,2
2020-10-22-171017,171017,4,0,17,250,14.857142857142858,1.095295,3
2020-10-23-171017,171017,0,0,1,250,18.428571428571427,1.1761545,4
2020-10-24-171017,171017,3,0,0,253,7.0,0.6266394,5
2020-10-25-171017,171017,3,0,2,256,1.2857142857142858,0.18760058,6
2020-10-26-171017,171017,0,0,14,256,14.857142857142858,2.2365224,0
2020-10-27-171017,171017,4,1,6,260,14.285714285714285,1.5432597,1
2020-10-28-171017,171017,3,1,2,263,18.571428571428573,1.4858441,2
2020-10-29-171017,171017,7,0,5,270,19.0,3.3210042,3
2020-10-30-171017,171017,3,0,6,273,16.857142857142858,1.8147283,4
2020-10-31-171017,171017,3,0,0,276,10.428571428571429,2.01599,5
2020-11-01-171017,171017,0,1,0,276,9.714285714285714,1.0473197,6
2020-11-02-171017,171017,2,0,0,278,7.142857142857142,1.0544382,0
2020-11-03-171017,171017,6,0,0,284,12.285714285714285,1.4485954,1
2020-11-04-171017,171017,14,0,0,298,16.428571428571427,1.6580266,2
2020-11-05-171017,171017,17,0,0,315,26.57142857142857,2.7794316,3
2020-11-06-171017,171017,1,0,0,316,25.285714285714285,1.515887,4
2020-11-07-171017,171017,0,0,0,316,5.857142857142858,0.88419586,5
2020-11-08-171017,171017,2,0,0,318,9.0,0.28810224,6
2020-11-09-171017,171017,14,0,0,332,12.857142857142858,1.1432198,0
2020-11-10-171017,171017,6,0,0,338,12.285714285714285,1.3570913,1
2020-11-11-171017,171017,2,0,0,340,11.428571428571427,1.3367794,2
2020-11-12-171017,171017,5,0,0,345,13.428571428571427,1.5821043,3
2020-11-13-171017,171017,6,0,0,351,14.285714285714285,1.0213361,4
2020-03-01-171018,171018,1,0,0,1,0.0,0.021777118,6
2020-03-02-171018,171018,0,0,3,1,0.0,0.004508198,0
2020-03-03-171018,171018,0,1,2,1,0.0,0.008333193,1
2020-03-04-171018,171018,0,0,11,1,0.0,0.00095541956,2
2020-03-05-171018,171018,0,0,10,1,0.2,0.005464421,3
2020-03-06-171018,171018,0,0,4,1,0.4,0.0067666243,4
2020-03-07-171018,171018,0,0,2,1,0.0,0.0017780145,5
2020-03-08-171018,171018,0,0,1,1,0.0,0.0038836992,6
2020-03-09-171018,171018,0,0,13,1,0.2,0.08396111,0
2020-03-10-171018,171018,0,0,9,1,0.2,0.06548508,1
2020-03-11-171018,171018,1,0,9,2,0.2,0.032112762,2
2020-03-12-171018,171018,0,0,10,2,0.0,0.037887067,3
2020-03-13-171018,171018,1,0,15,3,1.4,0.21757431,4
2020-03-14-171018,171018,1,0,3,4,0.4,0.06448721,5
2020-03-15-171018,171018,0,0,5,4,1.8,0.0129284365,6
2020-03-16-171018,171018,3,0,10,7,4.6,0.476518,0
2020-03-17-171018,171018,2,0,5,9,4.0,0.3961689,1
2020-03-18-171018,171018,11,0,6,20,7.0,0.6044136,2
2020-03-19-171018,171018,10,0,7,30,6.2,0.5924346,3
2020-03-20-171018,171018,4,0,3,34,8.6,0.6856067,4
2020-03-21-171018,171018,2,0,3,36,3.2,0.14243352,5
2020-03-22-171018,171018,1,0,3,37,4.8,0.09054796,6
2020-03-23-171018,171018,13,0,6,50,10.0,1.1330135,0
2020-03-24-171018,171018,9,0,2,59,9.4,0.7152054,1
2020-03-25-171018,171018,9,0,4,68,7.6,0.36955103,2
2020-03-26-171018,171018,10,0,2,78,9.0,0.39177564,3
2020-03-27-171018,171018,15,0,3,93,8.0,0.5067658,4
2020-03-28-171018,171018,3,0,7,96,2.0,0.10763532,5
2020-03-29-171018,171018,5,0,2,101,2.0,0.06037464,6
2020-03-30-171018,171018,10,0,1,111,7.8,0.51411146,0
2020-03-31-171018,171018,5,0,4,116,4.8,0.3739939,1
2020-04-01-171018,171018,6,0,4,122,7.8,0.26632932,2
2020-04-02-171018,171018,7,0,3,129,5.4,0.43001887,3
2020-04-03-171018,171018,3,0,0,132,11.0,0.26886535,4
2020-04-04-171018,171018,3,0,1,135,1.4,0.09623166,5
2020-04-05-171018,171018,3,0,0,138,2.0,0.1013047,6
2020-04-06-171018,171018,6,0,11,144,6.4,0.2256259,0
2020-04-07-171018,171018,2,1,4,146,6.0,0.22306722,1
2020-04-08-171018,171018,4,0,1,150,5.2,0.5033387,2
2020-04-09-171018,171018,2,0,0,152,5.4,0.15279077,3
2020-04-10-171018,171018,3,0,2,155,2.8,0.035785798,4
2020-04-11-171018,171018,7,0,0,162,4.2,0.30227402,5
2020-04-12-171018,171018,2,0,1,164,4.4,0.16112919,6
2020-04-13-171018,171018,1,0,1,165,5.4,0.50881463,0
2020-04-14-171018,171018,4,0,2,169,5.0,0.39292416,1
2020-04-15-171018,171018,4,0,3,173,4.2,0.66691804,2
2020-04-16-171018,171018,3,0,1,176,3.2,0.32816392,3
2020-04-17-171018,171018,0,0,0,176,3.4,0.17800033,4
2020-04-18-171018,171018,1,0,1,177,1.2,0.00888412,5
2020-04-19-171018,171018,0,0,1,177,0.6,0.094092846,6
2020-04-20-171018,171018,11,1,0,188,3.8,0.46982008,0
2020-04-21-171018,171018,4,0,2,192,3.2,0.23202214,1
2020-04-22-171018,171018,1,0,3,193,2.8,0.281316,2
2020-04-23-171018,171018,0,0,3,193,0.4,0.025525274,3
2020-04-24-171018,171018,2,0,6,195,4.2,0.33721802,4
2020-04-25-171018,171018,0,0,0,195,0.2,0.0029402894,5
2020-04-26-171018,171018,1,0,0,196,3.6,0.38127464,6
2020-04-27-171018,171018,1,0,1,197,3.2,0.28897294,0
2020-04-28-171018,171018,2,0,2,199,2.8,0.21833776,1
2020-04-29-171018,171018,3,0,3,202,2.2,0.33656278,2
2020-04-30-171018,171018,1,0,3,203,3.0,0.06511159,3
2020-05-01-171018,171018,0,0,6,203,0.6,0.016998999,4
2020-05-02-171018,171018,1,0,1,204,0.8,0.019883716,5
2020-05-03-171018,171018,1,0,3,205,0.2,0.02309698,6
2020-05-04-171018,171018,0,0,2,205,3.0,0.12220762,0
2020-05-05-171018,171018,2,0,3,207,3.0,0.20466058,1
2020-05-06-171018,171018,3,0,0,210,3.8,0.38078713,2
2020-05-07-171018,171018,3,0,3,213,2.6,0.29459342,3
2020-05-08-171018,171018,6,0,3,219,2.8,0.33729175,4
2020-05-09-171018,171018,0,1,0,219,0.4,0.044228528,5
2020-05-10-171018,171018,0,1,1,219,0.4,0.013441066,6
2020-05-11-171018,171018,1,0,0,220,3.0,0.34092295,0
2020-05-12-171018,171018,2,0,5,222,2.0,0.15906805,1
2020-05-13-171018,171018,3,1,2,225,2.4,0.33485872,2
2020-05-14-171018,171018,3,0,0,228,2.0,0.2567243,3
2020-05-15-171018,171018,6,0,2,234,1.2,0.31838298,4
2020-05-16-171018,171018,1,0,1,235,0.0,0.0113830855,5
2020-05-17-171018,171018,3,0,0,238,0.0,0.01769555,6
2020-05-18-171018,171018,2,0,2,240,2.6,0.21155821,0
2020-05-19-171018,171018,3,0,3,243,1.8,0.20964335,1
2020-05-20-171018,171018,0,0,0,243,3.0,0.19145955,2
2020-05-21-171018,171018,3,0,1,246,1.8,0.24142388,3
2020-05-22-171018,171018,3,0,0,249,2.8,0.23661415,4
2020-05-23-171018,171018,0,0,1,249,0.0,0.0003567033,5
2020-05-24-171018,171018,1,0,0,250,0.2,0.005969066,6
2020-05-25-171018,171018,0,0,1,250,1.6,0.22187455,0
2020-05-26-171018,171018,5,0,0,255,1.0,0.23056564,1
2020-05-27-171018,171018,2,0,0,257,2.2,0.16861011,2
2020-05-28-171018,171018,0,0,1,257,0.6,0.09723268,3
2020-05-29-171018,171018,2,0,0,259,1.8,0.30956852,4
2020-05-30-171018,171018,1,0,0,260,0.0,0.037036113,5
2020-05-31-171018,171018,0,0,0,260,0.6,0.0073004426,6
2020-06-01-171018,171018,2,0,0,262,2.2,0.21487838,0
2020-06-02-171018,171018,3,0,2,265,1.6,0.18431677,1
2020-06-03-171018,171018,0,0,0,265,0.6,0.07872571,2
2020-06-04-171018,171018,1,1,2,266,1.0,0.11522251,3
2020-06-05-171018,171018,0,0,3,266,0.8,0.03854812,4
2020-06-06-171018,171018,1,0,0,267,0.0,0.03593227,5
2020-06-07-171018,171018,0,0,0,267,0.2,0.00069036573,6
2020-06-08-171018,171018,1,0,1,268,1.6,0.3566139,0
2020-06-09-171018,171018,0,0,1,268,1.0,0.09666014,1
2020-06-10-171018,171018,0,0,0,268,1.4,0.14040871,2
2020-06-11-171018,171018,1,0,0,269,1.4,0.14270972,3
2020-06-12-171018,171018,0,0,1,269,0.8,0.08275163,4
2020-06-13-171018,171018,0,2,0,269,0.0,0.002260684,5
2020-06-14-171018,171018,0,0,0,269,0.2,0.0002566302,6
2020-06-15-171018,171018,0,0,0,269,2.0,0.17941636,0
2020-06-16-171018,171018,2,0,0,271,1.8,0.2727671,1
2020-06-17-171018,171018,0,0,1,271,1.2,0.07810231,2
2020-06-18-171018,171018,2,0,0,273,1.0,0.16168429,3
2020-06-19-171018,171018,3,0,0,276,2.0,0.22800319,4
2020-06-20-171018,171018,0,0,0,276,0.6,0.027896335,5
2020-06-21-171018,171018,0,0,0,276,0.2,0.0008796576,6
2020-06-22-171018,171018,1,0,0,277,0.6,0.101440944,0
2020-06-23-171018,171018,1,0,1,278,1.2,0.117112696,1
2020-06-24-171018,171018,0,0,0,278,0.8,0.034460273,2
2020-06-25-171018,171018,0,0,0,278,0.4,0.06368872,3
2020-06-26-171018,171018,1,0,0,279,0.4,0.10139048,4
2020-06-27-171018,171018,0,0,0,279,0.2,0.028674314,5
2020-06-28-171018,171018,0,0,0,279,0.2,0.0061134677,6
2020-06-29-171018,171018,0,0,0,279,1.2,0.10003046,0
2020-06-30-171018,171018,0,0,0,279,1.0,0.047573544,1
2020-07-01-171018,171018,1,0,0,280,0.4,0.07577259,2
2020-07-02-171018,171018,0,0,0,280,0.2,0.0636509,3
2020-07-03-171018,171018,0,0,0,280,1.0,0.06514261,4
2020-07-04-171018,171018,0,0,0,280,0.4,0.0069384193,5
2020-07-05-171018,171018,0,0,0,280,0.0,0.0019950026,6
2020-07-06-171018,171018,0,0,0,280,0.6,0.06663988,0
2020-07-07-171018,171018,1,0,1,281,0.4,0.08792719,1
2020-07-08-171018,171018,0,0,0,281,1.0,0.026005588,2
2020-07-09-171018,171018,0,0,1,281,0.2,0.01734081,3
2020-07-10-171018,171018,0,0,2,281,1.0,0.08023237,4
2020-07-11-171018,171018,0,0,0,281,0.2,0.002565732,5
2020-07-12-171018,171018,0,0,0,281,0.2,0.007969184,6
2020-07-13-171018,171018,0,0,0,281,0.8,0.0531836,0
2020-07-14-171018,171018,0,0,2,281,0.6,0.020349192,1
2020-07-15-171018,171018,0,0,1,281,1.6,0.033487093,2
2020-07-16-171018,171018,0,0,2,281,1.8,0.019460635,3
2020-07-17-171018,171018,0,0,2,281,1.6,0.09423149,4
2020-07-18-171018,171018,0,0,0,281,0.0,0.0029087875,5
2020-07-19-171018,171018,0,0,0,281,0.4,0.00981392,6
2020-07-20-171018,171018,0,0,0,281,1.0,0.07926044,0
2020-07-21-171018,171018,1,0,0,282,1.0,0.12236799,1
2020-07-22-171018,171018,0,0,0,282,0.4,0.02378197,2
2020-07-23-171018,171018,1,0,0,283,0.4,0.110676356,3
2020-07-24-171018,171018,2,0,0,285,0.8,0.11958085,4
2020-07-25-171018,171018,0,0,1,285,0.2,0.023311798,5
2020-07-26-171018,171018,0,0,1,285,0.2,0.0024651089,6
2020-07-27-171018,171018,0,0,0,285,1.6,0.1966859,0
2020-07-28-171018,171018,2,0,2,287,0.4,0.06568084,1
2020-07-29-171018,171018,1,0,0,288,1.0,0.05252222,2
2020-07-30-171018,171018,2,0,1,290,0.8,0.12913203,3
2020-07-31-171018,171018,2,0,1,292,1.2,0.15605071,4
2020-08-01-171018,171018,0,0,0,292,0.6,0.026953189,5
2020-08-02-171018,171018,0,0,0,292,0.2,0.0100617595,6
2020-08-03-171018,171018,0,0,1,292,0.6,0.08745483,0
2020-08-04-171018,171018,0,0,2,292,1.0,0.13152605,1
2020-08-05-171018,171018,0,0,0,292,0.8,0.3801023,2
2020-08-06-171018,171018,0,0,2,292,0.2,0.09593674,3
2020-08-07-171018,171018,0,0,0,292,1.2,0.085708745,4
2020-08-08-171018,171018,1,0,0,293,1.2,0.2605719,5
2020-08-09-171018,171018,1,0,5,294,0.2,0.048213497,6
2020-08-10-171018,171018,0,0,2,294,0.8,0.15558839,0
2020-08-11-171018,171018,2,0,2,296,3.0,0.5634311,1
2020-08-12-171018,171018,0,0,0,296,0.4,0.2455295,2
2020-08-13-171018,171018,1,0,2,297,2.2,0.54879904,3
2020-08-14-171018,171018,1,0,2,298,2.0,0.43800864,4
2020-08-15-171018,171018,0,0,0,298,1.0,0.14844845,5
2020-08-16-171018,171018,0,0,0,298,0.8,0.12774701,6
2020-08-17-171018,171018,1,0,0,299,0.8,0.28256366,0
2020-08-18-171018,171018,2,0,1,301,3.2,0.37255004,1
2020-08-19-171018,171018,0,0,1,301,2.6,0.3434794,2
2020-08-20-171018,171018,2,0,0,303,4.4,0.5792878,3
2020-08-21-171018,171018,0,0,1,303,5.0,0.57185405,4
2020-08-22-171018,171018,0,0,1,303,1.2,0.13591029,5
2020-08-23-171018,171018,5,0,1,308,1.4,0.07676778,6
2020-08-24-171018,171018,2,0,5,310,4.2,0.35100657,0
2020-08-25-171018,171018,2,0,6,312,7.8,0.6075428,1
2020-08-26-171018,171018,0,0,3,312,5.6,0.67817706,2
2020-08-27-171018,171018,2,0,17,314,10.0,0.6781087,3
2020-08-28-171018,171018,2,0,3,316,9.0,0.9341983,4
2020-08-29-171018,171018,0,0,2,316,2.4,0.3817391,5
2020-08-30-171018,171018,0,0,2,316,2.6,0.297094,6
2020-08-31-171018,171018,0,0,5,316,4.8,0.50746286,0
2020-09-01-171018,171018,1,0,11,317,3.4,0.16912885,1
2020-09-02-171018,171018,1,0,26,318,4.4,0.26090735,2
2020-09-03-171018,171018,0,0,4,318,3.0,0.32379615,3
2020-09-04-171018,171018,1,0,48,319,3.8,0.5573344,4
2020-09-05-171018,171018,1,0,53,320,2.0,0.39315736,5
2020-09-06-171018,171018,1,0,0,321,4.8,0.2183834,6
2020-09-07-171018,171018,5,0,2,326,3.0,0.37987614,0
2020-09-08-171018,171018,6,1,0,332,4.2,0.9912739,1
2020-09-09-171018,171018,3,0,3,335,7.8,1.3897758,2
2020-09-10-171018,171018,17,0,6,352,8.0,1.4703566,3
2020-09-11-171018,171018,3,0,1,355,7.4,1.0310019,4
2020-09-12-171018,171018,2,0,0,357,3.4,0.57718134,5
2020-09-13-171018,171018,2,0,0,359,0.8,0.07331684,6
2020-09-14-171018,171018,5,0,2,364,6.4,0.6904212,0
2020-09-15-171018,171018,11,0,9,375,13.2,1.8825425,1
2020-09-16-171018,171018,26,0,8,401,6.8,1.2467232,2
2020-09-17-171018,171018,4,1,14,405,8.0,1.5944387,3
2020-09-18-171018,171018,48,0,4,453,7.0,0.80823374,4
2020-09-19-171018,171018,53,1,2,506,2.8,2.0878375,5
2020-09-20-171018,171018,0,0,0,506,2.2,0.109097935,6
2020-09-21-171018,171018,2,1,2,508,9.0,0.7095653,0
2020-09-22-171018,171018,0,0,12,508,11.0,0.4470843,1
2020-09-23-171018,171018,3,2,3,511,9.4,0.95107543,2
2020-09-24-171018,171018,6,0,0,517,7.2,0.60667723,3
2020-09-25-171018,171018,1,0,4,518,8.2,0.9137295,4
2020-09-26-171018,171018,0,0,4,518,6.6,0.48169374,5
2020-09-27-171018,171018,0,0,0,518,0.4,0.079583384,6
2020-09-28-171018,171018,2,1,2,520,3.0,0.35920534,0
2020-09-29-171018,171018,9,0,3,529,5.6,0.8483708,1
2020-09-30-171018,171018,8,0,10,537,3.6,0.5222458,2
2020-10-01-171018,171018,14,0,2,551,6.4,0.8047249,3
2020-10-02-171018,171018,4,0,5,555,6.8,0.36305472,4
2020-10-03-171018,171018,2,1,3,557,1.8,0.23273623,5
2020-10-04-171018,171018,0,4,1,557,0.8,0.028559003,6
2020-10-05-171018,171018,2,0,1,559,3.4,0.6436575,0
2020-10-06-171018,171018,12,0,9,571,6.0,0.83147347,1
2020-10-07-171018,171018,3,2,5,574,6.0,0.83462346,2
2020-10-08-171018,171018,0,2,2,574,3.4,0.8644009,3
2020-10-09-171018,171018,4,1,1,578,6.0,0.80794954,4
2020-10-10-171018,171018,4,0,4,582,2.0,0.35479787,5
2020-10-11-171018,171018,0,0,1,582,1.4,0.14374228,6
2020-10-12-171018,171018,2,0,1,584,1.4,0.19255035,0
2020-10-13-171018,171018,3,0,4,587,6.8,0.57513165,1
2020-10-14-171018,171018,10,0,3,597,5.4,0.9620203,2
2020-10-15-171018,171018,2,0,10,599,5.0,0.7664951,3
2020-10-16-171018,171018,5,0,5,604,7.2,0.967252,4
2020-10-17-171018,171018,3,0,6,607,3.2,0.33404255,5
2020-10-18-171018,171018,1,0,3,608,1.6,0.18645108,6
2020-10-19-171018,171018,1,0,2,609,4.2,0.594419,0
2020-10-20-171018,171018,9,0,4,618,16.0,1.2279737,1
2020-10-21-171018,171018,5,0,12,623,8.8,0.72553754,2
2020-10-22-171018,171018,2,1,11,625,9.8,0.53527683,3
2020-10-23-171018,171018,1,0,4,626,13.8,1.2532793,4
2020-10-24-171018,171018,4,1,5,630,5.0,0.76897967,5
2020-10-25-171018,171018,1,0,4,631,1.6,0.13216743,6
2020-10-26-171018,171018,1,0,2,632,9.6,0.87356406,0
2020-10-27-171018,171018,4,0,7,636,11.8,1.734658,1
2020-10-28-171018,171018,3,0,2,639,14.0,1.3728796,2
2020-10-29-171018,171018,10,0,3,649,14.0,1.1324174,3
2020-10-30-171018,171018,5,0,0,654,17.6,1.6644255,4
2020-10-31-171018,171018,6,0,0,660,7.6,0.68538713,5
2020-11-01-171018,171018,3,1,0,663,10.2,0.14430137,6
2020-11-02-171018,171018,2,1,0,665,4.8,0.0699344,0
2020-11-03-171018,171018,4,0,0,669,8.6,0.87190545,1
2020-11-04-171018,171018,12,0,0,681,16.4,1.5323817,2
2020-11-05-171018,171018,11,0,0,692,19.0,2.0863905,3
2020-11-06-171018,171018,4,0,0,696,16.2,1.3757383,4
2020-11-07-171018,171018,5,0,0,701,3.6,0.5442668,5
2020-11-08-171018,171018,4,2,0,705,11.6,0.14034674,6
2020-11-09-171018,171018,2,0,0,707,9.4,0.50828403,0
2020-11-10-171018,171018,7,0,0,714,9.6,0.97267723,1
2020-11-11-171018,171018,2,1,0,716,6.4,0.9630275,2
2020-11-12-171018,171018,3,0,0,719,8.8,1.5754164,3
2020-11-13-171018,171018,0,0,0,719,11.0,1.1904155,4
2020-03-01-171019,171019,0,0,0,0,0.0,0.005313642,6
2020-03-02-171019,171019,0,0,0,0,0.0,0.0104004685,0
2020-03-03-171019,171019,0,0,1,0,0.0,0.0012365195,1
2020-03-04-171019,171019,0,0,0,0,0.0,0.007453681,2
2020-03-05-171019,171019,0,0,1,0,0.0,0.005680073,3
2020-03-06-171019,171019,0,1,0,0,0.0,0.004882697,4
2020-03-07-171019,171019,0,0,2,0,0.0,0.003278241,5
2020-03-08-171019,171019,0,0,2,0,0.0,0.0001245755,6
2020-03-09-171019,171019,0,0,5,0,0.0,0.04395201,0
2020-03-10-171019,171019,0,0,1,0,0.0,0.0083956905,1
2020-03-11-171019,171019,1,0,3,1,0.3333333333333333,0.053057153,2
2020-03-12-171019,171019,0,0,1,1,0.0,0.015962178,3
2020-03-13-171019,171019,1,0,2,2,0.5,0.14640878,4
2020-03-14-171019,171019,0,0,0,2,0.0,0.034248497,5
2020-03-15-171019,171019,0,0,0,2,0.5,0.03529228,6
2020-03-16-171019,171019,0,0,0,2,1.5,0.27361792,0
2020-03-17-171019,171019,1,0,0,3,1.3333333333333333,0.25150236,1
2020-03-18-171019,171019,0,0,1,3,3.333333333333333,0.44084254,2
2020-03-19-171019,171019,1,0,1,4,4.0,0.9793912,3
2020-03-20-171019,171019,0,0,1,4,3.5,0.49334398,4
2020-03-21-171019,171019,2,0,0,6,2.833333333333333,0.445826,5
2020-03-22-171019,171019,2,0,0,8,1.6666666666666667,0.180369,6
2020-03-23-171019,171019,5,0,0,13,7.5,1.2760081,0
2020-03-24-171019,171019,1,0,0,14,2.5,0.47948676,1
2020-03-25-171019,171019,3,0,0,17,5.0,0.88028735,2
2020-03-26-171019,171019,1,0,0,18,3.1666666666666665,0.676367,3
2020-03-27-171019,171019,2,0,0,20,4.833333333333333,0.82049084,4
2020-03-28-171019,171019,0,0,0,20,1.5,0.3519208,5
2020-03-29-171019,171019,0,0,0,20,0.8333333333333334,0.17015462,6
2020-03-30-171019,171019,0,0,0,20,4.166666666666667,0.71391386,0
2020-03-31-171019,171019,0,0,0,20,2.5,0.4290629,1
2020-04-01-171019,171019,1,0,0,21,3.1666666666666665,0.5336421,2
2020-04-02-171019,171019,1,0,0,22,1.8333333333333333,0.25003245,3
2020-04-03-171019,171019,1,0,0,23,3.1666666666666665,0.4698249,4
2020-04-04-171019,171019,0,0,0,23,0.6666666666666666,0.18998347,5
2020-04-05-171019,171019,0,0,0,23,0.3333333333333333,0.040101092,6
2020-04-06-171019,171019,0,0,0,23,5.333333333333333,0.6093744,0
2020-04-07-171019,171019,0,0,0,23,5.833333333333332,1.0971869,1
2020-04-08-171019,171019,0,1,0,23,2.333333333333333,0.38112965,2
2020-04-09-171019,171019,0,0,0,23,3.1666666666666665,0.36906245,3
2020-04-10-171019,171019,0,0,0,23,4.333333333333333,0.30382818,4
2020-04-11-171019,171019,0,0,0,23,2.0,0.14468266,5
2020-04-12-171019,171019,0,0,0,23,1.1666666666666667,0.19193073,6
2020-04-13-171019,171019,0,0,0,23,4.5,0.7217329,0
2020-04-14-171019,171019,0,0,0,23,3.333333333333333,0.39196455,1
2020-04-15-171019,171019,0,1,0,23,5.166666666666667,0.7741011,2
2020-04-16-171019,171019,0,0,0,23,1.6666666666666667,0.1268043,3
2020-04-17-171019,171019,0,0,0,23,3.1666666666666665,0.23067574,4
2020-04-18-171019,171019,0,0,0,23,0.5,0.072840944,5
2020-04-19-171019,171019,0,0,0,23,0.3333333333333333,0.020774337,6
2020-04-20-171019,171019,0,2,0,23,1.8333333333333333,0.2678658,0
2020-04-21-171019,171019,0,0,0,23,2.833333333333333,0.14420934,1
2020-04-22-171019,171019,0,0,1,23,2.0,0.28160644,2
2020-04-23-171019,171019,0,0,0,23,0.5,0.086856976,3
2020-04-24-171019,171019,0,0,1,23,4.0,0.5675365,4
2020-04-25-171019,171019,0,0,0,23,0.6666666666666666,0.05597275,5
2020-04-26-171019,171019,0,0,0,23,0.16666666666666666,0.010844811,6
2020-04-27-171019,171019,0,0,0,23,1.8333333333333333,0.22965339,0
2020-04-28-171019,171019,0,0,0,23,1.5,0.2145363,1
2020-04-29-171019,171019,0,0,0,23,2.333333333333333,0.41248056,2
2020-04-30-171019,171019,0,0,0,23,2.6666666666666665,0.24976541,3
2020-05-01-171019,171019,0,0,0,23,0.16666666666666666,0.009729792,4
2020-05-02-171019,171019,0,0,0,23,0.16666666666666666,0.024740996,5
2020-05-03-171019,171019,0,0,0,23,0.6666666666666666,0.068718106,6
2020-05-04-171019,171019,0,0,0,23,3.5,0.32162777,0
2020-05-05-171019,171019,0,0,0,23,2.5,0.28097427,1
2020-05-06-171019,171019,1,0,2,24,12.833333333333336,0.79634064,2
2020-05-07-171019,171019,0,0,0,24,6.0,0.5000058,3
2020-05-08-171019,171019,1,0,0,25,4.0,0.65960175,4
2020-05-09-171019,171019,0,0,0,25,0.3333333333333333,0.045464993,5
2020-05-10-171019,171019,0,0,0,25,0.0,0.0060086553,6
2020-05-11-171019,171019,0,0,0,25,2.0,0.30550572,0
2020-05-12-171019,171019,0,0,0,25,4.333333333333333,0.27675468,1
2020-05-13-171019,171019,0,0,0,25,1.6666666666666667,0.2714392,2
2020-05-14-171019,171019,0,0,0,25,0.8333333333333334,0.2636399,3
2020-05-15-171019,171019,0,1,0,25,1.3333333333333333,0.20913088,4
2020-05-16-171019,171019,0,0,0,25,0.0,0.011509696,5
2020-05-17-171019,171019,0,0,0,25,0.0,0.0026680988,6
2020-05-18-171019,171019,0,0,0,25,2.1666666666666665,0.43694237,0
2020-05-19-171019,171019,0,0,0,25,2.6666666666666665,0.35021296,1
2020-05-20-171019,171019,2,0,0,27,2.1666666666666665,0.14182551,2
2020-05-21-171019,171019,0,0,0,27,1.8333333333333333,0.24461348,3
2020-05-22-171019,171019,0,0,0,27,2.0,0.32868493,4
2020-05-23-171019,171019,0,0,0,27,0.16666666666666666,0.015868044,5
2020-05-24-171019,171019,0,0,0,27,0.16666666666666666,0.047170054,6
2020-05-25-171019,171019,0,0,0,27,1.6666666666666667,0.4789537,0
2020-05-26-171019,171019,0,0,1,27,0.8333333333333334,0.1935857,1
2020-05-27-171019,171019,0,0,0,27,0.3333333333333333,0.08973973,2
2020-05-28-171019,171019,0,6,0,27,3.333333333333333,0.8606762,3
2020-05-29-171019,171019,0,1,0,27,1.0,0.48476562,4
2020-05-30-171019,171019,0,0,0,27,0.3333333333333333,0.047032367,5
2020-05-31-171019,171019,0,0,0,27,0.16666666666666666,0.03980643,6
2020-06-01-171019,171019,0,1,0,27,0.3333333333333333,0.18717828,0
2020-06-02-171019,171019,0,0,0,27,1.3333333333333333,0.23114549,1
2020-06-03-171019,171019,0,0,0,27,1.1666666666666667,0.36481705,2
2020-06-04-171019,171019,0,0,0,27,1.5,0.27330324,3
2020-06-05-171019,171019,0,0,0,27,0.6666666666666666,0.15245655,4
2020-06-06-171019,171019,0,2,0,27,0.16666666666666666,0.014307177,5
2020-06-07-171019,171019,0,1,0,27,0.16666666666666666,0.040950302,6
2020-06-08-171019,171019,0,0,1,27,0.6666666666666666,0.3208421,0
2020-06-09-171019,171019,1,0,0,28,0.5,0.19013986,1
2020-06-10-171019,171019,0,0,0,28,0.8333333333333334,0.28349882,2
2020-06-11-171019,171019,0,0,0,28,0.8333333333333334,0.28363028,3
2020-06-12-171019,171019,0,0,0,28,0.8333333333333334,0.21703264,4
2020-06-13-171019,171019,0,1,0,28,0.16666666666666666,0.063608944,5
2020-06-14-171019,171019,0,0,0,28,0.0,5.6075274e-05,6
2020-06-15-171019,171019,0,1,0,28,0.16666666666666666,0.031282473,0
2020-06-16-171019,171019,0,1,0,28,0.5,0.0945101,1
2020-06-17-171019,171019,0,0,0,28,1.0,0.27129564,2
2020-06-18-171019,171019,0,0,0,28,0.6666666666666666,0.17933893,3
2020-06-19-171019,171019,0,0,0,28,1.0,0.33184627,4
2020-06-20-171019,171019,0,0,0,28,0.16666666666666666,0.058213297,5
2020-06-21-171019,171019,0,0,0,28,0.0,0.014128556,6
2020-06-22-171019,171019,1,0,0,29,0.3333333333333333,0.09558177,0
2020-06-23-171019,171019,0,0,0,29,0.6666666666666666,0.20524435,1
2020-06-24-171019,171019,0,1,0,29,0.5,0.13457142,2
2020-06-25-171019,171019,0,0,0,29,0.6666666666666666,0.16524741,3
2020-06-26-171019,171019,0,0,0,29,0.16666666666666666,0.20492025,4
2020-06-27-171019,171019,0,0,0,29,0.0,0.023180228,5
2020-06-28-171019,171019,0,0,0,29,0.16666666666666666,0.027041852,6
2020-06-29-171019,171019,0,0,0,29,0.3333333333333333,0.14227967,0
2020-06-30-171019,171019,0,0,0,29,0.5,0.07443812,1
2020-07-01-171019,171019,0,0,0,29,0.16666666666666666,0.077000685,2
2020-07-02-171019,171019,0,0,1,29,0.16666666666666666,0.15488979,3
2020-07-03-171019,171019,0,0,0,29,0.0,0.004124851,4
2020-07-04-171019,171019,0,0,0,29,0.16666666666666666,0.014740991,5
2020-07-05-171019,171019,0,0,0,29,0.16666666666666666,0.02941889,6
2020-07-06-171019,171019,0,0,0,29,0.3333333333333333,0.1253319,0
2020-07-07-171019,171019,0,0,0,29,0.0,0.008556899,1
2020-07-08-171019,171019,0,1,0,29,0.0,0.01749732,2
2020-07-09-171019,171019,0,0,0,29,0.0,0.02234706,3
2020-07-10-171019,171019,0,0,0,29,0.3333333333333333,0.013839683,4
2020-07-11-171019,171019,0,0,0,29,0.0,0.0149351135,5
2020-07-12-171019,171019,0,0,0,29,0.0,0.0008518844,6
2020-07-13-171019,171019,0,0,0,29,0.5,0.07391786,0
2020-07-14-171019,171019,0,0,0,29,0.8333333333333334,0.1752474,1
2020-07-15-171019,171019,0,0,0,29,0.5,0.12716606,2
2020-07-16-171019,171019,1,0,0,30,0.6666666666666666,0.16374257,3
2020-07-17-171019,171019,0,0,0,30,0.5,0.12987949,4
2020-07-18-171019,171019,0,0,0,30,0.0,0.0060446095,5
2020-07-19-171019,171019,0,0,0,30,0.0,0.02430383,6
2020-07-20-171019,171019,0,0,0,30,0.3333333333333333,0.20522372,0
2020-07-21-171019,171019,0,0,0,30,0.16666666666666666,0.11183515,1
2020-07-22-171019,171019,0,0,0,30,0.16666666666666666,0.058963794,2
2020-07-23-171019,171019,0,0,0,30,0.0,0.13569315,3
2020-07-24-171019,171019,0,0,0,30,0.6666666666666666,0.36510935,4
2020-07-25-171019,171019,0,0,0,30,0.0,0.0011633554,5
2020-07-26-171019,171019,0,0,0,30,0.0,0.008344664,6
2020-07-27-171019,171019,0,0,0,30,0.5,0.28312764,0
2020-07-28-171019,171019,0,0,0,30,0.5,0.10844752,1
2020-07-29-171019,171019,0,0,0,30,0.8333333333333334,0.20352538,2
2020-07-30-171019,171019,0,0,0,30,1.1666666666666667,0.35427356,3
2020-07-31-171019,171019,0,0,0,30,0.6666666666666666,0.11744956,4
2020-08-01-171019,171019,0,0,0,30,0.0,0.011329717,5
2020-08-02-171019,171019,0,0,0,30,0.5,0.14986674,6
2020-08-03-171019,171019,0,0,0,30,0.6666666666666666,0.0761887,0
2020-08-04-171019,171019,0,0,0,30,0.16666666666666666,0.033413224,1
2020-08-05-171019,171019,0,0,0,30,0.5,0.63562626,2
2020-08-06-171019,171019,0,0,0,30,0.3333333333333333,0.034825567,3
2020-08-07-171019,171019,0,0,0,30,1.1666666666666667,0.28112143,4
2020-08-08-171019,171019,0,0,0,30,0.0,0.009703799,5
2020-08-09-171019,171019,0,0,0,30,0.0,0.008073215,6
2020-08-10-171019,171019,0,0,0,30,0.3333333333333333,0.038456794,0
2020-08-11-171019,171019,0,0,0,30,0.16666666666666666,0.11270176,1
2020-08-12-171019,171019,0,0,0,30,0.6666666666666666,0.09163984,2
2020-08-13-171019,171019,0,0,2,30,1.1666666666666667,0.46472365,3
2020-08-14-171019,171019,0,0,1,30,0.8333333333333334,0.31770495,4
2020-08-15-171019,171019,0,0,0,30,0.5,0.16594009,5
2020-08-16-171019,171019,0,0,0,30,0.3333333333333333,0.018266045,6
2020-08-17-171019,171019,0,0,1,30,0.5,0.40857694,0
2020-08-18-171019,171019,0,0,1,30,0.5,0.35955024,1
2020-08-19-171019,171019,0,0,0,30,2.0,1.5966535,2
2020-08-20-171019,171019,0,0,0,30,2.833333333333333,0.7608723,3
2020-08-21-171019,171019,0,0,0,30,1.3333333333333333,0.8729496,4
2020-08-22-171019,171019,0,0,0,30,0.5,0.20777632,5
2020-08-23-171019,171019,0,0,0,30,1.0,0.44076997,6
2020-08-24-171019,171019,0,0,0,30,3.1666666666666665,0.84904057,0
2020-08-25-171019,171019,0,0,1,30,3.8333333333333335,1.1072613,1
2020-08-26-171019,171019,0,0,1,30,4.166666666666667,1.4755723,2
2020-08-27-171019,171019,2,0,1,32,2.5,0.8207124,3
2020-08-28-171019,171019,1,0,0,33,2.333333333333333,0.5693626,4
2020-08-29-171019,171019,0,0,0,33,2.333333333333333,1.0101764,5
2020-08-30-171019,171019,0,0,0,33,2.333333333333333,0.71299994,6
2020-08-31-171019,171019,1,0,3,34,2.5,0.66228783,0
2020-09-01-171019,171019,1,0,1,35,1.5,0.4530064,1
2020-09-02-171019,171019,0,0,0,35,2.333333333333333,0.5654031,2
2020-09-03-171019,171019,0,0,0,35,2.0,1.1868963,3
2020-09-04-171019,171019,0,0,0,35,1.5,0.44515294,4
2020-09-05-171019,171019,0,0,0,35,1.5,0.9869807,5
2020-09-06-171019,171019,0,0,0,35,0.6666666666666666,0.3355442,6
2020-09-07-171019,171019,0,0,0,35,3.5,1.7237194,0
2020-09-08-171019,171019,1,0,1,36,2.0,0.4327742,1
2020-09-09-171019,171019,1,0,0,37,1.3333333333333333,0.63066155,2
2020-09-10-171019,171019,1,0,0,38,2.1666666666666665,1.1007361,3
2020-09-11-171019,171019,0,0,0,38,2.0,0.9627893,4
2020-09-12-171019,171019,0,0,5,38,2.1666666666666665,1.2617838,5
2020-09-13-171019,171019,0,0,0,38,1.3333333333333333,0.6584764,6
2020-09-14-171019,171019,3,0,2,41,4.166666666666667,2.299158,0
2020-09-15-171019,171019,1,0,1,42,2.6666666666666665,1.5875539,1
2020-09-16-171019,171019,0,0,1,42,3.5,2.0164256,2
2020-09-17-171019,171019,0,0,0,42,3.0,1.9225296,3
2020-09-18-171019,171019,0,0,0,42,4.5,1.9218178,4
2020-09-19-171019,171019,0,0,2,42,3.0,1.2329707,5
2020-09-20-171019,171019,0,0,1,42,2.0,0.570694,6
2020-09-21-171019,171019,0,0,0,42,1.3333333333333333,0.82612973,0
2020-09-22-171019,171019,1,0,1,43,1.1666666666666667,0.5978511,1
2020-09-23-171019,171019,0,0,0,43,4.833333333333333,1.7276727,2
2020-09-24-171019,171019,0,0,0,43,7.5,3.3133476,3
2020-09-25-171019,171019,0,0,0,43,8.0,1.7001567,4
2020-09-26-171019,171019,5,0,0,48,4.166666666666667,1.8940446,5
2020-09-27-171019,171019,0,0,0,48,1.1666666666666667,0.2803813,6
2020-09-28-171019,171019,2,0,0,50,2.833333333333333,0.67730564,0
2020-09-29-171019,171019,1,0,0,51,3.0,0.8190135,1
2020-09-30-171019,171019,1,0,0,52,4.666666666666667,1.2433776,2
2020-10-01-171019,171019,0,0,1,52,3.8333333333333335,1.2166967,3
2020-10-02-171019,171019,0,0,1,52,4.166666666666667,1.264023,4
2020-10-03-171019,171019,2,0,0,54,3.1666666666666665,1.1547928,5
2020-10-04-171019,171019,1,0,0,55,2.333333333333333,0.30632827,6
2020-10-05-171019,171019,0,0,1,55,2.1666666666666665,0.55514795,0
2020-10-06-171019,171019,1,0,2,56,7.333333333333332,2.081499,1
2020-10-07-171019,171019,0,0,0,56,3.1666666666666665,1.6621691,2
2020-10-08-171019,171019,0,0,1,56,5.666666666666668,1.5484426,3
2020-10-09-171019,171019,0,0,0,56,5.166666666666667,1.954481,4
2020-10-10-171019,171019,0,0,2,56,1.6666666666666667,0.46646127,5
2020-10-11-171019,171019,0,0,0,56,1.6666666666666667,0.56534624,6
2020-10-12-171019,171019,0,0,10,56,0.3333333333333333,0.1367822,0
2020-10-13-171019,171019,0,0,0,56,2.5,0.715572,1
2020-10-14-171019,171019,0,0,0,56,3.6666666666666665,0.99889356,2
2020-10-15-171019,171019,1,0,1,57,4.0,1.1577959,3
2020-10-16-171019,171019,1,0,1,58,6.333333333333332,1.213492,4
2020-10-17-171019,171019,0,0,7,58,3.8333333333333335,0.9771848,5
2020-10-18-171019,171019,0,0,0,58,2.0,0.5231212,6
2020-10-19-171019,171019,1,0,3,59,2.833333333333333,0.53940564,0
2020-10-20-171019,171019,2,0,2,61,6.0,1.5051063,1
2020-10-21-171019,171019,0,0,0,61,3.0,0.7849544,2
2020-10-22-171019,171019,1,0,0,62,5.833333333333332,1.2441759,3
2020-10-23-171019,171019,0,0,1,62,4.333333333333333,1.2993519,4
2020-10-24-171019,171019,2,0,5,64,2.6666666666666665,0.68915385,5
2020-10-25-171019,171019,0,0,0,64,0.6666666666666666,0.16792157,6
2020-10-26-171019,171019,10,1,0,74,7.333333333333332,3.1145658,0
2020-10-27-171019,171019,0,2,0,74,5.833333333333332,1.4604931,1
2020-10-28-171019,171019,0,0,0,74,5.5,1.5086876,2
2020-10-29-171019,171019,1,0,0,75,6.166666666666668,3.974865,3
2020-10-30-171019,171019,1,0,0,76,7.5,2.180616,4
2020-10-31-171019,171019,7,0,0,83,4.166666666666667,1.9582891,5
2020-11-01-171019,171019,0,0,0,83,2.6666666666666665,1.4917113,6
2020-11-02-171019,171019,3,0,0,86,4.166666666666667,1.4459808,0
2020-11-03-171019,171019,2,0,0,88,5.5,1.4605484,1
2020-11-04-171019,171019,0,0,0,88,4.5,1.560656,2
2020-11-05-171019,171019,0,0,0,88,6.166666666666668,2.5305643,3
2020-11-06-171019,171019,1,0,0,89,3.6666666666666665,1.6540593,4
2020-11-07-171019,171019,5,0,0,94,3.6666666666666665,1.2459769,5
2020-11-08-171019,171019,0,1,0,94,1.0,0.14869367,6
2020-11-09-171019,171019,0,0,0,94,1.6666666666666667,0.83633435,0
2020-11-10-171019,171019,0,0,0,94,4.166666666666667,1.2448884,1
2020-11-11-171019,171019,0,0,0,94,3.6666666666666665,1.2119558,2
2020-11-12-171019,171019,0,0,0,94,3.6666666666666665,1.7997683,3
2020-11-13-171019,171019,0,0,0,94,3.8333333333333335,0.95061344,4
2020-03-01-171020,171020,0,0,0,0,0.16666666666666666,0.017844262,6
2020-03-02-171020,171020,2,1,0,2,0.0,0.26741403,0
2020-03-03-171020,171020,0,0,1,2,0.0,0.0018283644,1
2020-03-04-171020,171020,0,1,3,2,0.0,0.0024563894,2
2020-03-05-171020,171020,0,1,3,2,0.5,0.028672084,3
2020-03-06-171020,171020,0,0,5,2,0.0,0.004035271,4
2020-03-07-171020,171020,0,0,2,2,0.0,0.0013181001,5
2020-03-08-171020,171020,0,0,1,2,0.0,0.006043002,6
2020-03-09-171020,171020,0,0,1,2,0.0,0.0068068043,0
2020-03-10-171020,171020,0,0,1,2,0.16666666666666666,0.031723786,1
2020-03-11-171020,171020,0,0,2,2,0.0,0.01088058,2
2020-03-12-171020,171020,0,0,1,2,0.0,0.014380879,3
2020-03-13-171020,171020,0,0,1,2,0.5,0.065587796,4
2020-03-14-171020,171020,0,0,1,2,0.0,0.00812679,5
2020-03-15-171020,171020,0,0,1,2,0.8333333333333334,0.030061014,6
2020-03-16-171020,171020,0,0,1,2,1.3333333333333333,0.31601557,0
2020-03-17-171020,171020,1,2,1,3,3.6666666666666665,0.2874139,1
2020-03-18-171020,171020,3,0,2,6,2.5,0.5368724,2
2020-03-19-171020,171020,3,0,1,9,7.0,1.0405165,3
2020-03-20-171020,171020,5,0,1,14,4.333333333333333,0.84392184,4
2020-03-21-171020,171020,2,0,5,16,2.1666666666666665,0.35706535,5
2020-03-22-171020,171020,1,0,0,17,6.0,0.2765222,6
2020-03-23-171020,171020,1,0,32,18,10.666666666666666,1.0139061,0
2020-03-24-171020,171020,1,0,3,19,8.0,0.5526686,1
2020-03-25-171020,171020,2,0,1,21,8.333333333333334,0.7890727,2
2020-03-26-171020,171020,1,0,1,22,9.166666666666666,0.6882282,3
2020-03-27-171020,171020,1,0,3,23,6.833333333333332,0.6733071,4
2020-03-28-171020,171020,1,0,0,24,5.166666666666667,0.4364199,5
2020-03-29-171020,171020,1,0,0,25,2.833333333333333,0.21203211,6
2020-03-30-171020,171020,1,0,2,26,6.0,0.6037022,0
2020-03-31-171020,171020,1,0,1,27,5.666666666666668,0.52683055,1
2020-04-01-171020,171020,2,0,1,29,4.333333333333333,0.542041,2
2020-04-02-171020,171020,1,0,0,30,5.833333333333332,0.6798292,3
2020-04-03-171020,171020,1,0,2,31,4.333333333333333,0.5463056,4
2020-04-04-171020,171020,5,0,0,36,3.5,0.6802396,5
2020-04-05-171020,171020,0,1,0,36,1.6666666666666667,0.059159003,6
2020-04-06-171020,171020,32,1,0,68,4.5,3.4834654,0
2020-04-07-171020,171020,3,1,0,71,3.0,0.74615353,1
2020-04-08-171020,171020,1,0,1,72,4.833333333333333,0.4718719,2
2020-04-09-171020,171020,1,0,0,73,2.5,0.20419982,3
2020-04-10-171020,171020,3,0,0,76,2.833333333333333,0.4281205,4
2020-04-11-171020,171020,0,0,0,76,4.833333333333333,0.18765377,5
2020-04-12-171020,171020,0,0,0,76,3.6666666666666665,0.20332426,6
2020-04-13-171020,171020,2,0,6,78,6.666666666666668,0.9027975,0
2020-04-14-171020,171020,1,0,0,79,4.0,0.5208505,1
2020-04-15-171020,171020,1,0,0,80,3.333333333333333,0.576442,2
2020-04-16-171020,171020,0,1,2,80,3.333333333333333,0.19112886,3
2020-04-17-171020,171020,2,0,0,82,4.166666666666667,0.49626037,4
2020-04-18-171020,171020,0,0,1,82,2.0,0.0836152,5
2020-04-19-171020,171020,0,0,0,82,0.6666666666666666,0.035081897,6
2020-04-20-171020,171020,0,2,3,82,9.0,0.33466354,0
2020-04-21-171020,171020,0,0,0,82,2.6666666666666665,0.14805496,1
2020-04-22-171020,171020,1,0,3,83,3.0,0.43583024,2
2020-04-23-171020,171020,0,0,0,83,1.3333333333333333,0.111806504,3
2020-04-24-171020,171020,0,0,0,83,3.0,0.39922354,4
2020-04-25-171020,171020,0,0,0,83,1.3333333333333333,0.13554068,5
2020-04-26-171020,171020,0,0,0,83,0.5,0.024070136,6
2020-04-27-171020,171020,6,0,0,89,3.1666666666666665,1.0720797,0
2020-04-28-171020,171020,0,0,0,89,2.0,0.1694237,1
2020-04-29-171020,171020,0,0,0,89,2.6666666666666665,0.37312979,2
2020-04-30-171020,171020,2,0,2,91,2.0,0.27177814,3
2020-05-01-171020,171020,0,0,0,91,0.5,0.026169475,4
2020-05-02-171020,171020,1,0,0,92,1.8333333333333333,0.12393636,5
2020-05-03-171020,171020,0,0,1,92,0.5,0.014666187,6
2020-05-04-171020,171020,3,0,3,95,3.5,0.37705266,0
2020-05-05-171020,171020,0,0,2,95,1.8333333333333333,0.21759512,1
2020-05-06-171020,171020,3,0,0,98,3.1666666666666665,0.65107906,2
2020-05-07-171020,171020,0,0,0,98,2.833333333333333,0.31338206,3
2020-05-08-171020,171020,0,0,0,98,2.6666666666666665,0.34338152,4
2020-05-09-171020,171020,0,0,0,98,0.3333333333333333,0.022338731,5
2020-05-10-171020,171020,0,0,0,98,0.3333333333333333,0.0285524,6
2020-05-11-171020,171020,0,0,1,98,3.333333333333333,0.28294227,0
2020-05-12-171020,171020,0,0,0,98,2.0,0.117979914,1
2020-05-13-171020,171020,0,0,0,98,1.5,0.18644188,2
2020-05-14-171020,171020,2,0,0,100,3.0,0.5436383,3
2020-05-15-171020,171020,0,0,0,100,0.8333333333333334,0.14582528,4
2020-05-16-171020,171020,0,0,0,100,1.1666666666666667,0.04651316,5
2020-05-17-171020,171020,1,1,0,101,0.0,0.10163752,6
2020-05-18-171020,171020,3,0,0,104,3.1666666666666665,0.7982456,0
2020-05-19-171020,171020,2,0,0,106,1.1666666666666667,0.5029367,1
2020-05-20-171020,171020,0,0,1,106,1.5,0.09983907,2
2020-05-21-171020,171020,0,0,0,106,2.0,0.20395905,3
2020-05-22-171020,171020,0,0,0,106,1.6666666666666667,0.28217265,4
2020-05-23-171020,171020,0,0,0,106,1.5,0.06973439,5
2020-05-24-171020,171020,0,0,0,106,0.5,0.023398116,6
2020-05-25-171020,171020,1,0,0,107,1.8333333333333333,0.47186235,0
2020-05-26-171020,171020,0,0,0,107,1.8333333333333333,0.22286297,1
2020-05-27-171020,171020,0,0,0,107,3.8333333333333335,0.25488424,2
2020-05-28-171020,171020,0,4,0,107,2.0,0.62900764,3
2020-05-29-171020,171020,0,0,0,107,1.1666666666666667,0.3623805,4
2020-05-30-171020,171020,0,0,0,107,0.0,0.0028559119,5
2020-05-31-171020,171020,0,0,0,107,0.3333333333333333,0.012357885,6
2020-06-01-171020,171020,0,0,0,107,2.1666666666666665,0.19563037,0
2020-06-02-171020,171020,0,0,0,107,1.5,0.13356215,1
2020-06-03-171020,171020,1,0,0,108,1.1666666666666667,0.28980398,2
2020-06-04-171020,171020,0,0,0,108,1.0,0.20140742,3
2020-06-05-171020,171020,0,0,0,108,1.0,0.08481156,4
2020-06-06-171020,171020,0,3,0,108,0.16666666666666666,0.02251137,5
2020-06-07-171020,171020,0,3,0,108,0.16666666666666666,0.0055267722,6
2020-06-08-171020,171020,0,0,0,108,1.5,0.2947695,0
2020-06-09-171020,171020,0,0,1,108,1.1666666666666667,0.062946655,1
2020-06-10-171020,171020,0,0,0,108,1.0,0.21587782,2
2020-06-11-171020,171020,0,0,0,108,2.0,0.25624633,3
2020-06-12-171020,171020,0,0,0,108,0.3333333333333333,0.061511397,4
2020-06-13-171020,171020,0,2,0,108,0.16666666666666666,0.019986536,5
2020-06-14-171020,171020,0,0,0,108,0.0,0.000729188,6
2020-06-15-171020,171020,0,0,0,108,1.6666666666666667,0.10317329,0
2020-06-16-171020,171020,0,0,0,108,1.1666666666666667,0.08914427,1
2020-06-17-171020,171020,0,0,0,108,0.5,0.043314066,2
2020-06-18-171020,171020,0,0,0,108,0.5,0.05907426,3
2020-06-19-171020,171020,0,0,0,108,2.6666666666666665,0.24288808,4
2020-06-20-171020,171020,0,0,0,108,0.3333333333333333,0.032030065,5
2020-06-21-171020,171020,0,0,0,108,0.3333333333333333,0.049807906,6
2020-06-22-171020,171020,0,0,0,108,0.6666666666666666,0.053067643,0
2020-06-23-171020,171020,1,0,0,109,0.3333333333333333,0.22040057,1
2020-06-24-171020,171020,0,0,0,109,1.3333333333333333,0.15383336,2
2020-06-25-171020,171020,0,0,0,109,0.8333333333333334,0.15433735,3
2020-06-26-171020,171020,0,0,0,109,1.1666666666666667,0.23192763,4
2020-06-27-171020,171020,0,0,0,109,0.3333333333333333,0.0625148,5
2020-06-28-171020,171020,0,0,0,109,0.3333333333333333,0.07429722,6
2020-06-29-171020,171020,0,1,0,109,0.5,0.036516685,0
2020-06-30-171020,171020,0,0,1,109,0.6666666666666666,0.053446185,1
2020-07-01-171020,171020,0,0,0,109,1.0,0.08774292,2
2020-07-02-171020,171020,0,0,0,109,0.5,0.16231571,3
2020-07-03-171020,171020,0,0,0,109,0.6666666666666666,0.03084277,4
2020-07-04-171020,171020,0,0,1,109,0.5,0.031684823,5
2020-07-05-171020,171020,0,0,0,109,0.0,0.016757175,6
2020-07-06-171020,171020,0,0,0,109,0.8333333333333334,0.06843178,0
2020-07-07-171020,171020,0,0,1,109,0.3333333333333333,0.033578474,1
2020-07-08-171020,171020,0,0,0,109,0.5,0.035513,2
2020-07-09-171020,171020,0,0,2,109,0.8333333333333334,0.09922383,3
2020-07-10-171020,171020,0,0,1,109,0.3333333333333333,0.019026086,4
2020-07-11-171020,171020,0,0,0,109,0.0,0.026239596,5
2020-07-12-171020,171020,0,0,0,109,0.0,0.0057428624,6
2020-07-13-171020,171020,0,0,0,109,0.16666666666666666,0.028958483,0
2020-07-14-171020,171020,1,0,0,110,0.3333333333333333,0.32206407,1
2020-07-15-171020,171020,0,0,0,110,0.6666666666666666,0.04760375,2
2020-07-16-171020,171020,0,0,0,110,1.8333333333333333,0.34840345,3
2020-07-17-171020,171020,0,0,0,110,0.8333333333333334,0.23078449,4
2020-07-18-171020,171020,1,0,0,111,0.0,0.14211482,5
2020-07-19-171020,171020,0,0,0,111,0.5,0.05212036,6
2020-07-20-171020,171020,0,0,0,111,0.8333333333333334,0.15770799,0
2020-07-21-171020,171020,1,0,0,112,1.0,0.055754587,1
2020-07-22-171020,171020,0,0,0,112,0.16666666666666666,0.01536667,2
2020-07-23-171020,171020,2,0,0,114,0.3333333333333333,0.4378756,3
2020-07-24-171020,171020,1,0,0,115,1.6666666666666667,0.5145845,4
2020-07-25-171020,171020,0,0,0,115,0.16666666666666666,0.013770832,5
2020-07-26-171020,171020,0,0,0,115,0.5,0.02596924,6
2020-07-27-171020,171020,0,0,2,115,2.0,0.23719943,0
2020-07-28-171020,171020,0,0,0,115,3.1666666666666665,0.14909628,1
2020-07-29-171020,171020,0,0,0,115,1.8333333333333333,0.10645431,2
2020-07-30-171020,171020,0,0,0,115,2.833333333333333,0.33209795,3
2020-07-31-171020,171020,0,1,0,115,2.333333333333333,0.09891441,4
2020-08-01-171020,171020,0,0,1,115,0.6666666666666666,0.044539172,5
2020-08-02-171020,171020,0,0,0,115,0.16666666666666666,0.034331925,6
2020-08-03-171020,171020,0,0,0,115,2.333333333333333,0.1552061,0
2020-08-04-171020,171020,0,0,3,115,2.0,0.07271332,1
2020-08-05-171020,171020,0,0,1,115,2.5,0.4981459,2
2020-08-06-171020,171020,0,0,3,115,1.5,0.08623971,3
2020-08-07-171020,171020,0,0,1,115,2.0,0.21061423,4
2020-08-08-171020,171020,0,0,1,115,0.5,0.011545547,5
2020-08-09-171020,171020,0,0,0,115,1.0,0.035229873,6
2020-08-10-171020,171020,2,0,0,117,0.5,0.04897127,0
2020-08-11-171020,171020,0,0,1,117,2.333333333333333,0.3217904,1
2020-08-12-171020,171020,0,0,1,117,1.3333333333333333,0.13985986,2
2020-08-13-171020,171020,0,0,0,117,1.3333333333333333,0.36541224,3
2020-08-14-171020,171020,0,0,1,117,1.8333333333333333,0.27896273,4
2020-08-15-171020,171020,1,0,0,118,2.0,0.44416958,5
2020-08-16-171020,171020,0,0,0,118,0.3333333333333333,0.026790963,6
2020-08-17-171020,171020,0,0,0,118,1.8333333333333333,0.5156483,0
2020-08-18-171020,171020,3,0,2,121,3.1666666666666665,1.0922917,1
2020-08-19-171020,171020,1,0,2,122,4.833333333333333,1.4940288,2
2020-08-20-171020,171020,3,0,0,125,3.1666666666666665,0.67233,3
2020-08-21-171020,171020,1,0,0,126,5.666666666666668,1.7347817,4
2020-08-22-171020,171020,1,0,0,127,1.6666666666666667,0.3329349,5
2020-08-23-171020,171020,0,0,0,127,1.6666666666666667,0.35742188,6
2020-08-24-171020,171020,0,0,0,127,2.833333333333333,0.5111823,0
2020-08-25-171020,171020,1,0,1,128,3.8333333333333335,0.8614097,1
2020-08-26-171020,171020,1,0,1,129,4.666666666666667,0.6956856,2
2020-08-27-171020,171020,0,0,0,129,2.1666666666666665,0.3544481,3
2020-08-28-171020,171020,1,0,2,130,4.333333333333333,0.63666046,4
2020-08-29-171020,171020,0,0,0,130,1.3333333333333333,0.45389423,5
2020-08-30-171020,171020,0,0,0,130,1.1666666666666667,0.17914449,6
2020-08-31-171020,171020,0,0,4,130,3.6666666666666665,0.61295325,0
2020-09-01-171020,171020,2,0,2,132,3.1666666666666665,0.89571667,1
2020-09-02-171020,171020,2,0,0,134,6.833333333333332,0.5272345,2
2020-09-03-171020,171020,0,0,0,134,4.333333333333333,0.82829994,3
2020-09-04-171020,171020,0,0,1,134,4.333333333333333,0.4407326,4
2020-09-05-171020,171020,0,0,10,134,4.833333333333333,0.79034084,5
2020-09-06-171020,171020,0,0,1,134,5.0,0.3403258,6
2020-09-07-171020,171020,0,0,6,134,7.833333333333332,1.6589203,0
2020-09-08-171020,171020,1,0,4,135,6.166666666666668,0.60325867,1
2020-09-09-171020,171020,1,0,11,136,4.333333333333333,0.77618,2
2020-09-10-171020,171020,0,1,5,136,5.166666666666667,0.90942186,3
2020-09-11-171020,171020,2,0,6,138,9.166666666666666,1.2196152,4
2020-09-12-171020,171020,0,0,4,138,3.8333333333333335,0.93602854,5
2020-09-13-171020,171020,0,0,1,138,2.5,0.594109,6
2020-09-14-171020,171020,4,0,2,142,8.166666666666666,1.9186724,0
2020-09-15-171020,171020,2,0,0,144,10.5,1.9475114,1
2020-09-16-171020,171020,0,0,10,144,9.5,1.7328899,2
2020-09-17-171020,171020,0,0,7,144,8.166666666666666,1.7235453,3
2020-09-18-171020,171020,1,0,5,145,5.666666666666668,1.7520459,4
2020-09-19-171020,171020,10,0,7,155,5.166666666666667,2.5771115,5
2020-09-20-171020,171020,1,0,0,156,3.333333333333333,0.43559727,6
2020-09-21-171020,171020,6,0,1,162,7.166666666666668,1.923673,0
2020-09-22-171020,171020,4,0,9,166,8.0,0.9907195,1
2020-09-23-171020,171020,11,1,2,177,10.333333333333334,3.4554698,2
2020-09-24-171020,171020,5,0,3,182,9.833333333333334,3.861396,3
2020-09-25-171020,171020,6,0,0,188,10.666666666666666,1.2457536,4
2020-09-26-171020,171020,4,0,5,192,9.666666666666666,2.1440465,5
2020-09-27-171020,171020,1,0,0,193,0.8333333333333334,0.2646812,6
2020-09-28-171020,171020,2,0,0,195,4.333333333333333,0.94899714,0
2020-09-29-171020,171020,0,0,3,195,5.333333333333333,0.785029,1
2020-09-30-171020,171020,10,0,1,205,3.5,2.3783185,2
2020-10-01-171020,171020,7,1,2,212,7.5,2.4533243,3
2020-10-02-171020,171020,5,0,8,217,7.5,1.3325514,4
2020-10-03-171020,171020,7,0,9,224,3.1666666666666665,1.684461,5
2020-10-04-171020,171020,0,0,0,224,3.6666666666666665,0.28263545,6
2020-10-05-171020,171020,1,0,1,225,4.0,0.887708,0
2020-10-06-171020,171020,9,0,6,234,9.666666666666666,3.5853994,1
2020-10-07-171020,171020,2,1,2,236,6.333333333333332,1.578446,2
2020-10-08-171020,171020,3,1,0,239,4.333333333333333,1.2482764,3
2020-10-09-171020,171020,0,0,2,239,5.0,1.729458,4
2020-10-10-171020,171020,5,0,16,244,2.5,0.9673299,5
2020-10-11-171020,171020,0,0,0,244,2.1666666666666665,0.23414178,6
2020-10-12-171020,171020,0,0,1,244,2.333333333333333,0.20785366,0
2020-10-13-171020,171020,3,0,6,247,4.833333333333333,1.2393686,1
2020-10-14-171020,171020,1,0,4,248,4.5,0.94257236,2
2020-10-15-171020,171020,2,0,5,250,5.166666666666667,1.4038799,3
2020-10-16-171020,171020,8,0,1,258,6.166666666666668,0.44477737,4
2020-10-17-171020,171020,9,0,11,267,4.333333333333333,2.295053,5
2020-10-18-171020,171020,0,0,2,267,3.333333333333333,0.4361438,6
2020-10-19-171020,171020,1,1,1,268,6.333333333333332,1.0080527,0
2020-10-20-171020,171020,6,0,4,274,10.0,2.374223,1
2020-10-21-171020,171020,2,1,2,276,4.0,0.8949271,2
2020-10-22-171020,171020,0,0,9,276,6.5,1.0974526,3
2020-10-23-171020,171020,2,0,10,278,4.666666666666667,1.5324788,4
2020-10-24-171020,171020,16,0,6,294,6.333333333333332,2.6418006,5
2020-10-25-171020,171020,0,1,2,294,4.5,0.2824921,6
2020-10-26-171020,171020,1,0,3,295,10.666666666666666,3.4208963,0
2020-10-27-171020,171020,6,0,0,301,9.666666666666666,2.5243592,1
2020-10-28-171020,171020,4,0,0,305,12.166666666666664,2.43445,2
2020-10-29-171020,171020,5,0,1,310,10.333333333333334,4.5424705,3
2020-10-30-171020,171020,1,0,7,311,10.166666666666666,2.3766992,4
2020-10-31-171020,171020,11,0,0,322,9.666666666666666,3.6579142,5
2020-11-01-171020,171020,2,0,0,324,5.5,1.984424,6
2020-11-02-171020,171020,1,0,0,325,6.666666666666668,1.568311,0
2020-11-03-171020,171020,4,0,0,329,7.0,2.0445442,1
2020-11-04-171020,171020,2,1,0,331,11.333333333333336,2.206314,2
2020-11-05-171020,171020,9,1,0,340,10.666666666666666,4.122501,3
2020-11-06-171020,171020,10,0,0,350,10.833333333333336,2.803826,4
2020-11-07-171020,171020,6,0,0,356,5.166666666666667,2.0797698,5
2020-11-08-171020,171020,2,0,0,358,4.166666666666667,0.43936777,6
2020-11-09-171020,171020,3,0,0,361,9.166666666666666,1.5879704,0
2020-11-10-171020,171020,0,0,0,361,9.666666666666666,1.4552879,1
2020-11-11-171020,171020,0,1,0,361,6.166666666666668,1.1571207,2
2020-11-12-171020,171020,1,0,0,362,6.5,2.029711,3
2020-11-13-171020,171020,7,2,0,369,8.833333333333334,1.8060298,4
2020-03-01-171021,171021,0,0,0,0,0.125,0.04326595,6
2020-03-02-171021,171021,0,0,0,0,0.25,0.20120023,0
2020-03-03-171021,171021,0,0,0,0,0.0,0.004327928,1
2020-03-04-171021,171021,0,1,0,0,0.0,0.02281291,2
2020-03-05-171021,171021,0,0,4,0,0.125,0.048161536,3
2020-03-06-171021,171021,0,0,1,0,0.0,0.026058396,4
2020-03-07-171021,171021,0,0,2,0,0.0,0.0068798484,5
2020-03-08-171021,171021,0,0,1,0,0.0,0.0032365425,6
2020-03-09-171021,171021,0,0,3,0,0.125,0.04565125,0
2020-03-10-171021,171021,0,0,0,0,0.375,0.05728175,1
2020-03-11-171021,171021,0,0,1,0,0.25,0.13262036,2
2020-03-12-171021,171021,0,0,2,0,0.0,0.057248093,3
2020-03-13-171021,171021,0,0,1,0,0.375,0.40413594,4
2020-03-14-171021,171021,0,0,1,0,0.0,0.0688425,5
2020-03-15-171021,171021,0,0,0,0,0.375,0.07909757,6
2020-03-16-171021,171021,0,0,1,0,1.5,0.8898603,0
2020-03-17-171021,171021,0,1,2,0,1.25,0.75911623,1
2020-03-18-171021,171021,0,0,1,0,3.0,1.4456117,2
2020-03-19-171021,171021,4,0,0,4,5.125,8.176482,3
2020-03-20-171021,171021,1,0,3,5,3.375,2.9414394,4
2020-03-21-171021,171021,2,0,2,7,2.0,3.1732671,5
2020-03-22-171021,171021,1,1,0,8,2.125,1.427683,6
2020-03-23-171021,171021,3,0,2,11,7.0,8.7226925,0
2020-03-24-171021,171021,0,0,4,11,4.375,1.4808892,1
2020-03-25-171021,171021,1,0,3,12,5.75,3.6361625,2
2020-03-26-171021,171021,2,0,0,14,5.875,4.5609016,3
2020-03-27-171021,171021,1,0,0,15,5.5,3.4019234,4
2020-03-28-171021,171021,1,0,1,16,3.625,2.0352244,5
2020-03-29-171021,171021,0,0,4,16,2.625,0.47862843,6
2020-03-30-171021,171021,1,0,4,17,5.75,2.8595319,0
2020-03-31-171021,171021,2,0,2,19,3.625,3.8196123,1
2020-04-01-171021,171021,1,0,1,20,3.625,2.749017,2
2020-04-02-171021,171021,0,0,0,20,3.875,1.1830888,3
2020-04-03-171021,171021,3,0,1,23,3.125,5.1558805,4
2020-04-04-171021,171021,2,0,0,25,3.625,2.8224416,5
2020-04-05-171021,171021,0,0,0,25,1.0,0.11407572,6
2020-04-06-171021,171021,2,0,0,27,15.375,5.6743937,0
2020-04-07-171021,171021,4,1,1,31,4.625,7.675895,1
2020-04-08-171021,171021,3,0,1,34,3.0,3.8125525,2
2020-04-09-171021,171021,0,0,1,34,3.25,1.0446324,3
2020-04-10-171021,171021,0,0,3,34,4.25,0.9240149,4
2020-04-11-171021,171021,1,0,0,35,1.625,1.537717,5
2020-04-12-171021,171021,4,0,0,39,0.75,3.202905,6
2020-04-13-171021,171021,4,0,1,43,5.125,7.4766817,0
2020-04-14-171021,171021,2,0,1,45,3.0,4.0164194,1
2020-04-15-171021,171021,1,0,2,46,4.0,3.6151135,2
2020-04-16-171021,171021,0,0,0,46,2.75,0.5204133,3
2020-04-17-171021,171021,1,0,0,47,3.25,2.1403823,4
2020-04-18-171021,171021,0,0,0,47,1.25,0.2382627,5
2020-04-19-171021,171021,0,0,0,47,0.75,0.07424338,6
2020-04-20-171021,171021,0,0,0,47,3.25,0.941018,0
2020-04-21-171021,171021,1,0,1,48,1.375,0.57450765,1
2020-04-22-171021,171021,1,0,0,49,2.375,2.3221102,2
2020-04-23-171021,171021,1,0,1,50,0.625,1.2809433,3
2020-04-24-171021,171021,3,0,2,53,3.625,5.296667,4
2020-04-25-171021,171021,0,0,0,53,0.625,0.22990383,5
2020-04-26-171021,171021,0,0,0,53,0.375,0.040081467,6
2020-04-27-171021,171021,1,0,1,54,3.5,2.4270885,0
2020-04-28-171021,171021,1,0,0,55,1.25,1.9088206,1
2020-04-29-171021,171021,2,0,1,57,2.125,3.968385,2
2020-04-30-171021,171021,0,0,1,57,1.625,0.68678784,3
2020-05-01-171021,171021,0,0,1,57,0.5,0.06139079,4
2020-05-02-171021,171021,0,0,0,57,0.75,0.16049723,5
2020-05-03-171021,171021,0,0,0,57,0.25,0.13288346,6
2020-05-04-171021,171021,0,0,2,57,2.75,1.0345855,0
2020-05-05-171021,171021,1,0,2,58,0.875,2.3087244,1
2020-05-06-171021,171021,0,0,0,58,3.25,1.8345687,2
2020-05-07-171021,171021,1,0,1,59,1.25,2.7124605,3
2020-05-08-171021,171021,2,0,1,61,1.875,4.656894,4
2020-05-09-171021,171021,0,1,0,61,0.375,0.1425133,5
2020-05-10-171021,171021,0,0,0,61,0.25,0.032225117,6
2020-05-11-171021,171021,1,0,2,62,1.0,2.3763196,0
2020-05-12-171021,171021,0,0,2,62,1.375,0.60227555,1
2020-05-13-171021,171021,1,0,0,63,1.0,2.3151278,2
2020-05-14-171021,171021,1,0,5,64,1.5,2.56922,3
2020-05-15-171021,171021,1,1,2,65,0.375,2.088076,4
2020-05-16-171021,171021,0,0,0,65,0.25,0.05575588,5
2020-05-17-171021,171021,0,0,0,65,0.125,0.046360694,6
2020-05-18-171021,171021,2,0,1,67,1.75,4.706772,0
2020-05-19-171021,171021,2,0,0,69,0.5,4.2859287,1
2020-05-20-171021,171021,0,0,1,69,0.5,0.33193403,2
2020-05-21-171021,171021,1,0,1,70,0.5,2.2610414,3
2020-05-22-171021,171021,1,0,0,71,0.25,4.176922,4
2020-05-23-171021,171021,0,0,0,71,0.375,0.07496139,5
2020-05-24-171021,171021,0,0,0,71,0.25,0.099557355,6
2020-05-25-171021,171021,2,0,2,73,1.125,5.0753593,0
2020-05-26-171021,171021,2,0,0,75,1.0,2.3445747,1
2020-05-27-171021,171021,0,1,1,75,2.25,0.60346866,2
2020-05-28-171021,171021,5,6,1,80,0.75,11.60569,3
2020-05-29-171021,171021,2,0,0,82,0.625,7.2291417,4
2020-05-30-171021,171021,0,0,0,82,0.375,0.094970144,5
2020-05-31-171021,171021,0,0,0,82,0.125,0.08922706,6
2020-06-01-171021,171021,1,0,0,83,0.375,2.5350137,0
2020-06-02-171021,171021,0,0,0,83,1.375,0.6751401,1
2020-06-03-171021,171021,1,0,0,84,2.0,2.9006286,2
2020-06-04-171021,171021,1,0,0,85,0.875,2.5932608,3
2020-06-05-171021,171021,0,0,1,85,1.125,0.44719884,4
2020-06-06-171021,171021,0,0,0,85,0.125,0.03547647,5
2020-06-07-171021,171021,0,0,0,85,0.125,0.0851935,6
2020-06-08-171021,171021,2,0,0,87,0.875,4.6920533,0
2020-06-09-171021,171021,0,0,0,87,1.25,0.53428894,1
2020-06-10-171021,171021,1,0,0,88,1.5,2.7338212,2
2020-06-11-171021,171021,1,0,1,89,1.125,2.5868359,3
2020-06-12-171021,171021,0,0,1,89,1.0,0.5775614,4
2020-06-13-171021,171021,0,0,0,89,0.25,0.14400774,5
2020-06-14-171021,171021,0,0,0,89,0.0,0.002225596,6
2020-06-15-171021,171021,0,0,0,89,0.25,0.15619434,0
2020-06-16-171021,171021,0,0,0,89,1.375,0.33666557,1
2020-06-17-171021,171021,0,0,0,89,1.25,0.70392877,2
2020-06-18-171021,171021,0,0,1,89,1.25,0.52652055,3
2020-06-19-171021,171021,1,0,0,90,1.25,3.0344288,4
2020-06-20-171021,171021,0,0,0,90,0.25,0.14367795,5
2020-06-21-171021,171021,0,0,0,90,0.25,0.07464661,6
2020-06-22-171021,171021,0,0,0,90,1.0,0.30180055,0
2020-06-23-171021,171021,0,0,0,90,1.125,0.6859693,1
2020-06-24-171021,171021,0,1,0,90,0.75,0.5092415,2
2020-06-25-171021,171021,1,1,0,91,0.375,2.475156,3
2020-06-26-171021,171021,1,0,0,92,0.375,2.7629745,4
2020-06-27-171021,171021,0,1,0,92,0.125,0.1104404,5
2020-06-28-171021,171021,0,0,0,92,0.25,0.124257386,6
2020-06-29-171021,171021,0,0,0,92,1.25,0.36719602,0
2020-06-30-171021,171021,0,0,1,92,0.25,0.2377793,1
2020-07-01-171021,171021,0,0,1,92,1.125,0.27570444,2
2020-07-02-171021,171021,1,0,2,93,1.375,2.5074687,3
2020-07-03-171021,171021,0,0,0,93,0.5,0.045654535,4
2020-07-04-171021,171021,0,0,0,93,0.125,0.059105117,5
2020-07-05-171021,171021,0,0,0,93,0.25,0.09059468,6
2020-07-06-171021,171021,0,0,1,93,1.25,0.36734098,0
2020-07-07-171021,171021,0,0,0,93,0.875,0.06585944,1
2020-07-08-171021,171021,0,0,0,93,0.0,0.099989705,2
2020-07-09-171021,171021,0,0,0,93,0.375,0.18249398,3
2020-07-10-171021,171021,0,0,2,93,0.75,0.061325457,4
2020-07-11-171021,171021,0,0,0,93,0.25,0.067078374,5
2020-07-12-171021,171021,0,0,0,93,0.0,0.0075238007,6
2020-07-13-171021,171021,0,0,1,93,1.625,0.2264948,0
2020-07-14-171021,171021,1,0,0,94,0.25,2.6192272,1
2020-07-15-171021,171021,1,0,0,95,1.0,0.32541838,2
2020-07-16-171021,171021,2,1,2,97,0.75,2.588212,3
2020-07-17-171021,171021,0,0,1,97,0.75,0.50288445,4
2020-07-18-171021,171021,0,0,0,97,0.25,0.0966066,5
2020-07-19-171021,171021,0,0,0,97,0.625,0.15715775,6
2020-07-20-171021,171021,1,0,0,98,1.0,2.6247525,0
2020-07-21-171021,171021,0,0,0,98,0.875,0.3336898,1
2020-07-22-171021,171021,0,0,2,98,0.75,0.16783778,2
2020-07-23-171021,171021,0,0,0,98,0.5,0.60190946,3
2020-07-24-171021,171021,2,0,2,100,0.5,5.235638,4
2020-07-25-171021,171021,0,0,0,100,0.125,0.01056695,5
2020-07-26-171021,171021,0,0,0,100,0.125,0.04965864,6
2020-07-27-171021,171021,1,0,0,101,0.125,2.7953472,0
2020-07-28-171021,171021,0,0,0,101,0.5,0.3430572,1
2020-07-29-171021,171021,0,0,0,101,0.625,0.541287,2
2020-07-30-171021,171021,2,0,1,103,0.75,2.9901178,3
2020-07-31-171021,171021,1,0,1,104,0.75,0.33773383,4
2020-08-01-171021,171021,0,0,0,104,0.25,0.07339043,5
2020-08-02-171021,171021,0,0,0,104,0.625,0.37677458,6
2020-08-03-171021,171021,0,0,2,104,0.5,0.33724573,0
2020-08-04-171021,171021,0,0,2,104,0.75,0.17028339,1
2020-08-05-171021,171021,2,0,8,106,0.375,6.179786,2
2020-08-06-171021,171021,0,0,1,106,0.375,0.1603187,3
2020-08-07-171021,171021,2,0,2,108,0.25,2.2453883,4
2020-08-08-171021,171021,0,0,0,108,0.375,0.042806383,5
2020-08-09-171021,171021,0,0,2,108,0.375,0.08061861,6
2020-08-10-171021,171021,0,0,2,108,0.5,0.16695094,0
2020-08-11-171021,171021,0,0,1,108,1.75,0.65332925,1
2020-08-12-171021,171021,0,0,3,108,0.875,0.29667684,2
2020-08-13-171021,171021,1,0,1,109,1.0,4.289933,3
2020-08-14-171021,171021,1,0,0,110,1.625,2.5946627,4
2020-08-15-171021,171021,0,0,2,110,1.875,0.6514957,5
2020-08-16-171021,171021,0,0,1,110,0.25,0.10820057,6
2020-08-17-171021,171021,2,0,4,112,0.75,4.317347,0
2020-08-18-171021,171021,2,0,1,114,2.0,3.0543602,1
2020-08-19-171021,171021,8,0,1,122,2.125,17.060547,2
2020-08-20-171021,171021,1,0,3,123,3.125,3.7873557,3
2020-08-21-171021,171021,2,0,0,125,3.25,7.808711,4
2020-08-22-171021,171021,0,0,6,125,1.125,0.7305973,5
2020-08-23-171021,171021,2,0,2,127,0.875,4.1970463,6
2020-08-24-171021,171021,2,0,13,129,3.375,4.167323,0
2020-08-25-171021,171021,1,0,4,130,5.0,5.1691656,1
2020-08-26-171021,171021,3,0,3,133,4.5,7.3786244,2
2020-08-27-171021,171021,1,0,3,134,2.125,3.9498055,3
2020-08-28-171021,171021,0,0,5,134,3.375,2.1859832,4
2020-08-29-171021,171021,2,0,8,136,2.375,5.450914,5
2020-08-30-171021,171021,1,0,5,137,2.0,3.1851602,6
2020-08-31-171021,171021,4,0,13,141,2.375,6.6858077,0
2020-09-01-171021,171021,1,0,10,142,2.25,3.3787777,1
2020-09-02-171021,171021,1,0,11,143,3.25,1.5820041,2
2020-09-03-171021,171021,3,0,10,146,2.125,10.564008,3
2020-09-04-171021,171021,0,0,8,146,2.5,2.8473785,4
2020-09-05-171021,171021,6,0,11,152,1.625,9.732702,5
2020-09-06-171021,171021,2,0,4,154,0.625,3.6529672,6
2020-09-07-171021,171021,13,0,3,167,3.0,19.088245,0
2020-09-08-171021,171021,4,0,4,171,2.125,3.0107913,1
2020-09-09-171021,171021,3,0,18,174,2.625,6.5341034,2
2020-09-10-171021,171021,3,0,18,177,3.25,10.272893,3
2020-09-11-171021,171021,5,0,17,182,5.25,9.542033,4
2020-09-12-171021,171021,8,0,13,190,3.5,13.488117,5
2020-09-13-171021,171021,5,0,1,195,1.125,8.544459,6
2020-09-14-171021,171021,13,0,4,208,5.25,25.365234,0
2020-09-15-171021,171021,10,0,4,218,5.75,19.114681,1
2020-09-16-171021,171021,11,0,6,229,5.125,21.566736,2
2020-09-17-171021,171021,10,0,7,239,5.125,19.973297,3
2020-09-18-171021,171021,8,0,7,247,5.625,20.566618,4
2020-09-19-171021,171021,11,0,5,258,4.25,18.132286,5
2020-09-20-171021,171021,4,0,2,262,1.625,6.214887,6
2020-09-21-171021,171021,3,0,3,265,4.25,9.287907,0
2020-09-22-171021,171021,4,0,14,269,4.625,7.195415,1
2020-09-23-171021,171021,18,1,10,287,7.5,28.179462,2
2020-09-24-171021,171021,18,0,4,305,7.25,42.90406,3
2020-09-25-171021,171021,17,0,12,322,9.375,16.096045,4
2020-09-26-171021,171021,13,0,2,335,4.5,25.335348,5
2020-09-27-171021,171021,1,0,1,336,1.625,1.9698521,6
2020-09-28-171021,171021,4,0,1,340,3.375,8.564105,0
2020-09-29-171021,171021,4,0,4,344,2.75,9.147022,1
2020-09-30-171021,171021,6,0,4,350,5.25,7.8143964,2
2020-10-01-171021,171021,7,0,6,357,9.75,11.203878,3
2020-10-02-171021,171021,7,1,3,364,5.875,9.620208,4
2020-10-03-171021,171021,5,0,3,369,4.625,8.7638,5
2020-10-04-171021,171021,2,1,3,371,3.625,2.1774714,6
2020-10-05-171021,171021,3,0,1,374,3.75,4.77739,0
2020-10-06-171021,171021,14,0,6,388,6.75,19.209578,1
2020-10-07-171021,171021,10,0,1,398,4.875,15.63563,2
2020-10-08-171021,171021,4,1,5,402,4.875,7.1617002,3
2020-10-09-171021,171021,12,1,6,414,3.875,19.204466,4
2020-10-10-171021,171021,2,0,0,416,1.625,3.2557476,5
2020-10-11-171021,171021,1,0,0,417,3.625,2.030426,6
2020-10-12-171021,171021,1,0,22,418,1.625,1.2989572,0
2020-10-13-171021,171021,4,0,6,422,2.5,6.8636928,1
2020-10-14-171021,171021,4,0,9,426,4.625,7.080407,2
2020-10-15-171021,171021,6,0,9,432,4.25,10.0539055,3
2020-10-16-171021,171021,3,0,11,435,6.75,3.8885164,4
2020-10-17-171021,171021,3,0,15,438,5.125,7.2573156,5
2020-10-18-171021,171021,3,1,11,441,1.875,4.143447,6
2020-10-19-171021,171021,1,0,17,442,3.0,4.6537523,0
2020-10-20-171021,171021,6,1,8,448,8.5,12.800807,1
2020-10-21-171021,171021,1,0,10,449,4.25,4.955212,2
2020-10-22-171021,171021,5,0,10,454,4.25,10.541982,3
2020-10-23-171021,171021,6,0,4,460,3.5,12.469988,4
2020-10-24-171021,171021,0,0,8,460,7.625,3.0006518,5
2020-10-25-171021,171021,0,0,0,460,2.25,0.6147598,6
2020-10-26-171021,171021,22,0,6,482,5.125,36.501827,0
2020-10-27-171021,171021,6,0,9,488,8.0,11.295299,1
2020-10-28-171021,171021,9,0,7,497,7.875,15.210948,2
2020-10-29-171021,171021,9,0,10,506,10.75,41.455536,3
2020-10-30-171021,171021,11,1,2,517,7.75,21.541487,4
2020-10-31-171021,171021,15,1,0,532,5.875,23.686966,5
2020-11-01-171021,171021,11,0,0,543,2.625,17.332531,6
2020-11-02-171021,171021,17,0,0,560,2.25,15.569107,0
2020-11-03-171021,171021,8,1,0,568,6.125,13.89695,1
2020-11-04-171021,171021,10,1,0,578,7.125,19.91979,2
2020-11-05-171021,171021,10,1,0,588,8.125,30.477766,3
2020-11-06-171021,171021,4,1,0,592,8.0,14.843819,4
2020-11-07-171021,171021,8,0,0,600,6.0,11.806678,5
2020-11-08-171021,171021,0,0,0,600,2.375,0.6655862,6
2020-11-09-171021,171021,6,0,0,606,4.0,9.654185,0
2020-11-10-171021,171021,9,1,0,615,5.875,13.548095,1
2020-11-11-171021,171021,7,0,0,622,7.125,12.275367,2
2020-11-12-171021,171021,10,0,0,632,7.0,19.964125,3
2020-11-13-171021,171021,2,2,0,634,8.875,9.383688,4
2020-03-01-171022,171022,0,0,0,0,0.0,0.000801658,6
2020-03-02-171022,171022,0,0,3,0,0.0,0.003184935,0
2020-03-03-171022,171022,0,0,1,0,0.0,8.727044e-05,1
2020-03-04-171022,171022,0,0,9,0,0.0,0.00018580681,2
2020-03-05-171022,171022,0,0,9,0,0.0,0.0007464129,3
2020-03-06-171022,171022,0,0,8,0,0.0,0.0004986788,4
2020-03-07-171022,171022,0,0,4,0,0.0,9.982142e-05,5
2020-03-08-171022,171022,0,0,6,0,0.0,5.119852e-05,6
2020-03-09-171022,171022,1,0,12,1,0.0,0.0003379933,0
2020-03-10-171022,171022,2,0,10,3,0.0,0.0010173135,1
2020-03-11-171022,171022,1,0,13,4,0.0,0.0022507862,2
2020-03-12-171022,171022,0,0,17,4,0.0,0.0010635467,3
2020-03-13-171022,171022,0,0,18,4,0.0,0.0057780747,4
2020-03-14-171022,171022,0,0,6,4,0.0,0.0007842105,5
2020-03-15-171022,171022,0,0,5,4,0.0,0.0008652112,6
2020-03-16-171022,171022,3,0,23,7,0.0,0.011157853,0
2020-03-17-171022,171022,1,0,15,8,0.0,0.009546631,1
2020-03-18-171022,171022,9,0,9,17,0.0,0.015271534,2
2020-03-19-171022,171022,9,0,13,26,4.0,0.19143303,3
2020-03-20-171022,171022,8,0,13,34,1.0,0.057092376,4
2020-03-21-171022,171022,4,0,15,38,2.0,0.07277536,5
2020-03-22-171022,171022,6,0,5,44,1.0,0.0315565,6
2020-03-23-171022,171022,12,0,72,56,3.0,0.18998039,0
2020-03-24-171022,171022,10,0,8,66,0.0,0.01635099,1
2020-03-25-171022,171022,13,0,9,79,1.0,0.06252612,2
2020-03-26-171022,171022,17,0,4,96,2.0,0.0972239,3
2020-03-27-171022,171022,18,0,11,114,1.0,0.05995841,4
2020-03-28-171022,171022,6,0,0,120,1.0,0.03907227,5
2020-03-29-171022,171022,5,0,2,125,0.0,0.0028617887,6
2020-03-30-171022,171022,23,0,10,148,1.0,0.0503243,0
2020-03-31-171022,171022,15,0,6,163,2.0,0.08682058,1
2020-04-01-171022,171022,9,0,4,172,1.0,0.053155113,2
2020-04-02-171022,171022,13,0,12,185,0.0,0.015600932,3
2020-04-03-171022,171022,13,0,13,198,3.0,0.12564854,4
2020-04-04-171022,171022,15,0,1,213,2.0,0.068922244,5
2020-04-05-171022,171022,5,0,3,218,0.0,0.00065273646,6
2020-04-06-171022,171022,72,0,7,290,2.0,0.1079645,0
2020-04-07-171022,171022,8,1,3,298,4.0,0.1724449,1
2020-04-08-171022,171022,9,0,4,307,3.0,0.09126729,2
2020-04-09-171022,171022,4,0,1,311,0.0,0.008562779,3
2020-04-10-171022,171022,11,0,13,322,0.0,0.007368195,4
2020-04-11-171022,171022,0,0,0,322,1.0,0.036350165,5
2020-04-12-171022,171022,2,0,1,324,4.0,0.08533739,6
2020-04-13-171022,171022,10,0,11,334,4.0,0.17828152,0
2020-04-14-171022,171022,6,0,5,340,2.0,0.09680151,1
2020-04-15-171022,171022,4,0,4,344,1.0,0.059394073,2
2020-04-16-171022,171022,12,0,3,356,0.0,0.0069448664,3
2020-04-17-171022,171022,13,0,3,369,1.0,0.048030738,4
2020-04-18-171022,171022,1,0,1,370,0.0,0.0025077283,5
2020-04-19-171022,171022,3,0,0,373,0.0,0.0008012076,6
2020-04-20-171022,171022,7,0,7,380,0.0,0.012392035,0
2020-04-21-171022,171022,3,0,2,383,1.0,0.008185133,1
2020-04-22-171022,171022,4,0,7,387,1.0,0.052384187,2
2020-04-23-171022,171022,1,0,1,388,1.0,0.03306671,3
2020-04-24-171022,171022,13,0,1,401,3.0,0.12934344,4
2020-04-25-171022,171022,0,0,0,401,0.0,0.0022740115,5
2020-04-26-171022,171022,1,0,0,402,0.0,0.00031913168,6
2020-04-27-171022,171022,11,0,2,413,1.0,0.052480284,0
2020-04-28-171022,171022,5,2,4,418,1.0,0.045760427,1
2020-04-29-171022,171022,4,0,3,422,2.0,0.0965323,2
2020-04-30-171022,171022,3,0,1,425,0.0,0.008260646,3
2020-05-01-171022,171022,3,0,1,428,0.0,0.00079571904,4
2020-05-02-171022,171022,1,0,0,429,0.0,0.002135341,5
2020-05-03-171022,171022,0,0,0,429,0.0,0.0005959335,6
2020-05-04-171022,171022,7,0,2,436,0.0,0.013503507,0
2020-05-05-171022,171022,2,0,0,438,1.0,0.05385242,1
2020-05-06-171022,171022,7,0,0,445,0.0,0.016712446,2
2020-05-07-171022,171022,1,0,1,446,1.0,0.057242583,3
2020-05-08-171022,171022,1,0,0,447,2.0,0.105186455,4
2020-05-09-171022,171022,0,0,1,447,0.0,0.0014366079,5
2020-05-10-171022,171022,0,0,0,447,0.0,0.00030357824,6
2020-05-11-171022,171022,2,1,2,449,1.0,0.053206045,0
2020-05-12-171022,171022,4,0,6,453,0.0,0.0068196673,1
2020-05-13-171022,171022,3,0,4,456,1.0,0.0543345,2
2020-05-14-171022,171022,1,0,3,457,1.0,0.057378225,3
2020-05-15-171022,171022,1,0,3,458,1.0,0.052165642,4
2020-05-16-171022,171022,0,0,1,458,0.0,0.0005576477,5
2020-05-17-171022,171022,0,2,0,458,0.0,0.0003216039,6
2020-05-18-171022,171022,2,0,1,460,2.0,0.114465676,0
2020-05-19-171022,171022,0,0,2,460,2.0,0.10986091,1
2020-05-20-171022,171022,0,0,8,460,0.0,0.0043908404,2
2020-05-21-171022,171022,1,0,3,461,1.0,0.055734254,3
2020-05-22-171022,171022,0,0,4,461,1.0,0.10844662,4
2020-05-23-171022,171022,1,0,0,462,0.0,0.0006891454,5
2020-05-24-171022,171022,0,0,0,462,0.0,0.0005563135,6
2020-05-25-171022,171022,2,0,5,464,2.0,0.12338005,0
2020-05-26-171022,171022,6,0,6,470,2.0,0.05892282,1
2020-05-27-171022,171022,4,0,8,474,0.0,0.0096508255,2
2020-05-28-171022,171022,3,0,4,477,5.0,0.3033537,3
2020-05-29-171022,171022,3,0,2,480,2.0,0.19096321,4
2020-05-30-171022,171022,1,0,0,481,0.0,0.0007801682,5
2020-05-31-171022,171022,0,0,0,481,0.0,0.0006166971,6
2020-06-01-171022,171022,1,0,0,482,1.0,0.065644145,0
2020-06-02-171022,171022,2,0,5,484,0.0,0.0076243696,1
2020-06-03-171022,171022,8,0,5,492,1.0,0.0668778,2
2020-06-04-171022,171022,3,0,5,495,1.0,0.063401364,3
2020-06-05-171022,171022,4,0,1,499,0.0,0.0054317834,4
2020-06-06-171022,171022,0,0,0,499,0.0,0.00029282543,5
2020-06-07-171022,171022,0,0,0,499,0.0,0.00055030454,6
2020-06-08-171022,171022,5,0,5,504,2.0,0.12456793,0
2020-06-09-171022,171022,6,0,4,510,0.0,0.006512207,1
2020-06-10-171022,171022,8,0,1,518,1.0,0.067616746,2
2020-06-11-171022,171022,4,0,3,522,1.0,0.062163465,3
2020-06-12-171022,171022,2,0,1,524,0.0,0.0071758097,4
2020-06-13-171022,171022,0,1,0,524,0.0,0.0012976571,5
2020-06-14-171022,171022,0,0,0,524,0.0,6.108958e-05,6
2020-06-15-171022,171022,0,1,8,524,0.0,0.0017649139,0
2020-06-16-171022,171022,5,0,0,529,0.0,0.00481563,1
2020-06-17-171022,171022,5,0,6,534,0.0,0.0073609683,2
2020-06-18-171022,171022,5,0,11,539,0.0,0.0059291054,3
2020-06-19-171022,171022,1,0,4,540,1.0,0.07338691,4
2020-06-20-171022,171022,0,0,0,540,0.0,0.0012189702,5
2020-06-21-171022,171022,0,0,1,540,0.0,0.0008885763,6
2020-06-22-171022,171022,5,0,7,545,0.0,0.00450433,0
2020-06-23-171022,171022,4,0,6,549,0.0,0.008701513,1
2020-06-24-171022,171022,1,0,0,550,0.0,0.006724225,2
2020-06-25-171022,171022,3,0,0,553,1.0,0.06524051,3
2020-06-26-171022,171022,1,0,6,554,1.0,0.07011241,4
2020-06-27-171022,171022,0,0,0,554,0.0,0.0013154609,5
2020-06-28-171022,171022,0,0,0,554,0.0,0.0014664818,6
2020-06-29-171022,171022,8,0,11,562,0.0,0.004141614,0
2020-06-30-171022,171022,0,0,1,562,0.0,0.0030368578,1
2020-07-01-171022,171022,6,0,5,568,0.0,0.0034644902,2
2020-07-02-171022,171022,11,0,4,579,1.0,0.066588,3
2020-07-03-171022,171022,4,0,3,583,0.0,0.0007070856,4
2020-07-04-171022,171022,0,0,1,583,0.0,0.000656315,5
2020-07-05-171022,171022,1,0,1,584,0.0,0.001111597,6
2020-07-06-171022,171022,7,0,6,591,0.0,0.004257573,0
2020-07-07-171022,171022,6,0,4,597,0.0,0.0010486216,1
2020-07-08-171022,171022,0,5,5,597,0.0,0.0014568294,2
2020-07-09-171022,171022,0,0,0,597,0.0,0.0031048746,3
2020-07-10-171022,171022,6,0,2,603,0.0,0.00084634835,4
2020-07-11-171022,171022,0,0,1,603,0.0,0.0009562098,5
2020-07-12-171022,171022,0,0,0,603,0.0,0.00014150457,6
2020-07-13-171022,171022,11,0,0,614,0.0,0.0026893886,0
2020-07-14-171022,171022,1,0,1,615,1.0,0.06806521,1
2020-07-15-171022,171022,5,0,0,620,1.0,0.0036025923,2
2020-07-16-171022,171022,4,0,1,624,2.0,0.067569405,3
2020-07-17-171022,171022,3,0,3,627,0.0,0.0069722002,4
2020-07-18-171022,171022,1,0,1,628,0.0,0.0014068977,5
2020-07-19-171022,171022,1,0,1,629,0.0,0.0025495698,6
2020-07-20-171022,171022,6,0,1,635,1.0,0.06784208,0
2020-07-21-171022,171022,4,0,5,639,0.0,0.00413864,1
2020-07-22-171022,171022,5,0,3,644,0.0,0.00208643,2
2020-07-23-171022,171022,0,0,2,644,0.0,0.007720748,3
2020-07-24-171022,171022,2,0,1,646,2.0,0.1377231,4
2020-07-25-171022,171022,1,0,3,647,0.0,0.00014436757,5
2020-07-26-171022,171022,0,0,2,647,0.0,0.0007050295,6
2020-07-27-171022,171022,0,0,1,647,1.0,0.06901192,0
2020-07-28-171022,171022,1,0,6,648,0.0,0.0040194327,1
2020-07-29-171022,171022,0,0,4,648,0.0,0.0061656553,2
2020-07-30-171022,171022,1,0,4,649,2.0,0.07071747,3
2020-07-31-171022,171022,3,0,8,652,1.0,0.0043312674,4
2020-08-01-171022,171022,1,0,5,653,0.0,0.0010234575,5
2020-08-02-171022,171022,1,0,0,654,0.0,0.0038739317,6
2020-08-03-171022,171022,1,0,3,655,0.0,0.0048818486,0
2020-08-04-171022,171022,5,0,3,660,0.0,0.0029068175,1
2020-08-05-171022,171022,3,0,5,663,2.0,0.1534299,2
2020-08-06-171022,171022,2,0,6,665,0.0,0.0019838463,3
2020-08-07-171022,171022,1,0,2,666,2.0,0.05272379,4
2020-08-08-171022,171022,3,0,2,669,0.0,0.00074061856,5
2020-08-09-171022,171022,2,0,0,671,0.0,0.0015733173,6
2020-08-10-171022,171022,1,0,2,672,0.0,0.002373177,0
2020-08-11-171022,171022,6,1,4,678,0.0,0.009595915,1
2020-08-12-171022,171022,4,0,9,682,0.0,0.0036223757,2
2020-08-13-171022,171022,4,0,3,686,1.0,0.105326265,3
2020-08-14-171022,171022,8,0,7,694,1.0,0.061893843,4
2020-08-15-171022,171022,5,0,3,699,0.0,0.0070007895,5
2020-08-16-171022,171022,0,0,2,699,0.0,0.0016436189,6
2020-08-17-171022,171022,3,0,6,702,2.0,0.10712343,0
2020-08-18-171022,171022,3,0,1,705,2.0,0.06304708,1
2020-08-19-171022,171022,5,0,5,710,8.0,0.4246826,2
2020-08-20-171022,171022,6,0,5,716,1.0,0.073817804,3
2020-08-21-171022,171022,2,0,10,718,2.0,0.17784494,4
2020-08-22-171022,171022,2,0,5,720,0.0,0.00855991,5
2020-08-23-171022,171022,0,0,4,720,2.0,0.104133956,6
2020-08-24-171022,171022,2,0,12,722,2.0,0.080340356,0
2020-08-25-171022,171022,4,0,5,726,1.0,0.09552557,1
2020-08-26-171022,171022,9,0,12,735,3.0,0.15045138,2
2020-08-27-171022,171022,3,1,14,738,1.0,0.07652715,3
2020-08-28-171022,171022,7,0,22,745,0.0,0.032898784,4
2020-08-29-171022,171022,3,0,23,748,2.0,0.118377686,5
2020-08-30-171022,171022,2,0,7,750,1.0,0.062903546,6
2020-08-31-171022,171022,6,0,17,756,4.0,0.1652078,0
2020-09-01-171022,171022,1,0,36,757,1.0,0.07271373,1
2020-09-02-171022,171022,5,0,21,762,1.0,0.016966293,2
2020-09-03-171022,171022,5,0,29,767,3.0,0.25267318,3
2020-09-04-171022,171022,10,0,28,777,0.0,0.060095433,4
2020-09-05-171022,171022,5,0,21,782,6.0,0.2419699,5
2020-09-06-171022,171022,4,0,6,786,2.0,0.09245984,6
2020-09-07-171022,171022,12,0,18,798,13.0,0.4819884,0
2020-09-08-171022,171022,5,0,21,803,4.0,0.06515019,1
2020-09-09-171022,171022,12,0,39,815,3.0,0.15901197,2
2020-09-10-171022,171022,14,0,29,829,3.0,0.24673171,3
2020-09-11-171022,171022,22,0,44,851,5.0,0.2290676,4
2020-09-12-171022,171022,23,1,16,874,8.0,0.3406812,5
2020-09-13-171022,171022,7,0,9,881,5.0,0.21793176,6
2020-09-14-171022,171022,17,0,18,898,13.0,0.6360407,0
2020-09-15-171022,171022,36,0,16,934,10.0,0.48274285,1
2020-09-16-171022,171022,21,0,18,955,11.0,0.53412354,2
2020-09-17-171022,171022,29,0,43,984,10.0,0.49225765,3
2020-09-18-171022,171022,28,0,24,1012,8.0,0.5191701,4
2020-09-19-171022,171022,21,1,10,1033,11.0,0.4671949,5
2020-09-20-171022,171022,6,0,16,1039,4.0,0.15380508,6
2020-09-21-171022,171022,18,0,10,1057,3.0,0.22310947,0
2020-09-22-171022,171022,21,0,19,1078,4.0,0.17249894,1
2020-09-23-171022,171022,39,1,23,1117,18.0,0.7141524,2
2020-09-24-171022,171022,29,0,15,1146,18.0,1.0749145,3
2020-09-25-171022,171022,44,0,19,1190,17.0,0.38728794,4
2020-09-26-171022,171022,16,0,6,1206,13.0,0.65251184,5
2020-09-27-171022,171022,9,0,20,1215,1.0,0.045652356,6
2020-09-28-171022,171022,18,1,13,1233,4.0,0.21411024,0
2020-09-29-171022,171022,16,0,7,1249,4.0,0.2199312,1
2020-09-30-171022,171022,18,0,19,1267,6.0,0.12730025,2
2020-10-01-171022,171022,43,0,14,1310,7.0,0.24608432,3
2020-10-02-171022,171022,24,0,9,1334,7.0,0.20588714,4
2020-10-03-171022,171022,10,0,8,1344,5.0,0.19096577,5
2020-10-04-171022,171022,16,1,4,1360,2.0,0.047025558,6
2020-10-05-171022,171022,10,1,6,1370,3.0,0.10303941,0
2020-10-06-171022,171022,19,0,15,1389,14.0,0.4106798,1
2020-10-07-171022,171022,23,0,12,1412,10.0,0.3655972,2
2020-10-08-171022,171022,15,0,7,1427,4.0,0.12766291,3
2020-10-09-171022,171022,19,1,15,1446,12.0,0.46218526,4
2020-10-10-171022,171022,6,0,5,1452,2.0,0.07053119,5
2020-10-11-171022,171022,20,0,3,1472,1.0,0.032632258,6
2020-10-12-171022,171022,13,0,16,1485,1.0,0.029672934,0
2020-10-13-171022,171022,7,0,19,1492,4.0,0.15248537,1
2020-10-14-171022,171022,19,0,21,1511,4.0,0.14969221,2
2020-10-15-171022,171022,14,0,37,1525,6.0,0.22600827,3
2020-10-16-171022,171022,9,0,16,1534,3.0,0.055453964,4
2020-10-17-171022,171022,8,0,7,1542,3.0,0.14725658,5
2020-10-18-171022,171022,4,0,7,1546,3.0,0.093599014,6
2020-10-19-171022,171022,6,0,4,1552,1.0,0.10035109,0
2020-10-20-171022,171022,15,0,20,1567,6.0,0.28314835,1
2020-10-21-171022,171022,12,0,30,1579,1.0,0.100438975,2
2020-10-22-171022,171022,7,1,16,1586,5.0,0.2435169,3
2020-10-23-171022,171022,15,1,14,1601,6.0,0.29393423,4
2020-10-24-171022,171022,5,0,19,1606,0.0,0.03176338,5
2020-10-25-171022,171022,3,0,10,1609,0.0,0.0048720073,6
2020-10-26-171022,171022,16,0,8,1625,22.0,0.91306275,0
2020-10-27-171022,171022,19,1,22,1644,6.0,0.24684377,1
2020-10-28-171022,171022,21,0,39,1665,9.0,0.36035872,2
2020-10-29-171022,171022,37,1,32,1702,9.0,0.9780076,3
2020-10-30-171022,171022,16,0,34,1718,11.0,0.51369834,4
2020-10-31-171022,171022,7,1,0,1725,15.0,0.5716786,5
2020-11-01-171022,171022,7,1,0,1732,11.0,0.43071622,6
2020-11-02-171022,171022,4,1,0,1736,17.0,0.38616973,0
2020-11-03-171022,171022,20,0,0,1756,8.0,0.32448924,1
2020-11-04-171022,171022,30,0,0,1786,10.0,0.5009015,2
2020-11-05-171022,171022,16,1,0,1802,10.0,0.7470135,3
2020-11-06-171022,171022,14,5,0,1816,4.0,0.34338537,4
2020-11-07-171022,171022,19,0,0,1835,8.0,0.28133276,5
2020-11-08-171022,171022,10,0,0,1845,0.0,0.007992558,6
2020-11-09-171022,171022,8,0,0,1853,6.0,0.22789374,0
2020-11-10-171022,171022,22,1,0,1875,9.0,0.32716268,1
2020-11-11-171022,171022,39,3,0,1914,7.0,0.28946334,2
2020-11-12-171022,171022,32,0,0,1946,10.0,0.4869753,3
2020-11-13-171022,171022,34,0,0,1980,2.0,0.21605055,4
2020-03-01-171023,171023,0,0,3,0,0.0,0.00616871,6
2020-03-02-171023,171023,0,0,10,0,0.125,0.007181178,0
2020-03-03-171023,171023,0,1,6,0,0.0,0.0020293696,1
2020-03-04-171023,171023,0,0,19,0,0.125,0.0012540285,2
2020-03-05-171023,171023,0,0,17,0,0.0,0.0048805755,3
2020-03-06-171023,171023,0,0,22,0,0.25,0.049897306,4
2020-03-07-171023,171023,0,0,6,0,0.0,0.0083084125,5
2020-03-08-171023,171023,0,0,5,0,0.0,0.0061639315,6
2020-03-09-171023,171023,0,0,32,0,0.5,0.041955814,0
2020-03-10-171023,171023,2,0,19,2,0.625,0.03276721,1
2020-03-11-171023,171023,3,0,30,5,0.5,0.029539047,2
2020-03-12-171023,171023,0,0,18,5,0.625,0.041597467,3
2020-03-13-171023,171023,5,0,18,10,1.75,0.13045758,4
2020-03-14-171023,171023,4,0,6,14,1.125,0.026403101,5
2020-03-15-171023,171023,3,0,3,17,1.75,0.03383392,6
2020-03-16-171023,171023,10,0,21,27,7.0,0.42029363,0
2020-03-17-171023,171023,6,1,6,33,5.625,0.26677203,1
2020-03-18-171023,171023,19,0,7,52,7.875,0.3996669,2
2020-03-19-171023,171023,17,0,6,69,11.5,0.42483923,3
2020-03-20-171023,171023,22,0,7,91,9.875,0.40195417,4
2020-03-21-171023,171023,6,0,6,97,2.875,0.071980275,5
2020-03-22-171023,171023,5,4,7,102,3.25,0.04734015,6
2020-03-23-171023,171023,32,0,13,134,16.25,0.6718715,0
2020-03-24-171023,171023,19,0,6,153,12.25,0.46427593,1
2020-03-25-171023,171023,30,0,7,183,11.375,0.46068308,2
2020-03-26-171023,171023,18,0,0,201,12.25,0.5554755,3
2020-03-27-171023,171023,18,0,5,219,11.625,0.41888925,4
2020-03-28-171023,171023,6,0,4,225,3.25,0.067442484,5
2020-03-29-171023,171023,3,0,0,228,3.375,0.107174926,6
2020-03-30-171023,171023,21,0,5,249,10.125,0.3661578,0
2020-03-31-171023,171023,6,0,5,255,5.625,0.17533755,1
2020-04-01-171023,171023,7,1,7,262,6.5,0.32228386,2
2020-04-02-171023,171023,6,0,2,268,9.875,0.38929045,3
2020-04-03-171023,171023,7,0,5,275,9.875,0.38521308,4
2020-04-04-171023,171023,6,0,3,281,2.25,0.03272509,5
2020-04-05-171023,171023,7,0,1,288,0.75,0.0739678,6
2020-04-06-171023,171023,13,0,5,301,8.0,0.39762288,0
2020-04-07-171023,171023,6,0,4,307,19.0,0.38283646,1
2020-04-08-171023,171023,7,0,7,314,9.375,0.2830984,2
2020-04-09-171023,171023,0,0,1,314,8.125,0.14846233,3
2020-04-10-171023,171023,5,0,4,319,4.375,0.06960396,4
2020-04-11-171023,171023,4,0,0,323,1.125,0.17699708,5
2020-04-12-171023,171023,0,0,0,323,3.125,0.092983834,6
2020-04-13-171023,171023,5,0,0,328,31.375,0.3119914,0
2020-04-14-171023,171023,5,0,3,333,7.75,0.3269,1
2020-04-15-171023,171023,7,0,2,340,5.375,0.25607952,2
2020-04-16-171023,171023,2,0,5,342,4.75,0.3234524,3
2020-04-17-171023,171023,5,0,1,347,3.875,0.22259332,4
2020-04-18-171023,171023,3,0,1,350,0.75,0.06394918,5
2020-04-19-171023,171023,1,0,0,351,0.25,0.010943695,6
2020-04-20-171023,171023,5,0,4,356,5.0,0.2565668,0
2020-04-21-171023,171023,4,0,3,360,3.875,0.27956033,1
2020-04-22-171023,171023,7,0,5,367,3.875,0.16340362,2
2020-04-23-171023,171023,1,0,4,368,0.125,0.0072398395,3
2020-04-24-171023,171023,4,0,6,372,3.625,0.18823741,4
2020-04-25-171023,171023,0,0,1,372,0.25,0.037619945,5
2020-04-26-171023,171023,0,0,1,372,0.375,0.046620753,6
2020-04-27-171023,171023,0,0,4,372,3.5,0.20619771,0
2020-04-28-171023,171023,3,0,1,375,2.375,0.21653336,1
2020-04-29-171023,171023,2,0,2,377,2.875,0.2898745,2
2020-04-30-171023,171023,5,0,4,382,2.875,0.12260027,3
2020-05-01-171023,171023,1,0,1,383,0.625,0.009704763,4
2020-05-02-171023,171023,1,0,0,384,0.5,0.017856529,5
2020-05-03-171023,171023,0,0,1,384,0.0,0.013656616,6
2020-05-04-171023,171023,4,0,4,388,3.0,0.23365368,0
2020-05-05-171023,171023,3,0,0,391,3.125,0.18955933,1
2020-05-06-171023,171023,5,0,1,396,4.75,0.3787033,2
2020-05-07-171023,171023,4,0,1,400,2.75,0.21502657,3
2020-05-08-171023,171023,6,0,1,406,4.375,0.1851284,4
2020-05-09-171023,171023,1,0,3,407,0.5,0.03178723,5
2020-05-10-171023,171023,1,0,0,408,0.625,0.03229986,6
2020-05-11-171023,171023,4,0,2,412,4.75,0.16482984,0
2020-05-12-171023,171023,1,0,3,413,3.25,0.14909998,1
2020-05-13-171023,171023,2,0,1,415,2.25,0.2011714,2
2020-05-14-171023,171023,4,0,1,419,2.25,0.19189514,3
2020-05-15-171023,171023,1,0,2,420,3.625,0.12279109,4
2020-05-16-171023,171023,0,0,1,420,0.625,0.05849067,5
2020-05-17-171023,171023,1,0,0,421,0.25,0.00543173,6
2020-05-18-171023,171023,4,0,0,425,2.875,0.21071798,0
2020-05-19-171023,171023,0,0,2,425,1.875,0.19150315,1
2020-05-20-171023,171023,1,0,0,426,2.0,0.10754552,2
2020-05-21-171023,171023,1,0,4,427,2.625,0.18769386,3
2020-05-22-171023,171023,1,0,3,428,1.625,0.14082135,4
2020-05-23-171023,171023,3,0,0,431,0.375,0.0061124656,5
2020-05-24-171023,171023,0,0,0,431,0.0,0.004324885,6
2020-05-25-171023,171023,2,0,2,433,2.75,0.2686192,0
2020-05-26-171023,171023,3,0,0,436,2.375,0.15187559,1
2020-05-27-171023,171023,1,1,1,437,1.125,0.1662761,2
2020-05-28-171023,171023,1,0,1,438,1.25,0.15848505,3
2020-05-29-171023,171023,2,0,2,440,1.875,0.26567057,4
2020-05-30-171023,171023,1,0,1,441,0.25,0.041469604,5
2020-05-31-171023,171023,0,1,0,441,0.125,0.029447434,6
2020-06-01-171023,171023,0,0,2,441,2.875,0.38430575,0
2020-06-02-171023,171023,2,0,2,443,2.125,0.17183387,1
2020-06-03-171023,171023,0,0,1,443,1.625,0.22419964,2
2020-06-04-171023,171023,4,0,1,447,1.25,0.12987365,3
2020-06-05-171023,171023,3,0,1,450,1.125,0.119839326,4
2020-06-06-171023,171023,0,0,0,450,0.125,0.0051907264,5
2020-06-07-171023,171023,0,0,0,450,0.0,0.012467111,6
2020-06-08-171023,171023,2,0,1,452,1.625,0.19498213,0
2020-06-09-171023,171023,0,0,3,452,0.875,0.20294686,1
2020-06-10-171023,171023,1,0,4,453,1.125,0.2189064,2
2020-06-11-171023,171023,1,0,2,454,1.625,0.20610657,3
2020-06-12-171023,171023,2,0,1,456,1.5,0.14353678,4
2020-06-13-171023,171023,1,0,0,457,0.125,0.016625442,5
2020-06-14-171023,171023,0,0,0,457,0.125,0.007623894,6
2020-06-15-171023,171023,2,0,2,459,2.0,0.16546874,0
2020-06-16-171023,171023,2,1,0,461,1.75,0.2832925,1
2020-06-17-171023,171023,1,0,0,462,1.75,0.14397551,2
2020-06-18-171023,171023,1,0,0,463,1.25,0.1517058,3
2020-06-19-171023,171023,1,0,3,464,1.5,0.17765991,4
2020-06-20-171023,171023,0,0,0,464,0.125,0.023612019,5
2020-06-21-171023,171023,0,0,0,464,0.0,0.0060185776,6
2020-06-22-171023,171023,1,0,2,465,1.0,0.13133816,0
2020-06-23-171023,171023,3,0,0,468,1.25,0.135272,1
2020-06-24-171023,171023,4,0,0,472,0.5,0.059324734,2
2020-06-25-171023,171023,2,0,0,474,0.375,0.08884008,3
2020-06-26-171023,171023,1,3,0,475,1.0,0.070891514,4
2020-06-27-171023,171023,0,0,0,475,0.125,0.020855296,5
2020-06-28-171023,171023,0,0,0,475,0.25,0.013186757,6
2020-06-29-171023,171023,2,0,0,477,1.75,0.11455959,0
2020-06-30-171023,171023,0,0,0,477,0.5,0.056459267,1
2020-07-01-171023,171023,0,0,0,477,0.375,0.10694802,2
2020-07-02-171023,171023,0,0,0,477,0.375,0.067709826,3
2020-07-03-171023,171023,3,0,2,480,0.625,0.05521253,4
2020-07-04-171023,171023,0,0,0,480,0.0,0.008174077,5
2020-07-05-171023,171023,0,0,0,480,0.0,0.02213835,6
2020-07-06-171023,171023,2,0,0,482,0.75,0.07815798,0
2020-07-07-171023,171023,0,0,1,482,0.625,0.04502777,1
2020-07-08-171023,171023,0,0,0,482,0.5,0.027554125,2
2020-07-09-171023,171023,0,0,1,482,0.5,0.045475695,3
2020-07-10-171023,171023,0,0,1,482,0.875,0.069331415,4
2020-07-11-171023,171023,0,0,0,482,0.0,0.014631327,5
2020-07-12-171023,171023,0,0,0,482,0.125,0.011654132,6
2020-07-13-171023,171023,0,0,0,482,0.375,0.055785637,0
2020-07-14-171023,171023,0,0,0,482,0.25,0.056111928,1
2020-07-15-171023,171023,0,0,0,482,0.5,0.047735076,2
2020-07-16-171023,171023,0,0,2,482,0.25,0.034942597,3
2020-07-17-171023,171023,2,0,1,484,0.75,0.11571883,4
2020-07-18-171023,171023,0,0,0,484,0.0,0.0033831669,5
2020-07-19-171023,171023,0,0,0,484,0.125,0.022664215,6
2020-07-20-171023,171023,0,0,2,484,0.5,0.05529863,0
2020-07-21-171023,171023,1,0,0,485,1.0,0.16732663,1
2020-07-22-171023,171023,0,0,4,485,0.25,0.057228755,2
2020-07-23-171023,171023,1,0,1,486,0.5,0.15019488,3
2020-07-24-171023,171023,1,0,1,487,0.875,0.07912841,4
2020-07-25-171023,171023,0,0,0,487,0.375,0.011144319,5
2020-07-26-171023,171023,0,0,1,487,0.25,0.0047592996,6
2020-07-27-171023,171023,0,0,1,487,1.125,0.19334532,0
2020-07-28-171023,171023,0,0,7,487,0.125,0.064819604,1
2020-07-29-171023,171023,0,0,6,487,0.5,0.07260945,2
2020-07-30-171023,171023,2,0,3,489,0.375,0.09495609,3
2020-07-31-171023,171023,1,0,3,490,1.125,0.11026371,4
2020-08-01-171023,171023,0,0,0,490,0.0,0.016552268,5
2020-08-02-171023,171023,0,0,0,490,0.125,0.051977806,6
2020-08-03-171023,171023,2,0,2,492,1.125,0.074086435,0
2020-08-04-171023,171023,0,0,4,492,1.125,0.106449775,1
2020-08-05-171023,171023,4,0,2,496,1.5,0.22664414,2
2020-08-06-171023,171023,1,0,3,497,1.0,0.10317288,3
2020-08-07-171023,171023,1,0,8,498,0.5,0.119963735,4
2020-08-08-171023,171023,0,0,0,498,1.5,0.11754447,5
2020-08-09-171023,171023,1,0,5,499,0.125,0.054582417,6
2020-08-10-171023,171023,1,0,2,500,1.875,0.19049558,0
2020-08-11-171023,171023,7,0,4,507,1.375,0.24654037,1
2020-08-12-171023,171023,6,0,2,513,1.25,0.14122099,2
2020-08-13-171023,171023,3,0,10,516,1.125,0.268893,3
2020-08-14-171023,171023,3,0,1,519,1.75,0.2316524,4
2020-08-15-171023,171023,0,0,0,519,0.375,0.1029701,5
2020-08-16-171023,171023,0,0,2,519,1.0,0.09291876,6
2020-08-17-171023,171023,2,0,4,521,1.875,0.28019148,0
2020-08-18-171023,171023,4,0,1,525,3.75,0.27272683,1
2020-08-19-171023,171023,2,0,3,527,3.125,0.3542858,2
2020-08-20-171023,171023,3,0,4,530,4.375,0.46410012,3
2020-08-21-171023,171023,8,0,4,538,3.0,0.3316385,4
2020-08-22-171023,171023,0,0,7,538,1.5,0.14214513,5
2020-08-23-171023,171023,5,0,5,543,1.25,0.11364982,6
2020-08-24-171023,171023,2,0,9,545,4.0,0.4302071,0
2020-08-25-171023,171023,4,0,3,549,4.875,0.6441519,1
2020-08-26-171023,171023,2,0,3,551,2.5,0.40413952,2
2020-08-27-171023,171023,10,0,6,561,7.0,0.5471114,3
2020-08-28-171023,171023,1,0,6,562,6.75,0.7985105,4
2020-08-29-171023,171023,0,1,0,562,2.75,0.18670122,5
2020-08-30-171023,171023,2,0,5,564,2.625,0.28078732,6
2020-08-31-171023,171023,4,0,8,568,3.75,0.26746267,0
2020-09-01-171023,171023,1,0,6,569,2.0,0.23373404,1
2020-09-02-171023,171023,3,0,4,572,5.25,0.5068097,2
2020-09-03-171023,171023,4,0,8,576,6.125,0.33707413,3
2020-09-04-171023,171023,4,0,7,580,3.375,0.4695692,4
2020-09-05-171023,171023,7,0,4,587,3.875,0.18578845,5
2020-09-06-171023,171023,5,0,3,592,4.75,0.27039418,6
2020-09-07-171023,171023,9,0,9,601,7.375,0.59209484,0
2020-09-08-171023,171023,3,0,12,604,2.625,0.4114743,1
2020-09-09-171023,171023,3,0,3,607,4.125,0.50740546,2
2020-09-10-171023,171023,6,0,9,613,7.125,0.6235606,3
2020-09-11-171023,171023,6,0,5,619,7.25,0.7652448,4
2020-09-12-171023,171023,0,0,1,619,2.25,0.23461485,5
2020-09-13-171023,171023,5,0,0,624,2.0,0.20037678,6
2020-09-14-171023,171023,8,0,11,632,7.5,0.7233548,0
2020-09-15-171023,171023,6,0,6,638,4.5,0.71755296,1
2020-09-16-171023,171023,4,1,4,642,8.0,0.8471497,2
2020-09-17-171023,171023,8,0,8,650,8.625,1.343286,3
2020-09-18-171023,171023,7,0,8,657,4.625,1.2550062,4
2020-09-19-171023,171023,4,0,0,661,4.375,0.5654328,5
2020-09-20-171023,171023,3,0,3,664,2.5,0.21944298,6
2020-09-21-171023,171023,9,0,5,673,5.75,0.6299982,0
2020-09-22-171023,171023,12,0,6,685,6.5,0.66837317,1
2020-09-23-171023,171023,3,0,7,688,7.0,0.65471774,2
2020-09-24-171023,171023,9,0,10,697,6.0,0.8722147,3
2020-09-25-171023,171023,5,1,12,702,5.875,0.86595905,4
2020-09-26-171023,171023,1,0,13,703,2.75,0.5437191,5
2020-09-27-171023,171023,0,0,0,703,2.25,0.22023967,6
2020-09-28-171023,171023,11,0,3,714,3.625,0.46269274,0
2020-09-29-171023,171023,6,0,10,720,4.125,0.42255053,1
2020-09-30-171023,171023,4,1,15,724,4.0,0.38490513,2
2020-10-01-171023,171023,8,0,5,732,4.875,0.8215157,3
2020-10-02-171023,171023,8,0,8,740,4.75,0.83321446,4
2020-10-03-171023,171023,0,0,0,740,2.375,0.3149766,5
2020-10-04-171023,171023,3,0,4,743,1.25,0.11029715,6
2020-10-05-171023,171023,5,0,9,748,7.0,0.7227235,0
2020-10-06-171023,171023,6,0,17,754,6.625,0.95275575,1
2020-10-07-171023,171023,7,1,8,761,5.625,0.7563391,2
2020-10-08-171023,171023,10,1,16,771,9.625,1.7957786,3
2020-10-09-171023,171023,12,1,18,783,6.375,1.2825905,4
2020-10-10-171023,171023,13,0,3,796,2.875,0.4064906,5
2020-10-11-171023,171023,0,0,5,796,0.875,0.31012174,6
2020-10-12-171023,171023,3,0,18,799,1.5,0.19919592,0
2020-10-13-171023,171023,10,0,19,809,5.875,0.7149317,1
2020-10-14-171023,171023,15,0,23,824,5.125,0.95168775,2
2020-10-15-171023,171023,5,0,15,829,4.375,0.6412045,3
2020-10-16-171023,171023,8,0,24,837,8.375,0.9297809,4
2020-10-17-171023,171023,0,0,11,837,4.25,0.4605666,5
2020-10-18-171023,171023,4,0,8,841,1.5,0.28695673,6
2020-10-19-171023,171023,9,0,5,850,5.5,0.64831954,0
2020-10-20-171023,171023,17,0,12,867,7.25,1.0843353,1
2020-10-21-171023,171023,8,0,17,875,10.25,1.0808312,2
2020-10-22-171023,171023,16,0,21,891,7.75,0.99006677,3
2020-10-23-171023,171023,18,2,24,909,14.75,1.5554926,4
2020-10-24-171023,171023,3,1,1,912,4.375,0.41349134,5
2020-10-25-171023,171023,5,0,2,917,3.75,0.23484787,6
2020-10-26-171023,171023,18,1,16,935,14.875,1.2297704,0
2020-10-27-171023,171023,19,1,12,954,14.25,1.2925303,1
2020-10-28-171023,171023,23,0,16,977,13.25,1.6108254,2
2020-10-29-171023,171023,15,0,17,992,11.75,1.0726389,3
2020-10-30-171023,171023,24,1,15,1016,17.875,1.6665173,4
2020-10-31-171023,171023,11,0,0,1027,6.75,0.59629196,5
2020-11-01-171023,171023,8,0,0,1035,3.875,0.37033844,6
2020-11-02-171023,171023,5,0,0,1040,1.5,0.29912373,0
2020-11-03-171023,171023,12,1,0,1052,8.875,1.0048918,1
2020-11-04-171023,171023,17,0,0,1069,11.625,1.4687914,2
2020-11-05-171023,171023,21,1,0,1090,11.375,1.5129275,3
2020-11-06-171023,171023,24,1,0,1114,9.5,1.5907509,4
2020-11-07-171023,171023,1,0,0,1115,6.75,0.50881535,5
2020-11-08-171023,171023,2,0,0,1117,3.0,0.24860886,6
2020-11-09-171023,171023,16,0,0,1133,11.875,0.86360806,0
2020-11-10-171023,171023,12,1,0,1145,8.75,0.9739691,1
2020-11-11-171023,171023,16,1,0,1161,11.75,1.2357455,2
2020-11-12-171023,171023,17,0,0,1178,9.0,1.1217197,3
2020-11-13-171023,171023,15,0,0,1193,10.5,0.88674504,4
2020-03-01-171024,171024,0,0,0,0,0.0,0.0058419826,6
2020-03-02-171024,171024,0,0,5,0,0.16666666666666666,0.006560319,0
2020-03-03-171024,171024,0,0,6,0,0.0,0.000923548,1
2020-03-04-171024,171024,0,0,9,0,0.5,0.0017864325,2
2020-03-05-171024,171024,0,0,10,0,0.0,0.00705354,3
2020-03-06-171024,171024,0,0,9,0,0.16666666666666666,0.030321643,4
2020-03-07-171024,171024,0,0,3,0,0.0,0.008416317,5
2020-03-08-171024,171024,0,0,10,0,0.16666666666666666,0.0065168096,6
2020-03-09-171024,171024,0,0,46,0,0.6666666666666666,0.060495563,0
2020-03-10-171024,171024,0,0,41,0,0.6666666666666666,0.033184376,1
2020-03-11-171024,171024,0,0,37,0,0.6666666666666666,0.030622307,2
2020-03-12-171024,171024,0,0,26,0,0.8333333333333334,0.045306414,3
2020-03-13-171024,171024,5,0,19,5,1.3333333333333333,0.10792756,4
2020-03-14-171024,171024,1,0,7,6,0.8333333333333334,0.014351,5
2020-03-15-171024,171024,0,0,3,6,2.5,0.017125733,6
2020-03-16-171024,171024,5,0,27,11,7.5,0.19219822,0
2020-03-17-171024,171024,6,1,9,17,8.5,0.11497212,1
2020-03-18-171024,171024,9,0,14,26,11.166666666666664,0.19333284,2
2020-03-19-171024,171024,10,0,13,36,14.833333333333336,0.21973741,3
2020-03-20-171024,171024,9,0,13,45,16.0,0.1699254,4
2020-03-21-171024,171024,3,2,2,48,3.1666666666666665,0.020892292,5
2020-03-22-171024,171024,10,0,2,58,5.333333333333333,0.012623911,6
2020-03-23-171024,171024,46,0,24,104,23.33333333333333,0.28714707,0
2020-03-24-171024,171024,41,0,16,145,16.166666666666668,0.18741752,1
2020-03-25-171024,171024,37,0,8,182,15.333333333333336,0.17532322,2
2020-03-26-171024,171024,26,0,10,208,17.333333333333332,0.19838761,3
2020-03-27-171024,171024,19,0,6,227,17.5,0.19546218,4
2020-03-28-171024,171024,7,0,8,234,3.0,0.022849955,5
2020-03-29-171024,171024,3,0,3,237,3.5,0.019926442,6
2020-03-30-171024,171024,27,0,35,264,21.0,0.09729231,0
2020-03-31-171024,171024,9,0,8,273,10.5,0.058633503,1
2020-04-01-171024,171024,14,0,15,287,8.0,0.12735248,2
2020-04-02-171024,171024,13,0,6,300,10.833333333333336,0.15127052,3
2020-04-03-171024,171024,13,0,5,313,10.333333333333334,0.15756302,4
2020-04-04-171024,171024,2,0,2,315,2.833333333333333,0.011022247,5
2020-04-05-171024,171024,2,1,1,317,1.3333333333333333,0.01205995,6
2020-04-06-171024,171024,24,0,6,341,12.333333333333336,0.09982794,0
2020-04-07-171024,171024,16,0,4,357,8.5,0.13420612,1
2020-04-08-171024,171024,8,0,6,365,9.833333333333334,0.1433022,2
2020-04-09-171024,171024,10,0,0,375,8.5,0.03201697,3
2020-04-10-171024,171024,6,0,9,381,4.666666666666667,0.017196653,4
2020-04-11-171024,171024,8,0,1,389,2.333333333333333,0.030233745,5
2020-04-12-171024,171024,3,0,0,392,3.0,0.01935846,6
2020-04-13-171024,171024,35,0,9,427,39.16666666666666,0.12794502,0
2020-04-14-171024,171024,8,0,0,435,11.5,0.090843804,1
2020-04-15-171024,171024,15,0,9,450,9.333333333333334,0.14709593,2
2020-04-16-171024,171024,6,0,9,456,6.0,0.09641491,3
2020-04-17-171024,171024,5,0,0,461,5.0,0.06666935,4
2020-04-18-171024,171024,2,0,0,463,1.3333333333333333,0.011240542,5
2020-04-19-171024,171024,1,1,0,464,0.5,0.0026072038,6
2020-04-20-171024,171024,6,1,8,470,6.5,0.11061956,0
2020-04-21-171024,171024,4,0,8,474,7.333333333333332,0.092631124,1
2020-04-22-171024,171024,6,0,4,480,5.0,0.058726434,2
2020-04-23-171024,171024,0,0,7,480,0.3333333333333333,0.0024488824,3
2020-04-24-171024,171024,9,0,9,489,3.8333333333333335,0.08798599,4
2020-04-25-171024,171024,1,0,0,490,0.16666666666666666,0.004243695,5
2020-04-26-171024,171024,0,0,0,490,0.5,0.0065455,6
2020-04-27-171024,171024,9,0,4,499,4.333333333333333,0.07452945,0
2020-04-28-171024,171024,0,0,2,499,3.8333333333333335,0.0813037,1
2020-04-29-171024,171024,9,0,0,508,4.333333333333333,0.09624968,2
2020-04-30-171024,171024,9,0,5,517,5.166666666666667,0.07051814,3
2020-05-01-171024,171024,0,0,2,517,0.6666666666666666,0.004876435,4
2020-05-02-171024,171024,0,0,0,517,0.6666666666666666,0.006860971,5
2020-05-03-171024,171024,0,0,0,517,0.16666666666666666,0.003173592,6
2020-05-04-171024,171024,8,0,6,525,5.0,0.08286029,0
2020-05-05-171024,171024,8,0,4,533,5.333333333333333,0.08458077,1
2020-05-06-171024,171024,4,0,1,537,5.0,0.14150916,2
2020-05-07-171024,171024,7,0,1,544,4.166666666666667,0.09461244,3
2020-05-08-171024,171024,9,0,5,553,6.166666666666668,0.09977388,4
2020-05-09-171024,171024,0,0,2,553,0.3333333333333333,0.008049407,5
2020-05-10-171024,171024,0,0,0,553,0.5,0.0055850907,6
2020-05-11-171024,171024,4,0,3,557,5.333333333333333,0.13068633,0
2020-05-12-171024,171024,2,0,2,559,4.0,0.07907949,1
2020-05-13-171024,171024,0,0,1,559,0.5,0.0601907,2
2020-05-14-171024,171024,5,0,0,564,3.0,0.095748834,3
2020-05-15-171024,171024,2,1,2,566,2.833333333333333,0.073515624,4
2020-05-16-171024,171024,0,0,0,566,0.16666666666666666,0.008123415,5
2020-05-17-171024,171024,0,0,0,566,0.3333333333333333,0.0011065644,6
2020-05-18-171024,171024,6,0,7,572,3.333333333333333,0.12434237,0
2020-05-19-171024,171024,4,0,5,576,3.333333333333333,0.09367382,1
2020-05-20-171024,171024,1,0,5,577,3.5,0.095886365,2
2020-05-21-171024,171024,1,0,3,578,3.1666666666666665,0.10207106,3
2020-05-22-171024,171024,5,0,4,583,1.5,0.10147276,4
2020-05-23-171024,171024,2,0,1,585,0.6666666666666666,0.0009554683,5
2020-05-24-171024,171024,0,0,0,585,0.16666666666666666,0.0018865356,6
2020-05-25-171024,171024,3,0,3,588,3.333333333333333,0.1755812,0
2020-05-26-171024,171024,2,0,6,590,3.0,0.09966197,1
2020-05-27-171024,171024,1,0,0,591,2.5,0.10388612,2
2020-05-28-171024,171024,0,0,1,591,2.1666666666666665,0.1170663,3
2020-05-29-171024,171024,2,0,1,593,2.6666666666666665,0.16206992,4
2020-05-30-171024,171024,0,0,0,593,0.0,0.017340772,5
2020-05-31-171024,171024,0,0,0,593,0.16666666666666666,0.01710845,6
2020-06-01-171024,171024,7,0,0,600,1.5,0.19819969,0
2020-06-02-171024,171024,5,0,9,605,2.0,0.104211345,1
2020-06-03-171024,171024,5,0,1,610,2.333333333333333,0.13263354,2
2020-06-04-171024,171024,3,0,4,613,2.6666666666666665,0.09198089,3
2020-06-05-171024,171024,4,0,1,617,2.6666666666666665,0.062071986,4
2020-06-06-171024,171024,1,0,0,618,0.16666666666666666,0.004678979,5
2020-06-07-171024,171024,0,0,0,618,0.0,0.0057733706,6
2020-06-08-171024,171024,3,0,3,621,1.6666666666666667,0.14363544,0
2020-06-09-171024,171024,6,0,4,627,1.0,0.109592825,1
2020-06-10-171024,171024,0,0,1,627,1.5,0.1655698,2
2020-06-11-171024,171024,1,0,4,628,1.5,0.15759502,3
2020-06-12-171024,171024,1,0,9,629,1.1666666666666667,0.08618906,4
2020-06-13-171024,171024,0,1,0,629,0.3333333333333333,0.010343147,5
2020-06-14-171024,171024,0,6,1,629,0.16666666666666666,0.0056417137,6
2020-06-15-171024,171024,0,0,1,629,1.5,0.15634416,0
2020-06-16-171024,171024,9,0,1,638,0.3333333333333333,0.17221531,1
2020-06-17-171024,171024,1,0,1,639,1.5,0.12443829,2
2020-06-18-171024,171024,4,0,0,643,0.6666666666666666,0.116023615,3
2020-06-19-171024,171024,1,0,2,644,0.8333333333333334,0.16608024,4
2020-06-20-171024,171024,0,0,0,644,0.0,0.023844816,5
2020-06-21-171024,171024,0,0,1,644,0.0,0.002670698,6
2020-06-22-171024,171024,3,0,2,647,0.6666666666666666,0.07299484,0
2020-06-23-171024,171024,4,0,1,651,1.0,0.11018463,1
2020-06-24-171024,171024,1,0,2,652,0.6666666666666666,0.055067178,2
2020-06-25-171024,171024,4,0,2,656,0.3333333333333333,0.0724668,3
2020-06-26-171024,171024,9,1,2,665,1.6666666666666667,0.073676445,4
2020-06-27-171024,171024,0,0,0,665,0.0,0.020992221,5
2020-06-28-171024,171024,1,0,0,666,0.16666666666666666,0.0074603804,6
2020-06-29-171024,171024,1,0,1,667,1.5,0.09878276,0
2020-06-30-171024,171024,1,0,0,668,0.3333333333333333,0.059165854,1
2020-07-01-171024,171024,1,0,2,669,0.3333333333333333,0.07261957,2
2020-07-02-171024,171024,0,0,4,669,0.5,0.050497126,3
2020-07-03-171024,171024,2,0,0,671,0.5,0.060037546,4
2020-07-04-171024,171024,0,0,0,671,0.16666666666666666,0.006585426,5
2020-07-05-171024,171024,1,0,0,672,0.0,0.013721251,6
2020-07-06-171024,171024,2,0,1,674,0.16666666666666666,0.075793706,0
2020-07-07-171024,171024,1,0,3,675,0.5,0.055918142,1
2020-07-08-171024,171024,2,0,3,677,0.8333333333333334,0.026805544,2
2020-07-09-171024,171024,2,0,2,679,0.6666666666666666,0.026421817,3
2020-07-10-171024,171024,2,0,4,681,1.0,0.06588003,4
2020-07-11-171024,171024,0,0,0,681,0.16666666666666666,0.009504445,5
2020-07-12-171024,171024,0,0,0,681,0.0,0.0068259765,6
2020-07-13-171024,171024,1,0,2,682,0.5,0.050855536,0
2020-07-14-171024,171024,0,0,1,682,0.8333333333333334,0.041480966,1
2020-07-15-171024,171024,2,0,1,684,0.6666666666666666,0.048633233,2
2020-07-16-171024,171024,4,0,5,688,0.5,0.03437508,3
2020-07-17-171024,171024,0,0,1,688,0.3333333333333333,0.102882594,4
2020-07-18-171024,171024,0,0,0,688,0.0,0.005396298,5
2020-07-19-171024,171024,0,0,0,688,0.0,0.01461841,6
2020-07-20-171024,171024,1,0,2,689,0.5,0.0607989,0
2020-07-21-171024,171024,3,0,2,692,0.3333333333333333,0.11912371,1
2020-07-22-171024,171024,3,0,4,695,1.1666666666666667,0.047743883,2
2020-07-23-171024,171024,2,0,0,697,0.6666666666666666,0.16182859,3
2020-07-24-171024,171024,4,0,1,701,1.1666666666666667,0.09842514,4
2020-07-25-171024,171024,0,0,1,701,0.16666666666666666,0.012765966,5
2020-07-26-171024,171024,0,0,1,701,0.3333333333333333,0.0036008614,6
2020-07-27-171024,171024,2,0,2,703,0.5,0.17597547,0
2020-07-28-171024,171024,1,0,2,704,0.3333333333333333,0.06915035,1
2020-07-29-171024,171024,1,0,0,705,0.5,0.077543505,2
2020-07-30-171024,171024,5,0,7,710,1.0,0.12328384,3
2020-07-31-171024,171024,1,0,4,711,0.8333333333333334,0.11397145,4
2020-08-01-171024,171024,0,0,6,711,0.16666666666666666,0.016328467,5
2020-08-02-171024,171024,0,0,4,711,0.3333333333333333,0.040620796,6
2020-08-03-171024,171024,2,0,5,713,0.8333333333333334,0.073197894,0
2020-08-04-171024,171024,2,0,3,715,1.0,0.0956447,1
2020-08-05-171024,171024,4,0,6,719,2.833333333333333,0.22310454,2
2020-08-06-171024,171024,0,0,6,719,1.5,0.12520052,3
2020-08-07-171024,171024,1,0,5,720,2.333333333333333,0.098917864,4
2020-08-08-171024,171024,1,0,4,721,1.3333333333333333,0.09106762,5
2020-08-09-171024,171024,1,0,3,722,0.16666666666666666,0.040976107,6
2020-08-10-171024,171024,2,0,7,724,1.6666666666666667,0.12536614,0
2020-08-11-171024,171024,2,0,12,726,1.5,0.22919956,1
2020-08-12-171024,171024,0,0,8,726,2.1666666666666665,0.12626714,2
2020-08-13-171024,171024,7,0,15,733,3.1666666666666665,0.24689591,3
2020-08-14-171024,171024,4,0,16,737,2.5,0.22015809,4
2020-08-15-171024,171024,6,0,5,743,0.8333333333333334,0.09114891,5
2020-08-16-171024,171024,4,0,9,747,2.333333333333333,0.07756397,6
2020-08-17-171024,171024,5,0,6,752,4.0,0.24425122,0
2020-08-18-171024,171024,3,0,4,755,2.833333333333333,0.2949855,1
2020-08-19-171024,171024,6,0,4,761,3.1666666666666665,0.3744342,2
2020-08-20-171024,171024,6,0,4,767,6.166666666666668,0.38090742,3
2020-08-21-171024,171024,5,0,10,772,3.333333333333333,0.3704906,4
2020-08-22-171024,171024,4,0,6,776,2.333333333333333,0.12692338,5
2020-08-23-171024,171024,3,0,6,779,1.5,0.06544535,6
2020-08-24-171024,171024,7,0,22,786,3.0,0.35947078,0
2020-08-25-171024,171024,12,0,1,798,5.333333333333333,0.53923535,1
2020-08-26-171024,171024,8,0,16,806,4.333333333333333,0.44112676,2
2020-08-27-171024,171024,15,1,6,821,8.333333333333334,0.54687107,3
2020-08-28-171024,171024,16,0,14,837,8.0,0.6073325,4
2020-08-29-171024,171024,5,0,7,842,3.0,0.16463272,5
2020-08-30-171024,171024,9,0,3,851,1.0,0.20833476,6
2020-08-31-171024,171024,6,0,16,857,5.5,0.24997629,0
2020-09-01-171024,171024,4,0,13,861,4.666666666666667,0.23384416,1
2020-09-02-171024,171024,4,0,8,865,6.666666666666668,0.36141118,2
2020-09-03-171024,171024,4,0,4,869,7.333333333333332,0.3472952,3
2020-09-04-171024,171024,10,0,6,879,5.166666666666667,0.37335017,4
2020-09-05-171024,171024,6,0,2,885,3.0,0.19501916,5
2020-09-06-171024,171024,6,1,3,891,1.8333333333333333,0.17681965,6
2020-09-07-171024,171024,22,0,7,913,10.333333333333334,0.4483977,0
2020-09-08-171024,171024,1,0,2,914,0.8333333333333334,0.3161346,1
2020-09-09-171024,171024,16,0,11,930,6.666666666666668,0.42303154,2
2020-09-10-171024,171024,6,0,6,936,7.5,0.72326666,3
2020-09-11-171024,171024,14,0,10,950,9.166666666666666,0.71107113,4
2020-09-12-171024,171024,7,0,3,957,1.0,0.30598047,5
2020-09-13-171024,171024,3,0,2,960,2.5,0.122062676,6
2020-09-14-171024,171024,16,1,3,976,10.333333333333334,0.6895759,0
2020-09-15-171024,171024,13,0,7,989,4.833333333333333,0.71459484,1
2020-09-16-171024,171024,8,0,3,997,12.333333333333336,0.78690463,2
2020-09-17-171024,171024,4,2,4,1001,8.666666666666666,0.9958357,3
2020-09-18-171024,171024,6,0,4,1007,6.166666666666668,0.9092645,4
2020-09-19-171024,171024,2,0,3,1009,2.0,0.59229004,5
2020-09-20-171024,171024,3,0,1,1012,2.1666666666666665,0.14631043,6
2020-09-21-171024,171024,7,0,9,1019,7.333333333333332,0.53043455,0
2020-09-22-171024,171024,2,0,10,1021,3.6666666666666665,0.52900285,1
2020-09-23-171024,171024,11,3,13,1032,7.5,0.67017066,2
2020-09-24-171024,171024,6,1,10,1038,7.0,0.86996025,3
2020-09-25-171024,171024,10,2,15,1048,9.666666666666666,0.6976717,4
2020-09-26-171024,171024,3,0,7,1051,2.833333333333333,0.5763725,5
2020-09-27-171024,171024,2,0,3,1053,2.833333333333333,0.16990483,6
2020-09-28-171024,171024,3,0,4,1056,7.5,0.39132556,0
2020-09-29-171024,171024,7,0,15,1063,6.666666666666668,0.37142015,1
2020-09-30-171024,171024,3,0,9,1066,7.0,0.35520753,2
2020-10-01-171024,171024,4,0,13,1070,5.333333333333333,0.7119055,3
2020-10-02-171024,171024,4,0,13,1074,7.666666666666668,0.55459005,4
2020-10-03-171024,171024,3,0,5,1077,2.0,0.32749057,5
2020-10-04-171024,171024,1,2,2,1078,3.6666666666666665,0.087787054,6
2020-10-05-171024,171024,9,1,8,1087,7.5,0.52512187,0
2020-10-06-171024,171024,10,1,8,1097,7.666666666666668,0.8825643,1
2020-10-07-171024,171024,13,1,14,1110,5.666666666666668,0.6687024,2
2020-10-08-171024,171024,10,0,16,1120,5.5,1.1564804,3
2020-10-09-171024,171024,15,1,23,1135,7.0,0.9179981,4
2020-10-10-171024,171024,7,0,6,1142,2.333333333333333,0.34787858,5
2020-10-11-171024,171024,3,0,3,1145,0.5,0.2842479,6
2020-10-12-171024,171024,4,0,14,1149,1.1666666666666667,0.15777357,0
2020-10-13-171024,171024,15,0,16,1164,6.0,0.67204463,1
2020-10-14-171024,171024,9,0,28,1173,7.333333333333332,0.68770844,2
2020-10-15-171024,171024,13,0,19,1186,6.166666666666668,0.68508226,3
2020-10-16-171024,171024,13,0,35,1199,7.833333333333332,0.8438526,4
2020-10-17-171024,171024,5,0,15,1204,4.5,0.31912467,5
2020-10-18-171024,171024,2,0,2,1206,0.8333333333333334,0.24291635,6
2020-10-19-171024,171024,8,0,3,1214,8.666666666666666,0.5714033,0
2020-10-20-171024,171024,8,0,18,1222,9.666666666666666,0.92359674,1
2020-10-21-171024,171024,14,1,28,1236,13.166666666666664,0.868508,2
2020-10-22-171024,171024,16,0,32,1252,12.5,0.81875205,3
2020-10-23-171024,171024,23,0,18,1275,21.66666666666667,1.3969249,4
2020-10-24-171024,171024,6,1,16,1281,5.0,0.40301093,5
2020-10-25-171024,171024,3,1,6,1284,3.1666666666666665,0.18122174,6
2020-10-26-171024,171024,14,2,8,1298,20.666666666666668,0.9693766,0
2020-10-27-171024,171024,16,1,21,1314,12.5,1.0440966,1
2020-10-28-171024,171024,28,1,21,1342,19.666666666666668,1.1526301,2
2020-10-29-171024,171024,19,0,20,1361,20.666666666666668,1.1198393,3
2020-10-30-171024,171024,35,1,32,1396,22.33333333333333,1.523878,4
2020-10-31-171024,171024,15,1,0,1411,7.0,0.46654665,5
2020-11-01-171024,171024,2,2,0,1413,5.5,0.22315657,6
2020-11-02-171024,171024,3,0,0,1416,2.6666666666666665,0.23525289,0
2020-11-03-171024,171024,18,0,0,1434,19.5,0.90001947,1
2020-11-04-171024,171024,28,0,0,1462,14.666666666666664,1.215719,2
2020-11-05-171024,171024,32,3,0,1494,18.5,1.4103376,3
2020-11-06-171024,171024,18,2,0,1512,16.5,1.028151,4
2020-11-07-171024,171024,16,2,0,1528,5.666666666666668,0.37123552,5
2020-11-08-171024,171024,6,0,0,1534,4.666666666666667,0.12794799,6
2020-11-09-171024,171024,8,0,0,1542,19.666666666666668,0.66263455,0
2020-11-10-171024,171024,21,0,0,1563,12.833333333333336,0.7840526,1
2020-11-11-171024,171024,21,1,0,1584,12.833333333333336,0.7822407,2
2020-11-12-171024,171024,20,1,0,1604,14.0,0.86490214,3
2020-11-13-171024,171024,32,3,0,1636,13.5,0.67076254,4
2020-03-01-171025,171025,0,0,3,0,0.1,0.014360093,6
2020-03-02-171025,171025,0,0,9,0,0.0,0.01867044,0
2020-03-03-171025,171025,0,1,9,0,0.2,0.033544827,1
2020-03-04-171025,171025,0,0,9,0,0.1,0.0050227335,2
2020-03-05-171025,171025,0,0,18,0,0.2,0.015141145,3
2020-03-06-171025,171025,0,0,13,0,0.2,0.029095752,4
2020-03-07-171025,171025,0,0,3,0,0.1,0.0034223641,5
2020-03-08-171025,171025,0,0,4,0,0.0,0.003162068,6
2020-03-09-171025,171025,0,0,15,0,0.3,0.115644455,0
2020-03-10-171025,171025,0,0,10,0,0.5,0.06920603,1
2020-03-11-171025,171025,0,0,7,0,0.5,0.035538014,2
2020-03-12-171025,171025,0,0,15,0,0.5,0.11475238,3
2020-03-13-171025,171025,2,0,13,2,1.3,0.269288,4
2020-03-14-171025,171025,0,0,1,2,1.2,0.16309966,5
2020-03-15-171025,171025,3,0,1,5,1.3,0.07456017,6
2020-03-16-171025,171025,9,0,8,14,5.4,0.9756276,0
2020-03-17-171025,171025,9,0,5,23,4.6,0.78548735,1
2020-03-18-171025,171025,9,1,10,32,8.4,1.0779452,2
2020-03-19-171025,171025,18,0,8,50,9.5,1.3368742,3
2020-03-20-171025,171025,13,0,38,63,11.7,1.3504986,4
2020-03-21-171025,171025,3,0,2,66,3.3,0.18217292,5
2020-03-22-171025,171025,4,0,0,70,4.1,0.20817736,6
2020-03-23-171025,171025,15,0,14,85,13.3,1.6791826,0
2020-03-24-171025,171025,10,0,15,95,11.8,1.0938932,1
2020-03-25-171025,171025,7,0,12,102,12.3,0.90569633,2
2020-03-26-171025,171025,15,0,17,117,11.7,1.1729822,3
2020-03-27-171025,171025,13,0,6,130,10.3,1.0389022,4
2020-03-28-171025,171025,1,0,1,131,3.0,0.18270026,5
2020-03-29-171025,171025,1,0,8,132,2.4,0.1005276,6
2020-03-30-171025,171025,8,0,8,140,11.2,0.6984409,0
2020-03-31-171025,171025,5,0,5,145,6.4,0.5650746,1
2020-04-01-171025,171025,10,0,6,155,8.3,0.64582795,2
2020-04-02-171025,171025,8,0,5,163,9.3,1.1208109,3
2020-04-03-171025,171025,38,0,6,201,7.8,1.2164648,4
2020-04-04-171025,171025,2,0,0,203,2.5,0.07788277,5
2020-04-05-171025,171025,0,0,0,203,2.0,0.10965155,6
2020-04-06-171025,171025,14,0,7,217,8.4,0.87032163,0
2020-04-07-171025,171025,15,0,1,232,5.1,0.8576586,1
2020-04-08-171025,171025,12,0,4,244,6.4,0.82634383,2
2020-04-09-171025,171025,17,0,0,261,3.5,0.70018494,3
2020-04-10-171025,171025,6,0,4,267,3.8,0.2397726,4
2020-04-11-171025,171025,1,0,0,268,3.6,0.19722371,5
2020-04-12-171025,171025,8,0,1,276,2.5,0.27260074,6
2020-04-13-171025,171025,8,0,5,284,5.6,0.6812913,0
2020-04-14-171025,171025,5,0,4,289,5.8,0.5851423,1
2020-04-15-171025,171025,6,0,4,295,5.7,0.858823,2
2020-04-16-171025,171025,5,0,5,300,3.1,0.46479717,3
2020-04-17-171025,171025,6,0,2,306,3.1,0.3325016,4
2020-04-18-171025,171025,0,0,1,306,1.3,0.037964292,5
2020-04-19-171025,171025,0,0,0,306,0.8,0.058271173,6
2020-04-20-171025,171025,7,0,2,313,4.4,0.72705144,0
2020-04-21-171025,171025,1,0,4,314,4.0,0.3995641,1
2020-04-22-171025,171025,4,0,6,318,3.1,0.30649924,2
2020-04-23-171025,171025,0,0,2,318,0.2,0.0188293,3
2020-04-24-171025,171025,4,0,5,322,3.5,0.39288983,4
2020-04-25-171025,171025,0,0,2,322,0.3,0.01298909,5
2020-04-26-171025,171025,1,0,1,323,0.7,0.06524283,6
2020-04-27-171025,171025,5,1,5,328,3.4,0.4605436,0
2020-04-28-171025,171025,4,1,3,332,2.2,0.3038156,1
2020-04-29-171025,171025,4,0,9,336,2.9,0.530102,2
2020-04-30-171025,171025,5,0,6,341,3.5,0.28199098,3
2020-05-01-171025,171025,2,0,1,343,0.6,0.05273897,4
2020-05-02-171025,171025,1,0,0,344,0.6,0.053191848,5
2020-05-03-171025,171025,0,0,0,344,0.3,0.014383001,6
2020-05-04-171025,171025,2,0,3,346,3.6,0.2968937,0
2020-05-05-171025,171025,4,0,1,350,2.6,0.28800967,1
2020-05-06-171025,171025,6,0,5,356,3.8,0.578178,2
2020-05-07-171025,171025,2,0,3,358,3.3,0.47092414,3
2020-05-08-171025,171025,5,0,3,363,3.2,0.43615046,4
2020-05-09-171025,171025,2,0,0,365,0.3,0.091197275,5
2020-05-10-171025,171025,1,0,0,366,0.4,0.063830085,6
2020-05-11-171025,171025,5,0,1,371,2.9,0.5067647,0
2020-05-12-171025,171025,3,0,0,374,2.4,0.2901808,1
2020-05-13-171025,171025,9,0,0,383,1.2,0.5683102,2
2020-05-14-171025,171025,6,0,1,389,1.9,0.37857988,3
2020-05-15-171025,171025,1,0,1,390,2.4,0.3109688,4
2020-05-16-171025,171025,0,0,0,390,0.5,0.018379403,5
2020-05-17-171025,171025,0,0,0,390,0.4,0.009837735,6
2020-05-18-171025,171025,3,0,3,393,3.1,0.39948538,0
2020-05-19-171025,171025,1,0,3,394,2.4,0.31301132,1
2020-05-20-171025,171025,5,0,2,399,2.6,0.34883037,2
2020-05-21-171025,171025,3,0,2,402,2.4,0.48799786,3
2020-05-22-171025,171025,3,0,0,405,2.4,0.44115055,4
2020-05-23-171025,171025,0,0,0,405,0.5,0.0022957667,5
2020-05-24-171025,171025,0,0,0,405,0.2,0.005333243,6
2020-05-25-171025,171025,1,0,1,406,2.5,0.31626827,0
2020-05-26-171025,171025,0,0,0,406,1.8,0.22924154,1
2020-05-27-171025,171025,0,0,4,406,2.4,0.2672838,2
2020-05-28-171025,171025,1,0,4,407,1.0,0.22222863,3
2020-05-29-171025,171025,1,0,0,408,2.2,0.31274205,4
2020-05-30-171025,171025,0,0,0,408,0.2,0.033521943,5
2020-05-31-171025,171025,0,0,0,408,0.3,0.03156552,6
2020-06-01-171025,171025,3,1,3,411,1.6,0.40141553,0
2020-06-02-171025,171025,3,0,3,414,1.7,0.30702755,1
2020-06-03-171025,171025,2,0,3,416,0.9,0.1883562,2
2020-06-04-171025,171025,2,0,2,418,1.3,0.19369785,3
2020-06-05-171025,171025,0,0,3,418,1.2,0.086894095,4
2020-06-06-171025,171025,0,0,1,418,0.1,0.023033384,5
2020-06-07-171025,171025,0,0,0,418,0.1,0.006467778,6
2020-06-08-171025,171025,1,1,1,419,1.3,0.3144973,0
2020-06-09-171025,171025,0,0,3,419,0.7,0.23022589,1
2020-06-10-171025,171025,4,1,0,423,1.1,0.30907556,2
2020-06-11-171025,171025,4,0,0,427,0.9,0.33346713,3
2020-06-12-171025,171025,0,0,1,427,1.6,0.18551315,4
2020-06-13-171025,171025,0,0,1,427,0.2,0.0053012567,5
2020-06-14-171025,171025,0,1,1,427,0.1,0.0039586592,6
2020-06-15-171025,171025,3,1,2,430,2.1,0.39000487,0
2020-06-16-171025,171025,3,0,1,433,1.7,0.44238096,1
2020-06-17-171025,171025,3,0,1,436,0.9,0.19733089,2
2020-06-18-171025,171025,2,0,0,438,1.1,0.30281132,3
2020-06-19-171025,171025,3,0,2,441,1.6,0.37536266,4
2020-06-20-171025,171025,1,1,0,442,0.2,0.05331033,5
2020-06-21-171025,171025,0,0,0,442,0.1,0.0041345092,6
2020-06-22-171025,171025,1,0,2,443,0.6,0.19153534,0
2020-06-23-171025,171025,3,0,2,446,0.9,0.25364608,1
2020-06-24-171025,171025,0,1,0,446,1.1,0.070567004,2
2020-06-25-171025,171025,0,0,0,446,0.6,0.06430608,3
2020-06-26-171025,171025,1,0,1,447,0.7,0.11919155,4
2020-06-27-171025,171025,1,0,0,448,0.0,0.047109038,5
2020-06-28-171025,171025,1,0,1,449,0.0,0.02709027,6
2020-06-29-171025,171025,2,0,2,451,1.1,0.19317803,0
2020-06-30-171025,171025,1,0,0,452,0.7,0.103528865,1
2020-07-01-171025,171025,1,0,0,453,0.6,0.118595615,2
2020-07-02-171025,171025,0,0,1,453,0.3,0.05835639,3
2020-07-03-171025,171025,2,0,4,455,0.8,0.12073179,4
2020-07-04-171025,171025,0,0,0,455,0.2,0.010710891,5
2020-07-05-171025,171025,0,0,0,455,0.0,0.009749106,6
2020-07-06-171025,171025,2,0,1,457,0.5,0.13930516,0
2020-07-07-171025,171025,2,0,2,459,0.3,0.1159491,1
2020-07-08-171025,171025,0,0,0,459,0.6,0.047316846,2
2020-07-09-171025,171025,0,0,2,459,0.4,0.029464902,3
2020-07-10-171025,171025,1,0,1,460,1.0,0.13051915,4
2020-07-11-171025,171025,0,0,1,460,0.2,0.006271605,5
2020-07-12-171025,171025,1,0,0,461,0.0,0.024875542,6
2020-07-13-171025,171025,2,0,4,463,0.3,0.13566123,0
2020-07-14-171025,171025,0,0,0,463,0.4,0.044482954,1
2020-07-15-171025,171025,0,0,1,463,0.9,0.06629939,2
2020-07-16-171025,171025,1,0,1,464,0.6,0.0450207,3
2020-07-17-171025,171025,4,0,3,468,0.6,0.21009794,4
2020-07-18-171025,171025,0,0,0,468,0.0,0.003018285,5
2020-07-19-171025,171025,0,0,1,468,0.2,0.023314415,6
2020-07-20-171025,171025,1,0,2,469,0.5,0.12452707,0
2020-07-21-171025,171025,2,0,1,471,0.7,0.18413202,1
2020-07-22-171025,171025,0,0,0,471,0.5,0.047425635,2
2020-07-23-171025,171025,2,0,1,473,0.5,0.19571199,3
2020-07-24-171025,171025,1,0,1,474,0.9,0.1474484,4
2020-07-25-171025,171025,1,0,3,475,0.0,0.033050116,5
2020-07-26-171025,171025,0,0,0,475,0.1,0.0051796003,6
2020-07-27-171025,171025,4,0,0,479,0.8,0.3984268,0
2020-07-28-171025,171025,0,0,1,479,0.8,0.094631895,1
2020-07-29-171025,171025,1,0,0,480,0.7,0.10713883,2
2020-07-30-171025,171025,1,0,0,481,1.2,0.1826492,3
2020-07-31-171025,171025,3,0,3,484,1.0,0.20012957,4
2020-08-01-171025,171025,0,0,0,484,0.4,0.03361867,5
2020-08-02-171025,171025,1,0,0,485,0.0,0.0457757,6
2020-08-03-171025,171025,2,0,2,487,0.6,0.14371176,0
2020-08-04-171025,171025,1,0,4,488,0.8,0.2439247,1
2020-08-05-171025,171025,0,0,3,488,2.5,0.58100873,2
2020-08-06-171025,171025,1,0,2,489,0.7,0.11295365,3
2020-08-07-171025,171025,1,0,8,490,1.8,0.108842954,4
2020-08-08-171025,171025,3,0,3,493,1.0,0.22521923,5
2020-08-09-171025,171025,0,1,0,493,1.1,0.05216509,6
2020-08-10-171025,171025,0,0,5,493,1.3,0.1410785,0
2020-08-11-171025,171025,1,0,17,494,2.9,0.49819458,1
2020-08-12-171025,171025,0,0,3,494,1.7,0.26440516,2
2020-08-13-171025,171025,0,0,21,494,2.9,0.45572385,3
2020-08-14-171025,171025,3,0,6,497,2.0,0.5888091,4
2020-08-15-171025,171025,0,0,0,497,0.8,0.11256415,5
2020-08-16-171025,171025,0,0,6,497,1.7,0.10200318,6
2020-08-17-171025,171025,2,0,2,499,2.2,0.42207697,0
2020-08-18-171025,171025,4,0,2,503,2.9,0.5214943,1
2020-08-19-171025,171025,3,0,4,506,2.5,0.43770474,2
2020-08-20-171025,171025,2,0,3,508,5.2,0.6425042,3
2020-08-21-171025,171025,8,0,1,516,4.1,0.7319584,4
2020-08-22-171025,171025,3,0,1,519,1.7,0.1768363,5
2020-08-23-171025,171025,0,0,1,519,3.1,0.09260773,6
2020-08-24-171025,171025,5,0,3,524,3.3,0.46787706,0
2020-08-25-171025,171025,17,1,4,541,5.0,1.1009582,1
2020-08-26-171025,171025,3,0,4,544,5.9,0.6062459,2
2020-08-27-171025,171025,21,0,11,565,7.1,1.0097727,3
2020-08-28-171025,171025,6,0,2,571,7.3,1.2389209,4
2020-08-29-171025,171025,0,0,2,571,2.0,0.18549967,5
2020-08-30-171025,171025,6,0,0,577,1.9,0.36883387,6
2020-08-31-171025,171025,2,0,4,579,3.7,0.48049182,0
2020-09-01-171025,171025,2,0,10,581,3.4,0.35633418,1
2020-09-02-171025,171025,4,0,3,585,4.1,0.43611744,2
2020-09-03-171025,171025,3,0,2,588,2.8,0.51288825,3
2020-09-04-171025,171025,1,0,6,589,3.7,0.59625417,4
2020-09-05-171025,171025,1,0,4,590,3.0,0.3020528,5
2020-09-06-171025,171025,1,0,1,591,5.2,0.3219272,6
2020-09-07-171025,171025,3,0,5,594,5.5,0.57597536,0
2020-09-08-171025,171025,4,0,4,598,3.3,0.7625007,1
2020-09-09-171025,171025,4,0,6,602,5.5,0.9218797,2
2020-09-10-171025,171025,11,1,10,613,8.8,1.4871743,3
2020-09-11-171025,171025,2,0,2,615,8.2,0.9049846,4
2020-09-12-171025,171025,2,0,2,617,2.7,0.38628688,5
2020-09-13-171025,171025,0,2,0,617,2.0,0.10877979,6
2020-09-14-171025,171025,4,1,1,621,9.1,1.0747329,0
2020-09-15-171025,171025,10,0,0,631,10.3,1.664028,1
2020-09-16-171025,171025,3,0,3,634,11.1,1.3076848,2
2020-09-17-171025,171025,2,0,5,636,9.8,1.4777321,3
2020-09-18-171025,171025,6,0,1,642,12.2,1.3686583,4
2020-09-19-171025,171025,4,0,1,646,9.9,1.6401265,5
2020-09-20-171025,171025,1,0,1,647,2.4,0.2600516,6
2020-09-21-171025,171025,5,1,3,652,8.0,0.95071864,0
2020-09-22-171025,171025,4,1,8,656,8.3,0.9271613,1
2020-09-23-171025,171025,6,0,3,662,7.8,1.1597383,2
2020-09-24-171025,171025,10,0,2,672,6.2,1.180533,3
2020-09-25-171025,171025,2,0,5,674,8.6,0.9643105,4
2020-09-26-171025,171025,2,0,5,676,4.6,0.59950894,5
2020-09-27-171025,171025,0,0,3,676,0.6,0.14591369,6
2020-09-28-171025,171025,1,0,3,677,4.0,0.4763168,0
2020-09-29-171025,171025,0,0,13,677,6.0,0.783172,1
2020-09-30-171025,171025,3,0,5,680,5.5,0.6662251,2
2020-10-01-171025,171025,5,0,5,685,5.8,1.0905043,3
2020-10-02-171025,171025,1,0,11,686,7.8,0.75667274,4
2020-10-03-171025,171025,1,2,9,687,1.6,0.2847622,5
2020-10-04-171025,171025,1,0,0,688,3.1,0.09674544,6
2020-10-05-171025,171025,3,0,1,691,4.0,0.7310808,0
2020-10-06-171025,171025,8,0,12,699,6.7,1.2083029,1
2020-10-07-171025,171025,3,1,3,702,5.4,1.038236,2
2020-10-08-171025,171025,2,0,5,704,4.5,1.396785,3
2020-10-09-171025,171025,5,1,19,709,6.6,1.0901093,4
2020-10-10-171025,171025,5,0,6,714,3.9,0.41061985,5
2020-10-11-171025,171025,3,0,0,717,1.0,0.17378215,6
2020-10-12-171025,171025,3,0,13,720,1.6,0.26441702,0
2020-10-13-171025,171025,13,0,11,733,4.8,0.9986381,1
2020-10-14-171025,171025,5,0,15,738,7.9,1.3342935,2
2020-10-15-171025,171025,5,0,9,743,4.1,0.9606046,3
2020-10-16-171025,171025,11,0,30,754,6.6,1.2819163,4
2020-10-17-171025,171025,9,0,7,763,1.7,0.52634656,5
2020-10-18-171025,171025,0,0,4,763,2.1,0.25510946,6
2020-10-19-171025,171025,1,0,0,764,5.5,0.7725392,0
2020-10-20-171025,171025,12,1,9,776,14.2,1.7635051,1
2020-10-21-171025,171025,3,0,16,779,9.8,1.27614,2
2020-10-22-171025,171025,5,0,5,784,13.6,1.0692134,3
2020-10-23-171025,171025,19,1,5,803,14.3,2.2193813,4
2020-10-24-171025,171025,6,0,2,809,3.2,0.6687351,5
2020-10-25-171025,171025,0,0,0,809,4.3,0.19210939,6
2020-10-26-171025,171025,13,0,1,822,11.5,1.6520388,0
2020-10-27-171025,171025,11,0,8,833,12.5,2.3957078,1
2020-10-28-171025,171025,15,0,9,848,14.1,2.0315855,2
2020-10-29-171025,171025,9,0,1,857,15.9,1.6608684,3
2020-10-30-171025,171025,30,0,1,887,16.3,2.6829445,4
2020-10-31-171025,171025,7,1,0,894,7.3,0.8695851,5
2020-11-01-171025,171025,4,0,0,898,7.3,0.4505834,6
2020-11-02-171025,171025,0,1,0,898,4.6,0.24800697,0
2020-11-03-171025,171025,9,0,0,907,14.1,1.3737334,1
2020-11-04-171025,171025,16,0,0,923,16.3,2.3632126,2
2020-11-05-171025,171025,5,0,0,928,20.5,2.4555168,3
2020-11-06-171025,171025,5,1,0,933,18.6,1.8032793,4
2020-11-07-171025,171025,2,0,0,935,9.0,0.7354194,5
2020-11-08-171025,171025,0,0,0,935,9.2,0.31258667,6
2020-11-09-171025,171025,1,1,0,936,12.8,0.9778496,0
2020-11-10-171025,171025,8,0,0,944,11.1,1.5670615,1
2020-11-11-171025,171025,9,1,0,953,10.2,1.4065484,2
2020-11-12-171025,171025,1,0,0,954,12.6,2.339034,3
2020-11-13-171025,171025,1,1,0,955,12.4,1.3231299,4
2020-03-01-171026,171026,0,0,0,0,0.0,0.0110301245,6
2020-03-02-171026,171026,0,0,7,0,0.0,0.002592686,0
2020-03-03-171026,171026,0,0,2,0,0.0,0.0003523754,1
2020-03-04-171026,171026,0,1,3,0,0.0,0.0014470589,2
2020-03-05-171026,171026,0,0,4,0,0.0,0.0027076695,3
2020-03-06-171026,171026,0,0,7,0,0.125,0.017052151,4
2020-03-07-171026,171026,0,1,1,0,0.0,0.0012517469,5
2020-03-08-171026,171026,0,0,0,0,0.125,0.004903572,6
2020-03-09-171026,171026,1,0,4,1,0.0,0.090173006,0
2020-03-10-171026,171026,1,0,3,2,0.375,0.069158204,1
2020-03-11-171026,171026,0,0,3,2,0.375,0.02389274,2
2020-03-12-171026,171026,1,0,6,3,0.25,0.06500985,3
2020-03-13-171026,171026,0,0,10,3,1.375,0.17582774,4
2020-03-14-171026,171026,1,0,4,4,0.5,0.06312806,5
2020-03-15-171026,171026,0,0,2,4,1.625,0.039650567,6
2020-03-16-171026,171026,7,0,2,11,4.0,0.69304734,0
2020-03-17-171026,171026,2,0,1,13,4.375,0.5099928,1
2020-03-18-171026,171026,3,1,6,16,5.75,0.57932514,2
2020-03-19-171026,171026,4,0,31,20,6.75,0.79769266,3
2020-03-20-171026,171026,7,0,5,27,7.25,0.80838627,4
2020-03-21-171026,171026,1,0,0,28,3.125,0.18434972,5
2020-03-22-171026,171026,0,0,1,28,2.375,0.12349252,6
2020-03-23-171026,171026,4,0,8,32,11.375,1.1645983,0
2020-03-24-171026,171026,3,0,4,35,7.5,0.68672705,1
2020-03-25-171026,171026,3,0,8,38,8.375,0.69692564,2
2020-03-26-171026,171026,6,0,6,44,8.25,0.8928262,3
2020-03-27-171026,171026,10,0,1,54,7.25,1.0197086,4
2020-03-28-171026,171026,4,0,1,58,1.75,0.20811844,5
2020-03-29-171026,171026,2,0,1,60,2.375,0.16246487,6
2020-03-30-171026,171026,2,0,5,62,6.0,0.5373814,0
2020-03-31-171026,171026,1,0,2,63,3.5,0.45744342,1
2020-04-01-171026,171026,6,0,3,69,5.125,0.6365997,2
2020-04-02-171026,171026,31,0,1,100,3.625,1.4300076,3
2020-04-03-171026,171026,5,0,0,105,7.5,0.98469526,4
2020-04-04-171026,171026,0,0,0,105,2.25,0.13372539,5
2020-04-05-171026,171026,1,0,1,106,2.75,0.12583064,6
2020-04-06-171026,171026,8,0,0,114,5.125,0.7571794,0
2020-04-07-171026,171026,4,0,1,118,4.625,0.71181005,1
2020-04-08-171026,171026,8,4,2,126,3.875,0.72361016,2
2020-04-09-171026,171026,6,0,0,132,3.5,0.5089915,3
2020-04-10-171026,171026,1,0,1,133,2.375,0.16649592,4
2020-04-11-171026,171026,1,0,0,134,1.25,0.19324268,5
2020-04-12-171026,171026,1,0,0,135,1.625,0.174588,6
2020-04-13-171026,171026,5,0,4,140,3.25,0.67358065,0
2020-04-14-171026,171026,2,0,0,142,2.625,0.43633595,1
2020-04-15-171026,171026,3,0,4,145,2.75,0.56997895,2
2020-04-16-171026,171026,1,0,3,146,3.25,0.36259028,3
2020-04-17-171026,171026,0,0,2,146,2.75,0.2126703,4
2020-04-18-171026,171026,0,0,0,146,0.625,0.029997462,5
2020-04-19-171026,171026,1,0,0,147,0.625,0.09731781,6
2020-04-20-171026,171026,0,1,3,147,3.0,0.39815167,0
2020-04-21-171026,171026,1,0,0,148,2.375,0.24566332,1
2020-04-22-171026,171026,2,0,3,150,2.375,0.25139305,2
2020-04-23-171026,171026,0,0,3,150,0.5,0.010155531,3
2020-04-24-171026,171026,1,0,0,151,2.0,0.2719349,4
2020-04-25-171026,171026,0,0,1,151,0.25,0.018549275,5
2020-04-26-171026,171026,0,0,1,151,0.75,0.07413152,6
2020-04-27-171026,171026,4,0,1,155,1.125,0.36889255,0
2020-04-28-171026,171026,0,0,1,155,2.25,0.22410195,1
2020-04-29-171026,171026,4,0,2,159,2.125,0.44167906,2
2020-04-30-171026,171026,3,0,0,162,1.625,0.17316864,3
2020-05-01-171026,171026,2,0,0,164,0.5,0.058863565,4
2020-05-02-171026,171026,0,0,0,164,0.5,0.04573106,5
2020-05-03-171026,171026,0,0,0,164,0.125,0.01840806,6
2020-05-04-171026,171026,3,0,3,167,1.875,0.20389333,0
2020-05-05-171026,171026,0,0,2,167,1.75,0.19497468,1
2020-05-06-171026,171026,3,0,0,170,3.5,0.5559185,2
2020-05-07-171026,171026,3,0,3,173,2.25,0.42012683,3
2020-05-08-171026,171026,0,0,3,173,1.75,0.31651416,4
2020-05-09-171026,171026,1,0,0,174,0.625,0.0936636,5
2020-05-10-171026,171026,1,0,0,175,0.5,0.06924658,6
2020-05-11-171026,171026,1,0,1,176,2.5,0.39284322,0
2020-05-12-171026,171026,1,0,0,177,1.125,0.22121955,1
2020-05-13-171026,171026,2,0,1,179,2.25,0.4424712,2
2020-05-14-171026,171026,0,0,1,179,1.75,0.25359622,3
2020-05-15-171026,171026,0,0,0,179,1.25,0.22424816,4
2020-05-16-171026,171026,0,0,0,179,0.75,0.03140772,5
2020-05-17-171026,171026,0,0,0,179,0.25,0.02183209,6
2020-05-18-171026,171026,3,0,1,182,1.625,0.3292775,0
2020-05-19-171026,171026,2,0,0,184,1.25,0.2502088,1
2020-05-20-171026,171026,0,0,0,184,1.25,0.17834765,2
2020-05-21-171026,171026,3,0,0,187,0.875,0.3128229,3
2020-05-22-171026,171026,3,0,0,190,1.125,0.3174914,4
2020-05-23-171026,171026,0,0,0,190,0.375,0.002210024,5
2020-05-24-171026,171026,0,0,0,190,0.0,0.01047443,6
2020-05-25-171026,171026,1,0,0,191,1.375,0.24939083,0
2020-05-26-171026,171026,0,0,1,191,1.0,0.15862045,1
2020-05-27-171026,171026,1,1,0,192,0.5,0.18533736,2
2020-05-28-171026,171026,1,0,0,193,0.5,0.15405841,3
2020-05-29-171026,171026,0,1,2,193,1.125,0.26196042,4
2020-05-30-171026,171026,0,0,0,193,0.375,0.03623464,5
2020-05-31-171026,171026,0,0,0,193,0.125,0.020236386,6
2020-06-01-171026,171026,1,1,4,194,2.0,0.36572674,0
2020-06-02-171026,171026,0,0,3,194,1.0,0.17721857,1
2020-06-03-171026,171026,0,0,0,194,0.875,0.16068716,2
2020-06-04-171026,171026,0,0,2,194,0.875,0.12432577,3
2020-06-05-171026,171026,0,0,1,194,0.75,0.0891442,4
2020-06-06-171026,171026,0,1,0,194,0.0,0.020586466,5
2020-06-07-171026,171026,0,0,0,194,0.0,0.0052445577,6
2020-06-08-171026,171026,0,0,1,194,0.875,0.2668405,0
2020-06-09-171026,171026,1,0,0,195,0.375,0.22777289,1
2020-06-10-171026,171026,0,0,0,195,1.0,0.25023168,2
2020-06-11-171026,171026,0,0,0,195,1.0,0.18337385,3
2020-06-12-171026,171026,2,0,0,197,0.75,0.16017738,4
2020-06-13-171026,171026,0,0,0,197,0.125,0.009267567,5
2020-06-14-171026,171026,0,1,0,197,0.0,0.0027798908,6
2020-06-15-171026,171026,4,0,1,201,1.125,0.29610232,0
2020-06-16-171026,171026,3,0,0,204,1.25,0.37216148,1
2020-06-17-171026,171026,0,0,0,204,1.0,0.12503725,2
2020-06-18-171026,171026,2,0,0,206,0.5,0.23076828,3
2020-06-19-171026,171026,1,0,0,207,0.875,0.23271868,4
2020-06-20-171026,171026,0,0,0,207,0.125,0.031395394,5
2020-06-21-171026,171026,0,0,0,207,0.0,0.0017729976,6
2020-06-22-171026,171026,1,0,0,208,0.5,0.13491867,0
2020-06-23-171026,171026,0,0,0,208,0.875,0.15448032,1
2020-06-24-171026,171026,0,0,0,208,0.75,0.034623705,2
2020-06-25-171026,171026,0,0,0,208,0.625,0.0491402,3
2020-06-26-171026,171026,0,0,1,208,0.375,0.082142815,4
2020-06-27-171026,171026,0,0,0,208,0.25,0.03876571,5
2020-06-28-171026,171026,0,0,0,208,0.125,0.027096365,6
2020-06-29-171026,171026,1,0,0,209,0.625,0.16371414,0
2020-06-30-171026,171026,0,1,0,209,0.5,0.06334963,1
2020-07-01-171026,171026,0,0,1,209,0.375,0.0898425,2
2020-07-02-171026,171026,0,0,0,209,0.25,0.04338318,3
2020-07-03-171026,171026,0,0,0,209,0.75,0.065286234,4
2020-07-04-171026,171026,0,0,0,209,0.125,0.0028353338,5
2020-07-05-171026,171026,0,0,0,209,0.0,0.024222143,6
2020-07-06-171026,171026,0,0,0,209,0.625,0.08928303,0
2020-07-07-171026,171026,0,0,0,209,0.625,0.098043576,1
2020-07-08-171026,171026,0,0,0,209,0.0,0.013851491,2
2020-07-09-171026,171026,0,0,0,209,0.25,0.021437507,3
2020-07-10-171026,171026,1,0,0,210,0.375,0.0995674,4
2020-07-11-171026,171026,0,0,0,210,0.0,0.0037196088,5
2020-07-12-171026,171026,0,0,0,210,0.125,0.022560606,6
2020-07-13-171026,171026,0,0,3,210,0.25,0.06709561,0
2020-07-14-171026,171026,0,0,1,210,0.5,0.030527541,1
2020-07-15-171026,171026,1,0,0,211,0.625,0.02446486,2
2020-07-16-171026,171026,0,0,0,211,0.375,0.01917258,3
2020-07-17-171026,171026,0,0,0,211,1.0,0.123479635,4
2020-07-18-171026,171026,0,0,0,211,0.0,0.0024672293,5
2020-07-19-171026,171026,0,0,0,211,0.0,0.017531589,6
2020-07-20-171026,171026,0,0,0,211,0.125,0.076328315,0
2020-07-21-171026,171026,0,1,2,211,0.625,0.1945052,1
2020-07-22-171026,171026,0,0,10,211,0.25,0.032940764,2
2020-07-23-171026,171026,0,0,0,211,0.75,0.29542586,3
2020-07-24-171026,171026,0,1,0,211,0.375,0.10001061,4
2020-07-25-171026,171026,0,0,2,211,0.125,0.021967273,5
2020-07-26-171026,171026,0,0,0,211,0.125,0.0035698363,6
2020-07-27-171026,171026,3,0,1,214,0.75,0.32193032,0
2020-07-28-171026,171026,1,0,3,215,0.125,0.06444256,1
2020-07-29-171026,171026,0,0,2,215,0.25,0.06258707,2
2020-07-30-171026,171026,0,0,2,215,1.0,0.12754515,3
2020-07-31-171026,171026,0,0,7,215,1.0,0.15543017,4
2020-08-01-171026,171026,0,0,1,215,0.0,0.0073162992,5
2020-08-02-171026,171026,0,0,1,215,0.125,0.038474105,6
2020-08-03-171026,171026,0,0,2,215,0.75,0.10429846,0
2020-08-04-171026,171026,2,0,4,217,0.625,0.16269267,1
2020-08-05-171026,171026,10,0,2,227,1.0,0.5394685,2
2020-08-06-171026,171026,0,0,1,227,0.875,0.085218675,3
2020-08-07-171026,171026,0,0,2,227,1.0,0.07961403,4
2020-08-08-171026,171026,2,0,0,229,0.625,0.20896561,5
2020-08-09-171026,171026,0,0,0,229,0.25,0.078964904,6
2020-08-10-171026,171026,1,0,0,230,0.875,0.14072385,0
2020-08-11-171026,171026,3,0,0,233,1.875,0.4439343,1
2020-08-12-171026,171026,2,0,0,235,1.375,0.18874782,2
2020-08-13-171026,171026,2,0,0,237,1.375,0.38112032,3
2020-08-14-171026,171026,7,0,4,244,1.75,0.504787,4
2020-08-15-171026,171026,1,0,0,245,0.25,0.1008714,5
2020-08-16-171026,171026,1,0,6,246,0.5,0.1195535,6
2020-08-17-171026,171026,2,0,0,248,2.5,0.33627352,0
2020-08-18-171026,171026,4,0,1,252,1.875,0.39671472,1
2020-08-19-171026,171026,2,0,0,254,1.375,0.30483162,2
2020-08-20-171026,171026,1,0,0,255,2.125,0.40874654,3
2020-08-21-171026,171026,2,0,0,257,3.0,0.44188738,4
2020-08-22-171026,171026,0,0,0,257,0.625,0.13256037,5
2020-08-23-171026,171026,0,0,4,257,0.875,0.0857358,6
2020-08-24-171026,171026,0,0,1,257,1.875,0.36306077,0
2020-08-25-171026,171026,0,0,2,257,4.0,0.6560281,1
2020-08-26-171026,171026,0,0,1,257,1.5,0.44147193,2
2020-08-27-171026,171026,0,0,0,257,5.5,0.69268996,3
2020-08-28-171026,171026,4,0,1,261,3.25,0.8514932,4
2020-08-29-171026,171026,0,0,1,261,0.375,0.16584498,5
2020-08-30-171026,171026,6,0,1,267,1.625,0.4075809,6
2020-08-31-171026,171026,0,0,9,267,1.25,0.3422062,0
2020-09-01-171026,171026,1,0,3,268,1.625,0.25853097,1
2020-09-02-171026,171026,0,0,3,268,2.375,0.3703797,2
2020-09-03-171026,171026,0,0,1,268,1.875,0.3168837,3
2020-09-04-171026,171026,0,0,4,268,3.125,0.49501282,4
2020-09-05-171026,171026,0,0,15,268,1.125,0.21408959,5
2020-09-06-171026,171026,4,0,5,272,1.375,0.290994,6
2020-09-07-171026,171026,1,0,2,273,3.75,0.44442558,0
2020-09-08-171026,171026,2,0,10,275,2.0,0.5001684,1
2020-09-09-171026,171026,1,0,3,276,2.125,0.5766517,2
2020-09-10-171026,171026,0,0,0,276,3.0,0.9312424,3
2020-09-11-171026,171026,1,0,2,277,2.75,0.58572054,4
2020-09-12-171026,171026,1,0,6,278,1.375,0.37098435,5
2020-09-13-171026,171026,1,0,1,279,1.125,0.094553225,6
2020-09-14-171026,171026,9,0,0,288,4.0,0.8468265,0
2020-09-15-171026,171026,3,0,3,291,3.125,1.0587428,1
2020-09-16-171026,171026,3,0,1,294,2.75,0.98951894,2
2020-09-17-171026,171026,1,0,1,295,7.25,1.1439182,3
2020-09-18-171026,171026,4,1,1,299,4.25,1.0572461,4
2020-09-19-171026,171026,15,0,3,314,1.75,1.6098417,5
2020-09-20-171026,171026,5,0,0,319,1.5,0.24159239,6
2020-09-21-171026,171026,2,1,5,321,3.75,0.54624856,0
2020-09-22-171026,171026,10,0,1,331,5.0,0.73619086,1
2020-09-23-171026,171026,3,0,5,334,3.875,0.82828766,2
2020-09-24-171026,171026,0,0,2,334,4.375,0.79745126,3
2020-09-25-171026,171026,2,0,3,336,3.625,0.86760366,4
2020-09-26-171026,171026,6,0,2,342,2.0,0.5084153,5
2020-09-27-171026,171026,1,0,1,343,0.875,0.20821288,6
2020-09-28-171026,171026,0,0,1,343,3.125,0.3271681,0
2020-09-29-171026,171026,3,0,3,346,1.75,0.5926466,1
2020-09-30-171026,171026,1,0,6,347,2.125,0.50964636,2
2020-10-01-171026,171026,1,0,0,348,4.25,0.71883875,3
2020-10-02-171026,171026,1,1,4,349,4.0,0.76048875,4
2020-10-03-171026,171026,3,0,0,352,0.75,0.2821678,5
2020-10-04-171026,171026,0,0,4,352,0.625,0.055700377,6
2020-10-05-171026,171026,5,0,1,357,3.375,0.5612585,0
2020-10-06-171026,171026,1,0,5,358,4.0,0.9254724,1
2020-10-07-171026,171026,5,1,6,363,2.625,0.89739037,2
2020-10-08-171026,171026,2,0,1,365,8.5,1.6283933,3
2020-10-09-171026,171026,3,0,1,368,4.75,1.071525,4
2020-10-10-171026,171026,2,0,3,370,3.75,0.54061854,5
2020-10-11-171026,171026,1,0,2,371,1.75,0.38421386,6
2020-10-12-171026,171026,1,0,4,372,1.125,0.20210475,0
2020-10-13-171026,171026,3,0,15,375,4.875,0.7524657,1
2020-10-14-171026,171026,6,0,7,381,9.125,1.20543,2
2020-10-15-171026,171026,0,0,2,381,3.125,0.8036493,3
2020-10-16-171026,171026,4,0,6,385,5.75,1.0513407,4
2020-10-17-171026,171026,0,0,7,385,2.625,0.3912006,5
2020-10-18-171026,171026,4,0,2,389,2.125,0.4392584,6
2020-10-19-171026,171026,1,0,1,390,6.375,0.5860181,0
2020-10-20-171026,171026,5,0,4,395,9.0,1.180401,1
2020-10-21-171026,171026,6,0,7,401,7.375,1.0270747,2
2020-10-22-171026,171026,1,0,2,402,8.875,0.8051081,3
2020-10-23-171026,171026,1,0,7,403,14.25,1.593366,4
2020-10-24-171026,171026,3,0,6,406,5.0,0.580301,5
2020-10-25-171026,171026,2,0,2,408,2.5,0.25433958,6
2020-10-26-171026,171026,4,0,2,412,9.25,1.0340339,0
2020-10-27-171026,171026,15,0,8,427,9.0,2.3201056,1
2020-10-28-171026,171026,7,0,7,434,12.375,1.4542764,2
2020-10-29-171026,171026,2,0,6,436,6.5,0.9485973,3
2020-10-30-171026,171026,6,0,7,442,14.375,1.8587989,4
2020-10-31-171026,171026,7,0,0,449,4.875,0.75428313,5
2020-11-01-171026,171026,2,1,0,451,2.25,0.31406805,6
2020-11-02-171026,171026,1,0,0,452,1.0,0.21188389,0
2020-11-03-171026,171026,4,0,0,456,6.625,0.9641031,1
2020-11-04-171026,171026,7,0,0,463,9.5,1.6104004,2
2020-11-05-171026,171026,2,1,0,465,9.375,1.454841,3
2020-11-06-171026,171026,7,0,0,472,9.625,1.6027329,4
2020-11-07-171026,171026,6,0,0,478,9.375,0.7522757,5
2020-11-08-171026,171026,2,1,0,480,0.875,0.21285157,6
2020-11-09-171026,171026,2,0,0,482,6.5,0.6704374,0
2020-11-10-171026,171026,8,0,0,490,4.875,1.1730006,1
2020-11-11-171026,171026,7,1,0,497,6.875,1.1565647,2
2020-11-12-171026,171026,6,0,0,503,4.25,2.6460483,3
2020-11-13-171026,171026,7,0,0,510,6.5,1.0380151,4
2020-03-01-171101,171101,0,0,0,0,0.0,1.989733e-05,6
2020-03-02-171101,171101,0,0,5,0,0.3333333333333333,0.12133876,0
2020-03-03-171101,171101,0,0,12,0,0.3333333333333333,9.257032e-05,1
2020-03-04-171101,171101,0,0,5,0,0.0,0.0019943886,2
2020-03-05-171101,171101,0,0,11,0,0.3333333333333333,0.00029434924,3
2020-03-06-171101,171101,0,0,5,0,0.3333333333333333,8.624788e-05,4
2020-03-07-171101,171101,0,0,4,0,0.3333333333333333,0.124988034,5
2020-03-08-171101,171101,0,0,2,0,0.3333333333333333,0.00012674532,6
2020-03-09-171101,171101,0,0,20,0,0.3333333333333333,0.14084257,0
2020-03-10-171101,171101,0,0,10,0,0.0,0.00073903764,1
2020-03-11-171101,171101,1,0,19,1,0.6666666666666666,0.28218913,2
2020-03-12-171101,171101,1,0,17,2,1.6666666666666667,0.42744958,3
2020-03-13-171101,171101,3,0,12,5,1.0,0.15411305,4
2020-03-14-171101,171101,3,0,1,8,0.3333333333333333,0.0886406,5
2020-03-15-171101,171101,0,0,2,8,0.3333333333333333,0.0017873885,6
2020-03-16-171101,171101,5,0,8,13,4.333333333333333,0.32816204,0
2020-03-17-171101,171101,12,0,6,25,6.333333333333332,0.09848373,1
2020-03-18-171101,171101,5,0,6,30,11.666666666666664,0.15166323,2
2020-03-19-171101,171101,11,0,6,41,11.666666666666664,0.19201702,3
2020-03-20-171101,171101,5,0,4,46,14.666666666666664,0.34038115,4
2020-03-21-171101,171101,4,0,1,50,2.6666666666666665,0.0181924,5
2020-03-22-171101,171101,2,0,1,52,0.6666666666666666,0.043816477,6
2020-03-23-171101,171101,20,0,3,72,15.0,0.23909491,0
2020-03-24-171101,171101,10,0,8,82,10.0,0.14763214,1
2020-03-25-171101,171101,19,0,6,101,8.333333333333334,0.37844908,2
2020-03-26-171101,171101,17,0,2,118,8.666666666666666,0.2173487,3
2020-03-27-171101,171101,12,0,3,130,10.666666666666666,0.41628134,4
2020-03-28-171101,171101,1,0,0,131,0.6666666666666666,0.0021354419,5
2020-03-29-171101,171101,2,0,1,133,1.0,0.00849002,6
2020-03-30-171101,171101,8,0,8,141,9.666666666666666,0.3699151,0
2020-03-31-171101,171101,6,0,4,147,5.0,0.03524342,1
2020-04-01-171101,171101,6,0,3,153,6.0,0.44353122,2
2020-04-02-171101,171101,6,0,3,159,3.333333333333333,0.15979168,3
2020-04-03-171101,171101,4,0,3,163,3.6666666666666665,0.1179257,4
2020-04-04-171101,171101,1,0,2,164,2.0,0.052987013,5
2020-04-05-171101,171101,1,1,0,165,1.0,0.048324615,6
2020-04-06-171101,171101,3,0,5,168,6.333333333333332,0.3291936,0
2020-04-07-171101,171101,8,1,5,176,3.0,0.03195478,1
2020-04-08-171101,171101,6,1,5,182,2.333333333333333,0.16612116,2
2020-04-09-171101,171101,2,1,1,184,1.6666666666666667,0.024400678,3
2020-04-10-171101,171101,3,0,5,187,1.6666666666666667,0.0084321685,4
2020-04-11-171101,171101,0,0,0,187,0.3333333333333333,0.08132379,5
2020-04-12-171101,171101,1,0,2,188,0.0,0.0140693,6
2020-04-13-171101,171101,8,1,5,196,1.6666666666666667,0.0693468,0
2020-04-14-171101,171101,4,0,5,200,4.333333333333333,0.03640663,1
2020-04-15-171101,171101,3,0,3,203,5.0,0.0842201,2
2020-04-16-171101,171101,3,0,3,206,2.0,0.16237082,3
2020-04-17-171101,171101,3,0,0,209,6.333333333333332,0.20072874,4
2020-04-18-171101,171101,2,0,0,211,0.0,0.008277984,5
2020-04-19-171101,171101,0,0,0,211,0.3333333333333333,0.0067380173,6
2020-04-20-171101,171101,5,1,4,216,5.0,0.10154448,0
2020-04-21-171101,171101,5,0,3,221,1.6666666666666667,0.08431131,1
2020-04-22-171101,171101,5,0,30,226,2.333333333333333,0.015234918,2
2020-04-23-171101,171101,1,0,4,227,0.0,0.004133827,3
2020-04-24-171101,171101,5,0,4,232,4.666666666666667,0.17981671,4
2020-04-25-171101,171101,0,0,1,232,0.6666666666666666,0.018725254,5
2020-04-26-171101,171101,2,0,0,234,0.6666666666666666,0.00047527906,6
2020-04-27-171101,171101,5,0,3,239,5.666666666666668,0.51067287,0
2020-04-28-171101,171101,5,0,8,244,5.0,0.17794622,1
2020-04-29-171101,171101,3,0,7,247,4.666666666666667,0.11182454,2
2020-04-30-171101,171101,3,0,5,250,6.0,0.37505984,3
2020-05-01-171101,171101,0,0,6,250,0.3333333333333333,0.012606895,4
2020-05-02-171101,171101,0,0,1,250,0.0,0.023981337,5
2020-05-03-171101,171101,0,0,0,250,0.0,0.002636136,6
2020-05-04-171101,171101,4,0,5,254,5.333333333333333,0.55081093,0
2020-05-05-171101,171101,3,0,1,257,5.333333333333333,0.22641775,1
2020-05-06-171101,171101,30,0,4,287,4.666666666666667,0.16793184,2
2020-05-07-171101,171101,4,0,1,291,3.0,0.25702536,3
2020-05-08-171101,171101,4,0,3,295,6.0,0.15507159,4
2020-05-09-171101,171101,1,0,4,296,0.3333333333333333,0.07788164,5
2020-05-10-171101,171101,0,0,0,296,0.0,0.00016986759,6
2020-05-11-171101,171101,3,1,2,299,5.333333333333333,0.19275361,0
2020-05-12-171101,171101,8,1,2,307,5.666666666666668,0.24926257,1
2020-05-13-171101,171101,7,0,0,314,4.0,0.24873596,2
2020-05-14-171101,171101,5,0,2,319,3.333333333333333,0.16569212,3
2020-05-15-171101,171101,6,0,0,325,5.333333333333333,0.18729039,4
2020-05-16-171101,171101,1,0,0,326,1.3333333333333333,0.08838937,5
2020-05-17-171101,171101,0,0,0,326,0.0,3.8981616e-05,6
2020-05-18-171101,171101,5,0,0,331,2.6666666666666665,0.034420326,0
2020-05-19-171101,171101,1,0,1,332,2.333333333333333,0.4452262,1
2020-05-20-171101,171101,4,0,3,336,2.0,0.13092606,2
2020-05-21-171101,171101,1,0,0,337,5.0,0.72806114,3
2020-05-22-171101,171101,3,0,3,340,5.0,0.017642703,4
2020-05-23-171101,171101,4,0,0,344,0.6666666666666666,0.00025898824,5
2020-05-24-171101,171101,0,0,0,344,0.0,0.00910995,6
2020-05-25-171101,171101,2,0,3,346,3.333333333333333,0.3857394,0
2020-05-26-171101,171101,2,0,0,348,3.333333333333333,0.21638447,1
2020-05-27-171101,171101,0,0,1,348,1.6666666666666667,0.18641824,2
2020-05-28-171101,171101,2,1,0,350,0.0,0.032738112,3
2020-05-29-171101,171101,0,0,0,350,2.0,0.19345394,4
2020-05-30-171101,171101,0,0,0,350,0.0,7.526124e-05,5
2020-05-31-171101,171101,0,0,0,350,0.0,0.00029261105,6
2020-06-01-171101,171101,0,0,5,350,0.0,0.0015812104,0
2020-06-02-171101,171101,1,0,0,351,0.6666666666666666,0.016244048,1
2020-06-03-171101,171101,3,0,0,354,1.0,0.0046814955,2
2020-06-04-171101,171101,0,0,0,354,1.6666666666666667,0.10515012,3
2020-06-05-171101,171101,3,0,0,357,0.6666666666666666,0.0057821767,4
2020-06-06-171101,171101,0,0,0,357,0.0,0.019332547,5
2020-06-07-171101,171101,0,0,0,357,0.0,7.7113225e-05,6
2020-06-08-171101,171101,3,0,0,360,1.6666666666666667,0.3969196,0
2020-06-09-171101,171101,0,0,0,360,2.0,0.10365416,1
2020-06-10-171101,171101,1,0,2,361,0.3333333333333333,0.053666458,2
2020-06-11-171101,171101,0,0,1,361,0.6666666666666666,0.30006105,3
2020-06-12-171101,171101,0,0,0,361,0.6666666666666666,0.021419307,4
2020-06-13-171101,171101,0,2,0,361,0.0,0.00031700707,5
2020-06-14-171101,171101,0,1,0,361,0.0,1.1013611e-06,6
2020-06-15-171101,171101,5,0,1,366,1.6666666666666667,0.10160603,0
2020-06-16-171101,171101,0,0,0,366,0.6666666666666666,0.0016931039,1
2020-06-17-171101,171101,0,0,0,366,0.0,0.0041959267,2
2020-06-18-171101,171101,0,0,0,366,1.0,0.0066984147,3
2020-06-19-171101,171101,0,0,0,366,2.333333333333333,0.23712367,4
2020-06-20-171101,171101,0,0,0,366,0.0,0.0063999714,5
2020-06-21-171101,171101,0,0,0,366,0.0,4.2758533e-05,6
2020-06-22-171101,171101,0,0,1,366,0.6666666666666666,0.0012142048,0
2020-06-23-171101,171101,0,0,0,366,0.6666666666666666,0.005280234,1
2020-06-24-171101,171101,2,0,0,368,0.0,0.008167457,2
2020-06-25-171101,171101,1,0,0,369,0.3333333333333333,0.007585805,3
2020-06-26-171101,171101,0,0,0,369,0.6666666666666666,0.023308141,4
2020-06-27-171101,171101,0,0,0,369,0.3333333333333333,0.00063244655,5
2020-06-28-171101,171101,0,0,1,369,0.0,0.0025091695,6
2020-06-29-171101,171101,1,0,0,370,0.0,0.0032989015,0
2020-06-30-171101,171101,0,0,0,370,0.3333333333333333,0.005584112,1
2020-07-01-171101,171101,0,0,0,370,0.0,0.0012753576,2
2020-07-02-171101,171101,0,0,0,370,0.3333333333333333,0.0065081255,3
2020-07-03-171101,171101,0,0,0,370,0.6666666666666666,0.0028645773,4
2020-07-04-171101,171101,0,0,0,370,0.0,0.0020657831,5
2020-07-05-171101,171101,0,0,0,370,0.0,0.0008253125,6
2020-07-06-171101,171101,1,0,0,371,0.3333333333333333,0.10461665,0
2020-07-07-171101,171101,0,0,0,371,0.0,0.0002050448,1
2020-07-08-171101,171101,0,0,0,371,0.0,0.0006580337,2
2020-07-09-171101,171101,0,0,0,371,0.3333333333333333,0.0014630994,3
2020-07-10-171101,171101,0,0,0,371,0.0,0.05167292,4
2020-07-11-171101,171101,0,0,0,371,0.0,6.1999956e-05,5
2020-07-12-171101,171101,1,0,0,372,0.0,7.797237e-05,6
2020-07-13-171101,171101,0,0,0,372,0.3333333333333333,0.004134444,0
2020-07-14-171101,171101,0,0,0,372,0.0,0.0066491,1
2020-07-15-171101,171101,0,0,0,372,0.3333333333333333,0.00030163283,2
2020-07-16-171101,171101,0,0,0,372,0.0,0.0024111182,3
2020-07-17-171101,171101,0,0,2,372,0.6666666666666666,0.0029740813,4
2020-07-18-171101,171101,0,0,0,372,0.0,0.005940252,5
2020-07-19-171101,171101,0,0,0,372,0.0,0.00017037656,6
2020-07-20-171101,171101,0,0,1,372,0.0,0.0017308469,0
2020-07-21-171101,171101,0,0,0,372,0.0,0.001745474,1
2020-07-22-171101,171101,0,0,0,372,0.3333333333333333,0.0068168025,2
2020-07-23-171101,171101,0,0,0,372,0.0,0.0039239945,3
2020-07-24-171101,171101,0,0,0,372,0.0,0.003211311,4
2020-07-25-171101,171101,0,0,0,372,0.0,6.440347e-05,5
2020-07-26-171101,171101,0,0,0,372,0.0,5.6847322e-05,6
2020-07-27-171101,171101,0,0,3,372,0.6666666666666666,0.10568325,0
2020-07-28-171101,171101,0,0,2,372,0.0,0.0013743007,1
2020-07-29-171101,171101,0,0,2,372,0.0,0.006129248,2
2020-07-30-171101,171101,0,0,0,372,0.3333333333333333,0.012820469,3
2020-07-31-171101,171101,2,0,1,374,2.0,0.21240428,4
2020-08-01-171101,171101,0,0,0,374,0.6666666666666666,0.0008130723,5
2020-08-02-171101,171101,0,0,0,374,0.0,0.0015139338,6
2020-08-03-171101,171101,1,0,2,375,1.6666666666666667,0.030763213,0
2020-08-04-171101,171101,0,0,13,375,0.3333333333333333,0.0040165675,1
2020-08-05-171101,171101,0,0,1,375,0.0,0.0041313223,2
2020-08-06-171101,171101,0,0,2,375,1.0,0.0029879734,3
2020-08-07-171101,171101,0,0,1,375,0.6666666666666666,0.14000238,4
2020-08-08-171101,171101,0,0,0,375,0.3333333333333333,0.0019335638,5
2020-08-09-171101,171101,0,0,0,375,0.0,0.024963131,6
2020-08-10-171101,171101,3,1,3,378,1.6666666666666667,0.026401732,0
2020-08-11-171101,171101,2,0,3,380,0.6666666666666666,0.071493305,1
2020-08-12-171101,171101,2,0,2,382,2.6666666666666665,0.11754572,2
2020-08-13-171101,171101,0,0,2,382,0.3333333333333333,0.8382233,3
2020-08-14-171101,171101,1,0,2,383,2.0,0.3052069,4
2020-08-15-171101,171101,0,0,0,383,0.6666666666666666,0.019349493,5
2020-08-16-171101,171101,0,0,1,383,2.0,0.010397849,6
2020-08-17-171101,171101,2,0,1,385,0.3333333333333333,0.04970511,0
2020-08-18-171101,171101,13,0,0,398,3.333333333333333,0.89560455,1
2020-08-19-171101,171101,1,0,2,399,0.3333333333333333,0.018713688,2
2020-08-20-171101,171101,2,0,2,401,0.6666666666666666,0.025010187,3
2020-08-21-171101,171101,1,0,6,402,2.0,0.13650036,4
2020-08-22-171101,171101,0,0,1,402,0.0,0.04820177,5
2020-08-23-171101,171101,0,0,3,402,0.0,0.01236738,6
2020-08-24-171101,171101,3,0,1,405,2.0,0.3018073,0
2020-08-25-171101,171101,3,0,9,408,2.6666666666666665,0.037774518,1
2020-08-26-171101,171101,2,0,0,410,1.0,0.13237087,2
2020-08-27-171101,171101,2,0,11,412,1.6666666666666667,0.09965004,3
2020-08-28-171101,171101,2,0,1,414,1.0,0.11788377,4
2020-08-29-171101,171101,0,0,4,414,0.6666666666666666,0.13750948,5
2020-08-30-171101,171101,1,0,0,415,0.6666666666666666,0.0059442325,6
2020-08-31-171101,171101,1,0,1,416,2.0,0.03496284,0
2020-09-01-171101,171101,0,0,3,416,2.333333333333333,0.46647573,1
2020-09-02-171101,171101,2,0,0,418,5.0,0.33398366,2
2020-09-03-171101,171101,2,0,6,420,0.6666666666666666,0.035376135,3
2020-09-04-171101,171101,6,0,9,426,2.6666666666666665,0.3760174,4
2020-09-05-171101,171101,1,0,1,427,2.0,0.024042305,5
2020-09-06-171101,171101,3,0,3,430,2.0,0.08249636,6
2020-09-07-171101,171101,1,0,3,431,2.0,0.1795361,0
2020-09-08-171101,171101,9,0,3,440,5.666666666666668,0.36466894,1
2020-09-09-171101,171101,0,0,4,440,0.3333333333333333,0.031962026,2
2020-09-10-171101,171101,11,0,3,451,5.0,0.62691957,3
2020-09-11-171101,171101,1,0,6,452,1.3333333333333333,0.3924885,4
2020-09-12-171101,171101,4,0,8,456,3.0,0.12311924,5
2020-09-13-171101,171101,0,0,4,456,2.0,0.07666972,6
2020-09-14-171101,171101,1,0,1,457,6.0,0.53137714,0
2020-09-15-171101,171101,3,0,3,460,4.0,0.36973143,1
2020-09-16-171101,171101,0,0,6,460,4.333333333333333,0.6968502,2
2020-09-17-171101,171101,6,0,11,466,6.666666666666668,1.581253,3
2020-09-18-171101,171101,9,0,8,475,7.333333333333332,1.0212047,4
2020-09-19-171101,171101,1,0,0,476,3.333333333333333,0.08024404,5
2020-09-20-171101,171101,3,0,1,479,2.333333333333333,0.12690857,6
2020-09-21-171101,171101,3,0,3,482,4.666666666666667,0.26254475,0
2020-09-22-171101,171101,3,0,3,485,1.3333333333333333,0.0912862,1
2020-09-23-171101,171101,4,0,4,489,6.0,0.3167812,2
2020-09-24-171101,171101,3,0,2,492,2.6666666666666665,0.40491182,3
2020-09-25-171101,171101,6,0,5,498,4.333333333333333,0.26935968,4
2020-09-26-171101,171101,8,0,1,506,2.0,0.16930974,5
2020-09-27-171101,171101,4,0,0,510,2.333333333333333,0.63343835,6
2020-09-28-171101,171101,1,0,4,511,2.0,0.07992624,0
2020-09-29-171101,171101,3,0,0,514,1.0,0.060161997,1
2020-09-30-171101,171101,6,0,12,520,2.6666666666666665,0.2472822,2
2020-10-01-171101,171101,11,0,6,531,3.0,0.18113899,3
2020-10-02-171101,171101,8,0,12,539,1.6666666666666667,0.42630875,4
2020-10-03-171101,171101,0,0,1,539,0.6666666666666666,0.23580235,5
2020-10-04-171101,171101,1,0,0,540,0.0,0.034068815,6
2020-10-05-171101,171101,3,1,16,543,1.6666666666666667,0.09360215,0
2020-10-06-171101,171101,3,0,2,546,5.333333333333333,0.87594813,1
2020-10-07-171101,171101,4,1,14,550,3.0,0.24827547,2
2020-10-08-171101,171101,2,0,7,552,1.6666666666666667,0.33960998,3
2020-10-09-171101,171101,5,2,19,557,3.333333333333333,0.3775121,4
2020-10-10-171101,171101,1,0,5,558,1.0,0.30693975,5
2020-10-11-171101,171101,0,0,1,558,1.6666666666666667,0.33680898,6
2020-10-12-171101,171101,4,0,9,562,0.3333333333333333,0.102238804,0
2020-10-13-171101,171101,0,0,9,562,3.333333333333333,0.144959,1
2020-10-14-171101,171101,12,0,6,574,3.333333333333333,1.5499157,2
2020-10-15-171101,171101,6,0,4,580,4.333333333333333,0.80123127,3
2020-10-16-171101,171101,12,0,18,592,14.333333333333336,4.1973457,4
2020-10-17-171101,171101,1,1,5,593,2.6666666666666665,0.32648355,5
2020-10-18-171101,171101,0,0,5,593,3.6666666666666665,0.36198306,6
2020-10-19-171101,171101,16,0,2,609,7.333333333333332,0.49708518,0
2020-10-20-171101,171101,2,1,16,611,12.666666666666664,1.93683,1
2020-10-21-171101,171101,14,0,13,625,7.0,0.7431704,2
2020-10-22-171101,171101,7,0,11,632,11.0,1.16879,3
2020-10-23-171101,171101,19,1,20,651,14.333333333333336,1.6051917,4
2020-10-24-171101,171101,5,0,9,656,9.333333333333334,0.30788386,5
2020-10-25-171101,171101,1,0,4,657,2.333333333333333,0.23608217,6
2020-10-26-171101,171101,9,0,13,666,16.666666666666668,1.3849136,0
2020-10-27-171101,171101,9,0,14,675,8.666666666666666,0.5502093,1
2020-10-28-171101,171101,6,0,10,681,7.666666666666668,0.9082268,2
2020-10-29-171101,171101,4,0,8,685,10.0,1.3432292,3
2020-10-30-171101,171101,18,0,18,703,19.666666666666668,3.354384,4
2020-10-31-171101,171101,5,0,0,708,1.0,0.2654071,5
2020-11-01-171101,171101,5,0,0,713,4.666666666666667,0.24434148,6
2020-11-02-171101,171101,2,1,0,715,3.333333333333333,0.36307606,0
2020-11-03-171101,171101,16,0,0,731,10.0,1.250951,1
2020-11-04-171101,171101,13,0,0,744,15.0,1.7961054,2
2020-11-05-171101,171101,11,0,0,755,16.0,1.9198806,3
2020-11-06-171101,171101,20,2,0,775,29.66666666666667,4.702571,4
2020-11-07-171101,171101,9,0,0,784,4.0,0.14269423,5
2020-11-08-171101,171101,4,0,0,788,3.0,0.16782853,6
2020-11-09-171101,171101,13,0,0,801,21.33333333333333,1.7753496,0
2020-11-10-171101,171101,14,0,0,815,20.0,0.7881637,1
2020-11-11-171101,171101,10,3,0,825,9.333333333333334,1.3021731,2
2020-11-12-171101,171101,8,0,0,833,10.333333333333334,0.7776109,3
2020-11-13-171101,171101,18,0,0,851,8.0,0.33053258,4
2020-03-01-171102,171102,0,0,0,0,0.0,4.391475e-09,6
2020-03-02-171102,171102,0,0,0,0,0.0,0.026785202,0
2020-03-03-171102,171102,0,0,2,0,0.0,0.00019635394,1
2020-03-04-171102,171102,0,0,0,0,0.0,0.001487932,2
2020-03-05-171102,171102,0,0,0,0,0.0,5.803204e-08,3
2020-03-06-171102,171102,0,0,0,0,0.0,0.0010674745,4
2020-03-07-171102,171102,0,0,0,0,0.4,0.13689412,5
2020-03-08-171102,171102,0,0,0,0,0.0,8.774729e-06,6
2020-03-09-171102,171102,0,0,0,0,0.2,0.04529719,0
2020-03-10-171102,171102,0,0,0,0,0.0,0.004854692,1
2020-03-11-171102,171102,0,0,1,0,0.2,0.073037386,2
2020-03-12-171102,171102,0,0,1,0,0.6,0.1368725,3
2020-03-13-171102,171102,0,0,2,0,0.4,0.14532562,4
2020-03-14-171102,171102,0,0,0,0,0.4,0.11484774,5
2020-03-15-171102,171102,0,0,1,0,0.0,0.0014568062,6
2020-03-16-171102,171102,0,0,0,0,0.6,0.12675881,0
2020-03-17-171102,171102,2,0,1,2,0.6,0.41741616,1
2020-03-18-171102,171102,0,0,2,2,1.2,0.34271175,2
2020-03-19-171102,171102,0,0,1,2,1.6,0.42683518,3
2020-03-20-171102,171102,0,1,0,2,0.6,0.34564406,4
2020-03-21-171102,171102,0,0,3,2,0.8,0.1505962,5
2020-03-22-171102,171102,0,0,0,2,0.0,0.007996885,6
2020-03-23-171102,171102,0,0,1,2,2.0,0.37701473,0
2020-03-24-171102,171102,0,0,1,2,0.2,0.062361963,1
2020-03-25-171102,171102,1,0,0,3,1.2,0.36159688,2
2020-03-26-171102,171102,1,0,0,4,0.6,0.23114176,3
2020-03-27-171102,171102,2,0,0,6,1.6,0.756661,4
2020-03-28-171102,171102,0,0,0,6,0.2,0.0064325845,5
2020-03-29-171102,171102,1,0,0,7,0.4,0.08696595,6
2020-03-30-171102,171102,0,0,0,7,1.4,0.23252955,0
2020-03-31-171102,171102,1,0,3,8,0.8,0.20027168,1
2020-04-01-171102,171102,2,0,0,10,2.0,0.75405824,2
2020-04-02-171102,171102,1,0,0,11,1.4,0.2683176,3
2020-04-03-171102,171102,0,0,0,11,2.0,0.5151337,4
2020-04-04-171102,171102,3,0,0,14,0.2,0.3181848,5
2020-04-05-171102,171102,0,0,1,14,0.2,0.019203847,6
2020-04-06-171102,171102,1,0,1,15,1.4,0.28925622,0
2020-04-07-171102,171102,1,0,1,16,0.4,0.2500435,1
2020-04-08-171102,171102,0,0,0,16,1.8,0.15714046,2
2020-04-09-171102,171102,0,0,0,16,0.6,0.061117575,3
2020-04-10-171102,171102,0,0,1,16,0.6,0.023562994,4
2020-04-11-171102,171102,0,0,0,16,0.6,0.034682687,5
2020-04-12-171102,171102,0,1,0,16,0.6,0.021657562,6
2020-04-13-171102,171102,0,0,0,16,1.2,0.11159238,0
2020-04-14-171102,171102,3,0,0,19,0.2,0.44548088,1
2020-04-15-171102,171102,0,0,0,19,0.2,0.03908777,2
2020-04-16-171102,171102,0,0,0,19,3.8,0.19799235,3
2020-04-17-171102,171102,0,1,0,19,0.8,0.16873802,4
2020-04-18-171102,171102,0,0,0,19,0.0,0.012656584,5
2020-04-19-171102,171102,1,0,0,20,0.2,0.08778949,6
2020-04-20-171102,171102,1,1,0,21,0.8,0.18913315,0
2020-04-21-171102,171102,1,0,0,22,0.2,0.25021818,1
2020-04-22-171102,171102,0,0,0,22,0.0,0.03172354,2
2020-04-23-171102,171102,0,0,0,22,0.2,0.02678105,3
2020-04-24-171102,171102,1,0,0,23,0.8,0.25298387,4
2020-04-25-171102,171102,0,0,0,23,0.6,0.026783459,5
2020-04-26-171102,171102,0,0,0,23,0.0,0.00043857584,6
2020-04-27-171102,171102,0,0,0,23,0.8,0.13299094,0
2020-04-28-171102,171102,0,0,0,23,0.8,0.15561265,1
2020-04-29-171102,171102,0,0,0,23,1.2,0.13428304,2
2020-04-30-171102,171102,0,0,0,23,1.4,0.13912712,3
2020-05-01-171102,171102,0,0,1,23,0.4,0.01955332,4
2020-05-02-171102,171102,0,0,0,23,0.8,0.044385992,5
2020-05-03-171102,171102,0,0,0,23,0.2,0.0069901412,6
2020-05-04-171102,171102,0,0,1,23,0.2,0.19870359,0
2020-05-05-171102,171102,0,0,0,23,2.2,0.23875394,1
2020-05-06-171102,171102,0,0,0,23,1.2,0.20197968,2
2020-05-07-171102,171102,0,0,0,23,1.0,0.18917744,3
2020-05-08-171102,171102,0,0,0,23,1.8,0.12497581,4
2020-05-09-171102,171102,0,0,0,23,0.2,0.020263867,5
2020-05-10-171102,171102,0,1,0,23,0.0,0.003379484,6
2020-05-11-171102,171102,0,0,0,23,0.4,0.14060453,0
2020-05-12-171102,171102,0,0,1,23,1.4,0.36324248,1
2020-05-13-171102,171102,0,0,0,23,1.4,0.226966,2
2020-05-14-171102,171102,0,0,0,23,0.2,0.2602023,3
2020-05-15-171102,171102,1,1,0,24,0.4,0.4455863,4
2020-05-16-171102,171102,0,0,0,24,0.6,0.036336645,5
2020-05-17-171102,171102,0,0,0,24,0.0,6.2652536e-05,6
2020-05-18-171102,171102,1,0,0,25,0.6,0.4743619,0
2020-05-19-171102,171102,0,0,0,25,0.4,0.33229616,1
2020-05-20-171102,171102,0,0,0,25,0.2,0.06209255,2
2020-05-21-171102,171102,0,0,0,25,0.0,0.14582124,3
2020-05-22-171102,171102,0,0,0,25,0.0,0.037099127,4
2020-05-23-171102,171102,0,0,0,25,0.0,3.4102613e-05,5
2020-05-24-171102,171102,0,0,0,25,0.2,0.01116498,6
2020-05-25-171102,171102,0,1,0,25,0.0,0.110683426,0
2020-05-26-171102,171102,1,0,0,26,1.4,0.37727952,1
2020-05-27-171102,171102,0,0,0,26,0.0,0.039305184,2
2020-05-28-171102,171102,0,2,0,26,0.2,0.11904127,3
2020-05-29-171102,171102,0,0,0,26,0.0,0.05975922,4
2020-05-30-171102,171102,0,0,0,26,0.0,1.5526409e-06,5
2020-05-31-171102,171102,0,0,0,26,0.0,0.004317069,6
2020-06-01-171102,171102,0,0,0,26,0.0,0.011587908,0
2020-06-02-171102,171102,0,0,0,26,0.0,0.033260953,1
2020-06-03-171102,171102,0,0,0,26,0.0,0.010247016,2
2020-06-04-171102,171102,0,0,0,26,0.0,0.053341422,3
2020-06-05-171102,171102,0,0,0,26,0.0,0.013833918,4
2020-06-06-171102,171102,0,0,0,26,0.2,0.021729149,5
2020-06-07-171102,171102,0,0,0,26,0.0,0.0002025922,6
2020-06-08-171102,171102,0,0,0,26,0.0,0.097452916,0
2020-06-09-171102,171102,0,0,0,26,0.0,0.031577297,1
2020-06-10-171102,171102,0,0,0,26,0.6,0.11335505,2
2020-06-11-171102,171102,0,0,0,26,0.0,0.06942814,3
2020-06-12-171102,171102,0,0,0,26,0.2,0.042581186,4
2020-06-13-171102,171102,0,0,0,26,0.0,0.0002657553,5
2020-06-14-171102,171102,0,0,0,26,0.0,8.952148e-08,6
2020-06-15-171102,171102,0,0,0,26,0.0,0.029934559,0
2020-06-16-171102,171102,0,0,0,26,0.0,0.00925871,1
2020-06-17-171102,171102,0,0,0,26,0.0,0.009971322,2
2020-06-18-171102,171102,0,0,0,26,0.2,0.022591539,3
2020-06-19-171102,171102,0,0,1,26,0.2,0.06743066,4
2020-06-20-171102,171102,0,0,0,26,0.2,0.01425087,5
2020-06-21-171102,171102,0,0,0,26,0.0,5.893795e-05,6
2020-06-22-171102,171102,0,0,0,26,0.0,0.005947711,0
2020-06-23-171102,171102,0,1,0,26,0.0,0.062232476,1
2020-06-24-171102,171102,0,0,0,26,0.2,0.030841967,2
2020-06-25-171102,171102,0,0,0,26,0.0,0.004222882,3
2020-06-26-171102,171102,0,0,0,26,0.2,0.035325218,4
2020-06-27-171102,171102,0,0,0,26,0.0,0.0051712277,5
2020-06-28-171102,171102,0,0,0,26,0.0,0.0006359831,6
2020-06-29-171102,171102,0,0,0,26,0.0,0.0067212763,0
2020-06-30-171102,171102,0,0,0,26,0.0,0.005424374,1
2020-07-01-171102,171102,0,0,0,26,0.0,0.00073673856,2
2020-07-02-171102,171102,0,0,0,26,0.2,0.01927521,3
2020-07-03-171102,171102,1,0,0,27,0.0,0.21380997,4
2020-07-04-171102,171102,0,0,0,27,0.0,0.00042961113,5
2020-07-05-171102,171102,0,0,0,27,0.0,0.0003281614,6
2020-07-06-171102,171102,0,0,0,27,0.0,0.030963596,0
2020-07-07-171102,171102,0,1,0,27,0.0,0.00097303314,1
2020-07-08-171102,171102,0,0,0,27,0.0,0.0109395,2
2020-07-09-171102,171102,0,1,0,27,0.0,0.0045422795,3
2020-07-10-171102,171102,0,0,0,27,0.0,0.0680218,4
2020-07-11-171102,171102,0,0,0,27,0.0,0.00024115806,5
2020-07-12-171102,171102,0,0,0,27,0.0,0.0001314366,6
2020-07-13-171102,171102,0,0,0,27,0.0,0.0023427412,0
2020-07-14-171102,171102,0,0,0,27,0.0,0.0049510314,1
2020-07-15-171102,171102,0,0,0,27,0.0,0.001277933,2
2020-07-16-171102,171102,0,0,0,27,0.0,0.0014461676,3
2020-07-17-171102,171102,0,0,0,27,0.0,0.007335762,4
2020-07-18-171102,171102,0,0,0,27,0.0,0.0018963184,5
2020-07-19-171102,171102,0,0,0,27,0.0,0.0016796378,6
2020-07-20-171102,171102,0,0,1,27,0.0,0.009096988,0
2020-07-21-171102,171102,0,0,0,27,0.0,0.0019411475,1
2020-07-22-171102,171102,0,0,0,27,0.0,0.0021788653,2
2020-07-23-171102,171102,0,0,0,27,0.0,0.005902282,3
2020-07-24-171102,171102,0,0,2,27,0.0,0.0018070955,4
2020-07-25-171102,171102,0,0,0,27,0.0,0.00043112173,5
2020-07-26-171102,171102,0,0,0,27,0.0,0.0008020077,6
2020-07-27-171102,171102,0,0,0,27,0.0,0.025268767,0
2020-07-28-171102,171102,0,0,0,27,0.0,0.004771568,1
2020-07-29-171102,171102,0,0,1,27,0.0,0.010720068,2
2020-07-30-171102,171102,0,0,0,27,0.2,0.14725263,3
2020-07-31-171102,171102,0,0,0,27,0.0,0.08492382,4
2020-08-01-171102,171102,0,0,0,27,0.0,0.010379205,5
2020-08-02-171102,171102,0,0,0,27,0.0,0.010176652,6
2020-08-03-171102,171102,1,0,0,28,0.2,0.26614746,0
2020-08-04-171102,171102,0,0,0,28,0.0,0.0044066217,1
2020-08-05-171102,171102,0,0,0,28,0.0,0.029251967,2
2020-08-06-171102,171102,0,0,0,28,0.0,0.019872244,3
2020-08-07-171102,171102,2,0,1,30,0.2,0.49675164,4
2020-08-08-171102,171102,0,0,0,30,0.0,0.024045765,5
2020-08-09-171102,171102,0,0,1,30,0.4,0.21603456,6
2020-08-10-171102,171102,0,0,1,30,0.2,0.03025598,0
2020-08-11-171102,171102,0,0,0,30,0.0,0.09825215,1
2020-08-12-171102,171102,1,0,0,31,0.0,0.06276809,2
2020-08-13-171102,171102,0,0,1,31,1.2,0.33042043,3
2020-08-14-171102,171102,0,0,0,31,0.8,0.20427147,4
2020-08-15-171102,171102,0,0,0,31,0.2,0.12606864,5
2020-08-16-171102,171102,0,0,0,31,0.6,0.3282624,6
2020-08-17-171102,171102,0,0,0,31,0.8,0.19381197,0
2020-08-18-171102,171102,0,0,0,31,1.0,0.32039365,1
2020-08-19-171102,171102,0,0,0,31,0.2,0.33244532,2
2020-08-20-171102,171102,0,0,2,31,0.0,0.37359104,3
2020-08-21-171102,171102,1,0,0,32,0.4,0.65247005,4
2020-08-22-171102,171102,0,0,1,32,0.8,1.0641366,5
2020-08-23-171102,171102,1,0,3,33,0.6,0.30979624,6
2020-08-24-171102,171102,1,0,0,34,0.6,0.9233532,0
2020-08-25-171102,171102,0,0,1,34,0.4,0.40095353,1
2020-08-26-171102,171102,0,0,0,34,0.6,0.2515735,2
2020-08-27-171102,171102,1,0,0,35,0.2,0.123263374,3
2020-08-28-171102,171102,0,0,0,35,0.2,0.27424902,4
2020-08-29-171102,171102,0,0,9,35,0.2,0.2439612,5
2020-08-30-171102,171102,0,0,0,35,0.2,0.20324157,6
2020-08-31-171102,171102,0,0,2,35,1.0,0.4108098,0
2020-09-01-171102,171102,0,0,0,35,0.4,0.2518422,1
2020-09-02-171102,171102,0,0,0,35,0.2,0.2177473,2
2020-09-03-171102,171102,2,0,0,37,0.2,0.9215089,3
2020-09-04-171102,171102,0,0,0,37,0.4,0.26948503,4
2020-09-05-171102,171102,1,0,0,38,0.2,0.051954307,5
2020-09-06-171102,171102,3,0,0,41,0.0,0.6469141,6
2020-09-07-171102,171102,0,0,3,41,2.2,0.28742415,0
2020-09-08-171102,171102,1,0,1,42,1.2,0.8738955,1
2020-09-09-171102,171102,0,0,0,42,0.8,0.8475312,2
2020-09-10-171102,171102,0,0,0,42,2.0,0.98689294,3
2020-09-11-171102,171102,0,0,2,42,0.2,0.6632687,4
2020-09-12-171102,171102,9,0,1,51,0.6,1.8788859,5
2020-09-13-171102,171102,0,0,0,51,1.4,0.17196882,6
2020-09-14-171102,171102,2,0,1,53,0.4,0.63662237,0
2020-09-15-171102,171102,0,0,1,53,1.2,0.57258373,1
2020-09-16-171102,171102,0,0,0,53,0.4,0.6153322,2
2020-09-17-171102,171102,0,0,0,53,1.4,1.9259694,3
2020-09-18-171102,171102,0,0,2,53,2.6,0.96828824,4
2020-09-19-171102,171102,0,0,1,53,1.4,0.26625243,5
2020-09-20-171102,171102,0,1,0,53,1.2,0.22859761,6
2020-09-21-171102,171102,3,0,0,56,0.4,0.86362267,0
2020-09-22-171102,171102,1,0,1,57,1.8,1.4912317,1
2020-09-23-171102,171102,0,2,2,57,2.6,0.5798948,2
2020-09-24-171102,171102,0,0,0,57,4.6,1.1614385,3
2020-09-25-171102,171102,2,0,0,59,2.6,1.1368816,4
2020-09-26-171102,171102,1,0,0,60,1.8,0.37447912,5
2020-09-27-171102,171102,0,0,0,60,2.0,0.31250715,6
2020-09-28-171102,171102,1,0,0,61,1.4,0.4348813,0
2020-09-29-171102,171102,1,0,0,62,0.8,0.35994163,1
2020-09-30-171102,171102,0,0,2,62,2.4,0.2689917,2
2020-10-01-171102,171102,0,0,2,62,1.2,0.26396796,3
2020-10-02-171102,171102,2,0,2,64,2.0,0.5794809,4
2020-10-03-171102,171102,1,0,1,65,0.6,0.34619713,5
2020-10-04-171102,171102,0,0,2,65,0.4,0.07195513,6
2020-10-05-171102,171102,0,0,0,65,1.6,0.22415613,0
2020-10-06-171102,171102,1,0,3,66,1.0,0.62599194,1
2020-10-07-171102,171102,2,1,0,68,0.2,0.56335837,2
2020-10-08-171102,171102,0,0,4,68,1.2,0.57136023,3
2020-10-09-171102,171102,0,1,1,68,0.4,0.27791214,4
2020-10-10-171102,171102,0,0,5,68,0.2,0.16108233,5
2020-10-11-171102,171102,0,0,2,68,0.0,0.15745226,6
2020-10-12-171102,171102,0,0,4,68,1.0,0.33709443,0
2020-10-13-171102,171102,0,0,9,68,0.0,0.091472164,1
2020-10-14-171102,171102,2,0,2,70,0.8,1.3724599,2
2020-10-15-171102,171102,2,0,4,72,1.2,1.090464,3
2020-10-16-171102,171102,2,0,4,74,0.6,1.4191122,4
2020-10-17-171102,171102,1,0,2,75,0.6,0.42943317,5
2020-10-18-171102,171102,2,0,1,77,0.6,0.636925,6
2020-10-19-171102,171102,0,0,2,77,1.2,0.48629522,0
2020-10-20-171102,171102,3,0,1,80,1.4,1.3003243,1
2020-10-21-171102,171102,0,0,1,80,2.0,1.2937386,2
2020-10-22-171102,171102,4,0,7,84,2.0,1.780699,3
2020-10-23-171102,171102,1,0,5,85,4.2,1.8719943,4
2020-10-24-171102,171102,5,0,1,90,0.8,1.1683586,5
2020-10-25-171102,171102,2,1,0,92,1.8,0.7802016,6
2020-10-26-171102,171102,4,0,0,96,3.0,2.1126325,0
2020-10-27-171102,171102,9,3,0,105,4.0,2.8930116,1
2020-10-28-171102,171102,2,1,0,107,3.4,1.9204601,2
2020-10-29-171102,171102,4,0,1,111,3.0,2.978442,3
2020-10-30-171102,171102,4,0,0,115,8.2,4.6974783,4
2020-10-31-171102,171102,2,1,0,117,1.4,0.8317543,5
2020-11-01-171102,171102,1,0,0,118,1.4,0.6313861,6
2020-11-02-171102,171102,2,0,0,120,0.6,0.3242728,0
2020-11-03-171102,171102,1,0,0,121,5.0,1.4600707,1
2020-11-04-171102,171102,1,0,0,122,5.6,1.9498231,2
2020-11-05-171102,171102,7,2,0,129,3.2,3.0482876,3
2020-11-06-171102,171102,5,1,0,134,5.0,2.9691896,4
2020-11-07-171102,171102,1,0,0,135,1.6,0.53096294,5
2020-11-08-171102,171102,0,0,0,135,1.0,0.21221986,6
2020-11-09-171102,171102,0,0,0,135,3.0,1.2288198,0
2020-11-10-171102,171102,0,1,0,135,3.6,1.0802583,1
2020-11-11-171102,171102,0,0,0,135,5.6,0.9066137,2
2020-11-12-171102,171102,1,0,0,136,3.0,0.85869426,3
2020-11-13-171102,171102,0,0,0,136,3.6,0.80843776,4
2020-03-01-171103,171103,0,0,0,0,0.0,0.00014725905,6
2020-03-02-171103,171103,0,0,0,0,0.0,0.0014821755,0
2020-03-03-171103,171103,0,0,0,0,0.0,0.00012896399,1
2020-03-04-171103,171103,0,0,0,0,0.0,0.002826,2
2020-03-05-171103,171103,0,0,0,0,0.0,1.9295012e-05,3
2020-03-06-171103,171103,0,0,0,0,0.0,5.658922e-05,4
2020-03-07-171103,171103,0,0,0,0,0.0,0.02311539,5
2020-03-08-171103,171103,0,0,0,0,0.0,3.816317e-05,6
2020-03-09-171103,171103,0,0,0,0,0.5,0.06076375,0
2020-03-10-171103,171103,0,0,0,0,0.5,0.05978104,1
2020-03-11-171103,171103,0,0,0,0,0.0,0.0040443446,2
2020-03-12-171103,171103,0,0,0,0,0.0,0.010477814,3
2020-03-13-171103,171103,0,0,0,0,0.0,0.039727032,4
2020-03-14-171103,171103,0,0,0,0,0.0,0.023075577,5
2020-03-15-171103,171103,0,0,0,0,0.0,0.00017815076,6
2020-03-16-171103,171103,0,0,0,0,0.5,0.0623814,0
2020-03-17-171103,171103,0,0,0,0,2.5,0.28109068,1
2020-03-18-171103,171103,0,0,0,0,1.0,0.12438672,2
2020-03-19-171103,171103,0,0,1,0,1.0,0.11743477,3
2020-03-20-171103,171103,0,0,1,0,1.0,0.11883017,4
2020-03-21-171103,171103,0,1,0,0,0.5,0.017563755,5
2020-03-22-171103,171103,0,0,0,0,0.0,0.0011456476,6
2020-03-23-171103,171103,0,0,0,0,1.0,0.081415206,0
2020-03-24-171103,171103,0,0,0,0,1.0,0.085443385,1
2020-03-25-171103,171103,0,0,0,0,2.0,0.07414731,2
2020-03-26-171103,171103,0,0,0,0,1.5,0.110726185,3
2020-03-27-171103,171103,0,0,0,0,1.0,0.065435685,4
2020-03-28-171103,171103,0,0,0,0,1.0,0.056692686,5
2020-03-29-171103,171103,0,0,0,0,0.0,0.0017823003,6
2020-03-30-171103,171103,0,0,0,0,0.0,0.010887783,0
2020-03-31-171103,171103,0,0,0,0,1.0,0.08233477,1
2020-04-01-171103,171103,0,0,0,0,0.0,0.09813412,2
2020-04-02-171103,171103,1,0,0,1,2.5,0.15912305,3
2020-04-03-171103,171103,1,0,0,2,0.5,0.15548038,4
2020-04-04-171103,171103,0,0,0,2,0.0,0.018872917,5
2020-04-05-171103,171103,0,0,0,2,0.0,0.0011228465,6
2020-04-06-171103,171103,0,0,0,2,1.0,0.06613886,0
2020-04-07-171103,171103,0,0,0,2,1.5,0.08627019,1
2020-04-08-171103,171103,0,0,0,2,0.5,0.048413303,2
2020-04-09-171103,171103,0,1,0,2,0.5,0.03626916,3
2020-04-10-171103,171103,0,0,0,2,0.0,0.001903925,4
2020-04-11-171103,171103,0,0,0,2,0.0,0.0020867009,5
2020-04-12-171103,171103,0,0,0,2,0.0,0.0012354893,6
2020-04-13-171103,171103,0,0,0,2,1.0,0.00807557,0
2020-04-14-171103,171103,0,0,0,2,1.0,0.09219302,1
2020-04-15-171103,171103,0,0,0,2,0.5,0.056762163,2
2020-04-16-171103,171103,0,0,0,2,0.5,0.06485388,3
2020-04-17-171103,171103,0,0,0,2,0.5,0.09496649,4
2020-04-18-171103,171103,0,0,0,2,0.0,0.0013631249,5
2020-04-19-171103,171103,0,0,0,2,0.0,0.0010672625,6
2020-04-20-171103,171103,0,0,0,2,0.0,0.0073567564,0
2020-04-21-171103,171103,0,0,0,2,0.0,0.02831899,1
2020-04-22-171103,171103,0,0,0,2,1.5,0.1441559,2
2020-04-23-171103,171103,0,0,0,2,1.0,0.10936241,3
2020-04-24-171103,171103,0,0,0,2,1.0,0.14468825,4
2020-04-25-171103,171103,0,0,0,2,0.5,0.048223592,5
2020-04-26-171103,171103,0,1,0,2,0.0,0.00034712732,6
2020-04-27-171103,171103,0,0,0,2,0.0,0.012674769,0
2020-04-28-171103,171103,0,0,0,2,1.5,0.16845147,1
2020-04-29-171103,171103,0,0,0,2,2.5,0.35496807,2
2020-04-30-171103,171103,0,0,0,2,1.0,0.14243183,3
2020-05-01-171103,171103,0,0,0,2,0.5,0.047978487,4
2020-05-02-171103,171103,0,0,0,2,0.0,0.00077463564,5
2020-05-03-171103,171103,0,0,0,2,0.0,5.8873728e-05,6
2020-05-04-171103,171103,0,0,0,2,0.0,0.013903627,0
2020-05-05-171103,171103,0,0,0,2,0.0,0.01330268,1
2020-05-06-171103,171103,0,0,0,2,0.5,0.12765798,2
2020-05-07-171103,171103,0,0,0,2,0.5,0.110566266,3
2020-05-08-171103,171103,0,0,0,2,0.5,0.012920587,4
2020-05-09-171103,171103,0,0,0,2,0.0,0.0019087882,5
2020-05-10-171103,171103,0,0,0,2,1.5,0.049816236,6
2020-05-11-171103,171103,0,0,0,2,0.0,0.015405296,0
2020-05-12-171103,171103,0,0,0,2,1.0,0.17938073,1
2020-05-13-171103,171103,0,0,0,2,0.0,0.02370347,2
2020-05-14-171103,171103,0,0,0,2,0.0,0.016603453,3
2020-05-15-171103,171103,0,0,0,2,2.0,0.2944056,4
2020-05-16-171103,171103,0,0,0,2,0.0,0.00071862055,5
2020-05-17-171103,171103,0,0,0,2,0.0,8.861938e-05,6
2020-05-18-171103,171103,0,0,0,2,0.5,0.122318,0
2020-05-19-171103,171103,0,0,0,2,1.0,0.18141247,1
2020-05-20-171103,171103,0,0,0,2,0.0,0.014193267,2
2020-05-21-171103,171103,0,0,0,2,0.0,0.021194827,3
2020-05-22-171103,171103,0,0,0,2,0.0,0.009368107,4
2020-05-23-171103,171103,0,0,0,2,0.0,2.8343084e-07,5
2020-05-24-171103,171103,0,0,0,2,0.0,0.0002973535,6
2020-05-25-171103,171103,0,0,0,2,1.0,0.092294306,0
2020-05-26-171103,171103,0,0,0,2,0.5,0.1825128,1
2020-05-27-171103,171103,0,3,0,2,0.0,0.009389531,2
2020-05-28-171103,171103,0,1,0,2,0.0,0.012826314,3
2020-05-29-171103,171103,0,0,0,2,0.5,0.094668925,4
2020-05-30-171103,171103,0,0,0,2,0.0,1.1298169e-05,5
2020-05-31-171103,171103,0,0,0,2,0.5,0.07588279,6
2020-06-01-171103,171103,0,0,0,2,0.0,0.006015013,0
2020-06-02-171103,171103,0,0,0,2,1.0,0.23287128,1
2020-06-03-171103,171103,0,0,0,2,0.0,0.004943164,2
2020-06-04-171103,171103,0,1,0,2,0.0,0.016053928,3
2020-06-05-171103,171103,0,0,0,2,0.0,0.005296261,4
2020-06-06-171103,171103,0,0,0,2,0.0,0.00236459,5
2020-06-07-171103,171103,0,0,0,2,0.0,5.2753912e-06,6
2020-06-08-171103,171103,0,0,0,2,0.0,0.009101524,0
2020-06-09-171103,171103,0,0,0,2,0.0,0.006403369,1
2020-06-10-171103,171103,0,0,0,2,0.5,0.006215772,2
2020-06-11-171103,171103,0,0,0,2,0.0,0.011088878,3
2020-06-12-171103,171103,0,0,0,2,0.0,0.0066467626,4
2020-06-13-171103,171103,0,0,0,2,0.0,1.9479785e-06,5
2020-06-14-171103,171103,0,6,0,2,0.0,6.058446e-08,6
2020-06-15-171103,171103,0,0,0,2,0.0,0.004398266,0
2020-06-16-171103,171103,0,0,0,2,0.5,0.0020795255,1
2020-06-17-171103,171103,0,0,0,2,0.0,0.0039854827,2
2020-06-18-171103,171103,0,0,0,2,0.0,0.0045427126,3
2020-06-19-171103,171103,0,0,0,2,0.0,0.01063489,4
2020-06-20-171103,171103,0,0,0,2,0.0,0.00018415003,5
2020-06-21-171103,171103,0,0,0,2,0.0,9.026301e-06,6
2020-06-22-171103,171103,0,0,0,2,0.0,0.002481238,0
2020-06-23-171103,171103,0,0,0,2,0.0,0.020808233,1
2020-06-24-171103,171103,0,0,0,2,0.0,0.0053505017,2
2020-06-25-171103,171103,0,1,0,2,0.0,0.0025130427,3
2020-06-26-171103,171103,0,0,0,2,0.0,0.008612856,4
2020-06-27-171103,171103,0,0,0,2,0.0,0.002886104,5
2020-06-28-171103,171103,0,0,0,2,0.0,0.00096657797,6
2020-06-29-171103,171103,0,0,0,2,0.0,0.0041607833,0
2020-06-30-171103,171103,0,0,0,2,0.0,0.0050274236,1
2020-07-01-171103,171103,0,0,0,2,0.0,0.0010544454,2
2020-07-02-171103,171103,0,0,0,2,0.0,0.0028680782,3
2020-07-03-171103,171103,0,0,0,2,0.0,0.008265819,4
2020-07-04-171103,171103,0,0,0,2,0.0,0.0006060748,5
2020-07-05-171103,171103,0,0,0,2,0.0,0.0003317879,6
2020-07-06-171103,171103,0,0,0,2,0.0,0.008741969,0
2020-07-07-171103,171103,0,0,0,2,0.0,0.00092124,1
2020-07-08-171103,171103,0,0,0,2,0.5,0.12343739,2
2020-07-09-171103,171103,0,0,0,2,0.0,0.0038737417,3
2020-07-10-171103,171103,0,0,0,2,0.0,0.018568624,4
2020-07-11-171103,171103,0,1,0,2,0.0,0.001060647,5
2020-07-12-171103,171103,0,0,0,2,0.0,0.0008891162,6
2020-07-13-171103,171103,0,0,0,2,0.0,0.0016744251,0
2020-07-14-171103,171103,0,0,0,2,0.0,0.00085846166,1
2020-07-15-171103,171103,0,0,0,2,0.0,0.000733484,2
2020-07-16-171103,171103,0,0,0,2,0.0,0.0040380564,3
2020-07-17-171103,171103,0,0,0,2,0.0,0.0033620144,4
2020-07-18-171103,171103,0,0,0,2,0.0,0.0026982045,5
2020-07-19-171103,171103,0,0,0,2,0.0,0.0010387062,6
2020-07-20-171103,171103,0,0,0,2,0.0,0.006909184,0
2020-07-21-171103,171103,0,0,0,2,0.0,0.002436006,1
2020-07-22-171103,171103,0,0,0,2,0.0,0.0016251416,2
2020-07-23-171103,171103,0,0,0,2,0.0,0.0086577535,3
2020-07-24-171103,171103,0,0,0,2,0.0,0.0046573794,4
2020-07-25-171103,171103,0,0,0,2,0.0,0.00045089712,5
2020-07-26-171103,171103,0,0,5,2,0.0,0.0006085401,6
2020-07-27-171103,171103,0,0,0,2,0.0,0.0067063402,0
2020-07-28-171103,171103,0,0,0,2,0.0,0.0067455545,1
2020-07-29-171103,171103,0,0,0,2,0.0,0.00645998,2
2020-07-30-171103,171103,0,0,0,2,0.0,0.06839414,3
2020-07-31-171103,171103,0,0,0,2,1.0,0.17482759,4
2020-08-01-171103,171103,0,0,0,2,0.0,0.17735778,5
2020-08-02-171103,171103,0,0,0,2,0.5,0.1728775,6
2020-08-03-171103,171103,0,0,0,2,0.0,0.015583656,0
2020-08-04-171103,171103,0,0,0,2,0.0,0.003252035,1
2020-08-05-171103,171103,0,0,0,2,0.5,0.01738749,2
2020-08-06-171103,171103,0,0,1,2,0.0,0.016438182,3
2020-08-07-171103,171103,0,0,0,2,0.0,0.3466072,4
2020-08-08-171103,171103,0,0,0,2,0.5,0.19625784,5
2020-08-09-171103,171103,5,0,0,7,0.0,1.6882914,6
2020-08-10-171103,171103,0,0,0,7,0.0,0.01622949,0
2020-08-11-171103,171103,0,0,0,7,0.0,0.32423943,1
2020-08-12-171103,171103,0,0,0,7,0.5,0.17914255,2
2020-08-13-171103,171103,0,0,0,7,0.0,0.070238814,3
2020-08-14-171103,171103,0,0,0,7,0.5,0.23218091,4
2020-08-15-171103,171103,0,0,0,7,0.0,0.05119074,5
2020-08-16-171103,171103,0,0,0,7,0.5,0.31681395,6
2020-08-17-171103,171103,0,0,0,7,0.0,0.029583843,0
2020-08-18-171103,171103,0,0,0,7,0.0,0.058846965,1
2020-08-19-171103,171103,0,0,0,7,0.0,0.4102447,2
2020-08-20-171103,171103,1,0,2,8,0.0,0.56356573,3
2020-08-21-171103,171103,0,0,2,8,0.0,1.5744978,4
2020-08-22-171103,171103,0,0,0,8,0.5,0.6298392,5
2020-08-23-171103,171103,0,0,1,8,0.0,0.03287315,6
2020-08-24-171103,171103,0,0,1,8,0.0,0.45302838,0
2020-08-25-171103,171103,0,0,1,8,0.0,0.16758344,1
2020-08-26-171103,171103,0,0,0,8,0.5,0.22188541,2
2020-08-27-171103,171103,0,0,0,8,0.5,0.042518813,3
2020-08-28-171103,171103,0,0,0,8,0.5,0.25049794,4
2020-08-29-171103,171103,0,0,1,8,0.0,0.039972942,5
2020-08-30-171103,171103,0,0,0,8,0.5,0.19225484,6
2020-08-31-171103,171103,0,0,0,8,0.0,0.27359125,0
2020-09-01-171103,171103,0,0,0,8,0.5,0.1976849,1
2020-09-02-171103,171103,0,0,4,8,0.5,0.1752467,2
2020-09-03-171103,171103,2,0,0,10,26.0,6.5972815,3
2020-09-04-171103,171103,2,0,1,12,6.0,1.7976668,4
2020-09-05-171103,171103,0,0,0,12,1.5,0.38225198,5
2020-09-06-171103,171103,1,0,0,13,7.0,1.4550036,6
2020-09-07-171103,171103,1,0,0,14,4.0,1.2533026,0
2020-09-08-171103,171103,1,0,0,15,5.0,1.2306226,1
2020-09-09-171103,171103,0,0,0,15,1.5,0.5114231,2
2020-09-10-171103,171103,0,0,0,15,7.5,0.76603454,3
2020-09-11-171103,171103,0,0,1,15,2.0,0.76694053,4
2020-09-12-171103,171103,1,0,0,16,1.0,0.38145533,5
2020-09-13-171103,171103,0,0,0,16,0.0,0.018321976,6
2020-09-14-171103,171103,0,0,0,16,0.5,0.12074509,0
2020-09-15-171103,171103,0,0,0,16,2.5,0.5319197,1
2020-09-16-171103,171103,4,0,0,20,0.0,0.75650966,2
2020-09-17-171103,171103,0,0,0,20,18.0,3.1095576,3
2020-09-18-171103,171103,1,0,0,21,4.0,0.97576374,4
2020-09-19-171103,171103,0,0,0,21,0.0,0.025717832,5
2020-09-20-171103,171103,0,0,0,21,0.5,0.11452188,6
2020-09-21-171103,171103,0,0,0,21,6.5,1.0874016,0
2020-09-22-171103,171103,0,0,0,21,0.5,0.56987,1
2020-09-23-171103,171103,0,0,0,21,1.5,0.39383054,2
2020-09-24-171103,171103,0,0,0,21,2.0,0.65703136,3
2020-09-25-171103,171103,1,0,0,22,1.0,0.32446495,4
2020-09-26-171103,171103,0,0,0,22,0.0,0.034151725,5
2020-09-27-171103,171103,0,0,0,22,0.0,0.04370922,6
2020-09-28-171103,171103,0,0,0,22,0.0,0.1606994,0
2020-09-29-171103,171103,0,0,0,22,0.5,0.151584,1
2020-09-30-171103,171103,0,0,0,22,1.0,0.17550014,2
2020-10-01-171103,171103,0,0,0,22,0.5,0.05738236,3
2020-10-02-171103,171103,0,0,0,22,1.0,0.20035446,4
2020-10-03-171103,171103,0,0,0,22,0.5,0.09303269,5
2020-10-04-171103,171103,0,0,0,22,0.0,0.01214807,6
2020-10-05-171103,171103,0,0,0,22,0.5,0.14858405,0
2020-10-06-171103,171103,0,0,0,22,1.5,0.4462934,1
2020-10-07-171103,171103,0,0,0,22,0.0,0.07356867,2
2020-10-08-171103,171103,0,0,0,22,0.0,0.21353966,3
2020-10-09-171103,171103,0,0,3,22,2.0,0.72186095,4
2020-10-10-171103,171103,0,0,0,22,0.0,0.0569693,5
2020-10-11-171103,171103,0,0,0,22,0.0,0.04196094,6
2020-10-12-171103,171103,0,0,0,22,0.5,0.16726173,0
2020-10-13-171103,171103,0,0,5,22,1.0,0.11009011,1
2020-10-14-171103,171103,0,0,0,22,1.0,0.2769253,2
2020-10-15-171103,171103,0,0,0,22,0.5,0.29858938,3
2020-10-16-171103,171103,0,0,0,22,1.5,0.3460403,4
2020-10-17-171103,171103,0,0,0,22,0.5,0.16760632,5
2020-10-18-171103,171103,0,0,0,22,0.5,0.17852011,6
2020-10-19-171103,171103,0,0,0,22,3.5,0.7498571,0
2020-10-20-171103,171103,0,0,0,22,2.5,0.3168208,1
2020-10-21-171103,171103,0,0,0,22,3.5,0.6867725,2
2020-10-22-171103,171103,0,0,0,22,0.5,0.29025447,3
2020-10-23-171103,171103,3,0,0,25,4.5,1.2302102,4
2020-10-24-171103,171103,0,0,0,25,1.0,0.1875976,5
2020-10-25-171103,171103,0,1,0,25,1.0,0.24639764,6
2020-10-26-171103,171103,0,0,0,25,0.0,0.3157741,0
2020-10-27-171103,171103,5,0,0,30,1.0,1.41348,1
2020-10-28-171103,171103,0,0,0,30,5.5,1.1681638,2
2020-10-29-171103,171103,0,0,0,30,0.5,0.24901491,3
2020-10-30-171103,171103,0,0,0,30,5.5,1.6800367,4
2020-10-31-171103,171103,0,0,0,30,0.5,0.21094958,5
2020-11-01-171103,171103,0,0,0,30,2.0,0.4129578,6
2020-11-02-171103,171103,0,0,0,30,1.5,0.33064118,0
2020-11-03-171103,171103,0,0,0,30,0.0,0.2008822,1
2020-11-04-171103,171103,0,0,0,30,3.5,0.7907316,2
2020-11-05-171103,171103,0,0,0,30,3.0,0.6780602,3
2020-11-06-171103,171103,0,0,0,30,1.5,0.5366514,4
2020-11-07-171103,171103,0,0,0,30,0.0,0.057466254,5
2020-11-08-171103,171103,0,0,0,30,0.0,0.032313287,6
2020-11-09-171103,171103,0,0,0,30,0.5,0.3492388,0
2020-11-10-171103,171103,0,0,0,30,1.5,0.38429153,1
2020-11-11-171103,171103,0,0,0,30,1.0,0.35293496,2
2020-11-12-171103,171103,0,0,0,30,0.0,0.10418768,3
2020-11-13-171103,171103,0,0,0,30,3.5,0.65305203,4
2020-03-01-171104,171104,0,0,1,0,0.0,0.00043732097,6
2020-03-02-171104,171104,0,0,1,0,0.0,0.012480022,0
2020-03-03-171104,171104,0,0,2,0,0.0,0.00028103177,1
2020-03-04-171104,171104,0,0,8,0,0.0,0.08768928,2
2020-03-05-171104,171104,0,0,3,0,0.0,0.0006417184,3
2020-03-06-171104,171104,0,0,6,0,0.0,0.0010390361,4
2020-03-07-171104,171104,0,0,0,0,0.0,0.033711083,5
2020-03-08-171104,171104,0,0,4,0,0.0,0.00030070834,6
2020-03-09-171104,171104,0,0,3,0,0.2,0.04145877,0
2020-03-10-171104,171104,0,0,6,0,0.0,0.0066207694,1
2020-03-11-171104,171104,0,0,7,0,0.0,0.040194146,2
2020-03-12-171104,171104,0,0,3,0,0.2,0.06914239,3
2020-03-13-171104,171104,0,0,11,0,0.0,0.05804187,4
2020-03-14-171104,171104,0,0,1,0,0.0,0.028005544,5
2020-03-15-171104,171104,1,0,3,1,0.4,0.09576731,6
2020-03-16-171104,171104,1,0,5,2,2.2,0.49470168,0
2020-03-17-171104,171104,2,1,4,4,5.4,1.7900646,1
2020-03-18-171104,171104,8,0,5,12,6.4,2.369062,2
2020-03-19-171104,171104,3,1,7,15,5.0,1.9862119,3
2020-03-20-171104,171104,6,0,1,21,4.8,2.1083655,4
2020-03-21-171104,171104,0,0,1,21,2.4,0.34873104,5
2020-03-22-171104,171104,4,0,0,25,1.2,0.30964345,6
2020-03-23-171104,171104,3,0,8,28,9.8,2.9708533,0
2020-03-24-171104,171104,6,0,5,34,7.4,1.5594059,1
2020-03-25-171104,171104,7,0,3,41,4.2,1.3751614,2
2020-03-26-171104,171104,3,0,20,44,3.4,1.3652524,3
2020-03-27-171104,171104,11,0,18,55,3.6,2.0666208,4
2020-03-28-171104,171104,1,0,2,56,0.8,0.26590207,5
2020-03-29-171104,171104,3,0,0,59,1.6,0.43216783,6
2020-03-30-171104,171104,5,0,3,64,2.2,0.76782453,0
2020-03-31-171104,171104,4,0,5,68,3.0,1.5502805,1
2020-04-01-171104,171104,5,0,0,73,2.4,1.3409295,2
2020-04-02-171104,171104,7,0,5,80,3.2,1.8001249,3
2020-04-03-171104,171104,1,0,5,81,2.0,1.1208243,4
2020-04-04-171104,171104,1,0,3,82,0.8,0.50811934,5
2020-04-05-171104,171104,0,0,1,82,0.6,0.1408161,6
2020-04-06-171104,171104,8,0,0,90,4.0,1.3551836,0
2020-04-07-171104,171104,5,0,6,95,2.0,1.0838295,1
2020-04-08-171104,171104,3,0,4,98,1.8,0.5873317,2
2020-04-09-171104,171104,20,0,2,118,0.8,1.8751297,3
2020-04-10-171104,171104,18,0,6,136,2.8,1.8288319,4
2020-04-11-171104,171104,2,0,0,138,0.8,0.29837576,5
2020-04-12-171104,171104,0,0,0,138,5.0,0.04218735,6
2020-04-13-171104,171104,3,0,6,141,1.6,0.82027584,0
2020-04-14-171104,171104,5,0,7,146,3.0,1.1400852,1
2020-04-15-171104,171104,0,0,3,146,0.4,0.15078118,2
2020-04-16-171104,171104,5,0,7,151,1.2,1.2624936,3
2020-04-17-171104,171104,5,0,1,156,0.4,0.88449866,4
2020-04-18-171104,171104,3,0,0,159,0.0,0.31765404,5
2020-04-19-171104,171104,1,0,1,160,0.0,0.0977519,6
2020-04-20-171104,171104,0,0,4,160,0.6,0.15286441,0
2020-04-21-171104,171104,6,0,5,166,2.2,1.6151695,1
2020-04-22-171104,171104,4,0,5,170,0.4,0.701458,2
2020-04-23-171104,171104,2,0,26,172,0.0,0.22673479,3
2020-04-24-171104,171104,6,0,4,178,7.4,1.3836182,4
2020-04-25-171104,171104,0,0,1,178,0.6,0.04640166,5
2020-04-26-171104,171104,0,0,1,178,0.4,0.12281199,6
2020-04-27-171104,171104,6,0,4,184,1.4,1.272004,0
2020-04-28-171104,171104,7,0,2,191,1.8,1.4919804,1
2020-04-29-171104,171104,3,0,13,194,1.0,1.0748348,2
2020-04-30-171104,171104,7,0,1,201,1.0,1.3833003,3
2020-05-01-171104,171104,1,0,4,202,0.0,0.11585458,4
2020-05-02-171104,171104,0,0,0,202,0.4,0.18242633,5
2020-05-03-171104,171104,1,0,0,203,0.0,0.11080785,6
2020-05-04-171104,171104,4,0,4,207,1.4,0.8300677,0
2020-05-05-171104,171104,5,0,2,212,1.8,0.86172557,1
2020-05-06-171104,171104,5,0,4,217,1.4,1.3722106,2
2020-05-07-171104,171104,26,0,3,243,1.2,4.6007776,3
2020-05-08-171104,171104,4,0,6,247,0.6,1.2715931,4
2020-05-09-171104,171104,1,0,0,248,0.2,0.23385221,5
2020-05-10-171104,171104,1,0,0,249,0.2,0.21657993,6
2020-05-11-171104,171104,4,1,0,253,0.6,0.6781691,0
2020-05-12-171104,171104,2,0,4,255,1.6,1.0186776,1
2020-05-13-171104,171104,13,0,1,268,1.4,2.0172637,2
2020-05-14-171104,171104,1,1,3,269,2.4,1.6103277,3
2020-05-15-171104,171104,4,2,2,273,0.8,0.6656938,4
2020-05-16-171104,171104,0,0,0,273,0.4,0.18384433,5
2020-05-17-171104,171104,0,1,0,273,0.0,0.006485409,6
2020-05-18-171104,171104,4,0,4,277,1.4,1.2058805,0
2020-05-19-171104,171104,2,0,1,279,1.6,1.1746451,1
2020-05-20-171104,171104,4,0,0,283,0.8,1.3927975,2
2020-05-21-171104,171104,3,0,6,286,1.0,0.95345044,3
2020-05-22-171104,171104,6,0,3,292,0.6,0.9479518,4
2020-05-23-171104,171104,0,0,0,292,0.0,0.0036423383,5
2020-05-24-171104,171104,0,0,0,292,0.0,0.00280878,6
2020-05-25-171104,171104,0,0,3,292,0.6,0.061532453,0
2020-05-26-171104,171104,4,0,0,296,0.0,0.71730775,1
2020-05-27-171104,171104,1,0,0,297,0.4,0.2637674,2
2020-05-28-171104,171104,3,1,3,300,1.2,1.2749232,3
2020-05-29-171104,171104,2,0,1,302,0.8,0.39270097,4
2020-05-30-171104,171104,0,0,0,302,0.0,0.013962271,5
2020-05-31-171104,171104,0,0,0,302,0.0,0.00441941,6
2020-06-01-171104,171104,4,0,2,306,0.6,0.6939249,0
2020-06-02-171104,171104,1,0,0,307,1.6,1.1667718,1
2020-06-03-171104,171104,0,0,1,307,1.2,0.68626857,2
2020-06-04-171104,171104,6,0,1,313,2.0,1.6912597,3
2020-06-05-171104,171104,3,1,0,316,0.4,0.53216285,4
2020-06-06-171104,171104,0,2,0,316,0.2,0.20844814,5
2020-06-07-171104,171104,0,0,0,316,0.0,0.0040832143,6
2020-06-08-171104,171104,3,0,0,319,0.4,0.8303136,0
2020-06-09-171104,171104,0,0,2,319,0.4,0.5120999,1
2020-06-10-171104,171104,0,0,2,319,1.0,0.1640987,2
2020-06-11-171104,171104,3,0,0,322,0.2,0.57315135,3
2020-06-12-171104,171104,1,0,1,323,1.0,0.6775917,4
2020-06-13-171104,171104,0,1,0,323,0.0,0.0019628166,5
2020-06-14-171104,171104,0,2,0,323,0.0,0.00087994535,6
2020-06-15-171104,171104,2,0,1,325,0.8,0.4081745,0
2020-06-16-171104,171104,0,0,0,325,0.2,0.24478751,1
2020-06-17-171104,171104,1,0,0,326,0.4,0.3996997,2
2020-06-18-171104,171104,1,0,0,327,0.4,0.43970245,3
2020-06-19-171104,171104,0,0,0,327,0.0,0.03797122,4
2020-06-20-171104,171104,0,0,0,327,0.0,0.0015738038,5
2020-06-21-171104,171104,0,0,0,327,0.0,0.0004559413,6
2020-06-22-171104,171104,0,0,1,327,0.6,0.27254125,0
2020-06-23-171104,171104,2,0,0,329,0.6,0.7193065,1
2020-06-24-171104,171104,2,0,1,331,0.8,0.6697098,2
2020-06-25-171104,171104,0,2,0,331,0.8,0.08421707,3
2020-06-26-171104,171104,1,1,2,332,0.8,0.7968451,4
2020-06-27-171104,171104,0,0,0,332,0.2,0.22419362,5
2020-06-28-171104,171104,0,0,0,332,0.0,0.0016398447,6
2020-06-29-171104,171104,1,0,0,333,0.6,0.21145937,0
2020-06-30-171104,171104,0,0,0,333,0.4,0.13122624,1
2020-07-01-171104,171104,0,0,0,333,0.2,0.022940978,2
2020-07-02-171104,171104,0,0,0,333,0.8,0.28919876,3
2020-07-03-171104,171104,0,0,1,333,0.4,0.2867347,4
2020-07-04-171104,171104,0,0,0,333,0.0,0.0006788714,5
2020-07-05-171104,171104,0,0,0,333,0.0,0.002346226,6
2020-07-06-171104,171104,1,0,0,334,0.0,0.21235125,0
2020-07-07-171104,171104,0,0,0,334,0.0,0.0049586017,1
2020-07-08-171104,171104,1,0,0,335,0.6,0.23963596,2
2020-07-09-171104,171104,0,0,0,335,0.6,0.28171307,3
2020-07-10-171104,171104,2,0,0,337,0.6,1.0627009,4
2020-07-11-171104,171104,0,0,0,337,0.2,0.0024570352,5
2020-07-12-171104,171104,0,0,0,337,0.0,0.0028165986,6
2020-07-13-171104,171104,0,0,0,337,0.2,0.017627167,0
2020-07-14-171104,171104,0,0,0,337,0.0,0.01266927,1
2020-07-15-171104,171104,0,0,1,337,0.4,0.023607377,2
2020-07-16-171104,171104,0,0,1,337,0.0,0.017159963,3
2020-07-17-171104,171104,1,0,4,338,0.0,0.21216197,4
2020-07-18-171104,171104,0,0,0,338,0.2,0.01654219,5
2020-07-19-171104,171104,0,0,0,338,0.2,0.021208657,6
2020-07-20-171104,171104,0,0,3,338,0.4,0.50129586,0
2020-07-21-171104,171104,0,0,0,338,0.0,0.015308017,1
2020-07-22-171104,171104,0,0,1,338,0.0,0.007851941,2
2020-07-23-171104,171104,0,0,0,338,0.2,0.14811975,3
2020-07-24-171104,171104,0,0,0,338,0.2,0.030984426,4
2020-07-25-171104,171104,0,0,0,338,0.0,0.0017763741,5
2020-07-26-171104,171104,0,0,0,338,0.0,0.0010069351,6
2020-07-27-171104,171104,0,0,0,338,0.2,0.024767643,0
2020-07-28-171104,171104,0,0,1,338,0.2,0.26326072,1
2020-07-29-171104,171104,1,0,2,339,0.4,0.4438449,2
2020-07-30-171104,171104,1,0,0,340,0.0,0.25082466,3
2020-07-31-171104,171104,4,0,0,344,0.0,0.24213284,4
2020-08-01-171104,171104,0,0,4,344,0.2,0.01999452,5
2020-08-02-171104,171104,0,0,1,344,0.2,0.04355282,6
2020-08-03-171104,171104,3,0,3,347,0.0,0.42396528,0
2020-08-04-171104,171104,0,0,4,347,0.0,0.03311253,1
2020-08-05-171104,171104,1,0,5,348,0.4,0.5042686,2
2020-08-06-171104,171104,0,0,2,348,2.0,0.43346423,3
2020-08-07-171104,171104,0,0,3,348,0.4,0.25702018,4
2020-08-08-171104,171104,0,0,1,348,0.0,0.4788586,5
2020-08-09-171104,171104,0,0,0,348,0.2,0.4567564,6
2020-08-10-171104,171104,0,0,0,348,0.4,0.33623412,0
2020-08-11-171104,171104,1,0,1,349,0.2,0.9758683,1
2020-08-12-171104,171104,2,0,6,351,0.8,0.53571993,2
2020-08-13-171104,171104,0,1,1,351,0.2,0.69842863,3
2020-08-14-171104,171104,0,0,2,351,0.6,1.0891138,4
2020-08-15-171104,171104,4,0,0,355,2.4,1.509445,5
2020-08-16-171104,171104,1,0,0,356,0.2,0.39526922,6
2020-08-17-171104,171104,3,0,4,359,0.6,1.4470205,0
2020-08-18-171104,171104,4,0,1,363,0.8,1.9030558,1
2020-08-19-171104,171104,5,0,8,368,1.6,2.2999413,2
2020-08-20-171104,171104,2,1,4,370,1.8,2.8431475,3
2020-08-21-171104,171104,3,0,7,373,1.8,2.7022216,4
2020-08-22-171104,171104,1,0,2,374,0.2,0.71506476,5
2020-08-23-171104,171104,0,0,0,374,0.6,0.6618818,6
2020-08-24-171104,171104,0,0,0,374,0.8,1.178676,0
2020-08-25-171104,171104,1,0,3,375,2.0,0.757504,1
2020-08-26-171104,171104,6,0,1,381,1.0,2.3567564,2
2020-08-27-171104,171104,1,0,2,382,1.6,1.4672061,3
2020-08-28-171104,171104,2,0,0,384,1.6,1.2333176,4
2020-08-29-171104,171104,0,0,0,384,1.2,1.3448212,5
2020-08-30-171104,171104,0,0,2,384,4.2,0.33115977,6
2020-08-31-171104,171104,4,0,1,388,1.0,1.30848,0
2020-09-01-171104,171104,1,0,0,389,1.2,0.5099083,1
2020-09-02-171104,171104,8,0,1,397,1.4,2.6857035,2
2020-09-03-171104,171104,4,0,4,401,1.0,1.8398267,3
2020-09-04-171104,171104,7,0,5,408,1.4,1.9211344,4
2020-09-05-171104,171104,2,0,4,410,0.4,0.7128491,5
2020-09-06-171104,171104,0,0,1,410,0.2,0.20435186,6
2020-09-07-171104,171104,0,0,4,410,0.0,0.45277894,0
2020-09-08-171104,171104,3,0,2,413,3.8,2.9622076,1
2020-09-09-171104,171104,1,0,2,414,2.6,1.584316,2
2020-09-10-171104,171104,2,0,2,416,2.0,1.5542533,3
2020-09-11-171104,171104,0,0,2,416,2.0,1.5794431,4
2020-09-12-171104,171104,0,1,1,416,0.6,0.3626305,5
2020-09-13-171104,171104,2,0,0,418,0.6,0.4944744,6
2020-09-14-171104,171104,1,0,0,419,1.2,0.71289593,0
2020-09-15-171104,171104,0,0,1,419,4.0,1.1443236,1
2020-09-16-171104,171104,1,0,0,420,1.6,1.5161242,2
2020-09-17-171104,171104,4,0,2,424,3.8,7.4068284,3
2020-09-18-171104,171104,5,0,4,429,2.8,2.5797548,4
2020-09-19-171104,171104,4,1,0,433,2.0,2.256836,5
2020-09-20-171104,171104,1,0,0,434,1.8,1.1783322,6
2020-09-21-171104,171104,4,0,1,438,0.8,1.229868,0
2020-09-22-171104,171104,2,1,2,440,4.4,3.004796,1
2020-09-23-171104,171104,2,0,7,442,2.8,3.6332166,2
2020-09-24-171104,171104,2,1,2,444,2.4,2.6442628,3
2020-09-25-171104,171104,2,0,26,446,1.8,2.0651472,4
2020-09-26-171104,171104,1,0,0,447,1.2,1.3166881,5
2020-09-27-171104,171104,0,0,0,447,0.4,0.61154157,6
2020-09-28-171104,171104,0,0,2,447,1.4,0.3312623,0
2020-09-29-171104,171104,1,0,5,448,2.2,1.4405494,1
2020-09-30-171104,171104,0,0,12,448,1.6,1.4970956,2
2020-10-01-171104,171104,2,0,8,450,2.2,2.0670426,3
2020-10-02-171104,171104,4,0,19,454,1.4,1.947969,4
2020-10-03-171104,171104,0,0,0,454,1.4,0.84362197,5
2020-10-04-171104,171104,0,0,1,454,0.2,0.16525297,6
2020-10-05-171104,171104,1,2,3,455,0.6,0.8653425,0
2020-10-06-171104,171104,2,0,9,457,1.8,1.5535158,1
2020-10-07-171104,171104,7,1,7,464,1.4,2.492825,2
2020-10-08-171104,171104,2,0,3,466,1.2,2.378634,3
2020-10-09-171104,171104,26,1,30,492,2.0,5.2425213,4
2020-10-10-171104,171104,0,0,0,492,1.6,1.2451694,5
2020-10-11-171104,171104,0,0,2,492,0.8,0.21676001,6
2020-10-12-171104,171104,2,0,8,494,1.4,0.7373452,0
2020-10-13-171104,171104,5,0,4,499,1.8,1.7301731,1
2020-10-14-171104,171104,12,0,25,511,1.4,3.7985072,2
2020-10-15-171104,171104,8,0,14,519,3.4,6.663148,3
2020-10-16-171104,171104,19,0,16,538,2.2,5.7694516,4
2020-10-17-171104,171104,0,0,2,538,1.2,1.4556993,5
2020-10-18-171104,171104,1,0,1,539,1.0,0.9756794,6
2020-10-19-171104,171104,3,0,1,542,1.8,2.2502067,0
2020-10-20-171104,171104,9,0,15,551,1.8,5.565698,1
2020-10-21-171104,171104,7,0,15,558,4.0,7.6690254,2
2020-10-22-171104,171104,3,0,18,561,2.6,2.5013664,3
2020-10-23-171104,171104,30,0,12,591,5.2,10.169569,4
2020-10-24-171104,171104,0,0,3,591,2.6,1.5426265,5
2020-10-25-171104,171104,2,0,1,593,4.6,3.38546,6
2020-10-26-171104,171104,8,1,13,601,3.8,5.973173,0
2020-10-27-171104,171104,4,1,4,605,3.4,4.4264417,1
2020-10-28-171104,171104,25,1,36,630,5.6,9.874062,2
2020-10-29-171104,171104,14,1,17,644,4.6,6.9337335,3
2020-10-30-171104,171104,16,1,12,660,13.4,13.242382,4
2020-10-31-171104,171104,2,0,0,662,2.6,0.940737,5
2020-11-01-171104,171104,1,1,0,663,7.2,3.0244062,6
2020-11-02-171104,171104,1,0,0,664,1.6,0.81216997,0
2020-11-03-171104,171104,15,0,0,679,4.2,8.285476,1
2020-11-04-171104,171104,15,2,0,694,5.2,9.189581,2
2020-11-05-171104,171104,18,0,0,712,11.6,10.184703,3
2020-11-06-171104,171104,12,0,0,724,9.2,6.795158,4
2020-11-07-171104,171104,3,0,0,727,4.2,2.767665,5
2020-11-08-171104,171104,1,0,0,728,1.6,0.5241957,6
2020-11-09-171104,171104,13,0,0,741,4.6,6.2410083,0
2020-11-10-171104,171104,4,0,0,745,4.8,3.8788538,1
2020-11-11-171104,171104,36,5,0,781,5.8,11.036167,2
2020-11-12-171104,171104,17,1,0,798,9.0,8.229017,3
2020-11-13-171104,171104,12,5,0,810,9.2,5.422354,4
2020-03-01-171105,171105,0,0,0,0,0.0,0.00075977604,6
2020-03-02-171105,171105,0,1,1,0,0.0,0.024426682,0
2020-03-03-171105,171105,0,2,8,0,0.0,0.0003886139,1
2020-03-04-171105,171105,0,1,6,0,0.16666666666666666,0.15975663,2
2020-03-05-171105,171105,0,0,8,0,0.0,0.001087091,3
2020-03-06-171105,171105,0,0,7,0,0.0,0.0015194028,4
2020-03-07-171105,171105,0,0,2,0,0.0,0.05195815,5
2020-03-08-171105,171105,0,0,1,0,0.0,0.0003862319,6
2020-03-09-171105,171105,0,0,13,0,0.0,0.07027154,0
2020-03-10-171105,171105,0,0,4,0,0.0,0.010491991,1
2020-03-11-171105,171105,0,1,1,0,0.0,0.07975018,2
2020-03-12-171105,171105,0,0,5,0,0.0,0.12836951,3
2020-03-13-171105,171105,0,0,3,0,0.0,0.09128341,4
2020-03-14-171105,171105,0,0,1,0,0.0,0.04087437,5
2020-03-15-171105,171105,0,0,2,0,0.16666666666666666,0.16170654,6
2020-03-16-171105,171105,1,0,0,1,0.6666666666666666,0.8087566,0
2020-03-17-171105,171105,8,0,6,9,0.3333333333333333,3.0598323,1
2020-03-18-171105,171105,6,0,2,15,2.5,3.9789815,2
2020-03-19-171105,171105,8,0,6,23,1.5,3.315981,3
2020-03-20-171105,171105,7,0,5,30,2.1666666666666665,3.591208,4
2020-03-21-171105,171105,2,0,3,32,0.6666666666666666,0.58044726,5
2020-03-22-171105,171105,1,0,1,33,0.8333333333333334,0.5261053,6
2020-03-23-171105,171105,13,0,1,46,1.5,5.0062337,0
2020-03-24-171105,171105,4,0,2,50,1.6666666666666667,2.5265903,1
2020-03-25-171105,171105,1,0,0,51,1.6666666666666667,2.236438,2
2020-03-26-171105,171105,5,0,1,56,1.0,2.2897503,3
2020-03-27-171105,171105,3,0,2,59,3.1666666666666665,3.4857373,4
2020-03-28-171105,171105,1,0,0,60,0.3333333333333333,0.44461685,5
2020-03-29-171105,171105,2,0,0,62,0.5,0.728841,6
2020-03-30-171105,171105,0,0,2,62,1.5,1.2965683,0
2020-03-31-171105,171105,6,0,2,68,1.5,2.6952434,1
2020-04-01-171105,171105,2,0,1,70,1.8333333333333333,2.164786,2
2020-04-02-171105,171105,6,0,2,76,1.5,3.1225152,3
2020-04-03-171105,171105,5,0,0,81,0.8333333333333334,1.9283993,4
2020-04-04-171105,171105,3,0,0,84,0.16666666666666666,0.90520453,5
2020-04-05-171105,171105,1,0,0,85,0.16666666666666666,0.25269958,6
2020-04-06-171105,171105,1,0,0,86,2.0,2.3290732,0
2020-04-07-171105,171105,2,0,4,88,1.0,1.8260939,1
2020-04-08-171105,171105,0,0,1,88,0.8333333333333334,0.98755854,2
2020-04-09-171105,171105,1,0,0,89,3.6666666666666665,3.2566457,3
2020-04-10-171105,171105,2,0,2,91,3.333333333333333,3.1776922,4
2020-04-11-171105,171105,0,0,0,91,0.6666666666666666,0.53936774,5
2020-04-12-171105,171105,0,0,1,91,0.0,0.04153598,6
2020-04-13-171105,171105,2,0,3,93,0.6666666666666666,1.4071207,0
2020-04-14-171105,171105,2,0,4,95,1.3333333333333333,1.9052571,1
2020-04-15-171105,171105,1,0,2,96,0.16666666666666666,0.2555381,2
2020-04-16-171105,171105,2,0,3,98,1.1666666666666667,2.1990125,3
2020-04-17-171105,171105,0,0,0,98,1.5,1.5710835,4
2020-04-18-171105,171105,0,0,1,98,0.6666666666666666,0.54656166,5
2020-04-19-171105,171105,0,0,0,98,0.3333333333333333,0.17450759,6
2020-04-20-171105,171105,0,0,1,98,0.3333333333333333,0.24362941,0
2020-04-21-171105,171105,4,0,0,102,1.1666666666666667,2.77011,1
2020-04-22-171105,171105,1,0,2,103,0.8333333333333334,1.1758757,2
2020-04-23-171105,171105,0,0,4,103,0.5,0.39436984,3
2020-04-24-171105,171105,2,0,2,105,1.1666666666666667,2.2406032,4
2020-04-25-171105,171105,0,0,1,105,0.3333333333333333,0.058282454,5
2020-04-26-171105,171105,1,0,1,106,0.0,0.2127533,6
2020-04-27-171105,171105,3,1,0,109,1.0,2.1559381,0
2020-04-28-171105,171105,4,0,3,113,1.3333333333333333,2.5297046,1
2020-04-29-171105,171105,2,0,1,115,1.3333333333333333,1.8733393,2
2020-04-30-171105,171105,3,0,7,118,1.1666666666666667,2.363485,3
2020-05-01-171105,171105,0,0,0,118,0.5,0.20591724,4
2020-05-02-171105,171105,1,0,1,119,0.0,0.30702505,5
2020-05-03-171105,171105,0,0,0,119,0.16666666666666666,0.17483546,6
2020-05-04-171105,171105,1,0,2,120,1.0,1.3890388,0
2020-05-05-171105,171105,0,0,3,120,1.0,1.3584112,1
2020-05-06-171105,171105,2,0,3,122,1.3333333333333333,2.249327,2
2020-05-07-171105,171105,4,0,2,126,4.5,7.6769238,3
2020-05-08-171105,171105,2,0,0,128,1.1666666666666667,2.1854124,4
2020-05-09-171105,171105,1,0,0,129,0.16666666666666666,0.39537516,5
2020-05-10-171105,171105,1,0,0,130,0.16666666666666666,0.36816585,6
2020-05-11-171105,171105,0,0,0,130,0.8333333333333334,1.1296101,0
2020-05-12-171105,171105,3,0,0,133,0.6666666666666666,1.7223957,1
2020-05-13-171105,171105,1,0,0,134,2.5,3.3350694,2
2020-05-14-171105,171105,7,0,3,141,0.3333333333333333,2.778022,3
2020-05-15-171105,171105,0,0,0,141,0.8333333333333334,1.0972232,4
2020-05-16-171105,171105,1,0,0,142,0.0,0.31665564,5
2020-05-17-171105,171105,0,0,0,142,0.0,0.0069854036,6
2020-05-18-171105,171105,2,0,0,144,1.5,2.0237782,0
2020-05-19-171105,171105,3,0,4,147,0.8333333333333334,1.9798435,1
2020-05-20-171105,171105,3,0,3,150,1.0,2.3791685,2
2020-05-21-171105,171105,2,0,4,152,0.5,1.6167855,3
2020-05-22-171105,171105,0,0,0,152,1.1666666666666667,1.5796193,4
2020-05-23-171105,171105,0,0,1,152,0.0,0.005047055,5
2020-05-24-171105,171105,0,0,0,152,0.0,0.006660248,6
2020-05-25-171105,171105,0,0,1,152,0.16666666666666666,0.10937995,0
2020-05-26-171105,171105,0,0,1,152,0.6666666666666666,1.2266847,1
2020-05-27-171105,171105,0,1,0,152,0.16666666666666666,0.39422256,2
2020-05-28-171105,171105,3,1,0,155,0.6666666666666666,2.1757505,3
2020-05-29-171105,171105,0,0,2,155,0.3333333333333333,0.63963175,4
2020-05-30-171105,171105,0,1,0,155,0.0,0.014802342,5
2020-05-31-171105,171105,0,0,0,155,0.0,0.0075744484,6
2020-06-01-171105,171105,0,1,0,155,0.6666666666666666,1.13708,0
2020-06-02-171105,171105,4,0,1,159,0.16666666666666666,1.9602923,1
2020-06-03-171105,171105,3,0,1,162,0.0,1.1702157,2
2020-06-04-171105,171105,4,0,1,166,1.0,2.8197558,3
2020-06-05-171105,171105,0,0,0,166,0.6666666666666666,0.8735371,4
2020-06-06-171105,171105,1,0,0,167,0.0,0.36139148,5
2020-06-07-171105,171105,0,0,0,167,0.0,0.004895267,6
2020-06-08-171105,171105,1,0,1,168,0.6666666666666666,1.3756942,0
2020-06-09-171105,171105,1,0,1,169,0.0,0.8705263,1
2020-06-10-171105,171105,0,0,1,169,0.3333333333333333,0.24393499,2
2020-06-11-171105,171105,0,0,1,169,0.6666666666666666,0.9406199,3
2020-06-12-171105,171105,2,0,2,171,0.16666666666666666,1.1225737,4
2020-06-13-171105,171105,0,0,1,171,0.0,0.002489433,5
2020-06-14-171105,171105,0,4,0,171,0.0,0.0011426124,6
2020-06-15-171105,171105,0,1,0,171,0.5,0.6441975,0
2020-06-16-171105,171105,1,0,0,172,0.0,0.41962603,1
2020-06-17-171105,171105,1,0,0,173,0.16666666666666666,0.72471285,2
2020-06-18-171105,171105,1,0,1,174,0.16666666666666666,0.77362376,3
2020-06-19-171105,171105,0,0,1,174,0.0,0.069148466,4
2020-06-20-171105,171105,0,0,0,174,0.0,0.002672661,5
2020-06-21-171105,171105,0,0,0,174,0.0,0.00046926792,6
2020-06-22-171105,171105,1,0,0,175,0.0,0.4575689,0
2020-06-23-171105,171105,1,0,0,176,0.3333333333333333,1.1844077,1
2020-06-24-171105,171105,1,0,0,177,0.3333333333333333,1.0861906,2
2020-06-25-171105,171105,1,0,1,178,0.16666666666666666,0.10154632,3
2020-06-26-171105,171105,2,0,2,180,0.3333333333333333,1.3660911,4
2020-06-27-171105,171105,1,0,0,181,0.0,0.39003694,5
2020-06-28-171105,171105,0,0,0,181,0.0,0.002791266,6
2020-06-29-171105,171105,0,0,0,181,0.3333333333333333,0.34551483,0
2020-06-30-171105,171105,0,0,0,181,0.3333333333333333,0.2213544,1
2020-07-01-171105,171105,0,0,0,181,0.16666666666666666,0.031933747,2
2020-07-02-171105,171105,1,0,0,182,0.0,0.48736137,3
2020-07-03-171105,171105,1,0,0,183,0.0,0.48588747,4
2020-07-04-171105,171105,0,0,0,183,0.0,0.0014312842,5
2020-07-05-171105,171105,0,0,0,183,0.0,0.0048465016,6
2020-07-06-171105,171105,0,0,2,183,0.16666666666666666,0.3460961,0
2020-07-07-171105,171105,0,0,0,183,0.0,0.008190972,1
2020-07-08-171105,171105,0,0,0,183,0.5,0.36305374,2
2020-07-09-171105,171105,1,0,0,184,0.0,0.46368414,3
2020-07-10-171105,171105,2,0,0,186,0.8333333333333334,1.7982751,4
2020-07-11-171105,171105,0,0,0,186,0.16666666666666666,0.0038125413,5
2020-07-12-171105,171105,0,0,0,186,0.0,0.0047480585,6
2020-07-13-171105,171105,0,0,0,186,0.0,0.021542557,0
2020-07-14-171105,171105,0,0,1,186,0.0,0.01723781,1
2020-07-15-171105,171105,0,0,2,186,0.16666666666666666,0.030579401,2
2020-07-16-171105,171105,0,0,0,186,0.0,0.024645675,3
2020-07-17-171105,171105,0,0,0,186,0.16666666666666666,0.3543042,4
2020-07-18-171105,171105,0,0,0,186,0.0,0.01796053,5
2020-07-19-171105,171105,0,0,0,186,0.16666666666666666,0.027345764,6
2020-07-20-171105,171105,2,0,0,188,0.0,0.86663073,0
2020-07-21-171105,171105,0,0,0,188,0.0,0.025958955,1
2020-07-22-171105,171105,0,0,1,188,0.0,0.013026306,2
2020-07-23-171105,171105,0,0,1,188,0.16666666666666666,0.2617063,3
2020-07-24-171105,171105,0,0,0,188,0.0,0.03740584,4
2020-07-25-171105,171105,0,0,0,188,0.0,0.0021919059,5
2020-07-26-171105,171105,0,0,1,188,0.0,0.00096099573,6
2020-07-27-171105,171105,0,0,1,188,0.0,0.03816463,0
2020-07-28-171105,171105,1,0,1,189,0.0,0.4568369,1
2020-07-29-171105,171105,2,0,0,191,0.16666666666666666,0.7591046,2
2020-07-30-171105,171105,0,0,1,191,0.16666666666666666,0.39997962,3
2020-07-31-171105,171105,0,0,3,191,0.6666666666666666,0.40005293,4
2020-08-01-171105,171105,0,0,4,191,0.0,0.025361938,5
2020-08-02-171105,171105,0,0,1,191,0.16666666666666666,0.06375046,6
2020-08-03-171105,171105,0,0,3,191,0.5,0.69067186,0
2020-08-04-171105,171105,0,0,3,191,0.0,0.044494405,1
2020-08-05-171105,171105,1,0,2,192,0.3333333333333333,0.8281007,2
2020-08-06-171105,171105,1,0,5,193,0.0,0.656988,3
2020-08-07-171105,171105,0,0,7,193,0.16666666666666666,0.4661482,4
2020-08-08-171105,171105,0,0,0,193,0.0,0.8397436,5
2020-08-09-171105,171105,1,0,1,194,0.5,0.788056,6
2020-08-10-171105,171105,1,0,1,195,0.16666666666666666,0.5537299,0
2020-08-11-171105,171105,1,0,1,196,0.6666666666666666,1.6719593,1
2020-08-12-171105,171105,0,0,2,196,0.3333333333333333,0.8905837,2
2020-08-13-171105,171105,1,0,2,197,0.0,1.2473598,3
2020-08-14-171105,171105,3,0,2,200,0.0,1.8707715,4
2020-08-15-171105,171105,4,0,4,204,0.6666666666666666,2.4982634,5
2020-08-16-171105,171105,1,0,0,205,0.3333333333333333,0.64077604,6
2020-08-17-171105,171105,3,0,2,208,0.6666666666666666,2.440174,0
2020-08-18-171105,171105,3,0,3,211,0.6666666666666666,3.3546462,1
2020-08-19-171105,171105,2,0,3,213,0.8333333333333334,3.8099422,2
2020-08-20-171105,171105,5,0,3,218,1.0,4.8581934,3
2020-08-21-171105,171105,7,0,2,225,1.0,4.476908,4
2020-08-22-171105,171105,0,0,1,225,0.5,1.0894356,5
2020-08-23-171105,171105,1,0,0,226,0.16666666666666666,1.0894957,6
2020-08-24-171105,171105,1,0,0,227,0.3333333333333333,1.9484047,0
2020-08-25-171105,171105,1,0,6,228,0.6666666666666666,1.1192997,1
2020-08-26-171105,171105,2,0,2,230,1.8333333333333333,4.0763426,2
2020-08-27-171105,171105,2,0,2,232,1.0,2.5186677,3
2020-08-28-171105,171105,2,0,2,234,0.6666666666666666,1.9663663,4
2020-08-29-171105,171105,4,0,1,238,1.5,2.4153616,5
2020-08-30-171105,171105,0,0,0,238,0.6666666666666666,0.43973356,6
2020-08-31-171105,171105,2,0,1,240,0.8333333333333334,2.151435,0
2020-09-01-171105,171105,3,0,1,243,0.16666666666666666,0.84149224,1
2020-09-02-171105,171105,3,0,2,246,1.6666666666666667,4.4752703,2
2020-09-03-171105,171105,3,0,4,249,0.8333333333333334,2.9779227,3
2020-09-04-171105,171105,2,0,8,251,1.6666666666666667,3.1929471,4
2020-09-05-171105,171105,1,0,7,252,0.3333333333333333,1.188181,5
2020-09-06-171105,171105,0,0,4,252,0.0,0.26682433,6
2020-09-07-171105,171105,0,0,0,252,0.6666666666666666,0.77571255,0
2020-09-08-171105,171105,6,0,2,258,1.1666666666666667,4.912935,1
2020-09-09-171105,171105,2,0,9,260,0.8333333333333334,2.3474576,2
2020-09-10-171105,171105,2,0,5,262,1.6666666666666667,2.583224,3
2020-09-11-171105,171105,2,0,8,264,0.8333333333333334,2.685161,4
2020-09-12-171105,171105,1,0,4,265,0.3333333333333333,0.599682,5
2020-09-13-171105,171105,0,0,1,265,1.0,0.8064322,6
2020-09-14-171105,171105,1,0,0,266,0.8333333333333334,1.2141694,0
2020-09-15-171105,171105,1,0,5,267,1.5,1.9248046,1
2020-09-16-171105,171105,2,0,4,269,1.6666666666666667,2.5657551,2
2020-09-17-171105,171105,4,0,4,273,12.833333333333336,13.464767,3
2020-09-18-171105,171105,8,0,3,281,2.5,4.5430303,4
2020-09-19-171105,171105,7,0,4,288,1.5,4.0401726,5
2020-09-20-171105,171105,4,0,0,292,0.5,2.065531,6
2020-09-21-171105,171105,0,0,1,292,1.5,2.0871174,0
2020-09-22-171105,171105,2,0,2,294,1.8333333333333333,4.8564014,1
2020-09-23-171105,171105,9,0,4,303,1.8333333333333333,6.465965,2
2020-09-24-171105,171105,5,2,3,308,0.8333333333333334,4.3195996,3
2020-09-25-171105,171105,8,0,4,316,0.5,3.5784245,4
2020-09-26-171105,171105,4,0,4,320,0.16666666666666666,2.2454624,5
2020-09-27-171105,171105,1,0,0,321,0.3333333333333333,1.0797938,6
2020-09-28-171105,171105,0,0,1,321,0.0,0.4824366,0
2020-09-29-171105,171105,5,1,1,326,0.8333333333333334,2.442928,1
2020-09-30-171105,171105,4,0,5,330,0.5,2.5429451,2
2020-10-01-171105,171105,4,0,12,334,0.6666666666666666,3.436479,3
2020-10-02-171105,171105,3,0,2,337,1.1666666666666667,3.3176036,4
2020-10-03-171105,171105,4,0,3,341,0.3333333333333333,1.4535384,5
2020-10-04-171105,171105,0,0,3,341,0.3333333333333333,0.2716234,6
2020-10-05-171105,171105,1,0,3,342,0.5,1.4193953,0
2020-10-06-171105,171105,2,1,7,344,1.0,2.5798202,1
2020-10-07-171105,171105,4,0,13,348,1.6666666666666667,4.131957,2
2020-10-08-171105,171105,3,1,6,351,1.8333333333333333,4.110559,3
2020-10-09-171105,171105,4,0,15,355,5.333333333333333,8.699103,4
2020-10-10-171105,171105,4,0,8,359,1.1666666666666667,2.1953204,5
2020-10-11-171105,171105,0,0,19,359,0.5,0.3567503,6
2020-10-12-171105,171105,1,0,16,360,1.6666666666666667,1.2464731,0
2020-10-13-171105,171105,1,0,12,361,2.1666666666666665,2.8858533,1
2020-10-14-171105,171105,5,0,22,366,2.6666666666666665,6.4987884,2
2020-10-15-171105,171105,12,0,15,378,4.333333333333333,11.518485,3
2020-10-16-171105,171105,2,0,47,380,6.833333333333332,10.028084,4
2020-10-17-171105,171105,3,0,3,383,1.5,2.598384,5
2020-10-18-171105,171105,3,0,15,386,0.6666666666666666,1.6548074,6
2020-10-19-171105,171105,3,0,3,389,2.0,3.8271255,0
2020-10-20-171105,171105,7,0,19,396,4.333333333333333,9.851157,1
2020-10-21-171105,171105,13,0,24,409,5.666666666666668,14.046284,2
2020-10-22-171105,171105,6,0,22,415,1.3333333333333333,4.3719606,3
2020-10-23-171105,171105,15,0,22,430,9.166666666666666,17.348396,4
2020-10-24-171105,171105,8,0,8,438,0.6666666666666666,2.781123,5
2020-10-25-171105,171105,19,0,1,457,2.1666666666666665,6.0030217,6
2020-10-26-171105,171105,16,1,15,473,2.6666666666666665,10.318017,0
2020-10-27-171105,171105,12,0,10,485,2.1666666666666665,7.50202,1
2020-10-28-171105,171105,22,0,20,507,6.0,16.961,2
2020-10-29-171105,171105,15,2,17,522,3.8333333333333335,11.905647,3
2020-10-30-171105,171105,47,0,7,569,5.5,22.423021,4
2020-10-31-171105,171105,3,2,0,572,1.0,1.5192492,5
2020-11-01-171105,171105,15,0,0,587,4.666666666666667,5.2579255,6
2020-11-02-171105,171105,3,1,0,590,0.8333333333333334,1.3644229,0
2020-11-03-171105,171105,19,0,0,609,3.1666666666666665,14.270432,1
2020-11-04-171105,171105,24,0,0,633,4.5,16.14469,2
2020-11-05-171105,171105,22,1,0,655,5.666666666666668,17.334715,3
2020-11-06-171105,171105,22,4,0,677,5.0,11.8010025,4
2020-11-07-171105,171105,8,0,0,685,2.6666666666666665,4.693755,5
2020-11-08-171105,171105,1,0,0,686,1.6666666666666667,0.8892587,6
2020-11-09-171105,171105,15,2,0,701,2.833333333333333,10.535456,0
2020-11-10-171105,171105,10,0,0,711,3.8333333333333335,6.674821,1
2020-11-11-171105,171105,20,1,0,731,7.5,18.883902,2
2020-11-12-171105,171105,17,3,0,748,7.0,14.096888,3
2020-11-13-171105,171105,7,2,0,755,8.666666666666666,8.8997345,4
2020-03-01-171106,171106,0,0,0,0,0.0,1.3658645e-09,6
2020-03-02-171106,171106,0,0,0,0,0.0,0.005050486,0
2020-03-03-171106,171106,0,0,0,0,0.0,5.515601e-07,1
2020-03-04-171106,171106,0,0,0,0,0.0,0.0045705186,2
2020-03-05-171106,171106,0,0,0,0,0.0,0.000107818516,3
2020-03-06-171106,171106,0,0,0,0,0.0,0.00016610105,4
2020-03-07-171106,171106,0,0,1,0,0.2,0.061069354,5
2020-03-08-171106,171106,0,0,0,0,0.0,0.00026645992,6
2020-03-09-171106,171106,0,0,1,0,0.0,0.015766814,0
2020-03-10-171106,171106,0,0,0,0,0.0,0.007915436,1
2020-03-11-171106,171106,0,0,0,0,0.0,0.012820577,2
2020-03-12-171106,171106,0,0,0,0,0.0,0.028955348,3
2020-03-13-171106,171106,0,0,1,0,0.2,0.07159769,4
2020-03-14-171106,171106,0,0,0,0,0.2,0.06475877,5
2020-03-15-171106,171106,0,0,0,0,0.2,0.0067103356,6
2020-03-16-171106,171106,0,0,0,0,0.4,0.05424475,0
2020-03-17-171106,171106,0,0,0,0,2.2,0.20173873,1
2020-03-18-171106,171106,0,0,1,0,3.2,0.2286086,2
2020-03-19-171106,171106,0,0,0,0,3.0,0.2171501,3
2020-03-20-171106,171106,0,1,0,0,3.2,0.21450308,4
2020-03-21-171106,171106,1,1,0,1,0.8,0.08470327,5
2020-03-22-171106,171106,0,2,0,1,1.0,0.017026516,6
2020-03-23-171106,171106,1,0,0,2,4.0,0.2911282,0
2020-03-24-171106,171106,0,0,0,2,2.0,0.110452995,1
2020-03-25-171106,171106,0,0,0,2,2.0,0.18230662,2
2020-03-26-171106,171106,0,0,0,2,1.6,0.1099328,3
2020-03-27-171106,171106,1,0,1,3,3.6,0.2772986,4
2020-03-28-171106,171106,0,0,0,3,0.6,0.017171932,5
2020-03-29-171106,171106,0,0,0,3,1.2,0.031627588,6
2020-03-30-171106,171106,0,1,0,3,1.4,0.10615316,0
2020-03-31-171106,171106,0,0,0,3,2.2,0.13469936,1
2020-04-01-171106,171106,1,0,0,4,3.0,0.3865697,2
2020-04-02-171106,171106,0,0,0,4,3.0,0.16022454,3
2020-04-03-171106,171106,0,0,0,4,2.2,0.2730087,4
2020-04-04-171106,171106,0,0,0,4,1.0,0.11168478,5
2020-04-05-171106,171106,0,0,0,4,0.2,0.010580362,6
2020-04-06-171106,171106,0,0,0,4,2.0,0.13706917,0
2020-04-07-171106,171106,0,0,0,4,1.8,0.1565784,1
2020-04-08-171106,171106,0,1,1,4,0.8,0.09413101,2
2020-04-09-171106,171106,0,0,0,4,4.2,0.10991479,3
2020-04-10-171106,171106,1,0,0,5,4.0,0.08000839,4
2020-04-11-171106,171106,0,0,0,5,0.4,0.022220103,5
2020-04-12-171106,171106,0,0,0,5,0.0,0.01442259,6
2020-04-13-171106,171106,0,0,0,5,1.0,0.0709756,0
2020-04-14-171106,171106,0,0,0,5,1.6,0.14438903,1
2020-04-15-171106,171106,0,0,2,5,0.2,0.034599055,2
2020-04-16-171106,171106,0,0,0,5,1.4,0.11020453,3
2020-04-17-171106,171106,0,0,0,5,1.2,0.11085789,4
2020-04-18-171106,171106,0,0,0,5,0.6,0.018585276,5
2020-04-19-171106,171106,0,0,0,5,0.2,0.017801167,6
2020-04-20-171106,171106,0,0,0,5,0.0,0.034652144,0
2020-04-21-171106,171106,0,0,0,5,2.4,0.17875877,1
2020-04-22-171106,171106,1,0,0,6,1.0,0.06565666,2
2020-04-23-171106,171106,0,0,1,6,0.4,0.022457661,3
2020-04-24-171106,171106,0,0,0,6,1.8,0.16943471,4
2020-04-25-171106,171106,0,0,0,6,0.0,0.008787446,5
2020-04-26-171106,171106,0,0,0,6,0.2,0.006023535,6
2020-04-27-171106,171106,0,0,0,6,1.8,0.096161254,0
2020-04-28-171106,171106,0,0,0,6,2.4,0.14025377,1
2020-04-29-171106,171106,2,0,0,8,1.0,0.12852725,2
2020-04-30-171106,171106,0,0,1,8,2.0,0.10328052,3
2020-05-01-171106,171106,0,0,0,8,0.4,0.010754443,4
2020-05-02-171106,171106,0,0,0,8,0.2,0.015243994,5
2020-05-03-171106,171106,0,0,0,8,0.2,0.007072719,6
2020-05-04-171106,171106,0,0,2,8,1.2,0.08704991,0
2020-05-05-171106,171106,0,0,0,8,1.2,0.09347895,1
2020-05-06-171106,171106,0,0,0,8,1.6,0.14461218,2
2020-05-07-171106,171106,1,0,0,9,6.0,0.31030047,3
2020-05-08-171106,171106,0,0,1,9,1.2,0.09373407,4
2020-05-09-171106,171106,0,0,0,9,0.4,0.015209412,5
2020-05-10-171106,171106,0,0,0,9,0.4,0.011414865,6
2020-05-11-171106,171106,0,0,0,9,1.0,0.09462949,0
2020-05-12-171106,171106,0,0,0,9,1.6,0.18772253,1
2020-05-13-171106,171106,0,0,0,9,3.0,0.16838624,2
2020-05-14-171106,171106,1,0,0,10,1.6,0.120270185,3
2020-05-15-171106,171106,0,0,0,10,1.2,0.19543019,4
2020-05-16-171106,171106,0,0,0,10,0.2,0.015874153,5
2020-05-17-171106,171106,0,0,0,10,0.0,0.0005842252,6
2020-05-18-171106,171106,2,0,0,12,1.6,0.20454562,0
2020-05-19-171106,171106,0,0,0,12,1.4,0.1563695,1
2020-05-20-171106,171106,0,0,0,12,1.4,0.08955519,2
2020-05-21-171106,171106,0,0,0,12,1.0,0.07504663,3
2020-05-22-171106,171106,1,0,0,13,1.2,0.07387104,4
2020-05-23-171106,171106,0,0,0,13,0.0,0.00064106577,5
2020-05-24-171106,171106,0,0,0,13,0.0,0.0023341046,6
2020-05-25-171106,171106,0,0,0,13,0.0,0.026725568,0
2020-05-26-171106,171106,0,0,0,13,0.8,0.103122965,1
2020-05-27-171106,171106,0,1,0,13,0.4,0.02029026,2
2020-05-28-171106,171106,0,1,0,13,1.4,0.107351914,3
2020-05-29-171106,171106,0,0,0,13,0.4,0.03823106,4
2020-05-30-171106,171106,0,0,0,13,0.0,0.0007246306,5
2020-05-31-171106,171106,0,0,0,13,0.0,0.0045806533,6
2020-06-01-171106,171106,0,0,0,13,0.8,0.047774065,0
2020-06-02-171106,171106,0,0,0,13,1.0,0.09788778,1
2020-06-03-171106,171106,0,0,0,13,0.6,0.049876988,2
2020-06-04-171106,171106,0,0,0,13,2.0,0.1414183,3
2020-06-05-171106,171106,0,0,0,13,0.6,0.038280487,4
2020-06-06-171106,171106,0,0,0,13,0.2,0.018819712,5
2020-06-07-171106,171106,0,0,0,13,0.0,0.00040800514,6
2020-06-08-171106,171106,0,0,0,13,0.8,0.063843876,0
2020-06-09-171106,171106,0,0,0,13,0.2,0.042095535,1
2020-06-10-171106,171106,0,0,0,13,0.0,0.03931507,2
2020-06-11-171106,171106,0,0,0,13,0.6,0.05355008,3
2020-06-12-171106,171106,0,0,0,13,0.6,0.055183157,4
2020-06-13-171106,171106,0,1,0,13,0.0,0.00034880533,5
2020-06-14-171106,171106,0,0,0,13,0.0,0.00016236083,6
2020-06-15-171106,171106,0,0,0,13,0.4,0.035071254,0
2020-06-16-171106,171106,0,0,0,13,0.2,0.017534606,1
2020-06-17-171106,171106,0,0,0,13,0.4,0.03799832,2
2020-06-18-171106,171106,0,0,0,13,0.4,0.035077564,3
2020-06-19-171106,171106,0,0,0,13,0.0,0.016773649,4
2020-06-20-171106,171106,0,0,0,13,0.0,0.0020186258,5
2020-06-21-171106,171106,0,0,0,13,0.0,0.0001774665,6
2020-06-22-171106,171106,0,0,0,13,0.2,0.021694597,0
2020-06-23-171106,171106,0,0,0,13,0.8,0.11645388,1
2020-06-24-171106,171106,0,0,0,13,0.6,0.054028854,2
2020-06-25-171106,171106,0,0,0,13,0.2,0.009295996,3
2020-06-26-171106,171106,0,0,0,13,0.8,0.06217301,4
2020-06-27-171106,171106,0,0,0,13,0.2,0.019006815,5
2020-06-28-171106,171106,0,0,0,13,0.0,0.0006057236,6
2020-06-29-171106,171106,0,0,0,13,0.2,0.016524453,0
2020-06-30-171106,171106,0,0,0,13,0.0,0.012171967,1
2020-07-01-171106,171106,0,0,0,13,0.0,0.0011499296,2
2020-07-02-171106,171106,0,0,0,13,0.2,0.02657589,3
2020-07-03-171106,171106,0,0,0,13,0.2,0.04797427,4
2020-07-04-171106,171106,0,0,0,13,0.0,0.00018338137,5
2020-07-05-171106,171106,0,0,0,13,0.0,0.00039358728,6
2020-07-06-171106,171106,0,0,0,13,0.2,0.02155251,0
2020-07-07-171106,171106,0,0,0,13,0.0,0.00059751334,1
2020-07-08-171106,171106,0,0,0,13,0.2,0.03169615,2
2020-07-09-171106,171106,0,0,0,13,0.2,0.026834253,3
2020-07-10-171106,171106,0,0,0,13,0.8,0.09268884,4
2020-07-11-171106,171106,0,0,0,13,0.0,0.0007390839,5
2020-07-12-171106,171106,0,0,0,13,0.0,0.0007875169,6
2020-07-13-171106,171106,0,0,0,13,0.0,0.0039577526,0
2020-07-14-171106,171106,0,0,0,13,0.0,0.0028798277,1
2020-07-15-171106,171106,0,0,0,13,0.2,0.0015619188,2
2020-07-16-171106,171106,0,0,0,13,0.0,0.0036485565,3
2020-07-17-171106,171106,0,0,0,13,0.2,0.018386599,4
2020-07-18-171106,171106,0,0,0,13,0.0,0.004034424,5
2020-07-19-171106,171106,0,0,0,13,0.0,0.0012772906,6
2020-07-20-171106,171106,0,0,0,13,0.4,0.037457485,0
2020-07-21-171106,171106,0,0,0,13,0.0,0.0013835498,1
2020-07-22-171106,171106,0,0,0,13,0.0,0.0014668406,2
2020-07-23-171106,171106,0,0,0,13,0.0,0.009235216,3
2020-07-24-171106,171106,0,0,0,13,0.0,0.0067897364,4
2020-07-25-171106,171106,0,0,0,13,0.0,0.00015919554,5
2020-07-26-171106,171106,0,0,0,13,0.0,0.00022731887,6
2020-07-27-171106,171106,0,0,0,13,0.0,0.0070054554,0
2020-07-28-171106,171106,0,0,0,13,0.2,0.02135517,1
2020-07-29-171106,171106,0,0,0,13,0.6,0.037942346,2
2020-07-30-171106,171106,0,0,0,13,0.4,0.09765421,3
2020-07-31-171106,171106,0,0,0,13,0.8,0.04297163,4
2020-08-01-171106,171106,0,0,0,13,0.0,0.013203731,5
2020-08-02-171106,171106,0,0,0,13,0.0,0.013921643,6
2020-08-03-171106,171106,0,0,0,13,0.6,0.0619598,0
2020-08-04-171106,171106,0,0,0,13,0.0,0.004784413,1
2020-08-05-171106,171106,0,0,0,13,0.4,0.04030475,2
2020-08-06-171106,171106,0,0,0,13,0.2,0.042576984,3
2020-08-07-171106,171106,0,0,1,13,0.0,0.098099366,4
2020-08-08-171106,171106,0,0,1,13,0.0,0.054401763,5
2020-08-09-171106,171106,0,0,1,13,0.4,0.18748245,6
2020-08-10-171106,171106,0,0,0,13,0.2,0.034141544,0
2020-08-11-171106,171106,0,0,0,13,0.4,0.102813065,1
2020-08-12-171106,171106,0,0,0,13,0.4,0.06672452,2
2020-08-13-171106,171106,0,0,0,13,0.2,0.119030386,3
2020-08-14-171106,171106,0,0,1,13,0.6,0.13828173,4
2020-08-15-171106,171106,0,0,0,13,1.8,0.24497269,5
2020-08-16-171106,171106,0,0,2,13,1.0,0.21274813,6
2020-08-17-171106,171106,0,0,1,13,1.4,0.17707993,0
2020-08-18-171106,171106,0,0,0,13,1.4,0.21357813,1
2020-08-19-171106,171106,0,0,0,13,2.6,0.5482321,2
2020-08-20-171106,171106,0,0,1,13,1.4,0.41590637,3
2020-08-21-171106,171106,1,0,1,14,2.4,0.46883005,4
2020-08-22-171106,171106,1,0,0,15,0.8,0.5774428,5
2020-08-23-171106,171106,1,0,0,16,0.8,0.18649507,6
2020-08-24-171106,171106,0,0,0,16,1.0,0.40904468,0
2020-08-25-171106,171106,0,0,2,16,1.4,0.43328458,1
2020-08-26-171106,171106,0,0,1,16,1.6,0.26603785,2
2020-08-27-171106,171106,0,0,4,16,0.8,0.16232169,3
2020-08-28-171106,171106,1,0,0,17,1.4,0.3404258,4
2020-08-29-171106,171106,0,0,0,17,0.8,0.15008773,5
2020-08-30-171106,171106,2,0,3,19,0.2,0.190144,6
2020-08-31-171106,171106,1,0,0,20,2.0,0.3456484,0
2020-09-01-171106,171106,0,0,5,20,1.0,0.14600909,1
2020-09-02-171106,171106,0,0,0,20,2.8,0.35932848,2
2020-09-03-171106,171106,1,0,2,21,1.4,0.6073297,3
2020-09-04-171106,171106,1,0,1,22,1.8,0.32235837,4
2020-09-05-171106,171106,0,0,0,22,0.8,0.080732815,5
2020-09-06-171106,171106,0,0,0,22,0.2,0.22024524,6
2020-09-07-171106,171106,0,0,1,22,0.0,0.15052691,0
2020-09-08-171106,171106,2,0,1,24,3.8,0.98780817,1
2020-09-09-171106,171106,1,0,0,25,2.2,0.8497189,2
2020-09-10-171106,171106,4,0,1,29,2.0,0.5676532,3
2020-09-11-171106,171106,0,0,0,29,0.4,0.23709303,4
2020-09-12-171106,171106,0,0,0,29,0.2,0.24040167,5
2020-09-13-171106,171106,3,0,0,32,0.4,0.1394344,6
2020-09-14-171106,171106,0,0,0,32,0.4,0.15757325,0
2020-09-15-171106,171106,5,0,0,37,1.0,0.47964793,1
2020-09-16-171106,171106,0,0,0,37,1.4,0.39854136,2
2020-09-17-171106,171106,2,0,0,39,1.6,1.1654879,3
2020-09-18-171106,171106,1,0,0,40,3.0,0.49306685,4
2020-09-19-171106,171106,0,1,0,40,2.2,0.22652572,5
2020-09-20-171106,171106,0,0,1,40,1.4,0.2072353,6
2020-09-21-171106,171106,1,0,0,41,0.8,0.26800966,0
2020-09-22-171106,171106,1,3,0,42,4.8,1.3634001,1
2020-09-23-171106,171106,0,0,0,42,2.4,0.38500294,2
2020-09-24-171106,171106,1,0,0,43,3.0,0.82912683,3
2020-09-25-171106,171106,0,0,2,43,2.2,0.3566803,4
2020-09-26-171106,171106,0,0,1,43,1.2,0.17444585,5
2020-09-27-171106,171106,0,0,2,43,0.2,0.094027,6
2020-09-28-171106,171106,0,0,5,43,0.8,0.22727603,0
2020-09-29-171106,171106,0,0,0,43,1.6,0.20345831,1
2020-09-30-171106,171106,0,0,0,43,1.0,0.22866647,2
2020-10-01-171106,171106,0,0,1,43,2.2,0.3400468,3
2020-10-02-171106,171106,0,0,6,43,1.4,0.29048258,4
2020-10-03-171106,171106,0,0,0,43,0.8,0.10344767,5
2020-10-04-171106,171106,1,0,0,44,0.0,0.06477702,6
2020-10-05-171106,171106,0,1,6,44,0.6,0.15271087,0
2020-10-06-171106,171106,0,0,0,44,1.2,0.3047643,1
2020-10-07-171106,171106,0,0,0,44,2.4,0.2782464,2
2020-10-08-171106,171106,0,0,2,44,1.6,0.43157154,3
2020-10-09-171106,171106,2,0,7,46,6.0,0.49620822,4
2020-10-10-171106,171106,1,0,3,47,0.8,0.14137605,5
2020-10-11-171106,171106,2,0,2,49,0.0,0.08435609,6
2020-10-12-171106,171106,5,0,1,54,1.0,0.2367264,0
2020-10-13-171106,171106,0,0,3,54,1.2,0.13216825,1
2020-10-14-171106,171106,0,0,1,54,3.6,0.47809932,2
2020-10-15-171106,171106,1,0,4,55,4.6,0.6532053,3
2020-10-16-171106,171106,6,0,5,61,4.4,0.6882827,4
2020-10-17-171106,171106,0,0,2,61,0.8,0.2132895,5
2020-10-18-171106,171106,0,0,2,61,1.2,0.23046434,6
2020-10-19-171106,171106,6,0,2,67,1.6,0.40143034,0
2020-10-20-171106,171106,0,0,0,67,3.4,0.5315337,1
2020-10-21-171106,171106,0,0,0,67,5.6,0.9364754,2
2020-10-22-171106,171106,2,0,4,69,2.4,0.57871574,3
2020-10-23-171106,171106,7,0,5,76,11.6,1.3881459,4
2020-10-24-171106,171106,3,0,0,79,1.8,0.33120984,5
2020-10-25-171106,171106,2,0,6,81,5.2,0.51887494,6
2020-10-26-171106,171106,1,0,2,82,6.4,0.9024222,0
2020-10-27-171106,171106,3,0,8,85,6.0,1.2874831,1
2020-10-28-171106,171106,1,3,2,86,10.4,1.2114359,2
2020-10-29-171106,171106,4,0,4,90,6.8,0.9442914,3
2020-10-30-171106,171106,5,0,8,95,16.4,2.4288921,4
2020-10-31-171106,171106,2,0,0,97,1.6,0.36478326,5
2020-11-01-171106,171106,2,0,0,99,3.4,0.46089578,6
2020-11-02-171106,171106,2,0,0,101,1.4,0.2416689,0
2020-11-03-171106,171106,0,0,0,101,7.4,0.9519066,1
2020-11-04-171106,171106,0,1,0,101,9.6,1.1102588,2
2020-11-05-171106,171106,4,2,0,105,9.0,1.2199543,3
2020-11-06-171106,171106,5,2,0,110,8.4,1.2633106,4
2020-11-07-171106,171106,0,0,0,110,3.4,0.46072274,5
2020-11-08-171106,171106,6,0,0,116,0.6,0.17737706,6
2020-11-09-171106,171106,2,0,0,118,7.2,0.8704852,0
2020-11-10-171106,171106,8,0,0,126,4.0,0.6518036,1
2020-11-11-171106,171106,2,0,0,128,11.4,0.9912431,2
2020-11-12-171106,171106,4,0,0,132,7.2,0.7895522,3
2020-11-13-171106,171106,8,0,0,140,4.8,0.82643384,4
2020-03-01-171107,171107,0,0,0,0,0.0,0.00013087342,6
2020-03-02-171107,171107,0,0,1,0,0.0,0.13439015,0
2020-03-03-171107,171107,0,0,0,0,0.0,0.000280549,1
2020-03-04-171107,171107,0,0,2,0,0.14285714285714285,0.0843276,2
2020-03-05-171107,171107,0,0,0,0,0.0,0.0006493441,3
2020-03-06-171107,171107,0,0,0,0,0.0,0.0009472413,4
2020-03-07-171107,171107,0,0,0,0,0.14285714285714285,0.1821906,5
2020-03-08-171107,171107,0,0,0,0,0.0,0.0005511189,6
2020-03-09-171107,171107,0,0,1,0,0.14285714285714285,0.19835049,0
2020-03-10-171107,171107,0,0,0,0,0.0,0.005047649,1
2020-03-11-171107,171107,0,0,2,0,0.2857142857142857,0.3664286,2
2020-03-12-171107,171107,0,0,0,0,0.42857142857142855,0.6213375,3
2020-03-13-171107,171107,0,0,0,0,0.14285714285714285,0.24100998,4
2020-03-14-171107,171107,0,0,0,0,0.14285714285714285,0.15370822,5
2020-03-15-171107,171107,0,0,0,0,0.2857142857142857,0.040016174,6
2020-03-16-171107,171107,1,0,0,1,1.2857142857142858,0.7185514,0
2020-03-17-171107,171107,0,0,1,1,1.7142857142857142,0.41438594,1
2020-03-18-171107,171107,2,1,1,3,2.2857142857142856,0.9403672,2
2020-03-19-171107,171107,0,0,0,3,2.571428571428572,0.7327571,3
2020-03-20-171107,171107,0,4,1,3,2.571428571428572,0.89986366,4
2020-03-21-171107,171107,0,0,0,3,1.2857142857142858,0.17092709,5
2020-03-22-171107,171107,0,0,1,3,0.5714285714285714,0.09356886,6
2020-03-23-171107,171107,1,0,3,4,5.142857142857143,1.1799345,0
2020-03-24-171107,171107,0,0,1,4,1.7142857142857142,0.5070666,1
2020-03-25-171107,171107,2,0,1,6,1.8571428571428568,1.0759168,2
2020-03-26-171107,171107,0,0,1,6,2.0,0.6376278,3
2020-03-27-171107,171107,0,0,0,6,2.8571428571428568,1.150251,4
2020-03-28-171107,171107,0,0,0,6,0.2857142857142857,0.03340644,5
2020-03-29-171107,171107,0,0,0,6,0.8571428571428571,0.10814242,6
2020-03-30-171107,171107,0,0,0,6,3.1428571428571432,0.975026,0
2020-03-31-171107,171107,1,0,1,7,2.8571428571428568,0.62049747,1
2020-04-01-171107,171107,1,0,0,8,2.142857142857143,1.0433698,2
2020-04-02-171107,171107,0,0,0,8,2.2857142857142856,0.6765841,3
2020-04-03-171107,171107,1,0,2,9,2.7142857142857144,0.7528638,4
2020-04-04-171107,171107,0,0,1,9,0.5714285714285714,0.12921251,5
2020-04-05-171107,171107,1,0,1,10,0.2857142857142857,0.15952116,6
2020-04-06-171107,171107,3,0,0,13,2.0,1.0550531,0
2020-04-07-171107,171107,1,0,0,14,1.5714285714285714,0.35999382,1
2020-04-08-171107,171107,1,0,0,15,2.0,0.7133064,2
2020-04-09-171107,171107,1,0,0,16,1.2857142857142858,0.4002398,3
2020-04-10-171107,171107,0,0,0,16,2.0,0.33403113,4
2020-04-11-171107,171107,0,0,0,16,1.8571428571428568,0.42163986,5
2020-04-12-171107,171107,0,1,0,16,0.8571428571428571,0.14713478,6
2020-04-13-171107,171107,0,0,0,16,3.2857142857142856,0.60093844,0
2020-04-14-171107,171107,1,0,0,17,1.8571428571428568,0.44748652,1
2020-04-15-171107,171107,0,0,2,17,0.7142857142857143,0.28052554,2
2020-04-16-171107,171107,0,0,0,17,3.4285714285714284,0.9450181,3
2020-04-17-171107,171107,2,0,1,19,1.2857142857142858,0.8001043,4
2020-04-18-171107,171107,1,0,0,20,0.14285714285714285,0.12137763,5
2020-04-19-171107,171107,1,0,0,21,0.14285714285714285,0.08980477,6
2020-04-20-171107,171107,0,0,0,21,1.0,0.3662736,0
2020-04-21-171107,171107,0,0,0,21,1.0,0.39343306,1
2020-04-22-171107,171107,0,1,1,21,0.7142857142857143,0.16346252,2
2020-04-23-171107,171107,0,0,0,21,0.2857142857142857,0.108244054,3
2020-04-24-171107,171107,0,0,0,21,2.2857142857142856,0.683928,4
2020-04-25-171107,171107,0,0,0,21,0.42857142857142855,0.1168951,5
2020-04-26-171107,171107,0,0,0,21,0.2857142857142857,0.021753594,6
2020-04-27-171107,171107,0,0,1,21,1.7142857142857142,0.8638174,0
2020-04-28-171107,171107,0,0,0,21,1.2857142857142858,0.5417084,1
2020-04-29-171107,171107,2,0,0,23,2.2857142857142856,0.74952364,2
2020-04-30-171107,171107,0,1,0,23,2.2857142857142856,1.0025795,3
2020-05-01-171107,171107,1,0,0,24,0.2857142857142857,0.13086225,4
2020-05-02-171107,171107,0,0,0,24,0.5714285714285714,0.14636892,5
2020-05-03-171107,171107,0,0,0,24,0.0,0.017374832,6
2020-05-04-171107,171107,0,0,0,24,2.2857142857142856,1.072932,0
2020-05-05-171107,171107,0,0,0,24,1.0,0.53645,1
2020-05-06-171107,171107,1,0,1,25,10.714285714285714,1.9337932,2
2020-05-07-171107,171107,0,0,0,25,4.142857142857143,1.4602484,3
2020-05-08-171107,171107,0,0,0,25,2.8571428571428568,0.9799433,4
2020-05-09-171107,171107,0,0,0,25,0.2857142857142857,0.13539223,5
2020-05-10-171107,171107,0,0,0,25,0.14285714285714285,0.019680908,6
2020-05-11-171107,171107,1,0,0,26,1.0,0.5608648,0
2020-05-12-171107,171107,0,0,0,26,4.142857142857143,0.95608854,1
2020-05-13-171107,171107,0,0,0,26,1.7142857142857142,0.84162706,2
2020-05-14-171107,171107,0,0,0,26,1.2857142857142858,0.39495426,3
2020-05-15-171107,171107,0,11,0,26,0.8571428571428571,0.45534372,4
2020-05-16-171107,171107,0,0,0,26,0.5714285714285714,0.1956709,5
2020-05-17-171107,171107,0,0,0,26,0.0,0.00051057915,6
2020-05-18-171107,171107,0,0,0,26,2.142857142857143,0.5336167,0
2020-05-19-171107,171107,0,0,0,26,2.4285714285714284,1.0012895,1
2020-05-20-171107,171107,1,0,0,27,2.2857142857142856,0.77190524,2
2020-05-21-171107,171107,0,0,0,27,1.5714285714285714,1.2200193,3
2020-05-22-171107,171107,0,0,0,27,1.4285714285714286,0.28339034,4
2020-05-23-171107,171107,0,0,0,27,0.0,0.00074619555,5
2020-05-24-171107,171107,0,0,0,27,0.14285714285714285,0.053917065,6
2020-05-25-171107,171107,0,0,0,27,0.0,0.5733585,0
2020-05-26-171107,171107,0,0,0,27,1.2857142857142858,0.7182658,1
2020-05-27-171107,171107,0,0,1,27,0.14285714285714285,0.3042349,2
2020-05-28-171107,171107,0,0,0,27,2.2857142857142856,0.42975244,3
2020-05-29-171107,171107,0,0,0,27,0.14285714285714285,0.32540464,4
2020-05-30-171107,171107,0,0,0,27,0.0,0.0046527274,5
2020-05-31-171107,171107,0,0,0,27,0.0,0.007563456,6
2020-06-01-171107,171107,0,0,0,27,0.2857142857142857,0.10091517,0
2020-06-02-171107,171107,0,0,0,27,1.1428571428571428,0.22167875,1
2020-06-03-171107,171107,0,0,0,27,0.42857142857142855,0.09532322,2
2020-06-04-171107,171107,0,0,0,27,1.1428571428571428,0.39182055,3
2020-06-05-171107,171107,0,0,0,27,0.14285714285714285,0.07065895,4
2020-06-06-171107,171107,0,0,0,27,0.42857142857142855,0.11214304,5
2020-06-07-171107,171107,0,0,0,27,0.0,0.0017118864,6
2020-06-08-171107,171107,0,0,0,27,0.2857142857142857,0.5922164,0
2020-06-09-171107,171107,0,0,0,27,0.42857142857142855,0.21908239,1
2020-06-10-171107,171107,1,0,0,28,0.8571428571428571,0.3080935,2
2020-06-11-171107,171107,0,0,0,28,0.0,0.450456,3
2020-06-12-171107,171107,0,0,0,28,0.42857142857142855,0.1476911,4
2020-06-13-171107,171107,0,0,0,28,0.0,0.0018592308,5
2020-06-14-171107,171107,0,4,0,28,0.0,0.004116999,6
2020-06-15-171107,171107,0,0,0,28,0.14285714285714285,0.18436244,0
2020-06-16-171107,171107,0,0,0,28,0.2857142857142857,0.039031,1
2020-06-17-171107,171107,0,0,0,28,0.14285714285714285,0.07747267,2
2020-06-18-171107,171107,0,0,0,28,0.14285714285714285,0.06971,3
2020-06-19-171107,171107,0,0,0,28,0.2857142857142857,0.41343558,4
2020-06-20-171107,171107,0,0,0,28,0.0,0.012966096,5
2020-06-21-171107,171107,0,0,0,28,0.0,0.000534353,6
2020-06-22-171107,171107,0,0,0,28,0.2857142857142857,0.03352832,0
2020-06-23-171107,171107,0,0,0,28,0.14285714285714285,0.09451103,1
2020-06-24-171107,171107,0,1,0,28,0.14285714285714285,0.083344266,2
2020-06-25-171107,171107,0,1,0,28,0.2857142857142857,0.041799176,3
2020-06-26-171107,171107,0,0,2,28,0.42857142857142855,0.16411811,4
2020-06-27-171107,171107,0,0,0,28,0.14285714285714285,0.026642134,5
2020-06-28-171107,171107,0,0,0,28,0.0,0.002900227,6
2020-06-29-171107,171107,0,0,0,28,0.14285714285714285,0.033879187,0
2020-06-30-171107,171107,0,0,0,28,0.2857142857142857,0.16727214,1
2020-07-01-171107,171107,0,0,0,28,0.0,0.009214052,2
2020-07-02-171107,171107,0,0,0,28,0.14285714285714285,0.043825224,3
2020-07-03-171107,171107,0,0,0,28,0.14285714285714285,0.042470776,4
2020-07-04-171107,171107,0,0,0,28,0.0,0.0027285987,5
2020-07-05-171107,171107,0,0,0,28,0.14285714285714285,0.010152914,6
2020-07-06-171107,171107,0,0,0,28,0.0,0.1761483,0
2020-07-07-171107,171107,0,0,0,28,0.0,0.0035872345,1
2020-07-08-171107,171107,0,0,0,28,0.0,0.023133919,2
2020-07-09-171107,171107,0,3,0,28,0.14285714285714285,0.032412596,3
2020-07-10-171107,171107,2,1,0,30,0.2857142857142857,0.40186763,4
2020-07-11-171107,171107,0,0,0,30,0.0,0.0047271885,5
2020-07-12-171107,171107,0,0,0,30,0.0,0.001951398,6
2020-07-13-171107,171107,0,0,0,30,0.0,0.014170643,0
2020-07-14-171107,171107,0,0,0,30,0.14285714285714285,0.041076045,1
2020-07-15-171107,171107,0,0,0,30,0.0,0.010343729,2
2020-07-16-171107,171107,0,0,0,30,0.0,0.011560393,3
2020-07-17-171107,171107,0,0,0,30,0.0,0.037103172,4
2020-07-18-171107,171107,0,0,0,30,0.0,0.009120241,5
2020-07-19-171107,171107,0,0,0,30,0.0,0.0066257827,6
2020-07-20-171107,171107,0,0,0,30,0.2857142857142857,0.05799434,0
2020-07-21-171107,171107,0,0,0,30,0.2857142857142857,0.03910355,1
2020-07-22-171107,171107,0,0,0,30,0.0,0.01348499,2
2020-07-23-171107,171107,0,0,0,30,1.1428571428571428,0.19961797,3
2020-07-24-171107,171107,0,0,0,30,0.14285714285714285,0.035687692,4
2020-07-25-171107,171107,0,0,0,30,0.0,0.0016311416,5
2020-07-26-171107,171107,0,0,1,30,0.0,0.0010836255,6
2020-07-27-171107,171107,0,0,0,30,0.0,0.16016978,0
2020-07-28-171107,171107,0,0,3,30,0.14285714285714285,0.039106973,1
2020-07-29-171107,171107,0,0,0,30,0.42857142857142855,0.090334505,2
2020-07-30-171107,171107,0,0,0,30,0.0,0.078268245,3
2020-07-31-171107,171107,0,0,0,30,0.2857142857142857,0.3744156,4
2020-08-01-171107,171107,0,0,0,30,0.0,0.0043890886,5
2020-08-02-171107,171107,0,0,0,30,0.0,0.020507379,6
2020-08-03-171107,171107,0,0,0,30,0.2857142857142857,0.15416121,0
2020-08-04-171107,171107,0,0,0,30,0.14285714285714285,0.037924826,1
2020-08-05-171107,171107,0,0,0,30,0.2857142857142857,0.06475606,2
2020-08-06-171107,171107,0,0,0,30,0.14285714285714285,0.049966637,3
2020-08-07-171107,171107,0,0,0,30,0.42857142857142855,0.57216835,4
2020-08-08-171107,171107,0,0,1,30,0.0,0.06478114,5
2020-08-09-171107,171107,1,0,0,31,0.5714285714285714,0.37669095,6
2020-08-10-171107,171107,0,0,2,31,0.2857142857142857,0.1345418,0
2020-08-11-171107,171107,3,0,0,34,0.5714285714285714,0.62131155,1
2020-08-12-171107,171107,0,0,2,34,0.42857142857142855,0.45031404,2
2020-08-13-171107,171107,0,0,3,34,1.2857142857142858,1.8537877,3
2020-08-14-171107,171107,0,0,0,34,1.1428571428571428,0.85202277,4
2020-08-15-171107,171107,0,0,8,34,1.0,0.30688167,5
2020-08-16-171107,171107,0,0,0,34,0.2857142857142857,0.06865931,6
2020-08-17-171107,171107,0,0,0,34,0.7142857142857143,0.33467716,0
2020-08-18-171107,171107,0,0,0,34,0.5714285714285714,1.6223357,1
2020-08-19-171107,171107,0,0,1,34,0.2857142857142857,0.30315048,2
2020-08-20-171107,171107,0,0,0,34,1.0,0.550162,3
2020-08-21-171107,171107,0,0,0,34,1.4285714285714286,0.5246178,4
2020-08-22-171107,171107,1,0,0,35,0.14285714285714285,0.34894875,5
2020-08-23-171107,171107,0,0,0,35,0.14285714285714285,0.11197464,6
2020-08-24-171107,171107,2,0,4,37,0.7142857142857143,0.90713,0
2020-08-25-171107,171107,0,0,1,37,0.5714285714285714,0.28128004,1
2020-08-26-171107,171107,2,0,0,39,1.0,1.3495758,2
2020-08-27-171107,171107,3,0,0,42,0.5714285714285714,0.8054152,3
2020-08-28-171107,171107,0,0,0,42,0.42857142857142855,0.3723334,4
2020-08-29-171107,171107,8,0,0,50,0.7142857142857143,1.3173666,5
2020-08-30-171107,171107,0,0,1,50,0.2857142857142857,0.17396802,6
2020-08-31-171107,171107,0,0,1,50,0.2857142857142857,0.26020044,0
2020-09-01-171107,171107,0,0,3,50,0.7142857142857143,0.8647102,1
2020-09-02-171107,171107,1,0,6,51,0.5714285714285714,0.8416905,2
2020-09-03-171107,171107,0,0,61,51,0.5714285714285714,0.33979568,3
2020-09-04-171107,171107,0,0,3,51,0.7142857142857143,0.8469544,4
2020-09-05-171107,171107,0,0,1,51,0.42857142857142855,0.17161268,5
2020-09-06-171107,171107,0,0,0,51,0.14285714285714285,0.18573093,6
2020-09-07-171107,171107,4,0,3,55,0.42857142857142855,0.86519253,0
2020-09-08-171107,171107,1,0,2,56,1.4285714285714286,1.1216189,1
2020-09-09-171107,171107,0,0,2,56,0.42857142857142855,0.21824804,2
2020-09-10-171107,171107,0,0,2,56,1.2857142857142858,1.5628958,3
2020-09-11-171107,171107,0,0,1,56,0.5714285714285714,1.1248717,4
2020-09-12-171107,171107,0,0,0,56,0.2857142857142857,0.39858997,5
2020-09-13-171107,171107,1,0,0,57,0.0,0.3866229,6
2020-09-14-171107,171107,1,0,0,58,0.42857142857142855,1.0010021,0
2020-09-15-171107,171107,3,0,0,61,1.0,1.2045813,1
2020-09-16-171107,171107,6,0,2,67,0.5714285714285714,1.7988553,2
2020-09-17-171107,171107,61,0,0,128,1.4285714285714286,9.264445,3
2020-09-18-171107,171107,3,0,0,131,3.4285714285714284,2.752141,4
2020-09-19-171107,171107,1,1,0,132,1.5714285714285714,0.63772166,5
2020-09-20-171107,171107,0,0,0,132,1.1428571428571428,0.4609147,6
2020-09-21-171107,171107,3,0,1,135,0.2857142857142857,0.9094649,0
2020-09-22-171107,171107,2,0,1,137,1.1428571428571428,1.0299919,1
2020-09-23-171107,171107,2,0,0,139,3.0,1.7015955,2
2020-09-24-171107,171107,2,1,1,141,3.571428571428572,1.6800768,3
2020-09-25-171107,171107,1,1,0,142,4.857142857142857,1.4633175,4
2020-09-26-171107,171107,0,1,0,142,2.8571428571428568,0.92005277,5
2020-09-27-171107,171107,0,1,0,142,2.0,1.5081716,6
2020-09-28-171107,171107,0,0,0,142,1.2857142857142858,0.37318996,0
2020-09-29-171107,171107,0,1,0,142,2.571428571428572,0.83104116,1
2020-09-30-171107,171107,2,0,1,144,3.2857142857142856,1.4665414,2
2020-10-01-171107,171107,0,0,0,144,1.4285714285714286,0.67206347,3
2020-10-02-171107,171107,0,1,0,144,3.7142857142857135,1.5642571,4
2020-10-03-171107,171107,0,1,0,144,0.7142857142857143,0.50906026,5
2020-10-04-171107,171107,0,0,0,144,1.0,0.2813643,6
2020-10-05-171107,171107,1,2,0,145,1.0,0.59896314,0
2020-10-06-171107,171107,1,0,1,146,3.1428571428571432,1.7032744,1
2020-10-07-171107,171107,0,1,1,146,2.0,0.7736678,2
2020-10-08-171107,171107,1,0,0,147,4.0,1.9387873,3
2020-10-09-171107,171107,0,0,0,147,3.0,1.2939283,4
2020-10-10-171107,171107,0,0,0,147,2.8571428571428568,0.9714267,5
2020-10-11-171107,171107,0,0,5,147,1.4285714285714286,0.7017455,6
2020-10-12-171107,171107,0,0,0,147,0.8571428571428571,0.5219049,0
2020-10-13-171107,171107,0,0,2,147,0.7142857142857143,0.4922115,1
2020-10-14-171107,171107,1,0,1,148,1.8571428571428568,2.7726884,2
2020-10-15-171107,171107,0,0,0,148,4.857142857142857,3.062993,3
2020-10-16-171107,171107,0,0,2,148,2.7142857142857144,6.7350817,4
2020-10-17-171107,171107,0,0,0,148,2.4285714285714284,1.7683102,5
2020-10-18-171107,171107,0,1,6,148,1.0,0.9424343,6
2020-10-19-171107,171107,0,0,0,148,2.0,1.2110682,0
2020-10-20-171107,171107,1,1,1,149,4.285714285714286,4.5325108,1
2020-10-21-171107,171107,1,1,1,150,6.571428571428571,3.9699438,2
2020-10-22-171107,171107,0,1,0,150,4.428571428571429,2.6321063,3
2020-10-23-171107,171107,0,0,0,150,6.571428571428571,4.400109,4
2020-10-24-171107,171107,0,1,2,150,1.8571428571428568,0.8421412,5
2020-10-25-171107,171107,5,0,2,155,3.7142857142857135,1.3446088,6
2020-10-26-171107,171107,0,0,0,155,5.285714285714286,3.092018,0
2020-10-27-171107,171107,2,0,1,157,3.4285714285714284,1.7131673,1
2020-10-28-171107,171107,1,0,0,158,6.428571428571429,3.0411673,2
2020-10-29-171107,171107,0,2,0,158,4.285714285714286,3.0630345,3
2020-10-30-171107,171107,2,0,0,160,12.0,6.3938556,4
2020-10-31-171107,171107,0,1,0,160,1.1428571428571428,0.67027646,5
2020-11-01-171107,171107,6,0,0,166,3.1428571428571432,1.5900073,6
2020-11-02-171107,171107,0,0,0,166,1.1428571428571428,0.6479579,0
2020-11-03-171107,171107,1,0,0,167,8.0,3.3391347,1
2020-11-04-171107,171107,1,0,0,168,7.571428571428571,4.0357957,2
2020-11-05-171107,171107,0,0,0,168,5.571428571428571,3.9059567,3
2020-11-06-171107,171107,0,0,0,168,4.571428571428571,6.6892734,4
2020-11-07-171107,171107,2,1,0,170,2.571428571428572,1.0710695,5
2020-11-08-171107,171107,2,1,0,172,0.7142857142857143,0.56350845,6
2020-11-09-171107,171107,0,0,0,172,3.571428571428572,2.9507642,0
2020-11-10-171107,171107,1,0,0,173,4.857142857142857,2.3082151,1
2020-11-11-171107,171107,0,0,0,173,5.285714285714286,3.317389,2
2020-11-12-171107,171107,0,0,0,173,4.571428571428571,2.2631621,3
2020-11-13-171107,171107,0,0,0,173,3.2857142857142856,1.5231252,4
2020-03-01-171108,171108,0,0,0,0,0.0,9.225769e-06,6
2020-03-02-171108,171108,0,0,1,0,0.0,0.034281664,0
2020-03-03-171108,171108,0,2,0,0,0.0,7.520682e-05,1
2020-03-04-171108,171108,0,2,0,0,0.0,0.0027340595,2
2020-03-05-171108,171108,0,0,0,0,0.0,6.928282e-05,3
2020-03-06-171108,171108,0,0,0,0,0.0,0.00031365815,4
2020-03-07-171108,171108,0,0,0,0,0.25,0.06425626,5
2020-03-08-171108,171108,0,0,0,0,0.0,3.3287462e-05,6
2020-03-09-171108,171108,0,0,0,0,0.25,0.05513613,0
2020-03-10-171108,171108,0,0,0,0,0.0,0.0007328687,1
2020-03-11-171108,171108,0,0,0,0,0.25,0.09125864,2
2020-03-12-171108,171108,0,0,0,0,0.75,0.18054509,3
2020-03-13-171108,171108,0,0,0,0,0.25,0.084959514,4
2020-03-14-171108,171108,0,0,0,0,0.25,0.058337837,5
2020-03-15-171108,171108,0,0,0,0,0.0,0.0020213113,6
2020-03-16-171108,171108,1,0,0,1,0.75,0.16814706,0
2020-03-17-171108,171108,0,0,0,1,1.0,0.10507784,1
2020-03-18-171108,171108,0,0,0,1,1.75,0.22003315,2
2020-03-19-171108,171108,0,0,0,1,1.75,0.23457432,3
2020-03-20-171108,171108,0,2,0,1,0.5,0.18881719,4
2020-03-21-171108,171108,0,1,0,1,0.5,0.06135348,5
2020-03-22-171108,171108,0,0,0,1,0.0,0.032520555,6
2020-03-23-171108,171108,0,1,0,1,2.0,0.3116295,0
2020-03-24-171108,171108,0,0,0,1,0.25,0.08598362,1
2020-03-25-171108,171108,0,0,0,1,1.75,0.2926463,2
2020-03-26-171108,171108,0,0,0,1,0.75,0.14964925,3
2020-03-27-171108,171108,0,0,0,1,2.25,0.33823404,4
2020-03-28-171108,171108,0,0,0,1,0.25,0.0037756916,5
2020-03-29-171108,171108,0,0,0,1,0.5,0.040369365,6
2020-03-30-171108,171108,0,0,1,1,1.25,0.23108235,0
2020-03-31-171108,171108,0,0,0,1,1.25,0.08569968,1
2020-04-01-171108,171108,0,0,0,1,2.0,0.29192218,2
2020-04-02-171108,171108,0,0,0,1,1.5,0.13606736,3
2020-04-03-171108,171108,0,0,0,1,1.5,0.18668388,4
2020-04-04-171108,171108,0,0,0,1,0.75,0.053047385,5
2020-04-05-171108,171108,0,0,0,1,0.5,0.037447236,6
2020-04-06-171108,171108,0,0,0,1,2.5,0.25784993,0
2020-04-07-171108,171108,0,0,0,1,0.75,0.066983745,1
2020-04-08-171108,171108,0,0,0,1,2.5,0.17947456,2
2020-04-09-171108,171108,0,0,0,1,0.75,0.08736843,3
2020-04-10-171108,171108,0,0,0,1,0.5,0.028858783,4
2020-04-11-171108,171108,0,0,0,1,0.75,0.07061283,5
2020-04-12-171108,171108,0,1,0,1,0.75,0.04057591,6
2020-04-13-171108,171108,1,0,0,2,1.0,0.12553534,0
2020-04-14-171108,171108,0,0,0,2,1.25,0.091483355,1
2020-04-15-171108,171108,0,0,0,2,0.25,0.05423131,2
2020-04-16-171108,171108,0,0,0,2,3.25,0.34321523,3
2020-04-17-171108,171108,0,0,0,2,1.25,0.1504714,4
2020-04-18-171108,171108,0,0,0,2,0.25,0.014990824,5
2020-04-19-171108,171108,0,0,0,2,0.5,0.036014482,6
2020-04-20-171108,171108,0,0,0,2,0.75,0.11204427,0
2020-04-21-171108,171108,0,0,0,2,0.25,0.09243085,1
2020-04-22-171108,171108,0,0,0,2,0.0,0.024853323,2
2020-04-23-171108,171108,0,0,0,2,0.0,0.039630424,3
2020-04-24-171108,171108,0,0,0,2,0.75,0.16430494,4
2020-04-25-171108,171108,0,0,0,2,0.5,0.044891924,5
2020-04-26-171108,171108,0,0,0,2,0.0,0.00076051697,6
2020-04-27-171108,171108,0,0,0,2,0.25,0.2531874,0
2020-04-28-171108,171108,0,0,0,2,0.75,0.11736468,1
2020-04-29-171108,171108,0,0,0,2,2.0,0.15418664,2
2020-04-30-171108,171108,0,0,1,2,1.75,0.223444,3
2020-05-01-171108,171108,0,0,0,2,0.75,0.026500896,4
2020-05-02-171108,171108,0,0,0,2,0.5,0.07156955,5
2020-05-03-171108,171108,0,0,0,2,0.0,0.016853847,6
2020-05-04-171108,171108,0,0,0,2,0.25,0.24255152,0
2020-05-05-171108,171108,0,0,0,2,0.5,0.32203904,1
2020-05-06-171108,171108,0,0,0,2,1.0,0.21139765,2
2020-05-07-171108,171108,0,0,0,2,1.25,0.22052963,3
2020-05-08-171108,171108,0,0,0,2,0.5,0.22644652,4
2020-05-09-171108,171108,0,0,0,2,0.25,0.040662743,5
2020-05-10-171108,171108,0,0,0,2,0.0,0.0012334032,6
2020-05-11-171108,171108,0,0,0,2,0.5,0.13213687,0
2020-05-12-171108,171108,0,0,1,2,1.5,0.23569757,1
2020-05-13-171108,171108,0,0,0,2,1.25,0.22726658,2
2020-05-14-171108,171108,1,1,0,3,0.0,0.08903551,3
2020-05-15-171108,171108,0,0,0,3,0.5,0.13882074,4
2020-05-16-171108,171108,0,0,0,3,0.75,0.059539467,5
2020-05-17-171108,171108,0,0,0,3,0.0,3.543721e-05,6
2020-05-18-171108,171108,0,0,0,3,0.75,0.10769326,0
2020-05-19-171108,171108,0,0,0,3,0.5,0.24641831,1
2020-05-20-171108,171108,0,1,0,3,0.5,0.09545757,2
2020-05-21-171108,171108,0,0,0,3,0.0,0.2897668,3
2020-05-22-171108,171108,0,0,0,3,0.0,0.023189578,4
2020-05-23-171108,171108,0,0,0,3,0.0,0.00011391511,5
2020-05-24-171108,171108,0,0,0,3,0.25,0.017212901,6
2020-05-25-171108,171108,0,0,0,3,0.0,0.1700677,0
2020-05-26-171108,171108,1,0,0,4,1.75,0.21110111,1
2020-05-27-171108,171108,0,0,1,4,0.0,0.075508446,2
2020-05-28-171108,171108,0,1,0,4,0.25,0.048083488,3
2020-05-29-171108,171108,0,0,0,4,0.0,0.08282072,4
2020-05-30-171108,171108,0,0,0,4,0.0,0.00013631015,5
2020-05-31-171108,171108,0,0,0,4,0.0,0.0010049632,6
2020-06-01-171108,171108,0,0,0,4,0.0,0.0075314147,0
2020-06-02-171108,171108,0,0,0,4,0.0,0.020993814,1
2020-06-03-171108,171108,0,0,0,4,0.0,0.009783175,2
2020-06-04-171108,171108,0,0,0,4,0.0,0.05758252,3
2020-06-05-171108,171108,0,1,0,4,0.0,0.008303398,4
2020-06-06-171108,171108,0,0,0,4,0.25,0.025566937,5
2020-06-07-171108,171108,0,0,0,4,0.0,0.00016137536,6
2020-06-08-171108,171108,0,0,0,4,0.0,0.14765356,0
2020-06-09-171108,171108,0,0,0,4,0.0,0.042354453,1
2020-06-10-171108,171108,1,0,0,5,0.5,0.09834345,2
2020-06-11-171108,171108,0,0,0,5,0.0,0.118117124,3
2020-06-12-171108,171108,0,0,0,5,0.25,0.03029033,4
2020-06-13-171108,171108,0,1,0,5,0.0,0.00021112361,5
2020-06-14-171108,171108,0,0,0,5,0.0,6.0765364e-05,6
2020-06-15-171108,171108,0,0,0,5,0.0,0.039187554,0
2020-06-16-171108,171108,0,0,0,5,0.0,0.0038995857,1
2020-06-17-171108,171108,0,0,0,5,0.0,0.006992165,2
2020-06-18-171108,171108,0,0,0,5,0.0,0.032438487,3
2020-06-19-171108,171108,0,0,0,5,0.25,0.115263104,4
2020-06-20-171108,171108,0,0,0,5,0.0,0.027788064,5
2020-06-21-171108,171108,0,0,0,5,0.0,0.00018205588,6
2020-06-22-171108,171108,0,0,0,5,0.0,0.0034033046,0
2020-06-23-171108,171108,0,0,0,5,0.0,0.01786932,1
2020-06-24-171108,171108,0,0,0,5,0.0,0.04101099,2
2020-06-25-171108,171108,0,0,0,5,0.0,0.0076582367,3
2020-06-26-171108,171108,0,1,0,5,0.25,0.033139132,4
2020-06-27-171108,171108,0,1,0,5,0.0,0.0027660495,5
2020-06-28-171108,171108,0,0,0,5,0.0,0.0014808646,6
2020-06-29-171108,171108,0,0,0,5,0.0,0.0043558273,0
2020-06-30-171108,171108,0,0,0,5,0.0,0.007242,1
2020-07-01-171108,171108,0,0,0,5,0.0,0.0005955826,2
2020-07-02-171108,171108,0,0,0,5,0.0,0.030764904,3
2020-07-03-171108,171108,0,0,0,5,0.25,0.02113445,4
2020-07-04-171108,171108,0,0,0,5,0.0,0.0017618455,5
2020-07-05-171108,171108,0,0,0,5,0.0,0.00046080552,6
2020-07-06-171108,171108,0,0,0,5,0.0,0.044024363,0
2020-07-07-171108,171108,0,0,0,5,0.0,0.00053240365,1
2020-07-08-171108,171108,0,0,0,5,0.0,0.0032481914,2
2020-07-09-171108,171108,0,0,0,5,0.0,0.0030096057,3
2020-07-10-171108,171108,0,0,0,5,0.5,0.06929899,4
2020-07-11-171108,171108,0,0,0,5,0.0,0.00028356738,5
2020-07-12-171108,171108,0,0,0,5,0.0,0.00043245076,6
2020-07-13-171108,171108,0,0,0,5,0.0,0.00486619,0
2020-07-14-171108,171108,0,0,0,5,0.0,0.005910077,1
2020-07-15-171108,171108,0,0,0,5,0.0,0.0002645285,2
2020-07-16-171108,171108,0,0,0,5,0.0,0.0030369824,3
2020-07-17-171108,171108,0,0,0,5,0.0,0.0046195635,4
2020-07-18-171108,171108,0,0,0,5,0.0,0.006965254,5
2020-07-19-171108,171108,0,0,0,5,0.0,0.00059641275,6
2020-07-20-171108,171108,0,0,0,5,0.0,0.005963211,0
2020-07-21-171108,171108,0,0,0,5,0.0,0.0018687892,1
2020-07-22-171108,171108,0,0,0,5,0.0,0.0067480197,2
2020-07-23-171108,171108,0,0,0,5,0.0,0.006090452,3
2020-07-24-171108,171108,0,0,0,5,0.0,0.0026277567,4
2020-07-25-171108,171108,0,0,0,5,0.0,0.00028164996,5
2020-07-26-171108,171108,0,0,0,5,0.0,8.7287124e-05,6
2020-07-27-171108,171108,0,0,0,5,0.0,0.04607576,0
2020-07-28-171108,171108,0,0,0,5,0.0,0.0043210187,1
2020-07-29-171108,171108,0,0,0,5,0.0,0.010158038,2
2020-07-30-171108,171108,0,0,0,5,0.0,0.030829268,3
2020-07-31-171108,171108,0,0,0,5,0.0,0.097533114,4
2020-08-01-171108,171108,0,0,0,5,0.0,0.0030747107,5
2020-08-02-171108,171108,0,0,0,5,0.0,0.0037742795,6
2020-08-03-171108,171108,0,0,0,5,0.5,0.054237995,0
2020-08-04-171108,171108,0,0,0,5,0.0,0.0037325798,1
2020-08-05-171108,171108,0,0,0,5,0.0,0.007926972,2
2020-08-06-171108,171108,0,0,0,5,0.0,0.010374132,3
2020-08-07-171108,171108,0,0,0,5,0.75,0.13438103,4
2020-08-08-171108,171108,0,0,0,5,0.0,0.0112478435,5
2020-08-09-171108,171108,0,0,0,5,0.5,0.065873384,6
2020-08-10-171108,171108,0,0,0,5,0.25,0.039172135,0
2020-08-11-171108,171108,0,0,0,5,0.75,0.09543599,1
2020-08-12-171108,171108,0,0,0,5,0.25,0.068180665,2
2020-08-13-171108,171108,0,0,0,5,1.5,0.51737344,3
2020-08-14-171108,171108,0,0,0,5,1.0,0.24154161,4
2020-08-15-171108,171108,0,0,1,5,0.25,0.07443015,5
2020-08-16-171108,171108,0,0,0,5,0.25,0.08349072,6
2020-08-17-171108,171108,0,0,0,5,0.5,0.14091158,0
2020-08-18-171108,171108,0,0,0,5,0.25,0.49356887,1
2020-08-19-171108,171108,0,0,0,5,0.0,0.11805302,2
2020-08-20-171108,171108,0,0,1,5,0.0,0.087924235,3
2020-08-21-171108,171108,0,0,0,5,0.5,0.22916546,4
2020-08-22-171108,171108,0,0,0,5,0.25,0.2032084,5
2020-08-23-171108,171108,0,0,0,5,0.25,0.07286979,6
2020-08-24-171108,171108,0,0,0,5,1.25,0.34143955,0
2020-08-25-171108,171108,0,0,0,5,0.25,0.104043454,1
2020-08-26-171108,171108,0,0,0,5,1.0,0.2511627,2
2020-08-27-171108,171108,0,0,0,5,1.0,0.12777245,3
2020-08-28-171108,171108,0,0,0,5,0.0,0.1315193,4
2020-08-29-171108,171108,1,0,0,6,2.0,0.239689,5
2020-08-30-171108,171108,0,0,0,6,0.0,0.032368213,6
2020-08-31-171108,171108,0,0,0,6,0.0,0.08549352,0
2020-09-01-171108,171108,0,0,0,6,0.25,0.23764917,1
2020-09-02-171108,171108,0,0,0,6,0.25,0.20477614,2
2020-09-03-171108,171108,1,0,2,7,0.5,0.123086065,3
2020-09-04-171108,171108,0,0,0,7,0.5,0.2489635,4
2020-09-05-171108,171108,0,0,0,7,0.5,0.040641926,5
2020-09-06-171108,171108,0,0,0,7,0.75,0.10591695,6
2020-09-07-171108,171108,0,0,0,7,1.5,0.3489921,0
2020-09-08-171108,171108,0,0,0,7,1.5,0.41702893,1
2020-09-09-171108,171108,0,0,0,7,0.0,0.20570175,2
2020-09-10-171108,171108,0,0,1,7,1.0,0.43406376,3
2020-09-11-171108,171108,0,0,0,7,0.0,0.30500302,4
2020-09-12-171108,171108,0,0,0,7,2.5,0.30047956,5
2020-09-13-171108,171108,0,0,0,7,0.25,0.25086427,6
2020-09-14-171108,171108,0,0,0,7,1.25,0.3319384,0
2020-09-15-171108,171108,0,0,0,7,2.0,0.3246383,1
2020-09-16-171108,171108,0,0,0,7,2.0,0.4378497,2
2020-09-17-171108,171108,2,0,0,9,16.0,1.8165618,3
2020-09-18-171108,171108,0,0,0,9,2.75,0.6599176,4
2020-09-19-171108,171108,0,1,0,9,0.5,0.24464703,5
2020-09-20-171108,171108,0,0,0,9,0.5,0.18114576,6
2020-09-21-171108,171108,0,0,0,9,2.0,0.4091804,0
2020-09-22-171108,171108,0,0,0,9,0.75,0.33379954,1
2020-09-23-171108,171108,0,0,0,9,1.5,0.45252886,2
2020-09-24-171108,171108,1,2,0,10,2.5,0.775598,3
2020-09-25-171108,171108,0,0,0,10,1.75,0.5296964,4
2020-09-26-171108,171108,0,0,0,10,2.0,0.2915753,5
2020-09-27-171108,171108,0,0,0,10,2.25,0.4260503,6
2020-09-28-171108,171108,0,0,0,10,0.5,0.18292798,0
2020-09-29-171108,171108,0,0,0,10,0.25,0.12101203,1
2020-09-30-171108,171108,0,0,0,10,2.75,0.35918003,2
2020-10-01-171108,171108,0,0,0,10,0.0,0.26540467,3
2020-10-02-171108,171108,0,0,0,10,2.75,0.35512304,4
2020-10-03-171108,171108,0,2,0,10,0.25,0.21511036,5
2020-10-04-171108,171108,0,0,0,10,0.25,0.06977917,6
2020-10-05-171108,171108,0,0,2,10,0.25,0.23993543,0
2020-10-06-171108,171108,0,0,0,10,1.25,0.43275824,1
2020-10-07-171108,171108,0,0,1,10,0.5,0.16246474,2
2020-10-08-171108,171108,0,0,1,10,0.5,0.28510082,3
2020-10-09-171108,171108,0,0,0,10,0.25,0.19762439,4
2020-10-10-171108,171108,0,0,1,10,0.25,0.16872856,5
2020-10-11-171108,171108,0,0,0,10,0.0,0.17605083,6
2020-10-12-171108,171108,0,0,0,10,0.5,0.16876838,0
2020-10-13-171108,171108,0,0,0,10,0.0,0.081141435,1
2020-10-14-171108,171108,0,0,1,10,1.5,0.68836874,2
2020-10-15-171108,171108,0,0,0,10,2.0,0.52100587,3
2020-10-16-171108,171108,0,0,2,10,0.75,1.6185642,4
2020-10-17-171108,171108,0,0,1,10,0.75,0.23987955,5
2020-10-18-171108,171108,0,0,5,10,0.75,0.24965087,6
2020-10-19-171108,171108,2,0,0,12,0.5,0.3120824,0
2020-10-20-171108,171108,0,0,19,12,1.75,0.9245677,1
2020-10-21-171108,171108,1,0,4,13,2.5,0.6608107,2
2020-10-22-171108,171108,1,0,0,14,2.25,0.79434705,3
2020-10-23-171108,171108,0,0,0,14,3.0,0.96839017,4
2020-10-24-171108,171108,1,0,0,15,1.75,0.3035371,5
2020-10-25-171108,171108,0,0,0,15,3.25,0.32671157,6
2020-10-26-171108,171108,0,0,2,15,2.75,0.8142134,0
2020-10-27-171108,171108,0,0,0,15,4.75,0.63603395,1
2020-10-28-171108,171108,1,0,2,16,2.75,0.7950353,2
2020-10-29-171108,171108,0,0,0,16,4.25,0.91445607,3
2020-10-30-171108,171108,2,0,0,18,7.25,2.004343,4
2020-10-31-171108,171108,1,1,0,19,1.5,0.26836458,5
2020-11-01-171108,171108,5,0,0,24,2.0,0.37875947,6
2020-11-02-171108,171108,0,0,0,24,0.75,0.19688602,0
2020-11-03-171108,171108,19,0,0,43,1.25,0.95006466,1
2020-11-04-171108,171108,4,0,0,47,4.5,1.1762109,2
2020-11-05-171108,171108,0,0,0,47,4.25,1.2511337,3
2020-11-06-171108,171108,0,0,0,47,3.25,2.1309366,4
2020-11-07-171108,171108,0,1,0,47,2.5,0.25366127,5
2020-11-08-171108,171108,0,0,0,47,1.0,0.17777205,6
2020-11-09-171108,171108,2,0,0,49,1.5,0.8603543,0
2020-11-10-171108,171108,0,0,0,49,3.75,0.6081786,1
2020-11-11-171108,171108,2,0,0,51,2.5,0.94377255,2
2020-11-12-171108,171108,0,0,0,51,3.25,0.6176425,3
2020-11-13-171108,171108,0,0,0,51,2.25,0.52783614,4
2020-03-01-171109,171109,0,0,0,0,0.0,1.36139215e-05,6
2020-03-02-171109,171109,0,0,0,0,0.0,0.005282823,0
2020-03-03-171109,171109,0,0,1,0,0.0,1.3014015e-05,1
2020-03-04-171109,171109,0,0,0,0,0.0,0.003827356,2
2020-03-05-171109,171109,0,0,0,0,0.0,0.0005385849,3
2020-03-06-171109,171109,0,0,1,0,0.0,0.00024466208,4
2020-03-07-171109,171109,1,0,1,1,0.0,0.14765805,5
2020-03-08-171109,171109,0,0,0,1,0.0,2.233873e-05,6
2020-03-09-171109,171109,0,0,1,1,0.2857142857142857,0.037184697,0
2020-03-10-171109,171109,0,0,0,1,0.14285714285714285,0.033945426,1
2020-03-11-171109,171109,0,0,0,1,0.0,0.01650877,2
2020-03-12-171109,171109,0,0,0,1,0.14285714285714285,0.027054278,3
2020-03-13-171109,171109,1,0,0,2,0.0,0.18478033,4
2020-03-14-171109,171109,1,0,0,3,0.0,0.18241099,5
2020-03-15-171109,171109,0,0,0,3,0.2857142857142857,0.0054090037,6
2020-03-16-171109,171109,0,0,0,3,1.2857142857142858,0.06302864,0
2020-03-17-171109,171109,1,0,0,4,3.7142857142857135,0.36437362,1
2020-03-18-171109,171109,0,0,5,4,3.8571428571428568,0.24083753,2
2020-03-19-171109,171109,0,0,1,4,3.0,0.24090649,3
2020-03-20-171109,171109,1,0,4,5,2.4285714285714284,0.32995993,4
2020-03-21-171109,171109,1,0,1,6,1.4285714285714286,0.15388171,5
2020-03-22-171109,171109,0,0,0,6,0.5714285714285714,0.014746452,6
2020-03-23-171109,171109,1,1,0,7,5.428571428571429,0.35850802,0
2020-03-24-171109,171109,0,1,1,7,4.428571428571429,0.096210845,1
2020-03-25-171109,171109,0,0,0,7,3.7142857142857135,0.24481426,2
2020-03-26-171109,171109,0,0,0,7,1.8571428571428568,0.13393143,3
2020-03-27-171109,171109,0,0,0,7,2.8571428571428568,0.41166213,4
2020-03-28-171109,171109,0,0,0,7,0.8571428571428571,0.027597107,5
2020-03-29-171109,171109,0,0,0,7,1.0,0.047359847,6
2020-03-30-171109,171109,0,0,0,7,1.8571428571428568,0.11086341,0
2020-03-31-171109,171109,0,0,0,7,1.8571428571428568,0.14429924,1
2020-04-01-171109,171109,5,0,0,12,2.0,0.8576582,2
2020-04-02-171109,171109,1,0,0,13,2.4285714285714284,0.27537426,3
2020-04-03-171109,171109,4,0,1,17,1.0,0.58063114,4
2020-04-04-171109,171109,1,0,0,18,0.5714285714285714,0.27720588,5
2020-04-05-171109,171109,0,0,0,18,0.2857142857142857,0.003166658,6
2020-04-06-171109,171109,0,0,0,18,3.2857142857142856,0.15952228,0
2020-04-07-171109,171109,1,0,0,19,1.7142857142857142,0.27992517,1
2020-04-08-171109,171109,0,0,0,19,1.4285714285714286,0.11384241,2
2020-04-09-171109,171109,0,0,0,19,0.42857142857142855,0.057172723,3
2020-04-10-171109,171109,0,0,0,19,1.7142857142857142,0.049748972,4
2020-04-11-171109,171109,0,2,0,19,0.5714285714285714,0.009341294,5
2020-04-12-171109,171109,0,0,0,19,3.571428571428572,0.006041936,6
2020-04-13-171109,171109,0,0,0,19,1.1428571428571428,0.040279612,0
2020-04-14-171109,171109,0,0,1,19,2.571428571428572,0.22833356,1
2020-04-15-171109,171109,0,0,0,19,0.2857142857142857,0.053759683,2
2020-04-16-171109,171109,0,0,0,19,0.7142857142857143,0.081792794,3
2020-04-17-171109,171109,1,0,0,20,0.42857142857142855,0.18977045,4
2020-04-18-171109,171109,0,0,0,20,0.0,0.008349763,5
2020-04-19-171109,171109,0,0,0,20,0.14285714285714285,0.03447429,6
2020-04-20-171109,171109,0,0,0,20,0.42857142857142855,0.05801323,0
2020-04-21-171109,171109,0,0,0,20,1.0,0.2184443,1
2020-04-22-171109,171109,0,0,1,20,0.5714285714285714,0.10536702,2
2020-04-23-171109,171109,0,0,0,20,0.2857142857142857,0.0372133,3
2020-04-24-171109,171109,0,0,0,20,5.428571428571429,0.19684285,4
2020-04-25-171109,171109,0,0,0,20,0.2857142857142857,0.017952342,5
2020-04-26-171109,171109,0,1,0,20,0.14285714285714285,0.0013708092,6
2020-04-27-171109,171109,0,0,0,20,0.5714285714285714,0.056122087,0
2020-04-28-171109,171109,1,0,0,21,1.0,0.19969308,1
2020-04-29-171109,171109,0,0,0,21,1.0,0.20756052,2
2020-04-30-171109,171109,0,0,0,21,0.5714285714285714,0.11013402,3
2020-05-01-171109,171109,0,0,1,21,0.2857142857142857,0.015422936,4
2020-05-02-171109,171109,0,0,0,21,0.14285714285714285,0.003968511,5
2020-05-03-171109,171109,0,0,0,21,0.0,0.002106721,6
2020-05-04-171109,171109,0,0,1,21,0.8571428571428571,0.07186295,0
2020-05-05-171109,171109,0,0,0,21,1.4285714285714286,0.08160213,1
2020-05-06-171109,171109,1,0,0,22,0.7142857142857143,0.21995118,2
2020-05-07-171109,171109,0,0,0,22,0.42857142857142855,0.19563326,3
2020-05-08-171109,171109,0,0,0,22,0.2857142857142857,0.04186261,4
2020-05-09-171109,171109,0,0,0,22,0.0,0.009467872,5
2020-05-10-171109,171109,0,0,0,22,0.42857142857142855,0.015252775,6
2020-05-11-171109,171109,0,0,0,22,0.42857142857142855,0.09674137,0
2020-05-12-171109,171109,0,0,0,22,1.2857142857142858,0.26680785,1
2020-05-13-171109,171109,0,1,0,22,1.0,0.12932834,2
2020-05-14-171109,171109,0,0,0,22,0.7142857142857143,0.13141762,3
2020-05-15-171109,171109,1,0,0,23,1.1428571428571428,0.41650066,4
2020-05-16-171109,171109,0,0,0,23,0.14285714285714285,0.006579944,5
2020-05-17-171109,171109,0,1,0,23,0.0,4.9900507e-05,6
2020-05-18-171109,171109,1,0,0,24,1.0,0.35922226,0
2020-05-19-171109,171109,0,0,0,24,1.1428571428571428,0.2114783,1
2020-05-20-171109,171109,0,0,0,24,0.14285714285714285,0.047941342,2
2020-05-21-171109,171109,0,0,0,24,0.42857142857142855,0.052057542,3
2020-05-22-171109,171109,0,0,0,24,0.42857142857142855,0.06708185,4
2020-05-23-171109,171109,0,0,0,24,0.0,0.00043244244,5
2020-05-24-171109,171109,0,0,0,24,0.0,0.001332559,6
2020-05-25-171109,171109,0,0,0,24,0.5714285714285714,0.05318143,0
2020-05-26-171109,171109,0,0,0,24,0.2857142857142857,0.1750148,1
2020-05-27-171109,171109,0,2,0,24,0.2857142857142857,0.025031013,2
2020-05-28-171109,171109,0,0,0,24,0.5714285714285714,0.10068041,3
2020-05-29-171109,171109,0,1,0,24,0.7142857142857143,0.05597625,4
2020-05-30-171109,171109,0,0,0,24,0.0,0.00025154577,5
2020-05-31-171109,171109,0,0,0,24,0.14285714285714285,0.02356948,6
2020-06-01-171109,171109,0,0,0,24,0.42857142857142855,0.028466918,0
2020-06-02-171109,171109,0,0,0,24,0.8571428571428571,0.1013349,1
2020-06-03-171109,171109,0,0,0,24,0.42857142857142855,0.018961681,2
2020-06-04-171109,171109,0,0,0,24,0.8571428571428571,0.0678561,3
2020-06-05-171109,171109,0,0,0,24,0.14285714285714285,0.023141058,4
2020-06-06-171109,171109,0,0,0,24,0.0,0.010186518,5
2020-06-07-171109,171109,0,0,0,24,0.0,0.0005360989,6
2020-06-08-171109,171109,0,0,0,24,0.0,0.04324338,0
2020-06-09-171109,171109,0,0,0,24,0.14285714285714285,0.018337406,1
2020-06-10-171109,171109,0,0,0,24,0.7142857142857143,0.03482941,2
2020-06-11-171109,171109,0,0,0,24,0.0,0.03456659,3
2020-06-12-171109,171109,0,0,0,24,0.42857142857142855,0.032366045,4
2020-06-13-171109,171109,0,1,0,24,0.0,0.00029410966,5
2020-06-14-171109,171109,0,4,0,24,0.0,0.0008678016,6
2020-06-15-171109,171109,0,0,0,24,0.42857142857142855,0.021540454,0
2020-06-16-171109,171109,0,0,0,24,0.14285714285714285,0.00874019,1
2020-06-17-171109,171109,0,0,0,24,0.14285714285714285,0.013606723,2
2020-06-18-171109,171109,0,0,0,24,0.14285714285714285,0.015678922,3
2020-06-19-171109,171109,0,0,0,24,0.0,0.023433654,4
2020-06-20-171109,171109,0,0,0,24,0.0,0.0009680474,5
2020-06-21-171109,171109,0,0,0,24,0.0,0.00014826306,6
2020-06-22-171109,171109,0,0,0,24,0.2857142857142857,0.011169815,0
2020-06-23-171109,171109,0,0,0,24,0.2857142857142857,0.13448277,1
2020-06-24-171109,171109,0,1,0,24,0.42857142857142855,0.030045027,2
2020-06-25-171109,171109,0,0,0,24,0.2857142857142857,0.0056131594,3
2020-06-26-171109,171109,0,1,0,24,0.14285714285714285,0.030857837,4
2020-06-27-171109,171109,0,0,0,24,0.0,0.007671118,5
2020-06-28-171109,171109,0,0,0,24,0.0,0.0028830941,6
2020-06-29-171109,171109,0,0,0,24,0.2857142857142857,0.010958757,0
2020-06-30-171109,171109,0,0,0,24,0.14285714285714285,0.009562926,1
2020-07-01-171109,171109,0,0,0,24,0.0,0.0013854647,2
2020-07-02-171109,171109,0,0,0,24,0.42857142857142855,0.011940511,3
2020-07-03-171109,171109,0,0,0,24,0.2857142857142857,0.07822121,4
2020-07-04-171109,171109,0,0,0,24,0.0,0.0007219865,5
2020-07-05-171109,171109,0,0,0,24,0.0,0.00134617,6
2020-07-06-171109,171109,0,0,0,24,0.0,0.016442409,0
2020-07-07-171109,171109,0,0,0,24,0.0,0.0012368145,1
2020-07-08-171109,171109,0,3,0,24,0.2857142857142857,0.050849326,2
2020-07-09-171109,171109,0,0,0,24,0.2857142857142857,0.014167427,3
2020-07-10-171109,171109,0,0,0,24,0.0,0.04557207,4
2020-07-11-171109,171109,0,0,0,24,0.0,0.0007976168,5
2020-07-12-171109,171109,0,0,0,24,0.0,0.00063159596,6
2020-07-13-171109,171109,0,0,0,24,0.14285714285714285,0.00539145,0
2020-07-14-171109,171109,0,1,0,24,0.0,0.0025835433,1
2020-07-15-171109,171109,0,0,0,24,0.14285714285714285,0.0023414295,2
2020-07-16-171109,171109,0,0,1,24,0.0,0.0022554046,3
2020-07-17-171109,171109,0,0,0,24,0.0,0.013600195,4
2020-07-18-171109,171109,0,0,0,24,0.14285714285714285,0.0032159332,5
2020-07-19-171109,171109,0,0,0,24,0.0,0.0012938058,6
2020-07-20-171109,171109,0,0,0,24,0.0,0.016514625,0
2020-07-21-171109,171109,0,0,0,24,0.0,0.002972243,1
2020-07-22-171109,171109,0,0,0,24,0.0,0.0024801022,2
2020-07-23-171109,171109,0,0,0,24,0.14285714285714285,0.008756489,3
2020-07-24-171109,171109,0,0,0,24,0.14285714285714285,0.0074267033,4
2020-07-25-171109,171109,0,0,0,24,0.0,0.0003643665,5
2020-07-26-171109,171109,0,0,1,24,0.0,0.00043276855,6
2020-07-27-171109,171109,0,0,0,24,0.14285714285714285,0.009380404,0
2020-07-28-171109,171109,0,0,0,24,0.0,0.010658866,1
2020-07-29-171109,171109,0,0,0,24,0.0,0.020375695,2
2020-07-30-171109,171109,1,0,0,25,0.0,0.22441451,3
2020-07-31-171109,171109,0,0,0,25,0.2857142857142857,0.08335421,4
2020-08-01-171109,171109,0,0,0,25,0.14285714285714285,0.05502335,5
2020-08-02-171109,171109,0,0,2,25,0.14285714285714285,0.060567085,6
2020-08-03-171109,171109,0,0,0,25,0.14285714285714285,0.10189458,0
2020-08-04-171109,171109,0,0,0,25,0.0,0.007482741,1
2020-08-05-171109,171109,0,0,0,25,0.2857142857142857,0.025190692,2
2020-08-06-171109,171109,0,0,0,25,1.2857142857142858,0.031951435,3
2020-08-07-171109,171109,0,0,0,25,0.5714285714285714,0.28418437,4
2020-08-08-171109,171109,0,0,3,25,0.14285714285714285,0.07411273,5
2020-08-09-171109,171109,1,0,2,26,0.0,0.6840507,6
2020-08-10-171109,171109,0,0,1,26,0.0,0.038673427,0
2020-08-11-171109,171109,0,0,1,26,0.0,0.1435191,1
2020-08-12-171109,171109,0,0,0,26,0.8571428571428571,0.095975675,2
2020-08-13-171109,171109,0,0,1,26,0.0,0.114079855,3
2020-08-14-171109,171109,0,0,0,26,0.14285714285714285,0.13840187,4
2020-08-15-171109,171109,0,0,0,26,1.1428571428571428,0.20415005,5
2020-08-16-171109,171109,2,0,1,28,0.2857142857142857,0.55534315,6
2020-08-17-171109,171109,0,0,4,28,0.14285714285714285,0.15312898,0
2020-08-18-171109,171109,0,0,1,28,0.14285714285714285,0.14933148,1
2020-08-19-171109,171109,0,0,0,28,0.8571428571428571,0.7157267,2
2020-08-20-171109,171109,0,0,0,28,0.14285714285714285,0.663611,3
2020-08-21-171109,171109,0,0,0,28,0.5714285714285714,0.8685155,4
2020-08-22-171109,171109,3,0,0,31,0.2857142857142857,1.453925,5
2020-08-23-171109,171109,2,0,0,33,0.42857142857142855,0.25907728,6
2020-08-24-171109,171109,1,0,0,34,0.5714285714285714,0.7979926,0
2020-08-25-171109,171109,1,0,0,35,0.8571428571428571,0.80145836,1
2020-08-26-171109,171109,0,0,3,35,0.5714285714285714,0.20568773,2
2020-08-27-171109,171109,1,0,5,36,0.8571428571428571,0.09965751,3
2020-08-28-171109,171109,0,0,0,36,0.8571428571428571,0.5047688,4
2020-08-29-171109,171109,0,0,0,36,0.14285714285714285,0.088624924,5
2020-08-30-171109,171109,1,0,0,37,3.1428571428571432,0.34236866,6
2020-08-31-171109,171109,4,0,0,41,0.42857142857142855,0.6668132,0
2020-09-01-171109,171109,1,0,0,42,0.5714285714285714,0.28677747,1
2020-09-02-171109,171109,0,0,0,42,0.5714285714285714,0.35370088,2
2020-09-03-171109,171109,0,0,0,42,8.0,2.2671783,3
2020-09-04-171109,171109,0,0,0,42,2.142857142857143,0.7531078,4
2020-09-05-171109,171109,0,0,0,42,0.7142857142857143,0.14622936,5
2020-09-06-171109,171109,0,0,1,42,2.571428571428572,0.69752395,6
2020-09-07-171109,171109,0,0,0,42,1.1428571428571428,0.4171064,0
2020-09-08-171109,171109,0,1,6,42,3.571428571428572,1.6440203,1
2020-09-09-171109,171109,3,0,1,45,1.5714285714285714,1.475225,2
2020-09-10-171109,171109,5,0,4,50,2.8571428571428568,1.2490624,3
2020-09-11-171109,171109,0,0,1,50,1.0,0.4697753,4
2020-09-12-171109,171109,0,0,0,50,1.5714285714285714,0.611942,5
2020-09-13-171109,171109,0,0,0,50,0.42857142857142855,0.13176832,6
2020-09-14-171109,171109,0,1,1,50,0.7142857142857143,0.22959062,0
2020-09-15-171109,171109,0,0,2,50,3.2857142857142856,0.6977561,1
2020-09-16-171109,171109,0,0,0,50,0.7142857142857143,0.7856837,2
2020-09-17-171109,171109,0,0,0,50,5.857142857142858,1.7859533,3
2020-09-18-171109,171109,0,0,0,50,1.7142857142857142,0.8241098,4
2020-09-19-171109,171109,0,0,0,50,0.0,0.14745823,5
2020-09-20-171109,171109,1,0,0,51,0.7142857142857143,0.2825409,6
2020-09-21-171109,171109,0,0,1,51,2.7142857142857144,0.63856506,0
2020-09-22-171109,171109,6,1,1,57,2.8571428571428568,2.1567307,1
2020-09-23-171109,171109,1,0,1,58,0.5714285714285714,0.46030915,2
2020-09-24-171109,171109,4,1,3,62,1.5714285714285714,1.3622837,3
2020-09-25-171109,171109,1,0,0,63,0.7142857142857143,0.5546585,4
2020-09-26-171109,171109,0,0,0,63,0.42857142857142855,0.14794752,5
2020-09-27-171109,171109,0,0,0,63,0.14285714285714285,0.093822435,6
2020-09-28-171109,171109,1,0,1,64,1.1428571428571428,0.43402737,0
2020-09-29-171109,171109,2,0,0,66,1.1428571428571428,0.31831345,1
2020-09-30-171109,171109,0,0,1,66,0.7142857142857143,0.2423766,2
2020-10-01-171109,171109,0,0,0,66,1.1428571428571428,0.3703891,3
2020-10-02-171109,171109,0,0,1,66,0.7142857142857143,0.3498456,4
2020-10-03-171109,171109,0,0,1,66,0.5714285714285714,0.14325748,5
2020-10-04-171109,171109,0,0,2,66,0.14285714285714285,0.094900355,6
2020-10-05-171109,171109,1,0,0,67,0.42857142857142855,0.24338147,0
2020-10-06-171109,171109,1,0,0,68,1.4285714285714286,0.52479064,1
2020-10-07-171109,171109,1,0,0,69,0.5714285714285714,0.36435932,2
2020-10-08-171109,171109,3,0,3,72,0.2857142857142857,0.7226764,3
2020-10-09-171109,171109,0,0,7,72,1.2857142857142858,0.54644483,4
2020-10-10-171109,171109,0,0,0,72,0.14285714285714285,0.1105732,5
2020-10-11-171109,171109,0,0,3,72,0.5714285714285714,0.10761914,6
2020-10-12-171109,171109,1,0,5,73,1.1428571428571428,0.41028792,0
2020-10-13-171109,171109,0,0,11,73,0.42857142857142855,0.10240899,1
2020-10-14-171109,171109,1,0,3,74,0.8571428571428571,0.6276683,2
2020-10-15-171109,171109,0,0,1,74,1.4285714285714286,0.55338377,3
2020-10-16-171109,171109,1,0,12,75,1.7142857142857142,0.74410456,4
2020-10-17-171109,171109,1,0,2,76,0.7142857142857143,0.28914508,5
2020-10-18-171109,171109,2,0,1,78,0.42857142857142855,0.39188427,6
2020-10-19-171109,171109,0,0,2,78,2.142857142857143,0.5629204,0
2020-10-20-171109,171109,0,0,1,78,1.4285714285714286,0.4761808,1
2020-10-21-171109,171109,0,0,1,78,2.571428571428572,1.1684191,2
2020-10-22-171109,171109,3,0,1,81,1.5714285714285714,0.9832981,3
2020-10-23-171109,171109,7,0,5,88,3.571428571428572,1.6831086,4
2020-10-24-171109,171109,0,0,0,88,1.8571428571428568,0.4683071,5
2020-10-25-171109,171109,3,1,1,91,1.1428571428571428,0.6477896,6
2020-10-26-171109,171109,5,0,5,96,1.4285714285714286,1.1280757,0
2020-10-27-171109,171109,11,0,2,107,2.571428571428572,2.4986072,1
2020-10-28-171109,171109,3,0,1,110,2.7142857142857144,1.4961543,2
2020-10-29-171109,171109,1,0,0,111,2.4285714285714284,0.99648225,3
2020-10-30-171109,171109,12,0,0,123,5.285714285714286,3.7508216,4
2020-10-31-171109,171109,2,0,0,125,1.8571428571428568,0.6186012,5
2020-11-01-171109,171109,1,0,0,126,1.0,0.4617121,6
2020-11-02-171109,171109,2,1,0,128,1.4285714285714286,0.4484486,0
2020-11-03-171109,171109,1,0,0,129,0.42857142857142855,0.9757962,1
2020-11-04-171109,171109,1,0,0,130,2.2857142857142856,1.2104826,2
2020-11-05-171109,171109,1,0,0,131,6.857142857142858,1.3324559,3
2020-11-06-171109,171109,5,1,0,136,3.0,1.6496762,4
2020-11-07-171109,171109,0,0,0,136,1.1428571428571428,0.49456412,5
2020-11-08-171109,171109,1,0,0,137,1.0,0.24338205,6
2020-11-09-171109,171109,5,0,0,142,1.5714285714285714,1.1795619,0
2020-11-10-171109,171109,2,0,0,144,2.571428571428572,0.8633668,1
2020-11-11-171109,171109,1,0,0,145,0.8571428571428571,0.8502966,2
2020-11-12-171109,171109,0,0,0,145,1.7142857142857142,0.6062197,3
2020-11-13-171109,171109,0,0,0,145,3.1428571428571432,0.9625017,4
2020-03-01-171110,171110,0,0,0,0,0.0,0.00029748047,6
2020-03-02-171110,171110,0,0,0,0,0.25,0.093987435,0
2020-03-03-171110,171110,0,0,0,0,0.0,0.0012493149,1
2020-03-04-171110,171110,0,0,2,0,0.0,0.0016544433,2
2020-03-05-171110,171110,0,0,2,0,0.0,0.0012865341,3
2020-03-06-171110,171110,0,0,1,0,0.0,0.00027492348,4
2020-03-07-171110,171110,0,0,1,0,0.25,0.10891104,5
2020-03-08-171110,171110,0,0,4,0,0.0,0.000606116,6
2020-03-09-171110,171110,0,0,7,0,0.25,0.118754655,0
2020-03-10-171110,171110,0,0,1,0,0.0,0.0029464182,1
2020-03-11-171110,171110,0,0,2,0,1.0,0.26978272,2
2020-03-12-171110,171110,0,0,1,0,0.75,0.3347589,3
2020-03-13-171110,171110,2,0,0,2,0.75,0.32450056,4
2020-03-14-171110,171110,0,0,0,2,0.25,0.106428735,5
2020-03-15-171110,171110,0,0,1,2,0.25,0.021272605,6
2020-03-16-171110,171110,0,0,2,2,1.75,0.37824526,0
2020-03-17-171110,171110,0,0,0,2,0.5,0.20876373,1
2020-03-18-171110,171110,2,0,4,4,2.25,0.46071598,2
2020-03-19-171110,171110,2,0,0,6,2.5,0.5468332,3
2020-03-20-171110,171110,1,0,0,7,2.75,0.5121249,4
2020-03-21-171110,171110,1,0,0,8,1.5,0.14818314,5
2020-03-22-171110,171110,4,0,1,12,1.5,0.22785047,6
2020-03-23-171110,171110,7,0,3,19,3.0,0.99405545,0
2020-03-24-171110,171110,1,0,1,20,2.5,0.45019454,1
2020-03-25-171110,171110,2,0,1,22,4.0,0.83062965,2
2020-03-26-171110,171110,1,0,0,23,3.0,0.4348396,3
2020-03-27-171110,171110,0,0,0,23,4.25,0.8044262,4
2020-03-28-171110,171110,0,0,3,23,0.5,0.052967444,5
2020-03-29-171110,171110,1,0,1,24,0.75,0.099296644,6
2020-03-30-171110,171110,2,0,1,26,3.25,0.70891786,0
2020-03-31-171110,171110,0,0,0,26,1.5,0.21444544,1
2020-04-01-171110,171110,4,0,1,30,2.5,0.6117444,2
2020-04-02-171110,171110,0,0,1,30,1.0,0.2928353,3
2020-04-03-171110,171110,0,0,2,30,1.25,0.26747388,4
2020-04-04-171110,171110,0,0,1,30,0.5,0.06469,5
2020-04-05-171110,171110,1,0,0,31,0.25,0.09566381,6
2020-04-06-171110,171110,3,2,0,34,1.75,0.71102494,0
2020-04-07-171110,171110,1,0,2,35,0.5,0.17037566,1
2020-04-08-171110,171110,1,0,1,36,0.75,0.3599128,2
2020-04-09-171110,171110,0,0,0,36,0.5,0.09460372,3
2020-04-10-171110,171110,0,0,1,36,1.0,0.15276134,4
2020-04-11-171110,171110,3,0,0,39,0.5,0.2321012,5
2020-04-12-171110,171110,1,0,0,40,0.0,0.1015057,6
2020-04-13-171110,171110,1,0,0,41,0.25,0.30372113,0
2020-04-14-171110,171110,0,0,0,41,0.75,0.19819824,1
2020-04-15-171110,171110,1,0,0,42,1.75,0.29346055,2
2020-04-16-171110,171110,1,0,0,43,2.5,0.55064875,3
2020-04-17-171110,171110,2,0,0,45,2.75,0.41660917,4
2020-04-18-171110,171110,1,0,0,46,0.0,0.014829851,5
2020-04-19-171110,171110,0,0,0,46,0.5,0.039611414,6
2020-04-20-171110,171110,0,0,6,46,1.25,0.2450447,0
2020-04-21-171110,171110,2,0,2,48,1.25,0.3786403,1
2020-04-22-171110,171110,1,0,1,49,1.25,0.19410312,2
2020-04-23-171110,171110,0,0,0,49,0.25,0.05906726,3
2020-04-24-171110,171110,1,0,1,50,1.5,0.41008842,4
2020-04-25-171110,171110,0,0,1,50,0.5,0.08672408,5
2020-04-26-171110,171110,0,0,0,50,0.0,0.005822175,6
2020-04-27-171110,171110,0,0,0,50,3.0,0.6037982,0
2020-04-28-171110,171110,0,0,1,50,1.0,0.2655162,1
2020-04-29-171110,171110,0,0,3,50,0.25,0.28724477,2
2020-04-30-171110,171110,0,0,2,50,1.75,0.5089276,3
2020-05-01-171110,171110,0,0,4,50,0.25,0.044150066,4
2020-05-02-171110,171110,0,0,0,50,0.5,0.0934749,5
2020-05-03-171110,171110,0,0,0,50,0.75,0.07009161,6
2020-05-04-171110,171110,6,0,0,56,2.25,0.97133553,0
2020-05-05-171110,171110,2,0,1,58,4.0,0.795925,1
2020-05-06-171110,171110,1,0,0,59,0.5,0.56756467,2
2020-05-07-171110,171110,0,0,1,59,1.5,0.5579272,3
2020-05-08-171110,171110,1,0,0,60,2.75,0.45208567,4
2020-05-09-171110,171110,1,0,0,61,0.75,0.14745416,5
2020-05-10-171110,171110,0,0,0,61,0.0,0.00047645497,6
2020-05-11-171110,171110,0,0,1,61,1.25,0.29024655,0
2020-05-12-171110,171110,1,2,1,62,1.5,0.49694782,1
2020-05-13-171110,171110,3,0,0,65,1.75,0.5210619,2
2020-05-14-171110,171110,2,0,0,67,0.75,0.19732983,3
2020-05-15-171110,171110,4,0,0,71,0.5,0.2754277,4
2020-05-16-171110,171110,0,0,0,71,0.25,0.09892199,5
2020-05-17-171110,171110,0,0,0,71,0.0,0.00010053226,6
2020-05-18-171110,171110,0,0,0,71,0.25,0.13254982,0
2020-05-19-171110,171110,1,0,0,72,2.0,0.5513804,1
2020-05-20-171110,171110,0,0,0,72,0.25,0.20892954,2
2020-05-21-171110,171110,1,0,0,73,2.25,0.7763405,3
2020-05-22-171110,171110,0,0,0,73,0.25,0.114312835,4
2020-05-23-171110,171110,0,0,0,73,0.0,0.013323855,5
2020-05-24-171110,171110,0,1,0,73,0.0,0.0230451,6
2020-05-25-171110,171110,1,0,0,74,1.5,0.5014281,0
2020-05-26-171110,171110,1,0,0,75,0.5,0.40841514,1
2020-05-27-171110,171110,0,1,0,75,0.5,0.18172088,2
2020-05-28-171110,171110,0,0,1,75,0.5,0.155018,3
2020-05-29-171110,171110,0,0,0,75,0.5,0.20501332,4
2020-05-30-171110,171110,0,0,0,75,0.0,0.0015962732,5
2020-05-31-171110,171110,0,0,0,75,0.0,0.00070711796,6
2020-06-01-171110,171110,0,0,0,75,0.0,0.02093168,0
2020-06-02-171110,171110,0,0,0,75,0.5,0.11380124,1
2020-06-03-171110,171110,0,0,0,75,0.75,0.06610802,2
2020-06-04-171110,171110,0,0,0,75,0.25,0.15419388,3
2020-06-05-171110,171110,0,0,1,75,0.5,0.0875164,4
2020-06-06-171110,171110,0,1,0,75,0.0,0.036817633,5
2020-06-07-171110,171110,0,0,0,75,0.0,0.0005425312,6
2020-06-08-171110,171110,0,0,0,75,1.25,0.34655756,0
2020-06-09-171110,171110,0,0,0,75,0.25,0.093515754,1
2020-06-10-171110,171110,0,0,0,75,0.25,0.09864053,2
2020-06-11-171110,171110,1,0,0,76,0.75,0.35229638,3
2020-06-12-171110,171110,0,0,1,76,0.25,0.059653196,4
2020-06-13-171110,171110,0,0,0,76,0.0,0.0003116991,5
2020-06-14-171110,171110,0,0,0,76,0.0,5.174289e-05,6
2020-06-15-171110,171110,0,0,0,76,0.5,0.08311073,0
2020-06-16-171110,171110,0,0,0,76,0.0,0.0083701275,1
2020-06-17-171110,171110,0,0,0,76,0.25,0.04171565,2
2020-06-18-171110,171110,0,0,0,76,0.25,0.043075286,3
2020-06-19-171110,171110,1,0,0,77,0.25,0.29393584,4
2020-06-20-171110,171110,0,0,0,77,0.25,0.03239085,5
2020-06-21-171110,171110,0,0,0,77,0.0,0.0008115767,6
2020-06-22-171110,171110,0,0,0,77,0.0,0.008833107,0
2020-06-23-171110,171110,0,0,0,77,0.25,0.044880137,1
2020-06-24-171110,171110,0,0,0,77,0.25,0.0658593,2
2020-06-25-171110,171110,0,0,0,77,0.5,0.0714903,3
2020-06-26-171110,171110,1,1,0,78,0.0,0.042496286,4
2020-06-27-171110,171110,0,0,0,78,0.0,0.0023250752,5
2020-06-28-171110,171110,0,0,0,78,0.0,0.047991768,6
2020-06-29-171110,171110,0,0,0,78,0.0,0.04273125,0
2020-06-30-171110,171110,0,1,0,78,0.0,0.024055757,1
2020-07-01-171110,171110,0,0,0,78,0.0,0.0031006814,2
2020-07-02-171110,171110,0,0,0,78,0.25,0.04406275,3
2020-07-03-171110,171110,0,0,0,78,0.0,0.0046455166,4
2020-07-04-171110,171110,0,0,1,78,0.25,0.036956787,5
2020-07-05-171110,171110,0,0,0,78,0.0,0.01254427,6
2020-07-06-171110,171110,0,0,0,78,0.25,0.09697713,0
2020-07-07-171110,171110,0,0,0,78,0.0,0.0014839014,1
2020-07-08-171110,171110,0,0,1,78,0.0,0.0016073522,2
2020-07-09-171110,171110,0,0,0,78,0.0,0.0046124323,3
2020-07-10-171110,171110,0,0,0,78,0.5,0.101497486,4
2020-07-11-171110,171110,0,0,0,78,0.0,0.0011580575,5
2020-07-12-171110,171110,0,0,0,78,0.0,0.0009494596,6
2020-07-13-171110,171110,0,0,0,78,0.5,0.08088095,0
2020-07-14-171110,171110,0,0,0,78,0.75,0.0869784,1
2020-07-15-171110,171110,0,0,0,78,0.0,0.0025115886,2
2020-07-16-171110,171110,0,0,1,78,0.25,0.048058614,3
2020-07-17-171110,171110,0,0,0,78,0.25,0.041286156,4
2020-07-18-171110,171110,1,0,0,79,0.0,0.08543585,5
2020-07-19-171110,171110,0,0,0,79,0.0,0.00024003656,6
2020-07-20-171110,171110,0,0,0,79,0.0,0.0047400887,0
2020-07-21-171110,171110,0,0,0,79,0.0,0.0034307283,1
2020-07-22-171110,171110,1,0,0,80,0.0,0.07993539,2
2020-07-23-171110,171110,0,0,0,80,0.0,0.005656415,3
2020-07-24-171110,171110,0,0,0,80,0.0,0.012193988,4
2020-07-25-171110,171110,0,0,0,80,0.0,0.0001970273,5
2020-07-26-171110,171110,0,0,0,80,0.0,0.00016456735,6
2020-07-27-171110,171110,0,0,0,80,0.5,0.1348384,0
2020-07-28-171110,171110,0,0,0,80,0.0,0.005719074,1
2020-07-29-171110,171110,0,1,0,80,0.25,0.058022656,2
2020-07-30-171110,171110,1,0,1,81,0.25,0.18791173,3
2020-07-31-171110,171110,0,0,0,81,0.5,0.20985681,4
2020-08-01-171110,171110,0,0,0,81,0.0,0.008823654,5
2020-08-02-171110,171110,0,0,0,81,0.0,0.0081231985,6
2020-08-03-171110,171110,0,0,0,81,0.25,0.14993392,0
2020-08-04-171110,171110,0,0,0,81,0.0,0.016090944,1
2020-08-05-171110,171110,0,0,0,81,0.0,0.025102058,2
2020-08-06-171110,171110,0,0,0,81,0.0,0.05063212,3
2020-08-07-171110,171110,0,0,0,81,0.5,0.2736459,4
2020-08-08-171110,171110,0,0,0,81,0.0,0.019432066,5
2020-08-09-171110,171110,0,0,0,81,0.0,0.05828335,6
2020-08-10-171110,171110,0,0,0,81,0.0,0.09349598,0
2020-08-11-171110,171110,0,0,0,81,0.5,0.081656136,1
2020-08-12-171110,171110,0,0,0,81,0.5,0.15631466,2
2020-08-13-171110,171110,1,0,0,82,0.25,1.0556562,3
2020-08-14-171110,171110,0,0,0,82,0.0,0.36734653,4
2020-08-15-171110,171110,0,0,0,82,0.0,0.06297862,5
2020-08-16-171110,171110,0,0,0,82,0.25,0.07451456,6
2020-08-17-171110,171110,0,0,0,82,0.75,0.17330554,0
2020-08-18-171110,171110,0,0,0,82,3.0,0.98546314,1
2020-08-19-171110,171110,0,0,0,82,0.25,0.105265036,2
2020-08-20-171110,171110,0,0,0,82,1.5,0.20163703,3
2020-08-21-171110,171110,0,0,2,82,0.75,0.34935418,4
2020-08-22-171110,171110,0,0,0,82,0.25,0.12101017,5
2020-08-23-171110,171110,0,0,0,82,0.75,0.11363046,6
2020-08-24-171110,171110,0,0,1,82,0.75,0.5158478,0
2020-08-25-171110,171110,0,0,7,82,0.5,0.1505946,1
2020-08-26-171110,171110,0,0,2,82,0.75,0.2381314,2
2020-08-27-171110,171110,0,0,0,82,0.0,0.17334579,3
2020-08-28-171110,171110,0,0,0,82,0.5,0.28420985,4
2020-08-29-171110,171110,0,0,0,82,0.25,0.1245173,5
2020-08-30-171110,171110,0,0,1,82,0.0,0.022963714,6
2020-08-31-171110,171110,0,0,1,82,0.75,0.23214181,0
2020-09-01-171110,171110,0,0,0,82,1.5,0.5315687,1
2020-09-02-171110,171110,0,0,0,82,1.5,0.40708584,2
2020-09-03-171110,171110,0,0,0,82,0.0,0.10695849,3
2020-09-04-171110,171110,2,0,1,84,1.0,0.4330563,4
2020-09-05-171110,171110,0,0,0,84,0.25,0.06734473,5
2020-09-06-171110,171110,0,0,1,84,0.25,0.088260524,6
2020-09-07-171110,171110,1,0,32,85,2.5,0.48076382,0
2020-09-08-171110,171110,7,0,1,92,1.0,0.74717903,1
2020-09-09-171110,171110,2,0,1,94,0.25,0.18444404,2
2020-09-10-171110,171110,0,0,4,94,1.5,0.7232873,3
2020-09-11-171110,171110,0,0,3,94,1.0,0.5744834,4
2020-09-12-171110,171110,0,0,3,94,0.75,0.2194219,5
2020-09-13-171110,171110,1,0,4,95,1.75,0.35136873,6
2020-09-14-171110,171110,1,0,1,96,1.0,0.63062024,0
2020-09-15-171110,171110,0,0,2,96,0.75,0.38659465,1
2020-09-16-171110,171110,0,0,0,96,1.0,0.70015055,2
2020-09-17-171110,171110,0,0,3,96,1.25,1.1988972,3
2020-09-18-171110,171110,1,0,4,97,3.5,1.1443286,4
2020-09-19-171110,171110,0,0,9,97,2.5,0.39902306,5
2020-09-20-171110,171110,1,0,1,98,2.0,0.43117604,6
2020-09-21-171110,171110,32,0,0,130,0.0,1.9919147,0
2020-09-22-171110,171110,1,1,3,131,1.0,0.28094476,1
2020-09-23-171110,171110,1,0,1,132,2.25,0.7549808,2
2020-09-24-171110,171110,4,0,1,136,3.25,1.4309567,3
2020-09-25-171110,171110,3,0,0,139,3.75,0.94987446,4
2020-09-26-171110,171110,3,1,1,142,1.0,0.677765,5
2020-09-27-171110,171110,4,0,0,146,1.75,0.8865388,6
2020-09-28-171110,171110,1,0,0,147,1.5,0.3759964,0
2020-09-29-171110,171110,2,1,3,149,0.75,0.2979975,1
2020-09-30-171110,171110,0,1,0,149,1.25,0.505126,2
2020-10-01-171110,171110,3,0,2,152,1.5,0.64200056,3
2020-10-02-171110,171110,4,0,1,156,1.25,0.8133013,4
2020-10-03-171110,171110,9,1,0,165,2.0,0.93810076,5
2020-10-04-171110,171110,1,1,0,166,0.5,0.17923793,6
2020-10-05-171110,171110,0,0,1,166,2.5,0.48821354,0
2020-10-06-171110,171110,3,0,1,169,2.5,0.9676589,1
2020-10-07-171110,171110,1,0,37,170,1.25,0.48365572,2
2020-10-08-171110,171110,1,0,37,171,2.0,0.6027174,3
2020-10-09-171110,171110,0,1,2,171,1.25,0.47872385,4
2020-10-10-171110,171110,1,0,2,172,1.75,0.47829962,5
2020-10-11-171110,171110,0,0,1,172,1.25,0.40337858,6
2020-10-12-171110,171110,0,0,1,172,0.75,0.20128852,0
2020-10-13-171110,171110,3,0,1,175,0.5,0.4393589,1
2020-10-14-171110,171110,0,0,3,175,2.75,1.467646,2
2020-10-15-171110,171110,2,0,1,177,2.25,1.1147807,3
2020-10-16-171110,171110,1,0,3,178,6.75,3.6521583,4
2020-10-17-171110,171110,0,1,4,178,2.5,0.4550252,5
2020-10-18-171110,171110,0,0,2,178,1.5,0.46967417,6
2020-10-19-171110,171110,1,2,0,179,3.25,0.74482334,0
2020-10-20-171110,171110,1,0,5,180,9.5,1.9628333,1
2020-10-21-171110,171110,37,0,0,217,2.5,2.169716,2
2020-10-22-171110,171110,37,1,6,254,2.75,3.7980492,3
2020-10-23-171110,171110,2,0,2,256,6.0,1.5929668,4
2020-10-24-171110,171110,2,1,1,258,1.75,0.44515336,5
2020-10-25-171110,171110,1,1,0,259,1.0,0.307934,6
2020-10-26-171110,171110,1,0,1,260,5.5,1.3270911,0
2020-10-27-171110,171110,1,3,3,261,3.75,0.9205062,1
2020-10-28-171110,171110,3,0,0,264,3.5,1.2247084,2
2020-10-29-171110,171110,1,0,1,265,3.25,1.5917877,3
2020-10-30-171110,171110,3,0,0,268,9.0,2.999082,4
2020-10-31-171110,171110,4,0,0,272,1.0,0.63508403,5
2020-11-01-171110,171110,2,2,0,274,1.25,0.45365283,6
2020-11-02-171110,171110,0,0,0,274,1.25,0.32057482,0
2020-11-03-171110,171110,5,1,0,279,3.5,1.5507567,1
2020-11-04-171110,171110,0,0,0,279,6.5,1.854379,2
2020-11-05-171110,171110,6,2,0,285,5.0,2.2266016,3
2020-11-06-171110,171110,2,0,0,287,15.5,4.2134666,4
2020-11-07-171110,171110,1,1,0,288,1.5,0.34792912,5
2020-11-08-171110,171110,0,0,0,288,1.5,0.28149036,6
2020-11-09-171110,171110,1,1,0,289,4.5,1.3814902,0
2020-11-10-171110,171110,3,0,0,292,3.0,1.0895913,1
2020-11-11-171110,171110,0,1,0,292,6.0,1.6352289,2
2020-11-12-171110,171110,1,1,0,293,2.25,1.0068407,3
2020-11-13-171110,171110,0,2,0,293,4.0,0.65343535,4
2020-03-01-171111,171111,0,0,0,0,0.0,5.0513438e-05,6
2020-03-02-171111,171111,0,0,2,0,0.3333333333333333,0.099205725,0
2020-03-03-171111,171111,0,1,11,0,0.3333333333333333,0.00013871881,1
2020-03-04-171111,171111,0,0,12,0,0.0,0.0014341038,2
2020-03-05-171111,171111,1,0,14,1,0.3333333333333333,6.155857e-05,3
2020-03-06-171111,171111,0,0,15,1,0.3333333333333333,0.00014584692,4
2020-03-07-171111,171111,0,0,4,1,0.3333333333333333,0.10171436,5
2020-03-08-171111,171111,0,0,1,1,0.3333333333333333,0.00011401463,6
2020-03-09-171111,171111,1,0,19,2,0.3333333333333333,0.117893435,0
2020-03-10-171111,171111,0,1,13,2,0.0,0.0004459609,1
2020-03-11-171111,171111,1,0,12,3,0.6666666666666666,0.22668374,2
2020-03-12-171111,171111,0,0,6,3,1.6666666666666667,0.35156804,3
2020-03-13-171111,171111,0,0,15,3,1.0,0.12343497,4
2020-03-14-171111,171111,0,0,1,3,0.3333333333333333,0.069277674,5
2020-03-15-171111,171111,0,0,4,3,0.3333333333333333,0.0016299852,6
2020-03-16-171111,171111,2,0,14,5,4.333333333333333,0.2565598,0
2020-03-17-171111,171111,11,1,15,16,6.333333333333332,0.07837496,1
2020-03-18-171111,171111,12,0,7,28,11.666666666666664,0.12315419,2
2020-03-19-171111,171111,14,0,9,42,11.666666666666664,0.15399131,3
2020-03-20-171111,171111,15,0,5,57,14.666666666666664,0.26924536,4
2020-03-21-171111,171111,4,1,1,61,2.6666666666666665,0.014674209,5
2020-03-22-171111,171111,1,0,0,62,0.6666666666666666,0.0408474,6
2020-03-23-171111,171111,19,0,13,81,15.0,0.19864213,0
2020-03-24-171111,171111,13,0,16,94,10.0,0.12334722,1
2020-03-25-171111,171111,12,0,9,106,8.333333333333334,0.29539078,2
2020-03-26-171111,171111,6,0,5,112,8.666666666666666,0.17472947,3
2020-03-27-171111,171111,15,0,3,127,10.666666666666666,0.33474642,4
2020-03-28-171111,171111,1,0,0,128,0.6666666666666666,0.0015886687,5
2020-03-29-171111,171111,4,0,12,132,1.0,0.007983029,6
2020-03-30-171111,171111,14,0,12,146,9.666666666666666,0.30826822,0
2020-03-31-171111,171111,15,0,10,161,5.0,0.031043263,1
2020-04-01-171111,171111,7,0,10,168,6.0,0.35753804,2
2020-04-02-171111,171111,9,0,4,177,3.333333333333333,0.12810493,3
2020-04-03-171111,171111,5,0,6,182,3.6666666666666665,0.09930131,4
2020-04-04-171111,171111,1,0,1,183,2.0,0.039862316,5
2020-04-05-171111,171111,0,0,0,183,1.0,0.040268317,6
2020-04-06-171111,171111,13,0,7,196,6.333333333333332,0.26870584,0
2020-04-07-171111,171111,16,0,1,212,3.0,0.027659647,1
2020-04-08-171111,171111,9,0,4,221,2.333333333333333,0.13620754,2
2020-04-09-171111,171111,5,0,0,226,1.6666666666666667,0.021205889,3
2020-04-10-171111,171111,3,0,2,229,1.6666666666666667,0.00827675,4
2020-04-11-171111,171111,0,0,0,229,0.3333333333333333,0.067738414,5
2020-04-12-171111,171111,12,0,0,241,0.0,0.016101267,6
2020-04-13-171111,171111,12,0,6,253,1.6666666666666667,0.058769703,0
2020-04-14-171111,171111,10,0,6,263,4.333333333333333,0.026987057,1
2020-04-15-171111,171111,10,0,11,273,5.0,0.06875355,2
2020-04-16-171111,171111,4,0,9,277,2.0,0.13539219,3
2020-04-17-171111,171111,6,0,4,283,6.333333333333332,0.15428592,4
2020-04-18-171111,171111,1,0,0,284,0.0,0.0064519234,5
2020-04-19-171111,171111,0,0,0,284,0.3333333333333333,0.0060633756,6
2020-04-20-171111,171111,7,0,14,291,5.0,0.0797552,0
2020-04-21-171111,171111,1,0,6,292,1.6666666666666667,0.06612788,1
2020-04-22-171111,171111,4,0,32,296,2.333333333333333,0.015159419,2
2020-04-23-171111,171111,0,0,3,296,0.0,0.0035568853,3
2020-04-24-171111,171111,2,0,9,298,4.666666666666667,0.14231843,4
2020-04-25-171111,171111,0,0,1,298,0.6666666666666666,0.015675284,5
2020-04-26-171111,171111,0,0,1,298,0.6666666666666666,0.00063067133,6
2020-04-27-171111,171111,6,0,8,304,5.666666666666668,0.38497248,0
2020-04-28-171111,171111,6,0,20,310,5.0,0.14035894,1
2020-04-29-171111,171111,11,0,40,321,4.666666666666667,0.09140364,2
2020-04-30-171111,171111,9,0,14,330,6.0,0.29775262,3
2020-05-01-171111,171111,4,0,12,334,0.3333333333333333,0.011512483,4
2020-05-02-171111,171111,0,0,1,334,0.0,0.018308125,5
2020-05-03-171111,171111,0,0,1,334,0.0,0.0023075258,6
2020-05-04-171111,171111,14,0,10,348,5.333333333333333,0.4562009,0
2020-05-05-171111,171111,6,0,11,354,5.333333333333333,0.18854317,1
2020-05-06-171111,171111,32,0,5,386,4.666666666666667,0.12661147,2
2020-05-07-171111,171111,3,0,8,389,3.0,0.21272,3
2020-05-08-171111,171111,9,0,4,398,6.0,0.12579486,4
2020-05-09-171111,171111,1,0,0,399,0.3333333333333333,0.057808578,5
2020-05-10-171111,171111,1,1,0,400,0.0,0.00020967504,6
2020-05-11-171111,171111,8,0,6,408,5.333333333333333,0.15582703,0
2020-05-12-171111,171111,20,1,7,428,5.666666666666668,0.19996524,1
2020-05-13-171111,171111,40,1,2,468,4.0,0.1956352,2
2020-05-14-171111,171111,14,0,2,482,3.333333333333333,0.12249236,3
2020-05-15-171111,171111,12,0,0,494,5.333333333333333,0.15259817,4
2020-05-16-171111,171111,1,0,0,495,1.3333333333333333,0.06612781,5
2020-05-17-171111,171111,1,0,0,496,0.0,3.360006e-05,6
2020-05-18-171111,171111,10,0,0,506,2.6666666666666665,0.03284345,0
2020-05-19-171111,171111,11,0,2,517,2.333333333333333,0.3508792,1
2020-05-20-171111,171111,5,0,4,522,2.0,0.1061953,2
2020-05-21-171111,171111,8,0,0,530,5.0,0.6007978,3
2020-05-22-171111,171111,4,0,1,534,5.0,0.015020966,4
2020-05-23-171111,171111,0,0,0,534,0.6666666666666666,0.00017952941,5
2020-05-24-171111,171111,0,0,0,534,0.0,0.007500144,6
2020-05-25-171111,171111,6,0,0,540,3.333333333333333,0.3068539,0
2020-05-26-171111,171111,7,0,1,547,3.333333333333333,0.18448487,1
2020-05-27-171111,171111,2,0,1,549,1.6666666666666667,0.15269803,2
2020-05-28-171111,171111,2,1,0,551,0.0,0.028599741,3
2020-05-29-171111,171111,0,1,2,551,2.0,0.15467693,4
2020-05-30-171111,171111,0,1,0,551,0.0,8.426425e-05,5
2020-05-31-171111,171111,0,0,1,551,0.0,0.00028995084,6
2020-06-01-171111,171111,0,0,0,551,0.0,0.001764261,0
2020-06-02-171111,171111,2,7,3,553,0.6666666666666666,0.012381371,1
2020-06-03-171111,171111,4,0,2,557,1.0,0.0043004896,2
2020-06-04-171111,171111,0,0,1,557,1.6666666666666667,0.08734669,3
2020-06-05-171111,171111,1,0,0,558,0.6666666666666666,0.0040658554,4
2020-06-06-171111,171111,0,0,0,558,0.0,0.014754893,5
2020-06-07-171111,171111,0,0,0,558,0.0,5.916354e-05,6
2020-06-08-171111,171111,0,0,1,558,1.6666666666666667,0.32204893,0
2020-06-09-171111,171111,1,0,4,559,2.0,0.08140311,1
2020-06-10-171111,171111,1,0,1,560,0.3333333333333333,0.043170966,2
2020-06-11-171111,171111,0,0,0,560,0.6666666666666666,0.23820645,3
2020-06-12-171111,171111,2,0,1,562,0.6666666666666666,0.018352542,4
2020-06-13-171111,171111,0,0,0,562,0.0,6.779366e-05,5
2020-06-14-171111,171111,1,1,0,563,0.0,9.006899e-06,6
2020-06-15-171111,171111,0,1,0,563,1.6666666666666667,0.08192556,0
2020-06-16-171111,171111,3,0,1,566,0.6666666666666666,0.0013740477,1
2020-06-17-171111,171111,2,0,0,568,0.0,0.003609227,2
2020-06-18-171111,171111,1,0,2,569,1.0,0.0056119747,3
2020-06-19-171111,171111,0,0,1,569,2.333333333333333,0.19952038,4
2020-06-20-171111,171111,0,0,0,569,0.0,0.0043980503,5
2020-06-21-171111,171111,0,0,0,569,0.0,8.200749e-05,6
2020-06-22-171111,171111,1,0,0,570,0.6666666666666666,0.001320926,0
2020-06-23-171111,171111,4,0,0,574,0.6666666666666666,0.00503049,1
2020-06-24-171111,171111,1,0,0,575,0.0,0.0082457885,2
2020-06-25-171111,171111,0,0,0,575,0.3333333333333333,0.0068493667,3
2020-06-26-171111,171111,1,0,0,576,0.6666666666666666,0.021113228,4
2020-06-27-171111,171111,0,0,0,576,0.3333333333333333,0.000389023,5
2020-06-28-171111,171111,0,0,0,576,0.0,0.0019929414,6
2020-06-29-171111,171111,0,0,0,576,0.0,0.0025842064,0
2020-06-30-171111,171111,1,0,0,577,0.3333333333333333,0.0051240074,1
2020-07-01-171111,171111,0,0,0,577,0.0,0.0005858,2
2020-07-02-171111,171111,2,0,0,579,0.3333333333333333,0.0060721817,3
2020-07-03-171111,171111,1,0,0,580,0.6666666666666666,0.002161501,4
2020-07-04-171111,171111,0,0,0,580,0.0,0.002192107,5
2020-07-05-171111,171111,0,0,0,580,0.0,0.0007597741,6
2020-07-06-171111,171111,0,0,0,580,0.3333333333333333,0.08544651,0
2020-07-07-171111,171111,0,2,0,580,0.0,0.00027186598,1
2020-07-08-171111,171111,0,0,0,580,0.0,0.00081155624,2
2020-07-09-171111,171111,0,0,0,580,0.3333333333333333,0.00097112113,3
2020-07-10-171111,171111,0,0,0,580,0.0,0.036132604,4
2020-07-11-171111,171111,0,0,0,580,0.0,0.00011229451,5
2020-07-12-171111,171111,0,0,0,580,0.0,0.00019256884,6
2020-07-13-171111,171111,0,0,0,580,0.3333333333333333,0.0049436623,0
2020-07-14-171111,171111,0,0,1,580,0.0,0.0070698606,1
2020-07-15-171111,171111,0,0,0,580,0.3333333333333333,0.00049106,2
2020-07-16-171111,171111,0,0,1,580,0.0,0.002772058,3
2020-07-17-171111,171111,0,0,1,580,0.6666666666666666,0.0029315501,4
2020-07-18-171111,171111,0,0,0,580,0.0,0.0055012014,5
2020-07-19-171111,171111,0,0,0,580,0.0,0.00018217022,6
2020-07-20-171111,171111,0,0,0,580,0.0,0.0012021858,0
2020-07-21-171111,171111,0,0,0,580,0.0,0.0010858357,1
2020-07-22-171111,171111,0,0,0,580,0.3333333333333333,0.00637032,2
2020-07-23-171111,171111,0,0,0,580,0.0,0.0028733255,3
2020-07-24-171111,171111,0,0,1,580,0.0,0.003138041,4
2020-07-25-171111,171111,0,0,0,580,0.0,6.200983e-05,5
2020-07-26-171111,171111,0,0,0,580,0.0,6.3378495e-05,6
2020-07-27-171111,171111,0,0,0,580,0.6666666666666666,0.08544035,0
2020-07-28-171111,171111,1,0,1,581,0.0,0.001356948,1
2020-07-29-171111,171111,0,0,0,581,0.0,0.006029755,2
2020-07-30-171111,171111,1,0,1,582,0.3333333333333333,0.013886301,3
2020-07-31-171111,171111,1,0,1,583,2.0,0.17560133,4
2020-08-01-171111,171111,0,0,1,583,0.6666666666666666,0.0011398989,5
2020-08-02-171111,171111,0,0,1,583,0.0,0.0016180751,6
2020-08-03-171111,171111,0,0,1,583,1.6666666666666667,0.025697824,0
2020-08-04-171111,171111,0,0,3,583,0.3333333333333333,0.0034079193,1
2020-08-05-171111,171111,0,0,1,583,0.0,0.0040855897,2
2020-08-06-171111,171111,0,0,3,583,1.0,0.0033696701,3
2020-08-07-171111,171111,1,0,1,584,0.6666666666666666,0.11638647,4
2020-08-08-171111,171111,0,0,1,584,0.3333333333333333,0.0019431696,5
2020-08-09-171111,171111,0,0,0,584,0.0,0.025523515,6
2020-08-10-171111,171111,0,0,3,584,1.6666666666666667,0.023491936,0
2020-08-11-171111,171111,1,0,2,585,0.6666666666666666,0.04891231,1
2020-08-12-171111,171111,0,0,0,585,2.6666666666666665,0.08781688,2
2020-08-13-171111,171111,1,0,3,586,0.3333333333333333,0.66377044,3
2020-08-14-171111,171111,1,0,1,587,2.0,0.25616494,4
2020-08-15-171111,171111,1,0,1,588,0.6666666666666666,0.0200737,5
2020-08-16-171111,171111,1,0,3,589,2.0,0.010198121,6
2020-08-17-171111,171111,1,0,4,590,0.3333333333333333,0.04122598,0
2020-08-18-171111,171111,3,0,6,593,3.333333333333333,0.78513706,1
2020-08-19-171111,171111,1,1,4,594,0.3333333333333333,0.0164675,2
2020-08-20-171111,171111,3,0,4,597,0.6666666666666666,0.023429545,3
2020-08-21-171111,171111,1,0,6,598,2.0,0.119670324,4
2020-08-22-171111,171111,1,0,7,599,0.0,0.03841962,5
2020-08-23-171111,171111,0,0,6,599,0.0,0.012321754,6
2020-08-24-171111,171111,3,0,0,602,2.0,0.26161838,0
2020-08-25-171111,171111,2,0,3,604,2.6666666666666665,0.032530345,1
2020-08-26-171111,171111,0,0,0,604,1.0,0.103412285,2
2020-08-27-171111,171111,3,0,12,607,1.6666666666666667,0.06936562,3
2020-08-28-171111,171111,1,1,1,608,1.0,0.101264544,4
2020-08-29-171111,171111,1,0,4,609,0.6666666666666666,0.097242005,5
2020-08-30-171111,171111,3,0,2,612,0.6666666666666666,0.0062054945,6
2020-08-31-171111,171111,4,0,3,616,2.0,0.031276375,0
2020-09-01-171111,171111,6,0,1,622,2.333333333333333,0.39263797,1
2020-09-02-171111,171111,4,0,3,626,5.0,0.27450606,2
2020-09-03-171111,171111,4,0,5,630,0.6666666666666666,0.027883992,3
2020-09-04-171111,171111,6,0,9,636,2.6666666666666665,0.32079074,4
2020-09-05-171111,171111,7,0,1,643,2.0,0.019242711,5
2020-09-06-171111,171111,6,0,12,649,2.0,0.07384262,6
2020-09-07-171111,171111,0,0,6,649,2.0,0.135767,0
2020-09-08-171111,171111,3,0,1,652,5.666666666666668,0.31334144,1
2020-09-09-171111,171111,0,0,8,652,0.3333333333333333,0.029879546,2
2020-09-10-171111,171111,12,0,9,664,5.0,0.523389,3
2020-09-11-171111,171111,1,0,4,665,1.3333333333333333,0.3222595,4
2020-09-12-171111,171111,4,0,3,669,3.0,0.1011343,5
2020-09-13-171111,171111,2,0,5,671,2.0,0.069536015,6
2020-09-14-171111,171111,3,0,2,674,6.0,0.44929415,0
2020-09-15-171111,171111,1,0,2,675,4.0,0.30468288,1
2020-09-16-171111,171111,3,0,11,678,4.333333333333333,0.5819602,2
2020-09-17-171111,171111,5,0,9,683,6.666666666666668,1.1333674,3
2020-09-18-171111,171111,9,0,6,692,7.333333333333332,0.8657247,4
2020-09-19-171111,171111,1,0,2,693,3.333333333333333,0.061770488,5
2020-09-20-171111,171111,12,1,1,705,2.333333333333333,0.11038585,6
2020-09-21-171111,171111,6,0,7,711,4.666666666666667,0.26824623,0
2020-09-22-171111,171111,1,1,1,712,1.3333333333333333,0.07644125,1
2020-09-23-171111,171111,8,0,3,720,6.0,0.285999,2
2020-09-24-171111,171111,9,0,2,729,2.6666666666666665,0.38165256,3
2020-09-25-171111,171111,4,1,4,733,4.333333333333333,0.23949566,4
2020-09-26-171111,171111,3,1,0,736,2.0,0.1483218,5
2020-09-27-171111,171111,5,0,6,741,2.333333333333333,0.56012106,6
2020-09-28-171111,171111,2,1,4,743,2.0,0.07201308,0
2020-09-29-171111,171111,2,1,3,745,1.0,0.05662701,1
2020-09-30-171111,171111,11,0,4,756,2.6666666666666665,0.19609798,2
2020-10-01-171111,171111,9,0,3,765,3.0,0.15925238,3
2020-10-02-171111,171111,6,0,10,771,1.6666666666666667,0.38826272,4
2020-10-03-171111,171111,2,2,0,773,0.6666666666666666,0.20068598,5
2020-10-04-171111,171111,1,1,2,774,0.0,0.028725866,6
2020-10-05-171111,171111,7,0,15,781,1.6666666666666667,0.08569172,0
2020-10-06-171111,171111,1,0,15,782,5.333333333333333,0.76138,1
2020-10-07-171111,171111,3,0,5,785,3.0,0.21846506,2
2020-10-08-171111,171111,2,0,22,787,1.6666666666666667,0.28888962,3
2020-10-09-171111,171111,4,3,18,791,3.333333333333333,0.32543978,4
2020-10-10-171111,171111,0,0,2,791,1.0,0.25364402,5
2020-10-11-171111,171111,6,0,0,797,1.6666666666666667,0.3003257,6
2020-10-12-171111,171111,4,0,20,801,0.3333333333333333,0.094133005,0
2020-10-13-171111,171111,3,0,12,804,3.333333333333333,0.13020277,1
2020-10-14-171111,171111,4,0,18,808,3.333333333333333,1.3134291,2
2020-10-15-171111,171111,3,0,13,811,4.333333333333333,0.6951716,3
2020-10-16-171111,171111,10,0,41,821,14.333333333333336,3.550672,4
2020-10-17-171111,171111,0,0,4,821,2.6666666666666665,0.26832676,5
2020-10-18-171111,171111,2,1,6,823,3.6666666666666665,0.31097642,6
2020-10-19-171111,171111,15,0,6,838,7.333333333333332,0.42072365,0
2020-10-20-171111,171111,15,0,14,853,12.666666666666664,1.6711696,1
2020-10-21-171111,171111,5,0,14,858,7.0,0.6342541,2
2020-10-22-171111,171111,22,0,12,880,11.0,1.0559821,3
2020-10-23-171111,171111,18,0,31,898,14.333333333333336,1.3913054,4
2020-10-24-171111,171111,2,2,8,900,9.333333333333334,0.25117517,5
2020-10-25-171111,171111,0,1,10,900,2.333333333333333,0.1994532,6
2020-10-26-171111,171111,20,0,15,920,16.666666666666668,1.1990201,0
2020-10-27-171111,171111,12,2,19,932,8.666666666666666,0.47209045,1
2020-10-28-171111,171111,18,2,12,950,7.666666666666668,0.7744012,2
2020-10-29-171111,171111,13,0,15,963,10.0,1.1721518,3
2020-10-30-171111,171111,41,1,78,1004,19.666666666666668,2.70639,4
2020-10-31-171111,171111,4,3,0,1008,1.0,0.2191405,5
2020-11-01-171111,171111,6,3,0,1014,4.666666666666667,0.20752683,6
2020-11-02-171111,171111,6,0,0,1020,3.333333333333333,0.30940956,0
2020-11-03-171111,171111,14,3,0,1034,10.0,1.0573355,1
2020-11-04-171111,171111,14,0,0,1048,15.0,1.5200212,2
2020-11-05-171111,171111,12,0,0,1060,16.0,1.6031415,3
2020-11-06-171111,171111,31,3,0,1091,29.66666666666667,3.9210913,4
2020-11-07-171111,171111,8,0,0,1099,4.0,0.109943956,5
2020-11-08-171111,171111,10,1,0,1109,3.0,0.15004049,6
2020-11-09-171111,171111,15,0,0,1124,21.33333333333333,1.4995465,0
2020-11-10-171111,171111,19,2,0,1143,20.0,0.6688722,1
2020-11-11-171111,171111,12,2,0,1155,9.333333333333334,1.1309525,2
2020-11-12-171111,171111,15,0,0,1170,10.333333333333334,0.65670156,3
2020-11-13-171111,171111,78,1,0,1248,8.0,0.27843958,4
2020-03-01-171112,171112,0,0,0,0,0.0,0.00012362724,6
2020-03-02-171112,171112,0,0,3,0,0.25,0.20825574,0
2020-03-03-171112,171112,0,0,11,0,0.25,0.00036746392,1
2020-03-04-171112,171112,0,0,10,0,0.0,0.0026917562,2
2020-03-05-171112,171112,0,0,10,0,0.5,0.00014608323,3
2020-03-06-171112,171112,0,0,16,0,0.25,0.00020377491,4
2020-03-07-171112,171112,0,0,4,0,0.25,0.21489665,5
2020-03-08-171112,171112,0,0,0,0,0.25,0.00018242344,6
2020-03-09-171112,171112,0,0,19,0,0.5,0.24836737,0
2020-03-10-171112,171112,0,0,9,0,0.0,0.0009244575,1
2020-03-11-171112,171112,0,0,10,0,1.0,0.47381935,2
2020-03-12-171112,171112,1,0,8,1,1.25,0.7374594,3
2020-03-13-171112,171112,0,0,9,1,1.5,0.2605404,4
2020-03-14-171112,171112,0,0,1,1,1.0,0.14309397,5
2020-03-15-171112,171112,0,0,1,1,0.25,0.0030750863,6
2020-03-16-171112,171112,3,0,10,4,4.25,0.5448453,0
2020-03-17-171112,171112,11,0,0,15,7.75,0.16711311,1
2020-03-18-171112,171112,10,1,4,25,10.5,0.25779676,2
2020-03-19-171112,171112,10,0,3,35,12.5,0.3298521,3
2020-03-20-171112,171112,16,1,6,51,12.0,0.5558607,4
2020-03-21-171112,171112,4,0,3,55,3.0,0.030530576,5
2020-03-22-171112,171112,0,0,1,55,1.25,0.08639559,6
2020-03-23-171112,171112,19,0,5,74,16.25,0.41969067,0
2020-03-24-171112,171112,9,0,5,83,11.0,0.2603601,1
2020-03-25-171112,171112,10,0,4,93,11.5,0.6075919,2
2020-03-26-171112,171112,8,0,0,101,10.25,0.3668764,3
2020-03-27-171112,171112,9,0,2,110,12.5,0.6959299,4
2020-03-28-171112,171112,1,0,0,111,0.75,0.0036483654,5
2020-03-29-171112,171112,1,0,0,112,2.0,0.015049833,6
2020-03-30-171112,171112,10,0,0,122,10.25,0.6606488,0
2020-03-31-171112,171112,0,0,5,122,9.0,0.06479815,1
2020-04-01-171112,171112,4,1,8,126,6.75,0.7287217,2
2020-04-02-171112,171112,3,0,2,129,5.5,0.26310408,3
2020-04-03-171112,171112,6,0,8,135,3.5,0.21172184,4
2020-04-04-171112,171112,3,0,0,138,1.25,0.08254473,5
2020-04-05-171112,171112,1,0,0,139,0.75,0.08391475,6
2020-04-06-171112,171112,5,0,4,144,7.5,0.56644076,0
2020-04-07-171112,171112,5,2,3,149,7.0,0.05745296,1
2020-04-08-171112,171112,4,1,2,153,4.5,0.28391325,2
2020-04-09-171112,171112,0,0,0,153,3.0,0.044636704,3
2020-04-10-171112,171112,2,0,5,155,2.25,0.014962559,4
2020-04-11-171112,171112,0,1,1,155,0.25,0.14032161,5
2020-04-12-171112,171112,0,0,0,155,3.25,0.034738403,6
2020-04-13-171112,171112,0,0,4,155,6.25,0.12703113,0
2020-04-14-171112,171112,5,0,3,160,5.5,0.05165857,1
2020-04-15-171112,171112,8,1,3,168,5.0,0.14283982,2
2020-04-16-171112,171112,2,0,4,170,2.75,0.27680415,3
2020-04-17-171112,171112,8,0,0,178,5.0,0.3294157,4
2020-04-18-171112,171112,0,0,0,178,0.75,0.015114677,5
2020-04-19-171112,171112,0,1,0,178,0.25,0.014362528,6
2020-04-20-171112,171112,4,0,2,182,5.75,0.16540399,0
2020-04-21-171112,171112,3,0,6,185,2.0,0.13576105,1
2020-04-22-171112,171112,2,0,4,187,3.5,0.02996253,2
2020-04-23-171112,171112,0,0,4,187,0.25,0.007264711,3
2020-04-24-171112,171112,5,0,6,192,4.0,0.29977408,4
2020-04-25-171112,171112,1,0,0,193,0.25,0.03326865,5
2020-04-26-171112,171112,0,0,0,193,1.0,0.0015996299,6
2020-04-27-171112,171112,4,0,4,197,6.0,0.8055659,0
2020-04-28-171112,171112,3,0,6,200,5.75,0.29506814,1
2020-04-29-171112,171112,3,0,6,203,6.25,0.20233385,2
2020-04-30-171112,171112,4,0,1,207,6.5,0.6429791,3
2020-05-01-171112,171112,0,0,6,207,1.25,0.025449669,4
2020-05-02-171112,171112,0,0,2,207,0.0,0.03963408,5
2020-05-03-171112,171112,0,0,0,207,0.0,0.0048517836,6
2020-05-04-171112,171112,2,0,2,209,8.0,0.96729934,0
2020-05-05-171112,171112,6,0,1,215,4.75,0.39783397,1
2020-05-06-171112,171112,4,0,3,219,18.0,0.24921158,2
2020-05-07-171112,171112,4,0,1,223,3.0,0.445356,3
2020-05-08-171112,171112,6,0,5,229,6.25,0.26993072,4
2020-05-09-171112,171112,0,0,0,229,0.75,0.121708274,5
2020-05-10-171112,171112,0,1,0,229,0.25,0.0003746682,6
2020-05-11-171112,171112,4,0,2,233,5.75,0.32805863,0
2020-05-12-171112,171112,6,1,6,239,9.75,0.43056196,1
2020-05-13-171112,171112,6,0,3,245,13.25,0.40939227,2
2020-05-14-171112,171112,1,0,0,246,7.0,0.26058623,3
2020-05-15-171112,171112,6,0,3,252,7.0,0.3232206,4
2020-05-16-171112,171112,2,0,0,254,1.0,0.13913909,5
2020-05-17-171112,171112,0,0,0,254,0.25,5.3494783e-05,6
2020-05-18-171112,171112,2,0,0,256,5.25,0.070707604,0
2020-05-19-171112,171112,1,0,2,257,4.5,0.7309884,1
2020-05-20-171112,171112,3,0,2,260,3.0,0.22635314,2
2020-05-21-171112,171112,1,0,0,261,5.75,1.2784289,3
2020-05-22-171112,171112,5,0,2,266,4.25,0.03236816,4
2020-05-23-171112,171112,0,0,0,266,1.5,0.00056600146,5
2020-05-24-171112,171112,0,0,0,266,0.0,0.016319284,6
2020-05-25-171112,171112,2,0,0,268,4.0,0.63051325,0
2020-05-26-171112,171112,6,0,2,274,3.25,0.39249277,1
2020-05-27-171112,171112,3,3,0,277,1.0,0.32627568,2
2020-05-28-171112,171112,0,1,0,277,1.0,0.06198015,3
2020-05-29-171112,171112,3,3,1,280,0.75,0.32756528,4
2020-05-30-171112,171112,0,0,0,280,0.0,0.00014101063,5
2020-05-31-171112,171112,0,0,0,280,0.0,0.00060581596,6
2020-06-01-171112,171112,0,0,2,280,0.0,0.0033422562,0
2020-06-02-171112,171112,2,0,0,282,0.75,0.025748152,1
2020-06-03-171112,171112,2,0,0,284,2.0,0.008308965,2
2020-06-04-171112,171112,0,0,3,284,1.25,0.18884794,3
2020-06-05-171112,171112,2,0,3,286,1.0,0.007833242,4
2020-06-06-171112,171112,0,0,0,286,0.0,0.0318227,5
2020-06-07-171112,171112,0,0,0,286,0.0,0.00013045163,6
2020-06-08-171112,171112,0,0,0,286,2.0,0.6626429,0
2020-06-09-171112,171112,2,0,2,288,1.25,0.1763614,1
2020-06-10-171112,171112,0,0,0,288,0.75,0.09317723,2
2020-06-11-171112,171112,0,0,0,288,0.5,0.5048213,3
2020-06-12-171112,171112,1,0,0,289,0.75,0.03848584,4
2020-06-13-171112,171112,0,0,0,289,0.0,0.00021986247,5
2020-06-14-171112,171112,0,0,0,289,0.25,3.6756457e-05,6
2020-06-15-171112,171112,2,0,0,291,2.0,0.17238984,0
2020-06-16-171112,171112,0,0,0,291,1.25,0.002795603,1
2020-06-17-171112,171112,0,0,0,291,0.5,0.0077814846,2
2020-06-18-171112,171112,3,0,0,294,0.25,0.011671679,3
2020-06-19-171112,171112,3,0,1,297,1.0,0.41736618,4
2020-06-20-171112,171112,0,0,0,297,0.0,0.008899455,5
2020-06-21-171112,171112,0,0,0,297,0.0,0.00020534798,6
2020-06-22-171112,171112,0,0,0,297,0.75,0.0027410067,0
2020-06-23-171112,171112,2,0,0,299,1.0,0.01083786,1
2020-06-24-171112,171112,0,0,0,299,0.75,0.016885662,2
2020-06-25-171112,171112,0,1,1,299,0.5,0.014242224,3
2020-06-26-171112,171112,0,1,0,299,0.75,0.04451046,4
2020-06-27-171112,171112,0,0,0,299,0.25,0.00082572893,5
2020-06-28-171112,171112,0,0,0,299,0.0,0.0037545194,6
2020-06-29-171112,171112,0,0,1,299,0.25,0.005141665,0
2020-06-30-171112,171112,0,0,0,299,0.5,0.010655211,1
2020-07-01-171112,171112,0,0,1,299,0.0,0.0010156707,2
2020-07-02-171112,171112,0,0,0,299,0.75,0.011850236,3
2020-07-03-171112,171112,1,0,2,300,0.5,0.005221131,4
2020-07-04-171112,171112,0,0,0,300,0.0,0.0040685628,5
2020-07-05-171112,171112,0,0,0,300,0.0,0.0012967896,6
2020-07-06-171112,171112,0,0,0,300,0.5,0.17991461,0
2020-07-07-171112,171112,0,0,0,300,0.0,0.00016008533,1
2020-07-08-171112,171112,0,0,0,300,0.0,0.0018768018,2
2020-07-09-171112,171112,1,0,0,301,0.0,0.002001181,3
2020-07-10-171112,171112,0,0,0,301,0.0,0.0748761,4
2020-07-11-171112,171112,0,0,0,301,0.0,0.00017761243,5
2020-07-12-171112,171112,0,0,0,301,0.25,0.0005796573,6
2020-07-13-171112,171112,1,0,0,302,0.0,0.009727895,0
2020-07-14-171112,171112,0,0,0,302,0.0,0.012671182,1
2020-07-15-171112,171112,1,0,0,303,0.0,0.0014273461,2
2020-07-16-171112,171112,0,0,1,303,0.0,0.0050217104,3
2020-07-17-171112,171112,2,0,2,305,0.0,0.005638409,4
2020-07-18-171112,171112,0,0,0,305,0.0,0.01276702,5
2020-07-19-171112,171112,0,0,0,305,0.0,0.00051409425,6
2020-07-20-171112,171112,0,0,2,305,0.0,0.002321908,0
2020-07-21-171112,171112,0,0,1,305,0.0,0.0024338698,1
2020-07-22-171112,171112,0,0,0,305,0.25,0.013344082,2
2020-07-23-171112,171112,0,0,2,305,0.0,0.005791606,3
2020-07-24-171112,171112,0,0,1,305,0.0,0.0068366034,4
2020-07-25-171112,171112,0,0,0,305,0.0,0.00016698228,5
2020-07-26-171112,171112,0,0,0,305,0.0,6.975484e-05,6
2020-07-27-171112,171112,0,0,0,305,0.5,0.17737089,0
2020-07-28-171112,171112,0,0,1,305,0.25,0.0018578201,1
2020-07-29-171112,171112,0,0,4,305,0.0,0.012080725,2
2020-07-30-171112,171112,1,0,1,306,0.25,0.025677878,3
2020-07-31-171112,171112,2,0,3,308,1.75,0.36985174,4
2020-08-01-171112,171112,0,0,0,308,0.5,0.0024846173,5
2020-08-02-171112,171112,0,0,1,308,0.0,0.0030427864,6
2020-08-03-171112,171112,2,0,0,310,1.0,0.05462612,0
2020-08-04-171112,171112,1,0,0,311,0.0,0.0069026123,1
2020-08-05-171112,171112,0,0,1,311,0.0,0.0066895327,2
2020-08-06-171112,171112,2,0,1,313,0.25,0.007099838,3
2020-08-07-171112,171112,1,0,3,314,0.5,0.24608882,4
2020-08-08-171112,171112,0,0,0,314,0.25,0.003874731,5
2020-08-09-171112,171112,0,0,0,314,0.0,0.05677908,6
2020-08-10-171112,171112,0,0,1,314,2.0,0.04892649,0
2020-08-11-171112,171112,1,0,6,315,1.0,0.10716856,1
2020-08-12-171112,171112,4,0,3,319,1.5,0.18598089,2
2020-08-13-171112,171112,1,0,2,320,0.25,1.3829639,3
2020-08-14-171112,171112,3,0,1,323,1.25,0.54012513,4
2020-08-15-171112,171112,0,0,1,323,0.75,0.04095097,5
2020-08-16-171112,171112,1,0,2,324,1.5,0.020498525,6
2020-08-17-171112,171112,0,0,2,324,1.0,0.083164245,0
2020-08-18-171112,171112,0,0,2,324,6.5,1.6679599,1
2020-08-19-171112,171112,1,0,2,325,0.5,0.03395524,2
2020-08-20-171112,171112,1,0,2,326,1.5,0.049147464,3
2020-08-21-171112,171112,3,0,1,329,1.25,0.24796858,4
2020-08-22-171112,171112,0,0,5,329,0.25,0.084975235,5
2020-08-23-171112,171112,0,0,2,329,0.0,0.027357174,6
2020-08-24-171112,171112,1,0,2,330,2.75,0.5505321,0
2020-08-25-171112,171112,6,0,3,336,1.75,0.067027256,1
2020-08-26-171112,171112,3,0,0,339,0.5,0.2233712,2
2020-08-27-171112,171112,2,0,3,341,2.0,0.15473044,3
2020-08-28-171112,171112,1,0,1,342,1.25,0.21248218,4
2020-08-29-171112,171112,1,0,2,343,0.5,0.21232934,5
2020-08-30-171112,171112,2,0,6,345,1.0,0.012355497,6
2020-08-31-171112,171112,2,0,5,347,2.25,0.061138526,0
2020-09-01-171112,171112,2,0,6,349,2.75,0.8361276,1
2020-09-02-171112,171112,2,0,3,351,4.75,0.58973885,2
2020-09-03-171112,171112,2,0,2,353,1.5,0.058353655,3
2020-09-04-171112,171112,1,0,3,354,4.75,0.6582383,4
2020-09-05-171112,171112,5,0,1,359,2.25,0.039753873,5
2020-09-06-171112,171112,2,0,4,361,3.25,0.1600143,6
2020-09-07-171112,171112,2,0,8,363,1.25,0.2809869,0
2020-09-08-171112,171112,3,0,2,366,6.5,0.658612,1
2020-09-09-171112,171112,0,0,6,366,0.25,0.067648575,2
2020-09-10-171112,171112,3,0,1,369,8.75,1.135417,3
2020-09-11-171112,171112,1,0,2,370,1.25,0.6903375,4
2020-09-12-171112,171112,2,0,4,372,3.75,0.20961581,5
2020-09-13-171112,171112,6,1,0,378,0.5,0.14097774,6
2020-09-14-171112,171112,5,0,4,383,4.25,0.9601612,0
2020-09-15-171112,171112,6,0,3,389,2.5,0.65186703,1
2020-09-16-171112,171112,3,0,2,392,3.25,1.2190201,2
2020-09-17-171112,171112,2,0,8,394,7.25,2.4902608,3
2020-09-18-171112,171112,3,0,0,397,9.25,1.8575037,4
2020-09-19-171112,171112,1,0,1,398,2.75,0.13431747,5
2020-09-20-171112,171112,4,1,0,402,4.5,0.23409638,6
2020-09-21-171112,171112,8,0,3,410,3.75,0.5399376,0
2020-09-22-171112,171112,2,1,3,412,1.5,0.166297,1
2020-09-23-171112,171112,6,0,0,418,6.0,0.6124869,2
2020-09-24-171112,171112,1,0,0,419,4.75,0.81201684,3
2020-09-25-171112,171112,2,0,0,421,5.25,0.47235996,4
2020-09-26-171112,171112,4,0,0,425,3.25,0.3152596,5
2020-09-27-171112,171112,0,0,0,425,4.0,1.1982753,6
2020-09-28-171112,171112,4,0,0,429,1.25,0.14902765,0
2020-09-29-171112,171112,3,0,3,432,1.25,0.12097129,1
2020-09-30-171112,171112,2,0,2,434,5.75,0.42807883,2
2020-10-01-171112,171112,8,0,3,442,5.25,0.32903975,3
2020-10-02-171112,171112,0,0,7,442,4.75,0.81140053,4
2020-10-03-171112,171112,1,0,1,443,0.75,0.42026427,5
2020-10-04-171112,171112,0,0,2,443,0.5,0.05914823,6
2020-10-05-171112,171112,3,0,4,446,3.0,0.18226781,0
2020-10-06-171112,171112,3,0,11,449,4.25,1.6108804,1
2020-10-07-171112,171112,0,0,3,449,4.0,0.4637473,2
2020-10-08-171112,171112,0,0,4,449,2.25,0.61475873,3
2020-10-09-171112,171112,0,4,13,449,4.75,0.6879335,4
2020-10-10-171112,171112,0,0,12,449,1.0,0.5392321,5
2020-10-11-171112,171112,0,0,4,449,2.75,0.6419176,6
2020-10-12-171112,171112,0,0,5,449,2.25,0.20149566,0
2020-10-13-171112,171112,3,0,11,452,2.5,0.27293885,1
2020-10-14-171112,171112,2,0,4,454,6.0,2.7724369,2
2020-10-15-171112,171112,3,0,4,457,4.75,1.4623747,3
2020-10-16-171112,171112,7,0,12,464,14.5,7.463727,4
2020-10-17-171112,171112,1,0,0,465,2.0,0.5710043,5
2020-10-18-171112,171112,2,0,5,467,2.75,0.6492557,6
2020-10-19-171112,171112,4,1,4,471,12.25,0.8671932,0
2020-10-20-171112,171112,11,0,7,482,11.0,3.4833694,1
2020-10-21-171112,171112,3,1,10,485,9.25,1.2651019,2
2020-10-22-171112,171112,4,0,10,489,14.5,2.1667097,3
2020-10-23-171112,171112,13,0,16,502,16.75,2.9588094,4
2020-10-24-171112,171112,12,0,4,514,5.75,0.53074956,5
2020-10-25-171112,171112,4,0,4,518,1.0,0.42489934,6
2020-10-26-171112,171112,5,0,11,523,18.5,2.508711,0
2020-10-27-171112,171112,11,0,10,534,9.0,0.9990398,1
2020-10-28-171112,171112,4,0,8,538,10.75,1.6378784,2
2020-10-29-171112,171112,4,0,4,542,10.75,2.4942796,3
2020-10-30-171112,171112,12,0,8,554,26.5,5.806248,4
2020-10-31-171112,171112,0,0,0,554,3.0,0.4740059,5
2020-11-01-171112,171112,5,2,0,559,5.0,0.45056748,6
2020-11-02-171112,171112,4,0,0,563,3.5,0.6538268,0
2020-11-03-171112,171112,7,0,0,570,13.25,2.2473078,1
2020-11-04-171112,171112,10,0,0,580,15.5,3.2989986,2
2020-11-05-171112,171112,10,0,0,590,15.25,3.3633802,3
2020-11-06-171112,171112,16,1,0,606,31.0,8.381042,4
2020-11-07-171112,171112,4,0,0,610,6.25,0.2197327,5
2020-11-08-171112,171112,4,0,0,614,4.75,0.31418145,6
2020-11-09-171112,171112,11,0,0,625,20.25,3.1729922,0
2020-11-10-171112,171112,10,0,0,635,20.75,1.4097013,1
2020-11-11-171112,171112,8,1,0,643,10.5,2.3509316,2
2020-11-12-171112,171112,4,0,0,647,12.5,1.3850548,3
2020-11-13-171112,171112,8,1,0,655,28.0,0.56814945,4
2020-03-01-171113,171113,0,0,0,0,0.0,0.0015683613,6
2020-03-02-171113,171113,0,1,2,0,0.16666666666666666,0.065691195,0
2020-03-03-171113,171113,0,0,1,0,0.0,0.0019057303,1
2020-03-04-171113,171113,0,0,6,0,0.0,0.0028887494,2
2020-03-05-171113,171113,0,0,6,0,0.0,0.001104701,3
2020-03-06-171113,171113,0,0,4,0,0.0,0.000617255,4
2020-03-07-171113,171113,0,0,4,0,0.16666666666666666,0.07167827,5
2020-03-08-171113,171113,0,0,4,0,0.0,0.0016274578,6
2020-03-09-171113,171113,0,0,5,0,0.16666666666666666,0.08317418,0
2020-03-10-171113,171113,0,0,5,0,0.0,0.0045853155,1
2020-03-11-171113,171113,1,0,4,1,0.8333333333333334,0.3042254,2
2020-03-12-171113,171113,0,0,2,1,0.5,0.23094937,3
2020-03-13-171113,171113,2,0,8,3,0.6666666666666666,0.46650794,4
2020-03-14-171113,171113,0,0,2,3,0.16666666666666666,0.074374005,5
2020-03-15-171113,171113,0,0,0,3,0.5,0.03167532,6
2020-03-16-171113,171113,2,0,3,5,1.3333333333333333,0.45177066,0
2020-03-17-171113,171113,1,0,3,6,0.8333333333333334,0.37565473,1
2020-03-18-171113,171113,6,0,2,12,1.6666666666666667,0.74522835,2
2020-03-19-171113,171113,6,0,1,18,1.8333333333333333,0.84894353,3
2020-03-20-171113,171113,4,0,2,22,3.0,0.8172009,4
2020-03-21-171113,171113,4,0,1,26,1.6666666666666667,0.29016796,5
2020-03-22-171113,171113,4,0,0,30,1.8333333333333333,0.2877134,6
2020-03-23-171113,171113,5,0,2,35,6.333333333333332,1.5942289,0
2020-03-24-171113,171113,5,0,2,40,2.5,0.9556646,1
2020-03-25-171113,171113,4,0,1,44,5.0,1.3033569,2
2020-03-26-171113,171113,2,0,0,46,3.333333333333333,0.67618984,3
2020-03-27-171113,171113,8,0,3,54,3.8333333333333335,1.7199365,4
2020-03-28-171113,171113,2,0,0,56,0.16666666666666666,0.20209777,5
2020-03-29-171113,171113,0,0,0,56,0.8333333333333334,0.07915204,6
2020-03-30-171113,171113,3,0,0,59,4.333333333333333,0.91363126,0
2020-03-31-171113,171113,3,0,3,62,1.5,0.52137715,1
2020-04-01-171113,171113,2,0,6,64,3.333333333333333,0.7275641,2
2020-04-02-171113,171113,1,0,3,65,1.8333333333333333,0.46827593,3
2020-04-03-171113,171113,2,0,9,67,1.8333333333333333,0.43827024,4
2020-04-04-171113,171113,1,0,0,68,0.3333333333333333,0.11369384,5
2020-04-05-171113,171113,0,0,1,68,0.5,0.089478046,6
2020-04-06-171113,171113,2,0,2,70,4.666666666666667,1.0362687,0
2020-04-07-171113,171113,2,0,3,72,1.3333333333333333,0.42728564,1
2020-04-08-171113,171113,1,0,5,73,1.3333333333333333,0.37605423,2
2020-04-09-171113,171113,0,0,0,73,1.1666666666666667,0.11583484,3
2020-04-10-171113,171113,3,0,2,76,2.5,0.49666965,4
2020-04-11-171113,171113,0,0,1,76,2.333333333333333,0.2353417,5
2020-04-12-171113,171113,0,0,0,76,0.6666666666666666,0.080041304,6
2020-04-13-171113,171113,0,0,2,76,3.1666666666666665,0.5524837,0
2020-04-14-171113,171113,3,0,2,79,2.0,0.6096581,1
2020-04-15-171113,171113,6,0,1,85,1.6666666666666667,0.81188196,2
2020-04-16-171113,171113,3,0,3,88,1.3333333333333333,0.52320224,3
2020-04-17-171113,171113,9,0,1,97,1.6666666666666667,0.8705465,4
2020-04-18-171113,171113,0,0,0,97,0.5,0.09785452,5
2020-04-19-171113,171113,1,0,2,98,0.16666666666666666,0.070478335,6
2020-04-20-171113,171113,2,0,3,100,1.0,0.3915023,0
2020-04-21-171113,171113,3,0,6,103,2.5,1.0542548,1
2020-04-22-171113,171113,5,0,0,108,0.8333333333333334,0.53902304,2
2020-04-23-171113,171113,0,0,2,108,0.3333333333333333,0.07502474,3
2020-04-24-171113,171113,2,0,1,110,2.6666666666666665,0.6901766,4
2020-04-25-171113,171113,1,0,1,111,0.3333333333333333,0.14160225,5
2020-04-26-171113,171113,0,0,0,111,0.16666666666666666,0.008259521,6
2020-04-27-171113,171113,2,0,2,113,2.5,0.65668,0
2020-04-28-171113,171113,2,1,3,115,0.8333333333333334,0.3731706,1
2020-04-29-171113,171113,1,0,2,116,1.3333333333333333,0.43323576,2
2020-04-30-171113,171113,3,0,0,119,2.0,0.72598314,3
2020-05-01-171113,171113,1,0,0,120,0.0,0.10639919,4
2020-05-02-171113,171113,0,0,0,120,0.16666666666666666,0.04897099,5
2020-05-03-171113,171113,2,0,0,122,0.0,0.17906721,6
2020-05-04-171113,171113,3,0,1,125,4.5,1.2542778,0
2020-05-05-171113,171113,6,0,3,131,1.5,1.137577,1
2020-05-06-171113,171113,0,0,0,131,12.0,1.3432398,2
2020-05-07-171113,171113,2,0,0,133,5.5,1.2439686,3
2020-05-08-171113,171113,1,0,1,134,3.1666666666666665,0.64222467,4
2020-05-09-171113,171113,1,1,0,135,0.5,0.19067037,5
2020-05-10-171113,171113,0,0,0,135,0.0,0.00071097113,6
2020-05-11-171113,171113,2,0,2,137,1.5,0.49228114,0
2020-05-12-171113,171113,3,0,1,140,4.0,0.79872346,1
2020-05-13-171113,171113,2,0,0,142,1.8333333333333333,0.6023031,2
2020-05-14-171113,171113,0,0,2,142,1.1666666666666667,0.23165983,3
2020-05-15-171113,171113,0,0,0,142,2.0,0.3557943,4
2020-05-16-171113,171113,0,0,0,142,0.16666666666666666,0.059633933,5
2020-05-17-171113,171113,0,0,0,142,0.0,5.1177834e-05,6
2020-05-18-171113,171113,1,0,0,143,1.5,0.33200473,0
2020-05-19-171113,171113,3,0,2,146,2.833333333333333,0.7821936,1
2020-05-20-171113,171113,0,0,1,146,2.6666666666666665,0.41481468,2
2020-05-21-171113,171113,0,0,0,146,3.333333333333333,0.73185396,3
2020-05-22-171113,171113,1,0,1,147,1.6666666666666667,0.36065182,4
2020-05-23-171113,171113,0,0,0,147,0.16666666666666666,0.05612972,5
2020-05-24-171113,171113,0,0,0,147,0.0,0.014031874,6
2020-05-25-171113,171113,2,0,1,149,1.0,0.6955416,0
2020-05-26-171113,171113,1,0,0,150,0.6666666666666666,0.4149409,1
2020-05-27-171113,171113,0,3,0,150,0.5,0.14837638,2
2020-05-28-171113,171113,2,0,1,152,2.0,0.5132486,3
2020-05-29-171113,171113,0,0,0,152,0.6666666666666666,0.1703343,4
2020-05-30-171113,171113,0,0,0,152,0.0,0.0026548167,5
2020-05-31-171113,171113,0,0,0,152,0.0,0.0010167044,6
2020-06-01-171113,171113,0,0,0,152,0.0,0.045514252,0
2020-06-02-171113,171113,2,1,0,154,0.6666666666666666,0.4095822,1
2020-06-03-171113,171113,1,0,1,155,0.5,0.16956037,2
2020-06-04-171113,171113,0,0,0,155,1.1666666666666667,0.3152879,3
2020-06-05-171113,171113,1,0,0,156,0.3333333333333333,0.24886471,4
2020-06-06-171113,171113,0,0,0,156,0.16666666666666666,0.035302725,5
2020-06-07-171113,171113,0,0,0,156,0.0,0.00097249466,6
2020-06-08-171113,171113,1,0,0,157,0.6666666666666666,0.3368116,0
2020-06-09-171113,171113,0,0,1,157,0.3333333333333333,0.08377415,1
2020-06-10-171113,171113,0,0,0,157,0.3333333333333333,0.10648492,2
2020-06-11-171113,171113,1,0,2,158,0.5,0.37588176,3
2020-06-12-171113,171113,0,0,0,158,0.3333333333333333,0.13271615,4
2020-06-13-171113,171113,0,3,0,158,0.0,0.0008500955,5
2020-06-14-171113,171113,0,1,0,158,0.0,2.668387e-05,6
2020-06-15-171113,171113,0,2,0,158,0.5,0.07243545,0
2020-06-16-171113,171113,0,0,0,158,0.0,0.030684516,1
2020-06-17-171113,171113,1,0,0,159,0.0,0.12304778,2
2020-06-18-171113,171113,0,0,0,159,0.0,0.034177344,3
2020-06-19-171113,171113,0,0,0,159,0.6666666666666666,0.33119822,4
2020-06-20-171113,171113,0,0,1,159,0.0,0.010553505,5
2020-06-21-171113,171113,0,0,0,159,0.0,0.000959164,6
2020-06-22-171113,171113,0,0,0,159,0.3333333333333333,0.027529819,0
2020-06-23-171113,171113,1,0,0,160,0.0,0.14031833,1
2020-06-24-171113,171113,0,0,0,160,0.16666666666666666,0.10589623,2
2020-06-25-171113,171113,2,0,0,162,0.16666666666666666,0.23976111,3
2020-06-26-171113,171113,0,0,2,162,0.16666666666666666,0.051708117,4
2020-06-27-171113,171113,0,0,0,162,0.0,0.005645684,5
2020-06-28-171113,171113,0,0,0,162,0.16666666666666666,0.18195993,6
2020-06-29-171113,171113,0,0,2,162,0.0,0.12295427,0
2020-06-30-171113,171113,0,0,3,162,0.3333333333333333,0.10153826,1
2020-07-01-171113,171113,0,0,0,162,0.0,0.008242582,2
2020-07-02-171113,171113,0,0,1,162,0.0,0.023193318,3
2020-07-03-171113,171113,0,0,1,162,0.0,0.01706418,4
2020-07-04-171113,171113,1,0,0,163,0.0,0.12590656,5
2020-07-05-171113,171113,0,0,0,163,0.16666666666666666,0.075109504,6
2020-07-06-171113,171113,0,0,0,163,0.16666666666666666,0.07211266,0
2020-07-07-171113,171113,0,0,0,163,0.0,0.0031056725,1
2020-07-08-171113,171113,0,1,0,163,0.0,0.006208096,2
2020-07-09-171113,171113,0,0,0,163,0.0,0.011475061,3
2020-07-10-171113,171113,2,0,0,165,0.0,0.31536868,4
2020-07-11-171113,171113,0,0,0,165,0.0,0.0025116566,5
2020-07-12-171113,171113,0,0,0,165,0.0,0.004736921,6
2020-07-13-171113,171113,2,0,1,167,0.0,0.28212026,0
2020-07-14-171113,171113,3,0,0,170,0.16666666666666666,0.2717758,1
2020-07-15-171113,171113,0,0,1,170,0.0,0.007469569,2
2020-07-16-171113,171113,1,0,1,171,0.16666666666666666,0.14739189,3
2020-07-17-171113,171113,1,0,0,172,0.0,0.13821909,4
2020-07-18-171113,171113,0,0,0,172,0.16666666666666666,0.06872012,5
2020-07-19-171113,171113,0,0,0,172,0.0,0.0023135832,6
2020-07-20-171113,171113,0,0,1,172,0.0,0.023122542,0
2020-07-21-171113,171113,0,0,0,172,0.0,0.00960442,1
2020-07-22-171113,171113,0,0,0,172,0.16666666666666666,0.07789445,2
2020-07-23-171113,171113,0,0,0,172,0.0,0.011951624,3
2020-07-24-171113,171113,0,0,1,172,0.16666666666666666,0.050703526,4
2020-07-25-171113,171113,0,0,0,172,0.0,0.0006570225,5
2020-07-26-171113,171113,0,0,0,172,0.0,0.0010092475,6
2020-07-27-171113,171113,1,0,0,173,0.16666666666666666,0.2201074,0
2020-07-28-171113,171113,0,0,0,173,0.0,0.012983544,1
2020-07-29-171113,171113,1,0,1,174,0.16666666666666666,0.14669417,2
2020-07-30-171113,171113,1,0,1,175,0.16666666666666666,0.5466554,3
2020-07-31-171113,171113,0,0,0,175,0.5,0.17731623,4
2020-08-01-171113,171113,0,0,0,175,0.0,0.015702976,5
2020-08-02-171113,171113,0,0,0,175,0.0,0.024261959,6
2020-08-03-171113,171113,1,0,0,176,0.5,0.46698874,0
2020-08-04-171113,171113,0,0,0,176,0.16666666666666666,0.054079384,1
2020-08-05-171113,171113,0,0,0,176,0.16666666666666666,0.15748169,2
2020-08-06-171113,171113,0,0,3,176,0.3333333333333333,0.14153565,3
2020-08-07-171113,171113,1,0,1,177,0.8333333333333334,0.675506,4
2020-08-08-171113,171113,0,0,0,177,0.0,0.020261185,5
2020-08-09-171113,171113,0,0,2,177,0.0,0.041374017,6
2020-08-10-171113,171113,0,0,1,177,0.16666666666666666,0.16004375,0
2020-08-11-171113,171113,0,0,1,177,0.5,0.11540559,1
2020-08-12-171113,171113,1,0,0,178,0.6666666666666666,0.20631939,2
2020-08-13-171113,171113,1,0,0,179,0.5,0.9122879,3
2020-08-14-171113,171113,0,1,1,179,0.3333333333333333,0.37777683,4
2020-08-15-171113,171113,0,0,0,179,0.3333333333333333,0.07386689,5
2020-08-16-171113,171113,0,0,0,179,0.16666666666666666,0.063631095,6
2020-08-17-171113,171113,0,0,1,179,0.3333333333333333,0.21747059,0
2020-08-18-171113,171113,0,0,1,179,1.3333333333333333,0.666085,1
2020-08-19-171113,171113,0,0,0,179,0.3333333333333333,0.2242628,2
2020-08-20-171113,171113,3,0,0,182,0.8333333333333334,0.64712715,3
2020-08-21-171113,171113,1,0,0,183,0.3333333333333333,0.57479084,4
2020-08-22-171113,171113,0,0,0,183,0.0,0.07656731,5
2020-08-23-171113,171113,2,0,0,185,0.0,0.17840572,6
2020-08-24-171113,171113,1,0,0,186,1.1666666666666667,0.7096832,0
2020-08-25-171113,171113,1,0,0,187,0.3333333333333333,0.31816387,1
2020-08-26-171113,171113,0,0,0,187,0.6666666666666666,0.41968662,2
2020-08-27-171113,171113,0,0,2,187,1.1666666666666667,0.59747875,3
2020-08-28-171113,171113,1,0,0,188,0.8333333333333334,0.7209532,4
2020-08-29-171113,171113,0,0,0,188,0.16666666666666666,0.13809085,5
2020-08-30-171113,171113,0,0,0,188,0.0,0.077700265,6
2020-08-31-171113,171113,1,0,0,189,1.1666666666666667,0.6870467,0
2020-09-01-171113,171113,1,0,0,190,1.1666666666666667,0.56265503,1
2020-09-02-171113,171113,0,0,0,190,1.0,0.40941057,2
2020-09-03-171113,171113,0,0,0,190,0.0,0.24381705,3
2020-09-04-171113,171113,0,0,1,190,1.6666666666666667,0.48499203,4
2020-09-05-171113,171113,0,0,4,190,0.3333333333333333,0.1392546,5
2020-09-06-171113,171113,0,0,4,190,0.3333333333333333,0.13084128,6
2020-09-07-171113,171113,0,0,0,190,0.6666666666666666,0.45115763,0
2020-09-08-171113,171113,0,0,0,190,1.8333333333333333,0.68727857,1
2020-09-09-171113,171113,0,0,0,190,0.6666666666666666,0.17059958,2
2020-09-10-171113,171113,2,0,1,192,1.1666666666666667,0.8661175,3
2020-09-11-171113,171113,0,0,0,192,0.8333333333333334,0.9194735,4
2020-09-12-171113,171113,0,0,2,192,0.16666666666666666,0.2221982,5
2020-09-13-171113,171113,0,0,0,192,0.5,0.28779915,6
2020-09-14-171113,171113,0,0,1,192,1.6666666666666667,0.7872963,0
2020-09-15-171113,171113,0,0,0,192,1.0,0.5536839,1
2020-09-16-171113,171113,0,0,0,192,1.0,0.94307584,2
2020-09-17-171113,171113,0,0,0,192,0.6666666666666666,1.123342,3
2020-09-18-171113,171113,1,0,2,193,2.833333333333333,1.4063504,4
2020-09-19-171113,171113,4,0,0,197,0.3333333333333333,0.81959456,5
2020-09-20-171113,171113,4,1,1,201,0.5,0.58766556,6
2020-09-21-171113,171113,0,0,2,201,5.5,2.0271804,0
2020-09-22-171113,171113,0,1,3,201,0.6666666666666666,0.34516764,1
2020-09-23-171113,171113,0,0,1,201,1.5,0.82674086,2
2020-09-24-171113,171113,1,0,4,202,2.833333333333333,1.3905716,3
2020-09-25-171113,171113,0,0,1,202,5.166666666666667,0.8047967,4
2020-09-26-171113,171113,2,0,3,204,2.833333333333333,0.88207185,5
2020-09-27-171113,171113,0,0,1,204,2.1666666666666665,0.6596794,6
2020-09-28-171113,171113,1,0,0,205,2.1666666666666665,0.60693336,0
2020-09-29-171113,171113,0,0,1,205,2.833333333333333,0.59777015,1
2020-09-30-171113,171113,0,0,7,205,2.6666666666666665,0.92570865,2
2020-10-01-171113,171113,0,0,5,205,1.5,0.8362514,3
2020-10-02-171113,171113,2,0,5,207,2.333333333333333,1.011044,4
2020-10-03-171113,171113,0,0,5,207,2.833333333333333,0.90798324,5
2020-10-04-171113,171113,1,1,1,208,1.3333333333333333,0.32486388,6
2020-10-05-171113,171113,2,0,6,210,1.1666666666666667,0.7620376,0
2020-10-06-171113,171113,3,1,8,213,3.8333333333333335,1.2092499,1
2020-10-07-171113,171113,1,1,1,214,1.5,0.89951766,2
2020-10-08-171113,171113,4,0,1,218,2.0,1.0495256,3
2020-10-09-171113,171113,1,1,6,219,2.333333333333333,0.9356073,4
2020-10-10-171113,171113,3,0,2,222,1.5,0.7829068,5
2020-10-11-171113,171113,1,0,1,223,0.8333333333333334,0.3904534,6
2020-10-12-171113,171113,0,0,3,223,0.3333333333333333,0.23457633,0
2020-10-13-171113,171113,1,0,11,224,1.6666666666666667,0.7571793,1
2020-10-14-171113,171113,7,0,5,231,1.0,1.6716831,2
2020-10-15-171113,171113,5,0,7,236,1.6666666666666667,1.7350487,3
2020-10-16-171113,171113,5,0,5,241,4.666666666666667,3.6116445,4
2020-10-17-171113,171113,5,0,2,246,1.1666666666666667,0.79471475,5
2020-10-18-171113,171113,1,0,2,247,1.1666666666666667,0.67998093,6
2020-10-19-171113,171113,6,0,0,253,2.333333333333333,1.2591069,0
2020-10-20-171113,171113,8,0,2,261,6.0,2.2428012,1
2020-10-21-171113,171113,1,0,4,262,8.666666666666666,2.5087974,2
2020-10-22-171113,171113,1,0,6,263,10.833333333333336,3.968004,3
2020-10-23-171113,171113,6,0,4,269,4.5,2.0582745,4
2020-10-24-171113,171113,2,0,5,271,1.6666666666666667,0.52087325,5
2020-10-25-171113,171113,1,0,2,272,0.8333333333333334,0.31477955,6
2020-10-26-171113,171113,3,0,0,275,6.5,1.5600904,0
2020-10-27-171113,171113,11,0,2,286,1.1666666666666667,1.9380096,1
2020-10-28-171113,171113,5,0,1,291,3.0,1.7027855,2
2020-10-29-171113,171113,7,0,0,298,1.6666666666666667,2.1114933,3
2020-10-30-171113,171113,5,0,4,303,7.5,3.086051,4
2020-10-31-171113,171113,2,0,0,305,2.1666666666666665,0.8756397,5
2020-11-01-171113,171113,2,0,0,307,1.3333333333333333,0.7130995,6
2020-11-02-171113,171113,0,2,0,307,2.0,0.3289467,0
2020-11-03-171113,171113,2,0,0,309,5.5,1.8046542,1
2020-11-04-171113,171113,4,0,0,313,3.8333333333333335,1.7159572,2
2020-11-05-171113,171113,6,0,0,319,3.6666666666666665,2.4866982,3
2020-11-06-171113,171113,4,0,0,323,8.333333333333334,3.452781,4
2020-11-07-171113,171113,5,0,0,328,1.0,0.5924604,5
2020-11-08-171113,171113,2,0,0,330,0.5,0.33272052,6
2020-11-09-171113,171113,0,0,0,330,3.1666666666666665,1.0982983,0
2020-11-10-171113,171113,2,0,0,332,3.0,1.0973909,1
2020-11-11-171113,171113,1,1,0,333,2.0,1.1927444,2
2020-11-12-171113,171113,0,1,0,333,2.0,0.89697856,3
2020-11-13-171113,171113,4,0,0,337,1.3333333333333333,0.76664484,4
2020-03-01-171114,171114,0,0,0,0,0.0,0.00021280037,6
2020-03-02-171114,171114,0,0,1,0,0.0,0.0024115436,0
2020-03-03-171114,171114,0,0,5,0,0.0,0.00018641903,1
2020-03-04-171114,171114,0,1,2,0,0.0,0.0042707347,2
2020-03-05-171114,171114,0,0,2,0,0.0,5.602182e-05,3
2020-03-06-171114,171114,0,0,2,0,0.0,9.436326e-05,4
2020-03-07-171114,171114,0,0,0,0,0.3333333333333333,0.041031513,5
2020-03-08-171114,171114,0,0,0,0,0.0,5.6152865e-05,6
2020-03-09-171114,171114,1,0,2,1,0.0,0.089462906,0
2020-03-10-171114,171114,1,0,2,2,0.0,0.08787791,1
2020-03-11-171114,171114,0,0,1,2,0.0,0.0066900356,2
2020-03-12-171114,171114,0,0,3,2,0.0,0.016508682,3
2020-03-13-171114,171114,0,0,2,2,0.3333333333333333,0.06690221,4
2020-03-14-171114,171114,0,0,2,2,0.3333333333333333,0.042796493,5
2020-03-15-171114,171114,0,0,0,2,0.0,0.00054093543,6
2020-03-16-171114,171114,1,0,0,3,0.0,0.09314947,0
2020-03-17-171114,171114,5,1,2,8,0.3333333333333333,0.42394078,1
2020-03-18-171114,171114,2,1,0,10,0.0,0.19177534,2
2020-03-19-171114,171114,2,0,4,12,0.0,0.18176697,3
2020-03-20-171114,171114,2,0,1,14,0.3333333333333333,0.18844274,4
2020-03-21-171114,171114,0,0,0,14,0.6666666666666666,0.033363435,5
2020-03-22-171114,171114,0,0,0,14,0.0,0.0024241842,6
2020-03-23-171114,171114,2,0,2,16,0.3333333333333333,0.1360554,0
2020-03-24-171114,171114,2,0,3,18,0.0,0.1281071,1
2020-03-25-171114,171114,1,0,1,19,1.0,0.11962937,2
2020-03-26-171114,171114,3,0,1,22,0.0,0.16649625,3
2020-03-27-171114,171114,2,0,0,24,0.0,0.11582435,4
2020-03-28-171114,171114,2,0,0,26,0.0,0.08309888,5
2020-03-29-171114,171114,0,0,0,26,0.0,0.00505088,6
2020-03-30-171114,171114,0,0,0,26,0.0,0.021495452,0
2020-03-31-171114,171114,2,0,2,28,0.0,0.12614803,1
2020-04-01-171114,171114,0,0,1,28,1.6666666666666667,0.186295,2
2020-04-02-171114,171114,4,0,1,32,1.0,0.24361134,3
2020-04-03-171114,171114,1,0,1,33,1.6666666666666667,0.2543667,4
2020-04-04-171114,171114,0,0,0,33,0.3333333333333333,0.041713245,5
2020-04-05-171114,171114,0,0,0,33,0.0,0.0017834948,6
2020-04-06-171114,171114,2,0,0,35,0.0,0.10361959,0
2020-04-07-171114,171114,3,0,0,38,0.3333333333333333,0.13892536,1
2020-04-08-171114,171114,1,0,3,39,0.0,0.07569566,2
2020-04-09-171114,171114,1,0,2,40,0.0,0.055234388,3
2020-04-10-171114,171114,0,0,2,40,0.0,0.005351137,4
2020-04-11-171114,171114,0,0,1,40,0.0,0.0034959125,5
2020-04-12-171114,171114,0,1,0,40,0.0,0.0020958628,6
2020-04-13-171114,171114,0,0,0,40,0.6666666666666666,0.01374464,0
2020-04-14-171114,171114,2,0,3,42,0.0,0.1447493,1
2020-04-15-171114,171114,1,0,5,43,0.0,0.08456968,2
2020-04-16-171114,171114,1,0,2,44,0.0,0.097692974,3
2020-04-17-171114,171114,1,0,1,45,0.3333333333333333,0.14672244,4
2020-04-18-171114,171114,0,0,0,45,0.0,0.002401282,5
2020-04-19-171114,171114,0,1,0,45,0.0,0.0033446795,6
2020-04-20-171114,171114,0,0,0,45,0.0,0.013637792,0
2020-04-21-171114,171114,0,0,0,45,0.0,0.052237358,1
2020-04-22-171114,171114,3,0,1,48,0.0,0.21314356,2
2020-04-23-171114,171114,2,0,1,50,0.0,0.15945818,3
2020-04-24-171114,171114,2,0,1,52,0.0,0.21870345,4
2020-04-25-171114,171114,1,0,0,53,0.0,0.0703947,5
2020-04-26-171114,171114,0,0,1,53,0.0,0.00057193625,6
2020-04-27-171114,171114,0,0,0,53,0.0,0.02119786,0
2020-04-28-171114,171114,3,0,2,56,0.3333333333333333,0.25307834,1
2020-04-29-171114,171114,5,0,0,61,0.0,0.5221168,2
2020-04-30-171114,171114,2,0,0,63,0.0,0.21090885,3
2020-05-01-171114,171114,1,0,4,64,0.0,0.06990869,4
2020-05-02-171114,171114,0,0,0,64,0.0,0.0013238573,5
2020-05-03-171114,171114,0,0,0,64,0.0,0.00019551834,6
2020-05-04-171114,171114,0,0,1,64,0.0,0.023792733,0
2020-05-05-171114,171114,0,0,2,64,0.0,0.023437548,1
2020-05-06-171114,171114,1,0,0,65,0.3333333333333333,0.19538704,2
2020-05-07-171114,171114,1,0,0,66,0.0,0.1694961,3
2020-05-08-171114,171114,1,0,0,67,0.0,0.020804595,4
2020-05-09-171114,171114,0,0,0,67,0.0,0.0032461323,5
2020-05-10-171114,171114,1,0,0,68,0.6666666666666666,0.072547,6
2020-05-11-171114,171114,0,0,1,68,0.0,0.027259938,0
2020-05-12-171114,171114,2,0,1,70,0.0,0.27233613,1
2020-05-13-171114,171114,0,1,0,70,0.0,0.040917873,2
2020-05-14-171114,171114,0,0,0,70,0.0,0.030801572,3
2020-05-15-171114,171114,4,0,1,74,0.3333333333333333,0.44584462,4
2020-05-16-171114,171114,0,0,0,74,0.0,0.0013798729,5
2020-05-17-171114,171114,0,0,1,74,0.0,0.00013035623,6
2020-05-18-171114,171114,1,0,0,75,0.3333333333333333,0.1949965,0
2020-05-19-171114,171114,2,0,2,77,0.0,0.27236113,1
2020-05-20-171114,171114,0,0,0,77,0.0,0.02295526,2
2020-05-21-171114,171114,0,0,0,77,0.0,0.033254657,3
2020-05-22-171114,171114,0,0,0,77,0.0,0.017010244,4
2020-05-23-171114,171114,0,1,0,77,0.0,2.3190194e-05,5
2020-05-24-171114,171114,0,0,0,77,0.0,0.0004981137,6
2020-05-25-171114,171114,1,0,0,78,0.3333333333333333,0.13571477,0
2020-05-26-171114,171114,1,0,0,79,0.0,0.27203518,1
2020-05-27-171114,171114,0,6,1,79,0.0,0.014836548,2
2020-05-28-171114,171114,0,3,0,79,0.0,0.023752056,3
2020-05-29-171114,171114,1,0,0,80,0.0,0.13928041,4
2020-05-30-171114,171114,0,0,0,80,0.0,2.990364e-05,5
2020-05-31-171114,171114,1,0,0,81,0.0,0.110524096,6
2020-06-01-171114,171114,0,0,0,81,0.0,0.010158023,0
2020-06-02-171114,171114,2,0,0,83,0.0,0.34070066,1
2020-06-03-171114,171114,0,2,0,83,0.0,0.008113843,2
2020-06-04-171114,171114,0,0,0,83,0.0,0.026678715,3
2020-06-05-171114,171114,0,0,0,83,0.0,0.008842217,4
2020-06-06-171114,171114,0,0,0,83,0.0,0.0039396016,5
2020-06-07-171114,171114,0,0,0,83,0.0,3.5889123e-05,6
2020-06-08-171114,171114,0,0,0,83,0.0,0.015375147,0
2020-06-09-171114,171114,0,1,0,83,0.0,0.010184183,1
2020-06-10-171114,171114,1,0,0,84,0.0,0.010778861,2
2020-06-11-171114,171114,0,0,0,84,0.0,0.017783022,3
2020-06-12-171114,171114,0,0,0,84,0.0,0.011270428,4
2020-06-13-171114,171114,0,0,0,84,0.0,1.8267938e-05,5
2020-06-14-171114,171114,0,0,0,84,0.0,4.560859e-05,6
2020-06-15-171114,171114,0,0,0,84,0.0,0.007464179,0
2020-06-16-171114,171114,0,0,0,84,0.3333333333333333,0.0034540794,1
2020-06-17-171114,171114,0,0,0,84,0.0,0.006453982,2
2020-06-18-171114,171114,0,0,0,84,0.0,0.00736464,3
2020-06-19-171114,171114,0,0,0,84,0.0,0.016545108,4
2020-06-20-171114,171114,0,0,0,84,0.0,0.0003161385,5
2020-06-21-171114,171114,0,0,0,84,0.0,2.0808955e-05,6
2020-06-22-171114,171114,0,0,0,84,0.0,0.00415943,0
2020-06-23-171114,171114,0,0,0,84,0.0,0.037018515,1
2020-06-24-171114,171114,0,0,1,84,0.0,0.0092815785,2
2020-06-25-171114,171114,0,0,0,84,0.0,0.003914041,3
2020-06-26-171114,171114,0,0,0,84,0.0,0.014022195,4
2020-06-27-171114,171114,0,0,0,84,0.0,0.0045588175,5
2020-06-28-171114,171114,0,0,0,84,0.0,0.0015432255,6
2020-06-29-171114,171114,0,0,0,84,0.0,0.006567426,0
2020-06-30-171114,171114,0,0,0,84,0.0,0.00774221,1
2020-07-01-171114,171114,0,0,0,84,0.0,0.0015924342,2
2020-07-02-171114,171114,0,0,0,84,0.0,0.0047569326,3
2020-07-03-171114,171114,0,0,0,84,0.0,0.016004553,4
2020-07-04-171114,171114,0,0,0,84,0.0,0.00091079983,5
2020-07-05-171114,171114,0,0,0,84,0.0,0.00054846896,6
2020-07-06-171114,171114,0,0,0,84,0.0,0.013452435,0
2020-07-07-171114,171114,0,0,0,84,0.0,0.0013922281,1
2020-07-08-171114,171114,1,0,0,85,0.0,0.18044432,2
2020-07-09-171114,171114,0,0,0,85,0.0,0.006322192,3
2020-07-10-171114,171114,0,0,0,85,0.0,0.029132716,4
2020-07-11-171114,171114,0,0,0,85,0.0,0.0015693923,5
2020-07-12-171114,171114,0,0,0,85,0.0,0.0013136489,6
2020-07-13-171114,171114,0,0,0,85,0.0,0.0026949146,0
2020-07-14-171114,171114,0,0,0,85,0.0,0.0013723846,1
2020-07-15-171114,171114,0,0,0,85,0.0,0.0011793921,2
2020-07-16-171114,171114,0,0,0,85,0.0,0.0059349,3
2020-07-17-171114,171114,0,0,2,85,0.0,0.005555106,4
2020-07-18-171114,171114,0,0,0,85,0.0,0.0040552407,5
2020-07-19-171114,171114,0,0,1,85,0.0,0.0015654892,6
2020-07-20-171114,171114,0,0,0,85,0.0,0.01081726,0
2020-07-21-171114,171114,0,0,0,85,0.0,0.0036656111,1
2020-07-22-171114,171114,0,0,1,85,0.0,0.002471203,2
2020-07-23-171114,171114,0,0,0,85,0.0,0.012929378,3
2020-07-24-171114,171114,0,0,0,85,0.0,0.0070972424,4
2020-07-25-171114,171114,0,0,1,85,0.0,0.000668612,5
2020-07-26-171114,171114,0,0,0,85,0.0,0.0008991788,6
2020-07-27-171114,171114,0,0,0,85,0.0,0.010150551,0
2020-07-28-171114,171114,0,0,0,85,0.0,0.010274725,1
2020-07-29-171114,171114,0,0,1,85,0.0,0.010372266,2
2020-07-30-171114,171114,0,0,0,85,0.3333333333333333,0.110267155,3
2020-07-31-171114,171114,2,0,1,87,0.0,0.2561613,4
2020-08-01-171114,171114,0,1,0,87,0.0,0.2583202,5
2020-08-02-171114,171114,1,0,1,88,0.0,0.25215822,6
2020-08-03-171114,171114,0,0,0,88,0.0,0.027785525,0
2020-08-04-171114,171114,0,0,0,88,0.0,0.005077377,1
2020-08-05-171114,171114,1,0,0,89,0.0,0.026364006,2
2020-08-06-171114,171114,0,0,0,89,0.0,0.025351228,3
2020-08-07-171114,171114,0,0,0,89,0.0,0.51409155,4
2020-08-08-171114,171114,1,0,1,90,0.0,0.28654143,5
2020-08-09-171114,171114,0,0,0,90,2.0,2.467385,6
2020-08-10-171114,171114,0,0,0,90,0.0,0.02540312,0
2020-08-11-171114,171114,0,0,0,90,0.0,0.47450337,1
2020-08-12-171114,171114,1,0,1,91,0.0,0.26303864,2
2020-08-13-171114,171114,0,0,0,91,0.0,0.107140064,3
2020-08-14-171114,171114,1,0,1,92,0.0,0.3416498,4
2020-08-15-171114,171114,0,0,0,92,0.0,0.08442983,5
2020-08-16-171114,171114,1,0,1,93,0.6666666666666666,0.48539555,6
2020-08-17-171114,171114,0,0,0,93,0.0,0.050634656,0
2020-08-18-171114,171114,0,0,1,93,0.0,0.092582345,1
2020-08-19-171114,171114,0,0,1,93,0.0,0.62836516,2
2020-08-20-171114,171114,0,0,50,93,0.3333333333333333,0.84645045,3
2020-08-21-171114,171114,0,0,12,93,0.0,2.3131652,4
2020-08-22-171114,171114,1,0,3,94,1.0,0.98332673,5
2020-08-23-171114,171114,0,0,14,94,0.6666666666666666,0.06092517,6
2020-08-24-171114,171114,0,0,8,94,0.3333333333333333,0.6942943,0
2020-08-25-171114,171114,0,0,9,94,0.3333333333333333,0.2833717,1
2020-08-26-171114,171114,1,0,3,95,0.0,0.33035517,2
2020-08-27-171114,171114,0,0,15,95,0.6666666666666666,0.06646383,3
2020-08-28-171114,171114,1,0,4,96,0.0,0.38723746,4
2020-08-29-171114,171114,0,0,2,96,0.0,0.06221695,5
2020-08-30-171114,171114,1,0,0,97,0.3333333333333333,0.29483926,6
2020-08-31-171114,171114,0,0,1,97,1.3333333333333333,0.42898825,0
2020-09-01-171114,171114,1,0,5,98,0.3333333333333333,0.29974705,1
2020-09-02-171114,171114,1,0,0,99,0.0,0.27093676,2
2020-09-03-171114,171114,50,0,36,149,1.3333333333333333,9.620444,3
2020-09-04-171114,171114,12,0,8,161,0.6666666666666666,2.628533,4
2020-09-05-171114,171114,3,0,0,164,0.0,0.55819637,5
2020-09-06-171114,171114,14,0,1,178,0.3333333333333333,2.1321025,6
2020-09-07-171114,171114,8,0,13,186,0.3333333333333333,1.8269074,0
2020-09-08-171114,171114,9,0,1,195,0.6666666666666666,1.85856,1
2020-09-09-171114,171114,3,0,3,198,1.0,0.8138987,2
2020-09-10-171114,171114,15,0,4,213,1.6666666666666667,1.1687405,3
2020-09-11-171114,171114,4,0,2,217,0.0,1.1291968,4
2020-09-12-171114,171114,2,1,0,219,0.3333333333333333,0.5814572,5
2020-09-13-171114,171114,0,0,0,219,0.0,0.033295576,6
2020-09-14-171114,171114,1,2,0,220,0.0,0.18593504,0
2020-09-15-171114,171114,5,0,1,225,0.0,0.8026663,1
2020-09-16-171114,171114,0,2,2,225,1.3333333333333333,1.1307329,2
2020-09-17-171114,171114,36,0,0,261,0.0,4.572096,3
2020-09-18-171114,171114,8,0,2,269,0.3333333333333333,1.4485239,4
2020-09-19-171114,171114,0,0,1,269,0.0,0.044769645,5
2020-09-20-171114,171114,1,0,0,270,0.3333333333333333,0.17974888,6
2020-09-21-171114,171114,13,1,1,283,0.0,1.5995826,0
2020-09-22-171114,171114,1,0,3,284,2.0,0.9338003,1
2020-09-23-171114,171114,3,0,0,287,0.3333333333333333,0.5913369,2
2020-09-24-171114,171114,4,2,0,291,1.3333333333333333,1.017688,3
2020-09-25-171114,171114,2,0,4,293,0.6666666666666666,0.49637967,4
2020-09-26-171114,171114,0,0,0,293,0.0,0.056941465,5
2020-09-27-171114,171114,0,0,0,293,0.0,0.06787014,6
2020-09-28-171114,171114,0,0,1,293,0.3333333333333333,0.25419763,0
2020-09-29-171114,171114,1,0,1,294,0.6666666666666666,0.23500335,1
2020-09-30-171114,171114,2,0,2,296,0.0,0.26546893,2
2020-10-01-171114,171114,0,1,1,296,0.3333333333333333,0.10206304,3
2020-10-02-171114,171114,2,0,3,298,0.0,0.30689716,4
2020-10-03-171114,171114,1,0,1,299,0.0,0.14149843,5
2020-10-04-171114,171114,0,0,1,299,0.0,0.022471415,6
2020-10-05-171114,171114,1,1,6,300,0.3333333333333333,0.22675572,0
2020-10-06-171114,171114,3,0,3,303,0.3333333333333333,0.6702752,1
2020-10-07-171114,171114,0,0,7,303,0.3333333333333333,0.12505703,2
2020-10-08-171114,171114,0,0,1,303,1.0,0.3454302,3
2020-10-09-171114,171114,4,3,9,307,0.0,1.0682939,4
2020-10-10-171114,171114,0,0,2,307,0.0,0.087851405,5
2020-10-11-171114,171114,0,0,2,307,0.0,0.06607883,6
2020-10-12-171114,171114,1,0,0,308,0.3333333333333333,0.26240474,0
2020-10-13-171114,171114,1,0,2,309,0.3333333333333333,0.16392656,1
2020-10-14-171114,171114,2,0,11,311,0.3333333333333333,0.43173915,2
2020-10-15-171114,171114,1,0,1,312,0.0,0.45904586,3
2020-10-16-171114,171114,3,0,11,315,0.3333333333333333,0.537385,4
2020-10-17-171114,171114,1,0,1,316,0.3333333333333333,0.25655046,5
2020-10-18-171114,171114,1,0,4,317,0.6666666666666666,0.27765355,6
2020-10-19-171114,171114,6,0,3,323,0.3333333333333333,1.1094766,0
2020-10-20-171114,171114,3,0,0,326,0.6666666666666666,0.48125854,1
2020-10-21-171114,171114,7,0,7,333,0.0,1.0503609,2
2020-10-22-171114,171114,1,0,6,334,1.0,0.46957865,3
2020-10-23-171114,171114,9,0,3,343,3.333333333333333,1.8600147,4
2020-10-24-171114,171114,2,0,0,345,0.0,0.29473183,5
2020-10-25-171114,171114,2,0,0,347,1.0,0.38882583,6
2020-10-26-171114,171114,0,1,1,347,1.6666666666666667,0.51391983,0
2020-10-27-171114,171114,2,0,3,349,5.333333333333333,2.1667116,1
2020-10-28-171114,171114,11,0,2,360,1.0,1.7608526,2
2020-10-29-171114,171114,1,0,0,361,0.3333333333333333,0.41087377,3
2020-10-30-171114,171114,11,0,7,372,4.0,2.6162546,4
2020-10-31-171114,171114,1,1,0,373,0.6666666666666666,0.33625153,5
2020-11-01-171114,171114,4,2,0,377,0.3333333333333333,0.6189587,6
2020-11-02-171114,171114,3,0,0,380,0.6666666666666666,0.4997091,0
2020-11-03-171114,171114,0,0,0,380,0.3333333333333333,0.34047395,1
2020-11-04-171114,171114,7,0,0,387,0.3333333333333333,1.2022917,2
2020-11-05-171114,171114,6,0,0,393,0.3333333333333333,1.0464113,3
2020-11-06-171114,171114,3,3,0,396,1.6666666666666667,0.8593776,4
2020-11-07-171114,171114,0,0,0,396,0.0,0.10869223,5
2020-11-08-171114,171114,0,0,0,396,0.3333333333333333,0.059298664,6
2020-11-09-171114,171114,1,0,0,397,1.6666666666666667,0.56482387,0
2020-11-10-171114,171114,3,0,0,400,0.6666666666666666,0.5987288,1
2020-11-11-171114,171114,2,0,0,402,0.3333333333333333,0.55288976,2
2020-11-12-171114,171114,0,0,0,402,0.0,0.18183675,3
2020-11-13-171114,171114,7,1,0,409,0.0,0.99100304,4
2020-03-01-171115,171115,0,0,0,0,0.0,0.00029988712,6
2020-03-02-171115,171115,0,0,0,0,0.14285714285714285,0.07831602,0
2020-03-03-171115,171115,0,0,0,0,0.0,0.0007956868,1
2020-03-04-171115,171115,0,1,1,0,0.0,0.0006957166,2
2020-03-05-171115,171115,0,0,1,0,0.0,0.00038215175,3
2020-03-06-171115,171115,0,0,0,0,0.0,0.00037938854,4
2020-03-07-171115,171115,0,0,1,0,0.2857142857142857,0.1359325,5
2020-03-08-171115,171115,0,0,0,0,0.0,0.0006081439,6
2020-03-09-171115,171115,0,0,2,0,0.2857142857142857,0.14134438,0
2020-03-10-171115,171115,0,0,0,0,0.0,0.0055541126,1
2020-03-11-171115,171115,0,0,2,0,0.5714285714285714,0.22307399,2
2020-03-12-171115,171115,0,0,1,0,1.0,0.4717211,3
2020-03-13-171115,171115,0,0,1,0,0.8571428571428571,0.3275304,4
2020-03-14-171115,171115,0,0,0,0,0.2857142857142857,0.11646229,5
2020-03-15-171115,171115,0,0,1,0,0.2857142857142857,0.049797107,6
2020-03-16-171115,171115,0,3,2,0,1.1428571428571428,0.39608803,0
2020-03-17-171115,171115,0,0,1,0,1.5714285714285714,0.37904006,1
2020-03-18-171115,171115,1,0,0,1,2.571428571428572,0.72051907,2
2020-03-19-171115,171115,1,1,1,2,1.8571428571428568,0.75580686,3
2020-03-20-171115,171115,0,2,1,2,1.2857142857142858,0.37879503,4
2020-03-21-171115,171115,1,0,0,3,0.42857142857142855,0.33430845,5
2020-03-22-171115,171115,0,0,0,3,0.8571428571428571,0.18271413,6
2020-03-23-171115,171115,2,0,1,5,2.7142857142857144,1.6853935,0
2020-03-24-171115,171115,0,0,0,5,1.1428571428571428,0.32640168,1
2020-03-25-171115,171115,2,0,0,7,2.571428571428572,1.121296,2
2020-03-26-171115,171115,1,0,1,8,2.142857142857143,0.58582443,3
2020-03-27-171115,171115,1,0,1,9,2.142857142857143,0.94285834,4
2020-03-28-171115,171115,0,0,0,9,0.2857142857142857,0.02496479,5
2020-03-29-171115,171115,1,0,0,10,1.0,0.30207798,6
2020-03-30-171115,171115,2,0,1,12,2.571428571428572,1.142873,0
2020-03-31-171115,171115,1,0,0,13,1.1428571428571428,0.45144963,1
2020-04-01-171115,171115,0,0,0,13,2.8571428571428568,0.7512917,2
2020-04-02-171115,171115,1,0,6,14,1.0,0.28555152,3
2020-04-03-171115,171115,1,0,0,15,1.4285714285714286,0.5872531,4
2020-04-04-171115,171115,0,0,0,15,0.5714285714285714,0.053572044,5
2020-04-05-171115,171115,0,0,1,15,0.5714285714285714,0.10371998,6
2020-04-06-171115,171115,1,0,2,16,2.2857142857142856,0.87537146,0
2020-04-07-171115,171115,0,0,1,16,0.7142857142857143,0.18319312,1
2020-04-08-171115,171115,0,0,0,16,1.7142857142857142,0.41519508,2
2020-04-09-171115,171115,1,0,1,17,0.5714285714285714,0.50592005,3
2020-04-10-171115,171115,1,0,2,18,0.5714285714285714,0.28689313,4
2020-04-11-171115,171115,0,1,1,18,1.1428571428571428,0.20503052,5
2020-04-12-171115,171115,0,0,0,18,0.7142857142857143,0.13592932,6
2020-04-13-171115,171115,1,0,3,19,0.8571428571428571,0.5582455,0
2020-04-14-171115,171115,0,0,0,19,0.7142857142857143,0.17642352,1
2020-04-15-171115,171115,0,0,0,19,0.7142857142857143,0.19844805,2
2020-04-16-171115,171115,6,0,0,25,2.4285714285714284,2.0603456,3
2020-04-17-171115,171115,0,0,0,25,1.0,0.27743453,4
2020-04-18-171115,171115,0,0,2,25,0.14285714285714285,0.023612732,5
2020-04-19-171115,171115,1,0,1,26,0.14285714285714285,0.21134815,6
2020-04-20-171115,171115,2,0,0,28,1.2857142857142858,0.8235771,0
2020-04-21-171115,171115,1,0,9,29,0.5714285714285714,0.46550426,1
2020-04-22-171115,171115,0,0,2,29,0.14285714285714285,0.07784468,2
2020-04-23-171115,171115,1,0,0,30,0.14285714285714285,0.5224977,3
2020-04-24-171115,171115,2,0,7,32,0.8571428571428571,0.7117305,4
2020-04-25-171115,171115,1,0,0,33,0.2857142857142857,0.3060264,5
2020-04-26-171115,171115,0,0,0,33,0.0,0.00081892003,6
2020-04-27-171115,171115,3,0,1,36,1.1428571428571428,1.286098,0
2020-04-28-171115,171115,0,0,1,36,1.2857142857142858,0.36457217,1
2020-04-29-171115,171115,0,1,2,36,1.4285714285714286,0.34212774,2
2020-04-30-171115,171115,0,0,0,36,1.5714285714285714,0.4980855,3
2020-05-01-171115,171115,0,0,0,36,0.14285714285714285,0.04605204,4
2020-05-02-171115,171115,2,0,0,38,0.42857142857142855,0.61319333,5
2020-05-03-171115,171115,1,0,0,39,0.0,0.19268891,6
2020-05-04-171115,171115,0,0,0,39,2.0,0.66219926,0
2020-05-05-171115,171115,9,0,0,48,0.5714285714285714,2.6403072,1
2020-05-06-171115,171115,2,0,0,50,0.7142857142857143,0.87864685,2
2020-05-07-171115,171115,0,0,0,50,1.4285714285714286,0.48646253,3
2020-05-08-171115,171115,7,0,0,57,0.8571428571428571,2.0251338,4
2020-05-09-171115,171115,0,0,0,57,0.5714285714285714,0.12260157,5
2020-05-10-171115,171115,0,3,0,57,0.0,0.00027242082,6
2020-05-11-171115,171115,1,0,0,58,0.42857142857142855,0.47175652,0
2020-05-12-171115,171115,1,0,0,59,1.1428571428571428,0.76020205,1
2020-05-13-171115,171115,2,0,0,61,1.7142857142857142,1.083521,2
2020-05-14-171115,171115,0,0,0,61,0.8571428571428571,0.20706889,3
2020-05-15-171115,171115,0,0,0,61,1.1428571428571428,0.25912347,4
2020-05-16-171115,171115,0,0,0,61,0.5714285714285714,0.13285725,5
2020-05-17-171115,171115,0,0,0,61,0.0,5.999687e-07,6
2020-05-18-171115,171115,0,0,0,61,0.2857142857142857,0.09665555,0
2020-05-19-171115,171115,0,0,0,61,0.8571428571428571,0.45725173,1
2020-05-20-171115,171115,0,0,0,61,0.42857142857142855,0.18762022,2
2020-05-21-171115,171115,0,0,0,61,1.5714285714285714,0.6680444,3
2020-05-22-171115,171115,0,0,0,61,0.0,0.025343016,4
2020-05-23-171115,171115,0,0,0,61,0.0,0.00025734756,5
2020-05-24-171115,171115,0,0,0,61,0.14285714285714285,0.0333591,6
2020-05-25-171115,171115,0,0,0,61,0.7142857142857143,0.41649246,0
2020-05-26-171115,171115,0,0,0,61,1.2857142857142858,0.50622874,1
2020-05-27-171115,171115,0,0,1,61,0.5714285714285714,0.2700807,2
2020-05-28-171115,171115,0,0,0,61,0.0,0.04700821,3
2020-05-29-171115,171115,0,0,0,61,0.42857142857142855,0.24037813,4
2020-05-30-171115,171115,0,1,0,61,0.0,0.0008331828,5
2020-05-31-171115,171115,0,0,0,61,0.0,0.000115433766,6
2020-06-01-171115,171115,0,0,0,61,0.0,0.021466695,0
2020-06-02-171115,171115,0,0,0,61,0.0,0.02564286,1
2020-06-03-171115,171115,0,0,0,61,0.42857142857142855,0.12660056,2
2020-06-04-171115,171115,0,1,1,61,0.14285714285714285,0.09666611,3
2020-06-05-171115,171115,0,0,0,61,0.14285714285714285,0.06429995,4
2020-06-06-171115,171115,0,0,1,61,0.14285714285714285,0.061795272,5
2020-06-07-171115,171115,0,1,0,61,0.0,0.004214029,6
2020-06-08-171115,171115,0,0,0,61,0.5714285714285714,0.34234655,0
2020-06-09-171115,171115,0,0,0,61,0.14285714285714285,0.088932484,1
2020-06-10-171115,171115,1,0,1,62,0.14285714285714285,0.4706869,2
2020-06-11-171115,171115,0,0,0,62,0.42857142857142855,0.30718014,3
2020-06-12-171115,171115,0,0,0,62,0.42857142857142855,0.07663377,4
2020-06-13-171115,171115,0,0,0,62,0.0,0.0011166702,5
2020-06-14-171115,171115,0,1,0,62,0.0,2.1933668e-07,6
2020-06-15-171115,171115,0,0,0,62,0.2857142857142857,0.08564341,0
2020-06-16-171115,171115,0,0,0,62,0.0,0.011375578,1
2020-06-17-171115,171115,0,0,0,62,0.0,0.014410187,2
2020-06-18-171115,171115,1,0,1,63,0.0,0.39712623,3
2020-06-19-171115,171115,0,0,0,63,0.42857142857142855,0.30330276,4
2020-06-20-171115,171115,1,0,0,64,0.0,0.3490801,5
2020-06-21-171115,171115,0,0,0,64,0.0,0.00044512792,6
2020-06-22-171115,171115,0,0,0,64,0.14285714285714285,0.014751558,0
2020-06-23-171115,171115,0,0,0,64,0.0,0.019841114,1
2020-06-24-171115,171115,1,1,0,65,0.0,0.43511683,2
2020-06-25-171115,171115,0,0,0,65,0.14285714285714285,0.07390019,3
2020-06-26-171115,171115,0,1,0,65,0.2857142857142857,0.06571865,4
2020-06-27-171115,171115,0,0,0,65,0.0,0.001577438,5
2020-06-28-171115,171115,0,0,0,65,0.0,0.009579053,6
2020-06-29-171115,171115,0,0,0,65,0.0,0.018346298,0
2020-06-30-171115,171115,0,0,0,65,0.0,0.011958884,1
2020-07-01-171115,171115,0,0,0,65,0.0,0.004105345,2
2020-07-02-171115,171115,1,0,0,66,0.0,0.41465932,3
2020-07-03-171115,171115,0,0,0,66,0.14285714285714285,0.01840965,4
2020-07-04-171115,171115,0,0,0,66,0.0,0.006358018,5
2020-07-05-171115,171115,0,0,0,66,0.0,0.00091305916,6
2020-07-06-171115,171115,0,0,0,66,0.14285714285714285,0.10268145,0
2020-07-07-171115,171115,0,0,0,66,0.0,0.0010149177,1
2020-07-08-171115,171115,0,0,0,66,0.0,0.0013489464,2
2020-07-09-171115,171115,0,0,0,66,0.0,0.0035342793,3
2020-07-10-171115,171115,0,0,0,66,0.0,0.042911995,4
2020-07-11-171115,171115,0,0,0,66,0.0,0.0007707877,5
2020-07-12-171115,171115,0,0,0,66,0.0,0.00474839,6
2020-07-13-171115,171115,0,0,0,66,0.14285714285714285,0.034305256,0
2020-07-14-171115,171115,0,0,0,66,0.0,0.021011958,1
2020-07-15-171115,171115,0,0,0,66,0.0,0.0010943678,2
2020-07-16-171115,171115,0,0,0,66,0.14285714285714285,0.08130829,3
2020-07-17-171115,171115,0,0,0,66,0.0,0.010652639,4
2020-07-18-171115,171115,0,0,0,66,0.14285714285714285,0.04940276,5
2020-07-19-171115,171115,0,0,0,66,0.0,0.00030042726,6
2020-07-20-171115,171115,0,0,0,66,0.0,0.0044621616,0
2020-07-21-171115,171115,0,0,0,66,0.0,0.0036967932,1
2020-07-22-171115,171115,0,0,0,66,0.14285714285714285,0.049499236,2
2020-07-23-171115,171115,0,0,0,66,0.0,0.004734122,3
2020-07-24-171115,171115,0,0,0,66,0.0,0.004341437,4
2020-07-25-171115,171115,0,0,0,66,0.0,0.002407724,5
2020-07-26-171115,171115,0,0,0,66,0.0,0.00033010947,6
2020-07-27-171115,171115,0,0,0,66,0.14285714285714285,0.11292545,0
2020-07-28-171115,171115,0,0,0,66,0.0,0.012929432,1
2020-07-29-171115,171115,0,0,0,66,0.14285714285714285,0.07369919,2
2020-07-30-171115,171115,0,1,0,66,0.14285714285714285,0.07900242,3
2020-07-31-171115,171115,0,0,0,66,0.2857142857142857,0.23259291,4
2020-08-01-171115,171115,0,0,0,66,0.0,0.014240437,5
2020-08-02-171115,171115,0,0,0,66,0.0,0.011812925,6
2020-08-03-171115,171115,0,0,2,66,0.2857142857142857,0.10845151,0
2020-08-04-171115,171115,0,1,4,66,0.0,0.04224227,1
2020-08-05-171115,171115,0,0,1,66,0.0,0.019145017,2
2020-08-06-171115,171115,0,0,0,66,0.2857142857142857,0.16323966,3
2020-08-07-171115,171115,0,0,1,66,0.8571428571428571,0.4001866,4
2020-08-08-171115,171115,0,0,1,66,0.14285714285714285,0.12434091,5
2020-08-09-171115,171115,0,0,1,66,0.2857142857142857,0.21916516,6
2020-08-10-171115,171115,0,0,0,66,1.7142857142857142,0.3280182,0
2020-08-11-171115,171115,0,0,0,66,0.5714285714285714,0.13605705,1
2020-08-12-171115,171115,0,0,1,66,0.42857142857142855,0.28502542,2
2020-08-13-171115,171115,0,0,0,66,1.5714285714285714,1.6001363,3
2020-08-14-171115,171115,0,0,1,66,0.8571428571428571,0.7874137,4
2020-08-15-171115,171115,0,0,0,66,0.14285714285714285,0.14446168,5
2020-08-16-171115,171115,0,0,0,66,0.2857142857142857,0.69432694,6
2020-08-17-171115,171115,2,0,1,68,0.7142857142857143,1.1837795,0
2020-08-18-171115,171115,4,0,0,72,1.7142857142857142,2.2271838,1
2020-08-19-171115,171115,1,1,1,73,0.0,0.7074827,2
2020-08-20-171115,171115,0,0,0,73,0.5714285714285714,0.1722835,3
2020-08-21-171115,171115,1,0,0,74,0.7142857142857143,1.4261007,4
2020-08-22-171115,171115,1,0,0,75,0.0,0.84116066,5
2020-08-23-171115,171115,1,0,0,76,0.5714285714285714,0.6580408,6
2020-08-24-171115,171115,0,0,9,76,1.0,1.5458679,0
2020-08-25-171115,171115,0,0,2,76,1.0,0.54953367,1
2020-08-26-171115,171115,1,0,1,77,1.0,1.0882951,2
2020-08-27-171115,171115,0,0,1,77,0.2857142857142857,0.21594703,3
2020-08-28-171115,171115,1,0,1,78,0.42857142857142855,0.71349174,4
2020-08-29-171115,171115,0,0,2,78,0.2857142857142857,0.3886471,5
2020-08-30-171115,171115,0,0,7,78,0.0,0.023358552,6
2020-08-31-171115,171115,1,0,0,79,0.5714285714285714,0.16103278,0
2020-09-01-171115,171115,0,0,1,79,1.5714285714285714,0.77529514,1
2020-09-02-171115,171115,1,0,0,80,1.0,0.9144342,2
2020-09-03-171115,171115,0,0,2,80,0.5714285714285714,0.35421064,3
2020-09-04-171115,171115,0,0,5,80,1.2857142857142858,0.93575746,4
2020-09-05-171115,171115,0,0,6,80,0.42857142857142855,0.12660837,5
2020-09-06-171115,171115,0,1,3,80,0.5714285714285714,0.14628474,6
2020-09-07-171115,171115,9,0,0,89,0.5714285714285714,3.3060954,0
2020-09-08-171115,171115,2,0,3,91,1.8571428571428568,1.7714217,1
2020-09-09-171115,171115,1,0,8,92,0.2857142857142857,0.9447373,2
2020-09-10-171115,171115,1,0,10,93,1.1428571428571428,0.9256566,3
2020-09-11-171115,171115,1,0,8,94,0.7142857142857143,1.3165536,4
2020-09-12-171115,171115,2,0,2,96,1.5714285714285714,1.0685263,5
2020-09-13-171115,171115,7,0,1,103,0.14285714285714285,2.7373693,6
2020-09-14-171115,171115,0,0,5,103,1.5714285714285714,1.1192214,0
2020-09-15-171115,171115,1,0,2,104,1.0,0.49335736,1
2020-09-16-171115,171115,0,0,3,104,0.7142857142857143,0.72786903,2
2020-09-17-171115,171115,2,0,6,106,0.8571428571428571,2.8533876,3
2020-09-18-171115,171115,5,0,1,111,2.571428571428572,1.2533154,4
2020-09-19-171115,171115,6,0,3,117,0.14285714285714285,2.2208006,5
2020-09-20-171115,171115,3,0,1,120,1.0,1.2301078,6
2020-09-21-171115,171115,0,0,7,120,5.7142857142857135,1.9787645,0
2020-09-22-171115,171115,3,0,1,123,0.7142857142857143,1.1627548,1
2020-09-23-171115,171115,8,0,0,131,1.2857142857142858,3.377273,2
2020-09-24-171115,171115,10,0,2,141,2.2857142857142856,6.242626,3
2020-09-25-171115,171115,8,0,1,149,2.7142857142857144,4.6282587,4
2020-09-26-171115,171115,2,1,0,151,1.5714285714285714,1.2017944,5
2020-09-27-171115,171115,1,0,0,152,3.0,1.341974,6
2020-09-28-171115,171115,5,1,2,157,0.42857142857142855,1.3718882,0
2020-09-29-171115,171115,2,1,0,159,1.4285714285714286,0.8969515,1
2020-09-30-171115,171115,3,0,0,162,2.142857142857143,1.7942274,2
2020-10-01-171115,171115,6,1,0,168,1.0,2.4963279,3
2020-10-02-171115,171115,1,1,1,169,3.0,0.95782006,4
2020-10-03-171115,171115,3,0,0,172,2.2857142857142856,1.5107319,5
2020-10-04-171115,171115,1,0,0,173,0.42857142857142855,0.5053048,6
2020-10-05-171115,171115,7,1,2,180,0.2857142857142857,2.2659602,0
2020-10-06-171115,171115,1,1,4,181,2.4285714285714284,0.9544136,1
2020-10-07-171115,171115,0,2,0,181,1.5714285714285714,0.4461745,2
2020-10-08-171115,171115,2,0,1,183,0.5714285714285714,1.0570327,3
2020-10-09-171115,171115,1,1,3,184,1.1428571428571428,0.51756716,4
2020-10-10-171115,171115,0,0,1,184,1.1428571428571428,0.45224202,5
2020-10-11-171115,171115,0,0,0,184,0.5714285714285714,0.46571767,6
2020-10-12-171115,171115,2,0,3,186,0.42857142857142855,0.8507265,0
2020-10-13-171115,171115,0,0,1,186,0.8571428571428571,0.32961082,1
2020-10-14-171115,171115,0,0,5,186,1.5714285714285714,1.464819,2
2020-10-15-171115,171115,0,0,1,186,1.8571428571428568,0.9998828,3
2020-10-16-171115,171115,1,0,4,187,3.8571428571428568,3.806857,4
2020-10-17-171115,171115,0,0,0,187,1.2857142857142858,0.5697634,5
2020-10-18-171115,171115,0,0,0,187,1.1428571428571428,0.51216584,6
2020-10-19-171115,171115,2,1,0,189,1.4285714285714286,0.9287171,0
2020-10-20-171115,171115,4,0,2,193,4.857142857142857,2.5270715,1
2020-10-21-171115,171115,0,1,7,193,7.142857142857142,2.13536,2
2020-10-22-171115,171115,1,0,5,194,8.0,2.7350585,3
2020-10-23-171115,171115,3,0,12,197,3.571428571428572,2.6775522,4
2020-10-24-171115,171115,1,1,1,198,2.0,0.90004575,5
2020-10-25-171115,171115,0,1,2,198,2.571428571428572,0.58851665,6
2020-10-26-171115,171115,3,1,2,201,4.0,2.2366207,0
2020-10-27-171115,171115,1,0,2,202,2.7142857142857144,1.1846918,1
2020-10-28-171115,171115,5,0,15,207,2.4285714285714284,2.6696887,2
2020-10-29-171115,171115,1,0,3,208,3.2857142857142856,2.102078,3
2020-10-30-171115,171115,4,1,9,212,8.0,5.459094,4
2020-10-31-171115,171115,0,3,0,212,1.7142857142857142,0.6927722,5
2020-11-01-171115,171115,0,0,0,212,1.0,0.6294122,6
2020-11-02-171115,171115,0,0,0,212,1.1428571428571428,0.411796,0
2020-11-03-171115,171115,2,0,0,214,2.7142857142857144,2.8858042,1
2020-11-04-171115,171115,7,0,0,221,3.571428571428572,4.23796,2
2020-11-05-171115,171115,5,1,0,226,4.285714285714286,4.4660597,3
2020-11-06-171115,171115,12,3,0,238,9.0,7.6718206,4
2020-11-07-171115,171115,1,1,0,239,1.1428571428571428,0.6443175,5
2020-11-08-171115,171115,2,0,0,241,1.0,0.7415956,6
2020-11-09-171115,171115,2,0,0,243,3.2857142857142856,2.1732275,0
2020-11-10-171115,171115,2,0,0,245,3.0,1.6129879,1
2020-11-11-171115,171115,15,1,0,260,2.571428571428572,5.7203913,2
2020-11-12-171115,171115,3,0,0,263,2.571428571428572,2.8240504,3
2020-11-13-171115,171115,9,0,0,272,1.2857142857142858,2.9040818,4
2020-03-01-171116,171116,0,0,0,0,0.0,2.4631365e-05,6
2020-03-02-171116,171116,0,0,0,0,0.0,0.057040058,0
2020-03-03-171116,171116,0,0,0,0,0.0,0.00012689042,1
2020-03-04-171116,171116,0,0,2,0,0.0,0.00946561,2
2020-03-05-171116,171116,0,0,4,0,0.0,0.0002158501,3
2020-03-06-171116,171116,0,0,2,0,0.0,0.0008122179,4
2020-03-07-171116,171116,0,0,1,0,0.2857142857142857,0.1489531,5
2020-03-08-171116,171116,0,0,0,0,0.0,0.0001660245,6
2020-03-09-171116,171116,0,0,2,0,0.14285714285714285,0.0942931,0
2020-03-10-171116,171116,0,0,0,0,0.0,0.0062258504,1
2020-03-11-171116,171116,0,0,1,0,0.14285714285714285,0.15204495,2
2020-03-12-171116,171116,0,0,0,0,0.42857142857142855,0.30157122,3
2020-03-13-171116,171116,0,0,4,0,0.2857142857142857,0.18012664,4
2020-03-14-171116,171116,0,0,1,0,0.2857142857142857,0.13784188,5
2020-03-15-171116,171116,0,0,0,0,0.0,0.0074554267,6
2020-03-16-171116,171116,0,0,2,0,0.7142857142857143,0.30193034,0
2020-03-17-171116,171116,0,0,1,0,1.8571428571428568,0.34028563,1
2020-03-18-171116,171116,2,0,2,2,1.5714285714285714,0.5210677,2
2020-03-19-171116,171116,4,0,1,6,1.5714285714285714,0.518232,3
2020-03-20-171116,171116,2,0,1,8,1.1428571428571428,0.46853912,4
2020-03-21-171116,171116,1,0,0,9,0.7142857142857143,0.1438794,5
2020-03-22-171116,171116,0,0,0,9,0.14285714285714285,0.0311715,6
2020-03-23-171116,171116,2,0,1,11,3.0,0.6075855,0
2020-03-24-171116,171116,0,0,0,11,0.7142857142857143,0.19395266,1
2020-03-25-171116,171116,1,0,0,12,1.0,0.54124975,2
2020-03-26-171116,171116,0,0,0,12,1.1428571428571428,0.29471353,3
2020-03-27-171116,171116,4,0,0,16,1.2857142857142858,0.76175535,4
2020-03-28-171116,171116,1,0,0,17,0.14285714285714285,0.014864227,5
2020-03-29-171116,171116,0,0,0,17,0.5714285714285714,0.07123641,6
2020-03-30-171116,171116,2,0,0,19,0.42857142857142855,0.38604856,0
2020-03-31-171116,171116,1,0,1,20,1.4285714285714286,0.23191676,1
2020-04-01-171116,171116,2,0,0,22,2.0,0.74413925,2
2020-04-02-171116,171116,1,0,0,23,1.7142857142857142,0.34648344,3
2020-04-03-171116,171116,1,0,0,24,2.0,0.5134791,4
2020-04-04-171116,171116,0,1,0,24,1.0,0.19440562,5
2020-04-05-171116,171116,0,0,0,24,0.42857142857142855,0.06483539,6
2020-04-06-171116,171116,1,0,0,25,1.4285714285714286,0.4921457,0
2020-04-07-171116,171116,0,0,0,25,0.8571428571428571,0.23480119,1
2020-04-08-171116,171116,0,0,0,25,1.4285714285714286,0.3407045,2
2020-04-09-171116,171116,0,0,0,25,0.5714285714285714,0.17866765,3
2020-04-10-171116,171116,0,0,0,25,0.7142857142857143,0.08279856,4
2020-04-11-171116,171116,0,0,0,25,0.42857142857142855,0.109290004,5
2020-04-12-171116,171116,0,0,0,25,0.42857142857142855,0.06549634,6
2020-04-13-171116,171116,0,0,0,25,1.0,0.21881634,0
2020-04-14-171116,171116,1,0,0,26,0.8571428571428571,0.30856425,1
2020-04-15-171116,171116,0,0,0,26,0.2857142857142857,0.09490541,2
2020-04-16-171116,171116,0,0,0,26,2.142857142857143,0.46440035,3
2020-04-17-171116,171116,0,0,1,26,0.8571428571428571,0.32289764,4
2020-04-18-171116,171116,0,0,0,26,0.14285714285714285,0.0446265,5
2020-04-19-171116,171116,0,0,0,26,0.2857142857142857,0.066661894,6
2020-04-20-171116,171116,0,0,1,26,0.42857142857142855,0.17512827,0
2020-04-21-171116,171116,0,0,1,26,0.7142857142857143,0.2531766,1
2020-04-22-171116,171116,0,0,0,26,0.2857142857142857,0.07074943,2
2020-04-23-171116,171116,0,0,0,26,0.0,0.040151864,3
2020-04-24-171116,171116,0,0,0,26,0.7142857142857143,0.34867072,4
2020-04-25-171116,171116,0,0,0,26,0.2857142857142857,0.057155486,5
2020-04-26-171116,171116,0,0,0,26,0.14285714285714285,0.0050838743,6
2020-04-27-171116,171116,0,1,0,26,0.5714285714285714,0.37721318,0
2020-04-28-171116,171116,0,1,2,26,1.1428571428571428,0.2788844,1
2020-04-29-171116,171116,0,0,1,26,1.7142857142857142,0.33742362,2
2020-04-30-171116,171116,0,0,0,26,1.4285714285714286,0.40975273,3
2020-05-01-171116,171116,1,0,0,27,0.2857142857142857,0.05126852,4
2020-05-02-171116,171116,0,0,0,27,0.42857142857142855,0.07958917,5
2020-05-03-171116,171116,0,0,0,27,0.0,0.0127882045,6
2020-05-04-171116,171116,1,0,1,28,0.14285714285714285,0.4036145,0
2020-05-05-171116,171116,1,0,2,29,0.14285714285714285,0.34959632,1
2020-05-06-171116,171116,0,0,0,29,1.0,0.47193384,2
2020-05-07-171116,171116,0,0,0,29,1.4285714285714286,0.5508924,3
2020-05-08-171116,171116,0,0,0,29,0.5714285714285714,0.2974092,4
2020-05-09-171116,171116,0,0,0,29,0.2857142857142857,0.06100508,5
2020-05-10-171116,171116,0,1,0,29,0.14285714285714285,0.009244619,6
2020-05-11-171116,171116,0,0,0,29,0.2857142857142857,0.26882842,0
2020-05-12-171116,171116,2,0,0,31,1.0,0.4972445,1
2020-05-13-171116,171116,1,0,0,32,0.7142857142857143,0.40969184,2
2020-05-14-171116,171116,0,0,1,32,1.2857142857142858,0.23674306,3
2020-05-15-171116,171116,0,0,0,32,0.42857142857142855,0.38468117,4
2020-05-16-171116,171116,0,0,0,32,0.5714285714285714,0.09488313,5
2020-05-17-171116,171116,0,0,0,32,0.0,0.0003937804,6
2020-05-18-171116,171116,1,0,0,33,1.0,0.37542272,0
2020-05-19-171116,171116,2,0,0,35,0.42857142857142855,0.5142276,1
2020-05-20-171116,171116,0,0,0,35,0.7142857142857143,0.22435518,2
2020-05-21-171116,171116,0,0,0,35,0.2857142857142857,0.46402836,3
2020-05-22-171116,171116,0,0,0,35,0.14285714285714285,0.09035593,4
2020-05-23-171116,171116,0,0,0,35,0.0,0.00059424463,5
2020-05-24-171116,171116,0,0,0,35,0.14285714285714285,0.027144674,6
2020-05-25-171116,171116,0,0,0,35,0.0,0.25995812,0
2020-05-26-171116,171116,0,0,0,35,1.1428571428571428,0.40887862,1
2020-05-27-171116,171116,0,0,0,35,0.0,0.11980708,2
2020-05-28-171116,171116,1,0,0,36,0.42857142857142855,0.16842386,3
2020-05-29-171116,171116,0,0,0,36,0.0,0.14258838,4
2020-05-30-171116,171116,0,0,0,36,0.0,0.0005479609,5
2020-05-31-171116,171116,0,1,0,36,0.0,0.00515803,6
2020-06-01-171116,171116,0,0,0,36,0.0,0.04210981,0
2020-06-02-171116,171116,0,0,0,36,0.5714285714285714,0.09787206,1
2020-06-03-171116,171116,0,0,0,36,0.42857142857142855,0.04595227,2
2020-06-04-171116,171116,0,0,0,36,0.5714285714285714,0.18077137,3
2020-06-05-171116,171116,0,1,0,36,0.0,0.03764324,4
2020-06-06-171116,171116,0,0,0,36,0.2857142857142857,0.051730476,5
2020-06-07-171116,171116,0,0,0,36,0.0,0.00053657894,6
2020-06-08-171116,171116,0,1,0,36,0.14285714285714285,0.2646142,0
2020-06-09-171116,171116,0,0,0,36,0.14285714285714285,0.08949542,1
2020-06-10-171116,171116,0,0,0,36,0.42857142857142855,0.17474557,2
2020-06-11-171116,171116,0,0,0,36,0.0,0.20384008,3
2020-06-12-171116,171116,0,0,0,36,0.42857142857142855,0.08381261,4
2020-06-13-171116,171116,0,1,0,36,0.0,0.0006763677,5
2020-06-14-171116,171116,0,0,0,36,0.0,0.00024503408,6
2020-06-15-171116,171116,0,0,0,36,0.0,0.08088713,0
2020-06-16-171116,171116,0,0,0,36,0.14285714285714285,0.017734665,1
2020-06-17-171116,171116,0,0,0,36,0.14285714285714285,0.03310495,2
2020-06-18-171116,171116,0,0,0,36,0.14285714285714285,0.046091143,3
2020-06-19-171116,171116,0,0,0,36,0.14285714285714285,0.17215921,4
2020-06-20-171116,171116,0,0,0,36,0.0,0.015650034,5
2020-06-21-171116,171116,0,0,0,36,0.0,0.00024030649,6
2020-06-22-171116,171116,0,0,0,36,0.14285714285714285,0.0190132,0
2020-06-23-171116,171116,0,0,0,36,0.14285714285714285,0.1046564,1
2020-06-24-171116,171116,0,0,0,36,0.14285714285714285,0.06578059,2
2020-06-25-171116,171116,0,0,0,36,0.14285714285714285,0.012771739,3
2020-06-26-171116,171116,0,3,0,36,0.42857142857142855,0.09308308,4
2020-06-27-171116,171116,0,0,0,36,0.14285714285714285,0.016579824,5
2020-06-28-171116,171116,0,0,0,36,0.0,0.0011220155,6
2020-06-29-171116,171116,0,0,0,36,0.0,0.01604316,0
2020-06-30-171116,171116,0,0,0,36,0.0,0.023831673,1
2020-07-01-171116,171116,0,0,0,36,0.0,0.0018011052,2
2020-07-02-171116,171116,0,0,0,36,0.14285714285714285,0.036249712,3
2020-07-03-171116,171116,0,0,0,36,0.2857142857142857,0.09524163,4
2020-07-04-171116,171116,0,0,0,36,0.0,0.0009609583,5
2020-07-05-171116,171116,0,0,0,36,0.0,0.0010074449,6
2020-07-06-171116,171116,0,0,0,36,0.0,0.07958115,0
2020-07-07-171116,171116,0,0,0,36,0.0,0.0014518626,1
2020-07-08-171116,171116,0,0,0,36,0.0,0.025067464,2
2020-07-09-171116,171116,0,0,0,36,0.14285714285714285,0.021294365,3
2020-07-10-171116,171116,0,0,0,36,0.5714285714285714,0.19718386,4
2020-07-11-171116,171116,0,0,0,36,0.0,0.001011685,5
2020-07-12-171116,171116,0,0,0,36,0.0,0.0010753429,6
2020-07-13-171116,171116,0,0,0,36,0.0,0.006519261,0
2020-07-14-171116,171116,0,0,0,36,0.0,0.009075813,1
2020-07-15-171116,171116,0,0,0,36,0.0,0.0014895243,2
2020-07-16-171116,171116,0,0,0,36,0.0,0.0047779162,3
2020-07-17-171116,171116,0,0,0,36,0.0,0.017751683,4
2020-07-18-171116,171116,0,0,0,36,0.0,0.0057794307,5
2020-07-19-171116,171116,0,0,0,36,0.0,0.001933958,6
2020-07-20-171116,171116,0,0,0,36,0.2857142857142857,0.033251926,0
2020-07-21-171116,171116,0,0,0,36,0.0,0.0041764276,1
2020-07-22-171116,171116,0,0,0,36,0.0,0.0047830725,2
2020-07-23-171116,171116,0,0,0,36,0.0,0.017810822,3
2020-07-24-171116,171116,0,0,0,36,0.0,0.008612893,4
2020-07-25-171116,171116,0,0,0,36,0.0,0.0004483204,5
2020-07-26-171116,171116,0,0,0,36,0.0,0.0004446186,6
2020-07-27-171116,171116,0,0,0,36,0.0,0.067745246,0
2020-07-28-171116,171116,0,0,0,36,0.14285714285714285,0.019553235,1
2020-07-29-171116,171116,0,0,0,36,0.2857142857142857,0.038335502,2
2020-07-30-171116,171116,0,0,0,36,0.14285714285714285,0.11668249,3
2020-07-31-171116,171116,0,0,0,36,0.0,0.1688097,4
2020-08-01-171116,171116,0,0,0,36,0.0,0.013221096,5
2020-08-02-171116,171116,0,0,1,36,0.0,0.013955437,6
2020-08-03-171116,171116,0,0,1,36,0.2857142857142857,0.15743154,0
2020-08-04-171116,171116,0,0,0,36,0.0,0.009244308,1
2020-08-05-171116,171116,0,0,0,36,0.14285714285714285,0.039324306,2
2020-08-06-171116,171116,0,0,0,36,0.14285714285714285,0.04080078,3
2020-08-07-171116,171116,0,0,1,36,0.42857142857142855,0.32404706,4
2020-08-08-171116,171116,0,0,0,36,0.0,0.050655648,5
2020-08-09-171116,171116,0,0,0,36,0.5714285714285714,0.23909597,6
2020-08-10-171116,171116,0,0,0,36,0.2857142857142857,0.07197917,0
2020-08-11-171116,171116,0,0,0,36,0.5714285714285714,0.2650369,1
2020-08-12-171116,171116,0,0,0,36,0.14285714285714285,0.14656624,2
2020-08-13-171116,171116,0,0,0,36,1.0,0.82730967,3
2020-08-14-171116,171116,0,0,0,36,1.0,0.43882737,4
2020-08-15-171116,171116,0,0,0,36,0.7142857142857143,0.26936185,5
2020-08-16-171116,171116,1,0,0,37,0.42857142857142855,0.27319947,6
2020-08-17-171116,171116,1,0,0,38,0.5714285714285714,0.2781945,0
2020-08-18-171116,171116,0,0,0,38,0.5714285714285714,0.7964507,1
2020-08-19-171116,171116,0,0,0,38,0.2857142857142857,0.51778597,2
2020-08-20-171116,171116,0,0,0,38,0.7142857142857143,0.443465,3
2020-08-21-171116,171116,1,0,0,39,1.2857142857142858,0.6483798,4
2020-08-22-171116,171116,0,0,0,39,0.7142857142857143,0.7859152,5
2020-08-23-171116,171116,0,0,0,39,0.7142857142857143,0.2389001,6
2020-08-24-171116,171116,0,0,0,39,1.0,0.8319163,0
2020-08-25-171116,171116,0,0,1,39,0.42857142857142855,0.4616515,1
2020-08-26-171116,171116,0,0,0,39,0.8571428571428571,0.5717302,2
2020-08-27-171116,171116,0,0,0,39,1.0,0.3558565,3
2020-08-28-171116,171116,0,0,0,39,0.42857142857142855,0.3931113,4
2020-08-29-171116,171116,0,0,0,39,1.8571428571428568,0.57788014,5
2020-08-30-171116,171116,0,0,0,39,0.42857142857142855,0.19249976,6
2020-08-31-171116,171116,0,0,0,39,1.0,0.39618227,0
2020-09-01-171116,171116,0,0,0,39,0.7142857142857143,0.46354133,1
2020-09-02-171116,171116,0,0,1,39,0.5714285714285714,0.50744224,2
2020-09-03-171116,171116,0,0,0,39,1.0,0.6848762,3
2020-09-04-171116,171116,0,0,1,39,0.7142857142857143,0.5430603,4
2020-09-05-171116,171116,0,0,0,39,0.42857142857142855,0.110459775,5
2020-09-06-171116,171116,0,0,0,39,0.42857142857142855,0.38230556,6
2020-09-07-171116,171116,0,0,0,39,0.8571428571428571,0.5046786,0
2020-09-08-171116,171116,1,0,0,40,1.8571428571428568,1.2433583,1
2020-09-09-171116,171116,0,0,0,40,0.8571428571428571,0.8855243,2
2020-09-10-171116,171116,0,0,0,40,2.142857142857143,1.1373837,3
2020-09-11-171116,171116,0,0,0,40,0.2857142857142857,0.6389908,4
2020-09-12-171116,171116,0,0,0,40,1.5714285714285714,0.8429117,5
2020-09-13-171116,171116,0,0,0,40,0.5714285714285714,0.29696023,6
2020-09-14-171116,171116,0,0,0,40,0.8571428571428571,0.6349259,0
2020-09-15-171116,171116,0,0,0,40,2.0,0.8904497,1
2020-09-16-171116,171116,1,0,0,41,1.2857142857142858,1.0523195,2
2020-09-17-171116,171116,0,0,0,41,10.285714285714286,4.2992067,3
2020-09-18-171116,171116,1,0,0,42,2.7142857142857144,1.4857329,4
2020-09-19-171116,171116,0,0,0,42,1.2857142857142858,0.4072428,5
2020-09-20-171116,171116,0,0,0,42,1.0,0.3352359,6
2020-09-21-171116,171116,0,0,0,42,1.2857142857142858,0.71103334,0
2020-09-22-171116,171116,0,1,0,42,1.7142857142857142,1.5100651,1
2020-09-23-171116,171116,0,0,0,42,2.2857142857142856,0.8306581,2
2020-09-24-171116,171116,0,1,0,42,3.0,1.46449,3
2020-09-25-171116,171116,0,0,0,42,2.2857142857142856,0.91936684,4
2020-09-26-171116,171116,0,0,0,42,1.7142857142857142,0.51764363,5
2020-09-27-171116,171116,0,0,0,42,1.4285714285714286,0.6411387,6
2020-09-28-171116,171116,0,0,1,42,0.42857142857142855,0.3873911,0
2020-09-29-171116,171116,0,0,0,42,1.1428571428571428,0.33132032,1
2020-09-30-171116,171116,0,0,0,42,2.142857142857143,0.66693085,2
2020-10-01-171116,171116,0,0,3,42,0.5714285714285714,0.46775907,3
2020-10-02-171116,171116,0,0,0,42,2.0,0.7748096,4
2020-10-03-171116,171116,0,1,0,42,0.7142857142857143,0.30921152,5
2020-10-04-171116,171116,0,0,0,42,0.2857142857142857,0.12298241,6
2020-10-05-171116,171116,0,0,2,42,0.42857142857142855,0.3616337,0
2020-10-06-171116,171116,0,0,1,42,1.1428571428571428,0.907387,1
2020-10-07-171116,171116,0,1,6,42,1.0,0.4862996,2
2020-10-08-171116,171116,0,0,0,42,1.1428571428571428,0.73731416,3
2020-10-09-171116,171116,0,1,5,42,1.0,0.63439924,4
2020-10-10-171116,171116,0,0,1,42,0.8571428571428571,0.3325105,5
2020-10-11-171116,171116,0,0,2,42,0.2857142857142857,0.30902702,6
2020-10-12-171116,171116,1,0,3,43,1.1428571428571428,0.391172,0
2020-10-13-171116,171116,0,0,3,43,0.14285714285714285,0.19876368,1
2020-10-14-171116,171116,0,0,2,43,1.7142857142857142,1.4933038,2
2020-10-15-171116,171116,3,0,4,46,2.571428571428572,1.3466222,3
2020-10-16-171116,171116,0,0,6,46,1.7142857142857142,2.9139276,4
2020-10-17-171116,171116,0,0,1,46,1.0,0.5343803,5
2020-10-18-171116,171116,0,0,0,46,1.1428571428571428,0.5817522,6
2020-10-19-171116,171116,2,0,1,48,1.5714285714285714,0.7453433,0
2020-10-20-171116,171116,1,0,1,49,1.8571428571428568,1.8531106,1
2020-10-21-171116,171116,6,0,8,55,2.571428571428572,1.6521403,2
2020-10-22-171116,171116,0,0,4,55,3.0,1.5526015,3
2020-10-23-171116,171116,5,0,1,60,5.142857142857143,2.5132291,4
2020-10-24-171116,171116,1,1,1,61,2.571428571428572,0.80977094,5
2020-10-25-171116,171116,2,0,0,63,5.0,0.9271236,6
2020-10-26-171116,171116,3,0,2,66,4.285714285714286,2.072235,0
2020-10-27-171116,171116,3,0,4,69,6.0,2.168408,1
2020-10-28-171116,171116,2,1,0,71,5.142857142857143,2.105101,2
2020-10-29-171116,171116,4,0,2,75,4.714285714285714,2.3882775,3
2020-10-30-171116,171116,6,0,3,81,12.714285714285715,5.0521946,4
2020-10-31-171116,171116,1,0,0,82,1.8571428571428568,0.7036842,5
2020-11-01-171116,171116,0,0,0,82,4.428571428571429,0.9674094,6
2020-11-02-171116,171116,1,0,0,83,1.2857142857142858,0.45015365,0
2020-11-03-171116,171116,1,1,0,84,6.142857142857142,2.093229,1
2020-11-04-171116,171116,8,0,0,92,5.571428571428571,2.5700223,2
2020-11-05-171116,171116,4,2,0,96,5.7142857142857135,2.8881178,3
2020-11-06-171116,171116,1,1,0,97,6.2857142857142865,4.0940294,4
2020-11-07-171116,171116,1,1,0,98,2.4285714285714284,0.7077858,5
2020-11-08-171116,171116,0,1,0,98,1.7142857142857142,0.36379066,6
2020-11-09-171116,171116,2,0,0,100,4.0,1.9015503,0
2020-11-10-171116,171116,4,0,0,104,4.428571428571429,1.4522612,1
2020-11-11-171116,171116,0,0,0,104,5.0,1.8569205,2
2020-11-12-171116,171116,2,1,0,106,4.571428571428571,1.3898338,3
2020-11-13-171116,171116,3,0,0,109,3.0,1.2670662,4
2020-03-01-171117,171117,0,0,2,0,0.0,0.00053045235,6
2020-03-02-171117,171117,0,3,3,0,0.14285714285714285,0.12967016,0
2020-03-03-171117,171117,0,0,1,0,0.0,0.00042461048,1
2020-03-04-171117,171117,0,1,5,0,0.0,0.034464803,2
2020-03-05-171117,171117,0,2,3,0,0.0,0.0007124262,3
2020-03-06-171117,171117,0,0,8,0,0.0,0.0023122658,4
2020-03-07-171117,171117,0,0,5,0,0.2857142857142857,0.19796157,5
2020-03-08-171117,171117,0,0,3,0,0.0,0.0020998141,6
2020-03-09-171117,171117,0,0,16,0,0.2857142857142857,0.21885663,0
2020-03-10-171117,171117,0,0,6,0,0.0,0.005063962,1
2020-03-11-171117,171117,1,0,8,1,0.7142857142857143,0.75985503,2
2020-03-12-171117,171117,0,0,7,1,0.8571428571428571,0.62304336,3
2020-03-13-171117,171117,0,0,9,1,0.8571428571428571,0.37488818,4
2020-03-14-171117,171117,0,0,0,1,0.2857142857142857,0.16183445,5
2020-03-15-171117,171117,2,0,2,3,0.14285714285714285,0.38398412,6
2020-03-16-171117,171117,3,0,11,6,2.0,1.3371614,0
2020-03-17-171117,171117,1,0,4,7,1.2857142857142858,0.54237807,1
2020-03-18-171117,171117,5,0,6,12,2.8571428571428568,1.9002908,2
2020-03-19-171117,171117,3,0,4,15,3.0,1.3749964,3
2020-03-20-171117,171117,8,1,6,23,2.0,2.340487,4
2020-03-21-171117,171117,5,1,1,28,1.7142857142857142,1.0482768,5
2020-03-22-171117,171117,3,0,0,31,1.2857142857142858,0.41922256,6
2020-03-23-171117,171117,16,0,7,47,4.714285714285714,4.541914,0
2020-03-24-171117,171117,6,0,5,53,1.7142857142857142,1.7248243,1
2020-03-25-171117,171117,8,0,4,61,3.7142857142857135,2.509624,2
2020-03-26-171117,171117,7,0,6,68,2.142857142857143,2.0891569,3
2020-03-27-171117,171117,9,0,9,77,3.571428571428572,3.1520479,4
2020-03-28-171117,171117,0,0,8,77,0.8571428571428571,0.08088814,5
2020-03-29-171117,171117,2,0,3,79,0.7142857142857143,0.3712204,6
2020-03-30-171117,171117,11,0,12,90,3.0,2.904233,0
2020-03-31-171117,171117,4,0,10,94,1.8571428571428568,1.3644716,1
2020-04-01-171117,171117,6,0,2,100,3.2857142857142856,2.0061483,2
2020-04-02-171117,171117,4,0,6,104,1.4285714285714286,1.2463247,3
2020-04-03-171117,171117,6,0,4,110,1.8571428571428568,1.8252182,4
2020-04-04-171117,171117,1,0,1,111,0.2857142857142857,0.26966912,5
2020-04-05-171117,171117,0,1,1,111,0.5714285714285714,0.12121287,6
2020-04-06-171117,171117,7,0,4,118,2.8571428571428568,2.3692646,0
2020-04-07-171117,171117,5,0,2,123,4.0,1.4666768,1
2020-04-08-171117,171117,4,0,4,127,2.0,1.5795227,2
2020-04-09-171117,171117,6,0,1,133,2.2857142857142856,1.2264048,3
2020-04-10-171117,171117,9,0,10,142,1.8571428571428568,1.5200168,4
2020-04-11-171117,171117,8,0,1,150,0.7142857142857143,1.7216761,5
2020-04-12-171117,171117,3,0,1,153,0.42857142857142855,0.6145949,6
2020-04-13-171117,171117,12,0,7,165,1.5714285714285714,3.1916766,0
2020-04-14-171117,171117,10,0,2,175,1.0,2.6083875,1
2020-04-15-171117,171117,2,0,6,177,3.2857142857142856,0.9451845,2
2020-04-16-171117,171117,6,0,6,183,2.4285714285714284,1.8847752,3
2020-04-17-171117,171117,4,0,0,187,2.7142857142857144,1.5751535,4
2020-04-18-171117,171117,1,0,1,188,0.2857142857142857,0.2616179,5
2020-04-19-171117,171117,1,0,0,189,0.2857142857142857,0.20967218,6
2020-04-20-171117,171117,4,0,14,193,1.2857142857142858,1.2989851,0
2020-04-21-171117,171117,2,0,5,195,0.8571428571428571,0.7606929,1
2020-04-22-171117,171117,4,0,69,199,1.0,1.1359289,2
2020-04-23-171117,171117,1,0,20,200,0.0,0.22096461,3
2020-04-24-171117,171117,10,0,13,210,1.7142857142857142,2.9847786,4
2020-04-25-171117,171117,1,0,0,211,0.5714285714285714,0.35174614,5
2020-04-26-171117,171117,1,0,0,212,0.0,0.164713,6
2020-04-27-171117,171117,7,0,5,219,1.4285714285714286,2.2567873,0
2020-04-28-171117,171117,2,0,20,221,1.2857142857142858,0.8780668,1
2020-04-29-171117,171117,6,0,5,227,2.0,2.4513655,2
2020-04-30-171117,171117,6,0,1,233,2.7142857142857144,2.3737955,3
2020-05-01-171117,171117,0,0,5,233,0.42857142857142855,0.13270143,4
2020-05-02-171117,171117,1,0,0,234,0.2857142857142857,0.41335618,5
2020-05-03-171117,171117,0,0,0,234,0.5714285714285714,0.05458474,6
2020-05-04-171117,171117,14,0,8,248,1.7142857142857142,4.7081,0
2020-05-05-171117,171117,5,0,11,253,1.4285714285714286,1.8389511,1
2020-05-06-171117,171117,69,0,11,322,1.7142857142857142,18.454899,2
2020-05-07-171117,171117,20,0,9,342,2.0,5.882854,3
2020-05-08-171117,171117,13,0,10,355,1.7142857142857142,4.0560822,4
2020-05-09-171117,171117,0,0,0,355,0.5714285714285714,0.16502425,5
2020-05-10-171117,171117,0,0,0,355,0.0,0.0009875342,6
2020-05-11-171117,171117,5,0,0,360,1.2857142857142858,1.648391,0
2020-05-12-171117,171117,20,0,2,380,1.5714285714285714,5.2609367,1
2020-05-13-171117,171117,5,0,1,385,1.5714285714285714,1.8735132,2
2020-05-14-171117,171117,1,1,11,386,0.7142857142857143,0.5118667,3
2020-05-15-171117,171117,5,0,1,391,0.5714285714285714,1.6602172,4
2020-05-16-171117,171117,0,0,0,391,0.5714285714285714,0.17400177,5
2020-05-17-171117,171117,0,1,0,391,0.0,1.7214781e-05,6
2020-05-18-171117,171117,8,1,0,399,0.7142857142857143,2.551238,0
2020-05-19-171117,171117,11,0,3,410,1.2857142857142858,3.6680806,1
2020-05-20-171117,171117,11,0,0,421,0.7142857142857143,3.2936702,2
2020-05-21-171117,171117,9,0,4,430,1.2857142857142858,3.2388968,3
2020-05-22-171117,171117,10,0,0,440,0.14285714285714285,2.8731024,4
2020-05-23-171117,171117,0,0,1,440,0.0,0.01160895,5
2020-05-24-171117,171117,0,0,0,440,0.2857142857142857,0.071766704,6
2020-05-25-171117,171117,0,0,0,440,1.2857142857142858,0.5340548,0
2020-05-26-171117,171117,2,0,0,442,1.1428571428571428,1.3664883,1
2020-05-27-171117,171117,1,0,2,443,0.2857142857142857,0.5011044,2
2020-05-28-171117,171117,11,2,0,454,0.5714285714285714,3.330062,3
2020-05-29-171117,171117,1,0,0,455,0.5714285714285714,0.2667817,4
2020-05-30-171117,171117,0,0,0,455,0.2857142857142857,0.02065334,5
2020-05-31-171117,171117,0,0,0,455,0.14285714285714285,0.013930553,6
2020-06-01-171117,171117,0,0,1,455,0.42857142857142855,0.10041585,0
2020-06-02-171117,171117,3,0,0,458,0.7142857142857143,1.164144,1
2020-06-03-171117,171117,0,0,0,458,0.7142857142857143,0.13627063,2
2020-06-04-171117,171117,4,0,0,462,0.42857142857142855,1.645751,3
2020-06-05-171117,171117,0,0,1,462,0.5714285714285714,0.15115796,4
2020-06-06-171117,171117,1,0,0,463,0.14285714285714285,0.40853366,5
2020-06-07-171117,171117,0,0,0,463,0.14285714285714285,0.012090916,6
2020-06-08-171117,171117,0,0,1,463,1.0,0.5346813,0
2020-06-09-171117,171117,0,0,0,463,0.8571428571428571,0.24750105,1
2020-06-10-171117,171117,2,0,0,465,0.8571428571428571,1.0045295,2
2020-06-11-171117,171117,0,0,1,465,0.8571428571428571,0.43832034,3
2020-06-12-171117,171117,0,0,0,465,0.7142857142857143,0.18553895,4
2020-06-13-171117,171117,0,0,0,465,0.14285714285714285,0.016033879,5
2020-06-14-171117,171117,0,0,0,465,0.0,0.00057192316,6
2020-06-15-171117,171117,1,0,0,466,0.2857142857142857,0.43979877,0
2020-06-16-171117,171117,0,0,1,466,0.42857142857142855,0.072938286,1
2020-06-17-171117,171117,0,0,0,466,0.8571428571428571,0.15064096,2
2020-06-18-171117,171117,0,0,0,466,0.42857142857142855,0.08014904,3
2020-06-19-171117,171117,1,0,0,467,0.7142857142857143,0.77897847,4
2020-06-20-171117,171117,0,0,0,467,0.14285714285714285,0.020535776,5
2020-06-21-171117,171117,0,0,0,467,0.0,0.0011192154,6
2020-06-22-171117,171117,1,0,0,468,0.2857142857142857,0.047507294,0
2020-06-23-171117,171117,0,0,0,468,0.5714285714285714,0.119528085,1
2020-06-24-171117,171117,0,1,0,468,0.2857142857142857,0.07169138,2
2020-06-25-171117,171117,1,0,0,469,0.2857142857142857,0.45884973,3
2020-06-26-171117,171117,0,0,0,469,0.14285714285714285,0.1288013,4
2020-06-27-171117,171117,0,0,0,469,0.0,0.0048314007,5
2020-06-28-171117,171117,0,0,0,469,0.0,0.045687422,6
2020-06-29-171117,171117,0,0,0,469,0.42857142857142855,0.1388512,0
2020-06-30-171117,171117,1,0,1,470,0.14285714285714285,0.44461825,1
2020-07-01-171117,171117,0,0,0,470,0.14285714285714285,0.03359552,2
2020-07-02-171117,171117,0,0,0,470,0.0,0.029194685,3
2020-07-03-171117,171117,0,0,0,470,0.0,0.010261853,4
2020-07-04-171117,171117,0,0,0,470,0.14285714285714285,0.03067513,5
2020-07-05-171117,171117,0,0,0,470,0.14285714285714285,0.05811717,6
2020-07-06-171117,171117,0,0,0,470,0.42857142857142855,0.16646266,0
2020-07-07-171117,171117,0,0,0,470,0.0,0.00738232,1
2020-07-08-171117,171117,0,0,0,470,0.0,0.0067402823,2
2020-07-09-171117,171117,0,0,0,470,0.0,0.006434439,3
2020-07-10-171117,171117,0,0,1,470,0.5714285714285714,0.33329976,4
2020-07-11-171117,171117,0,0,0,470,0.0,0.0014597061,5
2020-07-12-171117,171117,0,0,0,470,0.0,0.0012149076,6
2020-07-13-171117,171117,0,0,0,470,0.42857142857142855,0.106959924,0
2020-07-14-171117,171117,1,0,0,471,0.42857142857142855,0.45543924,1
2020-07-15-171117,171117,0,0,1,471,0.2857142857142857,0.05376841,2
2020-07-16-171117,171117,0,0,0,471,0.42857142857142855,0.065459326,3
2020-07-17-171117,171117,0,0,1,471,0.42857142857142855,0.10191457,4
2020-07-18-171117,171117,0,0,0,471,0.0,0.023964303,5
2020-07-19-171117,171117,0,0,0,471,0.0,0.0016028488,6
2020-07-20-171117,171117,0,0,0,471,0.14285714285714285,0.04853101,0
2020-07-21-171117,171117,0,0,1,471,0.42857142857142855,0.12843601,1
2020-07-22-171117,171117,0,0,0,471,0.14285714285714285,0.050216395,2
2020-07-23-171117,171117,0,0,0,471,1.0,0.41951823,3
2020-07-24-171117,171117,1,0,0,472,0.14285714285714285,0.4537571,4
2020-07-25-171117,171117,0,2,0,472,0.0,0.0017720154,5
2020-07-26-171117,171117,0,0,0,472,0.0,0.0012570453,6
2020-07-27-171117,171117,0,0,0,472,0.42857142857142855,0.21911518,0
2020-07-28-171117,171117,0,0,0,472,0.42857142857142855,0.06195424,1
2020-07-29-171117,171117,1,0,3,473,0.5714285714285714,0.52418315,2
2020-07-30-171117,171117,0,0,1,473,0.7142857142857143,0.57889885,3
2020-07-31-171117,171117,1,0,1,474,0.5714285714285714,0.7462229,4
2020-08-01-171117,171117,0,0,2,474,0.0,0.0060621803,5
2020-08-02-171117,171117,0,0,0,474,0.42857142857142855,0.07291005,6
2020-08-03-171117,171117,0,0,0,474,0.42857142857142855,0.27627945,0
2020-08-04-171117,171117,1,0,0,475,0.0,0.3872578,1
2020-08-05-171117,171117,0,0,0,475,0.0,0.08908961,2
2020-08-06-171117,171117,0,0,1,475,0.0,0.043395378,3
2020-08-07-171117,171117,0,0,0,475,0.5714285714285714,0.5141812,4
2020-08-08-171117,171117,0,0,0,475,0.0,0.02229442,5
2020-08-09-171117,171117,0,0,0,475,0.2857142857142857,0.19030513,6
2020-08-10-171117,171117,0,0,1,475,0.14285714285714285,0.21527821,0
2020-08-11-171117,171117,0,0,1,475,0.8571428571428571,0.55054086,1
2020-08-12-171117,171117,3,0,0,478,0.2857142857142857,1.3571563,2
2020-08-13-171117,171117,1,0,2,479,1.1428571428571428,2.1540403,3
2020-08-14-171117,171117,1,0,0,480,0.5714285714285714,1.1230594,4
2020-08-15-171117,171117,2,0,0,482,0.2857142857142857,0.90317976,5
2020-08-16-171117,171117,0,0,0,482,0.0,0.03251867,6
2020-08-17-171117,171117,0,0,0,482,0.14285714285714285,0.22846738,0
2020-08-18-171117,171117,0,0,0,482,1.2857142857142858,1.2443445,1
2020-08-19-171117,171117,0,0,0,482,0.2857142857142857,0.32704377,2
2020-08-20-171117,171117,1,0,0,483,2.0,1.0022376,3
2020-08-21-171117,171117,0,0,0,483,1.0,0.38627237,4
2020-08-22-171117,171117,0,0,1,483,0.7142857142857143,0.36744824,5
2020-08-23-171117,171117,0,0,1,483,0.5714285714285714,0.13750662,6
2020-08-24-171117,171117,1,1,0,484,2.4285714285714284,1.1884052,0
2020-08-25-171117,171117,1,1,0,485,3.2857142857142856,1.1412042,1
2020-08-26-171117,171117,0,0,1,485,3.4285714285714284,1.3680788,2
2020-08-27-171117,171117,2,0,1,487,2.0,1.4246049,3
2020-08-28-171117,171117,0,1,1,487,1.4285714285714286,0.5420218,4
2020-08-29-171117,171117,0,0,0,487,2.8571428571428568,1.2007911,5
2020-08-30-171117,171117,0,0,0,487,1.8571428571428568,0.3918485,6
2020-08-31-171117,171117,0,0,0,487,1.0,0.40067366,0
2020-09-01-171117,171117,0,0,1,487,2.0,0.8500391,1
2020-09-02-171117,171117,0,0,0,487,2.4285714285714284,0.66526616,2
2020-09-03-171117,171117,0,0,1,487,1.1428571428571428,0.2734413,3
2020-09-04-171117,171117,0,0,6,487,1.4285714285714286,0.70695925,4
2020-09-05-171117,171117,1,0,2,488,0.42857142857142855,0.30503094,5
2020-09-06-171117,171117,1,0,1,489,0.2857142857142857,0.3816759,6
2020-09-07-171117,171117,0,0,0,489,1.7142857142857142,1.247767,0
2020-09-08-171117,171117,0,0,1,489,2.0,0.92242324,1
2020-09-09-171117,171117,1,0,4,490,0.5714285714285714,0.18685837,2
2020-09-10-171117,171117,1,0,9,491,2.2857142857142856,1.7256062,3
2020-09-11-171117,171117,1,1,21,492,0.8571428571428571,1.4179327,4
2020-09-12-171117,171117,0,0,8,492,0.8571428571428571,0.4908159,5
2020-09-13-171117,171117,0,0,2,492,0.2857142857142857,0.37621537,6
2020-09-14-171117,171117,0,0,8,492,2.4285714285714284,1.4183152,0
2020-09-15-171117,171117,1,0,9,493,2.0,1.655785,1
2020-09-16-171117,171117,0,0,9,493,2.7142857142857144,1.9693296,2
2020-09-17-171117,171117,1,0,4,494,10.428571428571429,8.265986,3
2020-09-18-171117,171117,6,0,6,500,3.8571428571428568,4.8542414,4
2020-09-19-171117,171117,2,0,0,502,1.0,0.96225816,5
2020-09-20-171117,171117,1,1,5,503,1.4285714285714286,0.78397685,6
2020-09-21-171117,171117,0,0,5,503,1.2857142857142858,1.3747007,0
2020-09-22-171117,171117,1,0,10,504,0.8571428571428571,1.5462492,1
2020-09-23-171117,171117,4,1,2,508,1.5714285714285714,4.2714615,2
2020-09-24-171117,171117,9,0,4,517,4.142857142857143,4.517035,3
2020-09-25-171117,171117,21,0,6,538,3.1428571428571432,4.221806,4
2020-09-26-171117,171117,8,0,2,546,2.2857142857142856,3.901807,5
2020-09-27-171117,171117,2,0,1,548,2.571428571428572,1.8195639,6
2020-09-28-171117,171117,8,0,1,556,0.8571428571428571,2.609595,0
2020-09-29-171117,171117,9,0,1,565,0.2857142857142857,3.599469,1
2020-09-30-171117,171117,9,0,2,574,2.571428571428572,3.4973621,2
2020-10-01-171117,171117,4,0,1,578,1.4285714285714286,1.3160945,3
2020-10-02-171117,171117,6,0,2,584,3.8571428571428568,2.509869,4
2020-10-03-171117,171117,0,0,1,584,2.2857142857142856,0.6939617,5
2020-10-04-171117,171117,5,0,1,589,0.8571428571428571,1.3894545,6
2020-10-05-171117,171117,5,0,6,594,0.7142857142857143,1.7542497,0
2020-10-06-171117,171117,10,0,6,604,4.714285714285714,4.2080774,1
2020-10-07-171117,171117,2,0,4,606,1.8571428571428568,1.198242,2
2020-10-08-171117,171117,4,0,17,610,5.428571428571429,3.3981578,3
2020-10-09-171117,171117,6,0,8,616,2.4285714285714284,2.4538739,4
2020-10-10-171117,171117,2,0,2,618,2.4285714285714284,1.3782493,5
2020-10-11-171117,171117,1,0,1,619,2.8571428571428568,1.2377515,6
2020-10-12-171117,171117,1,0,10,620,0.2857142857142857,0.54773843,0
2020-10-13-171117,171117,1,0,3,621,1.0,0.7905124,1
2020-10-14-171117,171117,2,0,9,623,3.4285714285714284,3.293219,2
2020-10-15-171117,171117,1,0,1,624,3.0,2.826104,3
2020-10-16-171117,171117,2,0,12,626,6.142857142857142,5.8054924,4
2020-10-17-171117,171117,1,0,0,627,3.0,1.5079186,5
2020-10-18-171117,171117,1,0,1,628,1.8571428571428568,0.95351857,6
2020-10-19-171117,171117,6,0,4,634,1.8571428571428568,2.5890417,0
2020-10-20-171117,171117,6,0,13,640,6.2857142857142865,4.820286,1
2020-10-21-171117,171117,4,0,8,644,2.4285714285714284,3.6067917,2
2020-10-22-171117,171117,17,0,4,661,3.1428571428571432,7.686537,3
2020-10-23-171117,171117,8,0,0,669,4.142857142857143,6.676899,4
2020-10-24-171117,171117,2,0,0,671,2.571428571428572,1.206841,5
2020-10-25-171117,171117,1,2,1,672,1.8571428571428568,0.990598,6
2020-10-26-171117,171117,10,0,2,682,4.857142857142857,5.436372,0
2020-10-27-171117,171117,3,1,7,685,4.857142857142857,2.9357197,1
2020-10-28-171117,171117,9,0,3,694,3.4285714285714284,4.905485,2
2020-10-29-171117,171117,1,1,3,695,5.571428571428571,3.4592862,3
2020-10-30-171117,171117,12,0,5,707,8.0,6.999729,4
2020-10-31-171117,171117,0,1,0,707,2.4285714285714284,0.88863724,5
2020-11-01-171117,171117,1,0,0,708,1.4285714285714286,1.2389319,6
2020-11-02-171117,171117,4,0,0,712,1.2857142857142858,1.5546031,0
2020-11-03-171117,171117,13,1,0,725,3.2857142857142856,5.8691564,1
2020-11-04-171117,171117,8,0,0,733,4.285714285714286,5.1454964,2
2020-11-05-171117,171117,4,0,0,737,4.142857142857143,4.056705,3
2020-11-06-171117,171117,0,3,0,737,10.285714285714286,5.5438848,4
2020-11-07-171117,171117,0,0,0,737,3.8571428571428568,1.0975158,5
2020-11-08-171117,171117,1,0,0,738,1.5714285714285714,0.6368683,6
2020-11-09-171117,171117,2,1,0,740,3.1428571428571432,2.830966,0
2020-11-10-171117,171117,7,0,0,747,3.2857142857142856,3.693865,1
2020-11-11-171117,171117,3,2,0,750,4.0,3.254322,2
2020-11-12-171117,171117,3,1,0,753,3.2857142857142856,2.756784,3
2020-11-13-171117,171117,5,0,0,758,2.8571428571428568,2.6789489,4
2020-03-01-171118,171118,0,0,0,0,0.0,6.815048e-09,6
2020-03-02-171118,171118,0,0,0,0,0.0,0.0039441623,0
2020-03-03-171118,171118,0,0,0,0,0.0,4.0551032e-07,1
2020-03-04-171118,171118,0,0,0,0,0.0,0.0060248156,2
2020-03-05-171118,171118,0,0,0,0,0.0,0.00015360635,3
2020-03-06-171118,171118,0,0,0,0,0.0,0.00011487135,4
2020-03-07-171118,171118,0,0,0,0,0.25,0.0737443,5
2020-03-08-171118,171118,0,0,0,0,0.0,0.00036312983,6
2020-03-09-171118,171118,0,0,1,0,0.25,0.01608377,0
2020-03-10-171118,171118,0,0,0,0,0.0,0.010943149,1
2020-03-11-171118,171118,0,0,1,0,0.0,0.008897325,2
2020-03-12-171118,171118,0,0,0,0,0.25,0.018636808,3
2020-03-13-171118,171118,0,0,0,0,0.25,0.08630308,4
2020-03-14-171118,171118,0,0,0,0,0.25,0.07978266,5
2020-03-15-171118,171118,0,0,1,0,0.75,0.00905326,6
2020-03-16-171118,171118,0,0,0,0,2.25,0.055866595,0
2020-03-17-171118,171118,0,0,0,0,5.5,0.25482443,1
2020-03-18-171118,171118,0,0,1,0,7.75,0.27557296,2
2020-03-19-171118,171118,0,0,0,0,4.5,0.25259265,3
2020-03-20-171118,171118,0,2,0,0,5.0,0.26395595,4
2020-03-21-171118,171118,0,0,0,0,2.25,0.104964264,5
2020-03-22-171118,171118,0,0,0,0,2.0,0.022149345,6
2020-03-23-171118,171118,1,0,0,1,9.25,0.3573036,0
2020-03-24-171118,171118,0,0,1,1,8.75,0.14226553,1
2020-03-25-171118,171118,1,0,1,2,6.5,0.21315604,2
2020-03-26-171118,171118,0,0,0,2,3.0,0.1333467,3
2020-03-27-171118,171118,0,0,0,2,5.75,0.3222017,4
2020-03-28-171118,171118,0,0,0,2,1.0,0.023108523,5
2020-03-29-171118,171118,1,0,0,3,2.0,0.037636377,6
2020-03-30-171118,171118,0,0,0,3,4.0,0.12199764,0
2020-03-31-171118,171118,0,0,0,3,3.25,0.16967689,1
2020-04-01-171118,171118,1,0,0,4,4.75,0.48624906,2
2020-04-02-171118,171118,0,0,0,4,4.5,0.1969663,3
2020-04-03-171118,171118,0,0,0,4,2.5,0.34100363,4
2020-04-04-171118,171118,0,0,0,4,0.75,0.13947389,5
2020-04-05-171118,171118,0,0,0,4,0.5,0.009727241,6
2020-04-06-171118,171118,0,0,0,4,6.75,0.15381299,0
2020-04-07-171118,171118,1,0,2,5,3.25,0.20051883,1
2020-04-08-171118,171118,1,0,0,6,2.75,0.101333536,2
2020-04-09-171118,171118,0,0,0,6,5.5,0.13671759,3
2020-04-10-171118,171118,0,0,1,6,7.5,0.10482619,4
2020-04-11-171118,171118,0,0,0,6,1.5,0.022773245,5
2020-04-12-171118,171118,0,0,0,6,6.25,0.014826029,6
2020-04-13-171118,171118,0,0,0,6,2.25,0.07733058,0
2020-04-14-171118,171118,0,0,0,6,4.25,0.1745228,1
2020-04-15-171118,171118,0,0,0,6,0.25,0.042440183,2
2020-04-16-171118,171118,0,0,0,6,2.25,0.10736411,3
2020-04-17-171118,171118,0,0,0,6,2.0,0.13422306,4
2020-04-18-171118,171118,0,0,0,6,0.75,0.022513788,5
2020-04-19-171118,171118,0,0,0,6,0.25,0.018058073,6
2020-04-20-171118,171118,0,0,0,6,0.5,0.032341376,0
2020-04-21-171118,171118,2,0,0,8,2.5,0.22884046,1
2020-04-22-171118,171118,0,0,0,8,1.25,0.08716023,2
2020-04-23-171118,171118,0,0,0,8,0.5,0.026408197,3
2020-04-24-171118,171118,1,0,0,9,10.0,0.20777479,4
2020-04-25-171118,171118,0,0,0,9,0.25,0.006929496,5
2020-04-26-171118,171118,0,0,0,9,0.25,0.008129768,6
2020-04-27-171118,171118,0,0,1,9,2.5,0.10782994,0
2020-04-28-171118,171118,0,0,1,9,3.0,0.17774571,1
2020-04-29-171118,171118,0,0,0,9,1.25,0.1525834,2
2020-04-30-171118,171118,0,0,0,9,2.25,0.117503345,3
2020-05-01-171118,171118,0,1,1,9,0.25,0.011262388,4
2020-05-02-171118,171118,0,0,0,9,0.25,0.012809166,5
2020-05-03-171118,171118,0,0,0,9,0.25,0.008152201,6
2020-05-04-171118,171118,0,0,0,9,2.25,0.0971038,0
2020-05-05-171118,171118,0,0,0,9,3.5,0.09301862,1
2020-05-06-171118,171118,0,0,0,9,2.5,0.17278412,2
2020-05-07-171118,171118,0,0,0,9,7.0,0.39210606,3
2020-05-08-171118,171118,0,0,0,9,1.25,0.10317332,4
2020-05-09-171118,171118,0,0,0,9,0.25,0.016871942,5
2020-05-10-171118,171118,0,0,0,9,0.25,0.015331818,6
2020-05-11-171118,171118,1,0,0,10,1.5,0.11160061,0
2020-05-12-171118,171118,1,0,0,11,1.5,0.21898513,1
2020-05-13-171118,171118,0,0,1,11,4.75,0.20052353,2
2020-05-14-171118,171118,0,0,0,11,1.5,0.15133546,3
2020-05-15-171118,171118,1,0,0,12,1.75,0.24325755,4
2020-05-16-171118,171118,0,0,0,12,0.25,0.014696239,5
2020-05-17-171118,171118,0,0,0,12,0.0,0.00078223896,6
2020-05-18-171118,171118,0,0,0,12,2.25,0.25109938,0
2020-05-19-171118,171118,0,0,0,12,1.5,0.17786017,1
2020-05-20-171118,171118,0,0,0,12,1.25,0.11119803,2
2020-05-21-171118,171118,0,0,0,12,1.5,0.08192641,3
2020-05-22-171118,171118,0,0,0,12,2.25,0.09656709,4
2020-05-23-171118,171118,0,0,0,12,0.0,0.0008725255,5
2020-05-24-171118,171118,0,0,0,12,0.0,0.00052481075,6
2020-05-25-171118,171118,0,0,0,12,0.5,0.02226835,0
2020-05-26-171118,171118,0,0,0,12,1.0,0.111772366,1
2020-05-27-171118,171118,1,4,0,13,0.5,0.02280592,2
2020-05-28-171118,171118,0,0,0,13,1.5,0.1369023,3
2020-05-29-171118,171118,0,3,0,13,1.5,0.04590044,4
2020-05-30-171118,171118,0,0,0,13,0.0,0.0009956476,5
2020-05-31-171118,171118,0,0,0,13,0.0,0.0060792477,6
2020-06-01-171118,171118,0,0,0,13,1.75,0.0631402,0
2020-06-02-171118,171118,0,0,0,13,1.25,0.13024615,1
2020-06-03-171118,171118,0,0,0,13,0.75,0.06619976,2
2020-06-04-171118,171118,0,0,0,13,3.0,0.18485653,3
2020-06-05-171118,171118,0,0,0,13,1.0,0.05025217,4
2020-06-06-171118,171118,0,0,0,13,0.0,0.021837506,5
2020-06-07-171118,171118,0,0,0,13,0.0,0.00050942943,6
2020-06-08-171118,171118,0,0,0,13,0.75,0.07468245,0
2020-06-09-171118,171118,0,0,1,13,0.25,0.0537301,1
2020-06-10-171118,171118,0,0,0,13,1.0,0.035649356,2
2020-06-11-171118,171118,0,0,0,13,0.75,0.06321026,3
2020-06-12-171118,171118,0,0,1,13,1.0,0.06984928,4
2020-06-13-171118,171118,0,0,0,13,0.0,0.00040503108,5
2020-06-14-171118,171118,0,0,0,13,0.0,0.00023210146,6
2020-06-15-171118,171118,0,0,0,13,1.25,0.04456874,0
2020-06-16-171118,171118,0,0,0,13,0.0,0.023105618,1
2020-06-17-171118,171118,0,0,0,13,0.5,0.050369263,2
2020-06-18-171118,171118,0,1,0,13,0.5,0.043856096,3
2020-06-19-171118,171118,0,0,0,13,0.0,0.013560923,4
2020-06-20-171118,171118,0,0,0,13,0.0,0.00045666867,5
2020-06-21-171118,171118,0,0,0,13,0.0,0.00023768924,6
2020-06-22-171118,171118,0,0,0,13,0.5,0.028874123,0
2020-06-23-171118,171118,1,0,0,14,0.75,0.15424383,1
2020-06-24-171118,171118,0,0,0,14,1.25,0.06827507,2
2020-06-25-171118,171118,0,0,0,14,0.5,0.012233655,3
2020-06-26-171118,171118,1,0,0,15,0.25,0.07859997,4
2020-06-27-171118,171118,0,0,0,15,0.0,0.025195906,5
2020-06-28-171118,171118,0,0,0,15,0.0,0.0008279754,6
2020-06-29-171118,171118,0,0,0,15,0.75,0.021862857,0
2020-06-30-171118,171118,0,0,0,15,0.25,0.015950147,1
2020-07-01-171118,171118,0,1,1,15,0.0,0.001501962,2
2020-07-02-171118,171118,0,0,0,15,0.75,0.033261232,3
2020-07-03-171118,171118,0,0,0,15,0.25,0.058612533,4
2020-07-04-171118,171118,0,0,0,15,0.0,0.0002106146,5
2020-07-05-171118,171118,0,0,0,15,0.0,0.00045893466,6
2020-07-06-171118,171118,0,0,0,15,0.25,0.025645979,0
2020-07-07-171118,171118,0,0,0,15,0.0,0.0007109017,1
2020-07-08-171118,171118,0,0,0,15,0.5,0.04259806,2
2020-07-09-171118,171118,0,0,0,15,0.5,0.035962597,3
2020-07-10-171118,171118,0,0,0,15,0.5,0.112283856,4
2020-07-11-171118,171118,0,0,0,15,0.0,0.0009592331,5
2020-07-12-171118,171118,0,0,0,15,0.0,0.0010641346,6
2020-07-13-171118,171118,0,0,0,15,0.25,0.0051332265,0
2020-07-14-171118,171118,0,0,0,15,0.0,0.0034759482,1
2020-07-15-171118,171118,1,0,0,16,0.0,0.002150143,2
2020-07-16-171118,171118,0,0,0,16,0.0,0.004708389,3
2020-07-17-171118,171118,0,0,0,16,0.25,0.024289127,4
2020-07-18-171118,171118,0,0,0,16,0.25,0.005285937,5
2020-07-19-171118,171118,0,0,0,16,0.0,0.0015154498,6
2020-07-20-171118,171118,0,0,0,16,0.0,0.049406826,0
2020-07-21-171118,171118,0,0,0,16,0.0,0.0016180672,1
2020-07-22-171118,171118,0,0,0,16,0.0,0.0017324698,2
2020-07-23-171118,171118,0,0,0,16,0.25,0.012112959,3
2020-07-24-171118,171118,0,0,0,16,0.25,0.009033414,4
2020-07-25-171118,171118,0,0,0,16,0.0,0.00021415474,5
2020-07-26-171118,171118,0,0,0,16,0.0,0.00030912703,6
2020-07-27-171118,171118,0,0,0,16,0.25,0.0063182497,0
2020-07-28-171118,171118,0,0,0,16,0.0,0.028251395,1
2020-07-29-171118,171118,0,0,0,16,0.25,0.04971054,2
2020-07-30-171118,171118,0,0,0,16,0.5,0.12762329,3
2020-07-31-171118,171118,0,0,0,16,1.0,0.05063096,4
2020-08-01-171118,171118,0,0,1,16,0.25,0.01747471,5
2020-08-02-171118,171118,0,0,0,16,0.0,0.018881701,6
2020-08-03-171118,171118,0,0,0,16,0.75,0.07213122,0
2020-08-04-171118,171118,0,0,0,16,0.0,0.0060734665,1
2020-08-05-171118,171118,0,0,6,16,0.5,0.053051908,2
2020-08-06-171118,171118,0,0,0,16,2.25,0.05586557,3
2020-08-07-171118,171118,0,0,1,16,0.5,0.111662954,4
2020-08-08-171118,171118,0,0,0,16,0.0,0.071502514,5
2020-08-09-171118,171118,0,0,1,16,0.25,0.24540979,6
2020-08-10-171118,171118,0,0,3,16,0.0,0.04173048,0
2020-08-11-171118,171118,0,0,4,16,0.25,0.12434008,1
2020-08-12-171118,171118,0,0,0,16,1.5,0.08463199,2
2020-08-13-171118,171118,0,0,0,16,0.0,0.11329615,3
2020-08-14-171118,171118,0,0,3,16,0.0,0.15887643,4
2020-08-15-171118,171118,1,0,0,17,2.75,0.31671086,5
2020-08-16-171118,171118,0,0,0,17,0.75,0.27054822,6
2020-08-17-171118,171118,0,0,0,17,0.75,0.21974286,0
2020-08-18-171118,171118,0,0,0,17,1.25,0.2447952,1
2020-08-19-171118,171118,6,0,3,23,1.25,0.71815974,2
2020-08-20-171118,171118,0,0,0,23,0.75,0.5444439,3
2020-08-21-171118,171118,1,0,0,24,1.0,0.596047,4
2020-08-22-171118,171118,0,0,1,24,1.25,0.7411708,5
2020-08-23-171118,171118,1,0,1,25,0.75,0.23793972,6
2020-08-24-171118,171118,3,0,0,28,0.25,0.50146556,0
2020-08-25-171118,171118,4,0,9,32,1.0,0.5672655,1
2020-08-26-171118,171118,0,0,5,32,2.25,0.31937855,2
2020-08-27-171118,171118,0,0,1,32,1.5,0.19833983,3
2020-08-28-171118,171118,3,0,0,35,1.0,0.4439097,4
2020-08-29-171118,171118,0,0,0,35,0.25,0.15911232,5
2020-08-30-171118,171118,0,0,0,35,5.5,0.25015077,6
2020-08-31-171118,171118,0,0,0,35,2.75,0.45087504,0
2020-09-01-171118,171118,0,0,4,35,1.25,0.1729894,1
2020-09-02-171118,171118,3,0,3,38,2.0,0.4641753,2
2020-09-03-171118,171118,0,0,0,38,1.5,0.8065063,3
2020-09-04-171118,171118,0,0,1,38,2.5,0.41405362,4
2020-09-05-171118,171118,1,0,0,39,0.5,0.10371267,5
2020-09-06-171118,171118,1,0,1,40,0.0,0.2765848,6
2020-09-07-171118,171118,0,0,0,40,0.0,0.15970941,0
2020-09-08-171118,171118,9,0,14,49,1.75,1.2796744,1
2020-09-09-171118,171118,5,0,0,54,1.75,1.104722,2
2020-09-10-171118,171118,1,0,4,55,2.75,0.71107644,3
2020-09-11-171118,171118,0,0,0,55,0.75,0.28214213,4
2020-09-12-171118,171118,0,0,1,55,0.0,0.2517766,5
2020-09-13-171118,171118,0,0,0,55,1.25,0.16274871,6
2020-09-14-171118,171118,0,0,3,55,0.75,0.1675027,0
2020-09-15-171118,171118,4,0,0,59,3.5,0.59103936,1
2020-09-16-171118,171118,3,0,1,62,0.5,0.47467983,2
2020-09-17-171118,171118,0,0,5,62,2.25,1.2881315,3
2020-09-18-171118,171118,1,0,0,63,1.75,0.57218206,4
2020-09-19-171118,171118,0,0,0,63,1.0,0.2716682,5
2020-09-20-171118,171118,1,1,0,64,1.25,0.257274,6
2020-09-21-171118,171118,0,0,0,64,1.75,0.31492957,0
2020-09-22-171118,171118,14,0,1,78,3.0,1.773751,1
2020-09-23-171118,171118,0,0,0,78,1.0,0.46316084,2
2020-09-24-171118,171118,4,0,0,82,2.25,1.0199752,3
2020-09-25-171118,171118,0,1,0,82,1.0,0.4036209,4
2020-09-26-171118,171118,1,0,0,83,0.5,0.19376655,5
2020-09-27-171118,171118,0,0,0,83,0.25,0.08383685,6
2020-09-28-171118,171118,3,0,0,86,1.25,0.27961832,0
2020-09-29-171118,171118,0,0,0,86,2.25,0.25566247,1
2020-09-30-171118,171118,1,0,0,87,0.5,0.26278383,2
2020-10-01-171118,171118,5,0,0,92,1.0,0.42934692,3
2020-10-02-171118,171118,0,0,0,92,1.25,0.34267223,4
2020-10-03-171118,171118,0,0,0,92,0.5,0.11651421,5
2020-10-04-171118,171118,0,1,0,92,0.25,0.07872396,6
2020-10-05-171118,171118,0,0,0,92,1.0,0.17471023,0
2020-10-06-171118,171118,1,0,0,93,2.0,0.3621198,1
2020-10-07-171118,171118,0,0,2,93,2.5,0.35164008,2
2020-10-08-171118,171118,0,0,0,93,1.75,0.5455685,3
2020-10-09-171118,171118,0,0,1,93,7.75,0.6478195,4
2020-10-10-171118,171118,0,0,0,93,0.25,0.1726669,5
2020-10-11-171118,171118,0,0,0,93,1.0,0.09411743,6
2020-10-12-171118,171118,0,0,0,93,2.25,0.2932699,0
2020-10-13-171118,171118,0,0,0,93,1.5,0.17072271,1
2020-10-14-171118,171118,0,0,0,93,3.75,0.56423455,2
2020-10-15-171118,171118,0,0,0,93,3.0,0.8082193,3
2020-10-16-171118,171118,0,0,1,93,6.75,0.7896216,4
2020-10-17-171118,171118,0,0,0,93,1.0,0.25621298,5
2020-10-18-171118,171118,0,0,0,93,0.75,0.2759695,6
2020-10-19-171118,171118,0,1,0,93,2.25,0.4983825,0
2020-10-20-171118,171118,0,0,1,93,2.5,0.61223024,1
2020-10-21-171118,171118,2,0,0,95,2.5,1.1678193,2
2020-10-22-171118,171118,0,0,0,95,3.0,0.69516194,3
2020-10-23-171118,171118,1,0,2,96,11.5,1.7374549,4
2020-10-24-171118,171118,0,0,5,96,1.25,0.38514018,5
2020-10-25-171118,171118,0,0,0,96,1.75,0.6448675,6
2020-10-26-171118,171118,0,0,1,96,4.0,1.0896963,0
2020-10-27-171118,171118,0,0,0,96,4.75,1.614703,1
2020-10-28-171118,171118,0,0,0,96,8.0,1.510461,2
2020-10-29-171118,171118,0,0,0,96,5.75,1.1167011,3
2020-10-30-171118,171118,1,0,2,97,10.75,2.9831195,4
2020-10-31-171118,171118,0,0,0,97,3.25,0.4487943,5
2020-11-01-171118,171118,0,1,0,97,1.0,0.5618215,6
2020-11-02-171118,171118,0,0,0,97,1.75,0.30476648,0
2020-11-03-171118,171118,1,0,0,98,4.0,1.1415536,1
2020-11-04-171118,171118,0,0,0,98,4.0,1.33603,2
2020-11-05-171118,171118,0,0,0,98,12.5,1.4488177,3
2020-11-06-171118,171118,2,0,0,100,6.75,1.4603449,4
2020-11-07-171118,171118,5,0,0,105,1.0,0.5822562,5
2020-11-08-171118,171118,0,0,0,105,2.25,0.21573341,6
2020-11-09-171118,171118,1,0,0,106,6.25,1.0772064,0
2020-11-10-171118,171118,0,0,0,106,4.25,0.78591365,1
2020-11-11-171118,171118,0,0,0,106,10.25,1.2305678,2
2020-11-12-171118,171118,0,0,0,106,6.5,0.98587906,3
2020-11-13-171118,171118,2,0,0,108,5.5,1.022436,4
2020-03-01-171119,171119,0,0,0,0,0.0,1.8790648e-05,6
2020-03-02-171119,171119,0,0,0,0,0.0,0.0125607215,0
2020-03-03-171119,171119,0,1,0,0,0.0,0.00010870353,1
2020-03-04-171119,171119,1,1,0,1,0.0,0.27735823,2
2020-03-05-171119,171119,0,0,0,1,0.0,0.0008558945,3
2020-03-06-171119,171119,0,0,1,1,0.0,0.0012828542,4
2020-03-07-171119,171119,0,0,0,1,0.0,0.033928372,5
2020-03-08-171119,171119,0,0,0,1,0.0,0.00025801783,6
2020-03-09-171119,171119,0,0,0,1,0.0,0.034321357,0
2020-03-10-171119,171119,0,0,0,1,0.0,0.01226346,1
2020-03-11-171119,171119,0,0,0,1,0.0,0.0769081,2
2020-03-12-171119,171119,0,0,0,1,0.0,0.09456624,3
2020-03-13-171119,171119,0,0,0,1,0.0,0.05541375,4
2020-03-14-171119,171119,0,0,0,1,0.0,0.021347297,5
2020-03-15-171119,171119,0,0,0,1,0.0,0.03561306,6
2020-03-16-171119,171119,0,1,2,1,1.3333333333333333,0.29945546,0
2020-03-17-171119,171119,0,0,3,1,1.5,0.38298008,1
2020-03-18-171119,171119,0,3,2,1,1.8333333333333333,0.7166669,2
2020-03-19-171119,171119,0,1,1,1,1.6666666666666667,0.47569293,3
2020-03-20-171119,171119,1,2,2,2,1.8333333333333333,0.74941653,4
2020-03-21-171119,171119,0,0,0,2,0.6666666666666666,0.10910812,5
2020-03-22-171119,171119,0,0,0,2,0.3333333333333333,0.06859551,6
2020-03-23-171119,171119,0,0,0,2,2.833333333333333,0.8168147,0
2020-03-24-171119,171119,0,0,0,2,1.8333333333333333,0.44200993,1
2020-03-25-171119,171119,0,0,1,2,1.3333333333333333,0.6720778,2
2020-03-26-171119,171119,0,1,0,2,1.5,0.42005128,3
2020-03-27-171119,171119,0,0,1,2,1.3333333333333333,0.58380836,4
2020-03-28-171119,171119,0,0,2,2,0.16666666666666666,0.047442112,5
2020-03-29-171119,171119,0,0,0,2,0.5,0.089064784,6
2020-03-30-171119,171119,2,0,1,4,0.6666666666666666,0.88150734,0
2020-03-31-171119,171119,3,0,0,7,1.8333333333333333,1.2741878,1
2020-04-01-171119,171119,2,0,1,9,0.6666666666666666,0.982654,2
2020-04-02-171119,171119,1,0,2,10,1.0,0.70529664,3
2020-04-03-171119,171119,2,0,2,12,1.5,0.7224956,4
2020-04-04-171119,171119,0,0,0,12,0.5,0.1049811,5
2020-04-05-171119,171119,0,1,0,12,0.5,0.1211304,6
2020-04-06-171119,171119,0,0,1,12,1.1666666666666667,0.6292521,0
2020-04-07-171119,171119,0,0,0,12,1.6666666666666667,0.47263622,1
2020-04-08-171119,171119,1,0,0,13,0.3333333333333333,0.5677764,2
2020-04-09-171119,171119,0,0,1,13,0.5,0.41092318,3
2020-04-10-171119,171119,1,0,1,14,0.5,0.6398392,4
2020-04-11-171119,171119,2,0,0,16,0.0,0.6293985,5
2020-04-12-171119,171119,0,0,0,16,0.16666666666666666,0.051834527,6
2020-04-13-171119,171119,1,0,0,17,1.5,0.61490774,0
2020-04-14-171119,171119,0,0,0,17,1.3333333333333333,0.38930586,1
2020-04-15-171119,171119,1,0,0,18,0.16666666666666666,0.38521662,2
2020-04-16-171119,171119,2,0,0,20,0.6666666666666666,0.6755038,3
2020-04-17-171119,171119,2,0,0,22,0.6666666666666666,0.9292631,4
2020-04-18-171119,171119,0,0,0,22,0.16666666666666666,0.15067789,5
2020-04-19-171119,171119,0,1,0,22,0.16666666666666666,0.106268525,6
2020-04-20-171119,171119,1,0,0,23,0.3333333333333333,0.4191376,0
2020-04-21-171119,171119,0,0,0,23,3.333333333333333,0.6570971,1
2020-04-22-171119,171119,0,0,1,23,0.3333333333333333,0.19075912,2
2020-04-23-171119,171119,1,0,0,24,0.0,0.30270138,3
2020-04-24-171119,171119,1,0,3,25,0.6666666666666666,0.6390593,4
2020-04-25-171119,171119,0,0,0,25,0.3333333333333333,0.042270847,5
2020-04-26-171119,171119,0,1,0,25,0.16666666666666666,0.02096832,6
2020-04-27-171119,171119,0,0,0,25,0.6666666666666666,0.28509223,0
2020-04-28-171119,171119,0,0,0,25,1.1666666666666667,0.35877547,1
2020-04-29-171119,171119,0,0,1,25,1.1666666666666667,0.47085893,2
2020-04-30-171119,171119,0,0,0,25,0.5,0.38636705,3
2020-05-01-171119,171119,0,0,0,25,0.16666666666666666,0.11559892,4
2020-05-02-171119,171119,0,0,0,25,0.16666666666666666,0.057461724,5
2020-05-03-171119,171119,0,0,0,25,0.0,0.017304068,6
2020-05-04-171119,171119,0,0,1,25,0.3333333333333333,0.30673462,0
2020-05-05-171119,171119,0,0,0,25,0.0,0.19165397,1
2020-05-06-171119,171119,1,0,1,26,0.8333333333333334,1.1077099,2
2020-05-07-171119,171119,0,0,0,26,0.6666666666666666,1.3149488,3
2020-05-08-171119,171119,3,0,0,29,0.3333333333333333,1.5423435,4
2020-05-09-171119,171119,0,0,0,29,0.16666666666666666,0.04697272,5
2020-05-10-171119,171119,0,1,0,29,0.16666666666666666,0.034549676,6
2020-05-11-171119,171119,0,0,0,29,0.3333333333333333,0.30643493,0
2020-05-12-171119,171119,0,0,0,29,1.0,0.46032622,1
2020-05-13-171119,171119,1,3,0,30,0.8333333333333334,0.79311943,2
2020-05-14-171119,171119,0,0,0,30,1.5,0.31364056,3
2020-05-15-171119,171119,0,0,0,30,0.16666666666666666,0.1618763,4
2020-05-16-171119,171119,0,2,0,30,0.16666666666666666,0.054244284,5
2020-05-17-171119,171119,0,0,0,30,0.0,0.002175079,6
2020-05-18-171119,171119,1,0,0,31,0.8333333333333334,0.69964707,0
2020-05-19-171119,171119,0,0,0,31,0.8333333333333334,0.34415492,1
2020-05-20-171119,171119,1,0,0,32,0.8333333333333334,0.8627751,2
2020-05-21-171119,171119,0,0,0,32,0.3333333333333333,0.31725323,3
2020-05-22-171119,171119,0,0,0,32,0.3333333333333333,0.2368617,4
2020-05-23-171119,171119,0,0,0,32,0.0,0.00018779752,5
2020-05-24-171119,171119,0,0,0,32,0.0,0.013899933,6
2020-05-25-171119,171119,0,0,0,32,0.3333333333333333,0.102977246,0
2020-05-26-171119,171119,0,0,0,32,0.0,0.24466018,1
2020-05-27-171119,171119,0,1,0,32,0.0,0.08841146,2
2020-05-28-171119,171119,0,4,0,32,1.0,0.32742828,3
2020-05-29-171119,171119,0,0,0,32,0.3333333333333333,0.14135659,4
2020-05-30-171119,171119,0,0,0,32,0.0,0.01161852,5
2020-05-31-171119,171119,0,0,0,32,0.16666666666666666,0.019961046,6
2020-06-01-171119,171119,0,1,0,32,0.6666666666666666,0.20199853,0
2020-06-02-171119,171119,0,0,0,32,0.8333333333333334,0.20746395,1
2020-06-03-171119,171119,0,0,0,32,0.5,0.12711693,2
2020-06-04-171119,171119,0,0,0,32,0.6666666666666666,0.283916,3
2020-06-05-171119,171119,0,0,0,32,0.3333333333333333,0.09481037,4
2020-06-06-171119,171119,0,0,0,32,0.16666666666666666,0.0633293,5
2020-06-07-171119,171119,0,0,0,32,0.0,0.0016651155,6
2020-06-08-171119,171119,0,1,0,32,0.6666666666666666,0.1791491,0
2020-06-09-171119,171119,0,0,0,32,0.6666666666666666,0.13777049,1
2020-06-10-171119,171119,0,0,0,32,0.8333333333333334,0.22221643,2
2020-06-11-171119,171119,0,0,0,32,0.16666666666666666,0.12169258,3
2020-06-12-171119,171119,0,0,0,32,0.3333333333333333,0.14288238,4
2020-06-13-171119,171119,0,0,0,32,0.0,0.00195721,5
2020-06-14-171119,171119,0,0,0,32,0.0,0.017403439,6
2020-06-15-171119,171119,0,1,0,32,0.16666666666666666,0.0813123,0
2020-06-16-171119,171119,0,0,1,32,0.3333333333333333,0.05724121,1
2020-06-17-171119,171119,0,0,0,32,0.16666666666666666,0.12438345,2
2020-06-18-171119,171119,0,0,0,32,0.16666666666666666,0.095141694,3
2020-06-19-171119,171119,0,0,0,32,0.0,0.07942453,4
2020-06-20-171119,171119,0,0,0,32,0.0,0.004547822,5
2020-06-21-171119,171119,0,0,0,32,0.0,0.0004854295,6
2020-06-22-171119,171119,0,0,0,32,0.16666666666666666,0.048925564,0
2020-06-23-171119,171119,0,0,0,32,0.3333333333333333,0.13142751,1
2020-06-24-171119,171119,0,0,0,32,0.16666666666666666,0.12209877,2
2020-06-25-171119,171119,0,0,0,32,0.3333333333333333,0.029955614,3
2020-06-26-171119,171119,0,1,0,32,0.5,0.14945252,4
2020-06-27-171119,171119,0,0,0,32,0.16666666666666666,0.04088797,5
2020-06-28-171119,171119,0,0,0,32,0.0,0.0016746249,6
2020-06-29-171119,171119,0,0,0,32,0.3333333333333333,0.05040177,0
2020-06-30-171119,171119,1,0,0,33,0.16666666666666666,0.45078653,1
2020-07-01-171119,171119,0,0,0,33,0.16666666666666666,0.017791405,2
2020-07-02-171119,171119,0,0,0,33,0.16666666666666666,0.05255809,3
2020-07-03-171119,171119,0,0,0,33,0.16666666666666666,0.056241762,4
2020-07-04-171119,171119,0,0,0,33,0.0,0.0013676384,5
2020-07-05-171119,171119,0,0,0,33,0.16666666666666666,0.01200082,6
2020-07-06-171119,171119,0,0,0,33,0.16666666666666666,0.060132433,0
2020-07-07-171119,171119,0,0,0,33,0.0,0.007781692,1
2020-07-08-171119,171119,0,0,0,33,0.3333333333333333,0.038771283,2
2020-07-09-171119,171119,0,0,1,33,0.16666666666666666,0.055957202,3
2020-07-10-171119,171119,0,0,0,33,0.8333333333333334,0.41733795,4
2020-07-11-171119,171119,0,0,0,33,0.3333333333333333,0.016848208,5
2020-07-12-171119,171119,0,0,0,33,0.0,0.0005146737,6
2020-07-13-171119,171119,0,0,0,33,0.0,0.008016908,0
2020-07-14-171119,171119,0,0,0,33,0.0,0.023513388,1
2020-07-15-171119,171119,0,0,0,33,0.16666666666666666,0.019313931,2
2020-07-16-171119,171119,0,0,0,33,0.16666666666666666,0.022399832,3
2020-07-17-171119,171119,0,0,0,33,0.0,0.06482488,4
2020-07-18-171119,171119,0,0,0,33,0.0,0.0041518123,5
2020-07-19-171119,171119,0,0,0,33,0.3333333333333333,0.026526164,6
2020-07-20-171119,171119,0,0,0,33,0.3333333333333333,0.090738155,0
2020-07-21-171119,171119,0,0,0,33,0.6666666666666666,0.10168144,1
2020-07-22-171119,171119,0,0,1,33,0.16666666666666666,0.010833239,2
2020-07-23-171119,171119,1,0,0,34,1.1666666666666667,0.45992947,3
2020-07-24-171119,171119,0,0,1,34,0.0,0.020197868,4
2020-07-25-171119,171119,0,0,0,34,0.0,0.0036023883,5
2020-07-26-171119,171119,0,0,2,34,0.0,0.001566335,6
2020-07-27-171119,171119,0,0,0,34,0.16666666666666666,0.03192947,0
2020-07-28-171119,171119,0,0,0,34,0.5,0.062361613,1
2020-07-29-171119,171119,0,0,0,34,0.3333333333333333,0.10587721,2
2020-07-30-171119,171119,0,0,0,34,0.3333333333333333,0.06418909,3
2020-07-31-171119,171119,0,0,0,34,0.3333333333333333,0.102126785,4
2020-08-01-171119,171119,0,0,0,34,0.0,0.0055904547,5
2020-08-02-171119,171119,0,0,0,34,0.16666666666666666,0.026485592,6
2020-08-03-171119,171119,0,0,0,34,0.16666666666666666,0.117327474,0
2020-08-04-171119,171119,0,0,0,34,0.0,0.04047687,1
2020-08-05-171119,171119,1,0,0,35,0.16666666666666666,0.12520918,2
2020-08-06-171119,171119,0,0,1,35,0.16666666666666666,0.092840925,3
2020-08-07-171119,171119,1,0,1,36,0.16666666666666666,1.0772127,4
2020-08-08-171119,171119,0,0,0,36,0.0,0.116326496,5
2020-08-09-171119,171119,2,0,0,38,0.3333333333333333,0.95885944,6
2020-08-10-171119,171119,0,0,0,38,0.3333333333333333,0.108745895,0
2020-08-11-171119,171119,0,0,0,38,1.3333333333333333,0.66589344,1
2020-08-12-171119,171119,0,0,3,38,0.16666666666666666,0.6115258,2
2020-08-13-171119,171119,0,0,0,38,0.5,0.38725373,3
2020-08-14-171119,171119,0,0,0,38,0.5,0.38093516,4
2020-08-15-171119,171119,0,0,0,38,0.6666666666666666,0.28460863,5
2020-08-16-171119,171119,0,0,2,38,0.16666666666666666,0.08352669,6
2020-08-17-171119,171119,0,0,0,38,0.5,0.34739548,0
2020-08-18-171119,171119,0,0,0,38,0.5,0.49655518,1
2020-08-19-171119,171119,0,0,0,38,0.3333333333333333,0.43329135,2
2020-08-20-171119,171119,1,0,0,39,1.6666666666666667,1.070462,3
2020-08-21-171119,171119,1,0,0,40,1.8333333333333333,0.49548742,4
2020-08-22-171119,171119,0,0,0,40,0.6666666666666666,0.3252515,5
2020-08-23-171119,171119,0,0,0,40,0.16666666666666666,0.11063243,6
2020-08-24-171119,171119,0,0,0,40,1.0,0.49654132,0
2020-08-25-171119,171119,0,0,0,40,1.5,0.30935305,1
2020-08-26-171119,171119,3,0,0,43,0.8333333333333334,2.1997492,2
2020-08-27-171119,171119,0,1,1,43,2.1666666666666665,0.88268197,3
2020-08-28-171119,171119,0,0,0,43,1.0,0.330337,4
2020-08-29-171119,171119,0,0,0,43,2.1666666666666665,1.4513894,5
2020-08-30-171119,171119,2,0,0,45,0.0,0.5137515,6
2020-08-31-171119,171119,0,0,0,45,0.5,0.3231073,0
2020-09-01-171119,171119,0,0,0,45,0.8333333333333334,0.3705141,1
2020-09-02-171119,171119,0,0,0,45,1.3333333333333333,0.8814583,2
2020-09-03-171119,171119,0,0,0,45,0.8333333333333334,0.35254228,3
2020-09-04-171119,171119,0,0,2,45,1.6666666666666667,0.47244725,4
2020-09-05-171119,171119,0,0,1,45,0.16666666666666666,0.15270129,5
2020-09-06-171119,171119,0,0,1,45,0.0,0.08397585,6
2020-09-07-171119,171119,0,0,0,45,1.6666666666666667,0.8450567,0
2020-09-08-171119,171119,0,0,4,45,1.5,0.8106445,1
2020-09-09-171119,171119,0,0,3,45,1.5,0.2991024,2
2020-09-10-171119,171119,1,0,0,46,1.0,1.0506505,3
2020-09-11-171119,171119,0,0,0,46,1.8333333333333333,1.352969,4
2020-09-12-171119,171119,0,0,0,46,0.8333333333333334,0.23752789,5
2020-09-13-171119,171119,0,0,2,46,0.3333333333333333,0.38082743,6
2020-09-14-171119,171119,0,0,0,46,1.3333333333333333,0.45473057,0
2020-09-15-171119,171119,0,0,4,46,1.0,0.9646056,1
2020-09-16-171119,171119,0,0,0,46,1.8333333333333333,1.1751734,2
2020-09-17-171119,171119,0,0,2,46,12.666666666666664,8.451135,3
2020-09-18-171119,171119,2,0,0,48,2.6666666666666665,1.7169691,4
2020-09-19-171119,171119,1,0,1,49,1.8333333333333333,0.899284,5
2020-09-20-171119,171119,1,0,1,50,1.0,0.58078724,6
2020-09-21-171119,171119,0,1,1,50,1.3333333333333333,0.65847665,0
2020-09-22-171119,171119,4,0,2,54,1.5,1.9549451,1
2020-09-23-171119,171119,3,0,2,57,4.166666666666667,2.141673,2
2020-09-24-171119,171119,0,0,7,57,1.8333333333333333,1.0642697,3
2020-09-25-171119,171119,0,0,3,57,9.166666666666666,2.4565444,4
2020-09-26-171119,171119,0,0,3,57,1.3333333333333333,0.4498128,5
2020-09-27-171119,171119,2,0,1,59,0.16666666666666666,1.0824213,6
2020-09-28-171119,171119,0,0,2,59,0.0,0.15607989,0
2020-09-29-171119,171119,4,0,1,63,1.1666666666666667,1.6456481,1
2020-09-30-171119,171119,0,0,3,63,2.6666666666666665,0.83351827,2
2020-10-01-171119,171119,2,0,13,65,0.8333333333333334,1.0544455,3
2020-10-02-171119,171119,0,0,14,65,2.333333333333333,1.6756486,4
2020-10-03-171119,171119,1,0,9,66,1.0,0.56619155,5
2020-10-04-171119,171119,1,0,1,67,0.5,0.44438303,6
2020-10-05-171119,171119,1,0,1,68,0.8333333333333334,0.7228416,0
2020-10-06-171119,171119,2,0,14,70,1.6666666666666667,0.6380726,1
2020-10-07-171119,171119,2,0,18,72,2.833333333333333,0.8960249,2
2020-10-08-171119,171119,7,0,2,79,3.333333333333333,4.1499715,3
2020-10-09-171119,171119,3,1,12,82,2.1666666666666665,1.7651204,4
2020-10-10-171119,171119,3,0,0,85,3.1666666666666665,1.6433792,5
2020-10-11-171119,171119,1,0,0,86,1.3333333333333333,0.61967874,6
2020-10-12-171119,171119,2,0,4,88,0.16666666666666666,0.9646968,0
2020-10-13-171119,171119,1,0,0,89,1.8333333333333333,0.77507937,1
2020-10-14-171119,171119,3,0,5,92,1.0,2.0325108,2
2020-10-15-171119,171119,13,0,1,105,2.6666666666666665,5.435837,3
2020-10-16-171119,171119,14,0,0,119,1.0,4.8061805,4
2020-10-17-171119,171119,9,0,0,128,0.8333333333333334,4.3714604,5
2020-10-18-171119,171119,1,0,0,129,1.6666666666666667,1.1552916,6
2020-10-19-171119,171119,1,0,0,130,1.6666666666666667,1.0999724,0
2020-10-20-171119,171119,14,0,1,144,1.5,5.563817,1
2020-10-21-171119,171119,18,0,1,162,3.5,8.816719,2
2020-10-22-171119,171119,2,0,3,164,2.0,1.8168888,3
2020-10-23-171119,171119,12,0,0,176,3.8333333333333335,5.531496,4
2020-10-24-171119,171119,0,0,3,176,1.5,0.82637286,5
2020-10-25-171119,171119,0,0,1,176,6.0,1.4776708,6
2020-10-26-171119,171119,4,2,0,180,3.0,2.4493792,0
2020-10-27-171119,171119,0,0,3,180,3.1666666666666665,1.1289957,1
2020-10-28-171119,171119,5,0,2,185,4.5,3.4118361,2
2020-10-29-171119,171119,1,1,0,186,3.8333333333333335,2.0222502,3
2020-10-30-171119,171119,0,1,2,186,9.333333333333334,3.0025933,4
2020-10-31-171119,171119,0,0,0,186,0.8333333333333334,0.4016948,5
2020-11-01-171119,171119,0,1,0,186,6.833333333333332,1.4297231,6
2020-11-02-171119,171119,0,0,0,186,0.6666666666666666,0.31442595,0
2020-11-03-171119,171119,1,2,0,187,4.833333333333333,2.555152,1
2020-11-04-171119,171119,1,0,0,188,4.833333333333333,2.5050547,2
2020-11-05-171119,171119,3,0,0,191,5.166666666666667,3.0459075,3
2020-11-06-171119,171119,0,0,0,191,6.833333333333332,1.9366314,4
2020-11-07-171119,171119,3,0,0,194,2.833333333333333,1.4890096,5
2020-11-08-171119,171119,1,1,0,195,0.6666666666666666,0.5665283,6
2020-11-09-171119,171119,0,1,0,195,2.6666666666666665,1.1777918,0
2020-11-10-171119,171119,3,0,0,198,3.0,1.9311538,1
2020-11-11-171119,171119,2,0,0,200,4.333333333333333,2.7925577,2
2020-11-12-171119,171119,0,0,0,200,6.666666666666668,1.8506777,3
2020-11-13-171119,171119,2,0,0,202,6.666666666666668,1.8952342,4
2020-03-01-171120,171120,0,0,1,0,0.0,0.0004027919,6
2020-03-02-171120,171120,0,0,6,0,0.25,0.7279165,0
2020-03-03-171120,171120,1,0,7,1,0.0,0.0011722883,1
2020-03-04-171120,171120,0,0,24,1,0.0,0.010215318,2
2020-03-05-171120,171120,1,0,23,2,0.25,0.0005790552,3
2020-03-06-171120,171120,1,0,24,3,0.0,0.00070397404,4
2020-03-07-171120,171120,0,0,4,3,0.25,0.7451191,5
2020-03-08-171120,171120,1,0,1,4,0.0,0.0006818945,6
2020-03-09-171120,171120,0,0,24,4,0.5,0.85963845,0
2020-03-10-171120,171120,0,0,19,4,0.0,0.003395297,1
2020-03-11-171120,171120,0,0,10,4,1.0,1.6471263,2
2020-03-12-171120,171120,1,0,13,5,1.25,2.5575695,3
2020-03-13-171120,171120,2,0,17,7,1.0,0.9000838,4
2020-03-14-171120,171120,0,0,1,7,1.0,0.49706534,5
2020-03-15-171120,171120,1,0,2,8,0.0,0.011140405,6
2020-03-16-171120,171120,6,0,13,14,3.5,1.8719168,0
2020-03-17-171120,171120,7,0,15,21,8.75,0.57077,1
2020-03-18-171120,171120,24,1,7,45,7.0,0.88612616,2
2020-03-19-171120,171120,23,1,5,68,9.25,1.1180811,3
2020-03-20-171120,171120,24,1,4,92,10.0,1.912473,4
2020-03-21-171120,171120,4,0,2,96,3.0,0.104220055,5
2020-03-22-171120,171120,1,0,1,97,1.0,0.28986025,6
2020-03-23-171120,171120,24,0,10,121,15.0,1.4304299,0
2020-03-24-171120,171120,19,1,4,140,8.5,0.8876186,1
2020-03-25-171120,171120,10,0,3,150,11.5,2.0970669,2
2020-03-26-171120,171120,13,0,5,163,9.0,1.2567286,3
2020-03-27-171120,171120,17,0,3,180,10.5,2.3899143,4
2020-03-28-171120,171120,1,0,0,181,0.75,0.012388518,5
2020-03-29-171120,171120,2,1,0,183,1.75,0.05157221,6
2020-03-30-171120,171120,13,0,5,196,9.5,2.2352123,0
2020-03-31-171120,171120,15,0,8,211,5.25,0.22000153,1
2020-04-01-171120,171120,7,0,6,218,6.0,2.519893,2
2020-04-02-171120,171120,5,0,4,223,5.0,0.91007155,3
2020-04-03-171120,171120,4,0,9,227,4.0,0.72134644,4
2020-04-04-171120,171120,2,0,0,229,1.5,0.28452915,5
2020-04-05-171120,171120,1,0,1,230,0.75,0.28440782,6
2020-04-06-171120,171120,10,0,10,240,6.25,1.9431052,0
2020-04-07-171120,171120,4,0,1,244,7.25,0.19625005,1
2020-04-08-171120,171120,3,0,5,247,4.75,0.9795232,2
2020-04-09-171120,171120,5,0,0,252,1.75,0.15173674,3
2020-04-10-171120,171120,3,1,7,255,2.0,0.05447619,4
2020-04-11-171120,171120,0,0,1,255,0.25,0.4802786,5
2020-04-12-171120,171120,0,0,2,255,3.25,0.11380461,6
2020-04-13-171120,171120,5,1,7,260,5.0,0.43467498,0
2020-04-14-171120,171120,8,0,10,268,4.75,0.18636575,1
2020-04-15-171120,171120,6,0,11,274,5.5,0.4885657,2
2020-04-16-171120,171120,4,0,10,278,2.25,0.95033294,3
2020-04-17-171120,171120,9,0,1,287,4.75,1.1336746,4
2020-04-18-171120,171120,0,0,0,287,0.75,0.05159026,5
2020-04-19-171120,171120,1,0,0,288,0.0,0.047900565,6
2020-04-20-171120,171120,10,0,8,298,4.25,0.5695542,0
2020-04-21-171120,171120,1,0,9,299,2.5,0.46632415,1
2020-04-22-171120,171120,5,0,10,304,2.75,0.10305577,2
2020-04-23-171120,171120,0,0,2,304,0.25,0.024684316,3
2020-04-24-171120,171120,7,0,11,311,3.5,1.0336623,4
2020-04-25-171120,171120,1,0,0,312,0.25,0.11309363,5
2020-04-26-171120,171120,2,0,0,314,0.5,0.0052357824,6
2020-04-27-171120,171120,7,0,10,321,5.25,2.777486,0
2020-04-28-171120,171120,10,0,9,331,4.0,1.0155015,1
2020-04-29-171120,171120,11,0,3,342,4.25,0.6892082,2
2020-04-30-171120,171120,10,0,6,352,5.0,2.2046635,3
2020-05-01-171120,171120,1,0,8,353,1.0,0.08491519,4
2020-05-02-171120,171120,0,0,1,353,0.0,0.13669972,5
2020-05-03-171120,171120,0,0,0,353,0.0,0.01580103,6
2020-05-04-171120,171120,8,0,6,361,6.5,3.301917,0
2020-05-05-171120,171120,9,0,1,370,4.0,1.3529667,1
2020-05-06-171120,171120,10,0,2,380,16.5,0.8854096,2
2020-05-07-171120,171120,2,0,5,382,3.5,1.5348439,3
2020-05-08-171120,171120,11,0,10,393,5.0,0.92136025,4
2020-05-09-171120,171120,0,0,2,393,0.75,0.42006162,5
2020-05-10-171120,171120,0,0,0,393,0.25,0.0013250986,6
2020-05-11-171120,171120,10,1,4,403,4.25,1.1289363,0
2020-05-12-171120,171120,9,1,3,412,9.0,1.4746736,1
2020-05-13-171120,171120,3,1,0,415,14.0,1.4144906,2
2020-05-14-171120,171120,6,0,0,421,5.75,0.8966321,3
2020-05-15-171120,171120,8,0,1,429,6.5,1.1096113,4
2020-05-16-171120,171120,1,0,0,430,1.25,0.47999874,5
2020-05-17-171120,171120,0,0,0,430,0.25,0.00013665526,6
2020-05-18-171120,171120,6,0,0,436,4.25,0.24108215,0
2020-05-19-171120,171120,1,0,0,437,4.5,2.5233684,1
2020-05-20-171120,171120,2,0,1,439,3.25,0.7788892,2
2020-05-21-171120,171120,5,0,4,444,4.75,4.383975,3
2020-05-22-171120,171120,10,0,0,454,3.0,0.111450344,4
2020-05-23-171120,171120,2,0,0,456,1.0,0.0018006777,5
2020-05-24-171120,171120,0,0,0,456,0.0,0.055973306,6
2020-05-25-171120,171120,4,0,1,460,3.5,2.1887386,0
2020-05-26-171120,171120,3,0,3,463,4.0,1.3470455,1
2020-05-27-171120,171120,0,1,1,463,1.75,1.1192507,2
2020-05-28-171120,171120,0,6,0,463,1.0,0.21410489,3
2020-05-29-171120,171120,1,0,1,464,1.25,1.1325402,4
2020-05-30-171120,171120,0,0,0,464,0.0,0.00050757814,5
2020-05-31-171120,171120,0,0,0,464,0.0,0.0020364553,6
2020-06-01-171120,171120,0,0,1,464,0.0,0.011956621,0
2020-06-02-171120,171120,0,0,2,464,1.25,0.09056991,1
2020-06-03-171120,171120,1,0,0,465,2.25,0.028966418,2
2020-06-04-171120,171120,4,0,0,469,0.25,0.6466786,3
2020-06-05-171120,171120,0,0,3,469,1.5,0.028531227,4
2020-06-06-171120,171120,0,0,0,469,0.0,0.11102226,5
2020-06-07-171120,171120,0,1,0,469,0.0,0.00045086717,6
2020-06-08-171120,171120,1,0,2,470,1.75,2.300326,0
2020-06-09-171120,171120,3,0,0,473,1.0,0.60759586,1
2020-06-10-171120,171120,1,0,0,474,0.5,0.32384577,2
2020-06-11-171120,171120,0,0,1,474,0.5,1.7434175,3
2020-06-12-171120,171120,1,0,2,475,0.75,0.13344839,4
2020-06-13-171120,171120,0,1,1,475,0.0,0.0008557924,5
2020-06-14-171120,171120,0,0,0,475,0.25,0.00010675455,6
2020-06-15-171120,171120,1,3,0,476,2.25,0.59639496,0
2020-06-16-171120,171120,2,0,1,478,0.75,0.009669503,1
2020-06-17-171120,171120,0,0,0,478,0.5,0.026987772,2
2020-06-18-171120,171120,0,0,1,478,1.0,0.039679766,3
2020-06-19-171120,171120,3,0,1,481,1.0,1.4416965,4
2020-06-20-171120,171120,0,1,0,481,0.0,0.03178518,5
2020-06-21-171120,171120,0,0,0,481,0.0,0.0004560302,6
2020-06-22-171120,171120,2,0,0,483,0.25,0.009263748,0
2020-06-23-171120,171120,0,0,0,483,1.5,0.036225893,1
2020-06-24-171120,171120,0,1,0,483,0.75,0.057423823,2
2020-06-25-171120,171120,1,0,0,484,0.25,0.04901199,3
2020-06-26-171120,171120,2,0,0,486,0.25,0.15351616,4
2020-06-27-171120,171120,1,0,0,487,0.0,0.0030057286,5
2020-06-28-171120,171120,0,0,0,487,0.0,0.013322954,6
2020-06-29-171120,171120,0,0,0,487,0.25,0.018154662,0
2020-06-30-171120,171120,1,0,0,488,0.25,0.037078552,1
2020-07-01-171120,171120,0,0,0,488,0.0,0.0041193324,2
2020-07-02-171120,171120,1,0,0,489,0.5,0.0411684,3
2020-07-03-171120,171120,1,0,0,490,0.5,0.017445821,4
2020-07-04-171120,171120,0,0,0,490,0.0,0.014262804,5
2020-07-05-171120,171120,0,0,0,490,0.0,0.0047428706,6
2020-07-06-171120,171120,0,0,0,490,0.5,0.6223688,0
2020-07-07-171120,171120,0,0,0,490,0.0,0.00087617943,1
2020-07-08-171120,171120,0,0,1,490,0.0,0.0062089907,2
2020-07-09-171120,171120,0,0,0,490,0.25,0.00730504,3
2020-07-10-171120,171120,0,1,0,490,0.0,0.26670164,4
2020-07-11-171120,171120,0,0,0,490,0.0,0.00065645017,5
2020-07-12-171120,171120,0,0,0,490,0.25,0.0016611277,6
2020-07-13-171120,171120,0,0,1,490,0.25,0.033126805,0
2020-07-14-171120,171120,0,0,0,490,0.0,0.04505937,1
2020-07-15-171120,171120,0,0,0,490,0.25,0.004374777,2
2020-07-16-171120,171120,0,0,0,490,0.0,0.01719365,3
2020-07-17-171120,171120,0,0,2,490,0.5,0.019482054,4
2020-07-18-171120,171120,0,0,2,490,0.0,0.04236897,5
2020-07-19-171120,171120,0,0,0,490,0.0,0.0016793427,6
2020-07-20-171120,171120,0,0,3,490,0.0,0.008421698,0
2020-07-21-171120,171120,0,0,0,490,0.0,0.008545166,1
2020-07-22-171120,171120,1,0,0,491,0.0,0.04582469,2
2020-07-23-171120,171120,0,0,1,491,0.0,0.020376906,3
2020-07-24-171120,171120,0,0,0,491,0.0,0.023109335,4
2020-07-25-171120,171120,0,0,1,491,0.0,0.00050024013,5
2020-07-26-171120,171120,0,0,0,491,0.0,0.0003159635,6
2020-07-27-171120,171120,1,0,5,492,0.25,0.6172586,0
2020-07-28-171120,171120,0,0,1,492,0.25,0.00694208,1
2020-07-29-171120,171120,0,0,3,492,0.0,0.041679233,2
2020-07-30-171120,171120,0,0,0,492,0.5,0.089688815,3
2020-07-31-171120,171120,2,0,3,494,1.75,1.2807603,4
2020-08-01-171120,171120,2,0,2,496,0.0,0.006846532,5
2020-08-02-171120,171120,0,0,5,496,0.0,0.010404507,6
2020-08-03-171120,171120,3,0,1,499,0.75,0.18873844,0
2020-08-04-171120,171120,0,0,3,499,0.25,0.024651103,1
2020-08-05-171120,171120,0,0,0,499,0.0,0.023438938,2
2020-08-06-171120,171120,1,0,1,500,0.5,0.024201399,3
2020-08-07-171120,171120,0,0,2,500,0.75,0.8500314,4
2020-08-08-171120,171120,1,0,0,501,0.0,0.013439955,5
2020-08-09-171120,171120,0,0,0,501,0.0,0.1912638,6
2020-08-10-171120,171120,5,0,3,506,0.75,0.1689899,0
2020-08-11-171120,171120,1,0,2,507,1.0,0.37966034,1
2020-08-12-171120,171120,3,0,0,510,1.75,0.6459009,2
2020-08-13-171120,171120,0,0,3,510,0.5,4.8052573,3
2020-08-14-171120,171120,3,0,2,513,1.25,1.8715844,4
2020-08-15-171120,171120,2,0,1,515,0.25,0.14051577,5
2020-08-16-171120,171120,5,0,0,520,0.5,0.06982197,6
2020-08-17-171120,171120,1,0,4,521,0.75,0.29376587,0
2020-08-18-171120,171120,3,0,1,524,5.75,5.717599,1
2020-08-19-171120,171120,0,0,9,524,0.75,0.11769061,2
2020-08-20-171120,171120,1,0,0,525,1.5,0.16991724,3
2020-08-21-171120,171120,2,0,5,527,1.5,0.85531956,4
2020-08-22-171120,171120,0,0,1,527,0.25,0.29422742,5
2020-08-23-171120,171120,0,0,3,527,0.0,0.09060721,6
2020-08-24-171120,171120,3,0,4,530,2.25,1.8954668,0
2020-08-25-171120,171120,2,0,12,532,2.75,0.23497087,1
2020-08-26-171120,171120,0,0,1,532,1.25,0.77540445,2
2020-08-27-171120,171120,3,0,9,535,1.75,0.5426429,3
2020-08-28-171120,171120,2,1,1,537,1.0,0.7317937,4
2020-08-29-171120,171120,1,1,6,538,0.5,0.7487017,5
2020-08-30-171120,171120,0,0,0,538,1.5,0.042898998,6
2020-08-31-171120,171120,4,0,11,542,1.75,0.21633549,0
2020-09-01-171120,171120,1,0,4,543,3.0,2.883715,1
2020-09-02-171120,171120,9,0,6,552,3.0,2.030789,2
2020-09-03-171120,171120,0,0,15,552,2.0,0.20346771,3
2020-09-04-171120,171120,5,0,12,557,3.75,2.2865796,4
2020-09-05-171120,171120,1,0,9,558,3.25,0.13972418,5
2020-09-06-171120,171120,3,0,2,561,3.0,0.541802,6
2020-09-07-171120,171120,4,0,6,565,0.75,0.98944086,0
2020-09-08-171120,171120,12,0,2,577,4.25,2.2759004,1
2020-09-09-171120,171120,1,0,11,578,0.0,0.22580421,2
2020-09-10-171120,171120,9,0,5,587,7.25,3.897431,3
2020-09-11-171120,171120,1,0,5,588,1.25,2.3776577,4
2020-09-12-171120,171120,6,0,2,594,2.75,0.7276966,5
2020-09-13-171120,171120,0,0,1,594,2.0,0.48731214,6
2020-09-14-171120,171120,11,0,2,605,2.75,3.2934413,0
2020-09-15-171120,171120,4,0,0,609,3.0,2.2559144,1
2020-09-16-171120,171120,6,1,6,615,2.5,4.2278047,2
2020-09-17-171120,171120,15,1,1,630,4.0,8.745664,3
2020-09-18-171120,171120,12,0,4,642,7.0,6.391554,4
2020-09-19-171120,171120,9,1,0,651,0.75,0.46553993,5
2020-09-20-171120,171120,2,0,0,653,5.0,0.79478234,6
2020-09-21-171120,171120,6,2,2,659,4.25,1.8188663,0
2020-09-22-171120,171120,2,0,7,661,1.5,0.5728374,1
2020-09-23-171120,171120,11,1,7,672,4.75,2.0967312,2
2020-09-24-171120,171120,5,0,3,677,3.75,2.7671273,3
2020-09-25-171120,171120,5,1,8,682,4.5,1.655318,4
2020-09-26-171120,171120,2,0,0,684,3.75,1.0870656,5
2020-09-27-171120,171120,1,0,1,685,3.75,4.0827603,6
2020-09-28-171120,171120,2,0,0,687,1.75,0.51434994,0
2020-09-29-171120,171120,0,0,6,687,2.0,0.41438854,1
2020-09-30-171120,171120,6,0,4,693,4.75,1.480482,2
2020-10-01-171120,171120,1,0,7,694,7.0,1.138166,3
2020-10-02-171120,171120,4,0,20,698,3.75,2.7970724,4
2020-10-03-171120,171120,0,0,4,698,1.0,1.4479687,5
2020-10-04-171120,171120,0,0,4,698,0.5,0.20670632,6
2020-10-05-171120,171120,2,1,14,700,3.25,0.6266093,0
2020-10-06-171120,171120,7,0,10,707,3.25,5.548398,1
2020-10-07-171120,171120,7,0,14,714,2.25,1.5911937,2
2020-10-08-171120,171120,3,0,22,717,1.5,2.1238415,3
2020-10-09-171120,171120,8,2,17,725,2.75,2.379461,4
2020-10-10-171120,171120,0,0,13,725,1.0,1.8585867,5
2020-10-11-171120,171120,1,0,1,726,2.5,2.181978,6
2020-10-12-171120,171120,0,0,32,726,2.25,0.68401164,0
2020-10-13-171120,171120,6,0,13,732,1.75,0.9411502,1
2020-10-14-171120,171120,4,0,15,736,5.5,9.581476,2
2020-10-15-171120,171120,7,0,21,743,3.75,5.044078,3
2020-10-16-171120,171120,20,0,25,763,11.25,25.755684,4
2020-10-17-171120,171120,4,0,3,767,1.25,1.9716442,5
2020-10-18-171120,171120,4,0,8,771,2.25,2.2306678,6
2020-10-19-171120,171120,14,1,2,785,9.75,3.0145268,0
2020-10-20-171120,171120,10,0,15,795,11.25,12.018303,1
2020-10-21-171120,171120,14,0,21,809,6.5,4.4260798,2
2020-10-22-171120,171120,22,0,30,831,10.0,7.484096,3
2020-10-23-171120,171120,17,0,27,848,15.75,10.177254,4
2020-10-24-171120,171120,13,0,8,861,5.5,1.8337182,5
2020-10-25-171120,171120,1,1,3,862,1.75,1.4578319,6
2020-10-26-171120,171120,32,1,37,894,11.75,8.629033,0
2020-10-27-171120,171120,13,3,46,907,8.5,3.4505463,1
2020-10-28-171120,171120,15,0,12,922,8.0,5.644908,2
2020-10-29-171120,171120,21,0,21,943,6.5,8.586436,3
2020-10-30-171120,171120,25,0,14,968,23.25,20.05257,4
2020-10-31-171120,171120,3,1,0,971,2.25,1.6347497,5
2020-11-01-171120,171120,8,1,0,979,4.25,1.5323143,6
2020-11-02-171120,171120,2,0,0,981,4.0,2.2415714,0
2020-11-03-171120,171120,15,1,0,996,11.25,7.756179,1
2020-11-04-171120,171120,21,1,0,1017,12.75,11.297953,2
2020-11-05-171120,171120,30,1,0,1047,10.25,11.643312,3
2020-11-06-171120,171120,27,3,0,1074,28.25,28.81097,4
2020-11-07-171120,171120,8,1,0,1082,5.25,0.7830237,5
2020-11-08-171120,171120,3,1,0,1085,5.0,1.0725151,6
2020-11-09-171120,171120,37,2,0,1122,13.75,10.932297,0
2020-11-10-171120,171120,46,0,0,1168,11.75,4.8772683,1
2020-11-11-171120,171120,12,2,0,1180,9.5,8.119549,2
2020-11-12-171120,171120,21,0,0,1201,8.25,4.7857103,3
2020-11-13-171120,171120,14,0,0,1215,26.5,1.9903123,4
2020-03-01-171121,171121,0,0,0,0,0.0,0.0001531568,6
2020-03-02-171121,171121,0,1,2,0,0.14285714285714285,0.28690147,0
2020-03-03-171121,171121,0,1,2,0,0.0,0.0005308299,1
2020-03-04-171121,171121,0,0,3,0,0.0,0.023862412,2
2020-03-05-171121,171121,0,0,3,0,0.0,0.00062168215,3
2020-03-06-171121,171121,0,0,0,0,0.0,0.0009740249,4
2020-03-07-171121,171121,1,0,1,1,0.14285714285714285,0.34833944,5
2020-03-08-171121,171121,0,0,0,1,0.0,0.0009918502,6
2020-03-09-171121,171121,1,0,5,2,0.14285714285714285,0.39740187,0
2020-03-10-171121,171121,0,0,1,2,0.0,0.003358397,1
2020-03-11-171121,171121,1,0,3,3,0.42857142857142855,0.7293259,2
2020-03-12-171121,171121,3,0,2,6,0.42857142857142855,1.1971647,3
2020-03-13-171121,171121,1,0,3,7,0.14285714285714285,0.5051432,4
2020-03-14-171121,171121,1,0,0,8,0.14285714285714285,0.2959469,5
2020-03-15-171121,171121,0,0,1,8,0.2857142857142857,0.041538984,6
2020-03-16-171121,171121,2,0,3,10,1.2857142857142858,1.3055168,0
2020-03-17-171121,171121,2,0,2,12,0.5714285714285714,0.48978725,1
2020-03-18-171121,171121,3,0,3,15,1.5714285714285714,1.1360675,2
2020-03-19-171121,171121,3,0,4,18,1.4285714285714286,1.0640241,3
2020-03-20-171121,171121,0,0,4,18,2.0,1.2750843,4
2020-03-21-171121,171121,1,0,0,19,1.0,0.27416378,5
2020-03-22-171121,171121,0,0,1,19,0.5714285714285714,0.24726182,6
2020-03-23-171121,171121,5,0,5,24,3.2857142857142856,1.7833741,0
2020-03-24-171121,171121,1,0,1,25,1.1428571428571428,0.71534216,1
2020-03-25-171121,171121,3,0,9,28,2.7142857142857144,1.8043121,2
2020-03-26-171121,171121,2,0,2,30,2.0,1.0287465,3
2020-03-27-171121,171121,3,0,2,33,3.1428571428571432,1.9052119,4
2020-03-28-171121,171121,0,0,3,33,0.14285714285714285,0.02825735,5
2020-03-29-171121,171121,1,0,3,34,0.5714285714285714,0.16498938,6
2020-03-30-171121,171121,3,0,4,37,3.0,1.611155,0
2020-03-31-171121,171121,2,0,0,39,1.1428571428571428,0.4774957,1
2020-04-01-171121,171121,3,0,1,42,2.571428571428572,1.6594739,2
2020-04-02-171121,171121,4,0,13,46,1.2857142857142858,0.8208281,3
2020-04-03-171121,171121,4,0,3,50,1.4285714285714286,0.92198366,4
2020-04-04-171121,171121,0,0,0,50,0.7142857142857143,0.18076874,5
2020-04-05-171121,171121,1,0,0,51,0.2857142857142857,0.24000873,6
2020-04-06-171121,171121,5,0,2,56,2.4285714285714284,1.631873,0
2020-04-07-171121,171121,1,0,0,57,1.0,0.35952765,1
2020-04-08-171121,171121,9,0,0,66,0.7142857142857143,1.0851126,2
2020-04-09-171121,171121,2,1,0,68,1.1428571428571428,0.3945466,3
2020-04-10-171121,171121,2,0,2,70,1.4285714285714286,0.19742244,4
2020-04-11-171121,171121,3,0,2,73,1.2857142857142858,0.5582333,5
2020-04-12-171121,171121,3,0,0,76,0.42857142857142855,0.26118988,6
2020-04-13-171121,171121,4,0,1,80,2.0,0.8076118,0
2020-04-14-171121,171121,0,0,3,80,2.142857142857143,0.46201575,1
2020-04-15-171121,171121,1,0,6,81,0.42857142857142855,0.43753326,2
2020-04-16-171121,171121,13,0,7,94,1.7142857142857142,1.5865107,3
2020-04-17-171121,171121,3,0,1,97,1.1428571428571428,1.008714,4
2020-04-18-171121,171121,0,0,2,97,0.2857142857142857,0.08321977,5
2020-04-19-171121,171121,0,0,0,97,0.5714285714285714,0.10928343,6
2020-04-20-171121,171121,2,0,0,99,1.1428571428571428,0.628687,0
2020-04-21-171121,171121,0,0,1,99,0.7142857142857143,0.446827,1
2020-04-22-171121,171121,0,0,3,99,0.5714285714285714,0.19915943,2
2020-04-23-171121,171121,0,0,5,99,0.2857142857142857,0.11653656,3
2020-04-24-171121,171121,2,0,2,101,2.142857142857143,0.999812,4
2020-04-25-171121,171121,2,0,1,103,0.2857142857142857,0.2181223,5
2020-04-26-171121,171121,0,0,0,103,0.14285714285714285,0.017355707,6
2020-04-27-171121,171121,1,0,1,104,2.2857142857142856,1.7185082,0
2020-04-28-171121,171121,3,0,4,107,0.5714285714285714,0.7639176,1
2020-04-29-171121,171121,6,0,4,113,1.1428571428571428,0.9830476,2
2020-04-30-171121,171121,7,0,0,120,1.4285714285714286,1.633928,3
2020-05-01-171121,171121,1,0,1,121,0.2857142857142857,0.14818445,4
2020-05-02-171121,171121,2,0,3,123,0.42857142857142855,0.29311597,5
2020-05-03-171121,171121,0,0,0,123,0.14285714285714285,0.056066073,6
2020-05-04-171121,171121,0,0,1,123,3.0,2.1188474,0
2020-05-05-171121,171121,1,0,0,124,2.2857142857142856,1.3343799,1
2020-05-06-171121,171121,3,0,1,127,10.285714285714286,2.593724,2
2020-05-07-171121,171121,5,0,0,132,3.2857142857142856,1.7158153,3
2020-05-08-171121,171121,2,0,0,134,3.0,1.2640667,4
2020-05-09-171121,171121,1,0,0,135,0.14285714285714285,0.29156536,5
2020-05-10-171121,171121,0,1,1,135,0.0,0.002953663,6
2020-05-11-171121,171121,1,0,0,136,1.2857142857142858,0.8636768,0
2020-05-12-171121,171121,4,0,6,140,3.571428571428572,1.5446789,1
2020-05-13-171121,171121,4,0,0,144,1.5714285714285714,1.2963259,2
2020-05-14-171121,171121,0,1,0,144,0.7142857142857143,0.5586395,3
2020-05-15-171121,171121,1,0,0,145,1.1428571428571428,0.8062985,4
2020-05-16-171121,171121,3,0,0,148,0.14285714285714285,0.35039043,5
2020-05-17-171121,171121,0,0,0,148,0.0,2.2547832e-05,6
2020-05-18-171121,171121,1,0,0,149,1.4285714285714286,0.50084186,0
2020-05-19-171121,171121,0,0,0,149,2.571428571428572,1.7004598,1
2020-05-20-171121,171121,1,0,0,150,1.8571428571428568,0.8469077,2
2020-05-21-171121,171121,0,0,0,150,2.571428571428572,2.3335829,3
2020-05-22-171121,171121,0,0,0,150,1.4285714285714286,0.30548412,4
2020-05-23-171121,171121,0,0,1,150,0.0,0.0012894429,5
2020-05-24-171121,171121,1,0,0,151,0.0,0.09026447,6
2020-05-25-171121,171121,0,0,0,151,0.5714285714285714,1.222291,0
2020-05-26-171121,171121,6,0,0,157,0.7142857142857143,1.2124182,1
2020-05-27-171121,171121,0,0,1,157,0.42857142857142855,0.57882345,2
2020-05-28-171121,171121,0,0,0,157,1.7142857142857142,0.4634145,3
2020-05-29-171121,171121,0,0,1,157,0.42857142857142855,0.59220874,4
2020-05-30-171121,171121,0,0,0,157,0.0,0.0029344037,5
2020-05-31-171121,171121,0,0,0,157,0.0,0.0038431713,6
2020-06-01-171121,171121,0,0,0,157,0.0,0.043876298,0
2020-06-02-171121,171121,0,0,0,157,0.42857142857142855,0.194856,1
2020-06-03-171121,171121,0,0,0,157,0.0,0.059592783,2
2020-06-04-171121,171121,0,0,0,157,0.7142857142857143,0.47055665,3
2020-06-05-171121,171121,0,0,1,157,0.0,0.052157372,4
2020-06-06-171121,171121,1,0,0,158,0.14285714285714285,0.15116256,5
2020-06-07-171121,171121,0,0,0,158,0.0,0.002025891,6
2020-06-08-171121,171121,0,1,0,158,0.5714285714285714,1.1209745,0
2020-06-09-171121,171121,0,0,0,158,0.14285714285714285,0.3282729,1
2020-06-10-171121,171121,1,0,0,159,0.7142857142857143,0.43145078,2
2020-06-11-171121,171121,0,0,0,159,0.2857142857142857,0.8836381,3
2020-06-12-171121,171121,1,0,1,160,0.0,0.15334052,4
2020-06-13-171121,171121,0,0,0,160,0.0,0.0019860412,5
2020-06-14-171121,171121,0,0,0,160,0.0,0.0008043655,6
2020-06-15-171121,171121,0,0,0,160,0.42857142857142855,0.31258684,0
2020-06-16-171121,171121,0,0,0,160,0.0,0.025065836,1
2020-06-17-171121,171121,0,0,0,160,0.0,0.046542667,2
2020-06-18-171121,171121,0,0,0,160,0.14285714285714285,0.08584749,3
2020-06-19-171121,171121,1,0,0,161,0.2857142857142857,0.8352109,4
2020-06-20-171121,171121,0,0,0,161,0.14285714285714285,0.06915563,5
2020-06-21-171121,171121,0,0,0,161,0.0,0.00080571556,6
2020-06-22-171121,171121,0,0,0,161,0.14285714285714285,0.016501725,0
2020-06-23-171121,171121,0,1,0,161,0.0,0.054561615,1
2020-06-24-171121,171121,0,0,0,161,0.14285714285714285,0.102428265,2
2020-06-25-171121,171121,0,0,0,161,0.14285714285714285,0.07798536,3
2020-06-26-171121,171121,1,0,0,162,0.0,0.15466915,4
2020-06-27-171121,171121,0,0,0,162,0.0,0.007581968,5
2020-06-28-171121,171121,0,0,0,162,0.0,0.016233541,6
2020-06-29-171121,171121,0,0,0,162,0.0,0.03066077,0
2020-06-30-171121,171121,0,0,0,162,0.14285714285714285,0.08702995,1
2020-07-01-171121,171121,0,0,0,162,0.0,0.0072016446,2
2020-07-02-171121,171121,0,0,0,162,0.14285714285714285,0.07848872,3
2020-07-03-171121,171121,0,0,0,162,0.14285714285714285,0.025252573,4
2020-07-04-171121,171121,0,0,0,162,0.0,0.014036374,5
2020-07-05-171121,171121,0,0,0,162,0.0,0.011247933,6
2020-07-06-171121,171121,0,0,0,162,0.14285714285714285,0.31855744,0
2020-07-07-171121,171121,0,0,0,162,0.0,0.0024217688,1
2020-07-08-171121,171121,0,0,0,162,0.0,0.0068985685,2
2020-07-09-171121,171121,0,0,0,162,0.0,0.011248242,3
2020-07-10-171121,171121,0,0,0,162,0.2857142857142857,0.3218267,4
2020-07-11-171121,171121,0,0,0,162,0.0,0.001291262,5
2020-07-12-171121,171121,0,0,0,162,0.0,0.002757343,6
2020-07-13-171121,171121,0,0,0,162,0.0,0.041190527,0
2020-07-14-171121,171121,0,0,0,162,0.14285714285714285,0.07929318,1
2020-07-15-171121,171121,0,0,0,162,0.0,0.0088618705,2
2020-07-16-171121,171121,0,0,0,162,0.0,0.023449345,3
2020-07-17-171121,171121,0,0,0,162,0.0,0.031240325,4
2020-07-18-171121,171121,0,1,0,162,0.0,0.0530699,5
2020-07-19-171121,171121,0,0,0,162,0.0,0.00086746586,6
2020-07-20-171121,171121,0,0,1,162,0.0,0.01789099,0
2020-07-21-171121,171121,0,0,0,162,0.0,0.024672357,1
2020-07-22-171121,171121,0,0,0,162,0.0,0.051942494,2
2020-07-23-171121,171121,0,0,0,162,0.0,0.13167703,3
2020-07-24-171121,171121,0,0,1,162,0.14285714285714285,0.05008363,4
2020-07-25-171121,171121,0,0,0,162,0.0,0.0012126507,5
2020-07-26-171121,171121,0,0,1,162,0.0,0.0009907315,6
2020-07-27-171121,171121,0,0,1,162,0.14285714285714285,0.33395144,0
2020-07-28-171121,171121,0,0,0,162,0.0,0.018170746,1
2020-07-29-171121,171121,0,0,0,162,0.14285714285714285,0.08148976,2
2020-07-30-171121,171121,0,0,6,162,0.0,0.13265452,3
2020-07-31-171121,171121,0,0,4,162,0.42857142857142855,0.71619266,4
2020-08-01-171121,171121,0,0,1,162,0.0,0.006412036,5
2020-08-02-171121,171121,0,0,0,162,0.0,0.02062491,6
2020-08-03-171121,171121,1,0,1,163,0.14285714285714285,0.20916484,0
2020-08-04-171121,171121,0,0,1,163,0.14285714285714285,0.047126293,1
2020-08-05-171121,171121,0,0,0,163,0.0,0.02656553,2
2020-08-06-171121,171121,0,0,0,163,0.0,0.028485652,3
2020-08-07-171121,171121,1,0,0,164,0.42857142857142855,0.62724936,4
2020-08-08-171121,171121,0,0,0,164,0.0,0.023085136,5
2020-08-09-171121,171121,1,0,0,165,0.14285714285714285,0.24202594,6
2020-08-10-171121,171121,1,0,2,166,0.0,0.18096271,0
2020-08-11-171121,171121,0,0,1,166,0.42857142857142855,0.5002653,1
2020-08-12-171121,171121,0,0,2,166,0.7142857142857143,0.5481856,2
2020-08-13-171121,171121,6,0,0,172,0.14285714285714285,3.454114,3
2020-08-14-171121,171121,4,0,0,176,0.14285714285714285,1.3675421,4
2020-08-15-171121,171121,1,0,0,177,0.2857142857142857,0.28351635,5
2020-08-16-171121,171121,0,0,0,177,0.14285714285714285,0.11205821,6
2020-08-17-171121,171121,1,0,0,178,0.42857142857142855,0.4115957,0
2020-08-18-171121,171121,1,0,1,179,1.5714285714285714,3.0888033,1
2020-08-19-171121,171121,0,0,0,179,0.14285714285714285,0.20885637,2
2020-08-20-171121,171121,0,0,0,179,0.14285714285714285,0.27452138,3
2020-08-21-171121,171121,0,0,2,179,0.5714285714285714,0.6699712,4
2020-08-22-171121,171121,0,0,1,179,0.2857142857142857,0.41540423,5
2020-08-23-171121,171121,0,0,0,179,0.2857142857142857,0.14361243,6
2020-08-24-171121,171121,2,0,2,181,0.8571428571428571,1.4693203,0
2020-08-25-171121,171121,1,0,3,182,0.14285714285714285,0.31725383,1
2020-08-26-171121,171121,2,0,0,184,0.42857142857142855,1.0976589,2
2020-08-27-171121,171121,0,0,4,184,0.8571428571428571,0.6521476,3
2020-08-28-171121,171121,0,0,0,184,0.14285714285714285,0.5369394,4
2020-08-29-171121,171121,0,0,1,184,1.2857142857142858,1.0654424,5
2020-08-30-171121,171121,0,0,0,184,0.0,0.07762851,6
2020-08-31-171121,171121,0,0,2,184,0.14285714285714285,0.22856411,0
2020-09-01-171121,171121,1,0,5,185,0.5714285714285714,1.5070941,1
2020-09-02-171121,171121,0,0,1,185,0.8571428571428571,1.1379423,2
2020-09-03-171121,171121,0,0,3,185,0.42857142857142855,0.24708895,3
2020-09-04-171121,171121,2,0,7,187,0.2857142857142857,1.3629714,4
2020-09-05-171121,171121,1,0,1,188,0.2857142857142857,0.18457426,5
2020-09-06-171121,171121,0,0,2,188,0.7142857142857143,0.33151063,6
2020-09-07-171121,171121,2,0,2,190,1.8571428571428568,1.2237295,0
2020-09-08-171121,171121,3,0,0,193,1.0,1.6890435,1
2020-09-09-171121,171121,0,0,4,193,0.2857142857142857,0.2761471,2
2020-09-10-171121,171121,4,0,8,197,0.7142857142857143,2.2698746,3
2020-09-11-171121,171121,0,0,4,197,0.5714285714285714,1.4980767,4
2020-09-12-171121,171121,1,0,7,198,1.7142857142857142,0.6833316,5
2020-09-13-171121,171121,0,0,9,198,1.1428571428571428,0.75501883,6
2020-09-14-171121,171121,2,0,1,200,0.7142857142857143,1.8155413,0
2020-09-15-171121,171121,5,0,0,205,1.0,1.5588186,1
2020-09-16-171121,171121,1,0,9,206,1.5714285714285714,2.4715395,2
2020-09-17-171121,171121,3,0,0,209,9.857142857142858,8.794458,3
2020-09-18-171121,171121,7,0,9,216,3.1428571428571432,3.93728,4
2020-09-19-171121,171121,1,0,0,217,1.2857142857142858,0.74709904,5
2020-09-20-171121,171121,2,0,1,219,0.7142857142857143,0.7170327,6
2020-09-21-171121,171121,2,0,0,221,0.8571428571428571,1.9825096,0
2020-09-22-171121,171121,0,0,3,221,1.0,0.761083,1
2020-09-23-171121,171121,4,0,0,225,2.142857142857143,2.0625134,2
2020-09-24-171121,171121,8,0,1,233,3.4285714285714284,2.9731343,3
2020-09-25-171121,171121,4,0,1,237,5.428571428571429,1.8929609,4
2020-09-26-171121,171121,7,0,1,244,1.5714285714285714,1.5126916,5
2020-09-27-171121,171121,9,0,0,253,1.2857142857142858,2.622302,6
2020-09-28-171121,171121,1,0,1,254,2.0,0.7174941,0
2020-09-29-171121,171121,0,0,0,254,1.7142857142857142,0.72500366,1
2020-09-30-171121,171121,9,0,3,263,2.0,1.974716,2
2020-10-01-171121,171121,0,0,3,263,1.4285714285714286,1.0032678,3
2020-10-02-171121,171121,9,0,1,272,1.4285714285714286,2.110475,4
2020-10-03-171121,171121,0,0,2,272,0.7142857142857143,1.0138593,5
2020-10-04-171121,171121,1,0,1,273,0.8571428571428571,0.36191913,6
2020-10-05-171121,171121,0,0,0,273,1.8571428571428568,0.86219645,0
2020-10-06-171121,171121,3,0,2,276,2.7142857142857144,2.9965737,1
2020-10-07-171121,171121,0,1,3,276,0.8571428571428571,0.94709706,2
2020-10-08-171121,171121,1,0,5,277,1.2857142857142858,1.6957185,3
2020-10-09-171121,171121,1,1,6,278,1.2857142857142858,1.307554,4
2020-10-10-171121,171121,1,0,1,279,0.7142857142857143,1.124379,5
2020-10-11-171121,171121,0,0,4,279,0.7142857142857143,1.1953032,6
2020-10-12-171121,171121,1,0,4,280,0.7142857142857143,0.5823905,0
2020-10-13-171121,171121,0,0,5,280,0.2857142857142857,0.5490426,1
2020-10-14-171121,171121,3,0,6,283,1.2857142857142858,4.491317,2
2020-10-15-171121,171121,3,0,9,286,1.2857142857142858,2.9303179,3
2020-10-16-171121,171121,1,0,17,287,3.0,11.158166,4
2020-10-17-171121,171121,2,0,3,289,0.7142857142857143,1.3740561,5
2020-10-18-171121,171121,1,1,1,290,1.1428571428571428,1.3041818,6
2020-10-19-171121,171121,0,0,0,290,2.2857142857142856,1.734139,0
2020-10-20-171121,171121,2,0,2,292,4.571428571428571,6.337989,1
2020-10-21-171121,171121,3,0,8,295,2.2857142857142856,3.609469,2
2020-10-22-171121,171121,5,0,6,300,4.285714285714286,5.0081735,3
2020-10-23-171121,171121,6,0,7,306,4.285714285714286,5.315113,4
2020-10-24-171121,171121,1,1,6,307,1.8571428571428568,1.1407626,5
2020-10-25-171121,171121,4,0,2,311,1.7142857142857142,1.3493868,6
2020-10-26-171121,171121,4,0,4,315,4.714285714285714,4.5447736,0
2020-10-27-171121,171121,5,0,10,320,2.8571428571428568,2.3524208,1
2020-10-28-171121,171121,6,0,10,326,3.4285714285714284,3.6843507,2
2020-10-29-171121,171121,9,0,10,335,2.142857142857143,4.50193,3
2020-10-30-171121,171121,17,1,6,352,7.428571428571429,10.272015,4
2020-10-31-171121,171121,3,3,0,355,0.5714285714285714,1.1441941,5
2020-11-01-171121,171121,1,1,0,356,2.0,1.6169674,6
2020-11-02-171121,171121,0,2,0,356,1.5714285714285714,1.1609265,0
2020-11-03-171121,171121,2,1,0,358,6.428571428571429,4.630781,1
2020-11-04-171121,171121,8,1,0,366,6.142857142857142,6.090271,2
2020-11-05-171121,171121,6,2,0,372,4.0,6.0423107,3
2020-11-06-171121,171121,7,3,0,379,9.142857142857142,13.112563,4
2020-11-07-171121,171121,6,0,0,385,0.7142857142857143,1.0339627,5
2020-11-08-171121,171121,2,0,0,387,1.0,0.79454136,6
2020-11-09-171121,171121,4,0,0,391,3.4285714285714284,5.1282763,0
2020-11-10-171121,171121,10,0,0,401,2.571428571428572,3.160933,1
2020-11-11-171121,171121,10,1,0,411,4.0,4.7783813,2
2020-11-12-171121,171121,10,0,0,421,2.142857142857143,3.09585,3
2020-11-13-171121,171121,6,3,0,427,2.7142857142857144,1.8534753,4
2020-03-01-171122,171122,0,0,0,0,0.0,0.000886456,6
2020-03-02-171122,171122,1,0,4,1,0.0,2.8780944,0
2020-03-03-171122,171122,0,0,1,1,0.1111111111111111,0.0033265986,1
2020-03-04-171122,171122,0,0,1,1,0.0,0.040743854,2
2020-03-05-171122,171122,0,1,2,1,0.2222222222222222,0.0058843764,3
2020-03-06-171122,171122,0,1,4,1,0.1111111111111111,0.004559709,4
2020-03-07-171122,171122,1,0,0,2,0.1111111111111111,2.9979777,5
2020-03-08-171122,171122,0,0,1,2,0.1111111111111111,0.004008191,6
2020-03-09-171122,171122,1,0,2,3,0.2222222222222222,3.468069,0
2020-03-10-171122,171122,0,0,2,3,0.0,0.01650194,1
2020-03-11-171122,171122,2,0,5,5,0.5555555555555556,6.7640944,2
2020-03-12-171122,171122,3,0,5,8,0.6666666666666666,10.406813,3
2020-03-13-171122,171122,1,0,6,9,1.1111111111111112,3.9000385,4
2020-03-14-171122,171122,1,0,0,10,0.4444444444444444,2.1951458,5
2020-03-15-171122,171122,0,0,0,10,0.3333333333333333,0.06372231,6
2020-03-16-171122,171122,4,0,6,14,2.555555555555556,8.418511,0
2020-03-17-171122,171122,1,0,0,15,5.0,2.6611352,1
2020-03-18-171122,171122,1,0,7,16,7.5555555555555545,4.3412843,2
2020-03-19-171122,171122,2,0,2,18,8.11111111111111,5.3629446,3
2020-03-20-171122,171122,4,0,1,22,8.11111111111111,8.831603,4
2020-03-21-171122,171122,0,0,1,22,3.111111111111111,0.6775851,5
2020-03-22-171122,171122,1,0,1,23,1.6666666666666667,1.4792047,6
2020-03-23-171122,171122,2,0,4,25,13.0,7.214022,0
2020-03-24-171122,171122,2,0,0,27,7.111111111111112,4.127001,1
2020-03-25-171122,171122,5,0,0,32,7.777777777777778,10.256402,2
2020-03-26-171122,171122,5,0,0,37,6.333333333333332,5.940424,3
2020-03-27-171122,171122,6,0,0,43,8.222222222222221,11.311422,4
2020-03-28-171122,171122,0,0,1,43,0.6666666666666666,0.08669924,5
2020-03-29-171122,171122,0,0,0,43,1.5555555555555556,0.3984031,6
2020-03-30-171122,171122,6,0,0,49,7.333333333333332,10.098759,0
2020-03-31-171122,171122,0,0,0,49,5.111111111111111,1.2443831,1
2020-04-01-171122,171122,7,0,1,56,4.333333333333333,11.752823,2
2020-04-02-171122,171122,2,0,0,58,3.6666666666666665,4.3463435,3
2020-04-03-171122,171122,1,0,2,59,3.555555555555556,3.416494,4
2020-04-04-171122,171122,1,0,0,60,1.0,1.3451221,5
2020-04-05-171122,171122,1,0,0,61,0.5555555555555556,1.3750312,6
2020-04-06-171122,171122,4,0,1,65,5.4444444444444455,8.907363,0
2020-04-07-171122,171122,0,0,1,65,4.666666666666667,1.0909345,1
2020-04-08-171122,171122,0,0,0,65,4.111111111111111,4.748069,2
2020-04-09-171122,171122,0,0,0,65,2.333333333333333,0.87212443,3
2020-04-10-171122,171122,0,0,2,65,2.888888888888889,0.38949507,4
2020-04-11-171122,171122,1,0,0,66,1.5555555555555556,2.446067,5
2020-04-12-171122,171122,0,0,0,66,2.2222222222222223,0.6716418,6
2020-04-13-171122,171122,0,0,6,66,4.777777777777779,2.2423573,0
2020-04-14-171122,171122,0,0,2,66,4.4444444444444455,1.0744414,1
2020-04-15-171122,171122,1,0,0,67,4.111111111111111,2.4524696,2
2020-04-16-171122,171122,0,0,4,67,4.666666666666667,5.25106,3
2020-04-17-171122,171122,2,0,0,69,4.888888888888889,5.25263,4
2020-04-18-171122,171122,0,0,0,69,0.5555555555555556,0.19966516,5
2020-04-19-171122,171122,0,0,0,69,0.4444444444444444,0.22771241,6
2020-04-20-171122,171122,1,0,6,70,4.0,2.8887725,0
2020-04-21-171122,171122,1,0,1,71,2.0,2.471801,1
2020-04-22-171122,171122,0,0,0,71,2.888888888888889,0.6387126,2
2020-04-23-171122,171122,0,0,3,71,0.3333333333333333,0.20393188,3
2020-04-24-171122,171122,2,0,1,73,4.0,4.902239,4
2020-04-25-171122,171122,0,0,1,73,0.7777777777777778,0.62391233,5
2020-04-26-171122,171122,0,0,0,73,0.5555555555555556,0.022738835,6
2020-04-27-171122,171122,6,0,2,79,3.888888888888889,12.785597,0
2020-04-28-171122,171122,2,0,2,81,3.4444444444444446,4.6558747,1
2020-04-29-171122,171122,0,0,3,81,4.5555555555555545,3.2059803,2
2020-04-30-171122,171122,4,0,3,85,4.666666666666667,9.588072,3
2020-05-01-171122,171122,0,0,2,85,0.7777777777777778,0.41078138,4
2020-05-02-171122,171122,0,0,1,85,0.5555555555555556,0.76238865,5
2020-05-03-171122,171122,0,0,0,85,0.3333333333333333,0.14508444,6
2020-05-04-171122,171122,6,0,0,91,5.666666666666668,14.7644205,0
2020-05-05-171122,171122,1,0,5,92,5.222222222222221,6.651703,1
2020-05-06-171122,171122,0,0,1,92,16.77777777777778,5.34461,2
2020-05-07-171122,171122,3,0,9,95,4.4444444444444455,7.1376333,3
2020-05-08-171122,171122,1,0,0,96,6.0,4.5144444,4
2020-05-09-171122,171122,1,0,0,97,0.5555555555555556,2.0153284,5
2020-05-10-171122,171122,0,1,0,97,0.1111111111111111,0.006620992,6
2020-05-11-171122,171122,2,0,4,99,3.7777777777777777,5.033839,0
2020-05-12-171122,171122,2,0,1,101,8.0,6.8221035,1
2020-05-13-171122,171122,3,0,2,104,8.0,6.7061944,2
2020-05-14-171122,171122,3,0,0,107,3.2222222222222223,4.094908,3
2020-05-15-171122,171122,2,0,2,109,4.666666666666667,4.9752927,4
2020-05-16-171122,171122,1,0,0,110,0.8888888888888888,2.2254648,5
2020-05-17-171122,171122,0,0,0,110,0.1111111111111111,0.0013490287,6
2020-05-18-171122,171122,0,0,0,110,3.6666666666666665,1.1474956,0
2020-05-19-171122,171122,5,0,0,115,3.2222222222222223,11.396547,1
2020-05-20-171122,171122,1,0,0,116,2.888888888888889,3.4883225,2
2020-05-21-171122,171122,9,0,1,125,2.7777777777777777,18.61757,3
2020-05-22-171122,171122,0,0,0,125,3.6666666666666665,0.5980956,4
2020-05-23-171122,171122,0,0,0,125,0.6666666666666666,0.009633515,5
2020-05-24-171122,171122,0,0,0,125,0.1111111111111111,0.27863845,6
2020-05-25-171122,171122,4,0,4,129,1.8888888888888888,9.835721,0
2020-05-26-171122,171122,1,0,1,130,3.111111111111111,5.9916596,1
2020-05-27-171122,171122,2,0,0,132,0.6666666666666666,4.666294,2
2020-05-28-171122,171122,0,1,2,132,1.8888888888888888,1.024251,3
2020-05-29-171122,171122,2,0,0,134,0.5555555555555556,4.7495627,4
2020-05-30-171122,171122,0,0,0,134,0.0,0.0035008057,5
2020-05-31-171122,171122,0,0,0,134,0.0,0.008353985,6
2020-06-01-171122,171122,0,0,2,134,0.0,0.0631125,0
2020-06-02-171122,171122,0,0,0,134,1.1111111111111112,0.4791041,1
2020-06-03-171122,171122,0,0,0,134,1.2222222222222223,0.18158957,2
2020-06-04-171122,171122,1,0,0,135,0.8888888888888888,2.7102199,3
2020-06-05-171122,171122,0,0,1,135,0.7777777777777778,0.18027388,4
2020-06-06-171122,171122,0,0,0,135,0.2222222222222222,0.5204478,5
2020-06-07-171122,171122,0,0,0,135,0.0,0.0032288653,6
2020-06-08-171122,171122,4,0,0,139,0.5555555555555556,9.9519005,0
2020-06-09-171122,171122,1,0,0,140,0.6666666666666666,2.4787543,1
2020-06-10-171122,171122,0,0,0,140,0.7777777777777778,1.4343452,2
2020-06-11-171122,171122,2,0,0,142,0.2222222222222222,7.429237,3
2020-06-12-171122,171122,0,0,0,142,0.5555555555555556,0.6034316,4
2020-06-13-171122,171122,0,0,0,142,0.0,0.0034183832,5
2020-06-14-171122,171122,0,2,0,142,0.1111111111111111,0.0008981769,6
2020-06-15-171122,171122,2,1,0,144,1.0,2.5196526,0
2020-06-16-171122,171122,0,0,0,144,0.5555555555555556,0.05412375,1
2020-06-17-171122,171122,0,0,0,144,0.3333333333333333,0.13620085,2
2020-06-18-171122,171122,0,0,0,144,0.5555555555555556,0.22942306,3
2020-06-19-171122,171122,1,0,0,145,1.0,6.192134,4
2020-06-20-171122,171122,0,0,0,145,0.1111111111111111,0.19289942,5
2020-06-21-171122,171122,0,0,0,145,0.0,0.005123321,6
2020-06-22-171122,171122,0,0,1,145,0.4444444444444444,0.044486515,0
2020-06-23-171122,171122,0,0,0,145,0.7777777777777778,0.17601152,1
2020-06-24-171122,171122,0,1,0,145,0.4444444444444444,0.30452996,2
2020-06-25-171122,171122,0,0,0,145,0.5555555555555556,0.27015573,3
2020-06-26-171122,171122,0,0,0,145,0.5555555555555556,0.6517243,4
2020-06-27-171122,171122,0,0,0,145,0.1111111111111111,0.013559075,5
2020-06-28-171122,171122,0,0,0,145,0.0,0.09895785,6
2020-06-29-171122,171122,0,0,0,145,0.1111111111111111,0.11187467,0
2020-06-30-171122,171122,0,0,0,145,0.3333333333333333,0.166875,1
2020-07-01-171122,171122,0,0,0,145,0.0,0.024479337,2
2020-07-02-171122,171122,0,0,0,145,0.4444444444444444,0.23256706,3
2020-07-03-171122,171122,0,0,0,145,0.3333333333333333,0.07042535,4
2020-07-04-171122,171122,0,0,0,145,0.1111111111111111,0.087415755,5
2020-07-05-171122,171122,0,0,0,145,0.0,0.025956031,6
2020-07-06-171122,171122,1,0,0,146,0.1111111111111111,2.6077487,0
2020-07-07-171122,171122,0,2,0,146,0.0,0.010699894,1
2020-07-08-171122,171122,0,0,0,146,0.0,0.020158663,2
2020-07-09-171122,171122,0,0,0,146,0.1111111111111111,0.03295658,3
2020-07-10-171122,171122,0,0,0,146,0.2222222222222222,1.1673617,4
2020-07-11-171122,171122,0,0,0,146,0.0,0.0033890244,5
2020-07-12-171122,171122,0,0,0,146,0.1111111111111111,0.006394488,6
2020-07-13-171122,171122,0,0,1,146,0.3333333333333333,0.19901249,0
2020-07-14-171122,171122,0,0,0,146,0.4444444444444444,0.28288418,1
2020-07-15-171122,171122,0,0,0,146,0.1111111111111111,0.01254764,2
2020-07-16-171122,171122,0,0,0,146,0.1111111111111111,0.11731008,3
2020-07-17-171122,171122,0,0,2,146,0.3333333333333333,0.120143786,4
2020-07-18-171122,171122,0,0,0,146,0.1111111111111111,0.24379656,5
2020-07-19-171122,171122,0,0,0,146,0.0,0.0038903565,6
2020-07-20-171122,171122,0,0,0,146,0.0,0.040371165,0
2020-07-21-171122,171122,0,0,0,146,0.0,0.03746481,1
2020-07-22-171122,171122,0,0,0,146,0.2222222222222222,0.25363255,2
2020-07-23-171122,171122,0,0,0,146,0.0,0.10063809,3
2020-07-24-171122,171122,0,0,1,146,0.1111111111111111,0.112855226,4
2020-07-25-171122,171122,0,0,0,146,0.0,0.0022336396,5
2020-07-26-171122,171122,0,0,0,146,0.0,0.0020443548,6
2020-07-27-171122,171122,1,0,0,147,0.2222222222222222,2.660863,0
2020-07-28-171122,171122,0,0,0,147,0.1111111111111111,0.050496332,1
2020-07-29-171122,171122,0,0,1,147,0.2222222222222222,0.22420919,2
2020-07-30-171122,171122,0,0,0,147,0.4444444444444444,0.54694176,3
2020-07-31-171122,171122,2,0,0,149,0.8888888888888888,5.348248,4
2020-08-01-171122,171122,0,0,0,149,0.2222222222222222,0.045739427,5
2020-08-02-171122,171122,0,0,0,149,0.0,0.056468226,6
2020-08-03-171122,171122,0,0,0,149,0.8888888888888888,0.8817768,0
2020-08-04-171122,171122,0,0,7,149,0.2222222222222222,0.12170324,1
2020-08-05-171122,171122,0,0,0,149,0.0,0.14474219,2
2020-08-06-171122,171122,0,0,0,149,0.3333333333333333,0.11141888,3
2020-08-07-171122,171122,1,0,1,150,0.4444444444444444,3.6399379,4
2020-08-08-171122,171122,0,0,0,150,0.1111111111111111,0.06617206,5
2020-08-09-171122,171122,0,0,0,150,0.1111111111111111,0.7856705,6
2020-08-10-171122,171122,0,0,2,150,1.0,0.7718369,0
2020-08-11-171122,171122,0,0,0,150,0.5555555555555556,1.5403079,1
2020-08-12-171122,171122,1,0,0,151,1.4444444444444444,2.9108994,2
2020-08-13-171122,171122,0,0,0,151,1.2222222222222223,21.452599,3
2020-08-14-171122,171122,0,0,0,151,1.4444444444444444,7.9064417,4
2020-08-15-171122,171122,0,0,0,151,0.6666666666666666,0.71934736,5
2020-08-16-171122,171122,0,0,0,151,0.7777777777777778,0.38609472,6
2020-08-17-171122,171122,0,0,0,151,0.7777777777777778,1.4103961,0
2020-08-18-171122,171122,7,0,4,158,2.6666666666666665,23.435797,1
2020-08-19-171122,171122,0,0,4,158,0.4444444444444444,0.5868998,2
2020-08-20-171122,171122,0,0,0,158,1.2222222222222223,0.79436475,3
2020-08-21-171122,171122,1,0,2,159,1.0,3.7956963,4
2020-08-22-171122,171122,0,0,0,159,0.2222222222222222,1.252253,5
2020-08-23-171122,171122,0,0,1,159,0.3333333333333333,0.449928,6
2020-08-24-171122,171122,2,0,0,161,1.5555555555555556,8.168013,0
2020-08-25-171122,171122,0,0,2,161,1.7777777777777777,1.0909598,1
2020-08-26-171122,171122,0,0,0,161,0.8888888888888888,3.3497202,2
2020-08-27-171122,171122,0,0,3,161,1.3333333333333333,2.1588466,3
2020-08-28-171122,171122,0,0,2,161,0.8888888888888888,3.182231,4
2020-08-29-171122,171122,0,0,1,161,0.3333333333333333,3.0191927,5
2020-08-30-171122,171122,0,0,0,161,0.6666666666666666,0.19124815,6
2020-08-31-171122,171122,0,0,2,161,1.4444444444444444,1.0448096,0
2020-09-01-171122,171122,4,0,2,165,1.2222222222222223,11.708588,1
2020-09-02-171122,171122,4,0,4,169,2.0,8.321821,2
2020-09-03-171122,171122,0,0,3,169,0.8888888888888888,0.90482783,3
2020-09-04-171122,171122,2,0,7,171,2.4444444444444446,9.781243,4
2020-09-05-171122,171122,0,0,0,171,1.7777777777777777,0.6635634,5
2020-09-06-171122,171122,1,0,1,172,1.6666666666666667,2.2543068,6
2020-09-07-171122,171122,0,0,0,172,2.1111111111111107,4.5365868,0
2020-09-08-171122,171122,2,0,0,174,4.333333333333333,9.788675,1
2020-09-09-171122,171122,0,0,1,174,0.5555555555555556,0.99138534,2
2020-09-10-171122,171122,3,0,2,177,4.777777777777779,15.636339,3
2020-09-11-171122,171122,2,0,6,179,0.6666666666666666,9.896118,4
2020-09-12-171122,171122,1,0,0,180,2.1111111111111107,3.2927637,5
2020-09-13-171122,171122,0,0,6,180,1.7777777777777777,2.502825,6
2020-09-14-171122,171122,2,0,0,182,2.555555555555556,13.544073,0
2020-09-15-171122,171122,2,0,0,184,2.333333333333333,9.10756,1
2020-09-16-171122,171122,4,0,0,188,1.4444444444444444,17.378336,2
2020-09-17-171122,171122,3,0,0,191,3.7777777777777777,34.013187,3
2020-09-18-171122,171122,7,0,1,198,5.888888888888888,25.720785,4
2020-09-19-171122,171122,0,0,1,198,2.7777777777777777,2.3040998,5
2020-09-20-171122,171122,1,1,0,199,3.555555555555556,3.7439868,6
2020-09-21-171122,171122,0,0,0,199,6.333333333333332,9.6402645,0
2020-09-22-171122,171122,0,1,6,199,1.4444444444444444,2.436907,1
2020-09-23-171122,171122,1,0,2,200,5.111111111111111,8.82763,2
2020-09-24-171122,171122,2,2,2,202,5.5555555555555545,12.41917,3
2020-09-25-171122,171122,6,1,2,208,5.888888888888888,7.839932,4
2020-09-26-171122,171122,0,0,3,208,4.333333333333333,5.2146683,5
2020-09-27-171122,171122,6,0,4,214,2.888888888888889,17.241873,6
2020-09-28-171122,171122,0,0,1,214,2.7777777777777777,2.477532,0
2020-09-29-171122,171122,0,0,1,214,2.333333333333333,1.8845985,1
2020-09-30-171122,171122,0,0,4,214,5.111111111111111,6.373624,2
2020-10-01-171122,171122,0,0,3,214,4.666666666666667,5.172761,3
2020-10-02-171122,171122,1,0,16,215,4.4444444444444455,11.793127,4
2020-10-03-171122,171122,1,0,3,216,1.6666666666666667,6.5804486,5
2020-10-04-171122,171122,0,1,5,216,1.2222222222222223,1.0846974,6
2020-10-05-171122,171122,0,1,4,216,3.2222222222222223,2.9085946,0
2020-10-06-171122,171122,6,0,17,222,3.7777777777777777,22.554377,1
2020-10-07-171122,171122,2,0,4,224,2.0,6.4912076,2
2020-10-08-171122,171122,2,0,7,226,2.1111111111111107,8.713832,3
2020-10-09-171122,171122,2,0,13,228,2.888888888888889,9.521668,4
2020-10-10-171122,171122,3,0,3,231,0.8888888888888888,7.767529,5
2020-10-11-171122,171122,4,0,2,235,1.0,9.127471,6
2020-10-12-171122,171122,1,0,13,236,1.3333333333333333,2.9551396,0
2020-10-13-171122,171122,1,0,2,237,1.8888888888888888,3.9451265,1
2020-10-14-171122,171122,4,0,4,241,3.7777777777777777,38.539314,2
2020-10-15-171122,171122,3,0,5,244,3.333333333333333,20.689957,3
2020-10-16-171122,171122,16,0,22,260,6.5555555555555545,104.220894,4
2020-10-17-171122,171122,3,0,0,263,1.5555555555555556,8.200464,5
2020-10-18-171122,171122,5,0,1,268,1.2222222222222223,9.621912,6
2020-10-19-171122,171122,4,0,4,272,7.111111111111112,12.742647,0
2020-10-20-171122,171122,17,0,8,289,6.5555555555555545,50.015125,1
2020-10-21-171122,171122,4,0,14,293,9.0,20.906044,2
2020-10-22-171122,171122,7,0,8,300,12.888888888888891,33.355347,3
2020-10-23-171122,171122,13,1,46,313,10.222222222222221,40.536858,4
2020-10-24-171122,171122,3,1,0,316,4.4444444444444455,7.805092,5
2020-10-25-171122,171122,2,1,2,318,1.4444444444444444,6.262743,6
2020-10-26-171122,171122,13,2,16,331,9.666666666666666,35.665855,0
2020-10-27-171122,171122,2,1,4,333,7.333333333333332,14.29192,1
2020-10-28-171122,171122,4,2,8,337,7.888888888888888,23.506493,2
2020-10-29-171122,171122,5,0,6,342,6.777777777777778,34.31977,3
2020-10-30-171122,171122,22,2,2,364,15.222222222222221,80.58125,4
2020-10-31-171122,171122,0,1,0,364,2.333333333333333,6.9311447,5
2020-11-01-171122,171122,1,0,0,365,3.333333333333333,6.59302,6
2020-11-02-171122,171122,4,0,0,369,2.0,9.424872,0
2020-11-03-171122,171122,8,1,0,377,8.444444444444445,31.527788,1
2020-11-04-171122,171122,14,0,0,391,9.444444444444443,44.63569,2
2020-11-05-171122,171122,8,1,0,399,10.0,48.159813,3
2020-11-06-171122,171122,46,0,0,445,13.222222222222221,117.08861,4
2020-11-07-171122,171122,0,2,0,445,4.666666666666667,3.7843637,5
2020-11-08-171122,171122,2,1,0,447,3.111111111111111,4.6966696,6
2020-11-09-171122,171122,16,0,0,463,9.444444444444443,44.58393,0
2020-11-10-171122,171122,4,4,0,467,12.555555555555555,20.280964,1
2020-11-11-171122,171122,8,1,0,475,7.888888888888888,34.147274,2
2020-11-12-171122,171122,6,0,0,481,7.222222222222222,20.067448,3
2020-11-13-171122,171122,2,0,0,483,15.777777777777779,8.911174,4
