date_hzcode,hzone_code,cases,deaths,shifted_cases,cum_cases,cases_neighbors_avg,weights,dow
2020-03-01-170101,170101,0,0,0,0,0.0,0.0,6
2020-03-02-170101,170101,0,0,2,0,0.0,1.8943877059634353,0
2020-03-03-170101,170101,0,0,1,0,0.0,8.454594489446688,1
2020-03-04-170101,170101,0,1,3,0,0.0,10.889462077985666,2
2020-03-05-170101,170101,0,0,3,0,0.0,11.930604369734189,3
2020-03-06-170101,170101,0,0,9,0,0.0,12.278807634295724,4
2020-03-07-170101,170101,0,0,1,0,0.0,14.242320219162554,5
2020-03-08-170101,170101,0,0,2,0,0.0,13.094046581429133,6
2020-03-09-170101,170101,0,0,10,0,0.0,13.072063833482876,0
2020-03-10-170101,170101,0,0,4,0,0.0,29.968388398426505,1
2020-03-11-170101,170101,0,0,5,0,0.0,23.505780562669603,2
2020-03-12-170101,170101,0,0,4,0,0.5,17.484118269188507,3
2020-03-13-170101,170101,1,0,3,1,0.25,13.401430998622299,4
2020-03-14-170101,170101,0,0,2,1,0.25,10.006223964304265,5
2020-03-15-170101,170101,0,0,5,1,0.25,6.5273703062779695,6
2020-03-16-170101,170101,2,0,6,3,0.75,3.2900396408384593,0
2020-03-17-170101,170101,1,0,5,4,0.0,5.463287436884332,1
2020-03-18-170101,170101,3,0,10,7,2.75,5.873094002515485,2
2020-03-19-170101,170101,3,1,15,10,1.75,8.325295176433286,3
2020-03-20-170101,170101,9,0,6,19,0.25,9.565624841055874,4
2020-03-21-170101,170101,1,0,2,20,0.75,10.77830942033457,5
2020-03-22-170101,170101,2,0,2,22,0.75,10.973800391420681,6
2020-03-23-170101,170101,10,0,5,32,2.5,10.674824244131024,0
2020-03-24-170101,170101,4,0,3,36,0.75,13.748312134900388,1
2020-03-25-170101,170101,5,0,1,41,5.5,12.648073139510766,2
2020-03-26-170101,170101,4,0,3,45,3.5,12.351108484080711,3
2020-03-27-170101,170101,3,0,26,48,3.25,14.920222462999222,4
2020-03-28-170101,170101,2,0,5,50,0.75,14.976250614465918,5
2020-03-29-170101,170101,5,0,0,55,1.0,13.941986276976639,6
2020-03-30-170101,170101,6,0,6,61,3.0,11.43349213096443,0
2020-03-31-170101,170101,5,0,6,66,3.25,13.229409073827433,1
2020-04-01-170101,170101,10,0,6,76,4.25,2.832135529440252,2
2020-04-02-170101,170101,15,0,6,91,2.25,6.654457431987462,3
2020-04-03-170101,170101,6,0,1,97,2.75,4.898605867300501,4
2020-04-04-170101,170101,2,0,2,99,0.5,6.156354156891092,5
2020-04-05-170101,170101,2,0,0,101,0.75,5.506652022890872,6
2020-04-06-170101,170101,5,0,5,106,2.75,6.177459741672415,0
2020-04-07-170101,170101,3,0,1,109,1.75,8.892645292876097,1
2020-04-08-170101,170101,1,0,2,110,2.0,10.909533269451014,2
2020-04-09-170101,170101,3,0,0,113,1.75,12.722705552878388,3
2020-04-10-170101,170101,26,0,1,139,7.25,3.622483506860508,4
2020-04-11-170101,170101,5,1,0,144,0.75,16.023229233188815,5
2020-04-12-170101,170101,0,0,0,144,0.25,17.70271244072268,6
2020-04-13-170101,170101,6,0,1,150,1.0,18.088424321123803,0
2020-04-14-170101,170101,6,0,2,156,0.25,19.25911944369615,1
2020-04-15-170101,170101,6,0,1,162,1.25,19.986591920577606,2
2020-04-16-170101,170101,6,0,1,168,0.5,22.715850044566487,3
2020-04-17-170101,170101,1,0,1,169,0.25,21.71665897187103,4
2020-04-18-170101,170101,2,0,0,171,0.0,9.505242840608002,5
2020-04-19-170101,170101,0,0,0,171,0.0,8.036364240472274,6
2020-04-20-170101,170101,5,0,0,176,0.5,11.256996031093031,0
2020-04-21-170101,170101,1,0,1,177,0.5,11.331068380960295,1
2020-04-22-170101,170101,2,0,4,179,0.25,10.106336021693174,2
2020-04-23-170101,170101,0,0,0,179,0.0,9.91387159462715,3
2020-04-24-170101,170101,1,0,4,180,0.75,8.77621895475182,4
2020-04-25-170101,170101,0,0,2,180,0.75,9.093929353372491,5
2020-04-26-170101,170101,0,0,0,180,0.25,10.099209053332974,6
2020-04-27-170101,170101,1,0,2,181,0.25,5.569088233347939,0
2020-04-28-170101,170101,2,0,1,183,0.5,5.187017851797304,1
2020-04-29-170101,170101,1,2,0,184,1.25,5.502502575070184,2
2020-04-30-170101,170101,1,0,3,185,0.25,8.023463489452398,3
2020-05-01-170101,170101,1,0,2,186,0.25,16.132943085511705,4
2020-05-02-170101,170101,0,0,0,186,0.5,3.2469795989399257,5
2020-05-03-170101,170101,0,0,0,186,0.25,2.0950834475264006,6
2020-05-04-170101,170101,0,0,1,186,0.25,2.362953441040122,0
2020-05-05-170101,170101,1,0,1,187,0.5,2.2716029520909635,1
2020-05-06-170101,170101,4,0,1,191,1.25,2.7255949445902834,2
2020-05-07-170101,170101,0,0,0,191,1.25,3.181115205719015,3
2020-05-08-170101,170101,4,0,1,195,1.25,6.297689611930126,4
2020-05-09-170101,170101,2,0,0,197,0.75,8.248006340111862,5
2020-05-10-170101,170101,0,0,0,197,0.25,18.753630427201106,6
2020-05-11-170101,170101,2,0,2,199,1.0,18.579738766690962,0
2020-05-12-170101,170101,1,0,1,200,0.0,18.5667811433674,1
2020-05-13-170101,170101,0,0,1,200,0.25,16.390891537218604,2
2020-05-14-170101,170101,3,0,0,203,0.5,12.854699674956578,3
2020-05-15-170101,170101,2,0,1,205,0.5,10.24495117650178,4
2020-05-16-170101,170101,0,0,0,205,0.0,6.4024159346779195,5
2020-05-17-170101,170101,0,0,1,205,0.0,5.827697113819735,6
2020-05-18-170101,170101,1,0,0,206,0.0,5.287499486010409,0
2020-05-19-170101,170101,1,0,1,207,0.25,4.456502465105358,1
2020-05-20-170101,170101,1,0,2,208,0.75,4.460249156291243,2
2020-05-21-170101,170101,0,0,0,208,0.25,4.340360901342508,3
2020-05-22-170101,170101,1,1,0,209,0.25,4.087593757346637,4
2020-05-23-170101,170101,0,0,0,209,0.0,5.034236739602137,5
2020-05-24-170101,170101,0,0,1,209,0.0,5.0570776671031865,6
2020-05-25-170101,170101,2,1,0,211,0.5,4.7857035801711545,0
2020-05-26-170101,170101,1,0,1,212,0.0,5.13955689382952,1
2020-05-27-170101,170101,1,0,0,213,0.5,4.349039547233733,2
2020-05-28-170101,170101,0,3,2,213,0.0,3.232477245727667,3
2020-05-29-170101,170101,1,2,1,214,0.25,3.7964410258910704,4
2020-05-30-170101,170101,0,0,0,214,0.0,3.937563055884449,5
2020-05-31-170101,170101,1,1,0,215,0.0,3.914086780710737,6
2020-06-01-170101,170101,0,0,0,215,0.0,13.956665784507075,0
2020-06-02-170101,170101,1,0,0,216,0.25,5.157751786252215,1
2020-06-03-170101,170101,2,0,1,218,0.25,1.5488015100294887,2
2020-06-04-170101,170101,0,0,0,218,0.5,1.9564441160399277,3
2020-06-05-170101,170101,0,0,0,218,0.25,1.8263755677602298,4
2020-06-06-170101,170101,0,0,0,218,0.0,1.6191214950373063,5
2020-06-07-170101,170101,1,0,0,219,0.0,1.7046307896756354,6
2020-06-08-170101,170101,0,0,2,219,0.75,1.8485708794817994,0
2020-06-09-170101,170101,1,0,1,220,0.25,2.7321741665493158,1
2020-06-10-170101,170101,0,0,0,220,0.0,14.333764315958419,2
2020-06-11-170101,170101,2,0,1,222,0.25,13.850871876483108,3
2020-06-12-170101,170101,1,0,0,223,0.0,12.955846302839825,4
2020-06-13-170101,170101,0,0,0,223,0.0,11.415258236409702,5
2020-06-14-170101,170101,0,0,0,223,0.25,7.099827428319386,6
2020-06-15-170101,170101,0,0,0,223,0.25,4.370566362606168,0
2020-06-16-170101,170101,0,0,0,223,0.5,2.0919532028618737,1
2020-06-17-170101,170101,1,0,0,224,0.5,2.761880125676959,2
2020-06-18-170101,170101,0,0,0,224,0.75,3.935241868176375,3
2020-06-19-170101,170101,0,0,0,224,0.0,5.338524869079881,4
2020-06-20-170101,170101,0,0,0,224,0.25,6.277204519567766,5
2020-06-21-170101,170101,0,0,0,224,0.0,6.504015349502218,6
2020-06-22-170101,170101,2,0,0,226,0.0,6.534440573814782,0
2020-06-23-170101,170101,1,0,0,227,0.25,5.988034304512345,1
2020-06-24-170101,170101,0,0,0,227,0.0,4.979483896545667,2
2020-06-25-170101,170101,1,0,1,228,0.25,3.5021678106177263,3
2020-06-26-170101,170101,0,2,0,228,0.0,3.9277259505105895,4
2020-06-27-170101,170101,0,0,1,228,0.0,3.199503016442267,5
2020-06-28-170101,170101,0,0,0,228,0.0,2.292870079292179,6
2020-06-29-170101,170101,0,0,0,228,0.25,2.1867338061047903,0
2020-06-30-170101,170101,0,0,0,228,0.0,2.4483665230256326,1
2020-07-01-170101,170101,0,0,0,228,0.5,2.9386311736456623,2
2020-07-02-170101,170101,0,0,0,228,0.0,2.351429727403409,3
2020-07-03-170101,170101,0,0,1,228,0.0,2.553212403675522,4
2020-07-04-170101,170101,0,0,0,228,0.0,1.922467485434051,5
2020-07-05-170101,170101,0,0,0,228,0.0,2.083156199171934,6
2020-07-06-170101,170101,0,0,0,228,0.0,1.7821620229409185,0
2020-07-07-170101,170101,0,0,0,228,0.5,1.8741752606071314,1
2020-07-08-170101,170101,0,0,0,228,0.0,2.137889343005126,2
2020-07-09-170101,170101,1,0,0,229,0.0,1.9497694735123003,3
2020-07-10-170101,170101,0,0,0,229,0.0,3.8988519884464257,4
2020-07-11-170101,170101,1,0,0,230,0.0,4.213608596509191,5
2020-07-12-170101,170101,0,0,0,230,0.0,4.616815061145073,6
2020-07-13-170101,170101,0,0,1,230,0.0,4.540970362326794,0
2020-07-14-170101,170101,0,0,0,230,0.5,4.597557549113712,1
2020-07-15-170101,170101,0,0,0,230,0.5,3.520335106705457,2
2020-07-16-170101,170101,0,0,0,230,0.0,3.568183551544696,3
2020-07-17-170101,170101,1,1,0,231,0.0,2.6172399568575697,4
2020-07-18-170101,170101,0,0,0,231,0.0,2.9279429349488604,5
2020-07-19-170101,170101,0,0,0,231,0.0,2.676943954240589,6
2020-07-20-170101,170101,0,0,0,231,0.0,2.6433377241237555,0
2020-07-21-170101,170101,0,0,0,231,0.25,2.56591917144614,1
2020-07-22-170101,170101,0,0,0,231,0.0,3.201503946860596,2
2020-07-23-170101,170101,0,0,0,231,0.75,3.1271350816026473,3
2020-07-24-170101,170101,0,0,0,231,0.0,4.560161933081402,4
2020-07-25-170101,170101,0,0,1,231,0.0,4.148864279685088,5
2020-07-26-170101,170101,0,0,0,231,0.0,4.0563588403946484,6
2020-07-27-170101,170101,1,0,0,232,0.25,3.903730550817219,0
2020-07-28-170101,170101,0,0,2,232,0.0,3.9436029196591815,1
2020-07-29-170101,170101,0,0,1,232,0.0,3.259231741842425,2
2020-07-30-170101,170101,0,0,0,232,0.0,1.1074770425531013,3
2020-07-31-170101,170101,0,0,0,232,0.25,1.3606284338391252,4
2020-08-01-170101,170101,0,0,0,232,0.0,2.318975465640934,5
2020-08-02-170101,170101,0,0,0,232,0.0,25.968254254147244,6
2020-08-03-170101,170101,0,0,1,232,0.0,15.942661167026852,0
2020-08-04-170101,170101,0,0,0,232,0.0,16.30445541425214,1
2020-08-05-170101,170101,0,0,0,232,0.75,14.233836980009599,2
2020-08-06-170101,170101,0,1,0,232,0.25,13.997970450782674,3
2020-08-07-170101,170101,0,0,3,232,1.25,13.836988327710024,4
2020-08-08-170101,170101,1,0,0,233,0.0,13.68732853838716,5
2020-08-09-170101,170101,0,0,0,233,0.5,15.588312834938119,6
2020-08-10-170101,170101,0,0,2,233,0.75,1.4362251868038034,0
2020-08-11-170101,170101,2,0,4,235,2.0,4.662284726923806,1
2020-08-12-170101,170101,1,0,7,236,1.25,10.800905026476537,2
2020-08-13-170101,170101,0,0,0,236,0.75,16.86237598147954,3
2020-08-14-170101,170101,0,0,0,236,3.5,21.288450682086122,4
2020-08-15-170101,170101,0,0,1,236,0.75,34.684685396144,5
2020-08-16-170101,170101,0,0,2,236,0.0,37.39438281289947,6
2020-08-17-170101,170101,1,0,1,237,0.5,37.66194077772453,0
2020-08-18-170101,170101,0,0,0,237,0.25,36.64470852684427,1
2020-08-19-170101,170101,0,2,1,237,1.25,33.004864651549134,2
2020-08-20-170101,170101,0,0,10,237,12.5,23.5875721962631,3
2020-08-21-170101,170101,3,0,0,240,1.0,17.773130821321388,4
2020-08-22-170101,170101,0,0,0,240,7.75,20.402206304718234,5
2020-08-23-170101,170101,0,0,0,240,0.75,24.01821618392393,6
2020-08-24-170101,170101,2,0,2,242,0.75,23.36440519470486,0
2020-08-25-170101,170101,4,0,0,246,1.0,22.061773429548694,1
2020-08-26-170101,170101,7,0,2,253,1.25,22.955662086673886,2
2020-08-27-170101,170101,0,0,0,253,0.5,26.277138775824238,3
2020-08-28-170101,170101,0,0,3,253,0.5,21.96075753868022,4
2020-08-29-170101,170101,1,0,25,254,3.75,17.741654734615324,5
2020-08-30-170101,170101,2,0,0,256,1.0,16.923005021458533,6
2020-08-31-170101,170101,1,0,1,257,0.75,17.016259069611337,0
2020-09-01-170101,170101,0,0,8,257,0.5,13.031786123577083,1
2020-09-02-170101,170101,1,1,3,258,0.0,26.841221744864583,2
2020-09-03-170101,170101,10,0,4,268,2.0,16.891125044763722,3
2020-09-04-170101,170101,0,0,4,268,2.75,22.29449336144448,4
2020-09-05-170101,170101,0,0,1,268,1.0,25.464898546274235,5
2020-09-06-170101,170101,0,0,0,268,0.25,25.28365036590715,6
2020-09-07-170101,170101,2,1,0,270,0.5,25.453434735126958,0
2020-09-08-170101,170101,0,0,2,270,0.75,25.40081148912636,1
2020-09-09-170101,170101,2,0,6,272,1.25,25.89220859753425,2
2020-09-10-170101,170101,0,0,1,272,1.5,9.83097228702794,3
2020-09-11-170101,170101,3,0,6,275,2.25,13.311699642061999,4
2020-09-12-170101,170101,25,0,2,300,0.25,16.33621232871419,5
2020-09-13-170101,170101,0,0,0,300,1.25,20.47517867277703,6
2020-09-14-170101,170101,1,0,2,301,0.25,21.177810718102073,0
2020-09-15-170101,170101,8,0,0,309,1.0,20.1229183028095,1
2020-09-16-170101,170101,3,0,7,312,2.5,23.875762789489883,2
2020-09-17-170101,170101,4,0,1,316,0.0,25.016626531851713,3
2020-09-18-170101,170101,4,0,2,320,4.5,22.630443169719925,4
2020-09-19-170101,170101,1,0,2,321,1.75,24.199657129265987,5
2020-09-20-170101,170101,0,1,0,321,0.5,18.344309455969363,6
2020-09-21-170101,170101,0,1,5,321,0.75,17.12966712861505,0
2020-09-22-170101,170101,2,1,1,323,1.75,16.10381831878729,1
2020-09-23-170101,170101,6,0,2,329,0.75,18.017588458674986,2
2020-09-24-170101,170101,1,1,2,330,0.25,19.22483634975499,3
2020-09-25-170101,170101,6,0,1,336,0.75,15.501075275804297,4
2020-09-26-170101,170101,2,0,1,338,0.0,16.140741354544197,5
2020-09-27-170101,170101,0,0,0,338,0.0,16.84848639665189,6
2020-09-28-170101,170101,2,0,1,340,0.25,16.57779915608993,0
2020-09-29-170101,170101,0,1,0,340,0.5,14.972500330367705,1
2020-09-30-170101,170101,7,1,0,347,0.25,15.27409145704804,2
2020-10-01-170101,170101,1,0,0,348,0.75,0.0,3
2020-10-02-170101,170101,2,0,0,350,0.75,10.325807992761845,4
2020-10-03-170101,170101,2,0,0,352,0.25,16.922123040375446,5
2020-10-04-170101,170101,0,0,4,352,0.25,19.365731830772706,6
2020-10-05-170101,170101,5,1,1,357,0.0,17.48454160685735,0
2020-10-06-170101,170101,1,2,0,358,0.25,17.591059184936462,1
2020-10-07-170101,170101,2,0,1,360,0.75,16.727703735042116,2
2020-10-08-170101,170101,2,0,2,362,0.75,17.398319453654008,3
2020-10-09-170101,170101,1,1,3,363,1.0,20.506276088673836,4
2020-10-10-170101,170101,1,0,0,364,1.0,3.294001901213001,5
2020-10-11-170101,170101,0,0,0,364,0.0,4.994496231909592,6
2020-10-12-170101,170101,1,0,3,365,1.0,5.884361518180519,0
2020-10-13-170101,170101,0,0,1,365,0.25,8.257035147848464,1
2020-10-14-170101,170101,0,0,1,365,0.5,9.180751633773177,2
2020-10-15-170101,170101,0,0,2,365,0.25,13.318358093603148,3
2020-10-16-170101,170101,0,0,0,365,0.0,14.01853387728876,4
2020-10-17-170101,170101,0,0,0,365,0.25,11.02213599041319,5
2020-10-18-170101,170101,4,0,3,369,0.25,9.49232735179693,6
2020-10-19-170101,170101,1,2,0,370,0.25,11.383422258221898,0
2020-10-20-170101,170101,0,0,2,370,0.25,11.8839629121663,1
2020-10-21-170101,170101,1,0,1,371,0.25,8.601310603765317,2
2020-10-22-170101,170101,2,0,1,373,0.75,10.118353551904267,3
2020-10-23-170101,170101,3,0,1,376,1.25,12.557670545596928,4
2020-10-24-170101,170101,0,0,0,376,0.0,16.731419173640962,5
2020-10-25-170101,170101,0,0,1,376,0.5,14.55223273999245,6
2020-10-26-170101,170101,3,0,0,379,0.75,14.345522843600904,0
2020-10-27-170101,170101,1,0,0,380,1.0,14.674015866423005,1
2020-10-28-170101,170101,1,0,1,381,0.25,16.27210048730324,2
2020-10-29-170101,170101,2,0,1,383,1.0,17.929328609382658,3
2020-10-30-170101,170101,0,0,0,383,2.25,14.839910248348405,4
2020-10-31-170101,170101,0,0,0,383,1.0,19.285407552698466,5
2020-11-01-170101,170101,3,1,0,386,1.5,20.171833377951238,6
2020-11-02-170101,170101,0,0,0,386,0.5,32.5932391598506,0
2020-11-03-170101,170101,2,0,0,388,1.0,18.138183574130476,1
2020-11-04-170101,170101,1,1,0,389,1.5,19.195648682934085,2
2020-11-05-170101,170101,1,0,0,390,2.25,22.688001861145665,3
2020-11-06-170101,170101,1,1,0,391,2.5,22.991147263198652,4
2020-11-07-170101,170101,0,0,0,391,1.25,26.012905238296742,5
2020-11-08-170101,170101,1,0,0,392,2.25,26.136895836375395,6
2020-11-09-170101,170101,0,0,0,392,1.25,26.789246815161754,0
2020-11-10-170101,170101,0,1,0,392,1.5,17.019321541214243,1
2020-11-11-170101,170101,1,0,0,393,1.75,20.40015537027547,2
2020-11-12-170101,170101,1,1,0,394,1.75,25.603290751506286,3
2020-11-13-170101,170101,0,2,0,394,4.0,31.308044514313835,4
2020-03-01-170102,170102,1,0,2,1,0.0,0.0,6
2020-03-02-170102,170102,0,0,4,1,0.2222222222222222,49.59353329841137,0
2020-03-03-170102,170102,0,0,2,1,0.0,340.71497377754963,1
2020-03-04-170102,170102,0,0,3,1,0.0,407.19069619665277,2
2020-03-05-170102,170102,1,0,16,2,0.1111111111111111,429.59257682030966,3
2020-03-06-170102,170102,0,0,4,2,0.1111111111111111,425.25624594132887,4
2020-03-07-170102,170102,0,0,3,2,0.1111111111111111,380.2661701840178,5
2020-03-08-170102,170102,0,0,6,2,0.0,317.95812887509635,6
2020-03-09-170102,170102,0,0,17,2,0.1111111111111111,319.1203426816712,0
2020-03-10-170102,170102,1,0,12,3,0.0,570.3688278730855,1
2020-03-11-170102,170102,0,0,16,3,0.2222222222222222,489.6662507335479,2
2020-03-12-170102,170102,0,0,17,3,0.7777777777777778,355.85116963794724,3
2020-03-13-170102,170102,1,0,10,4,1.1111111111111112,217.6568113728048,4
2020-03-14-170102,170102,0,0,15,4,0.7777777777777778,146.89725482517102,5
2020-03-15-170102,170102,2,0,11,6,1.1111111111111112,115.15147895923057,6
2020-03-16-170102,170102,4,0,15,10,3.333333333333333,59.60066313700948,0
2020-03-17-170102,170102,2,0,9,12,5.0,100.1281459412527,1
2020-03-18-170102,170102,3,0,4,15,6.111111111111112,131.51994490181437,2
2020-03-19-170102,170102,16,0,13,31,6.888888888888888,182.25757238478334,3
2020-03-20-170102,170102,4,0,3,35,5.666666666666668,279.1876240306617,4
2020-03-21-170102,170102,3,0,6,38,3.111111111111111,305.4825324758805,5
2020-03-22-170102,170102,6,0,2,44,5.5555555555555545,308.13712934633406,6
2020-03-23-170102,170102,17,0,8,61,11.222222222222221,324.4324827784308,0
2020-03-24-170102,170102,12,0,3,73,6.777777777777778,416.7448409109448,1
2020-03-25-170102,170102,16,0,5,89,8.888888888888891,461.32934980906197,2
2020-03-26-170102,170102,17,0,7,106,8.666666666666666,474.9909318167754,3
2020-03-27-170102,170102,10,0,11,116,8.888888888888891,593.2362434859488,4
2020-03-28-170102,170102,15,0,8,131,3.555555555555556,640.4289678676761,5
2020-03-29-170102,170102,11,0,3,142,2.888888888888889,702.2573568403875,6
2020-03-30-170102,170102,15,0,8,157,6.888888888888888,591.1094199054314,0
2020-03-31-170102,170102,9,0,12,166,5.111111111111111,584.0098096801103,1
2020-04-01-170102,170102,4,0,8,170,5.666666666666668,74.6214560429457,2
2020-04-02-170102,170102,13,0,5,183,9.444444444444443,340.6165489673722,3
2020-04-03-170102,170102,3,0,6,186,4.666666666666667,174.75198505521723,4
2020-04-04-170102,170102,6,0,8,192,4.888888888888889,180.66176805391814,5
2020-04-05-170102,170102,2,0,2,194,1.7777777777777777,207.50609714489386,6
2020-04-06-170102,170102,8,0,13,202,11.222222222222221,212.83732288488864,0
2020-04-07-170102,170102,3,0,4,205,3.4444444444444446,257.85228700681364,1
2020-04-08-170102,170102,5,0,12,210,3.2222222222222223,278.952367881227,2
2020-04-09-170102,170102,7,0,4,217,2.2222222222222223,272.8463188688182,3
2020-04-10-170102,170102,11,0,6,228,4.111111111111111,52.20760409403164,4
2020-04-11-170102,170102,8,0,2,236,1.3333333333333333,127.65987999756514,5
2020-04-12-170102,170102,3,0,2,239,3.333333333333333,155.025846892908,6
2020-04-13-170102,170102,8,0,7,247,6.333333333333332,181.55621228666064,0
2020-04-14-170102,170102,12,1,1,259,5.333333333333333,232.6070047755067,1
2020-04-15-170102,170102,8,0,9,267,6.0,297.884445494047,2
2020-04-16-170102,170102,5,0,3,272,2.333333333333333,379.11544537810386,3
2020-04-17-170102,170102,6,0,1,278,2.2222222222222223,384.09828785993807,4
2020-04-18-170102,170102,8,0,2,286,4.666666666666667,356.9574849708644,5
2020-04-19-170102,170102,2,0,0,288,3.4444444444444446,365.45962567199246,6
2020-04-20-170102,170102,13,0,6,301,5.666666666666668,394.9244641093231,0
2020-04-21-170102,170102,4,0,3,305,2.1111111111111107,408.97246595114257,1
2020-04-22-170102,170102,12,0,5,317,4.333333333333333,348.0510855126456,2
2020-04-23-170102,170102,4,0,5,321,0.6666666666666666,387.2681117337404,3
2020-04-24-170102,170102,6,0,6,327,2.7777777777777777,354.21533284745686,4
2020-04-25-170102,170102,2,0,1,329,0.6666666666666666,354.07828850324256,5
2020-04-26-170102,170102,2,0,2,331,0.3333333333333333,354.44275107541637,6
2020-04-27-170102,170102,7,0,3,338,2.4444444444444446,271.90597756157723,0
2020-04-28-170102,170102,1,0,5,339,2.2222222222222223,225.41897195146765,1
2020-04-29-170102,170102,9,0,3,348,2.888888888888889,218.85116131270814,2
2020-04-30-170102,170102,3,0,3,351,3.2222222222222223,216.93300381204796,3
2020-05-01-170102,170102,1,0,1,352,0.5555555555555556,319.786112314325,4
2020-05-02-170102,170102,2,0,2,354,1.3333333333333333,144.2936437303565,5
2020-05-03-170102,170102,0,0,0,354,0.4444444444444444,129.1227282167156,6
2020-05-04-170102,170102,6,0,6,360,1.7777777777777777,94.35598241180756,0
2020-05-05-170102,170102,3,0,2,363,2.2222222222222223,114.19229929601761,1
2020-05-06-170102,170102,5,0,2,368,1.7777777777777777,95.28263342550949,2
2020-05-07-170102,170102,5,0,3,373,2.4444444444444446,115.92857776043425,3
2020-05-08-170102,170102,6,0,1,379,2.2222222222222223,149.51736087962033,4
2020-05-09-170102,170102,1,0,2,380,1.0,207.42450483413558,5
2020-05-10-170102,170102,2,0,1,382,0.7777777777777778,350.6750138148568,6
2020-05-11-170102,170102,3,3,0,385,3.333333333333333,307.827595278907,0
2020-05-12-170102,170102,5,0,2,390,2.333333333333333,328.224487355577,1
2020-05-13-170102,170102,3,0,7,393,1.8888888888888888,248.36458154922892,2
2020-05-14-170102,170102,3,0,2,396,2.7777777777777777,228.06748356601324,3
2020-05-15-170102,170102,1,0,0,397,2.4444444444444446,207.96922154134774,4
2020-05-16-170102,170102,2,0,0,399,1.3333333333333333,163.77137378003323,5
2020-05-17-170102,170102,0,0,0,399,1.1111111111111112,172.86794948280016,6
2020-05-18-170102,170102,6,0,0,405,4.111111111111111,163.61071865243974,0
2020-05-19-170102,170102,2,0,6,407,2.333333333333333,186.81866559271924,1
2020-05-20-170102,170102,2,0,1,409,2.2222222222222223,179.13388933987196,2
2020-05-21-170102,170102,3,0,2,412,2.555555555555556,166.45432209249708,3
2020-05-22-170102,170102,1,0,2,413,2.6666666666666665,183.6576972691096,4
2020-05-23-170102,170102,2,0,1,415,1.3333333333333333,189.23834792432797,5
2020-05-24-170102,170102,1,0,0,416,1.0,212.84193182832536,6
2020-05-25-170102,170102,0,0,1,416,3.0,154.56069660142353,0
2020-05-26-170102,170102,2,0,0,418,3.111111111111111,161.08990635123303,1
2020-05-27-170102,170102,7,0,2,425,2.4444444444444446,161.78437026637474,2
2020-05-28-170102,170102,2,2,2,427,1.7777777777777777,203.4717095177199,3
2020-05-29-170102,170102,0,1,1,427,1.1111111111111112,197.21555638152574,4
2020-05-30-170102,170102,0,0,1,427,0.2222222222222222,166.98031626255965,5
2020-05-31-170102,170102,0,0,0,427,0.1111111111111111,158.63595800319112,6
2020-06-01-170102,170102,0,0,2,427,0.8888888888888888,266.66837282794154,0
2020-06-02-170102,170102,6,0,3,433,1.5555555555555556,79.99722254715371,1
2020-06-03-170102,170102,1,0,0,434,1.2222222222222223,98.84743602421938,2
2020-06-04-170102,170102,2,0,0,436,0.5555555555555556,83.42679847344311,3
2020-06-05-170102,170102,2,0,5,438,0.5555555555555556,101.70012929426488,4
2020-06-06-170102,170102,1,0,1,439,0.1111111111111111,104.62881709997077,5
2020-06-07-170102,170102,0,0,2,439,0.1111111111111111,98.8131175866603,6
2020-06-08-170102,170102,1,1,0,440,1.2222222222222223,80.9653229934091,0
2020-06-09-170102,170102,0,0,0,440,1.2222222222222223,91.73360273349937,1
2020-06-10-170102,170102,2,0,3,442,0.5555555555555556,275.50653467304926,2
2020-06-11-170102,170102,2,0,0,444,0.5555555555555556,239.57332917515777,3
2020-06-12-170102,170102,1,0,2,445,1.2222222222222223,222.4466228655399,4
2020-06-13-170102,170102,1,0,1,446,0.1111111111111111,184.41370270290008,5
2020-06-14-170102,170102,0,0,2,446,0.3333333333333333,140.69867306620725,6
2020-06-15-170102,170102,2,2,0,448,0.7777777777777778,79.66917288416283,0
2020-06-16-170102,170102,3,0,1,451,0.8888888888888888,87.65869435272626,1
2020-06-17-170102,170102,0,0,2,451,1.1111111111111112,98.21723695981103,2
2020-06-18-170102,170102,0,0,0,451,0.5555555555555556,84.43442790089688,3
2020-06-19-170102,170102,5,0,0,456,1.2222222222222223,76.69434187489315,4
2020-06-20-170102,170102,1,0,1,457,0.3333333333333333,131.45477717819313,5
2020-06-21-170102,170102,2,0,0,459,0.1111111111111111,140.33882505387675,6
2020-06-22-170102,170102,0,0,1,459,0.7777777777777778,138.3116794398197,0
2020-06-23-170102,170102,0,0,1,459,0.8888888888888888,129.46175428954527,1
2020-06-24-170102,170102,3,1,0,462,0.4444444444444444,140.8304443131512,2
2020-06-25-170102,170102,0,1,2,462,1.0,163.76257858219535,3
2020-06-26-170102,170102,2,0,0,464,0.6666666666666666,150.20146043682922,4
2020-06-27-170102,170102,1,0,0,465,0.3333333333333333,110.93116248372104,5
2020-06-28-170102,170102,2,0,0,467,0.2222222222222222,119.96938040006953,6
2020-06-29-170102,170102,0,0,0,467,0.1111111111111111,127.02523099992771,0
2020-06-30-170102,170102,1,0,0,468,0.1111111111111111,124.84718145265269,1
2020-07-01-170102,170102,2,0,0,470,0.2222222222222222,105.86201391766738,2
2020-07-02-170102,170102,0,0,0,470,0.7777777777777778,52.70596534135225,3
2020-07-03-170102,170102,0,0,1,470,0.3333333333333333,68.46065886887531,4
2020-07-04-170102,170102,1,0,0,471,0.3333333333333333,79.59917893204378,5
2020-07-05-170102,170102,0,0,0,471,0.1111111111111111,81.50433761959866,6
2020-07-06-170102,170102,1,0,0,472,0.4444444444444444,80.17608222615192,0
2020-07-07-170102,170102,1,0,0,473,0.1111111111111111,80.83359511602701,1
2020-07-08-170102,170102,0,0,0,473,0.1111111111111111,69.85103944650083,2
2020-07-09-170102,170102,2,0,1,475,0.6666666666666666,74.02514124620386,3
2020-07-10-170102,170102,0,0,0,475,0.5555555555555556,115.39319465605413,4
2020-07-11-170102,170102,0,0,0,475,0.4444444444444444,89.19840912756594,5
2020-07-12-170102,170102,0,0,0,475,0.1111111111111111,73.67811912961355,6
2020-07-13-170102,170102,0,0,0,475,0.4444444444444444,65.95987941337808,0
2020-07-14-170102,170102,0,0,0,475,0.4444444444444444,73.38798895436557,1
2020-07-15-170102,170102,0,0,2,475,1.0,62.145502906400075,2
2020-07-16-170102,170102,0,0,1,475,1.0,52.55004296341208,3
2020-07-17-170102,170102,1,1,1,476,0.4444444444444444,39.1506716013014,4
2020-07-18-170102,170102,0,0,1,476,0.4444444444444444,46.85695193706766,5
2020-07-19-170102,170102,0,0,1,476,0.6666666666666666,40.28395817800988,6
2020-07-20-170102,170102,0,0,3,476,0.7777777777777778,50.290297848452425,0
2020-07-21-170102,170102,0,0,0,476,0.5555555555555556,54.01316496831534,1
2020-07-22-170102,170102,0,0,0,476,0.7777777777777778,53.82508743486227,2
2020-07-23-170102,170102,1,0,1,477,0.7777777777777778,49.84752054738989,3
2020-07-24-170102,170102,0,0,1,477,0.8888888888888888,53.65637873992532,4
2020-07-25-170102,170102,0,0,0,477,0.1111111111111111,58.255731080244395,5
2020-07-26-170102,170102,0,0,0,477,0.2222222222222222,46.965888558942865,6
2020-07-27-170102,170102,0,1,0,477,0.5555555555555556,46.436202263760904,0
2020-07-28-170102,170102,0,0,3,477,1.1111111111111112,44.92808821783196,1
2020-07-29-170102,170102,2,0,3,479,0.4444444444444444,51.42640060161662,2
2020-07-30-170102,170102,1,0,1,480,1.0,53.85680694453872,3
2020-07-31-170102,170102,1,0,2,481,1.0,62.88058128218873,4
2020-08-01-170102,170102,1,0,8,482,0.1111111111111111,77.17804553896208,5
2020-08-02-170102,170102,1,0,0,483,0.3333333333333333,332.98927825795244,6
2020-08-03-170102,170102,3,0,3,486,0.6666666666666666,500.13019878893545,0
2020-08-04-170102,170102,0,0,9,486,0.4444444444444444,330.9012873122689,1
2020-08-05-170102,170102,0,0,8,486,1.4444444444444444,289.7549244124193,2
2020-08-06-170102,170102,1,0,5,487,1.0,262.88597572727406,3
2020-08-07-170102,170102,1,0,19,488,0.7777777777777778,186.91952279211634,4
2020-08-08-170102,170102,0,0,3,488,0.1111111111111111,144.84410313366675,5
2020-08-09-170102,170102,0,0,4,488,0.7777777777777778,114.55558883200777,6
2020-08-10-170102,170102,0,0,6,488,0.8888888888888888,68.20156571428753,0
2020-08-11-170102,170102,3,0,8,491,0.8888888888888888,73.98929112867341,1
2020-08-12-170102,170102,3,0,6,494,1.0,107.16120201944699,2
2020-08-13-170102,170102,1,0,2,495,0.8888888888888888,131.4899068113896,3
2020-08-14-170102,170102,2,0,9,497,1.1111111111111112,139.76135902512289,4
2020-08-15-170102,170102,8,0,4,505,0.5555555555555556,165.906849799937,5
2020-08-16-170102,170102,0,0,1,505,0.3333333333333333,209.12311471389575,6
2020-08-17-170102,170102,3,0,2,508,2.1111111111111107,204.2248286942263,0
2020-08-18-170102,170102,9,0,6,517,1.3333333333333333,227.4048359580547,1
2020-08-19-170102,170102,8,0,3,525,2.6666666666666665,272.06978536289284,2
2020-08-20-170102,170102,5,0,3,530,1.5555555555555556,327.170903588601,3
2020-08-21-170102,170102,19,0,1,549,1.6666666666666667,332.4512326439113,4
2020-08-22-170102,170102,3,0,3,552,2.2222222222222223,437.8467367186502,5
2020-08-23-170102,170102,4,0,0,556,1.4444444444444444,485.48177069186863,6
2020-08-24-170102,170102,6,0,4,562,2.4444444444444446,489.9152346243763,0
2020-08-25-170102,170102,8,1,2,570,3.7777777777777777,509.16459239477945,1
2020-08-26-170102,170102,6,0,2,576,1.5555555555555556,526.1263960594483,2
2020-08-27-170102,170102,2,0,1,578,2.2222222222222223,567.1319049497705,3
2020-08-28-170102,170102,9,0,8,587,1.5555555555555556,568.8983786705194,4
2020-08-29-170102,170102,4,0,0,591,1.3333333333333333,486.1444490731193,5
2020-08-30-170102,170102,1,0,1,592,0.7777777777777778,483.9181674437533,6
2020-08-31-170102,170102,2,0,3,594,2.333333333333333,389.92030536901825,0
2020-09-01-170102,170102,6,0,1,600,1.7777777777777777,106.61359808468629,1
2020-09-02-170102,170102,3,0,5,603,4.666666666666667,410.6419203991527,2
2020-09-03-170102,170102,3,0,5,606,2.333333333333333,453.8352727077826,3
2020-09-04-170102,170102,1,0,4,607,3.4444444444444446,335.34239924122096,4
2020-09-05-170102,170102,3,0,2,610,2.2222222222222223,335.05020026519605,5
2020-09-06-170102,170102,0,0,3,610,1.8888888888888888,315.09937973491634,6
2020-09-07-170102,170102,4,0,1,614,4.0,336.7115588196583,0
2020-09-08-170102,170102,2,0,5,616,4.222222222222221,367.2516422935513,1
2020-09-09-170102,170102,2,0,6,618,2.333333333333333,394.39540500192913,2
2020-09-10-170102,170102,1,0,5,619,2.1111111111111107,112.63854848803894,3
2020-09-11-170102,170102,8,0,9,627,5.0,139.9559526258759,4
2020-09-12-170102,170102,0,0,6,627,2.333333333333333,224.58831196193347,5
2020-09-13-170102,170102,1,0,0,628,1.1111111111111112,226.46512127924265,6
2020-09-14-170102,170102,3,1,3,631,5.5555555555555545,238.8747558267212,0
2020-09-15-170102,170102,1,0,3,632,3.888888888888889,301.87280724350296,1
2020-09-16-170102,170102,5,0,2,637,3.555555555555556,339.98329311025174,2
2020-09-17-170102,170102,5,0,12,642,3.2222222222222223,354.010951017397,3
2020-09-18-170102,170102,4,0,9,646,4.4444444444444455,387.44549703843796,4
2020-09-19-170102,170102,2,0,5,648,4.0,356.01846111655385,5
2020-09-20-170102,170102,3,2,7,651,2.7777777777777777,445.4103055951143,6
2020-09-21-170102,170102,1,0,8,652,4.0,411.64537395426515,0
2020-09-22-170102,170102,5,1,9,657,2.555555555555556,410.7243027653816,1
2020-09-23-170102,170102,6,0,3,663,6.222222222222222,413.1265835675209,2
2020-09-24-170102,170102,5,1,1,668,5.777777777777778,433.3327394183922,3
2020-09-25-170102,170102,9,0,4,677,6.0,477.38569205399403,4
2020-09-26-170102,170102,6,0,1,683,3.4444444444444446,496.7232269524126,5
2020-09-27-170102,170102,0,0,1,683,0.7777777777777778,493.65121745985994,6
2020-09-28-170102,170102,3,0,0,686,3.0,465.7514763604919,0
2020-09-29-170102,170102,3,0,2,689,1.7777777777777777,465.35106671192,1
2020-09-30-170102,170102,2,1,2,691,3.7777777777777777,386.23464873093405,2
2020-10-01-170102,170102,12,0,0,703,2.7777777777777777,0.0,3
2020-10-02-170102,170102,9,0,9,712,3.333333333333333,381.6524417644081,4
2020-10-03-170102,170102,5,1,11,717,2.2222222222222223,1063.3080374522426,5
2020-10-04-170102,170102,7,0,2,724,0.7777777777777778,1056.0802325145976,6
2020-10-05-170102,170102,8,1,6,732,1.6666666666666667,995.9663782535715,0
2020-10-06-170102,170102,9,0,13,741,4.888888888888889,909.6216460432348,1
2020-10-07-170102,170102,3,0,4,744,2.4444444444444446,797.6556913930398,2
2020-10-08-170102,170102,1,0,9,745,2.6666666666666665,646.3692055058341,3
2020-10-09-170102,170102,4,0,7,749,4.0,637.5239780828914,4
2020-10-10-170102,170102,1,0,22,750,2.6666666666666665,99.20563290651833,5
2020-10-11-170102,170102,1,0,9,751,1.1111111111111112,140.4697531486179,6
2020-10-12-170102,170102,0,0,7,751,2.0,160.12117920416193,0
2020-10-13-170102,170102,2,0,17,753,3.0,178.75839980156542,1
2020-10-14-170102,170102,2,0,27,755,2.4444444444444446,229.35636466258285,2
2020-10-15-170102,170102,0,0,18,755,4.0,275.7406134326044,3
2020-10-16-170102,170102,9,0,24,764,3.7777777777777777,310.2497396844754,4
2020-10-17-170102,170102,11,0,11,775,2.4444444444444446,238.29734269734593,5
2020-10-18-170102,170102,2,0,12,777,1.8888888888888888,298.2606890459008,6
2020-10-19-170102,170102,6,0,4,783,2.333333333333333,311.18065366119436,0
2020-10-20-170102,170102,13,0,9,796,3.111111111111111,395.0886778886626,1
2020-10-21-170102,170102,4,0,6,800,1.5555555555555556,467.9349426183635,2
2020-10-22-170102,170102,9,0,8,809,4.222222222222221,497.41798606248585,3
2020-10-23-170102,170102,7,0,25,816,3.2222222222222223,559.6500115995077,4
2020-10-24-170102,170102,22,0,9,838,2.7777777777777777,559.916014043782,5
2020-10-25-170102,170102,9,0,1,847,2.0,695.0101373971811,6
2020-10-26-170102,170102,7,1,5,854,4.333333333333333,720.1588435203588,0
2020-10-27-170102,170102,17,0,10,871,3.7777777777777777,739.4363330557396,1
2020-10-28-170102,170102,27,1,6,898,3.4444444444444446,785.3678258585071,2
2020-10-29-170102,170102,18,0,6,916,5.777777777777778,926.0443840373755,3
2020-10-30-170102,170102,24,0,12,940,4.666666666666667,988.9893058918399,4
2020-10-31-170102,170102,11,1,0,951,5.0,1017.0303173151954,5
2020-11-01-170102,170102,12,3,0,963,2.6666666666666665,511.2290626115114,6
2020-11-02-170102,170102,4,0,0,967,2.7777777777777777,555.7857682248881,0
2020-11-03-170102,170102,9,0,0,976,4.333333333333333,464.7888663518352,1
2020-11-04-170102,170102,6,0,0,982,4.0,526.2283657732797,2
2020-11-05-170102,170102,8,2,0,990,6.4444444444444455,519.6631540079071,3
2020-11-06-170102,170102,25,2,0,1015,4.666666666666667,497.39097045342504,4
2020-11-07-170102,170102,9,0,0,1024,2.1111111111111107,553.4477688185596,5
2020-11-08-170102,170102,1,2,0,1025,1.1111111111111112,599.6317149681513,6
2020-11-09-170102,170102,5,1,0,1030,3.0,573.6900819205106,0
2020-11-10-170102,170102,10,0,0,1040,2.7777777777777777,485.66150254636324,1
2020-11-11-170102,170102,6,0,0,1046,2.6666666666666665,524.4979553630029,2
2020-11-12-170102,170102,6,0,0,1052,3.4444444444444446,534.5150669543045,3
2020-11-13-170102,170102,12,0,0,1064,4.4444444444444455,545.0252941080146,4
2020-03-01-170103,170103,0,0,2,0,0.0,0.0,6
2020-03-02-170103,170103,0,0,17,0,0.0,156.4271211174916,0
2020-03-03-170103,170103,0,0,9,0,0.0,909.5177397221636,1
2020-03-04-170103,170103,0,0,33,0,0.0,946.7039324052296,2
2020-03-05-170103,170103,0,0,26,0,0.0,1024.8135209901754,3
2020-03-06-170103,170103,1,0,48,1,0.0,903.6447561945754,4
2020-03-07-170103,170103,0,1,15,1,0.0,934.8472804559832,5
2020-03-08-170103,170103,0,0,16,1,0.0,908.424284455079,6
2020-03-09-170103,170103,0,0,54,1,0.6666666666666666,911.0982475274203,0
2020-03-10-170103,170103,0,0,52,1,0.0,982.0558949757948,1
2020-03-11-170103,170103,3,1,33,4,1.3333333333333333,793.6884477034712,2
2020-03-12-170103,170103,0,1,34,4,0.6666666666666666,613.0986706381611,3
2020-03-13-170103,170103,1,0,33,5,3.333333333333333,460.08736543074684,4
2020-03-14-170103,170103,1,0,13,6,1.0,333.66249869911496,5
2020-03-15-170103,170103,2,0,15,8,1.0,225.10135795643356,6
2020-03-16-170103,170103,17,0,23,25,8.666666666666666,111.54275083891949,0
2020-03-17-170103,170103,9,1,28,34,7.333333333333332,252.3885928183766,1
2020-03-18-170103,170103,33,0,23,67,21.0,344.5650787527363,2
2020-03-19-170103,170103,26,0,20,93,17.0,629.768858203046,3
2020-03-20-170103,170103,48,1,19,141,20.0,949.375320499835,4
2020-03-21-170103,170103,15,0,6,156,10.0,1202.8666356869523,5
2020-03-22-170103,170103,16,1,5,172,11.333333333333336,1252.7547938061032,6
2020-03-23-170103,170103,54,0,19,226,28.0,1304.9922814893914,0
2020-03-24-170103,170103,52,0,9,278,21.0,1656.8592120019039,1
2020-03-25-170103,170103,33,0,17,311,20.666666666666668,1769.95266398042,2
2020-03-26-170103,170103,34,0,19,345,21.0,1719.463651099601,3
2020-03-27-170103,170103,33,0,8,378,24.0,1962.4043017336944,4
2020-03-28-170103,170103,13,0,4,391,7.666666666666668,1914.0942106516284,5
2020-03-29-170103,170103,15,0,2,406,5.666666666666668,1891.8324627515865,6
2020-03-30-170103,170103,23,0,6,429,16.333333333333332,1378.1770595980224,0
2020-03-31-170103,170103,28,0,13,457,13.666666666666664,1214.4736573971206,1
2020-04-01-170103,170103,23,0,10,480,14.0,226.85315366196497,2
2020-04-02-170103,170103,20,0,7,500,12.666666666666664,529.6236793099049,3
2020-04-03-170103,170103,19,0,14,519,14.333333333333336,248.76280055580872,4
2020-04-04-170103,170103,6,0,1,525,4.333333333333333,370.3937052752887,5
2020-04-05-170103,170103,5,0,2,530,3.6666666666666665,412.9654205235028,6
2020-04-06-170103,170103,19,0,15,549,14.0,448.0139696930385,0
2020-04-07-170103,170103,9,0,9,558,11.333333333333336,559.8325761694896,1
2020-04-08-170103,170103,17,0,10,575,9.0,670.7612925807895,2
2020-04-09-170103,170103,19,0,3,594,7.666666666666668,743.8351668495677,3
2020-04-10-170103,170103,8,0,10,602,8.666666666666666,154.73206431573294,4
2020-04-11-170103,170103,4,0,0,606,3.6666666666666665,231.6256637309811,5
2020-04-12-170103,170103,2,0,0,608,3.6666666666666665,272.457845419259,6
2020-04-13-170103,170103,6,0,8,614,6.333333333333332,303.24498884491715,0
2020-04-14-170103,170103,13,0,2,627,12.333333333333336,414.8591558885952,1
2020-04-15-170103,170103,10,0,7,637,6.333333333333332,542.9641410741967,2
2020-04-16-170103,170103,7,0,5,644,8.666666666666666,652.787722151331,3
2020-04-17-170103,170103,14,0,2,658,7.333333333333332,607.3176698080465,4
2020-04-18-170103,170103,1,0,1,659,0.3333333333333333,628.1658795044455,5
2020-04-19-170103,170103,2,0,0,661,2.0,590.4735360798372,6
2020-04-20-170103,170103,15,0,15,676,8.666666666666666,617.755215041038,0
2020-04-21-170103,170103,9,0,6,685,5.333333333333333,670.5243995951321,1
2020-04-22-170103,170103,10,0,7,695,5.666666666666668,618.5358151893325,2
2020-04-23-170103,170103,3,0,4,698,2.0,611.3445546403696,3
2020-04-24-170103,170103,10,0,5,708,3.6666666666666665,524.1550055824376,4
2020-04-25-170103,170103,0,0,2,708,0.6666666666666666,583.7661090769723,5
2020-04-26-170103,170103,0,0,1,708,1.6666666666666667,577.2813608100905,6
2020-04-27-170103,170103,8,0,9,716,4.333333333333333,430.45386122362663,0
2020-04-28-170103,170103,2,1,5,718,2.6666666666666665,322.42580032199214,1
2020-04-29-170103,170103,7,0,5,725,5.0,294.39682178871607,2
2020-04-30-170103,170103,5,0,6,730,3.0,429.5238971230433,3
2020-05-01-170103,170103,2,0,3,732,0.3333333333333333,745.4196831621441,4
2020-05-02-170103,170103,1,0,1,733,3.0,403.06822756312226,5
2020-05-03-170103,170103,0,0,1,733,1.0,186.17148962189006,6
2020-05-04-170103,170103,15,0,23,748,4.333333333333333,132.12610786939166,0
2020-05-05-170103,170103,6,0,2,754,4.333333333333333,199.80352460904084,1
2020-05-06-170103,170103,7,0,2,761,6.0,243.97851475181238,2
2020-05-07-170103,170103,4,0,11,765,3.333333333333333,290.5042254808605,3
2020-05-08-170103,170103,5,0,6,770,7.333333333333332,303.80538314439616,4
2020-05-09-170103,170103,2,0,0,772,0.6666666666666666,398.9808435777685,5
2020-05-10-170103,170103,1,0,2,773,1.3333333333333333,805.0481766634791,6
2020-05-11-170103,170103,9,0,9,782,10.0,754.4575085900761,0
2020-05-12-170103,170103,5,0,3,787,4.666666666666667,805.2691357792395,1
2020-05-13-170103,170103,5,0,3,792,2.6666666666666665,648.2229843392881,2
2020-05-14-170103,170103,6,0,11,798,2.333333333333333,511.87321407960815,3
2020-05-15-170103,170103,3,0,2,801,5.0,433.1828251177843,4
2020-05-16-170103,170103,1,0,0,802,1.0,361.6066257269297,5
2020-05-17-170103,170103,1,0,0,803,0.6666666666666666,388.25721206653003,6
2020-05-18-170103,170103,23,0,3,826,19.33333333333333,381.53398159577387,0
2020-05-19-170103,170103,2,0,7,828,2.6666666666666665,520.357068881976,1
2020-05-20-170103,170103,2,0,4,830,2.0,468.1186514863466,2
2020-05-21-170103,170103,11,0,7,841,2.0,457.67549264285617,3
2020-05-22-170103,170103,6,0,3,847,2.0,461.74602115369527,4
2020-05-23-170103,170103,0,0,0,847,0.6666666666666666,477.3046493910895,5
2020-05-24-170103,170103,2,0,0,849,0.0,480.64110400393054,6
2020-05-25-170103,170103,9,0,3,858,2.0,234.96227807806716,0
2020-05-26-170103,170103,3,0,4,861,2.333333333333333,262.00748749986224,1
2020-05-27-170103,170103,3,0,1,864,1.3333333333333333,287.14158392463713,2
2020-05-28-170103,170103,11,0,4,875,3.0,278.27530976788387,3
2020-05-29-170103,170103,2,1,2,877,2.0,265.2394398122922,4
2020-05-30-170103,170103,0,0,0,877,0.0,257.1755329791906,5
2020-05-31-170103,170103,0,0,0,877,0.0,238.31648036881256,6
2020-06-01-170103,170103,3,1,2,880,2.0,505.9525824886812,0
2020-06-02-170103,170103,7,0,5,887,4.0,131.67891743786828,1
2020-06-03-170103,170103,4,0,2,891,1.6666666666666667,107.45077445513462,2
2020-06-04-170103,170103,7,0,3,898,1.3333333333333333,126.07204513778285,3
2020-06-05-170103,170103,3,0,0,901,1.6666666666666667,143.22431542541767,4
2020-06-06-170103,170103,0,0,0,901,0.0,153.84678518608305,5
2020-06-07-170103,170103,0,0,0,901,0.0,154.25937523642375,6
2020-06-08-170103,170103,3,0,5,904,1.0,150.06519297080817,0
2020-06-09-170103,170103,4,0,2,908,1.0,159.87161946756044,1
2020-06-10-170103,170103,1,0,3,909,0.6666666666666666,555.1108941501614,2
2020-06-11-170103,170103,4,0,2,913,0.0,446.0787577198129,3
2020-06-12-170103,170103,2,0,2,915,1.6666666666666667,365.58140233505026,4
2020-06-13-170103,170103,0,0,0,915,0.3333333333333333,268.9951066569942,5
2020-06-14-170103,170103,0,2,0,915,0.0,221.54398374889948,6
2020-06-15-170103,170103,2,0,1,917,1.3333333333333333,111.82910631817208,0
2020-06-16-170103,170103,5,0,1,922,1.3333333333333333,121.26130642006386,1
2020-06-17-170103,170103,2,0,4,924,1.3333333333333333,133.44068271162828,2
2020-06-18-170103,170103,3,0,1,927,0.0,140.37044716168091,3
2020-06-19-170103,170103,0,0,0,927,0.6666666666666666,150.98555640683858,4
2020-06-20-170103,170103,0,0,0,927,0.0,203.01047564276104,5
2020-06-21-170103,170103,0,0,0,927,0.0,209.82171150098588,6
2020-06-22-170103,170103,5,0,1,932,1.3333333333333333,185.21877713558365,0
2020-06-23-170103,170103,2,0,0,934,0.6666666666666666,179.48903153506828,1
2020-06-24-170103,170103,3,0,1,937,0.3333333333333333,170.20053912397447,2
2020-06-25-170103,170103,2,0,0,939,0.6666666666666666,160.91814733823497,3
2020-06-26-170103,170103,2,0,2,941,0.6666666666666666,176.2868683447746,4
2020-06-27-170103,170103,0,0,0,941,0.0,130.67553950698198,5
2020-06-28-170103,170103,0,0,0,941,1.0,124.40840755207043,6
2020-06-29-170103,170103,1,0,1,942,0.3333333333333333,130.87561258148096,0
2020-06-30-170103,170103,1,0,0,943,1.6666666666666667,122.02477727410412,1
2020-07-01-170103,170103,4,0,1,947,1.0,171.38668252914866,2
2020-07-02-170103,170103,1,0,0,948,0.6666666666666666,47.697336652275936,3
2020-07-03-170103,170103,0,0,2,948,0.6666666666666666,42.44428567057624,4
2020-07-04-170103,170103,0,0,0,948,0.0,42.95305566293244,5
2020-07-05-170103,170103,0,0,0,948,0.3333333333333333,48.96875425548555,6
2020-07-06-170103,170103,1,0,0,949,0.6666666666666666,40.36675705043185,0
2020-07-07-170103,170103,0,0,0,949,0.3333333333333333,50.442714491830166,1
2020-07-08-170103,170103,1,0,0,950,0.3333333333333333,59.768806590424354,2
2020-07-09-170103,170103,0,0,2,950,0.0,53.9792636408227,3
2020-07-10-170103,170103,2,0,0,952,1.0,154.86296108938345,4
2020-07-11-170103,170103,0,0,0,952,0.3333333333333333,120.49256228490088,5
2020-07-12-170103,170103,0,0,0,952,0.0,100.76809323158476,6
2020-07-13-170103,170103,1,0,3,953,0.3333333333333333,106.06596435224367,0
2020-07-14-170103,170103,0,0,0,953,0.0,111.51121397346799,1
2020-07-15-170103,170103,1,0,0,954,0.0,83.62225442983622,2
2020-07-16-170103,170103,0,0,2,954,0.0,68.10274309391184,3
2020-07-17-170103,170103,2,0,1,956,0.3333333333333333,56.96297483323069,4
2020-07-18-170103,170103,0,0,0,956,0.0,55.41556195597525,5
2020-07-19-170103,170103,0,0,0,956,0.0,52.851114831934694,6
2020-07-20-170103,170103,0,0,0,956,0.0,48.83123746576356,0
2020-07-21-170103,170103,0,0,1,956,0.0,42.18138647441496,1
2020-07-22-170103,170103,0,1,0,956,0.6666666666666666,38.72619545394187,2
2020-07-23-170103,170103,2,0,1,958,0.6666666666666666,36.43760812070989,3
2020-07-24-170103,170103,0,0,1,958,0.3333333333333333,37.35943267809777,4
2020-07-25-170103,170103,0,0,0,958,0.0,36.19966512321099,5
2020-07-26-170103,170103,0,0,4,958,0.0,35.19216384893262,6
2020-07-27-170103,170103,3,0,5,961,0.0,28.21408296963615,0
2020-07-28-170103,170103,0,0,0,961,0.3333333333333333,35.61902822765232,1
2020-07-29-170103,170103,0,0,1,961,0.0,38.94205655048559,2
2020-07-30-170103,170103,2,0,1,963,0.0,38.32873284845626,3
2020-07-31-170103,170103,1,0,1,964,0.6666666666666666,38.89581153473354,4
2020-08-01-170103,170103,0,0,0,964,0.0,60.15949921822886,5
2020-08-02-170103,170103,0,0,0,964,0.0,200.28538379754724,6
2020-08-03-170103,170103,0,0,2,964,0.0,305.92875877130473,0
2020-08-04-170103,170103,1,0,0,965,0.0,255.83983609118442,1
2020-08-05-170103,170103,0,0,3,965,0.3333333333333333,213.3941510051718,2
2020-08-06-170103,170103,1,0,6,966,1.0,160.53427471838472,3
2020-08-07-170103,170103,1,0,0,967,0.3333333333333333,95.60570651682221,4
2020-08-08-170103,170103,0,0,0,967,0.3333333333333333,105.37813591184084,5
2020-08-09-170103,170103,4,0,1,971,0.6666666666666666,111.44577377878625,6
2020-08-10-170103,170103,5,0,1,976,1.0,55.49814587213551,0
2020-08-11-170103,170103,0,0,2,976,0.3333333333333333,80.52384671021343,1
2020-08-12-170103,170103,1,0,2,977,2.0,129.6163921753188,2
2020-08-13-170103,170103,1,0,1,978,1.0,192.37769897765543,3
2020-08-14-170103,170103,1,0,2,979,1.6666666666666667,235.93006496672066,4
2020-08-15-170103,170103,0,0,0,979,0.6666666666666666,269.99308892864974,5
2020-08-16-170103,170103,0,0,4,979,0.6666666666666666,269.67205421675897,6
2020-08-17-170103,170103,2,0,3,981,0.3333333333333333,274.9147831001217,0
2020-08-18-170103,170103,0,0,0,981,0.3333333333333333,272.86939874128916,1
2020-08-19-170103,170103,3,0,4,984,3.0,236.37685482458915,2
2020-08-20-170103,170103,6,0,6,990,3.6666666666666665,138.4902047640304,3
2020-08-21-170103,170103,0,0,6,990,0.0,146.904255865457,4
2020-08-22-170103,170103,0,0,2,990,0.3333333333333333,148.8885519408648,5
2020-08-23-170103,170103,1,0,1,991,0.6666666666666666,163.80536018378012,6
2020-08-24-170103,170103,1,0,10,992,2.0,144.7898398259322,0
2020-08-25-170103,170103,2,0,7,994,1.3333333333333333,174.1969346936957,1
2020-08-26-170103,170103,2,0,2,996,1.0,180.2544725382471,2
2020-08-27-170103,170103,1,0,0,997,4.333333333333333,225.19287216176645,3
2020-08-28-170103,170103,2,0,7,999,1.3333333333333333,238.08344014588118,4
2020-08-29-170103,170103,0,1,0,999,0.6666666666666666,301.1126724782977,5
2020-08-30-170103,170103,4,0,14,1003,1.0,286.5223478654632,6
2020-08-31-170103,170103,3,0,1,1006,0.3333333333333333,270.00391501650535,0
2020-09-01-170103,170103,0,0,0,1006,0.6666666666666666,97.41111315173225,1
2020-09-02-170103,170103,4,0,9,1010,2.6666666666666665,418.92782462244094,2
2020-09-03-170103,170103,6,0,4,1016,3.0,521.5751471598444,3
2020-09-04-170103,170103,6,0,8,1022,2.6666666666666665,463.19419396280074,4
2020-09-05-170103,170103,2,0,4,1024,1.3333333333333333,476.94666304622103,5
2020-09-06-170103,170103,1,0,8,1025,1.6666666666666667,482.457724536735,6
2020-09-07-170103,170103,10,0,9,1035,4.0,461.04265775083604,0
2020-09-08-170103,170103,7,0,1,1042,4.666666666666667,457.6437523488553,1
2020-09-09-170103,170103,2,0,4,1044,1.6666666666666667,494.5743972255817,2
2020-09-10-170103,170103,0,0,21,1044,2.6666666666666665,106.2495873146515,3
2020-09-11-170103,170103,7,0,8,1051,2.0,141.2686714643535,4
2020-09-12-170103,170103,0,0,3,1051,1.6666666666666667,212.23242466622145,5
2020-09-13-170103,170103,14,0,3,1065,2.333333333333333,211.85569401582717,6
2020-09-14-170103,170103,1,0,10,1066,4.666666666666667,264.33262786018986,0
2020-09-15-170103,170103,0,0,6,1066,2.0,318.1475509115171,1
2020-09-16-170103,170103,9,0,10,1075,2.6666666666666665,339.758231986259,2
2020-09-17-170103,170103,4,0,8,1079,2.0,391.2812497851603,3
2020-09-18-170103,170103,8,0,12,1087,7.333333333333332,460.1780502913251,4
2020-09-19-170103,170103,4,1,9,1091,1.6666666666666667,437.9138367846787,5
2020-09-20-170103,170103,8,0,5,1099,6.0,408.0053867382797,6
2020-09-21-170103,170103,9,0,7,1108,4.0,441.9300498888903,0
2020-09-22-170103,170103,1,0,2,1109,1.6666666666666667,507.6314884554792,1
2020-09-23-170103,170103,4,0,9,1113,4.0,464.4354769103568,2
2020-09-24-170103,170103,21,0,2,1134,5.0,427.50356282480845,3
2020-09-25-170103,170103,8,0,8,1142,4.666666666666667,519.505873785888,4
2020-09-26-170103,170103,3,0,2,1145,3.0,584.9126950328996,5
2020-09-27-170103,170103,3,0,2,1148,1.3333333333333333,601.572481054585,6
2020-09-28-170103,170103,10,0,1,1158,6.0,545.3862574824531,0
2020-09-29-170103,170103,6,0,2,1164,1.3333333333333333,553.9580521576406,1
2020-09-30-170103,170103,10,0,3,1174,3.0,544.1944987725533,2
2020-10-01-170103,170103,8,0,0,1182,2.6666666666666665,0.0,3
2020-10-02-170103,170103,12,0,4,1194,5.666666666666668,649.5005592922239,4
2020-10-03-170103,170103,9,0,0,1203,4.333333333333333,1244.7753010394902,5
2020-10-04-170103,170103,5,0,10,1208,3.0,1088.765836800786,6
2020-10-05-170103,170103,7,1,14,1215,2.0,947.8033896484376,0
2020-10-06-170103,170103,2,0,5,1217,2.333333333333333,902.2225333899706,1
2020-10-07-170103,170103,9,0,8,1226,4.333333333333333,823.2496117158948,2
2020-10-08-170103,170103,2,0,14,1228,2.0,745.3732469001543,3
2020-10-09-170103,170103,8,3,17,1236,5.333333333333333,705.2545879013267,4
2020-10-10-170103,170103,2,0,7,1238,4.0,91.58513826475327,5
2020-10-11-170103,170103,2,0,9,1240,3.0,163.68164753151416,6
2020-10-12-170103,170103,1,0,14,1241,1.3333333333333333,195.81351960954385,0
2020-10-13-170103,170103,2,0,7,1243,3.333333333333333,195.65315884135788,1
2020-10-14-170103,170103,3,0,13,1246,7.0,301.35990515863665,2
2020-10-15-170103,170103,0,0,20,1246,0.0,427.27297387872795,3
2020-10-16-170103,170103,4,0,17,1250,3.0,408.8741462714572,4
2020-10-17-170103,170103,0,0,7,1250,0.6666666666666666,409.0677268498417,5
2020-10-18-170103,170103,10,1,5,1260,4.333333333333333,357.9411164206664,6
2020-10-19-170103,170103,14,0,7,1274,6.666666666666668,421.9354681155546,0
2020-10-20-170103,170103,5,0,11,1279,4.666666666666667,570.88617193514,1
2020-10-21-170103,170103,8,0,8,1287,6.0,524.906595563826,2
2020-10-22-170103,170103,14,0,11,1301,9.666666666666666,671.2854765624274,3
2020-10-23-170103,170103,17,0,16,1318,13.666666666666664,788.7735092920727,4
2020-10-24-170103,170103,7,0,13,1325,4.666666666666667,997.4389595128922,5
2020-10-25-170103,170103,9,0,7,1334,11.333333333333336,983.1329648536147,6
2020-10-26-170103,170103,14,0,10,1348,8.666666666666666,1022.2491679621542,0
2020-10-27-170103,170103,7,1,3,1355,5.0,1182.107252236874,1
2020-10-28-170103,170103,13,1,7,1368,5.0,1235.0154414114193,2
2020-10-29-170103,170103,20,0,11,1388,14.333333333333336,1219.8465286412234,3
2020-10-30-170103,170103,17,0,3,1405,13.333333333333336,1115.9244779137252,4
2020-10-31-170103,170103,7,2,0,1412,6.333333333333332,1229.0350247366032,5
2020-11-01-170103,170103,5,0,0,1417,7.0,621.5363376860367,6
2020-11-02-170103,170103,7,0,0,1424,2.6666666666666665,489.6984184916366,0
2020-11-03-170103,170103,11,0,0,1435,5.333333333333333,435.45558675099005,1
2020-11-04-170103,170103,8,0,0,1443,12.0,526.0836454184233,2
2020-11-05-170103,170103,11,0,0,1454,9.333333333333334,618.5320720658525,3
2020-11-06-170103,170103,16,1,0,1470,9.333333333333334,719.4313940273249,4
2020-11-07-170103,170103,13,0,0,1483,6.333333333333332,761.0827937175218,5
2020-11-08-170103,170103,7,0,0,1490,6.333333333333332,799.9369832442965,6
2020-11-09-170103,170103,10,0,0,1500,6.666666666666668,838.9747081735459,0
2020-11-10-170103,170103,3,1,0,1503,4.0,643.8354959176277,1
2020-11-11-170103,170103,7,0,0,1510,5.333333333333333,658.2076902518309,2
2020-11-12-170103,170103,11,0,0,1521,6.0,692.8785555930473,3
2020-11-13-170103,170103,3,0,0,1524,4.666666666666667,807.3278899077582,4
2020-03-01-170104,170104,0,0,1,0,0.0,0.0,6
2020-03-02-170104,170104,0,0,10,0,0.0,85.72959556648249,0
2020-03-03-170104,170104,0,0,13,0,0.0,459.8586083897239,1
2020-03-04-170104,170104,0,0,22,0,0.0,469.9457983146323,2
2020-03-05-170104,170104,0,0,22,0,0.0,501.46092493982394,3
2020-03-06-170104,170104,0,0,27,0,0.25,440.8575744759506,4
2020-03-07-170104,170104,0,0,16,0,0.0,461.3303073373005,5
2020-03-08-170104,170104,0,0,17,0,0.0,457.20646811073857,6
2020-03-09-170104,170104,1,0,26,1,0.25,459.91615456304936,0
2020-03-10-170104,170104,0,0,22,1,0.0,487.1279423920857,1
2020-03-11-170104,170104,2,0,32,3,1.25,394.54591066626443,2
2020-03-12-170104,170104,2,0,33,5,0.5,307.1407951310248,3
2020-03-13-170104,170104,5,0,33,10,1.5,232.874016185075,4
2020-03-14-170104,170104,0,0,10,10,1.0,166.17709577490115,5
2020-03-15-170104,170104,1,0,6,11,1.25,107.63540861392724,6
2020-03-16-170104,170104,10,0,17,21,9.25,50.22056515810638,0
2020-03-17-170104,170104,13,0,18,34,6.0,112.54515329960951,1
2020-03-18-170104,170104,22,0,12,56,24.25,155.66796075910685,2
2020-03-19-170104,170104,22,2,13,78,28.75,283.09656386764283,3
2020-03-20-170104,170104,27,1,29,105,29.75,441.4155536125958,4
2020-03-21-170104,170104,16,0,7,121,9.5,554.6648206397847,5
2020-03-22-170104,170104,17,0,4,138,13.5,574.5769031071194,6
2020-03-23-170104,170104,26,0,12,164,41.75,605.8685355578178,0
2020-03-24-170104,170104,22,0,12,186,35.5,767.0290683328835,1
2020-03-25-170104,170104,32,0,9,218,26.75,828.1781858236742,2
2020-03-26-170104,170104,33,0,7,251,23.0,800.1274777909296,3
2020-03-27-170104,170104,33,0,9,284,26.5,916.2018108027322,4
2020-03-28-170104,170104,10,0,4,294,9.0,906.543624201895,5
2020-03-29-170104,170104,6,0,1,300,8.5,902.523302383295,6
2020-03-30-170104,170104,17,0,6,317,21.0,654.6889109183479,0
2020-03-31-170104,170104,18,0,5,335,21.5,582.6998568094695,1
2020-04-01-170104,170104,12,0,5,347,16.0,113.15333419082451,2
2020-04-02-170104,170104,13,0,9,360,16.5,256.7761845908156,3
2020-04-03-170104,170104,29,0,15,389,14.5,116.65272333734434,4
2020-04-04-170104,170104,7,0,0,396,4.5,178.44027189949333,5
2020-04-05-170104,170104,4,0,1,400,4.75,197.41094307808956,6
2020-04-06-170104,170104,12,0,8,412,18.25,214.89284650791268,0
2020-04-07-170104,170104,12,0,3,424,13.0,266.7989103452956,1
2020-04-08-170104,170104,9,0,8,433,11.25,319.9344789527701,2
2020-04-09-170104,170104,7,0,2,440,12.25,353.7643661547905,3
2020-04-10-170104,170104,9,0,5,449,8.0,66.99261025707713,4
2020-04-11-170104,170104,4,0,1,453,3.75,102.2087639777304,5
2020-04-12-170104,170104,1,0,1,454,4.25,120.22287294124251,6
2020-04-13-170104,170104,6,0,5,460,10.25,135.20176368107536,0
2020-04-14-170104,170104,5,0,4,465,15.5,191.9850124135509,1
2020-04-15-170104,170104,5,0,7,470,10.75,252.65979470688063,2
2020-04-16-170104,170104,9,0,5,479,8.0,307.1303524356502,3
2020-04-17-170104,170104,15,0,0,494,7.0,290.57997889508994,4
2020-04-18-170104,170104,0,0,1,494,0.75,297.49238491257205,5
2020-04-19-170104,170104,1,0,2,495,2.25,282.84926427642364,6
2020-04-20-170104,170104,8,0,4,503,16.75,292.4777141342232,0
2020-04-21-170104,170104,3,0,5,506,7.25,325.38901983852094,1
2020-04-22-170104,170104,8,1,4,514,6.5,296.9434336964884,2
2020-04-23-170104,170104,2,0,1,516,1.75,293.2890022336852,3
2020-04-24-170104,170104,5,0,9,521,5.5,251.3536760439426,4
2020-04-25-170104,170104,1,0,0,522,0.75,280.42163975357425,5
2020-04-26-170104,170104,1,0,1,523,1.5,278.65442143939805,6
2020-04-27-170104,170104,5,0,9,528,6.75,208.77247212810946,0
2020-04-28-170104,170104,4,0,2,532,2.5,151.09895203559188,1
2020-04-29-170104,170104,7,0,5,539,4.5,139.03961138239416,2
2020-04-30-170104,170104,5,0,3,544,3.25,208.79026630191828,3
2020-05-01-170104,170104,0,0,6,544,0.75,356.007212073696,4
2020-05-02-170104,170104,1,0,1,545,2.5,194.4049103936323,5
2020-05-03-170104,170104,2,0,1,547,0.5,86.99975337870701,6
2020-05-04-170104,170104,4,0,27,551,9.0,61.96376123461365,0
2020-05-05-170104,170104,5,0,5,556,5.75,95.28984360397902,1
2020-05-06-170104,170104,4,0,3,560,7.75,117.90941604463595,2
2020-05-07-170104,170104,1,0,1,561,4.0,141.86493059971127,3
2020-05-08-170104,170104,9,0,1,570,6.25,146.90428338335886,4
2020-05-09-170104,170104,0,0,1,570,1.25,191.94250910353426,5
2020-05-10-170104,170104,1,0,0,571,1.5,388.0681794608044,6
2020-05-11-170104,170104,9,0,1,580,10.0,362.6835122987916,0
2020-05-12-170104,170104,2,0,3,582,5.75,383.86328239515575,1
2020-05-13-170104,170104,5,0,3,587,2.75,305.31490615537217,2
2020-05-14-170104,170104,3,5,5,590,4.25,238.91194207199686,3
2020-05-15-170104,170104,6,0,1,596,4.75,205.97192226807644,4
2020-05-16-170104,170104,1,0,0,597,2.0,172.69533377085224,5
2020-05-17-170104,170104,1,0,0,598,0.75,186.88137718413776,6
2020-05-18-170104,170104,27,0,2,625,18.5,183.79917003528658,0
2020-05-19-170104,170104,5,0,5,630,1.75,250.85303531609608,1
2020-05-20-170104,170104,3,0,1,633,2.5,227.66178300692644,2
2020-05-21-170104,170104,1,0,3,634,5.5,223.12219215438165,3
2020-05-22-170104,170104,1,0,2,635,3.25,224.06499548495987,4
2020-05-23-170104,170104,1,0,0,636,0.5,229.1558159316511,5
2020-05-24-170104,170104,0,0,0,636,1.25,232.14043483332742,6
2020-05-25-170104,170104,1,0,0,637,4.25,114.05578840885076,0
2020-05-26-170104,170104,3,0,1,640,2.75,126.31423889482656,1
2020-05-27-170104,170104,3,0,1,643,1.75,139.54912423001946,2
2020-05-28-170104,170104,5,2,0,648,4.25,134.11037560729693,3
2020-05-29-170104,170104,1,16,0,649,2.5,127.18962536232057,4
2020-05-30-170104,170104,0,0,0,649,0.0,125.16052009645895,5
2020-05-31-170104,170104,0,0,0,649,0.0,115.87335198638529,6
2020-06-01-170104,170104,2,1,0,651,2.0,253.28701509025677,0
2020-06-02-170104,170104,5,0,0,656,4.5,62.974614609859735,1
2020-06-03-170104,170104,1,0,1,657,2.0,55.40017609417388,2
2020-06-04-170104,170104,3,0,0,660,2.75,63.13808538785509,3
2020-06-05-170104,170104,2,0,0,662,1.75,69.78451482815176,4
2020-06-06-170104,170104,0,1,0,662,0.0,74.4709805994173,5
2020-06-07-170104,170104,0,0,0,662,0.25,74.61439023943356,6
2020-06-08-170104,170104,0,0,2,662,2.25,73.24106688055659,0
2020-06-09-170104,170104,1,0,0,663,1.5,77.34115508506093,1
2020-06-10-170104,170104,1,0,0,664,1.25,278.3763970231665,2
2020-06-11-170104,170104,0,0,2,664,1.0,223.87284745415445,3
2020-06-12-170104,170104,0,0,1,664,2.0,181.2625498777037,4
2020-06-13-170104,170104,0,0,0,664,0.25,131.542939853463,5
2020-06-14-170104,170104,0,0,1,664,0.0,107.70220194363938,6
2020-06-15-170104,170104,0,0,1,664,1.75,52.660337816204375,0
2020-06-16-170104,170104,0,0,1,664,3.0,56.65371447916188,1
2020-06-17-170104,170104,1,0,0,665,2.0,62.50630758836108,2
2020-06-18-170104,170104,0,0,1,665,1.25,65.84493577064578,3
2020-06-19-170104,170104,0,0,1,665,0.75,72.2179824181192,4
2020-06-20-170104,170104,0,0,0,665,0.25,99.66404191211242,5
2020-06-21-170104,170104,0,0,1,665,0.0,103.76789744109453,6
2020-06-22-170104,170104,2,0,2,667,2.5,92.02453794714214,0
2020-06-23-170104,170104,0,0,1,667,1.5,90.14210095941033,1
2020-06-24-170104,170104,0,0,0,667,1.25,85.61840722071432,2
2020-06-25-170104,170104,2,0,0,669,1.25,80.52048928411094,3
2020-06-26-170104,170104,1,0,0,670,1.25,90.18225817821866,4
2020-06-27-170104,170104,0,0,1,670,0.0,68.31359551488876,5
2020-06-28-170104,170104,1,0,0,671,0.5,65.40937209922467,6
2020-06-29-170104,170104,1,0,0,672,1.0,69.20660211003735,0
2020-06-30-170104,170104,1,1,0,673,1.75,64.63997270069493,1
2020-07-01-170104,170104,0,0,0,673,1.75,88.95151617093943,2
2020-07-02-170104,170104,1,0,0,674,0.5,27.424708504280773,3
2020-07-03-170104,170104,1,0,1,675,0.5,23.741526180723195,4
2020-07-04-170104,170104,0,0,0,675,0.25,22.716348274893843,5
2020-07-05-170104,170104,1,0,0,676,0.0,26.359401734645633,6
2020-07-06-170104,170104,2,0,0,678,0.5,21.684282336530835,0
2020-07-07-170104,170104,1,0,0,679,0.5,27.362179106455322,1
2020-07-08-170104,170104,0,0,0,679,0.5,33.998117293232205,2
2020-07-09-170104,170104,0,0,2,679,0.5,30.290452586696425,3
2020-07-10-170104,170104,0,0,0,679,1.25,80.42084569099394,4
2020-07-11-170104,170104,1,0,0,680,0.25,61.85194352315146,5
2020-07-12-170104,170104,0,0,0,680,0.25,51.95300405719735,6
2020-07-13-170104,170104,0,0,0,680,0.5,55.30311944127747,0
2020-07-14-170104,170104,0,0,1,680,0.0,57.69860367476005,1
2020-07-15-170104,170104,0,0,0,680,0.25,44.367672247326524,2
2020-07-16-170104,170104,0,0,0,680,0.25,37.41223418039038,3
2020-07-17-170104,170104,1,0,0,681,0.5,33.08040012934806,4
2020-07-18-170104,170104,0,0,0,681,0.25,33.17505585943049,5
2020-07-19-170104,170104,0,1,0,681,0.0,31.472602862133794,6
2020-07-20-170104,170104,0,0,0,681,0.0,28.8092025904242,0
2020-07-21-170104,170104,0,0,0,681,0.0,24.07985388127399,1
2020-07-22-170104,170104,0,0,0,681,0.5,21.033407419329762,2
2020-07-23-170104,170104,2,0,2,683,0.5,19.29439619557134,3
2020-07-24-170104,170104,0,0,0,683,0.5,20.379565833589254,4
2020-07-25-170104,170104,0,0,1,683,0.0,19.555638655790332,5
2020-07-26-170104,170104,0,0,1,683,0.0,18.94531301397813,6
2020-07-27-170104,170104,0,0,0,683,0.75,15.411013725804153,0
2020-07-28-170104,170104,1,0,0,684,0.0,19.73615684463637,1
2020-07-29-170104,170104,0,0,0,684,0.25,21.724987452774254,2
2020-07-30-170104,170104,0,0,0,684,0.5,21.638554492031005,3
2020-07-31-170104,170104,0,0,3,684,0.75,21.16983770289858,4
2020-08-01-170104,170104,0,0,0,684,0.0,35.21163915682584,5
2020-08-02-170104,170104,0,0,1,684,0.0,111.57177326071367,6
2020-08-03-170104,170104,0,0,0,684,0.0,162.88212081942424,0
2020-08-04-170104,170104,0,0,0,684,0.25,137.2742964633456,1
2020-08-05-170104,170104,0,1,4,684,0.25,115.14429532662396,2
2020-08-06-170104,170104,2,0,6,686,0.5,89.00703857889785,3
2020-08-07-170104,170104,0,1,0,686,0.5,53.78472879980396,4
2020-08-08-170104,170104,1,0,0,687,0.0,59.73776090860915,5
2020-08-09-170104,170104,1,0,0,688,1.25,63.50105729405915,6
2020-08-10-170104,170104,0,0,2,688,2.5,33.080526481432706,0
2020-08-11-170104,170104,0,0,1,688,2.25,44.65820498854099,1
2020-08-12-170104,170104,0,0,1,688,3.75,74.14578691941594,2
2020-08-13-170104,170104,0,0,5,688,2.5,109.3058343169965,3
2020-08-14-170104,170104,3,0,0,691,1.5,133.03020236334393,4
2020-08-15-170104,170104,0,0,0,691,0.75,155.26531974759268,5
2020-08-16-170104,170104,1,0,0,692,0.25,155.04329356186878,6
2020-08-17-170104,170104,0,1,1,692,1.25,157.74138253099107,0
2020-08-18-170104,170104,0,0,2,692,0.5,160.67981839826467,1
2020-08-19-170104,170104,4,0,2,696,2.0,138.71335383867566,2
2020-08-20-170104,170104,6,0,2,702,3.0,80.65373374833098,3
2020-08-21-170104,170104,0,1,3,702,0.25,82.53239287294599,4
2020-08-22-170104,170104,0,0,2,702,0.5,84.4466874319387,5
2020-08-23-170104,170104,0,0,1,702,0.75,94.28719033961035,6
2020-08-24-170104,170104,2,0,2,704,1.5,81.67917264015554,0
2020-08-25-170104,170104,1,0,3,705,2.0,96.96813589369889,1
2020-08-26-170104,170104,1,0,2,706,2.0,101.1967104817221,2
2020-08-27-170104,170104,5,0,1,711,3.0,125.28939123435664,3
2020-08-28-170104,170104,0,0,0,711,3.0,130.60500535571379,4
2020-08-29-170104,170104,0,0,5,711,0.5,166.66137455560778,5
2020-08-30-170104,170104,0,0,1,711,1.75,157.73960024396845,6
2020-08-31-170104,170104,1,0,6,712,1.5,149.34574301206695,0
2020-09-01-170104,170104,2,0,3,714,0.75,55.546734992489334,1
2020-09-02-170104,170104,2,0,3,716,2.75,229.92176917208292,2
2020-09-03-170104,170104,2,0,2,718,3.5,276.8287795185757,3
2020-09-04-170104,170104,3,0,8,721,4.0,243.6180535800523,4
2020-09-05-170104,170104,2,0,3,723,2.25,244.1615030210725,5
2020-09-06-170104,170104,1,0,9,724,1.25,247.2401712736762,6
2020-09-07-170104,170104,2,0,7,726,5.75,233.54980910412542,0
2020-09-08-170104,170104,3,0,2,729,5.0,229.8630725127299,1
2020-09-09-170104,170104,2,0,6,731,2.25,248.84013088401164,2
2020-09-10-170104,170104,1,0,3,732,2.5,55.54560787444702,3
2020-09-11-170104,170104,0,0,5,732,4.25,75.43266918953722,4
2020-09-12-170104,170104,5,0,4,737,0.25,113.7656621853298,5
2020-09-13-170104,170104,1,0,1,738,5.5,113.99411084277281,6
2020-09-14-170104,170104,6,0,6,744,3.5,137.8887766810077,0
2020-09-15-170104,170104,3,0,1,747,1.5,166.95272428425037,1
2020-09-16-170104,170104,3,0,3,750,4.5,179.31210097121829,2
2020-09-17-170104,170104,2,0,3,752,3.5,206.4172796240394,3
2020-09-18-170104,170104,8,1,6,760,6.75,242.36846595713268,4
2020-09-19-170104,170104,3,1,3,763,1.5,231.0773886952265,5
2020-09-20-170104,170104,9,0,7,772,5.25,212.73983983207796,6
2020-09-21-170104,170104,7,0,1,779,5.0,228.40112287976345,0
2020-09-22-170104,170104,2,0,2,781,1.75,258.83084778745587,1
2020-09-23-170104,170104,6,0,4,787,3.5,237.2920538777537,2
2020-09-24-170104,170104,3,1,5,790,10.25,217.27609941002552,3
2020-09-25-170104,170104,5,0,3,795,5.75,257.5820613974853,4
2020-09-26-170104,170104,4,0,6,799,2.5,290.9368913703916,5
2020-09-27-170104,170104,1,0,6,800,2.25,300.39601464734693,6
2020-09-28-170104,170104,6,0,0,806,6.75,274.62122495670224,0
2020-09-29-170104,170104,1,0,5,807,2.5,276.5787890880738,1
2020-09-30-170104,170104,3,0,10,810,5.0,269.5356395643669,2
2020-10-01-170104,170104,3,0,0,813,5.25,0.0,3
2020-10-02-170104,170104,6,0,2,819,8.0,333.8703455664947,4
2020-10-03-170104,170104,3,0,1,822,6.0,629.4606706389683,5
2020-10-04-170104,170104,7,1,2,829,3.25,545.767353427276,6
2020-10-05-170104,170104,1,1,3,830,4.5,476.9010221106818,0
2020-10-06-170104,170104,2,0,6,832,3.25,455.5292307401023,1
2020-10-07-170104,170104,4,0,13,836,6.25,416.3021465726214,2
2020-10-08-170104,170104,5,0,11,841,1.5,378.70210069597726,3
2020-10-09-170104,170104,3,1,10,844,8.25,363.91708357619075,4
2020-10-10-170104,170104,6,0,6,850,3.75,47.795230314600914,5
2020-10-11-170104,170104,6,0,18,856,1.25,87.61254966132752,6
2020-10-12-170104,170104,0,0,4,856,1.5,106.11462733162824,0
2020-10-13-170104,170104,5,0,8,861,4.75,107.43617519887684,1
2020-10-14-170104,170104,10,0,6,871,5.75,165.7562055146666,2
2020-10-15-170104,170104,0,0,6,871,0.0,233.5746618279182,3
2020-10-16-170104,170104,2,0,10,873,4.5,225.33347690051315,4
2020-10-17-170104,170104,1,0,9,874,0.5,223.93107875905642,5
2020-10-18-170104,170104,2,0,10,876,7.25,193.68440909345537,6
2020-10-19-170104,170104,3,0,2,879,11.25,220.57605024741727,0
2020-10-20-170104,170104,6,0,5,885,4.25,289.14014907340385,1
2020-10-21-170104,170104,13,0,11,898,6.25,262.9315646351894,2
2020-10-22-170104,170104,11,0,5,909,9.75,340.1860005203159,3
2020-10-23-170104,170104,10,0,8,919,16.0,392.2270794956314,4
2020-10-24-170104,170104,6,0,11,925,5.0,493.80643660476505,5
2020-10-25-170104,170104,18,0,7,943,11.75,483.9018351630354,6
2020-10-26-170104,170104,4,0,11,947,12.5,506.59352455295664,0
2020-10-27-170104,170104,8,0,3,955,6.5,583.8523237601637,1
2020-10-28-170104,170104,6,0,3,961,7.75,616.5908061729662,2
2020-10-29-170104,170104,6,0,8,967,16.0,599.7132324945571,3
2020-10-30-170104,170104,10,0,6,977,14.0,546.3063609549447,4
2020-10-31-170104,170104,9,0,0,986,5.25,600.8413701377922,5
2020-11-01-170104,170104,10,0,0,996,5.75,311.96833747599175,6
2020-11-02-170104,170104,2,0,0,998,3.75,240.65749102971648,0
2020-11-03-170104,170104,5,0,0,1003,7.25,213.69923985778337,1
2020-11-04-170104,170104,11,0,0,1014,10.25,256.4901578393858,2
2020-11-05-170104,170104,5,0,0,1019,11.25,300.7872817732164,3
2020-11-06-170104,170104,8,0,0,1027,12.25,350.93932042667916,4
2020-11-07-170104,170104,11,0,0,1038,7.5,368.46637711471146,5
2020-11-08-170104,170104,7,0,0,1045,6.0,386.7476017914332,6
2020-11-09-170104,170104,11,0,0,1056,6.5,404.8592255202941,0
2020-11-10-170104,170104,3,0,0,1059,5.0,318.02965733558597,1
2020-11-11-170104,170104,3,0,0,1062,7.0,325.0238330642054,2
2020-11-12-170104,170104,8,1,0,1070,9.0,345.1904655222759,3
2020-11-13-170104,170104,6,1,0,1076,3.5,403.89785659409114,4
2020-03-01-170105,170105,0,0,0,0,0.07142857142857142,0.0,6
2020-03-02-170105,170105,0,0,4,0,0.0,75.4161952404873,0
2020-03-03-170105,170105,0,1,1,0,0.0,325.5133676694077,1
2020-03-04-170105,170105,0,0,11,0,0.07142857142857142,345.0393086133756,2
2020-03-05-170105,170105,0,0,6,0,0.14285714285714285,367.7071224455694,3
2020-03-06-170105,170105,0,0,4,0,0.07142857142857142,348.07475439723845,4
2020-03-07-170105,170105,0,0,1,0,0.0,354.4164381430468,5
2020-03-08-170105,170105,0,1,0,0,0.0,335.8099705621146,6
2020-03-09-170105,170105,0,0,13,0,0.14285714285714285,332.39720664188746,0
2020-03-10-170105,170105,0,0,6,0,0.2857142857142857,472.2671578215088,1
2020-03-11-170105,170105,1,0,7,1,0.5,388.2116539771629,2
2020-03-12-170105,170105,0,0,8,1,0.6428571428571429,281.99761184250394,3
2020-03-13-170105,170105,2,0,6,3,1.3571428571428572,186.75099023934652,4
2020-03-14-170105,170105,0,0,3,3,1.1428571428571428,153.2811465279956,5
2020-03-15-170105,170105,0,0,2,3,1.1428571428571428,110.52943478568946,6
2020-03-16-170105,170105,4,0,7,7,4.642857142857143,74.36494257120727,0
2020-03-17-170105,170105,1,0,9,8,4.5,133.61869675618942,1
2020-03-18-170105,170105,11,1,6,19,9.928571428571429,172.56935714666992,2
2020-03-19-170105,170105,6,2,11,25,13.214285714285715,283.1553957879979,3
2020-03-20-170105,170105,4,2,3,29,13.214285714285715,386.63141756151094,4
2020-03-21-170105,170105,1,0,2,30,5.0,464.3300538857974,5
2020-03-22-170105,170105,0,0,1,30,6.142857142857142,465.82944204803766,6
2020-03-23-170105,170105,13,0,10,43,17.0,459.1796949068359,0
2020-03-24-170105,170105,6,0,5,49,13.857142857142858,591.131402239429,1
2020-03-25-170105,170105,7,0,2,56,12.857142857142858,589.289410466426,2
2020-03-26-170105,170105,8,0,5,64,11.357142857142858,574.3314528532193,3
2020-03-27-170105,170105,6,0,6,70,11.714285714285715,663.6074226430551,4
2020-03-28-170105,170105,3,0,0,73,5.071428571428571,650.9668641739269,5
2020-03-29-170105,170105,2,0,8,75,4.428571428571429,656.2090352978479,6
2020-03-30-170105,170105,7,0,3,82,9.357142857142858,486.1460489355626,0
2020-03-31-170105,170105,9,0,17,91,9.428571428571429,466.4243820595011,1
2020-04-01-170105,170105,6,0,3,97,7.571428571428571,98.17250148610552,2
2020-04-02-170105,170105,11,0,6,108,8.142857142857142,317.4989648665672,3
2020-04-03-170105,170105,3,0,2,111,7.357142857142858,148.11890367085,4
2020-04-04-170105,170105,2,0,1,113,2.642857142857143,180.7137772957695,5
2020-04-05-170105,170105,1,0,4,114,2.142857142857143,184.73457464294538,6
2020-04-06-170105,170105,10,0,9,124,7.7142857142857135,200.21975751956603,0
2020-04-07-170105,170105,5,0,7,129,6.0,249.60364903933504,1
2020-04-08-170105,170105,2,0,1,131,5.071428571428571,283.68983658299646,2
2020-04-09-170105,170105,5,0,0,136,4.642857142857143,288.27097332371955,3
2020-04-10-170105,170105,6,0,0,142,5.428571428571429,76.14408720570529,4
2020-04-11-170105,170105,0,2,0,142,2.4285714285714284,142.1390711107679,5
2020-04-12-170105,170105,8,0,0,150,1.1428571428571428,157.44313680855387,6
2020-04-13-170105,170105,3,0,1,153,5.7142857142857135,195.00291097352243,0
2020-04-14-170105,170105,17,0,1,170,5.285714285714286,251.1957403885218,1
2020-04-15-170105,170105,3,0,3,173,4.5,345.6706446643916,2
2020-04-16-170105,170105,6,0,2,179,3.7142857142857135,397.5981872592921,3
2020-04-17-170105,170105,2,0,0,181,4.642857142857143,382.15117580129805,4
2020-04-18-170105,170105,1,0,5,182,0.8571428571428571,356.8355600550826,5
2020-04-19-170105,170105,4,0,1,186,0.8571428571428571,352.1663622064476,6
2020-04-20-170105,170105,9,0,3,195,6.357142857142858,380.5791337154723,0
2020-04-21-170105,170105,7,0,1,202,2.8571428571428568,356.3595998606259,1
2020-04-22-170105,170105,1,0,3,203,3.7857142857142856,346.28155866310885,2
2020-04-23-170105,170105,0,0,2,203,1.0714285714285714,340.689489054207,3
2020-04-24-170105,170105,0,0,3,203,3.4285714285714284,305.62866063324896,4
2020-04-25-170105,170105,0,0,1,203,1.2857142857142858,331.35715315369197,5
2020-04-26-170105,170105,0,0,2,203,0.7857142857142857,331.10511933381474,6
2020-04-27-170105,170105,1,0,7,204,4.0,230.2643626958801,0
2020-04-28-170105,170105,1,0,3,205,1.7142857142857142,190.14506308221618,1
2020-04-29-170105,170105,3,0,0,208,3.071428571428572,170.26890759879757,2
2020-04-30-170105,170105,2,0,2,210,1.6428571428571428,224.42126704177463,3
2020-05-01-170105,170105,0,0,1,210,0.35714285714285715,322.79570753280086,4
2020-05-02-170105,170105,5,0,0,215,0.6428571428571429,156.7305293457615,5
2020-05-03-170105,170105,1,0,1,216,0.5,98.47373570788247,6
2020-05-04-170105,170105,3,0,5,219,3.6428571428571432,86.45725928872292,0
2020-05-05-170105,170105,1,0,1,220,2.4285714285714284,106.45964364266244,1
2020-05-06-170105,170105,3,0,0,223,3.071428571428572,117.5878804733982,2
2020-05-07-170105,170105,2,0,1,225,1.8571428571428568,128.58341399889537,3
2020-05-08-170105,170105,3,0,1,228,4.714285714285714,149.90077881040315,4
2020-05-09-170105,170105,1,0,1,229,0.6428571428571429,195.44280143870986,5
2020-05-10-170105,170105,2,0,0,231,0.5714285714285714,362.70417116310324,6
2020-05-11-170105,170105,7,0,0,238,3.6428571428571432,347.5521436185294,0
2020-05-12-170105,170105,3,0,2,241,2.7857142857142856,379.50677038841826,1
2020-05-13-170105,170105,0,1,0,241,2.0,300.7156388539837,2
2020-05-14-170105,170105,2,0,2,243,1.7857142857142858,245.382439648625,3
2020-05-15-170105,170105,1,0,1,244,2.357142857142857,215.66205599737975,4
2020-05-16-170105,170105,0,0,0,244,0.9285714285714286,177.5147867874271,5
2020-05-17-170105,170105,1,0,0,245,0.2857142857142857,181.8806329544764,6
2020-05-18-170105,170105,5,0,0,250,8.0,175.04221589846304,0
2020-05-19-170105,170105,1,0,5,251,1.2857142857142858,195.85988375619195,1
2020-05-20-170105,170105,0,0,1,251,1.4285714285714286,188.39943810777442,2
2020-05-21-170105,170105,1,0,1,252,2.2142857142857144,184.78594208683074,3
2020-05-22-170105,170105,1,1,0,253,1.8571428571428568,187.32669576748813,4
2020-05-23-170105,170105,1,0,0,254,0.2857142857142857,209.9786428125345,5
2020-05-24-170105,170105,0,1,0,254,0.5714285714285714,215.55414794982417,6
2020-05-25-170105,170105,0,0,1,254,1.7857142857142858,135.9296788849468,0
2020-05-26-170105,170105,2,0,1,256,1.4285714285714286,141.20166190563586,1
2020-05-27-170105,170105,0,0,0,256,1.6428571428571428,141.84037606883368,2
2020-05-28-170105,170105,2,2,0,258,2.7857142857142856,143.84090240139432,3
2020-05-29-170105,170105,1,1,2,259,0.8571428571428571,151.36234302286852,4
2020-05-30-170105,170105,0,0,0,259,0.21428571428571427,145.48512980574867,5
2020-05-31-170105,170105,0,0,0,259,0.21428571428571427,141.12177318059724,6
2020-06-01-170105,170105,0,0,1,259,1.1428571428571428,259.905343184076,0
2020-06-02-170105,170105,5,0,1,264,2.2142857142857144,78.48651008203777,1
2020-06-03-170105,170105,1,0,1,265,1.1428571428571428,66.45941263749725,2
2020-06-04-170105,170105,1,0,0,266,1.5,70.79774409835872,3
2020-06-05-170105,170105,0,0,0,266,1.0,81.90997948655273,4
2020-06-06-170105,170105,0,0,0,266,0.21428571428571427,80.89403205063502,5
2020-06-07-170105,170105,0,0,0,266,0.14285714285714285,78.93344450643116,6
2020-06-08-170105,170105,1,0,1,267,1.2142857142857142,72.10027882629899,0
2020-06-09-170105,170105,1,0,1,268,0.7142857142857143,85.5878855711031,1
2020-06-10-170105,170105,0,0,0,268,0.7142857142857143,261.5228578410725,2
2020-06-11-170105,170105,0,0,0,268,0.6428571428571429,213.59569900770146,3
2020-06-12-170105,170105,2,0,0,270,0.8571428571428571,185.13289489688214,4
2020-06-13-170105,170105,0,0,0,270,0.2857142857142857,150.79302545561353,5
2020-06-14-170105,170105,0,0,1,270,0.35714285714285715,121.18766076728592,6
2020-06-15-170105,170105,1,0,0,271,0.6428571428571429,67.74585713683379,0
2020-06-16-170105,170105,1,0,0,272,1.2857142857142858,67.28487390945713,1
2020-06-17-170105,170105,1,1,1,273,1.0714285714285714,72.26687389607685,2
2020-06-18-170105,170105,0,0,1,273,0.9285714285714286,80.06022817667316,3
2020-06-19-170105,170105,0,0,0,273,0.8571428571428571,87.08762222134891,4
2020-06-20-170105,170105,0,0,0,273,0.35714285714285715,119.44684207419445,5
2020-06-21-170105,170105,0,0,0,273,0.42857142857142855,127.37752649612804,6
2020-06-22-170105,170105,1,0,0,274,0.9285714285714286,116.74095176957493,0
2020-06-23-170105,170105,1,0,0,275,0.5,114.71469581388553,1
2020-06-24-170105,170105,0,2,0,275,0.7857142857142857,113.40037327718487,2
2020-06-25-170105,170105,0,0,0,275,0.7142857142857143,114.24649614654238,3
2020-06-26-170105,170105,0,0,2,275,0.7142857142857143,118.66190020827942,4
2020-06-27-170105,170105,0,0,0,275,0.21428571428571427,86.80797028477414,5
2020-06-28-170105,170105,1,0,0,276,0.2857142857142857,82.11217957337908,6
2020-06-29-170105,170105,0,0,1,276,0.5714285714285714,90.34238602632072,0
2020-06-30-170105,170105,0,0,0,276,0.7142857142857143,92.042612362019,1
2020-07-01-170105,170105,1,0,0,277,0.8571428571428571,105.34020767331532,2
2020-07-02-170105,170105,1,0,0,278,0.35714285714285715,89.65264904833582,3
2020-07-03-170105,170105,0,0,0,278,0.42857142857142855,44.10430930419996,4
2020-07-04-170105,170105,0,0,0,278,0.21428571428571427,60.4397968957001,5
2020-07-05-170105,170105,0,0,0,278,0.07142857142857142,61.44559228878996,6
2020-07-06-170105,170105,0,0,0,278,0.6428571428571429,51.8914459742928,0
2020-07-07-170105,170105,0,0,0,278,0.42857142857142855,58.915028439414385,1
2020-07-08-170105,170105,0,0,1,278,0.21428571428571427,62.797056267369825,2
2020-07-09-170105,170105,0,0,0,278,0.6428571428571429,57.83151678284037,3
2020-07-10-170105,170105,2,2,0,280,0.7857142857142857,106.66011094053252,4
2020-07-11-170105,170105,0,0,0,280,0.42857142857142855,107.45194945560208,5
2020-07-12-170105,170105,0,0,0,280,0.14285714285714285,109.96236294981149,6
2020-07-13-170105,170105,1,0,0,281,0.5714285714285714,110.9975547611466,0
2020-07-14-170105,170105,0,0,0,281,0.42857142857142855,128.9270082256238,1
2020-07-15-170105,170105,0,0,0,281,0.42857142857142855,112.94270283775776,2
2020-07-16-170105,170105,0,0,0,281,0.14285714285714285,104.71381455706972,3
2020-07-17-170105,170105,0,1,2,281,0.5714285714285714,97.76368450299836,4
2020-07-18-170105,170105,0,0,0,281,0.35714285714285715,92.59452152917234,5
2020-07-19-170105,170105,0,0,0,281,0.07142857142857142,90.07872662146957,6
2020-07-20-170105,170105,0,0,0,281,0.5714285714285714,89.1887678383535,0
2020-07-21-170105,170105,0,0,0,281,0.07142857142857142,93.72632754965,1
2020-07-22-170105,170105,1,0,1,282,0.35714285714285715,86.65912112854821,2
2020-07-23-170105,170105,0,0,1,282,0.42857142857142855,87.88224256843975,3
2020-07-24-170105,170105,0,1,0,282,0.35714285714285715,75.76661456010919,4
2020-07-25-170105,170105,0,0,0,282,0.07142857142857142,65.6412592464851,5
2020-07-26-170105,170105,0,0,1,282,0.07142857142857142,62.767498038284025,6
2020-07-27-170105,170105,0,0,2,282,0.42857142857142855,48.86386102447683,0
2020-07-28-170105,170105,0,0,1,282,0.14285714285714285,44.94189466522891,1
2020-07-29-170105,170105,0,0,1,282,0.35714285714285715,49.292114918958305,2
2020-07-30-170105,170105,0,0,0,282,0.5714285714285714,44.419330125297805,3
2020-07-31-170105,170105,2,0,2,284,0.35714285714285715,50.902895093525515,4
2020-08-01-170105,170105,0,1,1,284,0.07142857142857142,59.951312762659015,5
2020-08-02-170105,170105,0,0,1,284,0.14285714285714285,349.99162441125924,6
2020-08-03-170105,170105,0,0,0,284,0.5714285714285714,316.59551035326666,0
2020-08-04-170105,170105,0,0,0,284,0.35714285714285715,270.1828645031799,1
2020-08-05-170105,170105,1,0,1,285,0.5714285714285714,242.2922537896867,2
2020-08-06-170105,170105,1,0,0,286,0.8571428571428571,231.52197060488396,3
2020-08-07-170105,170105,0,0,0,286,0.9285714285714286,228.76729446155406,4
2020-08-08-170105,170105,0,0,1,286,1.2142857142857142,233.19283813453234,5
2020-08-09-170105,170105,1,0,1,287,0.7857142857142857,278.03111482613946,6
2020-08-10-170105,170105,2,0,1,289,0.9285714285714286,45.71668496651931,0
2020-08-11-170105,170105,1,0,0,290,1.5714285714285714,80.28090734255933,1
2020-08-12-170105,170105,1,0,1,291,1.7857142857142858,135.79548486380145,2
2020-08-13-170105,170105,0,0,0,291,2.0,211.8128238539018,3
2020-08-14-170105,170105,2,0,1,293,1.2142857142857142,278.8438684701951,4
2020-08-15-170105,170105,1,1,2,294,1.1428571428571428,352.4868018167418,5
2020-08-16-170105,170105,1,0,2,295,0.35714285714285715,375.3322497534094,6
2020-08-17-170105,170105,0,0,0,295,1.4285714285714286,386.1074962943366,0
2020-08-18-170105,170105,0,0,0,295,1.2857142857142858,402.079309187382,1
2020-08-19-170105,170105,1,0,2,296,2.2857142857142856,380.07130915571724,2
2020-08-20-170105,170105,0,0,0,296,2.4285714285714284,279.32462331715533,3
2020-08-21-170105,170105,0,0,2,296,2.2857142857142856,262.96654115271764,4
2020-08-22-170105,170105,1,0,0,297,0.8571428571428571,286.7060213351989,5
2020-08-23-170105,170105,1,0,3,298,1.0,303.02889306236204,6
2020-08-24-170105,170105,1,0,0,299,1.7142857142857142,280.5720924853868,0
2020-08-25-170105,170105,0,0,5,299,2.4285714285714284,291.2512898073886,1
2020-08-26-170105,170105,1,0,1,300,2.2142857142857144,277.4969113457511,2
2020-08-27-170105,170105,0,0,2,300,2.642857142857143,319.80900172407325,3
2020-08-28-170105,170105,1,0,4,301,2.071428571428572,310.876859391276,4
2020-08-29-170105,170105,2,1,0,303,1.0714285714285714,297.03583478126626,5
2020-08-30-170105,170105,2,0,1,305,1.1428571428571428,278.9187308852297,6
2020-08-31-170105,170105,0,0,5,305,2.0,260.8794683148583,0
2020-09-01-170105,170105,0,0,2,305,1.2857142857142858,234.96481483656908,1
2020-09-02-170105,170105,2,0,0,307,1.7857142857142858,400.41899727463897,2
2020-09-03-170105,170105,0,0,1,307,2.9285714285714284,374.97124926947885,3
2020-09-04-170105,170105,2,0,6,309,2.571428571428572,345.5553479073283,4
2020-09-05-170105,170105,0,0,0,309,1.8571428571428568,338.5402975416016,5
2020-09-06-170105,170105,3,0,0,312,1.2142857142857142,322.65521451066735,6
2020-09-07-170105,170105,0,0,1,312,3.3571428571428568,337.33745314043176,0
2020-09-08-170105,170105,5,0,2,317,2.642857142857143,333.60516174140326,1
2020-09-09-170105,170105,1,0,4,318,2.2142857142857144,360.6143219740212,2
2020-09-10-170105,170105,2,0,5,320,1.3571428571428572,187.04547376863957,3
2020-09-11-170105,170105,4,0,5,324,2.7142857142857144,206.75869262421142,4
2020-09-12-170105,170105,0,0,1,324,0.8571428571428571,247.71281817509714,5
2020-09-13-170105,170105,1,0,0,325,1.7857142857142858,228.15641782800807,6
2020-09-14-170105,170105,5,0,3,330,3.3571428571428568,224.29478835566093,0
2020-09-15-170105,170105,2,0,1,332,1.5,253.25585618179798,1
2020-09-16-170105,170105,0,0,3,332,3.6428571428571432,274.70483863911363,2
2020-09-17-170105,170105,1,0,2,333,2.4285714285714284,318.33872455732114,3
2020-09-18-170105,170105,6,0,3,339,4.285714285714286,348.08706046830986,4
2020-09-19-170105,170105,0,0,3,339,1.7857142857142858,347.7515702000533,5
2020-09-20-170105,170105,0,0,1,339,3.0,349.2841198592082,6
2020-09-21-170105,170105,1,0,1,340,3.0,297.32682531444755,0
2020-09-22-170105,170105,2,0,2,342,2.2142857142857144,298.5035952072293,1
2020-09-23-170105,170105,4,1,1,346,4.285714285714286,276.947748643888,2
2020-09-24-170105,170105,5,0,0,351,4.785714285714286,274.2841873157412,3
2020-09-25-170105,170105,5,1,5,356,4.214285714285714,276.27871982867697,4
2020-09-26-170105,170105,1,0,3,357,2.571428571428572,316.7690164680879,5
2020-09-27-170105,170105,0,0,0,357,1.0,328.20210403191703,6
2020-09-28-170105,170105,3,0,4,360,3.4285714285714284,312.9614374885715,0
2020-09-29-170105,170105,1,0,1,361,1.8571428571428568,327.8552346627439,1
2020-09-30-170105,170105,3,0,5,364,3.8571428571428568,309.88324032852506,2
2020-10-01-170105,170105,2,0,0,366,3.7857142857142856,0.0,3
2020-10-02-170105,170105,3,0,4,369,4.428571428571429,308.0441362806589,4
2020-10-03-170105,170105,3,1,1,372,2.2857142857142856,601.0444572367425,5
2020-10-04-170105,170105,1,1,1,373,2.642857142857143,586.1629226651144,6
2020-10-05-170105,170105,1,1,6,374,2.357142857142857,517.6473097074684,0
2020-10-06-170105,170105,2,0,2,376,2.642857142857143,489.65087085145865,1
2020-10-07-170105,170105,1,0,0,377,2.7857142857142856,433.98553360078915,2
2020-10-08-170105,170105,0,1,7,377,1.7142857142857142,353.3436945866391,3
2020-10-09-170105,170105,5,0,6,382,3.1428571428571432,347.37226710602397,4
2020-10-10-170105,170105,3,0,3,385,1.6428571428571428,45.44125310116972,5
2020-10-11-170105,170105,0,0,6,385,1.3571428571428572,79.3532609597605,6
2020-10-12-170105,170105,4,0,2,389,0.5,97.19857430048592,0
2020-10-13-170105,170105,1,0,3,390,2.9285714285714284,121.97365281674439,1
2020-10-14-170105,170105,5,0,4,395,3.0,166.00209679785763,2
2020-10-15-170105,170105,0,0,20,395,0.5,229.01926823099257,3
2020-10-16-170105,170105,4,0,8,399,2.071428571428572,236.63961643482588,4
2020-10-17-170105,170105,1,0,5,400,1.3571428571428572,225.27256188773163,5
2020-10-18-170105,170105,1,0,1,401,2.8571428571428568,213.784042253429,6
2020-10-19-170105,170105,6,1,1,407,4.428571428571429,228.6861712020616,0
2020-10-20-170105,170105,2,0,7,409,3.071428571428572,278.179617935121,1
2020-10-21-170105,170105,0,0,11,409,4.428571428571429,253.97094476116771,2
2020-10-22-170105,170105,7,0,12,416,4.571428571428571,316.401630858651,3
2020-10-23-170105,170105,6,0,6,422,6.642857142857142,366.3351256295149,4
2020-10-24-170105,170105,3,1,3,425,3.571428571428572,421.14624880585745,5
2020-10-25-170105,170105,6,0,3,431,6.0,432.3107845850683,6
2020-10-26-170105,170105,2,1,0,433,6.142857142857142,435.3807849247356,0
2020-10-27-170105,170105,3,1,0,436,4.428571428571429,486.9642179980556,1
2020-10-28-170105,170105,4,1,1,440,6.0,509.14149789584843,2
2020-10-29-170105,170105,20,0,1,460,6.357142857142858,520.424722717472,3
2020-10-30-170105,170105,8,0,2,468,8.071428571428571,528.7021766304099,4
2020-10-31-170105,170105,5,1,0,473,3.5,599.1189755415024,5
2020-11-01-170105,170105,1,0,0,474,5.7142857142857135,305.31102856160174,6
2020-11-02-170105,170105,1,0,0,475,2.142857142857143,252.60693547700686,0
2020-11-03-170105,170105,7,0,0,482,3.928571428571429,208.545383296296,1
2020-11-04-170105,170105,11,1,0,493,5.357142857142857,273.7048444139706,2
2020-11-05-170105,170105,12,0,0,505,6.7142857142857135,324.5937326186305,3
2020-11-06-170105,170105,6,1,0,511,8.071428571428571,391.0755587186293,4
2020-11-07-170105,170105,3,1,0,514,4.428571428571429,444.208130779779,5
2020-11-08-170105,170105,3,1,0,517,2.7142857142857144,456.3706286246721,6
2020-11-09-170105,170105,0,0,0,517,3.7142857142857135,462.10311771580814,0
2020-11-10-170105,170105,0,0,0,517,3.3571428571428568,295.3293166992537,1
2020-11-11-170105,170105,1,2,0,518,4.214285714285714,307.1264003229575,2
2020-11-12-170105,170105,1,0,0,519,5.0,345.395119117897,3
2020-11-13-170105,170105,2,2,0,521,4.0,390.7405221431328,4
2020-03-01-170106,170106,0,0,0,0,0.0,0.0,6
2020-03-02-170106,170106,0,0,1,0,0.0,4.654943906960524,0
2020-03-03-170106,170106,0,0,0,0,0.0,19.220057045387357,1
2020-03-04-170106,170106,0,0,1,0,0.0,25.716205260048447,2
2020-03-05-170106,170106,0,2,2,0,0.25,28.25628337460448,3
2020-03-06-170106,170106,0,0,1,0,0.0,29.181783191477088,4
2020-03-07-170106,170106,0,1,2,0,0.0,33.711819159924815,5
2020-03-08-170106,170106,0,0,3,0,0.0,30.990132123788726,6
2020-03-09-170106,170106,0,0,4,0,0.0,30.83791203388408,0
2020-03-10-170106,170106,0,0,2,0,0.0,87.10372179843198,1
2020-03-11-170106,170106,0,0,4,0,0.0,66.32477284339056,2
2020-03-12-170106,170106,2,0,4,2,0.25,45.65177325516225,3
2020-03-13-170106,170106,1,0,1,3,0.75,31.997404210461575,4
2020-03-14-170106,170106,0,0,0,3,0.0,24.025371364571107,5
2020-03-15-170106,170106,0,0,2,3,0.25,15.994956735449467,6
2020-03-16-170106,170106,1,0,5,4,1.5,7.941167885951447,0
2020-03-17-170106,170106,0,0,4,4,1.0,13.327121511475305,1
2020-03-18-170106,170106,1,0,3,5,2.0,15.003813244493992,2
2020-03-19-170106,170106,2,0,5,7,3.5,21.44434039526164,3
2020-03-20-170106,170106,1,0,2,8,3.75,27.013459419376172,4
2020-03-21-170106,170106,2,0,0,10,0.25,30.039440657173614,5
2020-03-22-170106,170106,3,0,1,13,0.75,29.618272038354192,6
2020-03-23-170106,170106,4,0,1,17,4.0,27.497186069843124,0
2020-03-24-170106,170106,2,0,2,19,2.25,35.91966499573539,1
2020-03-25-170106,170106,4,0,3,23,1.75,34.721540661375414,2
2020-03-26-170106,170106,4,0,7,27,3.0,34.217535426114765,3
2020-03-27-170106,170106,1,0,28,28,2.25,40.191476475584494,4
2020-03-28-170106,170106,0,0,1,28,1.25,39.94554734126068,5
2020-03-29-170106,170106,2,0,1,30,2.5,36.97134134333501,6
2020-03-30-170106,170106,5,0,3,35,2.75,30.236292377515923,0
2020-03-31-170106,170106,4,0,1,39,2.75,34.39581098158683,1
2020-04-01-170106,170106,3,0,1,42,5.75,7.643876584883769,2
2020-04-02-170106,170106,5,0,0,47,8.75,21.250107537278467,3
2020-04-03-170106,170106,2,0,0,49,4.0,14.25537832304283,4
2020-04-04-170106,170106,0,0,0,49,2.25,18.27558448831541,5
2020-04-05-170106,170106,1,0,0,50,1.25,18.225117032902684,6
2020-04-06-170106,170106,1,0,1,51,4.75,20.095470935526244,0
2020-04-07-170106,170106,2,0,1,53,5.0,26.04058257645056,1
2020-04-08-170106,170106,3,0,1,56,3.25,34.63473885503821,2
2020-04-09-170106,170106,7,0,0,63,1.25,40.53349985354292,3
2020-04-10-170106,170106,28,0,2,91,10.5,10.41705137730564,4
2020-04-11-170106,170106,1,0,2,92,2.0,39.125535056920384,5
2020-04-12-170106,170106,1,0,1,93,0.25,43.27505483305967,6
2020-04-13-170106,170106,3,0,0,96,3.0,44.9167864217247,0
2020-04-14-170106,170106,1,0,1,97,2.75,48.34910702964816,1
2020-04-15-170106,170106,1,0,0,98,2.5,51.034260974516286,2
2020-04-16-170106,170106,0,0,0,98,2.75,56.5271349364766,3
2020-04-17-170106,170106,0,0,1,98,2.0,54.16825391516623,4
2020-04-18-170106,170106,0,0,2,98,0.75,27.64983721222169,5
2020-04-19-170106,170106,0,0,1,98,0.75,25.053731402040878,6
2020-04-20-170106,170106,1,0,0,99,2.5,34.366058615331646,0
2020-04-21-170106,170106,1,0,1,100,1.5,34.402323195496116,1
2020-04-22-170106,170106,1,0,0,101,1.75,33.5236095604891,2
2020-04-23-170106,170106,0,0,4,101,0.0,32.86354214264027,3
2020-04-24-170106,170106,2,0,1,103,2.0,28.99291321742043,4
2020-04-25-170106,170106,2,0,3,105,0.75,32.010813876135444,5
2020-04-26-170106,170106,1,0,1,106,0.0,33.25146080506885,6
2020-04-27-170106,170106,0,0,1,106,2.0,18.622133968259007,0
2020-04-28-170106,170106,1,0,0,107,1.25,17.440136138202263,1
2020-04-29-170106,170106,0,0,1,107,2.25,16.433734338041575,2
2020-04-30-170106,170106,0,0,0,107,0.75,23.982907825408944,3
2020-05-01-170106,170106,1,0,0,108,0.25,42.50829621595501,4
2020-05-02-170106,170106,2,0,0,110,0.0,9.865482267214375,5
2020-05-03-170106,170106,1,0,0,111,0.25,11.003248444712987,6
2020-05-04-170106,170106,0,0,0,111,0.5,10.470775478630312,0
2020-05-05-170106,170106,1,0,0,112,0.25,9.735628020586876,1
2020-05-06-170106,170106,0,0,2,112,2.0,10.651743403169387,2
2020-05-07-170106,170106,4,0,0,116,0.25,8.335586235102994,3
2020-05-08-170106,170106,1,0,1,117,6.0,14.417011130216684,4
2020-05-09-170106,170106,3,0,0,120,1.25,23.181929859434796,5
2020-05-10-170106,170106,1,0,0,121,0.25,47.809775412595584,6
2020-05-11-170106,170106,1,0,0,122,1.25,46.223542833593925,0
2020-05-12-170106,170106,0,0,0,122,1.5,48.385778045755266,1
2020-05-13-170106,170106,1,0,0,123,0.75,41.30628387169543,2
2020-05-14-170106,170106,0,0,0,123,1.75,31.80757392805296,3
2020-05-15-170106,170106,0,0,0,123,1.25,24.62660827221036,4
2020-05-16-170106,170106,0,0,0,123,0.0,18.208422572397296,5
2020-05-17-170106,170106,0,0,0,123,0.25,17.455414308032804,6
2020-05-18-170106,170106,0,0,0,123,0.75,16.735520101851804,0
2020-05-19-170106,170106,0,0,0,123,0.75,15.059326399576205,1
2020-05-20-170106,170106,2,0,0,125,0.5,13.349559502924496,2
2020-05-21-170106,170106,0,0,0,125,0.5,12.167193136326274,3
2020-05-22-170106,170106,1,0,0,126,1.0,11.65293526404918,4
2020-05-23-170106,170106,0,0,0,126,0.0,14.530080124788412,5
2020-05-24-170106,170106,0,0,0,126,0.25,14.030623422438385,6
2020-05-25-170106,170106,0,0,0,126,2.25,12.018277799060087,0
2020-05-26-170106,170106,0,0,0,126,1.25,14.247355357017192,1
2020-05-27-170106,170106,0,0,0,126,0.5,13.92956157713207,2
2020-05-28-170106,170106,0,0,0,126,3.75,11.918313668267173,3
2020-05-29-170106,170106,0,0,0,126,0.25,17.39226054025061,4
2020-05-30-170106,170106,0,0,0,126,0.25,16.970598049955278,5
2020-05-31-170106,170106,0,0,0,126,0.75,16.96351488313337,6
2020-06-01-170106,170106,0,0,1,126,0.75,35.43426431949304,0
2020-06-02-170106,170106,0,0,0,126,1.25,13.772108912209422,1
2020-06-03-170106,170106,0,0,1,126,1.5,4.851206340275261,2
2020-06-04-170106,170106,0,0,2,126,0.0,6.76819548795709,3
2020-06-05-170106,170106,0,0,0,126,0.25,6.1491820634715175,4
2020-06-06-170106,170106,0,1,1,126,0.5,5.737323852228636,5
2020-06-07-170106,170106,0,0,0,126,0.25,6.155372510852155,6
2020-06-08-170106,170106,0,0,0,126,0.75,6.377833804191935,0
2020-06-09-170106,170106,0,0,0,126,0.5,8.042533278727408,1
2020-06-10-170106,170106,0,0,0,126,0.25,35.314105039730826,2
2020-06-11-170106,170106,0,0,0,126,1.0,33.80539643445262,3
2020-06-12-170106,170106,0,0,0,126,0.25,32.576011815731206,4
2020-06-13-170106,170106,0,0,0,126,0.0,28.861227924215335,5
2020-06-14-170106,170106,0,0,0,126,0.5,20.714881097962675,6
2020-06-15-170106,170106,1,1,0,127,0.25,10.008233721337533,0
2020-06-16-170106,170106,0,0,0,127,0.5,5.875877805332491,1
2020-06-17-170106,170106,1,0,1,128,1.75,6.379395305611965,2
2020-06-18-170106,170106,2,0,0,130,1.75,9.795409232536224,3
2020-06-19-170106,170106,0,0,0,130,0.0,13.631476632504636,4
2020-06-20-170106,170106,1,0,0,131,0.5,16.97312807877614,5
2020-06-21-170106,170106,0,0,0,131,1.0,18.395265406739682,6
2020-06-22-170106,170106,0,0,0,131,0.75,19.845807814140123,0
2020-06-23-170106,170106,0,0,0,131,0.25,19.053955196137295,1
2020-06-24-170106,170106,0,0,0,131,0.25,15.704183273560561,2
2020-06-25-170106,170106,0,1,0,131,0.5,11.252364937687481,3
2020-06-26-170106,170106,0,0,0,131,0.5,12.514841009664995,4
2020-06-27-170106,170106,0,0,0,131,0.25,10.11724231885228,5
2020-06-28-170106,170106,0,0,0,131,0.0,8.452546080036463,6
2020-06-29-170106,170106,0,0,0,131,0.25,6.777390016884513,0
2020-06-30-170106,170106,0,0,0,131,0.25,8.977003422102339,1
2020-07-01-170106,170106,1,0,0,132,0.25,8.528594274016653,2
2020-07-02-170106,170106,0,0,0,132,0.5,7.77919239218103,3
2020-07-03-170106,170106,0,0,0,132,0.25,5.461859420499326,4
2020-07-04-170106,170106,0,0,0,132,0.0,5.235738703392406,5
2020-07-05-170106,170106,0,0,0,132,0.0,5.068540853112834,6
2020-07-06-170106,170106,0,0,0,132,0.25,4.014700087643463,0
2020-07-07-170106,170106,0,0,1,132,0.0,4.541705076692399,1
2020-07-08-170106,170106,0,0,0,132,0.0,5.213009721065091,2
2020-07-09-170106,170106,0,0,2,132,0.5,4.53005224216425,3
2020-07-10-170106,170106,0,2,0,132,0.75,9.788260391674104,4
2020-07-11-170106,170106,0,0,0,132,0.75,11.656478728306388,5
2020-07-12-170106,170106,0,0,0,132,0.25,12.868967871769,6
2020-07-13-170106,170106,0,0,0,132,0.5,12.236427097572172,0
2020-07-14-170106,170106,0,0,0,132,0.5,13.038709316444267,1
2020-07-15-170106,170106,0,0,0,132,0.25,11.631669270516923,2
2020-07-16-170106,170106,0,0,0,132,0.25,11.662038552044843,3
2020-07-17-170106,170106,0,0,1,132,0.75,11.254886437479069,4
2020-07-18-170106,170106,0,0,0,132,0.5,11.41840482999348,5
2020-07-19-170106,170106,0,0,0,132,0.0,11.07226131006843,6
2020-07-20-170106,170106,0,0,0,132,0.75,11.660982002935574,0
2020-07-21-170106,170106,1,0,0,133,0.0,12.130411262708028,1
2020-07-22-170106,170106,0,0,1,133,0.25,12.81139057321455,2
2020-07-23-170106,170106,2,0,0,135,0.0,12.155710541683893,3
2020-07-24-170106,170106,0,0,1,135,0.0,11.875891531900484,4
2020-07-25-170106,170106,0,0,0,135,0.0,9.972214596032835,5
2020-07-26-170106,170106,0,0,0,135,0.25,9.594307309348734,6
2020-07-27-170106,170106,0,1,3,135,0.5,8.291187637736979,0
2020-07-28-170106,170106,0,0,4,135,0.0,7.756127532107556,1
2020-07-29-170106,170106,0,0,3,135,0.0,6.540996366227733,2
2020-07-30-170106,170106,0,0,1,135,0.25,3.4430151991382205,3
2020-07-31-170106,170106,1,0,12,136,0.0,4.360633685335163,4
2020-08-01-170106,170106,0,0,0,136,0.0,5.087758776547978,5
2020-08-02-170106,170106,0,0,0,136,0.0,62.50085038166509,6
2020-08-03-170106,170106,0,0,0,136,0.5,35.809008579488264,0
2020-08-04-170106,170106,0,0,1,136,0.75,33.14843676812395,1
2020-08-05-170106,170106,1,0,0,137,0.75,30.087502889511846,2
2020-08-06-170106,170106,0,0,1,137,1.0,29.334497774380647,3
2020-08-07-170106,170106,1,0,2,138,1.0,32.19562691033825,4
2020-08-08-170106,170106,0,0,0,138,2.75,34.55647036958765,5
2020-08-09-170106,170106,0,0,0,138,0.0,44.451405829987166,6
2020-08-10-170106,170106,3,0,0,141,0.25,3.7653225079264847,0
2020-08-11-170106,170106,4,0,1,145,1.75,10.398715731172226,1
2020-08-12-170106,170106,3,0,0,148,2.0,23.65243932131517,2
2020-08-13-170106,170106,1,0,1,149,1.75,40.74359071405477,3
2020-08-14-170106,170106,12,0,0,161,1.25,54.027497351101786,4
2020-08-15-170106,170106,0,0,0,161,1.0,80.1939025003866,5
2020-08-16-170106,170106,0,0,1,161,0.75,84.36332397770781,6
2020-08-17-170106,170106,0,0,0,161,2.0,84.77267096901957,0
2020-08-18-170106,170106,1,0,1,162,0.75,84.28026642219996,1
2020-08-19-170106,170106,0,0,0,162,1.25,76.63268756553956,2
2020-08-20-170106,170106,1,0,0,163,1.75,52.65073518284924,3
2020-08-21-170106,170106,2,0,6,165,3.0,41.20487481170714,4
2020-08-22-170106,170106,0,0,0,165,0.5,48.546215943885976,5
2020-08-23-170106,170106,0,0,1,165,1.0,51.81389520336705,6
2020-08-24-170106,170106,0,0,0,165,1.25,47.35009416273891,0
2020-08-25-170106,170106,1,0,0,166,2.0,45.81092158415519,1
2020-08-26-170106,170106,0,0,0,166,2.75,46.06679052893043,2
2020-08-27-170106,170106,1,1,0,167,1.75,52.088160931452684,3
2020-08-28-170106,170106,0,0,1,167,0.5,46.326850462642184,4
2020-08-29-170106,170106,0,0,1,167,0.75,36.94738448617112,5
2020-08-30-170106,170106,1,0,0,168,0.75,34.997185224296956,6
2020-08-31-170106,170106,0,0,0,168,1.0,34.71704494066954,0
2020-09-01-170106,170106,1,0,0,169,0.5,35.21596505677661,1
2020-09-02-170106,170106,0,0,2,169,0.25,54.87106063382218,2
2020-09-03-170106,170106,0,0,0,169,4.25,46.194704692177226,3
2020-09-04-170106,170106,6,0,3,175,1.5,48.72303633764926,4
2020-09-05-170106,170106,0,0,0,175,2.75,51.23119950283835,5
2020-09-06-170106,170106,1,0,0,176,1.5,52.44944315241587,6
2020-09-07-170106,170106,0,0,2,176,1.5,56.21052477433767,0
2020-09-08-170106,170106,0,0,4,176,3.0,55.803916424357226,1
2020-09-09-170106,170106,0,0,1,176,2.75,59.227611297800344,2
2020-09-10-170106,170106,0,0,1,176,1.75,27.239887115599434,3
2020-09-11-170106,170106,1,0,1,177,1.75,32.07010581534614,4
2020-09-12-170106,170106,1,0,0,178,6.75,36.796623741503495,5
2020-09-13-170106,170106,0,0,0,178,0.5,42.174712290497816,6
2020-09-14-170106,170106,0,0,1,178,1.5,40.92556757684592,0
2020-09-15-170106,170106,0,0,0,178,3.25,38.271716971388415,1
2020-09-16-170106,170106,2,0,0,180,2.5,45.68102261714061,2
2020-09-17-170106,170106,0,0,1,180,1.0,50.33966334008883,3
2020-09-18-170106,170106,3,0,1,183,3.5,48.197400702517285,4
2020-09-19-170106,170106,0,0,0,183,0.75,51.92679023491131,5
2020-09-20-170106,170106,0,0,0,183,1.5,41.23526647497975,6
2020-09-21-170106,170106,2,0,0,185,1.5,39.11869489565776,0
2020-09-22-170106,170106,4,0,1,189,2.25,36.719153123249896,1
2020-09-23-170106,170106,1,0,0,190,5.25,38.54646681897127,2
2020-09-24-170106,170106,1,0,3,191,2.25,43.58991345096018,3
2020-09-25-170106,170106,1,0,2,192,4.5,38.76513011204476,4
2020-09-26-170106,170106,0,0,0,192,1.75,42.2337490071678,5
2020-09-27-170106,170106,0,0,0,192,0.0,46.04860334484111,6
2020-09-28-170106,170106,1,0,1,193,1.5,44.257443777322905,0
2020-09-29-170106,170106,0,0,0,193,2.0,42.237902871175976,1
2020-09-30-170106,170106,0,0,0,193,3.25,39.747150701312115,2
2020-10-01-170106,170106,1,0,0,194,2.25,0.0,3
2020-10-02-170106,170106,1,0,0,195,1.75,29.412426712290664,4
2020-10-03-170106,170106,0,0,0,195,0.75,58.254275810532846,5
2020-10-04-170106,170106,0,0,0,195,1.5,66.300172855986,6
2020-10-05-170106,170106,0,0,0,195,2.25,57.52306855509898,0
2020-10-06-170106,170106,1,1,0,196,1.75,53.21792004267306,1
2020-10-07-170106,170106,0,0,1,196,2.5,49.60878025963016,2
2020-10-08-170106,170106,3,1,0,199,1.5,47.25829432576292,3
2020-10-09-170106,170106,2,0,2,201,1.25,53.02688256643581,4
2020-10-10-170106,170106,0,0,0,201,0.5,8.112431647657958,5
2020-10-11-170106,170106,0,0,0,201,0.25,11.105641354343444,6
2020-10-12-170106,170106,1,0,0,202,1.0,12.746107022019114,0
2020-10-13-170106,170106,0,0,0,202,1.25,17.633270066876875,1
2020-10-14-170106,170106,0,0,1,202,2.75,20.85704875783405,2
2020-10-15-170106,170106,0,0,2,202,1.0,29.499769409642358,3
2020-10-16-170106,170106,0,0,0,202,0.25,31.649355113244734,4
2020-10-17-170106,170106,0,0,0,202,0.25,25.21528039437719,5
2020-10-18-170106,170106,0,0,2,202,2.0,22.932939345019996,6
2020-10-19-170106,170106,0,0,0,202,1.25,26.77120577038894,0
2020-10-20-170106,170106,0,0,0,202,1.5,29.2743082126573,1
2020-10-21-170106,170106,1,1,0,203,1.75,23.504742943365002,2
2020-10-22-170106,170106,0,0,1,203,2.0,28.87405306373807,3
2020-10-23-170106,170106,2,0,2,205,4.5,34.00290363445192,4
2020-10-24-170106,170106,0,0,1,205,0.5,44.08190949017959,5
2020-10-25-170106,170106,0,0,2,205,1.75,40.815461349976886,6
2020-10-26-170106,170106,0,0,3,205,5.5,41.228190714055,0
2020-10-27-170106,170106,0,0,2,205,2.75,45.88542616879138,1
2020-10-28-170106,170106,1,1,3,206,3.0,48.47769681401472,2
2020-10-29-170106,170106,2,0,1,208,3.0,51.40720928320354,3
2020-10-30-170106,170106,0,0,3,208,7.75,45.37683553573778,4
2020-10-31-170106,170106,0,1,0,208,2.75,60.33784574879457,5
2020-11-01-170106,170106,2,0,0,210,7.5,46.903973985901445,6
2020-11-02-170106,170106,0,0,0,210,1.5,62.624583868377414,0
2020-11-03-170106,170106,0,1,0,210,3.0,37.1916120588332,1
2020-11-04-170106,170106,0,0,0,210,7.25,42.44138858852983,2
2020-11-05-170106,170106,1,0,0,211,7.5,55.75551804128709,3
2020-11-06-170106,170106,2,0,0,213,6.25,63.22822546678925,4
2020-11-07-170106,170106,1,0,0,214,3.0,72.6505142821892,5
2020-11-08-170106,170106,2,0,0,216,1.5,74.08369547369443,6
2020-11-09-170106,170106,3,0,0,219,1.75,73.89923361964128,0
2020-11-10-170106,170106,2,0,0,221,1.75,47.18405746938934,1
2020-11-11-170106,170106,3,0,0,224,4.5,51.65796503333766,2
2020-11-12-170106,170106,1,1,0,225,4.0,63.4879690344223,3
2020-11-13-170106,170106,3,1,0,228,5.25,75.99636054053087,4
2020-03-01-170107,170107,0,0,1,0,0.0,0.0,6
2020-03-02-170107,170107,0,0,4,0,0.0,352.8817278330817,0
2020-03-03-170107,170107,0,0,6,0,0.0,1882.7383553059994,1
2020-03-04-170107,170107,0,1,23,0,0.0,1893.936947149818,2
2020-03-05-170107,170107,0,0,60,0,0.0,2014.3282643456826,3
2020-03-06-170107,170107,0,0,38,0,0.0,1758.5029400945682,4
2020-03-07-170107,170107,0,0,9,0,0.0,1817.8337508134962,5
2020-03-08-170107,170107,0,0,21,0,0.0,1786.8925017045342,6
2020-03-09-170107,170107,0,0,55,0,0.5,1792.2577459291049,0
2020-03-10-170107,170107,0,0,49,0,0.0,1896.2538606021415,1
2020-03-11-170107,170107,0,0,44,0,1.0,1538.8999352726173,2
2020-03-12-170107,170107,2,0,28,2,0.5,1199.6819303128557,3
2020-03-13-170107,170107,0,0,34,2,2.75,911.9197228489055,4
2020-03-14-170107,170107,0,0,10,2,0.75,659.6748913193791,5
2020-03-15-170107,170107,1,0,8,3,0.75,436.74829329274496,6
2020-03-16-170107,170107,4,0,29,7,6.5,206.76821407240277,0
2020-03-17-170107,170107,6,0,35,13,5.5,474.4798493660848,1
2020-03-18-170107,170107,23,0,11,36,15.75,669.1496708491055,2
2020-03-19-170107,170107,60,0,21,96,13.0,1261.7998309374893,3
2020-03-20-170107,170107,38,0,25,134,15.0,2075.636327644081,4
2020-03-21-170107,170107,9,0,6,143,8.0,2693.2776353266995,5
2020-03-22-170107,170107,21,0,7,164,8.5,2826.808933317274,6
2020-03-23-170107,170107,55,0,24,219,21.0,3001.7677050404163,0
2020-03-24-170107,170107,49,0,21,268,15.75,3829.9738610393983,1
2020-03-25-170107,170107,44,0,10,312,16.0,4153.142858478925,2
2020-03-26-170107,170107,28,0,14,340,15.75,4007.4153343680523,3
2020-03-27-170107,170107,34,0,7,374,18.25,4571.052139837115,4
2020-03-28-170107,170107,10,0,4,384,5.75,4510.317508567664,5
2020-03-29-170107,170107,8,0,5,392,4.25,4481.789589798872,6
2020-03-30-170107,170107,29,0,22,421,12.25,3228.734557882995,0
2020-03-31-170107,170107,35,0,17,456,10.75,2859.980723919617,1
2020-04-01-170107,170107,11,0,19,467,10.5,563.7867253234596,2
2020-04-02-170107,170107,21,0,8,488,9.5,1279.91260077929,3
2020-04-03-170107,170107,25,0,7,513,10.75,578.383020905975,4
2020-04-04-170107,170107,6,0,1,519,3.25,885.2673946631016,5
2020-04-05-170107,170107,7,0,2,526,2.75,979.0663696581253,6
2020-04-06-170107,170107,24,0,34,550,10.75,1063.6374633230791,0
2020-04-07-170107,170107,21,0,7,571,8.75,1320.0631413326523,1
2020-04-08-170107,170107,10,0,7,581,6.75,1588.5445424121342,2
2020-04-09-170107,170107,14,0,0,595,6.0,1750.383503096125,3
2020-04-10-170107,170107,7,0,6,602,6.75,318.4607006186026,4
2020-04-11-170107,170107,4,0,2,606,2.75,495.3936284189684,5
2020-04-12-170107,170107,5,1,2,611,2.75,586.3098209989106,6
2020-04-13-170107,170107,22,0,11,633,5.25,664.2167904229004,0
2020-04-14-170107,170107,17,0,4,650,9.25,970.3746653699004,1
2020-04-15-170107,170107,19,0,3,669,4.75,1272.471469467435,2
2020-04-16-170107,170107,8,0,4,677,6.5,1550.1779333208626,3
2020-04-17-170107,170107,7,0,0,684,5.5,1452.4024859740023,4
2020-04-18-170107,170107,1,0,1,685,0.25,1478.630480405036,5
2020-04-19-170107,170107,2,0,1,687,1.5,1401.2375027981827,6
2020-04-20-170107,170107,34,0,12,721,6.5,1432.3202317099626,0
2020-04-21-170107,170107,7,0,9,728,4.0,1614.7779660867154,1
2020-04-22-170107,170107,7,0,10,735,4.25,1462.0421700560119,2
2020-04-23-170107,170107,0,0,3,735,1.5,1447.1998302144455,3
2020-04-24-170107,170107,6,0,7,741,2.75,1259.2645513427724,4
2020-04-25-170107,170107,2,0,1,743,0.5,1389.9184480425479,5
2020-04-26-170107,170107,2,0,2,745,1.25,1375.1841103371223,6
2020-04-27-170107,170107,11,0,10,756,3.25,1023.2595859645734,0
2020-04-28-170107,170107,4,0,6,760,2.5,725.4559873885214,1
2020-04-29-170107,170107,3,0,3,763,4.0,667.0466930242831,2
2020-04-30-170107,170107,4,0,7,767,2.25,993.6303144261117,3
2020-05-01-170107,170107,0,0,7,767,0.25,1675.874661962195,4
2020-05-02-170107,170107,1,0,5,768,2.25,913.2303096972349,5
2020-05-03-170107,170107,1,0,1,769,0.75,403.8200644160037,6
2020-05-04-170107,170107,12,0,20,781,3.25,287.73179481264003,0
2020-05-05-170107,170107,9,0,2,790,3.25,439.1248223147043,1
2020-05-06-170107,170107,10,0,5,800,4.5,544.3178441915759,2
2020-05-07-170107,170107,3,0,6,803,2.5,662.6428210517023,3
2020-05-08-170107,170107,7,0,2,810,5.5,684.5928940280774,4
2020-05-09-170107,170107,1,0,1,811,0.5,885.7919462949928,5
2020-05-10-170107,170107,2,0,3,813,1.0,1782.492792219058,6
2020-05-11-170107,170107,10,0,3,823,7.75,1668.7278670520102,0
2020-05-12-170107,170107,6,0,4,829,3.5,1768.9895568509517,1
2020-05-13-170107,170107,3,0,3,832,2.0,1402.6488564612596,2
2020-05-14-170107,170107,7,1,2,839,1.75,1084.2044247839717,3
2020-05-15-170107,170107,7,0,3,846,3.75,939.2484551676118,4
2020-05-16-170107,170107,5,0,0,851,0.75,790.1187831086215,5
2020-05-17-170107,170107,1,0,0,852,0.5,862.9522272219039,6
2020-05-18-170107,170107,20,1,1,872,14.75,850.3022071637381,0
2020-05-19-170107,170107,2,0,4,874,2.0,1159.3603212997061,1
2020-05-20-170107,170107,5,0,0,879,1.5,1053.3192775034008,2
2020-05-21-170107,170107,6,0,3,885,1.5,1031.6255668933436,3
2020-05-22-170107,170107,2,0,1,887,1.5,1026.2199615092052,4
2020-05-23-170107,170107,1,0,0,888,0.5,1044.0085014608626,5
2020-05-24-170107,170107,3,0,1,891,0.0,1052.353267706519,6
2020-05-25-170107,170107,3,0,3,894,1.5,516.8281495940256,0
2020-05-26-170107,170107,4,0,0,898,1.75,566.397279822394,1
2020-05-27-170107,170107,3,0,3,901,1.25,624.1359485164819,2
2020-05-28-170107,170107,2,0,0,903,2.25,596.1182262014254,3
2020-05-29-170107,170107,3,2,1,906,1.5,558.7675951223779,4
2020-05-30-170107,170107,0,0,0,906,0.0,546.5570986848348,5
2020-05-31-170107,170107,0,0,0,906,0.0,501.7412373993014,6
2020-06-01-170107,170107,1,0,1,907,1.5,1100.1100321234205,0
2020-06-02-170107,170107,4,0,3,911,3.0,274.3148441309787,1
2020-06-03-170107,170107,0,0,3,911,1.25,239.41019751297543,2
2020-06-04-170107,170107,3,0,2,914,1.0,271.9703133602706,3
2020-06-05-170107,170107,1,0,1,915,1.25,300.0428195648344,4
2020-06-06-170107,170107,0,1,1,915,0.0,318.90509145322096,5
2020-06-07-170107,170107,1,0,0,916,0.0,320.43066693525185,6
2020-06-08-170107,170107,3,0,3,919,0.75,314.61124390774273,0
2020-06-09-170107,170107,0,0,2,919,0.75,330.5501510251456,1
2020-06-10-170107,170107,3,0,1,922,0.5,1187.3745093681923,2
2020-06-11-170107,170107,0,0,3,922,0.0,958.510212858571,3
2020-06-12-170107,170107,1,0,2,923,1.25,778.6235917858712,4
2020-06-13-170107,170107,0,0,0,923,0.25,566.9478802354863,5
2020-06-14-170107,170107,0,0,0,923,0.0,462.6550995205768,6
2020-06-15-170107,170107,1,0,3,924,1.0,225.97693125755984,0
2020-06-16-170107,170107,3,0,2,927,1.0,243.55231359064584,1
2020-06-17-170107,170107,3,0,0,930,1.0,268.37639974112545,2
2020-06-18-170107,170107,2,0,0,932,0.25,282.52617939873744,3
2020-06-19-170107,170107,1,0,1,933,0.75,307.97285256079476,4
2020-06-20-170107,170107,1,0,1,934,0.0,420.31586124032805,5
2020-06-21-170107,170107,0,0,0,934,0.0,436.8463326289302,6
2020-06-22-170107,170107,3,0,1,937,1.0,386.0330432268451,0
2020-06-23-170107,170107,2,0,2,939,0.5,376.0334925360357,1
2020-06-24-170107,170107,1,0,0,940,0.25,354.78150126526873,2
2020-06-25-170107,170107,3,5,2,943,0.5,333.0739993756247,3
2020-06-26-170107,170107,2,0,0,945,0.5,370.6495921106901,4
2020-06-27-170107,170107,0,1,1,945,0.0,277.7875299092621,5
2020-06-28-170107,170107,0,0,1,945,0.75,262.71038789378093,6
2020-06-29-170107,170107,3,0,0,948,0.25,276.56812879183695,0
2020-06-30-170107,170107,2,0,0,950,1.25,257.60659859686893,1
2020-07-01-170107,170107,0,0,0,950,0.75,354.10206850560536,2
2020-07-02-170107,170107,0,1,1,950,0.5,108.64468500120111,3
2020-07-03-170107,170107,1,0,0,951,0.5,92.2933723813899,4
2020-07-04-170107,170107,1,0,1,952,0.0,89.1509344791425,5
2020-07-05-170107,170107,0,0,0,952,0.25,102.66342289234733,6
2020-07-06-170107,170107,1,0,0,953,0.5,83.97035347631166,0
2020-07-07-170107,170107,2,0,0,955,0.25,106.18373222630929,1
2020-07-08-170107,170107,0,0,0,955,0.25,131.3489354275982,2
2020-07-09-170107,170107,2,0,0,957,0.0,116.41971400088464,3
2020-07-10-170107,170107,0,0,1,957,0.75,313.1005294315023,4
2020-07-11-170107,170107,1,0,0,958,0.25,242.50384611315752,5
2020-07-12-170107,170107,1,0,0,959,0.0,203.8919108069897,6
2020-07-13-170107,170107,0,0,0,959,0.25,217.0239749010785,0
2020-07-14-170107,170107,0,0,0,959,0.0,226.87556447913096,1
2020-07-15-170107,170107,0,0,1,959,0.0,174.83642345528963,2
2020-07-16-170107,170107,1,0,0,960,0.0,147.57134391203303,3
2020-07-17-170107,170107,0,0,0,960,0.25,129.0346261799362,4
2020-07-18-170107,170107,1,0,0,961,0.0,128.01901061968553,5
2020-07-19-170107,170107,0,0,0,961,0.0,121.08230192329472,6
2020-07-20-170107,170107,0,0,0,961,0.0,110.2741209951897,0
2020-07-21-170107,170107,0,0,0,961,0.0,91.14931725301642,1
2020-07-22-170107,170107,0,0,0,961,0.5,79.25419133585974,2
2020-07-23-170107,170107,0,0,0,961,0.5,73.56460112659535,3
2020-07-24-170107,170107,1,0,0,962,0.25,77.28611000812614,4
2020-07-25-170107,170107,0,2,0,962,0.0,74.04660084619135,5
2020-07-26-170107,170107,0,0,0,962,0.0,72.6718915856726,6
2020-07-27-170107,170107,0,0,2,962,0.0,58.67542630241415,0
2020-07-28-170107,170107,0,0,8,962,0.25,76.0923097332809,1
2020-07-29-170107,170107,1,0,8,963,0.0,83.98670295759868,2
2020-07-30-170107,170107,0,0,6,963,0.0,82.73042341441055,3
2020-07-31-170107,170107,0,0,3,963,0.75,81.59362449767328,4
2020-08-01-170107,170107,0,0,1,963,0.0,132.61601064373653,5
2020-08-02-170107,170107,0,0,0,963,0.0,424.7041244359732,6
2020-08-03-170107,170107,0,0,2,963,0.0,622.7725505482256,0
2020-08-04-170107,170107,0,0,1,963,0.0,525.1320782875416,1
2020-08-05-170107,170107,0,0,0,963,0.5,438.91077632203087,2
2020-08-06-170107,170107,0,0,1,963,0.75,336.32874976338167,3
2020-08-07-170107,170107,0,0,1,963,0.25,202.91983401249877,4
2020-08-08-170107,170107,0,0,1,963,0.25,225.91025736916504,5
2020-08-09-170107,170107,0,0,0,963,0.5,239.77275981943518,6
2020-08-10-170107,170107,2,0,1,965,1.0,122.20154987780813,0
2020-08-11-170107,170107,8,0,3,973,0.25,166.53917827131946,1
2020-08-12-170107,170107,8,0,4,981,1.5,276.21226803168827,2
2020-08-13-170107,170107,6,0,3,987,0.75,409.549720064132,3
2020-08-14-170107,170107,3,0,6,990,1.25,496.42362832894446,4
2020-08-15-170107,170107,1,0,0,991,0.5,581.4565474766657,5
2020-08-16-170107,170107,0,0,0,991,0.5,580.709867964328,6
2020-08-17-170107,170107,2,1,3,993,0.25,588.1150466984177,0
2020-08-18-170107,170107,1,0,3,994,0.25,594.0275368376354,1
2020-08-19-170107,170107,0,0,1,994,2.25,507.37272209650547,2
2020-08-20-170107,170107,1,0,1,995,2.75,289.32560408254295,3
2020-08-21-170107,170107,1,0,5,996,0.0,299.19231542000256,4
2020-08-22-170107,170107,1,0,5,997,0.5,302.05875220736834,5
2020-08-23-170107,170107,0,0,0,997,0.5,335.9433261464384,6
2020-08-24-170107,170107,1,1,3,998,1.75,292.3677304383482,0
2020-08-25-170107,170107,3,0,2,1001,2.0,351.95845329148074,1
2020-08-26-170107,170107,4,0,4,1005,0.75,369.46688459350935,2
2020-08-27-170107,170107,3,0,3,1008,3.75,459.2517538401458,3
2020-08-28-170107,170107,6,0,4,1014,1.0,482.8390277886929,4
2020-08-29-170107,170107,0,0,1,1014,0.5,617.5830534900273,5
2020-08-30-170107,170107,0,0,2,1014,0.75,587.0373264834736,6
2020-08-31-170107,170107,3,0,5,1017,0.25,559.6863586703153,0
2020-09-01-170107,170107,3,0,3,1020,0.5,207.6936183598794,1
2020-09-02-170107,170107,1,0,4,1021,2.0,873.1305350160021,2
2020-09-03-170107,170107,1,1,6,1022,2.25,1062.6476189916123,3
2020-09-04-170107,170107,5,0,5,1027,2.0,945.2060121267641,4
2020-09-05-170107,170107,5,0,0,1032,1.0,955.054443325964,5
2020-09-06-170107,170107,0,0,4,1032,1.25,970.6500456491474,6
2020-09-07-170107,170107,3,0,6,1035,3.0,924.0853958512132,0
2020-09-08-170107,170107,2,0,3,1037,3.5,914.2765918094531,1
2020-09-09-170107,170107,4,0,4,1041,1.25,988.7118922256416,2
2020-09-10-170107,170107,3,0,8,1044,2.25,223.53542450173657,3
2020-09-11-170107,170107,4,0,6,1048,1.75,298.9886649074905,4
2020-09-12-170107,170107,1,0,2,1049,1.25,446.7248577309175,5
2020-09-13-170107,170107,2,0,3,1051,1.75,446.56488400918545,6
2020-09-14-170107,170107,5,0,5,1056,3.75,540.406065188814,0
2020-09-15-170107,170107,3,0,1,1059,1.75,651.2666474456662,1
2020-09-16-170107,170107,4,0,4,1063,3.0,697.7350708219559,2
2020-09-17-170107,170107,6,0,8,1069,1.5,810.5601882842102,3
2020-09-18-170107,170107,5,0,9,1074,5.5,950.4579383479324,4
2020-09-19-170107,170107,0,0,5,1074,2.0,910.8270310421741,5
2020-09-20-170107,170107,4,0,6,1078,4.5,839.1286754756625,6
2020-09-21-170107,170107,6,1,6,1084,3.25,905.1073690418566,0
2020-09-22-170107,170107,3,0,6,1087,1.5,1031.2365939764748,1
2020-09-23-170107,170107,4,1,7,1091,3.0,946.0034897420433,2
2020-09-24-170107,170107,8,0,3,1099,3.75,867.9509390156067,3
2020-09-25-170107,170107,6,0,12,1105,3.5,1035.77233424626,4
2020-09-26-170107,170107,2,0,7,1107,2.25,1172.3587712148812,5
2020-09-27-170107,170107,3,0,0,1110,1.0,1215.384424948164,6
2020-09-28-170107,170107,5,0,1,1115,4.5,1105.7206361377994,0
2020-09-29-170107,170107,1,0,12,1116,1.0,1118.6209982956261,1
2020-09-30-170107,170107,4,0,9,1120,2.25,1094.120585173249,2
2020-10-01-170107,170107,8,0,0,1128,2.0,0.0,3
2020-10-02-170107,170107,9,0,7,1137,4.25,1338.1108793280207,4
2020-10-03-170107,170107,5,0,1,1142,3.25,2533.211108297582,5
2020-10-04-170107,170107,6,0,8,1148,2.25,2198.3250713689804,6
2020-10-05-170107,170107,6,0,14,1154,1.5,1930.2407826427548,0
2020-10-06-170107,170107,6,0,4,1160,1.75,1841.8901462070378,1
2020-10-07-170107,170107,7,0,12,1167,3.25,1684.9177936366898,2
2020-10-08-170107,170107,3,0,7,1170,1.5,1540.129252458882,3
2020-10-09-170107,170107,12,2,16,1182,4.25,1468.3800470396195,4
2020-10-10-170107,170107,7,0,5,1189,3.0,192.40417122798672,5
2020-10-11-170107,170107,0,0,22,1189,2.25,349.3083569705352,6
2020-10-12-170107,170107,1,0,14,1190,1.0,417.23556167848994,0
2020-10-13-170107,170107,12,0,12,1202,2.75,422.62607406466816,1
2020-10-14-170107,170107,9,0,9,1211,5.25,652.635785741957,2
2020-10-15-170107,170107,0,0,7,1211,0.25,915.6152209189172,3
2020-10-16-170107,170107,7,0,9,1218,2.25,890.0096133059008,4
2020-10-17-170107,170107,1,0,4,1219,0.5,882.8320504263174,5
2020-10-18-170107,170107,8,0,7,1227,3.25,768.386258598075,6
2020-10-19-170107,170107,14,0,2,1241,5.0,893.6022548034526,0
2020-10-20-170107,170107,4,0,7,1245,3.5,1166.5847657366064,1
2020-10-21-170107,170107,12,0,8,1257,4.5,1060.8392107349407,2
2020-10-22-170107,170107,7,0,11,1264,7.25,1372.3216215030657,3
2020-10-23-170107,170107,16,0,13,1280,10.5,1580.5040342267382,4
2020-10-24-170107,170107,5,2,9,1285,3.5,1997.3092837311442,5
2020-10-25-170107,170107,22,0,5,1307,8.5,1973.9941101098377,6
2020-10-26-170107,170107,14,0,7,1321,6.75,2071.924264795327,0
2020-10-27-170107,170107,12,1,8,1333,3.75,2402.130334595217,1
2020-10-28-170107,170107,9,0,8,1342,3.75,2525.672262382711,2
2020-10-29-170107,170107,7,0,15,1349,11.0,2473.1544355364654,3
2020-10-30-170107,170107,9,0,3,1358,10.0,2249.3897852781215,4
2020-10-31-170107,170107,4,0,0,1362,4.75,2484.631638512917,5
2020-11-01-170107,170107,7,0,0,1369,5.25,1284.664494260978,6
2020-11-02-170107,170107,2,0,0,1371,2.25,986.6153006478764,0
2020-11-03-170107,170107,7,0,0,1378,4.0,883.6269899473828,1
2020-11-04-170107,170107,8,0,0,1386,9.0,1062.7440554051243,2
2020-11-05-170107,170107,11,0,0,1397,7.0,1244.634242799664,3
2020-11-06-170107,170107,13,0,0,1410,7.25,1456.363002279184,4
2020-11-07-170107,170107,9,1,0,1419,4.75,1536.3123123351888,5
2020-11-08-170107,170107,5,0,0,1424,4.75,1617.0220099678813,6
2020-11-09-170107,170107,7,0,0,1431,5.5,1708.1951144291704,0
2020-11-10-170107,170107,8,0,0,1439,3.25,1330.3617083786305,1
2020-11-11-170107,170107,8,1,0,1447,4.25,1367.2719684506812,2
2020-11-12-170107,170107,15,1,0,1462,5.25,1459.4451733465553,3
2020-11-13-170107,170107,3,0,0,1465,4.5,1712.7093354645854,4
2020-03-01-170108,170108,0,0,0,0,0.0,0.0,6
2020-03-02-170108,170108,0,0,0,0,0.0,8.017113136302013,0
2020-03-03-170108,170108,0,1,0,0,0.2,51.967734215858314,1
2020-03-04-170108,170108,0,2,0,0,0.0,71.84315760036678,2
2020-03-05-170108,170108,0,5,1,0,0.0,87.47520414639631,3
2020-03-06-170108,170108,0,0,0,0,0.0,82.08071175500183,4
2020-03-07-170108,170108,0,0,0,0,0.0,96.73530486691863,5
2020-03-08-170108,170108,0,0,0,0,0.0,91.60578079200818,6
2020-03-09-170108,170108,0,0,1,0,0.0,89.91264970752444,0
2020-03-10-170108,170108,0,0,0,0,0.0,89.70835718022622,1
2020-03-11-170108,170108,0,0,2,0,0.0,77.84264631500615,2
2020-03-12-170108,170108,0,0,0,0,0.2,63.45792208073124,3
2020-03-13-170108,170108,1,0,3,1,0.6,33.241780192093394,4
2020-03-14-170108,170108,0,0,0,1,0.2,28.972924748375203,5
2020-03-15-170108,170108,0,0,2,1,0.8,16.16247352484011,6
2020-03-16-170108,170108,0,0,2,1,1.6,13.490548242587455,0
2020-03-17-170108,170108,0,1,3,1,2.2,17.136243990875037,1
2020-03-18-170108,170108,0,1,0,1,4.8,20.10108502836269,2
2020-03-19-170108,170108,1,0,4,2,4.6,26.701487140877287,3
2020-03-20-170108,170108,0,1,2,2,2.6,35.72073443340814,4
2020-03-21-170108,170108,0,0,1,2,0.8,36.32981141805857,5
2020-03-22-170108,170108,0,1,1,2,1.6,35.009710806096905,6
2020-03-23-170108,170108,1,0,5,3,8.2,41.82278189897155,0
2020-03-24-170108,170108,0,0,3,3,3.2,66.6443612668071,1
2020-03-25-170108,170108,2,0,3,5,7.4,66.46157702258422,2
2020-03-26-170108,170108,0,0,11,5,6.0,80.65810196726812,3
2020-03-27-170108,170108,3,0,2,8,8.0,88.6595878090591,4
2020-03-28-170108,170108,0,0,1,8,2.0,108.57344258606558,5
2020-03-29-170108,170108,2,0,0,10,2.8,104.5310653744811,6
2020-03-30-170108,170108,2,0,6,12,6.4,88.38095175207496,0
2020-03-31-170108,170108,3,0,2,15,6.2,108.21049008129438,1
2020-04-01-170108,170108,0,0,17,15,6.4,28.560450333305788,2
2020-04-02-170108,170108,4,0,3,19,3.8,216.81455028885526,3
2020-04-03-170108,170108,2,0,8,21,4.8,59.39435551817679,4
2020-04-04-170108,170108,1,0,0,22,2.0,77.6646256126293,5
2020-04-05-170108,170108,1,0,1,23,1.2,85.89872997287807,6
2020-04-06-170108,170108,5,0,3,28,5.8,92.29484772301008,0
2020-04-07-170108,170108,3,0,2,31,5.8,123.68049426062771,1
2020-04-08-170108,170108,3,0,0,34,3.0,136.9075208408115,2
2020-04-09-170108,170108,11,0,0,45,4.8,125.92516076194015,3
2020-04-10-170108,170108,2,0,0,47,1.2,7.814733549970885,4
2020-04-11-170108,170108,1,0,0,48,1.0,20.139305318317742,5
2020-04-12-170108,170108,0,2,0,48,1.4,26.33578153448185,6
2020-04-13-170108,170108,6,0,2,54,3.2,27.117935552011023,0
2020-04-14-170108,170108,2,0,1,56,3.4,65.70471949649394,1
2020-04-15-170108,170108,17,1,6,73,2.4,83.49256602250888,2
2020-04-16-170108,170108,3,0,0,76,2.2,185.16649297705422,3
2020-04-17-170108,170108,8,0,1,84,2.6,204.26740008782554,4
2020-04-18-170108,170108,0,0,0,84,0.8,242.8852210730984,5
2020-04-19-170108,170108,1,0,0,85,0.4,242.05967625157203,6
2020-04-20-170108,170108,3,0,1,88,2.2,242.41903053454047,0
2020-04-21-170108,170108,2,0,2,90,2.2,245.4682580854752,1
2020-04-22-170108,170108,0,0,1,90,1.2,154.6247067272075,2
2020-04-23-170108,170108,0,0,0,90,1.4,134.68342889197865,3
2020-04-24-170108,170108,0,0,1,90,1.4,83.55189021410932,4
2020-04-25-170108,170108,0,0,0,90,0.4,82.94022468830201,5
2020-04-26-170108,170108,0,0,1,90,0.2,73.87740401687503,6
2020-04-27-170108,170108,2,0,0,92,2.4,45.571972968486136,0
2020-04-28-170108,170108,1,0,2,93,1.6,37.56999914504239,1
2020-04-29-170108,170108,6,0,1,99,2.2,32.361370974376975,2
2020-04-30-170108,170108,0,0,1,99,1.4,87.6157754518259,3
2020-05-01-170108,170108,1,0,0,100,0.6,169.83740723044454,4
2020-05-02-170108,170108,0,0,0,100,0.4,25.456701188450445,5
2020-05-03-170108,170108,0,0,0,100,0.0,45.78270101096135,6
2020-05-04-170108,170108,1,0,0,101,2.2,32.08224846696214,0
2020-05-05-170108,170108,2,0,0,103,1.4,24.734537761865063,1
2020-05-06-170108,170108,1,0,2,104,18.0,32.95249391910958,2
2020-05-07-170108,170108,0,0,2,104,6.0,41.33898747427041,3
2020-05-08-170108,170108,1,0,1,105,3.4,50.440619345020096,4
2020-05-09-170108,170108,0,0,2,105,0.0,66.66478225973165,5
2020-05-10-170108,170108,1,0,0,106,0.0,190.30431869274818,6
2020-05-11-170108,170108,0,0,0,106,3.2,190.71487632097904,0
2020-05-12-170108,170108,2,0,3,108,1.8,195.07085958374444,1
2020-05-13-170108,170108,1,0,1,109,2.4,156.40552166146523,2
2020-05-14-170108,170108,1,1,1,110,2.2,140.88569070632383,3
2020-05-15-170108,170108,0,0,0,110,0.6,124.5259261197904,4
2020-05-16-170108,170108,0,0,0,110,0.0,54.42215456302809,5
2020-05-17-170108,170108,0,0,0,110,0.0,48.21216057496775,6
2020-05-18-170108,170108,0,2,0,110,1.0,41.665033988203966,0
2020-05-19-170108,170108,0,0,0,110,1.0,47.70901024511765,1
2020-05-20-170108,170108,2,0,1,112,1.0,23.33961495582563,2
2020-05-21-170108,170108,2,0,1,114,2.2,35.12370148375521,3
2020-05-22-170108,170108,1,0,1,115,1.2,58.805709063941705,4
2020-05-23-170108,170108,2,0,1,117,0.2,72.40588192038814,5
2020-05-24-170108,170108,0,0,0,117,0.0,88.22401339719788,6
2020-05-25-170108,170108,0,0,2,117,0.6,80.5013839880687,0
2020-05-26-170108,170108,3,0,0,120,0.2,82.82796770690763,1
2020-05-27-170108,170108,1,0,0,121,0.6,102.66286797195157,2
2020-05-28-170108,170108,1,0,0,122,0.4,89.2834534059583,3
2020-05-29-170108,170108,0,11,0,122,1.2,75.581222596674,4
2020-05-30-170108,170108,0,0,0,122,0.2,49.74620862420494,5
2020-05-31-170108,170108,0,0,0,122,0.0,49.675289930029564,6
2020-06-01-170108,170108,0,0,0,122,1.4,84.70709473832609,0
2020-06-02-170108,170108,0,0,0,122,0.8,19.62065728736765,1
2020-06-03-170108,170108,1,0,1,123,0.8,36.531490490773436,2
2020-06-04-170108,170108,1,0,0,124,1.0,28.561116924227516,3
2020-06-05-170108,170108,1,0,1,125,0.6,35.40691317070017,4
2020-06-06-170108,170108,1,6,0,126,0.0,38.12997650468253,5
2020-06-07-170108,170108,0,1,0,126,0.0,46.831343008016184,6
2020-06-08-170108,170108,2,0,0,128,0.6,46.88584194608521,0
2020-06-09-170108,170108,0,0,0,128,1.0,54.941117572144805,1
2020-06-10-170108,170108,0,0,2,128,0.2,91.68605092405667,2
2020-06-11-170108,170108,0,0,0,128,0.8,77.36264890633232,3
2020-06-12-170108,170108,0,0,1,128,0.2,57.34332725749081,4
2020-06-13-170108,170108,0,0,0,128,0.2,31.424315970390197,5
2020-06-14-170108,170108,0,0,0,128,0.2,19.57054989633911,6
2020-06-15-170108,170108,0,0,0,128,0.0,5.114782548229508,0
2020-06-16-170108,170108,0,0,0,128,0.4,4.841704066793072,1
2020-06-17-170108,170108,1,0,0,129,1.0,3.975814496570605,2
2020-06-18-170108,170108,0,0,1,129,0.6,12.185875439498027,3
2020-06-19-170108,170108,1,0,0,130,0.2,12.502396013863695,4
2020-06-20-170108,170108,0,0,0,130,0.0,24.949998069252842,5
2020-06-21-170108,170108,0,0,0,130,0.0,25.453285533143116,6
2020-06-22-170108,170108,0,0,0,130,0.2,25.434645697177,0
2020-06-23-170108,170108,0,0,0,130,0.2,25.874878641990048,1
2020-06-24-170108,170108,2,0,0,132,0.0,17.849148579834228,2
2020-06-25-170108,170108,0,0,0,132,0.2,34.427816904547846,3
2020-06-26-170108,170108,1,0,0,133,0.0,28.32596006364952,4
2020-06-27-170108,170108,0,0,0,133,0.4,32.85428334261717,5
2020-06-28-170108,170108,0,0,0,133,0.0,34.10699193129589,6
2020-06-29-170108,170108,0,0,0,133,0.8,34.9936698333113,0
2020-06-30-170108,170108,0,0,0,133,0.0,55.65244792965778,1
2020-07-01-170108,170108,0,0,0,133,0.2,58.86443020573554,2
2020-07-02-170108,170108,1,0,0,134,0.2,17.634901646160344,3
2020-07-03-170108,170108,0,0,0,134,0.2,113.88173974864631,4
2020-07-04-170108,170108,0,0,0,134,0.0,99.12847360285839,5
2020-07-05-170108,170108,0,0,0,134,0.0,99.0628227724678,6
2020-07-06-170108,170108,0,0,0,134,0.4,93.43638701311271,0
2020-07-07-170108,170108,0,0,0,134,0.4,29.433965648428273,1
2020-07-08-170108,170108,0,0,0,134,0.2,10.750544515498792,2
2020-07-09-170108,170108,0,0,1,134,0.0,13.41148276563049,3
2020-07-10-170108,170108,0,0,0,134,0.0,59.765215819868686,4
2020-07-11-170108,170108,0,0,0,134,0.2,48.77336975213897,5
2020-07-12-170108,170108,0,0,0,134,0.2,36.662889658708835,6
2020-07-13-170108,170108,0,0,0,134,0.4,30.093349624113614,0
2020-07-14-170108,170108,0,0,6,134,0.8,31.384280103893666,1
2020-07-15-170108,170108,0,0,2,134,0.4,18.608285144831733,2
2020-07-16-170108,170108,0,0,0,134,0.2,19.204688071046068,3
2020-07-17-170108,170108,0,0,0,134,0.8,19.425688997523157,4
2020-07-18-170108,170108,0,0,0,134,0.0,23.261103653963374,5
2020-07-19-170108,170108,0,0,2,134,0.0,22.434995895863032,6
2020-07-20-170108,170108,0,0,0,134,0.0,28.426520929932195,0
2020-07-21-170108,170108,0,0,0,134,0.0,22.32278349662854,1
2020-07-22-170108,170108,0,0,0,134,0.6,18.241231839172407,2
2020-07-23-170108,170108,1,0,12,135,0.6,21.19536343821945,3
2020-07-24-170108,170108,0,0,1,135,0.4,36.13539936618684,4
2020-07-25-170108,170108,0,0,0,135,0.0,36.169967681146,5
2020-07-26-170108,170108,0,0,0,135,0.2,36.7556437630139,6
2020-07-27-170108,170108,0,0,3,135,0.4,26.51042036215317,0
2020-07-28-170108,170108,6,0,1,141,1.2,32.515295072828536,1
2020-07-29-170108,170108,2,0,1,143,1.0,104.80797713401685,2
2020-07-30-170108,170108,0,0,4,143,0.4,106.57751021888092,3
2020-07-31-170108,170108,0,0,2,143,0.2,106.77986781914052,4
2020-08-01-170108,170108,0,0,4,143,0.4,14.40119529228175,5
2020-08-02-170108,170108,2,0,0,145,0.2,248.22245485515674,6
2020-08-03-170108,170108,0,0,3,145,0.6,207.25185085485333,0
2020-08-04-170108,170108,0,0,1,145,0.4,180.32282788010292,1
2020-08-05-170108,170108,0,0,4,145,0.6,177.43282213604203,2
2020-08-06-170108,170108,12,0,2,157,2.2,133.79821171045245,3
2020-08-07-170108,170108,1,0,2,158,2.2,233.38106897831523,4
2020-08-08-170108,170108,0,0,2,158,0.2,260.36881317976815,5
2020-08-09-170108,170108,0,0,1,158,0.4,264.68597055337665,6
2020-08-10-170108,170108,3,0,2,161,1.2,16.471187379054083,0
2020-08-11-170108,170108,1,0,3,162,2.6,58.27035712308998,1
2020-08-12-170108,170108,1,0,0,163,1.2,99.44203828733825,2
2020-08-13-170108,170108,4,0,5,167,2.2,120.66676051983345,3
2020-08-14-170108,170108,2,0,4,169,1.0,190.21842883490194,4
2020-08-15-170108,170108,4,0,1,173,1.0,228.27991308009885,5
2020-08-16-170108,170108,0,0,1,173,0.4,280.0696270870422,6
2020-08-17-170108,170108,3,1,3,176,2.4,281.6545186846429,0
2020-08-18-170108,170108,1,0,1,177,1.0,285.8467027315572,1
2020-08-19-170108,170108,4,0,1,181,2.2,255.431569018571,2
2020-08-20-170108,170108,2,0,0,183,13.0,241.78170685535133,3
2020-08-21-170108,170108,2,0,15,185,4.6,245.42420357638755,4
2020-08-22-170108,170108,2,0,1,187,6.4,244.1422384852733,5
2020-08-23-170108,170108,1,0,3,188,0.8,267.0182147622793,6
2020-08-24-170108,170108,2,0,0,190,1.6,235.28078577930745,0
2020-08-25-170108,170108,3,1,0,193,2.6,253.81661616547993,1
2020-08-26-170108,170108,0,0,1,193,1.4,242.77054858327173,2
2020-08-27-170108,170108,5,0,0,198,1.0,223.67338067282694,3
2020-08-28-170108,170108,4,0,0,202,1.0,242.0767024014333,4
2020-08-29-170108,170108,1,0,0,203,4.2,235.68596483717437,5
2020-08-30-170108,170108,1,0,0,204,1.2,207.37350306225295,6
2020-08-31-170108,170108,3,0,4,207,1.4,189.9846342440192,0
2020-09-01-170108,170108,1,0,0,208,1.0,213.6562973257585,1
2020-09-02-170108,170108,1,0,0,209,1.6,161.31480753600937,2
2020-09-03-170108,170108,0,0,0,209,3.0,138.5590622735374,3
2020-09-04-170108,170108,15,0,1,224,2.6,123.29209349865204,4
2020-09-05-170108,170108,1,0,0,225,0.8,246.81989873197068,5
2020-09-06-170108,170108,3,0,0,228,0.8,247.13782438356813,6
2020-09-07-170108,170108,0,0,0,228,1.6,268.41455610103833,0
2020-09-08-170108,170108,0,0,2,228,1.0,257.5717806550938,1
2020-09-09-170108,170108,1,0,0,229,4.0,245.41937003986936,2
2020-09-10-170108,170108,0,0,0,229,1.4,178.64451651502563,3
2020-09-11-170108,170108,0,0,0,229,2.6,178.05428100868852,4
2020-09-12-170108,170108,0,0,0,229,2.0,182.44963798874585,5
2020-09-13-170108,170108,0,0,0,229,1.0,70.93819572245529,6
2020-09-14-170108,170108,4,0,1,233,4.4,48.2448907309926,0
2020-09-15-170108,170108,0,0,0,233,2.6,92.41918313033196,1
2020-09-16-170108,170108,0,0,0,233,4.0,103.22011180512712,2
2020-09-17-170108,170108,0,0,0,233,4.4,104.33306239009826,3
2020-09-18-170108,170108,1,0,1,234,8.4,107.9880372116724,4
2020-09-19-170108,170108,0,0,0,234,3.6,125.6629497700279,5
2020-09-20-170108,170108,0,0,0,234,2.0,130.9409997662798,6
2020-09-21-170108,170108,0,0,4,234,3.6,90.36750292469289,0
2020-09-22-170108,170108,2,0,0,236,7.6,90.54180331751868,1
2020-09-23-170108,170108,0,0,0,236,5.6,110.28411488744251,2
2020-09-24-170108,170108,0,0,6,236,9.4,112.38544906824622,3
2020-09-25-170108,170108,0,0,4,236,7.0,108.02078301408045,4
2020-09-26-170108,170108,0,0,2,236,1.4,116.58502883228942,5
2020-09-27-170108,170108,0,0,6,236,0.6,114.94535355081646,6
2020-09-28-170108,170108,1,0,1,237,6.6,111.62773414871114,0
2020-09-29-170108,170108,0,0,7,237,4.2,120.74518046061762,1
2020-09-30-170108,170108,0,0,0,237,6.2,104.54863388020874,2
2020-10-01-170108,170108,0,0,3,237,5.6,0.0,3
2020-10-02-170108,170108,1,0,3,238,5.6,198.3486874633063,4
2020-10-03-170108,170108,0,0,0,238,1.2,162.21198596973562,5
2020-10-04-170108,170108,0,1,3,238,3.8,157.60109885527115,6
2020-10-05-170108,170108,4,0,0,242,4.8,152.22651778718816,0
2020-10-06-170108,170108,0,1,0,242,3.4,145.83640489401532,1
2020-10-07-170108,170108,0,0,3,242,4.4,124.83184693631301,2
2020-10-08-170108,170108,6,0,2,248,4.4,130.5805039650831,3
2020-10-09-170108,170108,4,0,2,252,5.8,186.93807799833888,4
2020-10-10-170108,170108,2,0,1,254,3.0,14.304284513110286,5
2020-10-11-170108,170108,6,0,1,260,2.8,30.760088045019092,6
2020-10-12-170108,170108,1,0,0,261,2.8,91.74128211347707,0
2020-10-13-170108,170108,7,0,3,268,3.6,111.40395065411165,1
2020-10-14-170108,170108,0,0,2,268,2.2,189.26433329247365,2
2020-10-15-170108,170108,3,0,0,271,4.0,202.82361663806103,3
2020-10-16-170108,170108,3,0,4,274,6.6,228.70689366479692,4
2020-10-17-170108,170108,0,0,0,274,1.4,240.70642266036282,5
2020-10-18-170108,170108,3,0,1,277,2.0,221.73525261083407,6
2020-10-19-170108,170108,0,0,1,277,6.0,187.50081397061354,0
2020-10-20-170108,170108,0,0,5,277,4.6,129.97656351495112,1
2020-10-21-170108,170108,3,0,0,280,3.6,126.32388668311594,2
2020-10-22-170108,170108,2,0,0,282,6.2,130.71912218764618,3
2020-10-23-170108,170108,2,0,3,284,6.6,129.43179109826846,4
2020-10-24-170108,170108,1,0,1,285,3.0,149.46000088123435,5
2020-10-25-170108,170108,1,1,0,286,2.6,137.44269210773933,6
2020-10-26-170108,170108,0,0,0,286,3.6,131.38506634046547,0
2020-10-27-170108,170108,3,0,0,289,7.6,133.1505876977241,1
2020-10-28-170108,170108,2,3,2,291,6.4,169.05512971213386,2
2020-10-29-170108,170108,0,0,4,291,4.2,166.1439534975914,3
2020-10-30-170108,170108,4,0,2,295,7.2,129.72017312997076,4
2020-10-31-170108,170108,0,0,0,295,1.4,164.36937312114492,5
2020-11-01-170108,170108,1,0,0,296,1.8,181.03366261634417,6
2020-11-02-170108,170108,1,1,0,297,3.8,75.41709348543601,0
2020-11-03-170108,170108,5,1,0,302,4.4,53.46740620548801,1
2020-11-04-170108,170108,0,1,0,302,6.2,81.32771281582987,2
2020-11-05-170108,170108,0,0,0,302,3.8,87.1919370679959,3
2020-11-06-170108,170108,3,0,0,305,4.6,93.80945838250966,4
2020-11-07-170108,170108,1,0,0,306,1.8,119.66445495272028,5
2020-11-08-170108,170108,0,0,0,306,2.6,121.71410059342821,6
2020-11-09-170108,170108,0,0,0,306,1.8,121.17716431666159,0
2020-11-10-170108,170108,0,0,0,306,4.0,178.06034546901128,1
2020-11-11-170108,170108,2,0,0,308,5.8,181.33809438096978,2
2020-11-12-170108,170108,4,0,0,312,6.0,164.97549835070208,3
2020-11-13-170108,170108,2,0,0,314,8.2,196.39806830083018,4
2020-03-01-170109,170109,0,0,0,0,0.0,0.0,6
2020-03-02-170109,170109,0,0,0,0,0.0,24.71721186924249,0
2020-03-03-170109,170109,0,0,1,0,0.0,84.4203324355269,1
2020-03-04-170109,170109,0,1,3,0,0.0,94.1101420325033,2
2020-03-05-170109,170109,0,0,8,0,0.2,103.61774248276555,3
2020-03-06-170109,170109,0,0,5,0,0.0,101.54382051522046,4
2020-03-07-170109,170109,0,0,0,0,0.0,109.60332154180679,5
2020-03-08-170109,170109,0,0,1,0,0.0,104.99086794150831,6
2020-03-09-170109,170109,0,0,3,0,0.0,104.55386221019332,0
2020-03-10-170109,170109,0,0,2,0,0.0,185.24640826160535,1
2020-03-11-170109,170109,0,0,0,0,0.2,150.38551985655755,2
2020-03-12-170109,170109,1,0,0,1,0.4,108.07788184409648,3
2020-03-13-170109,170109,2,0,1,3,0.6,73.93439670761052,4
2020-03-14-170109,170109,0,0,0,3,0.2,68.83394484745452,5
2020-03-15-170109,170109,0,0,1,3,0.2,44.61001418419345,6
2020-03-16-170109,170109,0,0,3,3,1.8,26.633522799590587,0
2020-03-17-170109,170109,1,0,1,4,0.6,42.243130468638896,1
2020-03-18-170109,170109,3,0,4,7,2.8,51.121791946282556,2
2020-03-19-170109,170109,8,0,3,15,2.6,89.48248872123753,3
2020-03-20-170109,170109,5,7,2,20,1.2,128.6657053587885,4
2020-03-21-170109,170109,0,0,0,20,0.8,157.99226216906786,5
2020-03-22-170109,170109,1,0,1,21,0.6,156.07811019580814,6
2020-03-23-170109,170109,3,0,0,24,5.2,153.16500725508988,0
2020-03-24-170109,170109,2,0,1,26,2.2,195.42700030759136,1
2020-03-25-170109,170109,0,0,0,26,4.2,192.34556928867156,2
2020-03-26-170109,170109,0,0,2,26,4.0,172.1948026722199,3
2020-03-27-170109,170109,1,0,5,27,2.4,195.49182657145732,4
2020-03-28-170109,170109,0,0,1,27,1.2,182.97552108749042,5
2020-03-29-170109,170109,1,0,1,28,1.6,181.91692000365825,6
2020-03-30-170109,170109,3,0,0,31,3.6,132.52707081470243,0
2020-03-31-170109,170109,1,0,2,32,4.6,136.60035100106268,1
2020-04-01-170109,170109,4,0,0,36,4.0,32.0391222401101,2
2020-04-02-170109,170109,3,0,3,39,6.8,116.1828238274867,3
2020-04-03-170109,170109,2,0,2,41,2.8,69.47057536765885,4
2020-04-04-170109,170109,0,0,1,41,1.8,76.57633061978697,5
2020-04-05-170109,170109,1,0,2,42,0.8,73.10664861685473,6
2020-04-06-170109,170109,0,0,1,42,5.4,81.27791254254666,0
2020-04-07-170109,170109,1,0,0,43,4.6,97.56817545236865,1
2020-04-08-170109,170109,0,0,4,43,3.4,109.56471734683939,2
2020-04-09-170109,170109,2,0,0,45,2.4,106.25886227949009,3
2020-04-10-170109,170109,5,0,5,50,9.0,33.56619625063585,4
2020-04-11-170109,170109,1,0,2,51,0.6,78.13791121132111,5
2020-04-12-170109,170109,1,0,0,52,1.8,86.5175400702285,6
2020-04-13-170109,170109,0,0,2,52,2.4,103.45303627257461,0
2020-04-14-170109,170109,2,0,3,54,4.2,119.23394725909498,1
2020-04-15-170109,170109,0,0,3,54,1.8,156.0526515440465,2
2020-04-16-170109,170109,3,0,0,57,1.6,171.77224327884926,3
2020-04-17-170109,170109,2,0,0,59,1.6,166.96325363955006,4
2020-04-18-170109,170109,1,0,0,60,0.2,135.71972524027558,5
2020-04-19-170109,170109,2,0,1,62,1.0,133.4751410944403,6
2020-04-20-170109,170109,1,1,0,63,2.8,159.70179199672006,0
2020-04-21-170109,170109,0,0,0,63,2.8,142.61748927532665,1
2020-04-22-170109,170109,4,0,3,67,0.6,146.8615916815508,2
2020-04-23-170109,170109,0,0,0,67,0.0,142.10160669556475,3
2020-04-24-170109,170109,5,0,1,72,0.8,125.65366040454894,4
2020-04-25-170109,170109,2,0,1,74,0.6,142.48094352004915,5
2020-04-26-170109,170109,0,0,1,74,0.2,139.99781328627523,6
2020-04-27-170109,170109,2,0,3,76,1.2,94.14147521952417,0
2020-04-28-170109,170109,3,1,2,79,0.4,83.02516794253516,1
2020-04-29-170109,170109,3,0,0,82,1.8,77.97552952935197,2
2020-04-30-170109,170109,0,0,0,82,0.8,101.5211452011501,3
2020-05-01-170109,170109,0,0,1,82,0.2,113.1874330534238,4
2020-05-02-170109,170109,0,0,0,82,1.4,49.45430432989623,5
2020-05-03-170109,170109,1,0,0,83,0.4,38.840469081967726,6
2020-05-04-170109,170109,0,0,1,83,1.2,35.81268971658794,0
2020-05-05-170109,170109,0,0,2,83,0.6,36.93166003241569,1
2020-05-06-170109,170109,3,0,0,86,0.8,41.83539044248531,2
2020-05-07-170109,170109,0,0,0,86,1.6,45.43450349358977,3
2020-05-08-170109,170109,1,0,0,87,4.8,54.165554487442705,4
2020-05-09-170109,170109,1,0,0,88,1.2,70.3637517716104,5
2020-05-10-170109,170109,1,0,1,89,0.6,120.25182404108203,6
2020-05-11-170109,170109,3,0,2,92,1.6,123.40019386835974,0
2020-05-12-170109,170109,2,0,1,94,1.2,144.49631200190902,1
2020-05-13-170109,170109,0,0,0,94,0.8,123.64291254420624,2
2020-05-14-170109,170109,0,0,1,94,1.2,102.9438929753918,3
2020-05-15-170109,170109,1,0,0,95,0.6,93.69100466323061,4
2020-05-16-170109,170109,0,0,0,95,0.0,75.51111956961822,5
2020-05-17-170109,170109,0,0,2,95,0.4,75.24986276038979,6
2020-05-18-170109,170109,1,0,1,96,1.2,69.84597008605772,0
2020-05-19-170109,170109,2,0,0,98,0.2,65.28285552250688,1
2020-05-20-170109,170109,0,1,1,98,0.8,66.35118475572878,2
2020-05-21-170109,170109,0,0,0,98,0.8,64.14851948577277,3
2020-05-22-170109,170109,0,0,0,98,1.0,62.3013009939211,4
2020-05-23-170109,170109,0,0,0,98,0.2,68.34144959580331,5
2020-05-24-170109,170109,1,0,0,99,0.0,69.70973421102457,6
2020-05-25-170109,170109,2,0,1,101,1.2,49.64138650982865,0
2020-05-26-170109,170109,1,0,0,102,1.0,52.45136971059575,1
2020-05-27-170109,170109,0,0,0,102,0.2,52.69974230906105,2
2020-05-28-170109,170109,1,0,0,103,3.2,50.140969998372846,3
2020-05-29-170109,170109,0,1,0,103,0.2,60.39954735901414,4
2020-05-30-170109,170109,0,0,0,103,0.2,63.985427262039316,5
2020-05-31-170109,170109,2,0,0,105,0.0,59.605682210575964,6
2020-06-01-170109,170109,1,0,1,106,0.4,107.787771955191,0
2020-06-02-170109,170109,0,0,0,106,1.8,34.45877183101315,1
2020-06-03-170109,170109,1,0,1,107,0.8,28.02701953981954,2
2020-06-04-170109,170109,0,0,1,107,0.4,33.61109557703911,3
2020-06-05-170109,170109,0,0,0,107,0.4,34.66607718347584,4
2020-06-06-170109,170109,0,3,2,107,0.4,27.803179809205922,5
2020-06-07-170109,170109,0,0,0,107,0.0,28.13747978259615,6
2020-06-08-170109,170109,1,0,0,108,0.6,26.498575556772707,0
2020-06-09-170109,170109,0,0,0,108,0.6,33.25263249748042,1
2020-06-10-170109,170109,0,0,1,108,0.2,106.23739323454518,2
2020-06-11-170109,170109,0,0,0,108,0.4,91.66686243800935,3
2020-06-12-170109,170109,0,0,2,108,0.4,83.31489616663609,4
2020-06-13-170109,170109,0,0,0,108,0.0,63.574518068059774,5
2020-06-14-170109,170109,0,0,0,108,0.4,50.2151096062812,6
2020-06-15-170109,170109,1,0,0,109,0.4,26.06401868367241,0
2020-06-16-170109,170109,0,0,1,109,0.6,23.021289042566664,1
2020-06-17-170109,170109,1,0,1,110,1.4,21.732023471009125,2
2020-06-18-170109,170109,1,0,1,111,1.6,30.058811921838576,3
2020-06-19-170109,170109,0,0,1,111,0.0,37.36388374242457,4
2020-06-20-170109,170109,2,0,0,113,0.2,47.88756618236229,5
2020-06-21-170109,170109,0,0,0,113,0.8,57.718221290170455,6
2020-06-22-170109,170109,0,0,1,113,0.4,52.6276412577391,0
2020-06-23-170109,170109,0,0,0,113,0.2,51.86603517538762,1
2020-06-24-170109,170109,1,0,0,114,0.0,45.551278958645185,2
2020-06-25-170109,170109,0,1,0,114,0.4,43.19709334816828,3
2020-06-26-170109,170109,2,0,2,116,0.0,47.62393171022498,4
2020-06-27-170109,170109,0,0,2,116,0.2,44.51391452123251,5
2020-06-28-170109,170109,0,1,0,116,0.2,34.86350679274197,6
2020-06-29-170109,170109,0,0,2,116,0.4,36.550328941003,0
2020-06-30-170109,170109,1,0,1,117,0.0,42.997115590812626,1
2020-07-01-170109,170109,1,0,1,118,0.6,36.47555008042699,2
2020-07-02-170109,170109,1,0,1,119,0.4,54.745766978964625,3
2020-07-03-170109,170109,1,0,2,120,0.0,17.87656243828582,4
2020-07-04-170109,170109,0,0,2,120,0.0,29.880726105931963,5
2020-07-05-170109,170109,0,0,0,120,0.0,30.000391928295816,6
2020-07-06-170109,170109,1,0,3,121,0.0,22.548564809584285,0
2020-07-07-170109,170109,0,0,0,121,0.4,27.885494580656214,1
2020-07-08-170109,170109,0,1,1,121,0.0,30.983877005344084,2
2020-07-09-170109,170109,0,1,0,121,0.2,25.62444870776715,3
2020-07-10-170109,170109,2,0,0,123,0.6,38.430773875163,4
2020-07-11-170109,170109,2,0,0,125,0.0,50.02931610580202,5
2020-07-12-170109,170109,0,0,0,125,0.2,59.32125234386483,6
2020-07-13-170109,170109,2,0,1,127,0.2,59.51771603381615,0
2020-07-14-170109,170109,1,0,0,128,0.6,69.57741055691373,1
2020-07-15-170109,170109,1,0,0,129,0.4,67.02759384122396,2
2020-07-16-170109,170109,1,0,1,130,0.0,64.92740335005688,3
2020-07-17-170109,170109,2,0,0,132,0.0,63.9803744194191,4
2020-07-18-170109,170109,2,0,0,134,0.0,63.94645371172018,5
2020-07-19-170109,170109,0,0,0,134,0.0,63.6331648053393,6
2020-07-20-170109,170109,3,0,2,137,0.0,64.1834337803982,0
2020-07-21-170109,170109,0,0,3,137,0.2,68.42828044445116,1
2020-07-22-170109,170109,1,0,3,138,0.2,66.08821455384822,2
2020-07-23-170109,170109,0,0,4,138,0.6,66.14434452953077,3
2020-07-24-170109,170109,0,0,3,138,0.0,53.21160158439873,4
2020-07-25-170109,170109,0,0,10,138,0.0,40.058021248164174,5
2020-07-26-170109,170109,0,0,0,138,0.2,39.46574438199585,6
2020-07-27-170109,170109,1,0,1,139,0.2,29.518360874126827,0
2020-07-28-170109,170109,0,0,2,139,0.0,26.04435997631188,1
2020-07-29-170109,170109,0,0,4,139,0.0,26.732907230979045,2
2020-07-30-170109,170109,1,0,3,140,0.0,21.634433117348912,3
2020-07-31-170109,170109,0,0,5,140,0.6,28.21384288177245,4
2020-08-01-170109,170109,0,0,2,140,0.0,23.46520401291522,5
2020-08-02-170109,170109,0,0,2,140,0.0,267.6959349871369,6
2020-08-03-170109,170109,2,0,6,142,0.0,130.10131804332244,0
2020-08-04-170109,170109,3,0,3,145,0.0,109.78562146111209,1
2020-08-05-170109,170109,3,0,4,148,0.8,107.1872025990695,2
2020-08-06-170109,170109,4,0,5,152,0.4,117.99778869157096,3
2020-08-07-170109,170109,3,0,4,155,1.2,140.61708955111928,4
2020-08-08-170109,170109,10,0,2,165,0.0,160.21925729606232,5
2020-08-09-170109,170109,0,0,3,165,0.2,217.40107427673965,6
2020-08-10-170109,170109,1,0,1,166,1.0,17.347337177598348,0
2020-08-11-170109,170109,2,0,2,168,2.2,39.22983345923316,1
2020-08-12-170109,170109,4,0,2,172,1.6,77.52038873954908,2
2020-08-13-170109,170109,3,0,2,175,1.2,141.81029518207384,3
2020-08-14-170109,170109,5,0,1,180,3.2,204.04270226469578,4
2020-08-15-170109,170109,2,0,0,182,0.6,277.13497272763334,5
2020-08-16-170109,170109,2,0,0,184,0.4,294.02916705684015,6
2020-08-17-170109,170109,6,0,0,190,0.6,299.5512741991408,0
2020-08-18-170109,170109,3,0,1,193,0.2,323.87984323795524,1
2020-08-19-170109,170109,4,0,0,197,0.4,309.2814269191657,2
2020-08-20-170109,170109,5,0,3,202,0.6,211.96007068137504,3
2020-08-21-170109,170109,4,0,0,206,1.6,189.20866262195952,4
2020-08-22-170109,170109,2,0,0,208,0.2,207.4216751453435,5
2020-08-23-170109,170109,3,0,0,211,0.4,212.6709880015096,6
2020-08-24-170109,170109,1,0,4,212,0.8,188.79931760153124,0
2020-08-25-170109,170109,2,0,4,214,0.8,178.9454317423312,1
2020-08-26-170109,170109,2,0,6,216,0.8,160.05419310718275,2
2020-08-27-170109,170109,2,0,0,218,1.2,182.34581227571636,3
2020-08-28-170109,170109,1,0,1,219,0.4,159.19442396613712,4
2020-08-29-170109,170109,0,0,0,219,1.4,136.80716973640222,5
2020-08-30-170109,170109,0,0,0,219,1.4,118.79889763538813,6
2020-08-31-170109,170109,0,0,3,219,0.6,114.72159075947114,0
2020-09-01-170109,170109,1,0,1,220,0.4,188.15601249863192,1
2020-09-02-170109,170109,0,0,4,220,0.4,215.6788726706007,2
2020-09-03-170109,170109,3,0,0,223,1.2,155.3495088166128,3
2020-09-04-170109,170109,0,0,3,223,2.8,157.5044941597686,4
2020-09-05-170109,170109,0,0,0,223,2.2,152.62235367936006,5
2020-09-06-170109,170109,0,0,0,223,2.0,142.74726674304185,6
2020-09-07-170109,170109,4,0,0,227,0.4,151.0953878347122,0
2020-09-08-170109,170109,4,0,0,231,2.6,160.33190474984485,1
2020-09-09-170109,170109,6,0,2,237,1.8,175.0181122457342,2
2020-09-10-170109,170109,0,0,0,237,2.0,148.48153385473617,3
2020-09-11-170109,170109,1,0,1,238,2.2,149.88244265280295,4
2020-09-12-170109,170109,0,0,1,238,0.6,162.33107649517106,5
2020-09-13-170109,170109,0,0,0,238,0.8,145.00324857239065,6
2020-09-14-170109,170109,3,0,0,241,1.6,131.13636545898692,0
2020-09-15-170109,170109,1,1,3,242,1.4,110.11180034685205,1
2020-09-16-170109,170109,4,0,2,246,1.8,128.12319381620796,2
2020-09-17-170109,170109,0,0,2,246,0.2,159.38158138694615,3
2020-09-18-170109,170109,3,0,0,249,4.2,178.42460732685026,4
2020-09-19-170109,170109,0,1,1,249,0.4,190.4200814743559,5
2020-09-20-170109,170109,0,0,0,249,1.4,177.95412569400682,6
2020-09-21-170109,170109,0,0,1,249,1.8,151.5967061262254,0
2020-09-22-170109,170109,0,2,1,249,2.8,143.50986131412526,1
2020-09-23-170109,170109,2,0,6,251,4.0,122.77462612769179,2
2020-09-24-170109,170109,0,0,0,251,2.8,116.58782519625754,3
2020-09-25-170109,170109,1,0,3,252,3.6,98.36063781872176,4
2020-09-26-170109,170109,1,0,0,253,1.0,111.41808878203992,5
2020-09-27-170109,170109,0,0,0,253,0.0,120.75154850963138,6
2020-09-28-170109,170109,0,0,1,253,1.6,114.01553499546381,0
2020-09-29-170109,170109,3,0,0,256,1.2,116.11793463116668,1
2020-09-30-170109,170109,2,0,6,258,1.6,123.53944050517056,2
2020-10-01-170109,170109,2,1,0,260,2.2,0.0,3
2020-10-02-170109,170109,0,0,0,260,2.0,115.33444508349635,4
2020-10-03-170109,170109,1,0,0,261,0.8,228.8523951215758,5
2020-10-04-170109,170109,0,0,1,261,1.4,242.3676670098635,6
2020-10-05-170109,170109,1,0,2,262,0.8,201.83694597275323,0
2020-10-06-170109,170109,1,0,1,263,1.6,194.05016895782052,1
2020-10-07-170109,170109,6,0,6,269,0.6,169.27039948973007,2
2020-10-08-170109,170109,0,1,2,269,1.4,152.7125841582183,3
2020-10-09-170109,170109,3,1,5,272,1.6,152.50605288608685,4
2020-10-10-170109,170109,0,0,0,272,0.8,17.0227752637251,5
2020-10-11-170109,170109,0,0,2,272,0.2,28.739028896925724,6
2020-10-12-170109,170109,1,0,9,273,1.4,34.40357211958595,0
2020-10-13-170109,170109,0,0,0,273,1.2,46.81391887212053,1
2020-10-14-170109,170109,6,0,4,279,2.0,58.93324332648598,2
2020-10-15-170109,170109,0,0,1,279,0.8,93.14044181314274,3
2020-10-16-170109,170109,0,0,8,279,1.0,96.01059715585805,4
2020-10-17-170109,170109,0,0,2,279,0.6,88.91087010337074,5
2020-10-18-170109,170109,1,0,3,280,0.8,80.71851417589617,6
2020-10-19-170109,170109,2,0,2,282,1.8,86.22702260033665,0
2020-10-20-170109,170109,1,0,1,283,1.4,100.9812166876051,1
2020-10-21-170109,170109,6,0,1,289,0.2,78.36035885026828,2
2020-10-22-170109,170109,2,0,2,291,2.2,115.84548048014528,3
2020-10-23-170109,170109,5,0,3,296,3.6,133.68396658046825,4
2020-10-24-170109,170109,0,0,0,296,1.0,159.62521436029266,5
2020-10-25-170109,170109,2,1,2,298,2.4,158.0281258253276,6
2020-10-26-170109,170109,9,1,2,307,2.4,157.4529989147882,0
2020-10-27-170109,170109,0,0,1,307,2.6,189.78298216700324,1
2020-10-28-170109,170109,4,0,9,311,2.4,193.22486066142034,2
2020-10-29-170109,170109,1,0,6,312,6.2,185.87815518434607,3
2020-10-30-170109,170109,8,0,5,320,6.4,183.64798750171323,4
2020-10-31-170109,170109,2,1,0,322,2.8,222.8580263891139,5
2020-11-01-170109,170109,3,1,0,325,5.6,128.64950802099153,6
2020-11-02-170109,170109,2,2,0,327,1.2,102.34198233580808,0
2020-11-03-170109,170109,1,1,0,328,3.4,74.48712236232795,1
2020-11-04-170109,170109,1,0,0,329,7.6,97.02102649885227,2
2020-11-05-170109,170109,2,1,0,331,8.6,121.60276075791114,3
2020-11-06-170109,170109,3,0,0,334,5.8,148.41722761818824,4
2020-11-07-170109,170109,0,0,0,334,3.2,174.67405235484048,5
2020-11-08-170109,170109,2,0,0,336,2.2,176.01649987855427,6
2020-11-09-170109,170109,2,0,0,338,1.6,178.87587027197543,0
2020-11-10-170109,170109,1,0,0,339,1.8,129.90069086194578,1
2020-11-11-170109,170109,9,0,0,348,2.6,136.23143939610299,2
2020-11-12-170109,170109,6,0,0,354,2.4,170.53801321028197,3
2020-11-13-170109,170109,5,0,0,359,4.4,196.68796800362156,4
2020-03-01-170110,170110,0,0,0,0,0.0,0.0,6
2020-03-02-170110,170110,0,0,0,0,0.0,1.2647775065304279,0
2020-03-03-170110,170110,0,0,0,0,0.0,8.133585919746778,1
2020-03-04-170110,170110,0,2,9,0,0.0,11.368865130949292,2
2020-03-05-170110,170110,0,0,1,0,0.0,11.398480625441035,3
2020-03-06-170110,170110,0,0,0,0,0.0,9.32352958611491,4
2020-03-07-170110,170110,0,0,0,0,0.0,9.621116674672454,5
2020-03-08-170110,170110,0,0,0,0,0.0,8.956399203686544,6
2020-03-09-170110,170110,0,0,0,0,0.0,8.896926692494205,0
2020-03-10-170110,170110,0,0,1,0,0.0,12.574204385693589,1
2020-03-11-170110,170110,0,0,10,0,0.0,10.162558581123337,2
2020-03-12-170110,170110,0,0,8,0,0.0,8.107258661187682,3
2020-03-13-170110,170110,0,0,11,0,0.6666666666666666,5.2864182684475285,4
2020-03-14-170110,170110,0,0,3,0,0.3333333333333333,4.086143525201065,5
2020-03-15-170110,170110,0,0,1,0,0.0,1.8709015866002594,6
2020-03-16-170110,170110,0,0,3,0,0.6666666666666666,0.9420746690601269,0
2020-03-17-170110,170110,0,0,3,0,0.3333333333333333,1.557927536485931,1
2020-03-18-170110,170110,9,0,10,9,1.0,1.6216155342061063,2
2020-03-19-170110,170110,1,0,1,10,2.0,7.132687049389964,3
2020-03-20-170110,170110,0,0,6,10,3.0,8.042891529301128,4
2020-03-21-170110,170110,0,0,1,10,0.6666666666666666,8.130406584057631,5
2020-03-22-170110,170110,0,1,1,10,0.6666666666666666,7.15154618635351,6
2020-03-23-170110,170110,0,0,2,10,5.666666666666668,7.027520141211486,0
2020-03-24-170110,170110,1,0,1,11,1.3333333333333333,7.663166043354005,1
2020-03-25-170110,170110,10,0,2,21,5.0,4.308322547394249,2
2020-03-26-170110,170110,8,0,0,29,1.3333333333333333,7.932637339650288,3
2020-03-27-170110,170110,11,0,1,40,2.0,11.336391106066523,4
2020-03-28-170110,170110,3,0,1,43,0.6666666666666666,14.461551440809949,5
2020-03-29-170110,170110,1,0,0,44,2.333333333333333,17.697676854826433,6
2020-03-30-170110,170110,3,0,1,47,4.0,17.99942668555255,0
2020-03-31-170110,170110,3,0,0,50,4.333333333333333,20.02253262683788,1
2020-04-01-170110,170110,10,0,1,60,4.0,1.967754360407147,2
2020-04-02-170110,170110,1,0,2,61,6.666666666666668,4.974899474721072,3
2020-04-03-170110,170110,6,0,0,67,3.0,4.737742874128701,4
2020-04-04-170110,170110,1,0,0,68,1.0,9.135537211192906,5
2020-04-05-170110,170110,1,0,0,69,1.0,9.29817519971169,6
2020-04-06-170110,170110,2,0,1,71,4.0,9.459756287767672,0
2020-04-07-170110,170110,1,0,0,72,2.0,12.250636291466233,1
2020-04-08-170110,170110,2,0,0,74,1.3333333333333333,14.630509620297817,2
2020-04-09-170110,170110,0,0,0,74,4.666666666666667,13.482493620110137,3
2020-04-10-170110,170110,1,0,1,75,9.333333333333334,5.564084770796441,4
2020-04-11-170110,170110,1,0,1,76,2.0,7.611425909784857,5
2020-04-12-170110,170110,0,0,0,76,0.0,8.607928786671287,6
2020-04-13-170110,170110,1,0,1,77,4.0,8.983325481563522,0
2020-04-14-170110,170110,0,0,1,77,2.6666666666666665,10.386503100252574,1
2020-04-15-170110,170110,1,0,4,78,8.0,10.073303088342298,2
2020-04-16-170110,170110,2,0,1,80,3.0,12.547279870135442,3
2020-04-17-170110,170110,0,0,0,80,3.333333333333333,9.329631474730856,4
2020-04-18-170110,170110,0,0,0,80,0.6666666666666666,9.11957367510948,5
2020-04-19-170110,170110,0,0,0,80,0.3333333333333333,6.200648280910659,6
2020-04-20-170110,170110,1,0,0,81,2.6666666666666665,6.4879138534596095,0
2020-04-21-170110,170110,0,1,0,81,1.3333333333333333,7.126321926960478,1
2020-04-22-170110,170110,0,0,5,81,0.6666666666666666,5.211296485156259,2
2020-04-23-170110,170110,0,0,0,81,0.0,4.486006887877276,3
2020-04-24-170110,170110,1,0,2,82,0.3333333333333333,4.0789551078468005,4
2020-04-25-170110,170110,1,0,0,83,0.0,4.289413852104799,5
2020-04-26-170110,170110,0,0,0,83,0.0,4.663607055754497,6
2020-04-27-170110,170110,1,0,3,84,1.0,2.8387920933132444,0
2020-04-28-170110,170110,1,0,0,85,1.0,2.626175834142693,1
2020-04-29-170110,170110,4,0,0,89,2.6666666666666665,2.505418798965879,2
2020-04-30-170110,170110,1,0,0,90,0.3333333333333333,5.975824944202631,3
2020-05-01-170110,170110,0,0,2,90,0.6666666666666666,8.470109402655048,4
2020-05-02-170110,170110,0,0,0,90,0.0,2.5424597901818533,5
2020-05-03-170110,170110,0,0,0,90,0.0,2.608510228854298,6
2020-05-04-170110,170110,0,0,0,90,0.6666666666666666,2.4559376269347295,0
2020-05-05-170110,170110,0,0,1,90,1.3333333333333333,2.223873701838288,1
2020-05-06-170110,170110,5,0,0,95,1.6666666666666667,1.65778672998628,2
2020-05-07-170110,170110,0,0,0,95,0.3333333333333333,4.636362663573212,3
2020-05-08-170110,170110,2,0,0,97,2.0,4.953843719772713,4
2020-05-09-170110,170110,0,0,0,97,0.6666666666666666,6.710394878865982,5
2020-05-10-170110,170110,0,0,0,97,0.3333333333333333,9.933627676525944,6
2020-05-11-170110,170110,3,0,0,100,0.6666666666666666,9.01729242135199,0
2020-05-12-170110,170110,0,0,0,100,1.0,10.977700195826818,1
2020-05-13-170110,170110,0,0,2,100,0.3333333333333333,8.468389232132486,2
2020-05-14-170110,170110,0,2,0,100,1.3333333333333333,7.003797690185706,3
2020-05-15-170110,170110,2,0,1,102,0.6666666666666666,4.92151370771419,4
2020-05-16-170110,170110,0,0,0,102,0.0,5.6334406546039215,5
2020-05-17-170110,170110,0,0,0,102,0.0,5.309441213805633,6
2020-05-18-170110,170110,0,0,0,102,0.3333333333333333,4.95037532921201,0
2020-05-19-170110,170110,1,0,1,103,0.3333333333333333,2.701277650412636,1
2020-05-20-170110,170110,0,0,1,103,1.3333333333333333,2.950106277721221,2
2020-05-21-170110,170110,0,0,1,103,1.0,2.894254699118666,3
2020-05-22-170110,170110,0,0,0,103,0.6666666666666666,1.5454083991763632,4
2020-05-23-170110,170110,0,0,0,103,0.6666666666666666,1.707228011708035,5
2020-05-24-170110,170110,0,0,0,103,0.0,1.685079193490997,6
2020-05-25-170110,170110,0,0,2,103,1.0,1.4308710841366337,0
2020-05-26-170110,170110,0,0,0,103,1.3333333333333333,0.9596350160536984,1
2020-05-27-170110,170110,2,0,0,105,0.6666666666666666,0.9399705771452493,2
2020-05-28-170110,170110,0,0,1,105,0.3333333333333333,2.2668608327569686,3
2020-05-29-170110,170110,1,0,0,106,0.3333333333333333,2.3771331801777236,4
2020-05-30-170110,170110,0,0,0,106,0.0,2.6947864420178664,5
2020-05-31-170110,170110,0,0,0,106,0.3333333333333333,2.91350888302685,6
2020-06-01-170110,170110,0,0,0,106,0.0,7.922948433313479,0
2020-06-02-170110,170110,1,0,1,107,0.3333333333333333,2.985270457302535,1
2020-06-03-170110,170110,1,0,1,108,1.0,1.3137100130300312,2
2020-06-04-170110,170110,1,0,1,109,0.6666666666666666,1.5222212952715601,3
2020-06-05-170110,170110,0,0,0,109,0.6666666666666666,2.0646871579461603,4
2020-06-06-170110,170110,0,0,0,109,0.3333333333333333,2.275369376231741,5
2020-06-07-170110,170110,0,0,0,109,0.3333333333333333,2.5663736681953413,6
2020-06-08-170110,170110,2,0,0,111,0.6666666666666666,2.7885643392969377,0
2020-06-09-170110,170110,0,0,1,111,0.6666666666666666,3.748095679650406,1
2020-06-10-170110,170110,0,0,0,111,0.0,8.812785918773171,2
2020-06-11-170110,170110,1,0,0,112,0.6666666666666666,7.95716345817295,3
2020-06-12-170110,170110,0,0,0,112,0.3333333333333333,8.87637831882608,4
2020-06-13-170110,170110,0,0,0,112,0.0,4.963275594056171,5
2020-06-14-170110,170110,0,0,0,112,0.0,4.156783369047012,6
2020-06-15-170110,170110,0,0,0,112,0.0,1.743475627196863,0
2020-06-16-170110,170110,1,0,0,113,0.0,1.3463588582968016,1
2020-06-17-170110,170110,1,0,0,114,0.6666666666666666,2.4270478902802624,2
2020-06-18-170110,170110,1,0,0,115,0.0,3.435191961311003,3
2020-06-19-170110,170110,0,0,0,115,0.3333333333333333,3.4031014206411667,4
2020-06-20-170110,170110,0,0,0,115,0.0,3.6656178710157814,5
2020-06-21-170110,170110,0,0,0,115,0.0,3.424961176800169,6
2020-06-22-170110,170110,0,0,0,115,0.6666666666666666,3.5026578533488446,0
2020-06-23-170110,170110,1,0,0,116,0.3333333333333333,2.837088080446234,1
2020-06-24-170110,170110,0,0,0,116,0.6666666666666666,2.576504476412052,2
2020-06-25-170110,170110,0,2,0,116,0.6666666666666666,1.7115590401614573,3
2020-06-26-170110,170110,0,0,0,116,0.3333333333333333,1.9408235461074002,4
2020-06-27-170110,170110,0,1,0,116,0.0,1.5797554662608135,5
2020-06-28-170110,170110,0,0,0,116,0.0,1.5515853801427153,6
2020-06-29-170110,170110,0,0,0,116,0.3333333333333333,1.5021551697999291,0
2020-06-30-170110,170110,0,0,0,116,0.0,1.586465976666021,1
2020-07-01-170110,170110,0,1,0,116,0.3333333333333333,3.4518964313558964,2
2020-07-02-170110,170110,0,0,0,116,0.3333333333333333,0.6178798912005538,3
2020-07-03-170110,170110,0,0,0,116,0.0,1.3727229052837302,4
2020-07-04-170110,170110,0,0,0,116,0.0,1.4349893924407917,5
2020-07-05-170110,170110,0,0,0,116,0.0,1.5390721605022835,6
2020-07-06-170110,170110,0,0,0,116,0.0,1.4208312595647756,0
2020-07-07-170110,170110,0,0,0,116,0.6666666666666666,0.9331219543055936,1
2020-07-08-170110,170110,0,0,0,116,0.0,0.71992334895355,2
2020-07-09-170110,170110,0,0,0,116,0.3333333333333333,0.7634156329715427,3
2020-07-10-170110,170110,0,0,0,116,0.0,3.6908208778215243,4
2020-07-11-170110,170110,0,0,0,116,0.3333333333333333,2.821712331651206,5
2020-07-12-170110,170110,0,0,0,116,0.0,2.589939290982835,6
2020-07-13-170110,170110,0,0,0,116,0.0,2.6259768797677046,0
2020-07-14-170110,170110,0,0,0,116,0.6666666666666666,2.607889040330624,1
2020-07-15-170110,170110,0,0,0,116,0.6666666666666666,1.1833468950323698,2
2020-07-16-170110,170110,0,0,0,116,0.0,1.2128692509443373,3
2020-07-17-170110,170110,0,0,0,116,0.3333333333333333,1.0509865871095272,4
2020-07-18-170110,170110,0,0,0,116,0.0,1.1443479103945575,5
2020-07-19-170110,170110,0,0,0,116,0.0,0.8940382494759503,6
2020-07-20-170110,170110,0,0,0,116,0.0,0.9585101538917669,0
2020-07-21-170110,170110,0,0,0,116,0.0,0.7868387907761524,1
2020-07-22-170110,170110,0,0,0,116,0.0,0.80470849263507,2
2020-07-23-170110,170110,0,0,0,116,0.6666666666666666,0.9520267628634986,3
2020-07-24-170110,170110,0,0,0,116,0.0,1.9463389592378175,4
2020-07-25-170110,170110,0,0,0,116,0.0,1.8780043250219902,5
2020-07-26-170110,170110,0,0,2,116,0.0,2.062480561762928,6
2020-07-27-170110,170110,0,0,0,116,0.6666666666666666,1.6567091472539848,0
2020-07-28-170110,170110,0,0,1,116,2.0,1.97589730460798,1
2020-07-29-170110,170110,0,0,0,116,0.6666666666666666,3.0112853763217053,2
2020-07-30-170110,170110,0,0,1,116,0.0,2.6116106751319137,3
2020-07-31-170110,170110,0,0,0,116,0.0,1.7445844620734565,4
2020-08-01-170110,170110,0,0,1,116,0.0,0.8090371443437455,5
2020-08-02-170110,170110,0,0,0,116,0.6666666666666666,10.89264001598764,6
2020-08-03-170110,170110,0,0,0,116,0.0,23.896548532020685,0
2020-08-04-170110,170110,0,0,0,116,0.0,18.590748620476592,1
2020-08-05-170110,170110,0,0,5,116,0.6666666666666666,15.045328623330953,2
2020-08-06-170110,170110,0,0,49,116,4.333333333333333,14.842326855390688,3
2020-08-07-170110,170110,0,0,0,116,1.6666666666666667,15.445081133307102,4
2020-08-08-170110,170110,0,0,31,116,0.3333333333333333,7.645215632694198,5
2020-08-09-170110,170110,2,0,3,118,0.0,8.483911054811013,6
2020-08-10-170110,170110,0,0,2,118,1.0,0.8237249948215943,0
2020-08-11-170110,170110,1,0,2,119,2.0,1.5723217861775876,1
2020-08-12-170110,170110,0,0,4,119,1.0,3.73710405937116,2
2020-08-13-170110,170110,1,0,0,120,1.6666666666666667,5.28724886895177,3
2020-08-14-170110,170110,0,0,2,120,1.3333333333333333,6.7880275715374205,4
2020-08-15-170110,170110,1,0,11,121,1.3333333333333333,9.141938524971923,5
2020-08-16-170110,170110,0,0,0,121,0.0,10.897061942637215,6
2020-08-17-170110,170110,0,0,1,121,2.0,10.924321716981815,0
2020-08-18-170110,170110,0,0,0,121,0.3333333333333333,10.878286864875099,1
2020-08-19-170110,170110,5,0,0,126,1.3333333333333333,9.560632820400748,2
2020-08-20-170110,170110,49,0,2,175,0.6666666666666666,11.731325477671483,3
2020-08-21-170110,170110,0,0,3,175,2.0,56.88364551701544,4
2020-08-22-170110,170110,31,0,3,206,0.6666666666666666,52.89648711134746,5
2020-08-23-170110,170110,3,0,0,209,0.3333333333333333,77.62454403231902,6
2020-08-24-170110,170110,2,0,0,211,1.6666666666666667,81.9276268507219,0
2020-08-25-170110,170110,2,0,0,213,2.6666666666666665,73.43500287466097,1
2020-08-26-170110,170110,4,0,0,217,2.6666666666666665,74.89814241275428,2
2020-08-27-170110,170110,0,1,1,217,1.6666666666666667,73.80179490843427,3
2020-08-28-170110,170110,2,0,2,219,1.3333333333333333,39.54191674399409,4
2020-08-29-170110,170110,11,2,0,230,1.6666666666666667,39.96676632899248,5
2020-08-30-170110,170110,0,1,2,230,2.0,22.58190476112046,6
2020-08-31-170110,170110,1,3,0,231,1.3333333333333333,17.807061175794548,0
2020-09-01-170110,170110,0,2,1,231,0.3333333333333333,6.651379334570484,1
2020-09-02-170110,170110,0,0,4,231,0.6666666666666666,19.83899883119894,2
2020-09-03-170110,170110,2,0,0,233,4.0,5.334991810428399,3
2020-09-04-170110,170110,3,0,10,236,5.0,7.3600772565900305,4
2020-09-05-170110,170110,3,1,5,239,0.3333333333333333,10.88158680785872,5
2020-09-06-170110,170110,0,1,1,239,1.0,12.244630612834492,6
2020-09-07-170110,170110,0,0,0,239,1.3333333333333333,13.132193827549244,0
2020-09-08-170110,170110,0,1,0,239,0.0,12.945912368538119,1
2020-09-09-170110,170110,0,1,0,239,2.6666666666666665,13.21344437947695,2
2020-09-10-170110,170110,1,1,0,240,0.3333333333333333,4.668705844514983,3
2020-09-11-170110,170110,2,0,0,242,2.0,6.607801071342521,4
2020-09-12-170110,170110,0,0,0,242,8.333333333333334,9.078974677190729,5
2020-09-13-170110,170110,2,0,0,244,0.3333333333333333,9.211905331241608,6
2020-09-14-170110,170110,0,0,0,244,2.0,9.08391777169544,0
2020-09-15-170110,170110,1,0,0,245,3.0,9.358394964539695,1
2020-09-16-170110,170110,4,0,0,249,2.333333333333333,10.128984458795802,2
2020-09-17-170110,170110,0,0,0,249,1.3333333333333333,12.86462936319401,3
2020-09-18-170110,170110,10,0,0,259,3.333333333333333,11.64169408885187,4
2020-09-19-170110,170110,5,1,0,264,0.3333333333333333,14.241396152338984,5
2020-09-20-170110,170110,1,0,0,265,0.3333333333333333,13.537555995845509,6
2020-09-21-170110,170110,0,1,0,265,0.0,14.132290193907105,0
2020-09-22-170110,170110,0,1,0,265,1.6666666666666667,12.829531789105223,1
2020-09-23-170110,170110,0,1,1,265,2.6666666666666665,11.464504173833758,2
2020-09-24-170110,170110,0,1,0,265,0.3333333333333333,12.129348524124989,3
2020-09-25-170110,170110,0,0,2,265,2.333333333333333,7.8585603810527935,4
2020-09-26-170110,170110,0,0,3,265,0.6666666666666666,5.178781374076042,5
2020-09-27-170110,170110,0,0,0,265,0.0,5.521299316658521,6
2020-09-28-170110,170110,0,0,2,265,1.0,5.160268373910833,0
2020-09-29-170110,170110,0,0,1,265,0.0,4.7247194939865285,1
2020-09-30-170110,170110,0,0,0,265,2.6666666666666665,5.878485217391283,2
2020-10-01-170110,170110,0,0,0,265,1.0,0.0,3
2020-10-02-170110,170110,0,0,0,265,1.3333333333333333,4.769366179803043,4
2020-10-03-170110,170110,0,1,0,265,1.0,12.503957350628877,5
2020-10-04-170110,170110,0,1,0,265,0.0,12.289973052325314,6
2020-10-05-170110,170110,0,0,0,265,3.0,9.381626165552488,0
2020-10-06-170110,170110,0,0,1,265,0.3333333333333333,7.393925142240313,1
2020-10-07-170110,170110,1,1,0,266,0.6666666666666666,6.932973604876825,2
2020-10-08-170110,170110,0,0,2,266,2.6666666666666665,6.378023060758566,3
2020-10-09-170110,170110,2,0,2,268,1.6666666666666667,7.8193124663009534,4
2020-10-10-170110,170110,3,0,0,271,1.0,0.8358847354247401,5
2020-10-11-170110,170110,0,0,0,271,2.0,3.0976963781089433,6
2020-10-12-170110,170110,2,0,3,273,0.6666666666666666,3.9075767670072654,0
2020-10-13-170110,170110,1,0,3,274,2.333333333333333,6.000270259197495,1
2020-10-14-170110,170110,0,0,0,274,0.0,8.380133412751508,2
2020-10-15-170110,170110,0,0,2,274,1.0,9.881224221122096,3
2020-10-16-170110,170110,0,0,2,274,1.0,9.581518660680013,4
2020-10-17-170110,170110,0,0,0,274,0.3333333333333333,8.869476978039344,5
2020-10-18-170110,170110,0,0,0,274,2.333333333333333,6.692522934344623,6
2020-10-19-170110,170110,0,0,0,274,0.6666666666666666,7.133201928952401,0
2020-10-20-170110,170110,1,0,1,275,0.0,5.021513281921708,1
2020-10-21-170110,170110,0,0,0,275,1.3333333333333333,4.208880178466736,2
2020-10-22-170110,170110,2,0,0,277,1.3333333333333333,4.480173969289145,3
2020-10-23-170110,170110,2,1,1,279,1.6666666666666667,6.0729210432142535,4
2020-10-24-170110,170110,0,0,0,279,0.3333333333333333,8.310225548845445,5
2020-10-25-170110,170110,0,1,3,279,0.6666666666666666,7.712548749283927,6
2020-10-26-170110,170110,3,0,0,282,1.0,7.5548510769641215,0
2020-10-27-170110,170110,3,0,2,285,1.3333333333333333,8.927484120740429,1
2020-10-28-170110,170110,0,0,0,285,1.0,10.786012511550613,2
2020-10-29-170110,170110,2,0,3,287,0.6666666666666666,11.13334850893091,3
2020-10-30-170110,170110,2,0,3,289,1.6666666666666667,9.511428520818045,4
2020-10-31-170110,170110,0,0,0,289,0.0,11.772010199371778,5
2020-11-01-170110,170110,0,0,0,289,1.6666666666666667,7.416586365779758,6
2020-11-02-170110,170110,0,0,0,289,0.6666666666666666,11.064390432151122,0
2020-11-03-170110,170110,1,0,0,290,2.6666666666666665,6.977744437984059,1
2020-11-04-170110,170110,0,0,0,290,0.3333333333333333,7.760813254743712,2
2020-11-05-170110,170110,0,0,0,290,1.3333333333333333,8.436043819105137,3
2020-11-06-170110,170110,1,0,0,291,1.3333333333333333,7.853642592658978,4
2020-11-07-170110,170110,0,0,0,291,0.3333333333333333,9.360611389373913,5
2020-11-08-170110,170110,3,0,0,294,1.3333333333333333,9.33388109450631,6
2020-11-09-170110,170110,0,0,0,294,0.0,10.501899466431084,0
2020-11-10-170110,170110,2,0,0,296,0.3333333333333333,6.46327380437156,1
2020-11-11-170110,170110,0,0,0,296,1.3333333333333333,8.366360585758404,2
2020-11-12-170110,170110,3,0,0,299,2.0,9.328810499712205,3
2020-11-13-170110,170110,3,0,0,302,1.0,11.156456061523825,4
2020-03-01-170111,170111,0,0,1,0,0.0,0.0,6
2020-03-02-170111,170111,0,0,7,0,0.0,23.400807396012638,0
2020-03-03-170111,170111,0,0,4,0,0.0,70.46757107712666,1
2020-03-04-170111,170111,0,0,8,0,0.0,77.49135297663862,2
2020-03-05-170111,170111,0,0,12,0,0.5,78.24684050230498,3
2020-03-06-170111,170111,0,0,11,0,0.0,75.27231590590019,4
2020-03-07-170111,170111,0,0,1,0,0.0,78.9444436196941,5
2020-03-08-170111,170111,0,0,1,0,0.0,72.77937127750059,6
2020-03-09-170111,170111,0,0,10,0,0.0,71.09032894318149,0
2020-03-10-170111,170111,0,0,7,0,0.0,150.4965826098388,1
2020-03-11-170111,170111,1,0,7,1,0.5,123.14203472221027,2
2020-03-12-170111,170111,1,0,9,2,0.0,84.5818274492103,3
2020-03-13-170111,170111,1,0,5,3,1.0,43.79883276151673,4
2020-03-14-170111,170111,2,0,2,5,0.0,34.32415518718494,5
2020-03-15-170111,170111,1,0,2,6,0.0,31.754072239647268,6
2020-03-16-170111,170111,7,0,4,13,3.0,25.795276546466376,0
2020-03-17-170111,170111,4,2,7,17,1.5,46.83589497412317,1
2020-03-18-170111,170111,8,0,10,25,6.0,61.90595120458379,2
2020-03-19-170111,170111,12,0,5,37,3.5,91.61072073726119,3
2020-03-20-170111,170111,11,0,4,48,2.5,123.2963898105049,4
2020-03-21-170111,170111,1,1,1,49,0.5,144.38506405156735,5
2020-03-22-170111,170111,1,0,3,50,0.0,141.69075597345315,6
2020-03-23-170111,170111,10,0,9,60,8.0,128.15515093831402,0
2020-03-24-170111,170111,7,0,4,67,4.5,152.02664608156485,1
2020-03-25-170111,170111,7,0,3,74,4.5,147.59522388528475,2
2020-03-26-170111,170111,9,0,3,83,7.0,140.8675164489252,3
2020-03-27-170111,170111,5,0,11,88,5.0,171.41417517305456,4
2020-03-28-170111,170111,2,0,1,90,3.0,158.6487183176891,5
2020-03-29-170111,170111,2,0,0,92,2.5,158.8955398304043,6
2020-03-30-170111,170111,4,0,17,96,4.5,125.25238868944508,0
2020-03-31-170111,170111,7,2,2,103,6.5,118.6191431531228,1
2020-04-01-170111,170111,10,0,3,113,6.5,27.688498991469277,2
2020-04-02-170111,170111,5,0,5,118,13.0,105.15000978064049,3
2020-04-03-170111,170111,4,0,8,122,4.5,62.301531160631626,4
2020-04-04-170111,170111,1,0,0,123,4.0,66.94808674824135,5
2020-04-05-170111,170111,3,0,0,126,1.0,61.67209173163734,6
2020-04-06-170111,170111,9,0,5,135,9.0,67.662938887454,0
2020-04-07-170111,170111,4,2,3,139,8.5,75.13899734706101,1
2020-04-08-170111,170111,3,0,2,142,5.5,88.65423766951294,2
2020-04-09-170111,170111,3,2,0,145,2.5,93.04284124666077,3
2020-04-10-170111,170111,11,0,6,156,8.5,29.6534418599978,4
2020-04-11-170111,170111,1,1,7,157,0.5,50.056128560701026,5
2020-04-12-170111,170111,0,0,1,157,4.0,54.66559385745525,6
2020-04-13-170111,170111,17,0,11,174,4.5,62.88569986821193,0
2020-04-14-170111,170111,2,0,1,176,10.0,96.55227550367783,1
2020-04-15-170111,170111,3,0,2,179,2.5,122.32790122988582,2
2020-04-16-170111,170111,5,0,1,184,4.0,131.01711429304936,3
2020-04-17-170111,170111,8,0,1,192,3.5,116.54707091916605,4
2020-04-18-170111,170111,0,0,0,192,0.5,116.34050924491221,5
2020-04-19-170111,170111,0,0,3,192,2.5,112.8359098569253,6
2020-04-20-170111,170111,5,0,3,197,6.5,103.28020783673526,0
2020-04-21-170111,170111,3,0,2,200,6.0,103.69418862254298,1
2020-04-22-170111,170111,2,0,2,202,1.0,108.07395124736539,2
2020-04-23-170111,170111,0,1,2,202,0.0,104.00010396282516,3
2020-04-24-170111,170111,6,0,6,208,1.0,87.69637990348717,4
2020-04-25-170111,170111,7,0,1,215,0.5,103.63552422662305,5
2020-04-26-170111,170111,1,0,0,216,0.0,113.70905279798988,6
2020-04-27-170111,170111,11,0,2,227,3.0,82.4060915702429,0
2020-04-28-170111,170111,1,0,6,228,0.5,82.64755728920034,1
2020-04-29-170111,170111,2,0,0,230,4.0,71.35620047989114,2
2020-04-30-170111,170111,1,0,0,231,2.0,87.06896540013818,3
2020-05-01-170111,170111,1,0,3,232,0.0,94.59806614226628,4
2020-05-02-170111,170111,0,0,0,232,2.5,33.654914975703406,5
2020-05-03-170111,170111,3,0,0,235,0.5,25.389456775956127,6
2020-05-04-170111,170111,3,0,2,238,2.5,28.367914556737308,0
2020-05-05-170111,170111,2,0,2,240,0.5,33.33070692687375,1
2020-05-06-170111,170111,2,0,0,242,2.0,35.18255427614575,2
2020-05-07-170111,170111,2,0,3,244,1.5,32.54655643584728,3
2020-05-08-170111,170111,6,0,5,250,10.5,40.7152697466619,4
2020-05-09-170111,170111,1,0,0,251,1.5,57.36401054537534,5
2020-05-10-170111,170111,0,0,0,251,1.0,112.69108505806727,6
2020-05-11-170111,170111,2,0,0,253,3.5,107.26971980331665,0
2020-05-12-170111,170111,6,0,1,259,3.0,114.40834600019355,1
2020-05-13-170111,170111,0,2,2,259,1.5,92.99663074220173,2
2020-05-14-170111,170111,0,0,2,259,2.0,72.05623234575839,3
2020-05-15-170111,170111,3,0,0,262,1.5,57.721112910783475,4
2020-05-16-170111,170111,0,0,0,262,0.0,52.05218213641529,5
2020-05-17-170111,170111,0,0,0,262,1.0,50.48215653685648,6
2020-05-18-170111,170111,2,0,1,264,3.0,49.65155955391049,0
2020-05-19-170111,170111,2,0,1,266,0.5,52.24995161337755,1
2020-05-20-170111,170111,0,0,1,266,0.5,44.79428630252419,2
2020-05-21-170111,170111,3,0,1,269,1.5,43.935738412246984,3
2020-05-22-170111,170111,5,0,0,274,2.0,43.80719299816306,4
2020-05-23-170111,170111,0,0,0,274,0.5,59.4282264245677,5
2020-05-24-170111,170111,0,0,0,274,0.0,61.000077965067284,6
2020-05-25-170111,170111,0,0,6,274,2.0,43.649060179128064,0
2020-05-26-170111,170111,1,0,0,275,2.5,41.462143617276546,1
2020-05-27-170111,170111,2,0,1,277,0.5,43.24581410865344,2
2020-05-28-170111,170111,2,0,1,279,8.0,48.09852870173369,3
2020-05-29-170111,170111,0,5,2,279,0.5,53.07041292981907,4
2020-05-30-170111,170111,0,0,0,279,0.5,45.159625317122526,5
2020-05-31-170111,170111,0,0,1,279,0.0,45.55712171531493,6
2020-06-01-170111,170111,1,0,0,280,1.0,77.45190467169405,0
2020-06-02-170111,170111,1,0,2,281,4.5,22.629644116078197,1
2020-06-03-170111,170111,1,0,0,282,2.0,13.739682399524453,2
2020-06-04-170111,170111,1,0,0,283,0.5,16.506656133976023,3
2020-06-05-170111,170111,0,0,0,283,0.5,22.250253952405757,4
2020-06-06-170111,170111,0,0,0,283,1.0,23.54496410652299,5
2020-06-07-170111,170111,0,0,0,283,0.0,21.320684679345575,6
2020-06-08-170111,170111,6,0,0,289,1.0,19.765538344604067,0
2020-06-09-170111,170111,0,0,0,289,1.0,31.77860485101955,1
2020-06-10-170111,170111,1,0,1,290,0.5,77.64174073391845,2
2020-06-11-170111,170111,1,0,0,291,1.0,62.97603475363232,3
2020-06-12-170111,170111,2,0,0,293,1.0,57.35327524932205,4
2020-06-13-170111,170111,0,0,1,293,0.0,53.27533491934441,5
2020-06-14-170111,170111,1,0,0,294,0.5,45.384958460522114,6
2020-06-15-170111,170111,0,2,0,294,0.5,25.387938923860176,0
2020-06-16-170111,170111,2,0,0,296,1.0,22.33582431896097,1
2020-06-17-170111,170111,0,0,2,296,3.0,24.650925570632474,2
2020-06-18-170111,170111,0,0,0,296,3.0,26.227827037290275,3
2020-06-19-170111,170111,0,0,1,296,0.0,27.29156968214081,4
2020-06-20-170111,170111,0,1,0,296,0.0,31.355572971259342,5
2020-06-21-170111,170111,0,0,0,296,2.0,30.549997836534995,6
2020-06-22-170111,170111,0,0,1,296,1.0,31.47960207835018,0
2020-06-23-170111,170111,0,0,0,296,0.5,28.346619407759107,1
2020-06-24-170111,170111,1,0,0,297,0.0,26.40173312867927,2
2020-06-25-170111,170111,0,1,1,297,0.5,26.552373847969456,3
2020-06-26-170111,170111,0,0,0,297,0.0,29.06809349522569,4
2020-06-27-170111,170111,1,0,0,298,0.5,18.685817873866046,5
2020-06-28-170111,170111,0,0,0,298,0.5,22.368957103220993,6
2020-06-29-170111,170111,0,0,3,298,0.5,21.613865690184582,0
2020-06-30-170111,170111,0,0,0,298,0.0,26.74107615825959,1
2020-07-01-170111,170111,2,0,1,300,0.5,40.80348638943801,2
2020-07-02-170111,170111,0,0,0,300,1.0,28.459775140964986,3
2020-07-03-170111,170111,1,0,1,301,0.0,16.064396989239917,4
2020-07-04-170111,170111,0,0,0,301,0.0,21.389694176013005,5
2020-07-05-170111,170111,0,0,0,301,0.0,19.48110661377071,6
2020-07-06-170111,170111,1,0,0,302,0.0,15.963455223302926,0
2020-07-07-170111,170111,0,0,0,302,0.0,16.901289061603407,1
2020-07-08-170111,170111,0,0,1,302,0.0,17.451464654375528,2
2020-07-09-170111,170111,1,0,0,303,0.5,15.170194971662,3
2020-07-10-170111,170111,0,0,2,303,1.5,40.814111920452106,4
2020-07-11-170111,170111,0,0,1,303,0.0,41.67753344137448,5
2020-07-12-170111,170111,0,0,0,303,0.5,41.38921193304485,6
2020-07-13-170111,170111,3,0,1,306,0.5,40.771858003742004,0
2020-07-14-170111,170111,0,0,1,306,0.5,49.91152242755287,1
2020-07-15-170111,170111,1,0,0,307,0.0,33.079055043989406,2
2020-07-16-170111,170111,0,0,2,307,0.0,32.21227851311485,3
2020-07-17-170111,170111,1,1,0,308,0.0,26.48369266953469,4
2020-07-18-170111,170111,0,0,0,308,0.0,22.811827692640122,5
2020-07-19-170111,170111,0,0,0,308,0.0,22.45993775234675,6
2020-07-20-170111,170111,0,1,2,308,0.0,14.265761654022038,0
2020-07-21-170111,170111,0,0,0,308,0.0,15.073265122684056,1
2020-07-22-170111,170111,1,0,0,309,0.5,12.485809421978924,2
2020-07-23-170111,170111,0,0,2,309,0.0,16.164817730396262,3
2020-07-24-170111,170111,2,0,0,311,0.0,11.650896998739459,4
2020-07-25-170111,170111,1,0,0,312,0.0,13.289770016887747,5
2020-07-26-170111,170111,0,0,2,312,0.5,15.64984230100904,6
2020-07-27-170111,170111,1,0,2,313,0.0,13.740223818825397,0
2020-07-28-170111,170111,1,0,1,314,0.0,15.286715442946868,1
2020-07-29-170111,170111,0,0,0,314,0.0,17.472803349265845,2
2020-07-30-170111,170111,2,0,8,316,0.0,16.32106590156737,3
2020-07-31-170111,170111,0,0,0,316,1.0,19.56274664821943,4
2020-08-01-170111,170111,0,0,2,316,0.0,14.365602258420992,5
2020-08-02-170111,170111,0,0,0,316,0.0,83.61311773969172,6
2020-08-03-170111,170111,2,0,2,318,0.0,113.4936936768395,0
2020-08-04-170111,170111,0,0,2,318,0.0,127.67036232317201,1
2020-08-05-170111,170111,0,0,3,318,0.5,112.3906226536964,2
2020-08-06-170111,170111,2,0,0,320,0.5,89.15994388539771,3
2020-08-07-170111,170111,0,0,1,320,0.5,81.88347756505544,4
2020-08-08-170111,170111,0,0,1,320,0.0,63.04961062600403,5
2020-08-09-170111,170111,2,0,1,322,0.5,66.12322712851093,6
2020-08-10-170111,170111,2,0,3,324,1.0,10.685607292227951,0
2020-08-11-170111,170111,1,0,3,325,2.0,19.65522675506179,1
2020-08-12-170111,170111,0,0,8,325,1.5,29.272730666409878,2
2020-08-13-170111,170111,8,0,5,333,2.0,37.62437980734434,3
2020-08-14-170111,170111,0,0,5,333,1.0,65.64654705245705,4
2020-08-15-170111,170111,2,0,7,335,0.5,71.89119299425039,5
2020-08-16-170111,170111,0,0,2,335,1.0,73.36705406856382,6
2020-08-17-170111,170111,2,0,8,337,0.5,76.44376939333836,0
2020-08-18-170111,170111,2,0,2,339,0.0,76.91936621721996,1
2020-08-19-170111,170111,3,0,5,342,1.0,74.75789527121778,2
2020-08-20-170111,170111,0,0,10,342,1.0,51.137690918087316,3
2020-08-21-170111,170111,1,0,9,343,2.0,53.503730858711585,4
2020-08-22-170111,170111,1,0,1,344,0.5,55.291848466670686,5
2020-08-23-170111,170111,1,0,3,345,1.0,58.28901107606707,6
2020-08-24-170111,170111,3,0,4,348,1.5,55.37602781325319,0
2020-08-25-170111,170111,3,0,4,351,1.0,62.39698048734788,1
2020-08-26-170111,170111,8,1,4,359,1.5,58.54594589137239,2
2020-08-27-170111,170111,5,0,4,364,2.0,71.5138915257605,3
2020-08-28-170111,170111,5,0,2,369,1.0,85.40148383594746,4
2020-08-29-170111,170111,7,1,0,376,1.5,89.17312475357639,5
2020-08-30-170111,170111,2,0,0,378,1.5,101.18460640396287,6
2020-08-31-170111,170111,8,0,9,386,0.5,98.10932101399729,0
2020-09-01-170111,170111,2,0,3,388,0.0,57.51947811262542,1
2020-09-02-170111,170111,5,0,3,393,1.0,132.05973389155108,2
2020-09-03-170111,170111,10,0,10,403,0.0,134.48857172735825,3
2020-09-04-170111,170111,9,0,2,412,3.0,121.65700394115916,4
2020-09-05-170111,170111,1,0,7,413,5.0,138.47109185410656,5
2020-09-06-170111,170111,3,0,2,416,4.5,145.12368407056974,6
2020-09-07-170111,170111,4,0,4,420,0.0,154.22602488807408,0
2020-09-08-170111,170111,4,0,1,424,5.0,155.48510628642936,1
2020-09-09-170111,170111,4,0,7,428,2.0,161.74889195266178,2
2020-09-10-170111,170111,4,2,11,432,2.5,36.07065775072329,3
2020-09-11-170111,170111,2,0,5,434,2.0,48.49451698749303,4
2020-09-12-170111,170111,0,0,2,434,1.0,62.11681350897555,5
2020-09-13-170111,170111,0,1,3,434,0.5,56.55364294511389,6
2020-09-14-170111,170111,9,0,3,443,3.5,57.89460350320095,0
2020-09-15-170111,170111,3,0,4,446,2.0,88.30735960173544,1
2020-09-16-170111,170111,3,1,11,449,1.5,94.48142508315414,2
2020-09-17-170111,170111,10,0,5,459,0.5,105.1051903365609,3
2020-09-18-170111,170111,2,0,8,461,6.5,118.53917880455231,4
2020-09-19-170111,170111,7,1,0,468,0.0,119.710879630309,5
2020-09-20-170111,170111,2,0,0,470,3.0,142.96950595881918,6
2020-09-21-170111,170111,4,0,2,474,3.0,112.7659271764481,0
2020-09-22-170111,170111,1,0,2,475,3.5,111.5467636613605,1
2020-09-23-170111,170111,7,0,1,482,8.5,112.76655878593465,2
2020-09-24-170111,170111,11,1,1,493,6.5,115.44656958663884,3
2020-09-25-170111,170111,5,1,1,498,7.5,132.14557600503406,4
2020-09-26-170111,170111,2,0,0,500,2.5,135.33048504662534,5
2020-09-27-170111,170111,3,0,2,503,0.0,131.52321118786114,6
2020-09-28-170111,170111,3,0,2,506,3.5,128.79740680134762,0
2020-09-29-170111,170111,4,0,4,510,2.0,132.4169607486666,1
2020-09-30-170111,170111,11,0,1,521,3.5,119.47309974711936,2
2020-10-01-170111,170111,5,0,3,526,4.0,0.0,3
2020-10-02-170111,170111,8,0,2,534,3.5,90.65164535240012,4
2020-10-03-170111,170111,0,0,2,534,1.5,148.80238253082914,5
2020-10-04-170111,170111,0,0,1,534,3.0,146.65345098565064,6
2020-10-05-170111,170111,2,0,5,536,2.0,131.5008606676127,0
2020-10-06-170111,170111,2,0,2,538,3.5,123.59426641193421,1
2020-10-07-170111,170111,1,1,8,539,0.5,108.27402194770795,2
2020-10-08-170111,170111,1,0,4,540,2.0,85.33103271323657,3
2020-10-09-170111,170111,1,2,1,541,3.0,91.00219120868775,4
2020-10-10-170111,170111,0,0,0,541,1.5,16.712985355087135,5
2020-10-11-170111,170111,2,0,6,543,0.5,21.929109463751214,6
2020-10-12-170111,170111,2,0,2,545,2.5,27.591161363607554,0
2020-10-13-170111,170111,4,0,1,549,3.0,37.915727387613614,1
2020-10-14-170111,170111,1,0,5,550,4.0,51.29866833949394,2
2020-10-15-170111,170111,3,0,2,553,1.5,63.76126123703955,3
2020-10-16-170111,170111,2,0,3,555,2.5,71.90835211338111,4
2020-10-17-170111,170111,2,0,1,557,1.0,67.55444746478341,5
2020-10-18-170111,170111,1,0,4,558,1.5,68.32436561996444,6
2020-10-19-170111,170111,5,0,0,563,4.0,69.28935238272851,0
2020-10-20-170111,170111,2,0,8,565,3.5,84.80294792669449,1
2020-10-21-170111,170111,8,0,3,573,0.0,82.93962192245252,2
2020-10-22-170111,170111,4,0,11,577,5.0,99.17266300558276,3
2020-10-23-170111,170111,1,0,8,578,7.5,119.55169604316757,4
2020-10-24-170111,170111,0,0,3,578,2.5,130.6399117672935,5
2020-10-25-170111,170111,6,0,1,584,5.0,133.49171279235998,6
2020-10-26-170111,170111,2,1,2,586,6.0,135.65038491333175,0
2020-10-27-170111,170111,1,0,2,587,6.0,139.35769731839451,1
2020-10-28-170111,170111,5,1,4,592,5.5,145.36801171671058,2
2020-10-29-170111,170111,2,1,4,594,14.5,146.9427508641374,3
2020-10-30-170111,170111,3,0,2,597,12.5,141.56691956708383,4
2020-10-31-170111,170111,1,1,0,598,5.0,166.50587265028787,5
2020-11-01-170111,170111,4,2,0,602,11.0,75.61466672118817,6
2020-11-02-170111,170111,0,1,0,602,2.0,60.72935379224615,0
2020-11-03-170111,170111,8,1,0,610,7.0,43.834506143365246,1
2020-11-04-170111,170111,3,0,0,613,16.0,73.26277808107055,2
2020-11-05-170111,170111,11,0,0,624,17.0,94.80424775128111,3
2020-11-06-170111,170111,8,0,0,632,10.0,133.33990483877523,4
2020-11-07-170111,170111,3,0,0,635,5.5,171.44575215145184,5
2020-11-08-170111,170111,1,0,0,636,2.5,181.43409218924705,6
2020-11-09-170111,170111,2,0,0,638,1.5,183.77300508782264,0
2020-11-10-170111,170111,2,0,0,640,2.5,80.48970407198416,1
2020-11-11-170111,170111,4,1,0,644,3.0,86.0740432839257,2
2020-11-12-170111,170111,4,0,0,648,4.0,95.65767504140614,3
2020-11-13-170111,170111,2,1,0,650,4.5,108.47701725036839,4
2020-03-01-170112,170112,0,0,0,0,0.5,0.0,6
2020-03-02-170112,170112,0,0,1,0,0.0,6.93454121662902,0
2020-03-03-170112,170112,0,0,1,0,0.0,52.87135998527185,1
2020-03-04-170112,170112,0,1,1,0,0.0,60.41121247692093,2
2020-03-05-170112,170112,0,7,1,0,0.25,65.75189561559728,3
2020-03-06-170112,170112,0,0,0,0,0.0,64.13923663047674,4
2020-03-07-170112,170112,0,0,2,0,0.0,57.747449571956736,5
2020-03-08-170112,170112,0,0,0,0,0.0,46.924712766593544,6
2020-03-09-170112,170112,0,0,2,0,0.0,47.06374706101202,0
2020-03-10-170112,170112,0,0,3,0,0.25,88.90314681418553,1
2020-03-11-170112,170112,0,0,5,0,0.0,73.27926826749119,2
2020-03-12-170112,170112,0,0,1,0,0.25,48.995226743090875,3
2020-03-13-170112,170112,1,0,3,1,0.5,30.844795880327396,4
2020-03-14-170112,170112,0,0,5,1,0.5,24.32421039414442,5
2020-03-15-170112,170112,0,0,5,1,0.5,17.738391186846417,6
2020-03-16-170112,170112,1,0,3,2,3.0,10.319613543305119,0
2020-03-17-170112,170112,1,0,3,3,2.0,17.114473621898327,1
2020-03-18-170112,170112,1,0,2,4,1.5,23.55692544989853,2
2020-03-19-170112,170112,1,0,5,5,4.5,30.20299453807276,3
2020-03-20-170112,170112,0,0,2,5,2.25,40.79023957911848,4
2020-03-21-170112,170112,2,0,0,7,2.0,45.98048058828931,5
2020-03-22-170112,170112,0,0,0,7,2.25,47.40722296843887,6
2020-03-23-170112,170112,2,0,4,9,7.5,47.50863509335665,0
2020-03-24-170112,170112,3,0,1,12,5.25,63.25715223834497,1
2020-03-25-170112,170112,5,0,0,17,6.75,73.6150479410241,2
2020-03-26-170112,170112,1,0,0,18,6.75,82.01196191657186,3
2020-03-27-170112,170112,3,0,12,21,5.0,99.27738355220649,4
2020-03-28-170112,170112,5,0,0,26,4.5,109.17058716688332,5
2020-03-29-170112,170112,5,0,3,31,3.5,120.96729133413874,6
2020-03-30-170112,170112,3,0,1,34,7.5,105.79669856523535,0
2020-03-31-170112,170112,3,0,1,37,5.0,103.458691443665,1
2020-04-01-170112,170112,2,0,17,39,4.25,13.31219717310399,2
2020-04-02-170112,170112,5,0,3,44,4.0,67.03304474092089,3
2020-04-03-170112,170112,2,0,1,46,2.5,27.806917024393062,4
2020-04-04-170112,170112,0,0,0,46,2.5,31.56076071138134,5
2020-04-05-170112,170112,0,0,0,46,1.0,37.37806490014983,6
2020-04-06-170112,170112,4,0,0,50,4.0,37.644757339668665,0
2020-04-07-170112,170112,1,0,0,51,1.5,50.83801589508147,1
2020-04-08-170112,170112,0,1,0,51,2.5,53.46827491184004,2
2020-04-09-170112,170112,0,0,0,51,2.25,51.31992975907548,3
2020-04-10-170112,170112,12,0,0,63,3.0,12.646111874370025,4
2020-04-11-170112,170112,0,0,0,63,2.5,35.06899705826306,5
2020-04-12-170112,170112,3,0,0,66,0.75,37.673020456700385,6
2020-04-13-170112,170112,1,0,0,67,3.25,44.225870022854124,0
2020-04-14-170112,170112,1,0,0,68,3.75,50.11105330117873,1
2020-04-15-170112,170112,17,0,1,85,2.25,58.83133275326244,2
2020-04-16-170112,170112,3,0,2,88,2.25,88.40771922237401,3
2020-04-17-170112,170112,1,0,0,89,2.75,88.4285767855684,4
2020-04-18-170112,170112,0,0,0,89,2.0,72.35721182141205,5
2020-04-19-170112,170112,0,0,0,89,1.25,72.0396443877128,6
2020-04-20-170112,170112,0,2,0,89,3.75,77.16803488009697,0
2020-04-21-170112,170112,0,0,0,89,2.0,74.5814150584583,1
2020-04-22-170112,170112,0,0,1,89,3.75,49.05376490519189,2
2020-04-23-170112,170112,0,0,1,89,1.25,47.68519329223611,3
2020-04-24-170112,170112,0,0,0,89,2.75,42.334177802143316,4
2020-04-25-170112,170112,0,0,0,89,0.75,46.28173267569528,5
2020-04-26-170112,170112,0,0,0,89,0.75,45.773990044013566,6
2020-04-27-170112,170112,0,0,2,89,2.0,29.26111655697637,0
2020-04-28-170112,170112,0,0,2,89,1.75,28.116081228327584,1
2020-04-29-170112,170112,1,0,0,90,3.25,28.378872506945285,2
2020-04-30-170112,170112,2,0,0,92,1.25,35.55394961275297,3
2020-05-01-170112,170112,0,0,1,92,0.5,53.70514391872125,4
2020-05-02-170112,170112,0,0,0,92,1.0,21.326000663477238,5
2020-05-03-170112,170112,0,0,0,92,0.0,22.98810558321884,6
2020-05-04-170112,170112,0,0,2,92,1.5,16.746585897354592,0
2020-05-05-170112,170112,0,0,0,92,1.0,16.49713385172471,1
2020-05-06-170112,170112,1,0,0,93,1.5,12.84256263276295,2
2020-05-07-170112,170112,1,0,0,94,1.75,17.092388473351257,3
2020-05-08-170112,170112,0,0,0,94,1.75,21.934656823090958,4
2020-05-09-170112,170112,0,0,0,94,0.5,28.737500564393578,5
2020-05-10-170112,170112,0,0,0,94,0.5,58.6779774530526,6
2020-05-11-170112,170112,2,1,2,96,1.25,50.15000570544251,0
2020-05-12-170112,170112,2,0,3,98,1.25,54.155514627008465,1
2020-05-13-170112,170112,0,0,0,98,0.75,35.56903907150188,2
2020-05-14-170112,170112,0,3,0,98,0.75,30.571865280273258,3
2020-05-15-170112,170112,1,0,0,99,0.75,25.925609090482,4
2020-05-16-170112,170112,0,1,0,99,0.5,23.18048626988853,5
2020-05-17-170112,170112,0,0,0,99,0.0,23.53933296714092,6
2020-05-18-170112,170112,2,0,0,101,2.25,22.753330770559643,0
2020-05-19-170112,170112,0,0,0,101,0.5,26.76003149141239,1
2020-05-20-170112,170112,0,0,0,101,0.5,25.49554667496931,2
2020-05-21-170112,170112,0,0,0,101,0.75,24.904636912844268,3
2020-05-22-170112,170112,0,0,1,101,1.0,24.150859566830768,4
2020-05-23-170112,170112,0,0,0,101,0.5,28.528023746208486,5
2020-05-24-170112,170112,0,0,0,101,0.25,30.054501278200117,6
2020-05-25-170112,170112,2,0,0,103,0.75,18.005150725197012,0
2020-05-26-170112,170112,3,0,1,106,0.5,23.815896535403745,1
2020-05-27-170112,170112,0,0,1,106,2.5,27.129521491184917,2
2020-05-28-170112,170112,0,0,0,106,1.0,34.04104843869998,3
2020-05-29-170112,170112,0,10,0,106,0.0,35.33887883925934,4
2020-05-30-170112,170112,0,0,0,106,0.0,31.205667708183295,5
2020-05-31-170112,170112,0,0,0,106,0.0,31.086623140463516,6
2020-06-01-170112,170112,0,0,0,106,0.0,34.6650049489149,0
2020-06-02-170112,170112,0,1,0,106,2.0,13.230016254400653,1
2020-06-03-170112,170112,0,0,0,106,0.75,19.037912571495767,2
2020-06-04-170112,170112,0,0,0,106,0.5,12.969689553601373,3
2020-06-05-170112,170112,1,0,0,107,1.25,14.658762655738958,4
2020-06-06-170112,170112,0,0,0,107,0.25,16.642006701703348,5
2020-06-07-170112,170112,0,0,0,107,0.0,14.887230079645658,6
2020-06-08-170112,170112,0,0,0,107,0.5,11.726211253243417,0
2020-06-09-170112,170112,1,0,1,108,0.0,13.259868030107327,1
2020-06-10-170112,170112,1,0,1,109,0.75,33.48455446284598,2
2020-06-11-170112,170112,0,0,0,109,0.5,31.444601798643777,3
2020-06-12-170112,170112,0,0,0,109,0.5,30.330936232123214,4
2020-06-13-170112,170112,0,0,1,109,0.25,24.587335763773897,5
2020-06-14-170112,170112,0,0,1,109,0.0,18.60174236069887,6
2020-06-15-170112,170112,0,0,0,109,0.5,12.305273945659158,0
2020-06-16-170112,170112,0,0,0,109,0.75,12.987901526654365,1
2020-06-17-170112,170112,0,0,0,109,0.25,14.765823619514869,2
2020-06-18-170112,170112,0,0,0,109,1.0,11.895265966501125,3
2020-06-19-170112,170112,0,0,0,109,2.5,14.420248324161044,4
2020-06-20-170112,170112,0,0,0,109,0.25,23.47874558027074,5
2020-06-21-170112,170112,0,0,0,109,0.5,24.166562495141747,6
2020-06-22-170112,170112,0,0,0,109,0.25,23.894251437360616,0
2020-06-23-170112,170112,1,0,0,110,0.75,25.679843741738775,1
2020-06-24-170112,170112,1,0,1,111,0.75,33.797495957418505,2
2020-06-25-170112,170112,0,2,0,111,0.25,35.170178691495494,3
2020-06-26-170112,170112,0,0,0,111,0.5,30.618458980589217,4
2020-06-27-170112,170112,1,0,0,112,0.25,23.399303274541733,5
2020-06-28-170112,170112,1,0,0,113,0.5,26.377587998306954,6
2020-06-29-170112,170112,0,0,0,113,0.0,29.788474264877266,0
2020-06-30-170112,170112,0,0,0,113,0.25,22.073006836708544,1
2020-07-01-170112,170112,0,0,0,113,0.5,18.181165787197305,2
2020-07-02-170112,170112,0,0,0,113,0.0,19.80895292407137,3
2020-07-03-170112,170112,0,0,0,113,0.0,11.474626218938539,4
2020-07-04-170112,170112,0,1,0,113,0.25,10.657322572869077,5
2020-07-05-170112,170112,0,0,0,113,0.25,8.713880496614218,6
2020-07-06-170112,170112,0,0,0,113,0.25,10.883959125852746,0
2020-07-07-170112,170112,0,1,0,113,0.25,11.839003805733448,1
2020-07-08-170112,170112,1,0,0,114,0.25,11.085865576184656,2
2020-07-09-170112,170112,0,0,0,114,0.75,13.46434101480023,3
2020-07-10-170112,170112,0,0,0,114,0.0,18.669892382458944,4
2020-07-11-170112,170112,0,0,0,114,0.5,15.853170218543278,5
2020-07-12-170112,170112,0,0,0,114,0.0,16.57650159562298,6
2020-07-13-170112,170112,0,0,0,114,0.25,15.825212419784858,0
2020-07-14-170112,170112,0,0,0,114,0.0,19.2094229532565,1
2020-07-15-170112,170112,0,0,0,114,0.25,17.497025082422052,2
2020-07-16-170112,170112,0,0,0,114,0.5,16.142291986665466,3
2020-07-17-170112,170112,0,0,0,114,0.25,15.829876912348873,4
2020-07-18-170112,170112,0,0,0,114,0.0,16.271329934066213,5
2020-07-19-170112,170112,0,0,0,114,0.75,10.649376299485276,6
2020-07-20-170112,170112,0,0,0,114,0.25,16.17244428300444,0
2020-07-21-170112,170112,0,0,0,114,0.25,18.645862037227907,1
2020-07-22-170112,170112,0,0,0,114,0.0,18.74153272877339,2
2020-07-23-170112,170112,0,0,0,114,0.5,17.43266648227633,3
2020-07-24-170112,170112,0,0,0,114,0.0,19.98768189477558,4
2020-07-25-170112,170112,0,0,0,114,0.0,20.690056999394965,5
2020-07-26-170112,170112,0,0,0,114,0.25,12.647582918211196,6
2020-07-27-170112,170112,0,0,0,114,0.0,14.793129741116742,0
2020-07-28-170112,170112,0,0,0,114,0.0,12.195557362630506,1
2020-07-29-170112,170112,0,0,0,114,0.5,9.36608059878608,2
2020-07-30-170112,170112,0,0,0,114,0.5,6.940634991470997,3
2020-07-31-170112,170112,0,0,0,114,0.5,7.333218401508154,4
2020-08-01-170112,170112,0,0,0,114,0.25,12.274472108504046,5
2020-08-02-170112,170112,0,0,0,114,0.25,41.69294899698082,6
2020-08-03-170112,170112,0,0,0,114,0.75,116.89857202250793,0
2020-08-04-170112,170112,0,0,0,114,0.75,71.67944994366445,1
2020-08-05-170112,170112,0,0,2,114,0.25,66.03142391528665,2
2020-08-06-170112,170112,0,0,1,114,0.25,57.931930118033094,3
2020-08-07-170112,170112,0,0,0,114,0.5,42.78780523794516,4
2020-08-08-170112,170112,0,0,0,114,0.0,29.658097744864733,5
2020-08-09-170112,170112,0,0,1,114,0.0,25.405289923274424,6
2020-08-10-170112,170112,0,0,0,114,0.5,11.293179472932126,0
2020-08-11-170112,170112,0,0,0,114,1.25,15.77699912892714,1
2020-08-12-170112,170112,0,0,1,114,1.25,19.864754988213612,2
2020-08-13-170112,170112,0,0,1,114,0.75,23.369015527101734,3
2020-08-14-170112,170112,0,1,3,114,2.25,25.974891842599636,4
2020-08-15-170112,170112,0,0,4,114,2.25,28.52517473302523,5
2020-08-16-170112,170112,0,0,0,114,0.5,32.41166759813646,6
2020-08-17-170112,170112,0,0,1,114,1.0,32.93052295855264,0
2020-08-18-170112,170112,0,0,0,114,2.75,30.790725404980435,1
2020-08-19-170112,170112,2,0,1,116,2.5,31.461148883602565,2
2020-08-20-170112,170112,1,0,0,117,2.25,38.73183154068619,3
2020-08-21-170112,170112,0,0,4,117,5.75,37.27949909243583,4
2020-08-22-170112,170112,0,0,0,117,1.25,45.42249657688351,5
2020-08-23-170112,170112,1,0,0,118,1.25,47.450116135581716,6
2020-08-24-170112,170112,0,0,0,118,5.25,50.60310009870492,0
2020-08-25-170112,170112,0,0,0,118,7.5,69.06154026184763,1
2020-08-26-170112,170112,1,0,0,119,5.0,85.43947392442516,2
2020-08-27-170112,170112,1,0,1,120,4.5,93.87227626940259,3
2020-08-28-170112,170112,3,0,0,123,4.25,99.6099537055266,4
2020-08-29-170112,170112,4,0,0,127,1.75,100.25268993176041,5
2020-08-30-170112,170112,0,0,0,127,2.0,107.36330529362635,6
2020-08-31-170112,170112,1,0,0,128,3.0,83.3323119853267,0
2020-09-01-170112,170112,0,0,1,128,4.5,19.245453326124906,1
2020-09-02-170112,170112,1,0,0,129,3.0,79.01109713399661,2
2020-09-03-170112,170112,0,1,0,129,2.0,78.43157477194316,3
2020-09-04-170112,170112,4,0,0,133,3.0,52.31686191080934,4
2020-09-05-170112,170112,0,0,0,133,3.25,52.36460668404566,5
2020-09-06-170112,170112,0,0,1,133,2.5,49.42935089745755,6
2020-09-07-170112,170112,0,0,0,133,3.75,51.15250673417525,0
2020-09-08-170112,170112,0,0,1,133,1.25,53.19815783065196,1
2020-09-09-170112,170112,0,0,3,133,1.0,55.49975543281861,2
2020-09-10-170112,170112,1,0,4,134,2.75,17.18956446944504,3
2020-09-11-170112,170112,0,0,1,134,7.25,21.4085346267206,4
2020-09-12-170112,170112,0,0,0,134,1.5,32.054468819668685,5
2020-09-13-170112,170112,0,0,0,134,3.25,35.44061587147014,6
2020-09-14-170112,170112,0,0,0,134,3.25,38.89804390815921,0
2020-09-15-170112,170112,1,0,0,135,2.25,51.13326875852615,1
2020-09-16-170112,170112,0,0,0,135,3.25,60.757480517503055,2
2020-09-17-170112,170112,0,0,0,135,2.75,64.8341356189959,3
2020-09-18-170112,170112,0,1,2,135,18.5,67.3061087654093,4
2020-09-19-170112,170112,0,0,0,135,8.0,64.15986198597226,5
2020-09-20-170112,170112,1,0,0,136,5.75,78.71352167011445,6
2020-09-21-170112,170112,0,0,1,136,3.0,74.41804734145627,0
2020-09-22-170112,170112,1,0,0,137,2.75,71.48175886433114,1
2020-09-23-170112,170112,3,1,0,140,3.75,68.46200917038406,2
2020-09-24-170112,170112,4,0,0,144,3.25,74.55568590472495,3
2020-09-25-170112,170112,1,0,0,145,3.0,82.89366644306587,4
2020-09-26-170112,170112,0,0,1,145,1.5,83.68345346535533,5
2020-09-27-170112,170112,0,0,0,145,1.5,79.00499562612633,6
2020-09-28-170112,170112,0,0,2,145,1.75,74.36757620491082,0
2020-09-29-170112,170112,0,0,3,145,1.25,75.69122160172738,1
2020-09-30-170112,170112,0,0,1,145,3.5,61.62506153281602,2
2020-10-01-170112,170112,0,1,5,145,4.5,0.0,3
2020-10-02-170112,170112,2,0,1,147,3.0,76.39854322770827,4
2020-10-03-170112,170112,0,0,4,147,1.5,152.667584849195,5
2020-10-04-170112,170112,0,0,0,147,2.5,157.78517572143267,6
2020-10-05-170112,170112,1,0,0,148,3.25,143.72796879841604,0
2020-10-06-170112,170112,0,0,1,148,2.75,125.230285619097,1
2020-10-07-170112,170112,0,0,2,148,3.5,113.54273872503146,2
2020-10-08-170112,170112,0,0,1,148,2.25,91.27419346904603,3
2020-10-09-170112,170112,0,0,1,148,2.25,94.65942794581721,4
2020-10-10-170112,170112,1,0,0,149,0.75,11.884984881879687,5
2020-10-11-170112,170112,0,0,3,149,0.5,18.165558411889204,6
2020-10-12-170112,170112,2,0,1,151,0.75,20.510563267420835,0
2020-10-13-170112,170112,3,0,1,154,2.25,26.372950781586486,1
2020-10-14-170112,170112,1,0,0,155,2.25,40.48648283733501,2
2020-10-15-170112,170112,5,0,2,160,3.0,46.52249293926144,3
2020-10-16-170112,170112,1,0,3,161,5.25,57.568019885399835,4
2020-10-17-170112,170112,4,0,0,165,3.5,54.16596164672259,5
2020-10-18-170112,170112,0,0,1,165,2.25,65.82892074089641,6
2020-10-19-170112,170112,0,0,0,165,6.5,67.22296329583631,0
2020-10-20-170112,170112,1,2,0,166,4.75,70.69215941726652,1
2020-10-21-170112,170112,2,0,2,168,3.75,79.20737419847347,2
2020-10-22-170112,170112,1,0,3,169,6.5,82.00683124158255,3
2020-10-23-170112,170112,1,0,1,170,6.25,88.71966114636231,4
2020-10-24-170112,170112,0,0,0,170,7.0,86.05072488659162,5
2020-10-25-170112,170112,3,0,1,173,3.0,95.10307047025796,6
2020-10-26-170112,170112,1,0,0,174,7.25,98.96676039034317,0
2020-10-27-170112,170112,1,0,0,175,7.5,105.10091769583047,1
2020-10-28-170112,170112,0,0,2,175,8.0,116.5539901455603,2
2020-10-29-170112,170112,2,0,1,177,8.25,122.89011532326404,3
2020-10-30-170112,170112,3,0,2,180,8.5,129.46347610898826,4
2020-10-31-170112,170112,0,0,0,180,4.0,144.85335038101454,5
2020-11-01-170112,170112,1,0,0,181,3.5,75.48520692272429,6
2020-11-02-170112,170112,0,0,0,181,2.75,121.44267897421585,0
2020-11-03-170112,170112,0,1,0,181,5.5,113.23439982300303,1
2020-11-04-170112,170112,2,0,0,183,6.75,117.49027193142987,2
2020-11-05-170112,170112,3,0,0,186,4.25,110.11313872887773,3
2020-11-06-170112,170112,1,0,0,187,10.5,97.16625974376623,4
2020-11-07-170112,170112,0,2,0,187,2.75,96.55054615228431,5
2020-11-08-170112,170112,1,0,0,188,1.75,94.76539496822754,6
2020-11-09-170112,170112,0,0,0,188,6.75,91.18642174987946,0
2020-11-10-170112,170112,0,0,0,188,6.25,63.98970269450133,1
2020-11-11-170112,170112,2,0,0,190,3.25,69.17395277585034,2
2020-11-12-170112,170112,1,1,0,191,6.75,72.18492937077569,3
2020-11-13-170112,170112,2,0,0,193,7.25,84.55086784310015,4
2020-03-01-170113,170113,0,0,0,0,0.0,0.0,6
2020-03-02-170113,170113,0,0,0,0,0.0,13.707056230000875,0
2020-03-03-170113,170113,0,0,0,0,0.125,73.96539718113534,1
2020-03-04-170113,170113,0,0,0,0,0.0,73.46158255705237,2
2020-03-05-170113,170113,0,3,2,0,0.0,81.55394751872973,3
2020-03-06-170113,170113,0,0,0,0,0.0,77.7615742358455,4
2020-03-07-170113,170113,0,0,1,0,0.0,83.63022433323869,5
2020-03-08-170113,170113,0,0,0,0,0.0,85.20334907735091,6
2020-03-09-170113,170113,0,0,6,0,0.0,84.26993505703177,0
2020-03-10-170113,170113,0,0,0,0,0.0,100.18177552075576,1
2020-03-11-170113,170113,0,0,8,0,0.125,85.68887009546447,2
2020-03-12-170113,170113,0,1,0,0,0.125,61.94779253271493,3
2020-03-13-170113,170113,0,0,0,0,0.75,44.090953704214954,4
2020-03-14-170113,170113,1,0,0,1,0.0,33.23584180555392,5
2020-03-15-170113,170113,0,0,0,1,0.25,16.596770132331873,6
2020-03-16-170113,170113,0,0,4,1,1.125,9.499084995853138,0
2020-03-17-170113,170113,0,0,5,1,0.375,18.482027585602253,1
2020-03-18-170113,170113,0,0,2,1,3.5,24.759228618751806,2
2020-03-19-170113,170113,2,0,1,3,3.0,44.58855424407595,3
2020-03-20-170113,170113,0,0,1,3,2.625,75.73859263812236,4
2020-03-21-170113,170113,1,3,0,4,0.25,93.99024914740224,5
2020-03-22-170113,170113,0,0,0,4,1.0,96.85439590775134,6
2020-03-23-170113,170113,6,0,2,10,4.625,103.9789687168809,0
2020-03-24-170113,170113,0,0,0,10,2.0,147.59158007158123,1
2020-03-25-170113,170113,8,0,0,18,3.375,152.82567406207687,2
2020-03-26-170113,170113,0,0,0,18,2.875,161.93119338004948,3
2020-03-27-170113,170113,0,0,0,18,3.375,180.48203135898672,4
2020-03-28-170113,170113,0,0,0,18,1.125,180.58780991296393,5
2020-03-29-170113,170113,0,0,0,18,1.875,175.8966655398507,6
2020-03-30-170113,170113,4,0,0,22,2.875,123.21811797438767,0
2020-03-31-170113,170113,5,0,0,27,3.0,122.4243874419868,1
2020-04-01-170113,170113,2,0,1,29,4.25,29.9458107842378,2
2020-04-02-170113,170113,1,0,0,30,5.125,72.50912923411047,3
2020-04-03-170113,170113,1,0,1,31,3.0,26.891789282572546,4
2020-04-04-170113,170113,0,0,0,31,0.875,42.40763253775306,5
2020-04-05-170113,170113,0,0,0,31,0.875,45.45172629715914,6
2020-04-06-170113,170113,2,0,0,33,4.25,48.39483620385738,0
2020-04-07-170113,170113,0,0,1,33,2.625,67.11611307282092,1
2020-04-08-170113,170113,0,0,0,33,1.75,79.23710539057961,2
2020-04-09-170113,170113,0,0,0,33,2.625,81.26139572098256,3
2020-04-10-170113,170113,0,0,0,33,5.25,16.80997201046656,4
2020-04-11-170113,170113,0,0,0,33,1.125,28.560668427002163,5
2020-04-12-170113,170113,0,0,0,33,1.25,31.69899879792493,6
2020-04-13-170113,170113,0,0,0,33,2.5,35.942777111573164,0
2020-04-14-170113,170113,0,0,0,33,3.375,50.452581885136894,1
2020-04-15-170113,170113,1,0,1,34,3.625,63.464261599986685,2
2020-04-16-170113,170113,0,0,0,34,2.625,81.98235940848863,3
2020-04-17-170113,170113,1,0,0,35,1.75,78.24834918678826,4
2020-04-18-170113,170113,0,0,0,35,0.75,80.09827749744468,5
2020-04-19-170113,170113,0,0,0,35,1.125,79.46402807723244,6
2020-04-20-170113,170113,0,0,1,35,2.5,87.1513395545267,0
2020-04-21-170113,170113,1,0,1,36,1.625,88.78391607308816,1
2020-04-22-170113,170113,0,0,0,36,1.0,80.6781279407873,2
2020-04-23-170113,170113,0,0,1,36,0.0,77.99875546542953,3
2020-04-24-170113,170113,0,0,1,36,0.875,65.81407934868659,4
2020-04-25-170113,170113,0,0,0,36,0.375,69.14535152833122,5
2020-04-26-170113,170113,0,0,0,36,0.0,67.27659651073361,6
2020-04-27-170113,170113,0,0,0,36,1.0,44.81136773985436,0
2020-04-28-170113,170113,0,0,0,36,1.125,34.01233664126295,1
2020-04-29-170113,170113,1,0,0,37,2.25,28.333708747368128,2
2020-04-30-170113,170113,0,0,0,37,0.5,50.66650737457476,3
2020-05-01-170113,170113,0,0,0,37,0.25,83.90940589038206,4
2020-05-02-170113,170113,0,0,0,37,0.625,37.51924586694648,5
2020-05-03-170113,170113,0,0,0,37,0.25,22.602060899630033,6
2020-05-04-170113,170113,1,0,0,38,0.625,15.866686283412482,0
2020-05-05-170113,170113,1,0,0,39,0.5,23.099660982593605,1
2020-05-06-170113,170113,0,0,1,39,2.125,28.89929297900752,2
2020-05-07-170113,170113,1,0,1,40,0.625,33.31350634915343,3
2020-05-08-170113,170113,1,0,0,41,1.875,39.44060263112428,4
2020-05-09-170113,170113,0,0,0,41,0.5,53.64003503919942,5
2020-05-10-170113,170113,0,0,0,41,0.5,93.81066948999796,6
2020-05-11-170113,170113,0,0,1,41,1.875,89.86014031688458,0
2020-05-12-170113,170113,0,0,0,41,1.125,92.69250799162138,1
2020-05-13-170113,170113,0,0,0,41,0.25,67.88183423210123,2
2020-05-14-170113,170113,0,1,0,41,1.125,52.777509610639726,3
2020-05-15-170113,170113,0,0,0,41,0.75,44.82145391979453,4
2020-05-16-170113,170113,0,0,0,41,0.125,34.15599612218935,5
2020-05-17-170113,170113,0,0,0,41,0.125,36.242240378056685,6
2020-05-18-170113,170113,0,0,0,41,1.25,34.976670942147145,0
2020-05-19-170113,170113,0,0,0,41,0.625,45.808964232912274,1
2020-05-20-170113,170113,1,0,0,42,0.75,39.96108455669345,2
2020-05-21-170113,170113,1,0,1,43,0.75,43.95294842599013,3
2020-05-22-170113,170113,0,0,1,43,0.75,50.18022045266105,4
2020-05-23-170113,170113,0,0,0,43,0.375,54.79660452767138,5
2020-05-24-170113,170113,0,0,0,43,0.125,56.48847547039671,6
2020-05-25-170113,170113,1,0,0,44,0.75,36.34482530248123,0
2020-05-26-170113,170113,0,0,1,44,0.875,40.732247854813124,1
2020-05-27-170113,170113,0,0,0,44,0.5,43.431236946105905,2
2020-05-28-170113,170113,0,0,0,44,0.625,36.59568030335018,3
2020-05-29-170113,170113,0,2,0,44,0.5,31.632001099631488,4
2020-05-30-170113,170113,0,0,0,44,0.0,28.24955123154618,5
2020-05-31-170113,170113,0,0,0,44,0.375,27.234042372788576,6
2020-06-01-170113,170113,0,0,0,44,0.125,65.4927088506387,0
2020-06-02-170113,170113,0,0,0,44,1.0,12.906270084935016,1
2020-06-03-170113,170113,0,0,0,44,0.75,21.10082480229694,2
2020-06-04-170113,170113,1,0,0,45,0.375,19.93644907175461,3
2020-06-05-170113,170113,1,0,0,46,0.125,18.872529661323192,4
2020-06-06-170113,170113,0,0,0,46,0.125,21.331651445055286,5
2020-06-07-170113,170113,0,0,0,46,0.125,21.992456592134737,6
2020-06-08-170113,170113,0,0,0,46,0.875,21.548374585590246,0
2020-06-09-170113,170113,1,0,0,47,0.25,18.001789433851357,1
2020-06-10-170113,170113,0,0,0,47,0.0,67.66393111615864,2
2020-06-11-170113,170113,0,1,1,47,0.375,55.262730706927684,3
2020-06-12-170113,170113,0,0,0,47,0.375,45.66750800756541,4
2020-06-13-170113,170113,0,0,0,47,0.0,34.475150770302804,5
2020-06-14-170113,170113,0,1,0,47,0.125,24.37921777002859,6
2020-06-15-170113,170113,0,0,1,47,0.25,9.447799136203017,0
2020-06-16-170113,170113,0,0,0,47,0.375,9.526050992047544,1
2020-06-17-170113,170113,0,1,1,47,0.625,10.715589137504761,2
2020-06-18-170113,170113,0,0,0,47,0.25,12.306135718172689,3
2020-06-19-170113,170113,0,0,0,47,0.125,14.035757434168527,4
2020-06-20-170113,170113,0,0,0,47,0.25,21.321507362086557,5
2020-06-21-170113,170113,0,0,0,47,0.0,22.641230637932225,6
2020-06-22-170113,170113,0,0,0,47,0.375,20.894202647711673,0
2020-06-23-170113,170113,0,0,2,47,0.5,20.61292541382317,1
2020-06-24-170113,170113,0,0,0,47,0.5,20.132549442474467,2
2020-06-25-170113,170113,1,2,0,48,0.125,21.13797786140176,3
2020-06-26-170113,170113,0,0,0,48,0.375,24.64236705054188,4
2020-06-27-170113,170113,0,0,0,48,0.0,20.082117982175056,5
2020-06-28-170113,170113,0,0,0,48,0.125,19.155146265518987,6
2020-06-29-170113,170113,1,1,0,49,0.375,20.157756880320424,0
2020-06-30-170113,170113,0,0,2,49,0.125,25.9142460987523,1
2020-07-01-170113,170113,1,0,2,50,0.25,24.892354465565752,2
2020-07-02-170113,170113,0,0,0,50,0.375,23.09583204236513,3
2020-07-03-170113,170113,0,0,0,50,0.125,25.667786476840917,4
2020-07-04-170113,170113,0,0,0,50,0.0,20.720296632080363,5
2020-07-05-170113,170113,0,0,0,50,0.0,21.162932824729182,6
2020-07-06-170113,170113,0,0,0,50,0.25,15.925992610780598,0
2020-07-07-170113,170113,2,0,0,52,0.0,10.876742794746637,1
2020-07-08-170113,170113,0,0,0,52,0.125,15.02985901806591,2
2020-07-09-170113,170113,0,0,1,52,0.125,15.787242429118486,3
2020-07-10-170113,170113,0,0,0,52,0.5,24.60202075279087,4
2020-07-11-170113,170113,0,0,0,52,0.5,22.27460300761104,5
2020-07-12-170113,170113,0,0,0,52,0.125,19.075213195833655,6
2020-07-13-170113,170113,0,0,1,52,0.5,20.410558647405843,0
2020-07-14-170113,170113,2,0,0,54,0.375,22.87550750011497,1
2020-07-15-170113,170113,2,0,0,56,0.125,24.85965825082772,2
2020-07-16-170113,170113,0,0,0,56,0.125,25.949455189223706,3
2020-07-17-170113,170113,0,0,0,56,0.625,25.447710723131514,4
2020-07-18-170113,170113,0,0,0,56,0.25,27.951186194501304,5
2020-07-19-170113,170113,0,0,0,56,0.0,26.761992775689983,6
2020-07-20-170113,170113,0,0,0,56,0.375,24.71059715652207,0
2020-07-21-170113,170113,0,0,0,56,0.0,18.64539104342643,1
2020-07-22-170113,170113,0,0,2,56,0.375,11.780952257256875,2
2020-07-23-170113,170113,1,0,1,57,0.375,13.174147354124099,3
2020-07-24-170113,170113,0,0,4,57,0.0,16.979356848305144,4
2020-07-25-170113,170113,0,0,0,57,0.0,15.890487411871177,5
2020-07-26-170113,170113,0,0,0,57,0.0,15.648844677848578,6
2020-07-27-170113,170113,1,0,0,58,0.375,13.323741415776126,0
2020-07-28-170113,170113,0,0,3,58,1.125,18.247718894465958,1
2020-07-29-170113,170113,0,0,1,58,0.5,27.783622964379312,2
2020-07-30-170113,170113,0,0,1,58,0.125,21.390044196579147,3
2020-07-31-170113,170113,0,0,2,58,0.25,21.831454794692835,4
2020-08-01-170113,170113,0,0,0,58,0.0,17.564984832236313,5
2020-08-02-170113,170113,0,0,0,58,0.25,75.69966506114133,6
2020-08-03-170113,170113,0,0,2,58,0.25,79.08693143574096,0
2020-08-04-170113,170113,0,0,0,58,0.5,76.07671843329553,1
2020-08-05-170113,170113,2,0,0,60,0.625,70.25563552292756,2
2020-08-06-170113,170113,1,0,0,61,2.375,72.0371980843709,3
2020-08-07-170113,170113,4,0,1,65,1.0,76.38287413025863,4
2020-08-08-170113,170113,0,0,0,65,1.375,88.83255594329191,5
2020-08-09-170113,170113,0,0,0,65,0.375,95.08748506887424,6
2020-08-10-170113,170113,0,0,1,65,0.875,17.062149211347737,0
2020-08-11-170113,170113,3,0,1,68,1.625,25.367263282033242,1
2020-08-12-170113,170113,1,0,1,69,1.125,54.99109710861859,2
2020-08-13-170113,170113,1,0,0,70,1.25,74.33289695102627,3
2020-08-14-170113,170113,2,0,0,72,1.25,87.07758565934697,4
2020-08-15-170113,170113,0,0,3,72,1.25,108.81964994663747,5
2020-08-16-170113,170113,0,0,3,72,0.375,115.61696372480048,6
2020-08-17-170113,170113,2,0,0,74,1.25,117.99980595761446,0
2020-08-18-170113,170113,0,0,0,74,0.5,126.88273877462565,1
2020-08-19-170113,170113,0,0,0,74,2.0,99.6304737640087,2
2020-08-20-170113,170113,0,0,2,74,7.125,70.15734825542499,3
2020-08-21-170113,170113,1,0,0,75,1.375,60.88248394230108,4
2020-08-22-170113,170113,0,0,0,75,4.5,69.3390526291578,5
2020-08-23-170113,170113,0,0,0,75,1.125,72.90144064863537,6
2020-08-24-170113,170113,1,0,2,76,1.125,58.92350145045543,0
2020-08-25-170113,170113,1,0,0,77,1.5,66.67391446000201,1
2020-08-26-170113,170113,1,0,5,78,1.75,68.31248221285637,2
2020-08-27-170113,170113,0,0,1,78,1.125,75.83697718063453,3
2020-08-28-170113,170113,0,0,3,78,1.0,74.89909720953892,4
2020-08-29-170113,170113,3,0,0,81,2.0,74.73722262174086,5
2020-08-30-170113,170113,3,0,1,84,0.875,77.64706286681218,6
2020-08-31-170113,170113,0,0,1,84,1.125,81.43303265689879,0
2020-09-01-170113,170113,0,0,1,84,0.5,71.07088763547834,1
2020-09-02-170113,170113,0,0,4,84,0.5,109.90591367947155,2
2020-09-03-170113,170113,2,0,0,86,3.25,104.52986351018129,3
2020-09-04-170113,170113,0,0,5,86,3.25,103.63943507720595,4
2020-09-05-170113,170113,0,0,0,86,0.625,105.00760289014653,5
2020-09-06-170113,170113,0,0,1,86,0.75,100.27888920614049,6
2020-09-07-170113,170113,2,0,0,88,0.75,99.70987725456031,0
2020-09-08-170113,170113,0,0,1,88,1.625,95.02473792801081,1
2020-09-09-170113,170113,5,0,2,93,1.625,95.05154288826515,2
2020-09-10-170113,170113,1,0,0,94,0.875,57.34217442361284,3
2020-09-11-170113,170113,3,0,1,97,1.875,62.42803616850776,4
2020-09-12-170113,170113,0,0,0,97,3.125,71.0304595892101,5
2020-09-13-170113,170113,1,0,0,98,0.625,59.18106446197148,6
2020-09-14-170113,170113,1,0,0,99,1.625,49.012317162604646,0
2020-09-15-170113,170113,1,0,0,100,2.0,59.537056120434954,1
2020-09-16-170113,170113,4,0,1,104,1.5,67.48094365392498,2
2020-09-17-170113,170113,0,0,2,104,0.875,83.30658075786295,3
2020-09-18-170113,170113,5,0,1,109,3.25,87.91988231026724,4
2020-09-19-170113,170113,0,0,1,109,1.0,89.99755986494381,5
2020-09-20-170113,170113,1,0,0,110,0.125,81.49155415656534,6
2020-09-21-170113,170113,0,0,0,110,0.5,76.39299249772142,0
2020-09-22-170113,170113,1,0,0,111,1.625,76.24834930350013,1
2020-09-23-170113,170113,2,1,0,113,2.125,70.30697227503745,2
2020-09-24-170113,170113,0,0,0,113,1.5,69.49920071686844,3
2020-09-25-170113,170113,1,0,0,114,2.375,65.26905188006239,4
2020-09-26-170113,170113,0,0,0,114,1.125,79.13385071089391,5
2020-09-27-170113,170113,0,0,0,114,0.125,87.45204581572597,6
2020-09-28-170113,170113,0,0,0,114,1.5,82.36724891767534,0
2020-09-29-170113,170113,0,0,0,114,1.125,87.934419307536,1
2020-09-30-170113,170113,1,0,0,115,2.0,88.9276945598904,2
2020-10-01-170113,170113,2,0,0,117,0.75,0.0,3
2020-10-02-170113,170113,1,0,0,118,1.25,85.37673912304598,4
2020-10-03-170113,170113,1,0,1,119,0.75,130.99617048264577,5
2020-10-04-170113,170113,0,0,0,119,0.875,124.33904254002697,6
2020-10-05-170113,170113,0,0,1,119,1.875,115.22648699126984,0
2020-10-06-170113,170113,0,0,0,119,0.75,107.51837747351146,1
2020-10-07-170113,170113,0,1,0,119,1.625,96.61387827614763,2
2020-10-08-170113,170113,0,0,0,119,2.0,91.01905195009019,3
2020-10-09-170113,170113,0,1,0,119,2.125,96.50976860964099,4
2020-10-10-170113,170113,0,0,0,119,2.25,13.453686435195916,5
2020-10-11-170113,170113,0,0,1,119,1.375,28.71091069161521,6
2020-10-12-170113,170113,0,0,0,119,1.75,41.54192545724236,0
2020-10-13-170113,170113,0,0,0,119,1.75,48.15788905642627,1
2020-10-14-170113,170113,0,0,0,119,1.75,68.0596091095931,2
2020-10-15-170113,170113,0,0,0,119,0.5,82.96735859021526,3
2020-10-16-170113,170113,0,0,1,119,0.875,85.66602825328235,4
2020-10-17-170113,170113,1,0,0,120,0.25,79.89588188035614,5
2020-10-18-170113,170113,0,0,1,120,1.375,67.87003694641851,6
2020-10-19-170113,170113,1,0,1,121,1.5,64.95042112475846,0
2020-10-20-170113,170113,0,0,1,121,0.5,70.75440144447948,1
2020-10-21-170113,170113,0,1,0,121,1.5,62.65224053504109,2
2020-10-22-170113,170113,0,0,3,121,2.0,77.72243396626058,3
2020-10-23-170113,170113,0,0,0,121,2.5,83.53756963674664,4
2020-10-24-170113,170113,0,0,0,121,0.625,97.17542384282163,5
2020-10-25-170113,170113,1,0,3,122,1.25,96.9084030699074,6
2020-10-26-170113,170113,0,0,0,122,2.25,95.85418729332788,0
2020-10-27-170113,170113,0,0,1,122,2.25,105.501473485864,1
2020-10-28-170113,170113,0,0,1,122,1.875,118.57811405682241,2
2020-10-29-170113,170113,0,0,1,122,3.25,119.0263745738367,3
2020-10-30-170113,170113,1,0,1,123,3.875,112.38484621551392,4
2020-10-31-170113,170113,0,0,0,123,1.75,129.51154589441572,5
2020-11-01-170113,170113,1,0,0,124,2.0,88.9135670080037,6
2020-11-02-170113,170113,1,0,0,125,0.625,56.028524028247396,0
2020-11-03-170113,170113,1,0,0,126,2.5,47.02094478940418,1
2020-11-04-170113,170113,0,0,0,126,2.5,61.687545940916024,2
2020-11-05-170113,170113,3,0,0,129,3.0,71.40742999881192,3
2020-11-06-170113,170113,0,0,0,129,3.625,89.8238840183248,4
2020-11-07-170113,170113,0,0,0,129,1.5,100.9656048233498,5
2020-11-08-170113,170113,3,0,0,132,1.375,105.39233612940926,6
2020-11-09-170113,170113,0,0,0,132,0.5,112.42745815777626,0
2020-11-10-170113,170113,1,0,0,133,0.625,93.95808514966478,1
2020-11-11-170113,170113,1,0,0,134,2.0,93.16611612662345,2
2020-11-12-170113,170113,1,0,0,135,2.125,96.28298600056573,3
2020-11-13-170113,170113,1,0,0,136,2.875,107.75908421323248,4
2020-03-01-170114,170114,0,0,2,0,0.0,0.0,6
2020-03-02-170114,170114,0,0,3,0,0.0,12.503142459242458,0
2020-03-03-170114,170114,0,0,8,0,0.0,34.46089140732726,1
2020-03-04-170114,170114,1,0,4,1,0.0,39.52073358871502,2
2020-03-05-170114,170114,0,1,8,1,0.0,43.46366973924723,3
2020-03-06-170114,170114,0,0,7,1,0.0,40.96486383861883,4
2020-03-07-170114,170114,0,0,3,1,0.0,42.65237689053923,5
2020-03-08-170114,170114,0,0,1,1,0.0,39.11008255839832,6
2020-03-09-170114,170114,0,0,3,1,0.25,38.91771841249975,0
2020-03-10-170114,170114,3,0,3,4,0.0,49.876916923967585,1
2020-03-11-170114,170114,0,0,3,4,0.5,44.258586646160786,2
2020-03-12-170114,170114,0,0,3,4,0.75,31.90758292838889,3
2020-03-13-170114,170114,2,0,2,6,2.0,19.283130412974792,4
2020-03-14-170114,170114,5,0,2,11,1.75,18.796471952825254,5
2020-03-15-170114,170114,2,0,3,13,1.75,22.835419816550996,6
2020-03-16-170114,170114,3,0,4,16,5.25,22.840526947851806,0
2020-03-17-170114,170114,8,1,3,24,4.75,33.591579533450044,1
2020-03-18-170114,170114,4,0,6,28,12.75,42.57516258074467,2
2020-03-19-170114,170114,8,0,4,36,9.0,55.56831268763115,3
2020-03-20-170114,170114,7,0,1,43,11.5,70.63515305219669,4
2020-03-21-170114,170114,3,7,1,46,5.75,76.0638314040944,5
2020-03-22-170114,170114,1,1,1,47,6.5,75.47293596876227,6
2020-03-23-170114,170114,3,0,2,50,17.0,67.99684177392255,0
2020-03-24-170114,170114,3,0,2,53,13.5,66.7378177007713,1
2020-03-25-170114,170114,3,0,1,56,11.5,65.41930822950368,2
2020-03-26-170114,170114,3,0,0,59,11.5,58.4590096661245,3
2020-03-27-170114,170114,2,0,0,61,13.25,67.315417996192,4
2020-03-28-170114,170114,2,0,2,63,7.0,58.31523899846931,5
2020-03-29-170114,170114,3,0,0,66,3.25,56.383664790193556,6
2020-03-30-170114,170114,4,0,1,70,11.0,45.2850866677921,0
2020-03-31-170114,170114,3,0,3,73,9.75,46.46316554434742,1
2020-04-01-170114,170114,6,0,1,79,8.0,11.015899239636102,2
2020-04-02-170114,170114,4,0,0,83,7.25,32.430575159453255,3
2020-04-03-170114,170114,1,0,1,84,6.0,18.613027818644824,4
2020-04-04-170114,170114,1,0,0,85,1.5,18.432659519536337,5
2020-04-05-170114,170114,1,0,0,86,3.0,17.47000168318423,6
2020-04-06-170114,170114,2,0,0,88,8.5,19.670657456287465,0
2020-04-07-170114,170114,2,0,0,90,6.25,23.60355298145736,1
2020-04-08-170114,170114,1,0,1,91,5.75,27.12049798880498,2
2020-04-09-170114,170114,0,0,2,91,5.75,29.775906133776942,3
2020-04-10-170114,170114,0,0,2,91,4.5,13.784035987488874,4
2020-04-11-170114,170114,2,0,1,93,3.0,18.039812671931543,5
2020-04-12-170114,170114,0,0,0,93,2.75,21.48873297775864,6
2020-04-13-170114,170114,1,1,0,94,4.75,24.662729324773125,0
2020-04-14-170114,170114,3,0,1,97,9.5,33.129340641256285,1
2020-04-15-170114,170114,1,0,0,98,4.5,47.25223890780141,2
2020-04-16-170114,170114,0,0,0,98,5.0,51.87599498122383,3
2020-04-17-170114,170114,1,0,0,99,2.25,41.25754288619724,4
2020-04-18-170114,170114,0,0,1,99,0.5,41.802020356826795,5
2020-04-19-170114,170114,0,0,0,99,2.0,37.68730222276107,6
2020-04-20-170114,170114,0,0,0,99,5.25,40.648086898985696,0
2020-04-21-170114,170114,0,0,0,99,4.25,36.84943940316732,1
2020-04-22-170114,170114,1,0,0,100,3.0,36.0797427000118,2
2020-04-23-170114,170114,2,0,0,102,1.75,36.60274378309625,3
2020-04-24-170114,170114,2,0,0,104,4.0,32.81507145577394,4
2020-04-25-170114,170114,1,0,0,105,0.75,38.006527751491866,5
2020-04-26-170114,170114,0,0,0,105,2.0,41.01079892877361,6
2020-04-27-170114,170114,0,0,0,105,2.5,27.93912437778386,0
2020-04-28-170114,170114,1,0,1,106,2.25,26.093343785673426,1
2020-04-29-170114,170114,0,0,1,106,2.5,24.240517135239006,2
2020-04-30-170114,170114,0,0,0,106,1.75,25.94474181248459,3
2020-05-01-170114,170114,0,0,1,106,0.5,33.422554424146085,4
2020-05-02-170114,170114,1,0,0,107,2.25,15.82291416075774,5
2020-05-03-170114,170114,0,0,0,107,0.75,8.454140228335275,6
2020-05-04-170114,170114,0,0,3,107,2.5,8.842747954075815,0
2020-05-05-170114,170114,0,0,0,107,2.5,10.037312012084882,1
2020-05-06-170114,170114,0,0,0,107,4.5,9.690029286699833,2
2020-05-07-170114,170114,0,0,0,107,2.75,9.429443870635218,3
2020-05-08-170114,170114,0,1,1,107,5.0,10.313559950126258,4
2020-05-09-170114,170114,0,0,0,107,0.75,14.617426756013568,5
2020-05-10-170114,170114,0,0,0,107,0.75,38.81928406691512,6
2020-05-11-170114,170114,0,0,0,107,6.0,37.02683066764861,0
2020-05-12-170114,170114,1,0,0,108,4.25,39.30773954333358,1
2020-05-13-170114,170114,1,0,1,109,2.5,31.319046149252443,2
2020-05-14-170114,170114,0,0,0,109,3.0,24.695385036606837,3
2020-05-15-170114,170114,1,0,1,110,3.25,20.352063086910412,4
2020-05-16-170114,170114,0,0,0,110,1.0,18.681189620179264,5
2020-05-17-170114,170114,0,0,0,110,0.75,18.84479646839586,6
2020-05-18-170114,170114,3,0,2,113,8.25,17.77941978110236,0
2020-05-19-170114,170114,0,0,0,113,1.5,20.98346020503884,1
2020-05-20-170114,170114,0,0,2,113,2.0,18.321592642827696,2
2020-05-21-170114,170114,0,0,2,113,2.0,17.13279321332063,3
2020-05-22-170114,170114,1,0,1,114,3.0,15.873506383093684,4
2020-05-23-170114,170114,0,0,0,114,1.5,20.19763304012194,5
2020-05-24-170114,170114,0,0,1,114,1.0,20.190049779112798,6
2020-05-25-170114,170114,0,0,0,114,2.0,12.714243932154236,0
2020-05-26-170114,170114,0,0,1,114,1.75,12.31157860753166,1
2020-05-27-170114,170114,1,0,0,115,2.75,11.68108166007957,2
2020-05-28-170114,170114,0,3,0,115,1.5,14.026291171200084,3
2020-05-29-170114,170114,1,2,1,116,2.25,14.937128805330934,4
2020-05-30-170114,170114,0,0,1,116,0.5,13.996356790870536,5
2020-05-31-170114,170114,0,0,0,116,0.25,14.137458571682378,6
2020-06-01-170114,170114,2,0,0,118,1.5,20.409947056351342,0
2020-06-02-170114,170114,0,0,0,118,2.5,6.619415395177865,1
2020-06-03-170114,170114,2,0,0,120,1.25,7.039886719286269,2
2020-06-04-170114,170114,2,0,0,122,1.0,9.289297323670063,3
2020-06-05-170114,170114,1,0,0,123,0.75,16.090073539420676,4
2020-06-06-170114,170114,0,0,0,123,1.25,18.865842379842164,5
2020-06-07-170114,170114,1,0,0,124,0.0,19.440046841424106,6
2020-06-08-170114,170114,0,0,1,124,1.0,21.63237725733408,0
2020-06-09-170114,170114,1,0,1,125,0.75,22.511309195009908,1
2020-06-10-170114,170114,0,0,0,125,0.5,25.365537600983576,2
2020-06-11-170114,170114,0,0,0,125,0.0,21.294024698621705,3
2020-06-12-170114,170114,1,0,0,126,2.25,18.441815973391513,4
2020-06-13-170114,170114,1,0,0,127,0.5,18.648045694281016,5
2020-06-14-170114,170114,0,1,0,127,0.75,17.59875638513236,6
2020-06-15-170114,170114,0,0,1,127,1.0,11.978947388216271,0
2020-06-16-170114,170114,0,0,0,127,1.0,12.005020289003149,1
2020-06-17-170114,170114,0,0,0,127,1.5,10.740683319588758,2
2020-06-18-170114,170114,0,0,0,127,0.0,10.67486472275014,3
2020-06-19-170114,170114,0,0,0,127,1.0,10.54523912912183,4
2020-06-20-170114,170114,0,0,0,127,0.25,8.802321715582675,5
2020-06-21-170114,170114,0,0,0,127,0.0,8.637603738404191,6
2020-06-22-170114,170114,1,0,0,128,0.5,8.136232344083782,0
2020-06-23-170114,170114,1,0,0,129,0.5,9.041256603738873,1
2020-06-24-170114,170114,0,0,1,129,0.25,10.554157278288153,2
2020-06-25-170114,170114,0,0,3,129,0.25,10.807439251462444,3
2020-06-26-170114,170114,0,0,5,129,0.5,11.846888603590127,4
2020-06-27-170114,170114,0,0,0,129,0.0,9.220486584274562,5
2020-06-28-170114,170114,0,0,0,129,0.5,10.140274567169364,6
2020-06-29-170114,170114,1,0,1,130,0.25,10.709304675856263,0
2020-06-30-170114,170114,0,0,0,130,1.0,13.75659966165535,1
2020-07-01-170114,170114,0,0,1,130,0.75,22.19094436324489,2
2020-07-02-170114,170114,0,0,0,130,0.5,10.686324293034687,3
2020-07-03-170114,170114,0,0,0,130,0.5,3.454570527982363,4
2020-07-04-170114,170114,0,1,0,130,0.25,5.13369383645373,5
2020-07-05-170114,170114,0,0,0,130,0.0,4.992024050704586,6
2020-07-06-170114,170114,0,0,1,130,0.5,4.11172963569139,0
2020-07-07-170114,170114,0,0,1,130,0.0,4.238167491377939,1
2020-07-08-170114,170114,1,0,2,131,0.25,4.383973134102591,2
2020-07-09-170114,170114,3,0,0,134,0.25,5.666971279842182,3
2020-07-10-170114,170114,5,0,0,139,0.75,18.65459467893675,4
2020-07-11-170114,170114,0,0,0,139,0.25,24.43437817745601,5
2020-07-12-170114,170114,0,0,0,139,0.0,22.417010772914026,6
2020-07-13-170114,170114,1,0,0,140,0.25,22.310406873354374,0
2020-07-14-170114,170114,0,0,0,140,0.25,24.944675448868693,1
2020-07-15-170114,170114,1,0,0,141,0.0,20.951052783802293,2
2020-07-16-170114,170114,0,0,0,141,0.0,19.940594652163718,3
2020-07-17-170114,170114,0,0,1,141,0.0,19.246300435509575,4
2020-07-18-170114,170114,0,0,0,141,0.5,8.903620937207885,5
2020-07-19-170114,170114,0,0,1,141,0.25,8.839492722940655,6
2020-07-20-170114,170114,1,0,0,142,1.0,5.493859279294379,0
2020-07-21-170114,170114,1,0,0,143,0.25,7.591745653677527,1
2020-07-22-170114,170114,2,0,0,145,0.5,7.283059984930329,2
2020-07-23-170114,170114,0,0,0,145,0.0,12.080905097474457,3
2020-07-24-170114,170114,0,0,0,145,0.5,10.84424413285546,4
2020-07-25-170114,170114,0,0,5,145,0.25,11.18109118636347,5
2020-07-26-170114,170114,0,0,0,145,0.0,11.660530882970129,6
2020-07-27-170114,170114,0,0,0,145,0.0,11.11621173451855,0
2020-07-28-170114,170114,0,0,1,145,0.0,9.32836937584081,1
2020-07-29-170114,170114,0,0,0,145,0.5,7.639550043054575,2
2020-07-30-170114,170114,0,0,0,145,0.75,3.521713532267587,3
2020-07-31-170114,170114,1,1,0,146,1.5,4.176685097364681,4
2020-08-01-170114,170114,0,0,0,146,0.0,11.919527723435076,5
2020-08-02-170114,170114,1,0,0,147,0.25,20.551325691661887,6
2020-08-03-170114,170114,0,0,0,147,0.5,43.487122201885015,0
2020-08-04-170114,170114,0,0,0,147,0.25,57.585314542320305,1
2020-08-05-170114,170114,0,0,1,147,0.75,51.1470611016005,2
2020-08-06-170114,170114,0,0,1,147,0.5,45.79625311446485,3
2020-08-07-170114,170114,0,0,1,147,0.75,41.344231901291515,4
2020-08-08-170114,170114,5,0,0,152,0.25,38.25004738952468,5
2020-08-09-170114,170114,0,1,0,152,1.25,47.844437752092574,6
2020-08-10-170114,170114,0,0,2,152,1.0,11.561275597642494,0
2020-08-11-170114,170114,1,0,1,153,0.75,13.664149459729664,1
2020-08-12-170114,170114,0,0,2,153,1.75,18.018127476878476,2
2020-08-13-170114,170114,0,0,2,153,1.25,20.330613811539827,3
2020-08-14-170114,170114,0,0,1,153,1.0,26.413341618891646,4
2020-08-15-170114,170114,0,0,0,153,1.25,25.90848540751431,5
2020-08-16-170114,170114,0,0,3,153,0.75,19.889618097519843,6
2020-08-17-170114,170114,0,0,8,153,0.5,20.633484052006608,0
2020-08-18-170114,170114,0,0,1,153,1.25,20.29713865188517,1
2020-08-19-170114,170114,1,0,3,154,1.75,17.687078347020066,2
2020-08-20-170114,170114,1,0,1,155,1.75,17.157163165036387,3
2020-08-21-170114,170114,1,0,1,156,0.25,19.439573844558513,4
2020-08-22-170114,170114,0,0,1,156,1.5,21.621540887563164,5
2020-08-23-170114,170114,0,0,4,156,1.25,22.869751132293274,6
2020-08-24-170114,170114,2,0,7,158,1.5,24.135673791153003,0
2020-08-25-170114,170114,1,0,3,159,2.0,32.51860264087849,1
2020-08-26-170114,170114,2,0,1,161,1.5,31.02212018272785,2
2020-08-27-170114,170114,2,0,0,163,2.5,35.73434009127428,3
2020-08-28-170114,170114,1,0,8,164,1.25,37.60989590401439,4
2020-08-29-170114,170114,0,0,0,164,0.5,38.98634584008274,5
2020-08-30-170114,170114,3,0,1,167,0.75,38.30250906039017,6
2020-08-31-170114,170114,8,0,10,175,0.75,37.07756775460817,0
2020-09-01-170114,170114,1,0,3,176,2.0,34.08749991432466,1
2020-09-02-170114,170114,3,0,6,179,3.0,90.27190632961452,2
2020-09-03-170114,170114,1,0,2,180,3.5,46.12804696693702,3
2020-09-04-170114,170114,1,0,9,181,2.5,41.730071158684694,4
2020-09-05-170114,170114,1,0,2,182,1.25,38.62703786738362,5
2020-09-06-170114,170114,4,0,0,186,1.25,40.83089512492066,6
2020-09-07-170114,170114,7,0,4,193,3.25,48.690067817454995,0
2020-09-08-170114,170114,3,0,9,196,3.25,55.370155684001894,1
2020-09-09-170114,170114,1,0,2,197,0.75,64.14266634760817,2
2020-09-10-170114,170114,0,0,0,197,2.0,16.069182910700587,3
2020-09-11-170114,170114,8,0,3,205,2.75,22.20686687632614,4
2020-09-12-170114,170114,0,0,0,205,1.25,35.803377081886396,5
2020-09-13-170114,170114,1,0,0,206,1.5,36.48547603122479,6
2020-09-14-170114,170114,10,0,3,216,3.5,38.4680896499586,0
2020-09-15-170114,170114,3,0,0,219,1.25,55.07393478862294,1
2020-09-16-170114,170114,6,0,2,225,1.5,61.91799037996834,2
2020-09-17-170114,170114,2,0,3,227,2.25,71.8049964732015,3
2020-09-18-170114,170114,9,0,0,236,4.0,75.37020270460438,4
2020-09-19-170114,170114,2,0,1,238,1.0,86.78783249673921,5
2020-09-20-170114,170114,0,0,0,238,2.25,94.12732019301431,6
2020-09-21-170114,170114,4,0,0,242,1.75,68.83088191078653,0
2020-09-22-170114,170114,9,0,2,251,1.0,68.78543091479534,1
2020-09-23-170114,170114,2,1,1,253,4.0,72.95112033118798,2
2020-09-24-170114,170114,0,0,1,253,3.5,73.07079902057683,3
2020-09-25-170114,170114,3,0,1,256,2.75,62.36744199547903,4
2020-09-26-170114,170114,0,0,0,256,2.5,60.38559901418445,5
2020-09-27-170114,170114,0,0,0,256,1.0,55.13522344650539,6
2020-09-28-170114,170114,3,0,1,259,4.0,53.67639033801838,0
2020-09-29-170114,170114,0,0,0,259,1.25,55.326909734651124,1
2020-09-30-170114,170114,2,0,1,261,4.0,37.75114666356174,2
2020-10-01-170114,170114,3,0,0,264,2.0,0.0,3
2020-10-02-170114,170114,0,0,0,264,4.75,28.49831699212448,4
2020-10-03-170114,170114,1,0,0,265,2.5,62.893395441614636,5
2020-10-04-170114,170114,0,1,0,265,0.75,65.81470547627177,6
2020-10-05-170114,170114,0,0,0,265,1.5,61.480671381428905,0
2020-10-06-170114,170114,2,0,0,267,2.0,55.16247353317064,1
2020-10-07-170114,170114,1,0,1,268,2.25,51.65058025571931,2
2020-10-08-170114,170114,1,0,3,269,1.0,37.58297691433979,3
2020-10-09-170114,170114,1,0,0,270,5.5,38.69511416574585,4
2020-10-10-170114,170114,0,0,1,270,1.5,8.199314828936412,5
2020-10-11-170114,170114,0,0,1,270,1.5,10.554770514580664,6
2020-10-12-170114,170114,1,0,0,271,1.0,12.815299841614596,0
2020-10-13-170114,170114,0,0,3,271,3.75,14.716216493076466,1
2020-10-14-170114,170114,1,0,2,272,4.75,19.687604374383348,2
2020-10-15-170114,170114,0,0,5,272,0.25,26.997375143730352,3
2020-10-16-170114,170114,0,0,1,272,3.0,27.866867444839237,4
2020-10-17-170114,170114,0,0,2,272,1.5,23.66325390719186,5
2020-10-18-170114,170114,0,1,0,272,4.25,23.47988536712097,6
2020-10-19-170114,170114,0,0,2,272,7.0,23.719381163646176,0
2020-10-20-170114,170114,0,0,0,272,2.25,29.622178037959415,1
2020-10-21-170114,170114,1,0,1,273,2.75,23.805614072971068,2
2020-10-22-170114,170114,3,0,0,276,5.0,30.10713733322965,3
2020-10-23-170114,170114,0,0,2,276,8.5,41.19346926766035,4
2020-10-24-170114,170114,1,0,0,277,2.5,45.31693920409444,5
2020-10-25-170114,170114,1,0,0,278,5.0,48.65772016493976,6
2020-10-26-170114,170114,0,1,0,278,7.0,51.03288591176219,0
2020-10-27-170114,170114,3,0,2,281,3.25,54.48123866321989,1
2020-10-28-170114,170114,2,0,0,283,3.0,64.46605996461037,2
2020-10-29-170114,170114,5,0,0,288,9.5,67.25791785610909,3
2020-10-30-170114,170114,1,0,3,289,7.75,71.47116503906935,4
2020-10-31-170114,170114,2,0,0,291,4.0,80.1297087109174,5
2020-11-01-170114,170114,0,0,0,291,3.0,42.028900320964155,6
2020-11-02-170114,170114,2,0,0,293,2.25,33.60113171838095,0
2020-11-03-170114,170114,0,0,0,293,5.75,27.16937645858938,1
2020-11-04-170114,170114,1,0,0,294,6.5,34.27012144647428,2
2020-11-05-170114,170114,0,0,0,294,7.5,41.94940866155141,3
2020-11-06-170114,170114,2,1,0,296,6.75,49.411798243267235,4
2020-11-07-170114,170114,0,0,0,296,2.5,61.07912691655882,5
2020-11-08-170114,170114,0,0,0,296,3.0,63.776186014143335,6
2020-11-09-170114,170114,0,0,0,296,3.25,60.91653355722048,0
2020-11-10-170114,170114,2,0,0,298,3.0,39.978443508312466,1
2020-11-11-170114,170114,0,0,0,298,4.0,46.13104721347939,2
2020-11-12-170114,170114,0,0,0,298,7.75,47.88850882913944,3
2020-11-13-170114,170114,3,0,0,301,4.25,50.49055083748594,4
2020-03-01-170115,170115,0,0,0,0,0.4,0.0,6
2020-03-02-170115,170115,0,0,0,0,0.0,7.820955371024581,0
2020-03-03-170115,170115,0,0,1,0,0.0,60.04694463380187,1
2020-03-04-170115,170115,0,0,0,0,0.0,68.46260842149624,2
2020-03-05-170115,170115,0,2,1,0,0.2,74.66113132689524,3
2020-03-06-170115,170115,0,0,1,0,0.0,70.9084635974615,4
2020-03-07-170115,170115,0,0,0,0,0.0,64.10280459761259,5
2020-03-08-170115,170115,0,0,0,0,0.0,52.00405938597708,6
2020-03-09-170115,170115,0,0,3,0,0.0,52.13203366773337,0
2020-03-10-170115,170115,0,0,3,0,0.2,99.96603097406145,1
2020-03-11-170115,170115,0,0,1,0,0.0,82.05998114509093,2
2020-03-12-170115,170115,0,0,3,0,0.2,54.41636688380109,3
2020-03-13-170115,170115,0,0,3,0,0.4,34.97675702552596,4
2020-03-14-170115,170115,0,0,1,0,0.4,27.94940667166655,5
2020-03-15-170115,170115,0,0,1,0,0.4,20.279514418064526,6
2020-03-16-170115,170115,0,0,2,0,2.8,11.818071022070553,0
2020-03-17-170115,170115,1,0,0,1,1.8,19.60754667231756,1
2020-03-18-170115,170115,0,0,3,1,1.4,26.72899960998867,2
2020-03-19-170115,170115,1,2,0,2,4.2,33.78436282002106,3
2020-03-20-170115,170115,1,4,0,3,1.8,44.728982824317065,4
2020-03-21-170115,170115,0,0,2,3,2.0,50.2730876563537,5
2020-03-22-170115,170115,0,0,0,3,2.0,51.77884147486152,6
2020-03-23-170115,170115,3,0,2,6,6.6,50.50139937092685,0
2020-03-24-170115,170115,3,0,0,9,4.2,67.16974502612915,1
2020-03-25-170115,170115,1,0,1,10,6.2,81.1240607566796,2
2020-03-26-170115,170115,3,0,0,13,5.6,90.97757241513904,3
2020-03-27-170115,170115,3,0,0,16,4.4,109.858574936807,4
2020-03-28-170115,170115,1,0,0,17,4.8,121.0929662273324,5
2020-03-29-170115,170115,1,0,0,18,3.6,134.50197746205487,6
2020-03-30-170115,170115,2,0,0,20,6.4,119.62416122573234,0
2020-03-31-170115,170115,0,0,0,20,4.6,116.91449739380089,1
2020-04-01-170115,170115,3,0,0,23,3.4,15.04729398535164,2
2020-04-02-170115,170115,0,0,0,23,4.2,76.05116864381436,3
2020-04-03-170115,170115,0,0,0,23,3.6,31.14928839811365,4
2020-04-04-170115,170115,2,0,0,25,2.0,35.7582686443333,5
2020-04-05-170115,170115,0,0,1,25,0.8,42.390434768980555,6
2020-04-06-170115,170115,2,0,0,27,4.0,42.68484210616398,0
2020-04-07-170115,170115,0,2,0,27,2.2,57.9764055102345,1
2020-04-08-170115,170115,1,0,0,28,2.8,60.86035957712281,2
2020-04-09-170115,170115,0,0,0,28,1.6,58.55089228583621,3
2020-04-10-170115,170115,0,0,2,28,4.6,14.674513355873788,4
2020-04-11-170115,170115,0,0,0,28,2.4,40.65920531763152,5
2020-04-12-170115,170115,0,0,0,28,2.0,43.39816157048426,6
2020-04-13-170115,170115,0,0,1,28,3.4,50.99922127798405,0
2020-04-14-170115,170115,0,0,1,28,3.6,57.4239954307285,1
2020-04-15-170115,170115,0,0,1,28,5.6,67.03611091443608,2
2020-04-16-170115,170115,0,0,0,28,2.6,100.22111351166154,3
2020-04-17-170115,170115,0,0,0,28,2.6,98.8164294391402,4
2020-04-18-170115,170115,0,0,1,28,1.6,80.27319079467246,5
2020-04-19-170115,170115,1,0,0,29,0.8,79.75360804775877,6
2020-04-20-170115,170115,0,0,0,29,3.0,85.03502403943497,0
2020-04-21-170115,170115,0,0,0,29,1.8,82.14316084068975,1
2020-04-22-170115,170115,0,0,1,29,3.2,52.53064542539034,2
2020-04-23-170115,170115,0,0,0,29,1.2,50.49719558759627,3
2020-04-24-170115,170115,2,0,0,31,2.6,44.699179150179944,4
2020-04-25-170115,170115,0,0,0,31,0.6,49.419088085989415,5
2020-04-26-170115,170115,0,0,0,31,0.6,48.091604916171335,6
2020-04-27-170115,170115,1,1,0,32,1.6,29.783580101809623,0
2020-04-28-170115,170115,1,0,0,33,1.2,29.334163240754222,1
2020-04-29-170115,170115,1,0,0,34,2.8,29.89609703827912,2
2020-04-30-170115,170115,0,0,0,34,1.4,38.497193903300555,3
2020-05-01-170115,170115,0,0,0,34,0.4,57.865685953303725,4
2020-05-02-170115,170115,1,0,0,35,0.6,22.124060325199785,5
2020-05-03-170115,170115,0,0,0,35,0.0,25.016169927685667,6
2020-05-04-170115,170115,0,0,1,35,1.2,18.157169845522635,0
2020-05-05-170115,170115,0,0,0,35,1.0,16.991547434413206,1
2020-05-06-170115,170115,1,0,0,36,1.2,12.317746756805553,2
2020-05-07-170115,170115,0,0,0,36,1.8,16.8648757455344,3
2020-05-08-170115,170115,0,0,1,36,1.8,21.8959027765683,4
2020-05-09-170115,170115,0,0,0,36,0.4,28.9550003189229,5
2020-05-10-170115,170115,0,1,0,36,0.4,61.988300220681,6
2020-05-11-170115,170115,0,0,1,36,1.4,53.19843412785831,0
2020-05-12-170115,170115,0,0,0,36,1.4,58.58140195718791,1
2020-05-13-170115,170115,0,0,2,36,0.8,38.758125375819255,2
2020-05-14-170115,170115,0,0,0,36,0.8,33.18445472923427,3
2020-05-15-170115,170115,0,0,0,36,1.0,28.56289321109181,4
2020-05-16-170115,170115,0,0,0,36,0.4,25.923339278724548,5
2020-05-17-170115,170115,0,0,0,36,0.0,26.252919781248465,6
2020-05-18-170115,170115,1,0,0,37,2.2,25.425460329220734,0
2020-05-19-170115,170115,0,0,1,37,0.8,29.97873298322289,1
2020-05-20-170115,170115,0,0,1,37,0.4,28.587829853807722,2
2020-05-21-170115,170115,0,0,0,37,0.8,28.0004076117052,3
2020-05-22-170115,170115,1,0,1,38,0.8,26.88139700421205,4
2020-05-23-170115,170115,0,0,0,38,0.4,31.413691707548157,5
2020-05-24-170115,170115,0,0,0,38,0.2,32.95506004143553,6
2020-05-25-170115,170115,1,0,0,39,1.6,19.467715963405823,0
2020-05-26-170115,170115,0,0,0,39,1.4,26.44343623279095,1
2020-05-27-170115,170115,2,0,0,41,1.6,30.512624410937196,2
2020-05-28-170115,170115,0,3,0,41,1.8,38.335185493028455,3
2020-05-29-170115,170115,0,0,1,41,0.4,39.9675000729929,4
2020-05-30-170115,170115,0,0,0,41,0.0,35.29026280861097,5
2020-05-31-170115,170115,0,0,0,41,0.0,35.28464337899548,6
2020-06-01-170115,170115,0,0,0,41,0.2,37.58477234815172,0
2020-06-02-170115,170115,1,0,0,42,1.4,14.734502388511595,1
2020-06-03-170115,170115,1,0,0,43,0.6,21.4361867470435,2
2020-06-04-170115,170115,0,0,1,43,0.6,14.396063504667861,3
2020-06-05-170115,170115,1,0,1,44,1.0,16.14853055541348,4
2020-06-06-170115,170115,0,2,0,44,0.2,18.475793681225234,5
2020-06-07-170115,170115,0,0,0,44,0.0,16.433132772323184,6
2020-06-08-170115,170115,0,0,1,44,0.8,12.89984624586748,0
2020-06-09-170115,170115,0,0,1,44,0.4,14.631521056125948,1
2020-06-10-170115,170115,0,0,0,44,1.0,36.11899170115777,2
2020-06-11-170115,170115,0,0,0,44,0.6,34.346849882458756,3
2020-06-12-170115,170115,1,0,0,45,0.2,33.27977970800836,4
2020-06-13-170115,170115,0,0,0,45,0.2,27.034179456645358,5
2020-06-14-170115,170115,0,0,0,45,0.0,20.464307378993926,6
2020-06-15-170115,170115,0,0,0,45,0.4,13.825005731878285,0
2020-06-16-170115,170115,0,0,0,45,0.8,14.54160120513926,1
2020-06-17-170115,170115,0,0,0,45,0.2,16.503199364981448,2
2020-06-18-170115,170115,1,1,0,46,0.6,13.228699059118512,3
2020-06-19-170115,170115,1,0,0,47,1.8,16.414138715680174,4
2020-06-20-170115,170115,0,0,0,47,0.2,26.496421888763805,5
2020-06-21-170115,170115,0,0,1,47,0.4,27.171855582452913,6
2020-06-22-170115,170115,1,0,0,48,0.0,26.877513180006304,0
2020-06-23-170115,170115,1,0,0,49,0.6,29.21563779858981,1
2020-06-24-170115,170115,0,0,0,49,0.8,38.866991555378654,2
2020-06-25-170115,170115,0,0,0,49,0.4,40.214601764762115,3
2020-06-26-170115,170115,0,0,0,49,0.6,34.89636860579501,4
2020-06-27-170115,170115,0,0,2,49,0.4,26.768338372959263,5
2020-06-28-170115,170115,0,0,0,49,0.6,30.29749204303182,6
2020-06-29-170115,170115,0,0,1,49,0.0,34.34247276287469,0
2020-06-30-170115,170115,0,0,0,49,0.2,25.022969540295627,1
2020-07-01-170115,170115,0,0,1,49,0.4,20.521346292223477,2
2020-07-02-170115,170115,0,0,0,49,0.2,23.21437686080354,3
2020-07-03-170115,170115,0,0,0,49,0.0,13.05658837065228,4
2020-07-04-170115,170115,0,0,0,49,0.2,11.928956458946704,5
2020-07-05-170115,170115,1,0,3,50,0.0,9.519184391619063,6
2020-07-06-170115,170115,0,0,1,50,0.2,12.148736036720774,0
2020-07-07-170115,170115,0,0,1,50,0.2,13.188095297274032,1
2020-07-08-170115,170115,0,0,0,50,0.4,12.3734828050234,2
2020-07-09-170115,170115,0,0,1,50,0.6,15.220218848251479,3
2020-07-10-170115,170115,0,0,0,50,0.0,20.927922444493937,4
2020-07-11-170115,170115,2,0,0,52,0.0,17.908492635119238,5
2020-07-12-170115,170115,0,0,1,52,0.0,18.99405816492307,6
2020-07-13-170115,170115,1,0,0,53,0.0,18.187844071241408,0
2020-07-14-170115,170115,0,0,0,53,0.2,22.169226121883355,1
2020-07-15-170115,170115,1,0,0,54,0.2,20.19177447170092,2
2020-07-16-170115,170115,0,0,0,54,0.8,18.64733133187194,3
2020-07-17-170115,170115,0,0,0,54,0.2,18.521813310523214,4
2020-07-18-170115,170115,0,0,0,54,0.0,18.949715683189567,5
2020-07-19-170115,170115,3,0,0,57,0.0,12.230675926961066,6
2020-07-20-170115,170115,1,0,0,58,0.2,18.831013792380098,0
2020-07-21-170115,170115,1,0,1,59,0.0,21.82102883682499,1
2020-07-22-170115,170115,0,0,0,59,0.0,22.00838012209276,2
2020-07-23-170115,170115,1,0,0,60,0.2,20.444600518217882,3
2020-07-24-170115,170115,0,0,0,60,0.4,23.488691447902667,4
2020-07-25-170115,170115,0,0,0,60,0.0,24.293940059870696,5
2020-07-26-170115,170115,1,0,0,61,0.0,14.698078454755423,6
2020-07-27-170115,170115,0,0,0,61,0.2,17.322183750843458,0
2020-07-28-170115,170115,0,0,1,61,0.0,14.194379251349886,1
2020-07-29-170115,170115,0,0,0,61,0.4,10.709934263712244,2
2020-07-30-170115,170115,0,0,0,61,0.8,7.744430482021062,3
2020-07-31-170115,170115,0,0,0,61,0.6,8.114926828565517,4
2020-08-01-170115,170115,0,1,0,61,0.2,13.611657983602178,5
2020-08-02-170115,170115,0,0,0,61,0.2,45.42290894569592,6
2020-08-03-170115,170115,0,0,0,61,0.6,134.2158843867506,0
2020-08-04-170115,170115,1,0,0,62,0.4,82.13552297721083,1
2020-08-05-170115,170115,0,0,0,62,0.4,75.83490857822092,2
2020-08-06-170115,170115,0,0,0,62,0.2,66.32763181698766,3
2020-08-07-170115,170115,0,0,0,62,0.8,49.03132942950654,4
2020-08-08-170115,170115,0,0,0,62,0.0,33.64574444102725,5
2020-08-09-170115,170115,0,0,0,62,0.0,28.87731198345202,6
2020-08-10-170115,170115,0,0,8,62,0.4,12.540264675762291,0
2020-08-11-170115,170115,1,0,7,63,0.8,17.883977023593424,1
2020-08-12-170115,170115,0,0,0,63,1.0,22.20404300830629,2
2020-08-13-170115,170115,0,0,0,63,1.4,25.987613331778462,3
2020-08-14-170115,170115,0,0,0,63,2.4,29.08273983134309,4
2020-08-15-170115,170115,0,0,0,63,1.8,31.63315060719269,5
2020-08-16-170115,170115,0,0,0,63,0.8,35.55880476509351,6
2020-08-17-170115,170115,0,0,0,63,1.2,36.2992778224142,0
2020-08-18-170115,170115,0,0,1,63,2.6,33.313820588883246,1
2020-08-19-170115,170115,0,0,4,63,4.0,33.533977555115385,2
2020-08-20-170115,170115,0,0,0,63,2.2,41.741155238188924,3
2020-08-21-170115,170115,0,0,1,63,5.0,39.862525561247466,4
2020-08-22-170115,170115,0,0,1,63,0.8,48.1046873674357,5
2020-08-23-170115,170115,0,0,0,63,1.6,49.94974152429654,6
2020-08-24-170115,170115,8,0,0,71,3.2,53.77854489094535,0
2020-08-25-170115,170115,7,0,1,78,4.0,75.93555473966103,1
2020-08-26-170115,170115,0,0,0,78,4.8,95.4908871521904,2
2020-08-27-170115,170115,0,0,0,78,3.6,105.0170615451247,3
2020-08-28-170115,170115,0,0,1,78,4.4,111.88466560860178,4
2020-08-29-170115,170115,0,0,0,78,2.6,114.17675914115692,5
2020-08-30-170115,170115,0,0,0,78,1.8,122.69473119823502,6
2020-08-31-170115,170115,0,0,1,78,3.4,94.83916203742814,0
2020-09-01-170115,170115,1,0,0,79,3.6,21.49937103035939,1
2020-09-02-170115,170115,4,0,0,83,2.2,89.84589141853296,2
2020-09-03-170115,170115,0,0,0,83,2.4,87.72924465332359,3
2020-09-04-170115,170115,1,0,2,84,3.0,57.84951291287594,4
2020-09-05-170115,170115,1,0,0,85,3.6,58.44330761419214,5
2020-09-06-170115,170115,0,0,0,85,2.4,55.23993680093653,6
2020-09-07-170115,170115,0,0,0,85,5.8,57.151464210450484,0
2020-09-08-170115,170115,1,0,0,86,1.6,59.474072992577575,1
2020-09-09-170115,170115,0,0,0,86,1.6,62.08553659080668,2
2020-09-10-170115,170115,0,0,0,86,2.8,19.01399328079559,3
2020-09-11-170115,170115,1,0,1,87,6.8,23.72660806887661,4
2020-09-12-170115,170115,0,0,0,87,3.0,35.374136217342596,5
2020-09-13-170115,170115,0,0,0,87,3.6,39.64841162190669,6
2020-09-14-170115,170115,1,0,0,88,5.0,43.80847906658133,0
2020-09-15-170115,170115,0,0,1,88,3.8,57.758475261470906,1
2020-09-16-170115,170115,0,0,0,88,4.0,69.06453752988538,2
2020-09-17-170115,170115,0,0,0,88,4.4,73.74160097110217,3
2020-09-18-170115,170115,2,0,0,90,16.2,76.27033668330584,4
2020-09-19-170115,170115,0,0,0,90,8.0,74.33445328018803,5
2020-09-20-170115,170115,0,0,0,90,5.6,90.77623876512178,6
2020-09-21-170115,170115,0,0,0,90,2.8,86.15614301777103,0
2020-09-22-170115,170115,0,0,0,90,3.0,82.54540898069862,1
2020-09-23-170115,170115,0,0,0,90,7.4,78.70617103139799,2
2020-09-24-170115,170115,0,0,2,90,7.2,85.74018563014312,3
2020-09-25-170115,170115,1,0,0,91,5.8,95.13020337734993,4
2020-09-26-170115,170115,0,0,0,91,3.8,94.21639453321491,5
2020-09-27-170115,170115,0,0,0,91,1.4,88.47419415647383,6
2020-09-28-170115,170115,0,0,0,91,2.2,83.21563271183425,0
2020-09-29-170115,170115,1,0,1,92,1.6,84.69511812765458,1
2020-09-30-170115,170115,0,0,0,92,4.8,68.8639118703244,2
2020-10-01-170115,170115,0,0,1,92,5.0,0.0,3
2020-10-02-170115,170115,0,0,0,92,4.4,87.25470832930152,4
2020-10-03-170115,170115,0,0,0,92,2.2,168.8513970760646,5
2020-10-04-170115,170115,0,0,0,92,2.8,174.98671418858777,6
2020-10-05-170115,170115,0,0,0,92,3.4,158.79757948990567,0
2020-10-06-170115,170115,0,0,0,92,5.0,137.35252926590226,1
2020-10-07-170115,170115,0,0,1,92,4.8,124.83841409847021,2
2020-10-08-170115,170115,2,0,2,94,2.2,100.46852353185935,3
2020-10-09-170115,170115,0,0,0,94,4.2,104.87377119729604,4
2020-10-10-170115,170115,0,0,1,94,1.4,12.83633810039521,5
2020-10-11-170115,170115,0,0,1,94,0.6,19.828778917615455,6
2020-10-12-170115,170115,0,0,0,94,1.2,22.367107254242228,0
2020-10-13-170115,170115,1,0,3,95,3.0,29.21020405616504,1
2020-10-14-170115,170115,0,0,0,95,2.8,45.53019948120125,2
2020-10-15-170115,170115,1,0,0,96,4.8,52.05040407036509,3
2020-10-16-170115,170115,0,0,2,96,6.0,65.14155107657797,4
2020-10-17-170115,170115,0,0,0,96,5.0,62.348829994401996,5
2020-10-18-170115,170115,0,0,0,96,2.6,75.57809227771648,6
2020-10-19-170115,170115,0,0,0,96,5.6,77.06988819632954,0
2020-10-20-170115,170115,0,0,1,96,5.4,79.7631786832647,1
2020-10-21-170115,170115,1,0,0,97,4.0,89.08927406580014,2
2020-10-22-170115,170115,2,0,1,99,6.6,91.81144084406301,3
2020-10-23-170115,170115,0,1,0,99,6.2,98.81961556991601,4
2020-10-24-170115,170115,1,0,0,100,5.8,95.58435679416365,5
2020-10-25-170115,170115,1,0,1,101,3.0,104.21342075865604,6
2020-10-26-170115,170115,0,0,0,101,10.8,108.45225681974478,0
2020-10-27-170115,170115,3,0,2,104,7.2,115.85739285769597,1
2020-10-28-170115,170115,0,0,0,104,8.2,129.0375427892568,2
2020-10-29-170115,170115,0,0,5,104,8.8,134.5721346539077,3
2020-10-30-170115,170115,2,0,0,106,10.4,141.37881615738334,4
2020-10-31-170115,170115,0,0,0,106,6.8,159.43246921698275,5
2020-11-01-170115,170115,0,0,0,106,5.2,83.74962566162843,6
2020-11-02-170115,170115,0,0,0,106,5.8,139.24578996756446,0
2020-11-03-170115,170115,1,0,0,107,5.8,130.34608243165678,1
2020-11-04-170115,170115,0,0,0,107,8.2,134.47884969599693,2
2020-11-05-170115,170115,1,0,0,108,6.8,125.75407139005357,3
2020-11-06-170115,170115,0,0,0,108,9.4,110.35508712731416,4
2020-11-07-170115,170115,0,0,0,108,3.8,109.07124627344136,5
2020-11-08-170115,170115,1,0,0,109,1.4,105.90353968303778,6
2020-11-09-170115,170115,0,0,0,109,6.2,101.81218556198901,0
2020-11-10-170115,170115,2,0,0,111,6.4,70.3121671662887,1
2020-11-11-170115,170115,0,0,0,111,4.4,76.12535112294408,2
2020-11-12-170115,170115,5,0,0,116,6.0,79.62187767728622,3
2020-11-13-170115,170115,0,1,0,116,6.6,94.20920506757642,4
2020-03-01-170116,170116,0,0,1,0,0.0,0.0,6
2020-03-02-170116,170116,0,0,2,0,0.0,3.40178607556596,0
2020-03-03-170116,170116,0,0,0,0,0.0,14.785284477094383,1
2020-03-04-170116,170116,0,0,1,0,0.0,19.287445384670356,2
2020-03-05-170116,170116,0,7,2,0,0.0,21.152325577942477,3
2020-03-06-170116,170116,0,0,0,0,0.0,21.795723874474398,4
2020-03-07-170116,170116,0,0,0,0,0.0,25.246279414668923,5
2020-03-08-170116,170116,0,0,0,0,0.0,23.21004623991094,6
2020-03-09-170116,170116,0,0,0,0,0.0,23.145564308234842,0
2020-03-10-170116,170116,0,0,0,0,0.0,57.24581500869263,1
2020-03-11-170116,170116,0,0,0,0,0.0,44.392109339768865,2
2020-03-12-170116,170116,0,0,2,0,0.75,32.080706751357596,3
2020-03-13-170116,170116,0,0,1,0,1.0,23.826330674501996,4
2020-03-14-170116,170116,0,0,0,0,0.25,17.82417681847533,5
2020-03-15-170116,170116,1,0,1,1,0.0,11.709619138649915,6
2020-03-16-170116,170116,2,0,0,3,0.75,5.871203954555575,0
2020-03-17-170116,170116,0,0,1,3,0.5,9.785419776872875,1
2020-03-18-170116,170116,1,1,2,4,1.75,10.692234521056072,2
2020-03-19-170116,170116,2,0,2,6,3.75,15.200827189779243,3
2020-03-20-170116,170116,0,0,2,6,3.75,18.071682402077037,4
2020-03-21-170116,170116,0,0,1,6,1.0,20.261672828770003,5
2020-03-22-170116,170116,0,0,1,6,1.5,20.383150327998745,6
2020-03-23-170116,170116,0,0,6,6,5.75,19.492780240141794,0
2020-03-24-170116,170116,0,0,4,6,2.0,25.234446391715778,1
2020-03-25-170116,170116,0,0,3,6,4.25,23.643651195431083,2
2020-03-26-170116,170116,2,0,0,8,2.0,23.167231542775802,3
2020-03-27-170116,170116,1,0,0,9,1.25,27.693819457386994,4
2020-03-28-170116,170116,0,0,1,9,0.5,27.695775259871528,5
2020-03-29-170116,170116,1,0,0,10,2.0,25.727545153781733,6
2020-03-30-170116,170116,0,0,0,10,4.5,21.076191264168237,0
2020-03-31-170116,170116,1,0,0,11,3.75,24.235625269038362,1
2020-04-01-170116,170116,2,0,2,13,4.75,5.260312867503732,2
2020-04-02-170116,170116,2,0,0,15,6.0,13.197519563748848,3
2020-04-03-170116,170116,2,0,0,17,2.75,9.361358949973942,4
2020-04-04-170116,170116,1,0,0,18,0.5,11.856290974187585,5
2020-04-05-170116,170116,1,0,0,19,1.0,11.083903037698363,6
2020-04-06-170116,170116,6,0,0,25,2.0,12.345094914704799,0
2020-04-07-170116,170116,4,0,0,29,1.5,17.03479860697032,1
2020-04-08-170116,170116,3,0,0,32,1.0,21.583945326746477,2
2020-04-09-170116,170116,0,1,0,32,3.0,25.20821221916013,3
2020-04-10-170116,170116,0,0,0,32,14.75,6.890577540090062,4
2020-04-11-170116,170116,1,0,0,33,1.75,28.708438371746954,5
2020-04-12-170116,170116,0,0,0,33,0.5,31.729861905005507,6
2020-04-13-170116,170116,0,0,0,33,2.25,32.599479113013814,0
2020-04-14-170116,170116,0,0,0,33,2.25,34.84314602937986,1
2020-04-15-170116,170116,2,0,0,35,2.0,36.37861282116459,2
2020-04-16-170116,170116,0,0,0,35,2.25,40.969226583619566,3
2020-04-17-170116,170116,0,0,0,35,1.0,39.20005632934145,4
2020-04-18-170116,170116,0,0,0,35,0.75,18.161641575131505,5
2020-04-19-170116,170116,0,0,0,35,0.5,15.782916847483417,6
2020-04-20-170116,170116,0,0,0,35,1.75,21.922849256907647,0
2020-04-21-170116,170116,0,0,0,35,0.75,22.01864118903497,1
2020-04-22-170116,170116,0,0,0,35,1.75,20.363565152509853,2
2020-04-23-170116,170116,0,0,0,35,0.0,19.97037815547632,3
2020-04-24-170116,170116,0,0,1,35,2.0,17.65348769259337,4
2020-04-25-170116,170116,0,0,0,35,1.0,18.794650557482022,5
2020-04-26-170116,170116,0,0,0,35,0.25,20.28623793062576,6
2020-04-27-170116,170116,0,0,0,35,0.75,11.259653071801827,0
2020-04-28-170116,170116,0,0,0,35,1.5,10.511322785020969,1
2020-04-29-170116,170116,0,0,0,35,1.25,10.623519870194475,2
2020-04-30-170116,170116,0,0,2,35,0.25,15.495268181757975,3
2020-05-01-170116,170116,0,0,0,35,0.5,29.699490186863272,4
2020-05-02-170116,170116,0,0,0,35,0.5,6.312062343450128,5
2020-05-03-170116,170116,0,0,0,35,0.5,5.254914103681719,6
2020-05-04-170116,170116,0,0,0,35,0.25,5.432265493454414,0
2020-05-05-170116,170116,0,0,0,35,0.75,5.138288589995506,1
2020-05-06-170116,170116,0,0,0,35,1.75,5.902865565929004,2
2020-05-07-170116,170116,0,0,0,35,1.25,5.844170176495377,3
2020-05-08-170116,170116,1,0,0,36,1.75,11.038290589673442,4
2020-05-09-170116,170116,0,0,0,36,1.5,15.553298070774812,5
2020-05-10-170116,170116,0,0,0,36,0.5,34.11479773769018,6
2020-05-11-170116,170116,0,1,1,36,1.5,33.50701413889678,0
2020-05-12-170116,170116,0,0,0,36,0.75,34.0429453831131,1
2020-05-13-170116,170116,0,0,0,36,0.25,29.69424458319798,2
2020-05-14-170116,170116,2,0,0,38,0.75,23.137964842423976,3
2020-05-15-170116,170116,0,0,0,38,0.75,18.256210777787665,4
2020-05-16-170116,170116,0,0,0,38,0.0,12.12746663328778,5
2020-05-17-170116,170116,0,0,0,38,0.0,11.263761834167932,6
2020-05-18-170116,170116,0,0,0,38,0.5,10.44874951114617,0
2020-05-19-170116,170116,0,0,0,38,0.75,9.050483854053924,1
2020-05-20-170116,170116,0,0,0,38,1.0,8.618849578901123,2
2020-05-21-170116,170116,0,0,0,38,0.25,8.177072154944211,3
2020-05-22-170116,170116,0,0,0,38,0.5,7.750457830787302,4
2020-05-23-170116,170116,0,0,0,38,0.0,9.590668121314552,5
2020-05-24-170116,170116,0,0,0,38,0.25,9.489941863719977,6
2020-05-25-170116,170116,1,0,1,39,1.25,8.659119535815151,0
2020-05-26-170116,170116,0,0,0,39,0.5,9.64134065655616,1
2020-05-27-170116,170116,0,0,0,39,0.25,8.636125628637833,2
2020-05-28-170116,170116,0,2,0,39,0.25,6.817765244717711,3
2020-05-29-170116,170116,0,0,0,39,0.25,8.873051406273087,4
2020-05-30-170116,170116,0,0,0,39,0.0,8.930670783114392,5
2020-05-31-170116,170116,0,0,1,39,0.75,8.901326052731319,6
2020-06-01-170116,170116,0,0,0,39,0.25,25.351336137594004,0
2020-06-02-170116,170116,0,0,1,39,0.25,9.54131151036335,1
2020-06-03-170116,170116,0,0,0,39,0.75,3.047525059993711,2
2020-06-04-170116,170116,0,0,0,39,0.25,4.01293710259229,3
2020-06-05-170116,170116,0,0,0,39,0.25,3.7028658522282814,4
2020-06-06-170116,170116,0,0,0,39,0.0,3.3555142750331415,5
2020-06-07-170116,170116,0,0,0,39,0.25,3.5619848438818744,6
2020-06-08-170116,170116,1,0,0,40,0.25,3.7869509015876126,0
2020-06-09-170116,170116,0,0,0,40,0.5,5.244307884092931,1
2020-06-10-170116,170116,0,0,0,40,0.0,25.761439915212478,2
2020-06-11-170116,170116,0,0,0,40,0.5,24.81215201832061,3
2020-06-12-170116,170116,0,0,0,40,0.25,23.45200880539867,4
2020-06-13-170116,170116,0,0,0,40,0.0,20.704452780359563,5
2020-06-14-170116,170116,1,0,0,41,0.0,13.582252347693352,6
2020-06-15-170116,170116,0,0,0,41,0.5,7.661497806998898,0
2020-06-16-170116,170116,1,0,0,42,0.0,3.9439955005013503,1
2020-06-17-170116,170116,0,0,0,42,0.75,4.855423269361733,2
2020-06-18-170116,170116,0,0,0,42,0.75,7.098029935155788,3
2020-06-19-170116,170116,0,0,0,42,0.0,9.716816501120457,4
2020-06-20-170116,170116,0,0,0,42,0.75,11.66634655686364,5
2020-06-21-170116,170116,0,0,0,42,0.0,12.294231953253515,6
2020-06-22-170116,170116,0,0,0,42,0.5,12.699617164705142,0
2020-06-23-170116,170116,0,0,0,42,0.25,11.859036628540936,1
2020-06-24-170116,170116,0,0,0,42,0.25,9.825866398537974,2
2020-06-25-170116,170116,0,0,0,42,0.5,6.963616342115194,3
2020-06-26-170116,170116,0,0,0,42,0.5,7.783142904127001,4
2020-06-27-170116,170116,0,0,0,42,0.0,6.32035502105734,5
2020-06-28-170116,170116,0,0,0,42,0.0,4.835911666538381,6
2020-06-29-170116,170116,0,0,0,42,0.25,4.2846969232990375,0
2020-06-30-170116,170116,0,0,0,42,0.25,5.151220088276085,1
2020-07-01-170116,170116,0,0,0,42,0.75,5.609791587060934,2
2020-07-02-170116,170116,0,0,0,42,0.25,4.73283872649999,3
2020-07-03-170116,170116,0,0,0,42,0.25,4.376660681978027,4
2020-07-04-170116,170116,0,0,0,42,0.0,3.5817651083893596,5
2020-07-05-170116,170116,0,0,0,42,0.0,3.726979798352072,6
2020-07-06-170116,170116,0,0,0,42,0.25,3.1063837140897577,0
2020-07-07-170116,170116,0,0,0,42,0.5,3.348941636049712,1
2020-07-08-170116,170116,0,0,0,42,0.0,3.8287392753208036,2
2020-07-09-170116,170116,0,0,0,42,0.25,3.4345751048634385,3
2020-07-10-170116,170116,0,0,0,42,0.5,7.053467465773828,4
2020-07-11-170116,170116,0,0,0,42,0.75,7.898009575056293,5
2020-07-12-170116,170116,0,0,0,42,0.0,8.678673739805488,6
2020-07-13-170116,170116,0,0,0,42,0.5,8.428733862622375,0
2020-07-14-170116,170116,0,0,0,42,0.75,8.699523484411671,1
2020-07-15-170116,170116,0,0,0,42,0.75,7.081721552733006,2
2020-07-16-170116,170116,0,0,0,42,0.25,7.145359039090359,3
2020-07-17-170116,170116,0,0,0,42,0.75,5.929825451685797,4
2020-07-18-170116,170116,0,0,0,42,0.5,6.334707148455051,5
2020-07-19-170116,170116,0,0,0,42,0.0,5.953024846187752,6
2020-07-20-170116,170116,0,0,0,42,0.75,6.063834181470647,0
2020-07-21-170116,170116,0,0,0,42,0.25,6.093059651864499,1
2020-07-22-170116,170116,0,0,0,42,0.25,7.00966532064129,2
2020-07-23-170116,170116,0,0,0,42,0.75,6.755431877544373,3
2020-07-24-170116,170116,0,0,0,42,0.0,8.35904751765237,4
2020-07-25-170116,170116,0,0,0,42,0.0,7.392754703172709,5
2020-07-26-170116,170116,0,0,0,42,0.0,7.188190787034524,6
2020-07-27-170116,170116,0,0,0,42,0.75,6.677552878432663,0
2020-07-28-170116,170116,0,0,0,42,0.0,6.587631701657029,1
2020-07-29-170116,170116,0,0,1,42,0.0,5.4769708375738,2
2020-07-30-170116,170116,0,0,0,42,0.25,2.1715351083348127,3
2020-07-31-170116,170116,0,0,0,42,0.25,2.7016425842057905,4
2020-08-01-170116,170116,0,0,2,42,0.0,4.008447789149899,5
2020-08-02-170116,170116,0,0,0,42,0.0,46.29382139051585,6
2020-08-03-170116,170116,0,0,0,42,0.5,27.764364009724265,0
2020-08-04-170116,170116,0,0,0,42,0.75,27.509894352476586,1
2020-08-05-170116,170116,0,1,0,42,1.5,24.309216175645506,2
2020-08-06-170116,170116,0,0,0,42,1.25,23.841809884848857,3
2020-08-07-170116,170116,0,0,1,42,2.0,24.38226913460718,4
2020-08-08-170116,170116,0,0,0,42,2.75,24.81073744689559,5
2020-08-09-170116,170116,0,0,0,42,0.0,29.556305956491187,6
2020-08-10-170116,170116,0,0,0,42,1.0,2.6392000295821845,0
2020-08-11-170116,170116,0,0,0,42,2.75,8.101845416132226,1
2020-08-12-170116,170116,1,0,0,43,2.25,18.657461885794785,2
2020-08-13-170116,170116,0,0,1,43,1.25,30.1017726388088,3
2020-08-14-170116,170116,0,0,0,43,4.75,38.66293862966552,4
2020-08-15-170116,170116,2,0,1,45,0.5,60.99614790318907,5
2020-08-16-170116,170116,0,0,0,45,0.5,65.22658558028529,6
2020-08-17-170116,170116,0,0,2,45,2.25,65.6437639536112,0
2020-08-18-170116,170116,0,0,1,45,1.0,64.32917983477714,1
2020-08-19-170116,170116,0,0,0,45,1.0,58.12423887910751,2
2020-08-20-170116,170116,0,0,4,45,1.5,40.99866722528784,3
2020-08-21-170116,170116,1,0,2,46,2.5,31.27350585801675,4
2020-08-22-170116,170116,0,0,1,46,0.5,36.21991311859142,5
2020-08-23-170116,170116,0,0,0,46,0.75,41.27557929767692,6
2020-08-24-170116,170116,0,0,0,46,1.0,39.37200869753452,0
2020-08-25-170116,170116,0,0,3,46,2.0,37.45828093141435,1
2020-08-26-170116,170116,0,0,0,46,2.5,38.568250358610634,2
2020-08-27-170116,170116,1,0,4,47,0.75,43.98715110100565,3
2020-08-28-170116,170116,0,0,3,47,0.25,37.47851971106429,4
2020-08-29-170116,170116,1,0,0,48,1.0,30.15448072721393,5
2020-08-30-170116,170116,0,0,2,48,1.5,28.703812108359607,6
2020-08-31-170116,170116,2,0,0,50,0.25,28.742595055776853,0
2020-09-01-170116,170116,1,0,2,51,0.5,24.213310174226855,1
2020-09-02-170116,170116,0,0,0,51,0.25,45.368069114643745,2
2020-09-03-170116,170116,4,0,0,55,3.75,31.5262092011151,3
2020-09-04-170116,170116,2,1,0,57,1.5,38.48749411348919,4
2020-09-05-170116,170116,1,0,2,58,0.0,42.83195324926332,5
2020-09-06-170116,170116,0,0,0,58,0.25,42.930292719024024,6
2020-09-07-170116,170116,0,0,1,58,2.0,44.08746623386671,0
2020-09-08-170116,170116,3,0,2,61,1.0,43.922451441707125,1
2020-09-09-170116,170116,0,0,0,61,3.25,45.37016348658432,2
2020-09-10-170116,170116,4,0,0,65,0.25,18.437868083161185,3
2020-09-11-170116,170116,3,0,1,68,2.0,23.73852978308461,4
2020-09-12-170116,170116,0,0,0,68,6.5,28.479368286226574,5
2020-09-13-170116,170116,2,0,0,70,0.25,34.690070650118514,6
2020-09-14-170116,170116,0,0,0,70,1.25,35.193072627835605,0
2020-09-15-170116,170116,2,0,2,72,2.5,33.282918300533986,1
2020-09-16-170116,170116,0,0,0,72,3.25,39.55945728350263,2
2020-09-17-170116,170116,0,0,0,72,1.0,42.08096320893874,3
2020-09-18-170116,170116,0,0,1,72,3.75,38.74541552606377,4
2020-09-19-170116,170116,2,0,0,74,0.25,41.53020800576124,5
2020-09-20-170116,170116,0,0,1,74,0.25,31.958485340372505,6
2020-09-21-170116,170116,1,1,0,75,0.5,29.99893926132902,0
2020-09-22-170116,170116,2,0,0,77,1.75,28.188055012275285,1
2020-09-23-170116,170116,0,0,2,77,2.75,30.891237286418814,2
2020-09-24-170116,170116,0,0,0,77,0.5,33.588439436765825,3
2020-09-25-170116,170116,1,1,0,78,2.25,28.005641082950426,4
2020-09-26-170116,170116,0,0,1,78,0.75,29.638797376859436,5
2020-09-27-170116,170116,0,0,0,78,0.0,31.439150376194842,6
2020-09-28-170116,170116,0,0,1,78,0.75,30.66588225619166,0
2020-09-29-170116,170116,2,0,0,80,0.75,28.27424570384109,1
2020-09-30-170116,170116,0,0,2,80,2.5,27.991626600008797,2
2020-10-01-170116,170116,0,0,1,80,1.5,0.0,3
2020-10-02-170116,170116,1,0,0,81,1.0,19.571393464591022,4
2020-10-03-170116,170116,0,0,0,81,1.0,34.63786027827258,5
2020-10-04-170116,170116,1,0,1,82,0.0,39.54605899936373,6
2020-10-05-170116,170116,0,0,0,82,1.5,35.108904992595676,0
2020-10-06-170116,170116,0,1,0,82,0.75,34.135897068215314,1
2020-10-07-170116,170116,2,0,0,84,2.0,32.206208089653884,2
2020-10-08-170116,170116,0,0,1,84,1.25,32.39059819569749,3
2020-10-09-170116,170116,0,0,1,84,1.5,37.49421090120117,4
2020-10-10-170116,170116,1,0,0,85,0.25,5.919571135345045,5
2020-10-11-170116,170116,0,0,1,85,0.0,8.670470621232006,6
2020-10-12-170116,170116,1,0,0,86,0.75,10.12864379763969,0
2020-10-13-170116,170116,0,0,1,86,0.0,14.14815297194486,1
2020-10-14-170116,170116,2,0,0,88,1.5,16.049453927679828,2
2020-10-15-170116,170116,1,0,0,89,0.0,23.090468963153807,3
2020-10-16-170116,170116,0,0,6,89,0.0,24.45705393114568,4
2020-10-17-170116,170116,0,0,4,89,0.25,19.313393184555537,5
2020-10-18-170116,170116,1,0,3,90,1.25,16.943382888637167,6
2020-10-19-170116,170116,0,0,1,90,1.0,20.133183220751185,0
2020-10-20-170116,170116,0,0,2,90,0.25,21.357735128238616,1
2020-10-21-170116,170116,0,0,6,90,2.0,16.048774774313483,2
2020-10-22-170116,170116,1,0,5,91,1.0,19.191861660850048,3
2020-10-23-170116,170116,1,0,7,92,2.5,23.351264348610528,4
2020-10-24-170116,170116,0,0,4,92,0.0,30.80054045287599,5
2020-10-25-170116,170116,1,1,1,93,0.75,27.42020764503694,6
2020-10-26-170116,170116,0,0,2,93,3.0,27.28405826430571,0
2020-10-27-170116,170116,1,0,1,94,0.25,28.85575745926428,1
2020-10-28-170116,170116,0,1,3,94,1.5,31.384525760218516,2
2020-10-29-170116,170116,0,0,2,94,1.25,34.06899789999623,3
2020-10-30-170116,170116,6,0,9,100,2.25,28.920052185855972,4
2020-10-31-170116,170116,4,0,0,104,0.5,37.931897763668985,5
2020-11-01-170116,170116,3,0,0,107,2.25,35.54178290456203,6
2020-11-02-170116,170116,1,0,0,108,0.75,54.0716501649982,0
2020-11-03-170116,170116,2,0,0,110,1.0,30.688134357874162,1
2020-11-04-170116,170116,6,0,0,116,0.5,33.262979564164745,2
2020-11-05-170116,170116,5,0,0,121,1.75,40.74093905771802,3
2020-11-06-170116,170116,7,2,0,128,1.5,43.001414577867656,4
2020-11-07-170116,170116,4,0,0,132,0.25,48.936408237842244,5
2020-11-08-170116,170116,1,0,0,133,2.0,49.44699404210519,6
2020-11-09-170116,170116,2,1,0,135,1.25,50.16244999151526,0
2020-11-10-170116,170116,1,2,0,136,1.0,31.92780618774687,1
2020-11-11-170116,170116,3,2,0,139,3.5,37.02067999545429,2
2020-11-12-170116,170116,2,0,0,141,2.25,46.12037476686656,3
2020-11-13-170116,170116,9,0,0,150,2.25,55.97910880735128,4
2020-03-01-170117,170117,0,0,1,0,0.14285714285714285,0.0,6
2020-03-02-170117,170117,0,0,0,0,0.0,9.27186072427521,0
2020-03-03-170117,170117,1,0,0,1,0.0,53.73667132535863,1
2020-03-04-170117,170117,0,0,1,1,0.0,59.43520673044294,2
2020-03-05-170117,170117,0,0,2,1,0.0,70.4413546064632,3
2020-03-06-170117,170117,0,0,0,1,0.0,67.56579426088922,4
2020-03-07-170117,170117,0,0,0,1,0.0,76.11682135289598,5
2020-03-08-170117,170117,0,0,4,1,0.0,76.33475225739984,6
2020-03-09-170117,170117,0,0,4,1,0.0,74.47562893958231,0
2020-03-10-170117,170117,0,0,0,1,0.0,91.8376245262859,1
2020-03-11-170117,170117,0,0,1,1,0.0,79.84963210383435,2
2020-03-12-170117,170117,0,0,1,1,0.2857142857142857,58.71764836744638,3
2020-03-13-170117,170117,0,0,1,1,0.2857142857142857,37.28451405699539,4
2020-03-14-170117,170117,0,0,0,1,0.5714285714285714,30.32515577566206,5
2020-03-15-170117,170117,1,0,1,2,0.5714285714285714,13.663445958034092,6
2020-03-16-170117,170117,0,0,1,2,2.0,9.888454915870053,0
2020-03-17-170117,170117,0,0,1,2,2.142857142857143,15.676098264825466,1
2020-03-18-170117,170117,1,0,0,3,2.571428571428572,19.64699256271046,2
2020-03-19-170117,170117,2,1,1,5,3.4285714285714284,32.060196557144295,3
2020-03-20-170117,170117,0,0,2,5,3.571428571428572,51.87262505912878,4
2020-03-21-170117,170117,0,2,0,5,2.4285714285714284,59.13127750986041,5
2020-03-22-170117,170117,4,0,0,9,2.571428571428572,59.23031551977755,6
2020-03-23-170117,170117,4,0,6,13,7.2857142857142865,68.58167171139057,0
2020-03-24-170117,170117,0,0,2,13,4.142857142857143,103.42898518027428,1
2020-03-25-170117,170117,1,0,2,14,7.7142857142857135,102.54961205659711,2
2020-03-26-170117,170117,1,0,0,15,5.285714285714286,115.32690482729934,3
2020-03-27-170117,170117,1,0,0,16,7.2857142857142865,129.06428577039094,4
2020-03-28-170117,170117,0,0,0,16,0.8571428571428571,134.80288036830723,5
2020-03-29-170117,170117,1,0,0,17,2.142857142857143,129.45758980543138,6
2020-03-30-170117,170117,1,0,2,18,7.857142857142858,90.4802125602758,0
2020-03-31-170117,170117,1,0,0,19,6.428571428571429,99.58142369703396,1
2020-04-01-170117,170117,0,0,0,19,5.7142857142857135,26.369267810248886,2
2020-04-02-170117,170117,1,0,1,20,3.571428571428572,93.90931262949164,3
2020-04-03-170117,170117,2,0,0,22,3.2857142857142856,27.15515488799812,4
2020-04-04-170117,170117,0,0,1,22,0.7142857142857143,41.76463952439322,5
2020-04-05-170117,170117,0,0,1,22,1.2857142857142858,44.64865101583895,6
2020-04-06-170117,170117,6,0,1,28,3.7142857142857135,47.00668149438643,0
2020-04-07-170117,170117,2,0,2,30,1.8571428571428568,71.94949051025937,1
2020-04-08-170117,170117,2,3,1,32,2.571428571428572,83.07555651466913,2
2020-04-09-170117,170117,0,0,0,32,2.2857142857142856,82.54230007706431,3
2020-04-10-170117,170117,0,0,0,32,0.7142857142857143,12.600901010621454,4
2020-04-11-170117,170117,0,0,0,32,1.0,20.4841637226662,5
2020-04-12-170117,170117,0,0,0,32,0.14285714285714285,23.07499674044681,6
2020-04-13-170117,170117,2,0,1,34,2.571428571428572,25.634485834432933,0
2020-04-14-170117,170117,0,0,0,34,2.4285714285714284,43.380472303640644,1
2020-04-15-170117,170117,0,0,1,34,5.428571428571429,55.29879724411179,2
2020-04-16-170117,170117,1,0,0,35,2.7142857142857144,87.31647091699907,3
2020-04-17-170117,170117,0,1,0,35,3.571428571428572,86.70026799318812,4
2020-04-18-170117,170117,1,0,0,36,1.2857142857142858,97.57015184220971,5
2020-04-19-170117,170117,1,0,0,37,1.1428571428571428,98.89754374054141,6
2020-04-20-170117,170117,1,0,0,38,1.7142857142857142,104.06245425749466,0
2020-04-21-170117,170117,2,0,0,40,2.4285714285714284,104.33212679649347,1
2020-04-22-170117,170117,1,1,1,41,2.0,82.83701874963214,2
2020-04-23-170117,170117,0,0,2,41,0.42857142857142855,79.40114547388819,3
2020-04-24-170117,170117,0,0,0,41,1.2857142857142858,61.779708164100356,4
2020-04-25-170117,170117,0,0,0,41,0.5714285714285714,61.04549611746792,5
2020-04-26-170117,170117,0,0,0,41,0.2857142857142857,56.80300190330516,6
2020-04-27-170117,170117,1,0,0,42,1.7142857142857142,37.44921766471958,0
2020-04-28-170117,170117,0,0,1,42,2.0,30.461296186333428,1
2020-04-29-170117,170117,1,0,1,43,2.8571428571428568,22.86599996584095,2
2020-04-30-170117,170117,0,0,1,43,1.1428571428571428,47.71735507103029,3
2020-05-01-170117,170117,0,0,0,43,0.5714285714285714,87.23196326118202,4
2020-05-02-170117,170117,0,0,0,43,1.1428571428571428,27.11196759738452,5
2020-05-03-170117,170117,0,0,0,43,0.0,23.71231181759717,6
2020-05-04-170117,170117,0,0,3,43,4.714285714285714,15.79148681993587,0
2020-05-05-170117,170117,0,0,0,43,1.7142857142857142,19.43809006526658,1
2020-05-06-170117,170117,1,0,3,44,9.0,24.47379566094281,2
2020-05-07-170117,170117,2,0,3,46,2.4285714285714284,30.45110834933,3
2020-05-08-170117,170117,0,0,2,46,2.571428571428572,40.24069467449721,4
2020-05-09-170117,170117,0,0,0,46,0.2857142857142857,53.750198006433685,5
2020-05-10-170117,170117,0,0,0,46,0.2857142857142857,101.5902353889569,6
2020-05-11-170117,170117,0,0,1,46,1.0,100.81982128200275,0
2020-05-12-170117,170117,1,0,0,47,0.5714285714285714,102.47269103032814,1
2020-05-13-170117,170117,1,0,0,48,0.42857142857142855,72.65628823075906,2
2020-05-14-170117,170117,1,0,1,49,1.0,61.1605239501276,3
2020-05-15-170117,170117,0,0,0,49,0.5714285714285714,51.44309146156697,4
2020-05-16-170117,170117,0,0,0,49,0.14285714285714285,31.776102386702345,5
2020-05-17-170117,170117,0,0,0,49,0.14285714285714285,31.248569122567353,6
2020-05-18-170117,170117,3,0,0,52,0.8571428571428571,29.188316470819682,0
2020-05-19-170117,170117,0,0,1,52,1.0,38.53579669482393,1
2020-05-20-170117,170117,3,0,0,55,0.8571428571428571,29.595315656595094,2
2020-05-21-170117,170117,3,0,0,58,1.0,38.237804344630064,3
2020-05-22-170117,170117,2,0,0,60,1.2857142857142858,53.13406006486222,4
2020-05-23-170117,170117,0,0,0,60,0.42857142857142855,62.63359442957986,5
2020-05-24-170117,170117,0,0,0,60,0.2857142857142857,66.72514571758023,6
2020-05-25-170117,170117,1,0,0,61,0.42857142857142855,51.339315113975374,0
2020-05-26-170117,170117,0,0,0,61,0.5714285714285714,56.640202133102704,1
2020-05-27-170117,170117,0,0,0,61,0.42857142857142855,60.95490490743856,2
2020-05-28-170117,170117,1,0,0,62,0.7142857142857143,48.96400049236972,3
2020-05-29-170117,170117,0,1,0,62,0.2857142857142857,39.19851698563488,4
2020-05-30-170117,170117,0,0,0,62,0.0,28.55299232280883,5
2020-05-31-170117,170117,0,0,0,62,0.0,28.490841447500408,6
2020-06-01-170117,170117,0,0,0,62,1.0,66.26647765428169,0
2020-06-02-170117,170117,1,0,0,63,0.8571428571428571,11.057140216395968,1
2020-06-03-170117,170117,0,0,0,63,0.42857142857142855,26.989895880089144,2
2020-06-04-170117,170117,0,0,0,63,0.42857142857142855,23.98878209999053,3
2020-06-05-170117,170117,0,0,0,63,1.0,23.968693238505516,4
2020-06-06-170117,170117,0,3,0,63,0.42857142857142855,27.151996242595136,5
2020-06-07-170117,170117,0,0,0,63,0.0,29.14735995612987,6
2020-06-08-170117,170117,0,0,0,63,0.42857142857142855,28.346480351068628,0
2020-06-09-170117,170117,0,0,0,63,0.42857142857142855,21.922267204989712,1
2020-06-10-170117,170117,0,0,0,63,0.2857142857142857,67.30894750027771,2
2020-06-11-170117,170117,0,0,0,63,0.0,55.65258192691838,3
2020-06-12-170117,170117,0,0,0,63,0.14285714285714285,45.96167456234397,4
2020-06-13-170117,170117,0,0,0,63,0.14285714285714285,30.94620099320107,5
2020-06-14-170117,170117,0,1,0,63,0.14285714285714285,17.934861031392447,6
2020-06-15-170117,170117,0,0,3,63,0.0,5.998348996368073,0
2020-06-16-170117,170117,0,0,0,63,0.5714285714285714,5.786396433982601,1
2020-06-17-170117,170117,0,0,0,63,0.42857142857142855,5.781577233377792,2
2020-06-18-170117,170117,0,0,0,63,0.5714285714285714,8.45453445125915,3
2020-06-19-170117,170117,0,0,0,63,0.8571428571428571,9.536218235267256,4
2020-06-20-170117,170117,0,0,0,63,0.0,17.513246822943202,5
2020-06-21-170117,170117,0,0,0,63,0.0,18.507540699672074,6
2020-06-22-170117,170117,0,0,1,63,0.0,17.855121630033832,0
2020-06-23-170117,170117,0,0,0,63,0.5714285714285714,17.671957604753004,1
2020-06-24-170117,170117,0,2,1,63,0.5714285714285714,16.00841261892698,2
2020-06-25-170117,170117,0,1,0,63,0.2857142857142857,20.532494242927307,3
2020-06-26-170117,170117,0,1,0,63,0.14285714285714285,21.82429915534246,4
2020-06-27-170117,170117,0,0,0,63,0.0,18.90476815714495,5
2020-06-28-170117,170117,0,0,1,63,0.0,18.710699783006643,6
2020-06-29-170117,170117,3,0,0,66,0.2857142857142857,19.293462126395227,0
2020-06-30-170117,170117,0,0,1,66,0.0,33.36695302422943,1
2020-07-01-170117,170117,0,0,0,66,0.14285714285714285,28.244160175204506,2
2020-07-02-170117,170117,0,0,0,66,0.2857142857142857,24.237949727118153,3
2020-07-03-170117,170117,0,1,1,66,0.0,53.692847641200686,4
2020-07-04-170117,170117,0,0,0,66,0.0,42.93288285184367,5
2020-07-05-170117,170117,0,0,0,66,0.0,43.05371959038844,6
2020-07-06-170117,170117,1,0,0,67,0.14285714285714285,36.06614339789435,0
2020-07-07-170117,170117,0,0,0,67,0.2857142857142857,15.97730133508877,1
2020-07-08-170117,170117,1,0,1,68,0.14285714285714285,14.48828719545267,2
2020-07-09-170117,170117,0,0,2,68,0.14285714285714285,17.50160483629106,3
2020-07-10-170117,170117,0,0,0,68,0.0,29.082369448617374,4
2020-07-11-170117,170117,0,0,0,68,0.2857142857142857,25.98891680874815,5
2020-07-12-170117,170117,1,0,0,69,0.14285714285714285,20.11596055176957,6
2020-07-13-170117,170117,0,0,1,69,0.42857142857142855,21.006452014531924,0
2020-07-14-170117,170117,1,0,3,70,0.5714285714285714,23.159552335334247,1
2020-07-15-170117,170117,0,0,2,70,0.2857142857142857,24.5888409026581,2
2020-07-16-170117,170117,0,0,0,70,0.2857142857142857,27.082972308918293,3
2020-07-17-170117,170117,1,0,0,71,0.14285714285714285,27.37738743965533,4
2020-07-18-170117,170117,0,0,0,71,0.14285714285714285,31.470871750026298,5
2020-07-19-170117,170117,0,0,0,71,0.0,30.692672032850897,6
2020-07-20-170117,170117,0,0,0,71,0.0,28.36449119640637,0
2020-07-21-170117,170117,0,0,1,71,0.14285714285714285,20.33026752502265,1
2020-07-22-170117,170117,1,0,1,72,0.2857142857142857,12.958320239191151,2
2020-07-23-170117,170117,2,0,2,74,0.2857142857142857,16.447365898568055,3
2020-07-24-170117,170117,0,1,3,74,0.0,24.652503248065834,4
2020-07-25-170117,170117,0,0,0,74,0.0,23.93327425669445,5
2020-07-26-170117,170117,0,0,0,74,0.0,23.998085953645926,6
2020-07-27-170117,170117,1,0,1,75,0.14285714285714285,20.421048564696882,0
2020-07-28-170117,170117,3,0,6,78,0.8571428571428571,27.85955149841577,1
2020-07-29-170117,170117,2,0,1,80,0.5714285714285714,54.616230618228485,2
2020-07-30-170117,170117,0,0,2,80,0.14285714285714285,45.8428807370412,3
2020-07-31-170117,170117,0,0,1,80,0.14285714285714285,46.68325806713142,4
2020-08-01-170117,170117,0,0,0,80,0.0,18.82836645248217,5
2020-08-02-170117,170117,0,0,0,80,0.5714285714285714,112.4786072205752,6
2020-08-03-170117,170117,0,0,0,80,0.0,113.75024713326965,0
2020-08-04-170117,170117,1,0,0,81,0.5714285714285714,109.9815280014927,1
2020-08-05-170117,170117,1,0,0,82,0.5714285714285714,106.27618711914008,2
2020-08-06-170117,170117,2,0,0,84,2.7142857142857144,100.43845563369274,3
2020-08-07-170117,170117,3,0,1,87,1.2857142857142858,128.09913083873647,4
2020-08-08-170117,170117,0,0,0,87,0.7142857142857143,148.82943287135683,5
2020-08-09-170117,170117,0,0,1,87,0.5714285714285714,154.28534244909005,6
2020-08-10-170117,170117,1,0,1,88,1.0,19.06204089359792,0
2020-08-11-170117,170117,6,0,1,94,1.1428571428571428,35.43700340379043,1
2020-08-12-170117,170117,1,0,0,95,1.4285714285714286,78.49996442367605,2
2020-08-13-170117,170117,2,0,1,97,2.0,102.36307439982723,3
2020-08-14-170117,170117,1,0,0,98,2.7142857142857144,128.22951188921388,4
2020-08-15-170117,170117,0,0,0,98,1.1428571428571428,152.89598388144316,5
2020-08-16-170117,170117,0,0,1,98,0.8571428571428571,167.9055378224963,6
2020-08-17-170117,170117,0,0,2,98,1.7142857142857142,170.9224639204882,0
2020-08-18-170117,170117,0,0,1,98,1.0,178.5557622077872,1
2020-08-19-170117,170117,0,0,0,98,2.4285714285714284,137.58884638147285,2
2020-08-20-170117,170117,0,0,2,98,3.0,105.1683128132762,3
2020-08-21-170117,170117,1,0,2,99,3.2857142857142856,94.79398412028965,4
2020-08-22-170117,170117,0,0,0,99,0.5714285714285714,106.16850020060708,5
2020-08-23-170117,170117,1,0,0,100,0.5714285714285714,111.68278331828458,6
2020-08-24-170117,170117,1,0,0,101,2.4285714285714284,94.82000571719621,0
2020-08-25-170117,170117,1,0,1,102,4.0,107.11136506585117,1
2020-08-26-170117,170117,0,0,3,102,3.4285714285714284,109.15806032737329,2
2020-08-27-170117,170117,1,1,0,103,3.7142857142857135,113.65940298871865,3
2020-08-28-170117,170117,0,0,1,103,3.0,116.673336324471,4
2020-08-29-170117,170117,0,0,0,103,1.7142857142857142,110.8079592205806,5
2020-08-30-170117,170117,1,1,0,104,2.142857142857143,108.24052995370457,6
2020-08-31-170117,170117,2,0,0,106,2.8571428571428568,106.66567754673378,0
2020-09-01-170117,170117,1,0,2,107,2.571428571428572,109.77192765048795,1
2020-09-02-170117,170117,0,0,1,107,1.7142857142857142,130.019713253979,2
2020-09-03-170117,170117,2,0,1,109,3.2857142857142856,123.51520756359156,3
2020-09-04-170117,170117,2,0,2,111,4.571428571428571,118.8930594623421,4
2020-09-05-170117,170117,0,0,0,111,2.0,141.94027021136105,5
2020-09-06-170117,170117,0,0,0,111,3.7142857142857135,139.76142484774292,6
2020-09-07-170117,170117,0,0,2,111,3.2857142857142856,145.19880436900328,0
2020-09-08-170117,170117,1,0,4,112,1.0,134.71481394137913,1
2020-09-09-170117,170117,3,0,2,115,1.7142857142857142,128.6405427298116,2
2020-09-10-170117,170117,0,0,4,115,3.0,90.24223253906703,3
2020-09-11-170117,170117,1,0,1,116,3.8571428571428568,93.01909185120827,4
2020-09-12-170117,170117,0,0,0,116,2.571428571428572,98.88014196950988,5
2020-09-13-170117,170117,0,0,1,116,2.2857142857142856,66.58092052516496,6
2020-09-14-170117,170117,0,0,5,116,4.571428571428571,50.01248150462865,0
2020-09-15-170117,170117,2,0,1,118,2.142857142857143,67.76929238573547,1
2020-09-16-170117,170117,1,0,2,119,2.4285714285714284,78.51239690397824,2
2020-09-17-170117,170117,1,0,1,120,2.2857142857142856,91.28534469020018,3
2020-09-18-170117,170117,2,0,1,122,13.571428571428573,95.6590012000072,4
2020-09-19-170117,170117,0,0,0,122,6.142857142857142,103.80758479260578,5
2020-09-20-170117,170117,0,0,0,122,3.8571428571428568,98.82568980082132,6
2020-09-21-170117,170117,2,0,3,124,3.4285714285714284,84.31865772400697,0
2020-09-22-170117,170117,4,0,0,128,4.285714285714286,83.44062344620296,1
2020-09-23-170117,170117,2,1,1,130,5.571428571428571,84.79613206451043,2
2020-09-24-170117,170117,4,0,4,134,6.142857142857142,86.6568896450554,3
2020-09-25-170117,170117,1,0,2,135,5.285714285714286,81.54921610510328,4
2020-09-26-170117,170117,0,0,4,135,2.142857142857143,92.50111171224748,5
2020-09-27-170117,170117,1,0,2,136,1.2857142857142858,98.13432481251468,6
2020-09-28-170117,170117,5,0,4,141,4.714285714285714,94.73552930044298,0
2020-09-29-170117,170117,1,0,2,142,3.0,103.63855732043774,1
2020-09-30-170117,170117,2,0,0,144,5.571428571428571,99.9618277566197,2
2020-10-01-170117,170117,1,0,0,145,3.4285714285714284,0.0,3
2020-10-02-170117,170117,1,0,0,146,4.857142857142857,101.2527444772494,4
2020-10-03-170117,170117,0,0,0,146,0.8571428571428571,118.6297924629743,5
2020-10-04-170117,170117,0,0,1,146,3.4285714285714284,117.45230140224348,6
2020-10-05-170117,170117,3,0,3,149,4.857142857142857,113.01127327281581,0
2020-10-06-170117,170117,0,0,0,149,3.1428571428571432,104.71846986560598,1
2020-10-07-170117,170117,1,0,1,150,2.571428571428572,93.00043526214466,2
2020-10-08-170117,170117,4,0,0,154,3.2857142857142856,93.62622132239075,3
2020-10-09-170117,170117,2,1,1,156,4.571428571428571,113.96611394144318,4
2020-10-10-170117,170117,4,0,0,160,3.1428571428571432,14.24135937583772,5
2020-10-11-170117,170117,2,0,0,162,3.1428571428571432,32.597636940191386,6
2020-10-12-170117,170117,4,0,0,166,1.7142857142857142,57.81185207792916,0
2020-10-13-170117,170117,2,0,7,168,4.285714285714286,69.76733655916165,1
2020-10-14-170117,170117,0,0,1,168,3.4285714285714284,101.76153394151768,2
2020-10-15-170117,170117,0,0,0,168,3.571428571428572,114.51678354628055,3
2020-10-16-170117,170117,0,0,2,168,7.2857142857142865,122.75743968927793,4
2020-10-17-170117,170117,0,0,0,168,1.7142857142857142,118.24858464835847,5
2020-10-18-170117,170117,1,0,0,169,2.2857142857142856,101.95564482947961,6
2020-10-19-170117,170117,3,0,0,172,5.857142857142858,89.63982083615879,0
2020-10-20-170117,170117,0,0,2,172,3.7142857142857135,80.0193538942737,1
2020-10-21-170117,170117,1,0,0,173,5.0,75.69665663626304,2
2020-10-22-170117,170117,0,0,0,173,7.0,84.92448996913143,3
2020-10-23-170117,170117,1,0,3,174,6.0,89.14552305226073,4
2020-10-24-170117,170117,0,0,0,174,2.571428571428572,102.99612990367771,5
2020-10-25-170117,170117,0,1,1,174,2.142857142857143,100.14396804083799,6
2020-10-26-170117,170117,0,2,0,174,4.571428571428571,92.80300793280813,0
2020-10-27-170117,170117,7,0,0,181,4.0,97.52930037139309,1
2020-10-28-170117,170117,1,3,0,182,5.142857142857143,119.37741959480306,2
2020-10-29-170117,170117,0,0,0,182,4.571428571428571,117.08681795875215,3
2020-10-30-170117,170117,2,0,1,184,4.857142857142857,102.60693011709952,4
2020-10-31-170117,170117,0,0,0,184,2.0,122.68114743694838,5
2020-11-01-170117,170117,0,0,0,184,2.4285714285714284,107.4540515174956,6
2020-11-02-170117,170117,0,1,0,184,2.7142857142857144,50.28385390590127,0
2020-11-03-170117,170117,2,0,0,186,4.714285714285714,39.33764387975666,1
2020-11-04-170117,170117,0,1,0,186,6.428571428571429,58.221551601311006,2
2020-11-05-170117,170117,0,0,0,186,4.285714285714286,67.16516906304841,3
2020-11-06-170117,170117,3,0,0,189,6.7142857142857135,82.33403986125523,4
2020-11-07-170117,170117,0,1,0,189,2.0,98.62708337087685,5
2020-11-08-170117,170117,1,0,0,190,2.7142857142857144,100.51188276625096,6
2020-11-09-170117,170117,0,0,0,190,5.142857142857143,107.64483564114367,0
2020-11-10-170117,170117,0,0,0,190,4.0,118.00710995407485,1
2020-11-11-170117,170117,0,0,0,190,3.7142857142857135,116.74574260453335,2
2020-11-12-170117,170117,0,1,0,190,4.857142857142857,109.80117814327559,3
2020-11-13-170117,170117,1,0,0,191,4.428571428571429,119.5355207749493,4
2020-03-01-170118,170118,0,0,0,0,0.3333333333333333,0.0,6
2020-03-02-170118,170118,0,0,0,0,0.0,4.863182732274784,0
2020-03-03-170118,170118,0,2,0,0,0.0,29.8656928723506,1
2020-03-04-170118,170118,0,0,0,0,0.0,33.538282854765875,2
2020-03-05-170118,170118,0,2,1,0,0.16666666666666666,35.79566225294178,3
2020-03-06-170118,170118,0,0,0,0,0.0,44.36166487703612,4
2020-03-07-170118,170118,0,1,2,0,0.0,39.990179890919165,5
2020-03-08-170118,170118,0,0,0,0,0.0,34.37329619160016,6
2020-03-09-170118,170118,0,0,0,0,0.0,34.384862852795436,0
2020-03-10-170118,170118,0,0,0,0,0.16666666666666666,52.93182009571971,1
2020-03-11-170118,170118,0,0,2,0,0.16666666666666666,44.18364680130492,2
2020-03-12-170118,170118,0,0,0,0,0.5,31.60285284789603,3
2020-03-13-170118,170118,1,0,1,1,0.6666666666666666,16.747205229270435,4
2020-03-14-170118,170118,0,0,0,1,0.3333333333333333,12.268202734248536,5
2020-03-15-170118,170118,0,0,0,1,0.5,9.328675604337892,6
2020-03-16-170118,170118,0,0,0,1,3.5,5.709253209017465,0
2020-03-17-170118,170118,0,0,2,1,2.5,10.016186357460981,1
2020-03-18-170118,170118,0,0,0,1,7.166666666666668,15.266886093582771,2
2020-03-19-170118,170118,1,0,0,2,13.833333333333336,23.541461271107888,3
2020-03-20-170118,170118,0,1,0,2,8.5,33.48072003368358,4
2020-03-21-170118,170118,2,0,0,4,3.0,39.54191037055165,5
2020-03-22-170118,170118,0,3,0,4,5.0,40.75764288926936,6
2020-03-23-170118,170118,0,0,1,4,16.333333333333332,47.71011122942484,0
2020-03-24-170118,170118,0,0,1,4,12.666666666666664,63.97098071377921,1
2020-03-25-170118,170118,2,0,0,6,13.5,54.79010568636015,2
2020-03-26-170118,170118,0,0,1,6,10.333333333333334,57.27003541991114,3
2020-03-27-170118,170118,1,0,1,7,9.833333333333334,68.57495990406633,4
2020-03-28-170118,170118,0,1,0,7,6.0,71.97874014769369,5
2020-03-29-170118,170118,0,0,0,7,4.666666666666667,76.58843487124946,6
2020-03-30-170118,170118,0,0,2,7,11.166666666666664,53.440014270949845,0
2020-03-31-170118,170118,2,1,0,9,10.833333333333336,51.77732580940149,1
2020-04-01-170118,170118,0,0,0,9,5.5,7.675401541349819,2
2020-04-02-170118,170118,0,0,0,9,9.0,32.31865683997175,3
2020-04-03-170118,170118,0,0,0,9,6.666666666666668,14.006324027354442,4
2020-04-04-170118,170118,0,0,0,9,2.6666666666666665,15.631693453854217,5
2020-04-05-170118,170118,0,0,0,9,2.0,17.946938702410872,6
2020-04-06-170118,170118,1,0,0,10,8.5,18.40417823285576,0
2020-04-07-170118,170118,1,3,0,11,5.333333333333333,23.695311968660988,1
2020-04-08-170118,170118,0,0,0,11,3.5,25.868194427349962,2
2020-04-09-170118,170118,1,0,0,12,4.5,25.17341970969856,3
2020-04-10-170118,170118,1,0,0,13,6.0,5.431821993159127,4
2020-04-11-170118,170118,0,0,0,13,2.333333333333333,13.337541216283093,5
2020-04-12-170118,170118,0,0,0,13,3.1666666666666665,15.117987352360139,6
2020-04-13-170118,170118,2,0,0,15,6.166666666666668,18.141273358132995,0
2020-04-14-170118,170118,0,0,2,15,8.333333333333334,22.157649562792198,1
2020-04-15-170118,170118,0,0,1,15,8.0,28.84037054790076,2
2020-04-16-170118,170118,0,0,0,15,4.666666666666667,46.00267055718873,3
2020-04-17-170118,170118,0,0,0,15,3.5,53.49419757813194,4
2020-04-18-170118,170118,0,0,0,15,1.6666666666666667,47.47448436728199,5
2020-04-19-170118,170118,0,0,0,15,1.6666666666666667,47.65398379180652,6
2020-04-20-170118,170118,0,1,0,15,9.666666666666666,52.58415654760847,0
2020-04-21-170118,170118,0,0,0,15,3.6666666666666665,50.5666582935237,1
2020-04-22-170118,170118,0,0,0,15,3.8333333333333335,42.19350458288902,2
2020-04-23-170118,170118,0,0,0,15,0.8333333333333334,41.971912535116644,3
2020-04-24-170118,170118,0,0,0,15,2.5,37.44430960768711,4
2020-04-25-170118,170118,0,0,0,15,0.8333333333333334,38.787825119453494,5
2020-04-26-170118,170118,0,0,0,15,0.8333333333333334,42.89388511217998,6
2020-04-27-170118,170118,0,0,1,15,3.1666666666666665,31.31444513971524,0
2020-04-28-170118,170118,2,0,0,17,1.5,25.717765853853106,1
2020-04-29-170118,170118,1,0,0,18,3.0,24.012991456613612,2
2020-04-30-170118,170118,0,0,0,18,2.1666666666666665,27.681990596025894,3
2020-05-01-170118,170118,0,0,0,18,0.3333333333333333,45.77603308912802,4
2020-05-02-170118,170118,0,0,0,18,1.5,23.799582838001186,5
2020-05-03-170118,170118,0,0,0,18,0.3333333333333333,17.2848157078784,6
2020-05-04-170118,170118,0,0,1,18,3.5,13.269160803944867,0
2020-05-05-170118,170118,0,0,0,18,2.333333333333333,18.197688466524006,1
2020-05-06-170118,170118,0,0,0,18,3.1666666666666665,20.28774665437942,2
2020-05-07-170118,170118,0,0,0,18,2.1666666666666665,23.600906555750072,3
2020-05-08-170118,170118,0,0,0,18,2.833333333333333,28.25026498695149,4
2020-05-09-170118,170118,0,0,0,18,0.6666666666666666,34.75378078066865,5
2020-05-10-170118,170118,0,0,0,18,1.0,57.39641161446647,6
2020-05-11-170118,170118,1,0,0,19,3.8333333333333335,48.49102247176825,0
2020-05-12-170118,170118,0,0,0,19,2.6666666666666665,45.571135586017434,1
2020-05-13-170118,170118,0,0,1,19,1.0,28.492213218789196,2
2020-05-14-170118,170118,0,1,0,19,2.0,24.20332609330295,3
2020-05-15-170118,170118,0,0,0,19,2.0,17.54604446477976,4
2020-05-16-170118,170118,0,0,0,19,1.1666666666666667,14.236743900397471,5
2020-05-17-170118,170118,0,0,0,19,0.3333333333333333,14.740116356910058,6
2020-05-18-170118,170118,1,0,0,20,5.833333333333332,14.135705227182836,0
2020-05-19-170118,170118,0,0,0,20,0.8333333333333334,16.424163470976826,1
2020-05-20-170118,170118,0,0,0,20,1.1666666666666667,15.690340731720653,2
2020-05-21-170118,170118,0,0,0,20,1.6666666666666667,15.100712346428525,3
2020-05-22-170118,170118,0,0,0,20,1.0,15.628745646974682,4
2020-05-23-170118,170118,0,0,0,20,0.6666666666666666,21.273178629589516,5
2020-05-24-170118,170118,0,0,0,20,0.6666666666666666,22.42881875144778,6
2020-05-25-170118,170118,0,0,0,20,1.1666666666666667,13.95070872856966,0
2020-05-26-170118,170118,0,0,0,20,1.8333333333333333,15.359241018968264,1
2020-05-27-170118,170118,1,0,0,21,1.6666666666666667,15.702958487757803,2
2020-05-28-170118,170118,0,1,0,21,1.3333333333333333,18.16052244042058,3
2020-05-29-170118,170118,0,0,0,21,0.6666666666666666,18.30518669473536,4
2020-05-30-170118,170118,0,0,0,21,0.0,16.743478376551028,5
2020-05-31-170118,170118,0,0,0,21,0.0,16.254409790882043,6
2020-06-01-170118,170118,0,0,0,21,0.16666666666666666,26.612668801533445,0
2020-06-02-170118,170118,0,0,0,21,2.6666666666666665,8.743423721103468,1
2020-06-03-170118,170118,0,0,0,21,0.5,9.679039301282945,2
2020-06-04-170118,170118,0,0,1,21,1.0,7.852014047771645,3
2020-06-05-170118,170118,0,0,1,21,1.0,9.267579941331878,4
2020-06-06-170118,170118,0,0,0,21,0.16666666666666666,10.021482213646841,5
2020-06-07-170118,170118,0,0,0,21,0.16666666666666666,9.491386447133562,6
2020-06-08-170118,170118,0,0,0,21,1.0,7.934753492187216,0
2020-06-09-170118,170118,0,0,0,21,0.5,8.792810631990491,1
2020-06-10-170118,170118,0,0,0,21,1.1666666666666667,26.83802694094457,2
2020-06-11-170118,170118,0,0,0,21,0.3333333333333333,22.725528143420412,3
2020-06-12-170118,170118,0,0,0,21,0.6666666666666666,20.56360437201026,4
2020-06-13-170118,170118,0,0,0,21,0.16666666666666666,16.554829286339096,5
2020-06-14-170118,170118,0,0,0,21,0.0,12.641503979016667,6
2020-06-15-170118,170118,0,0,0,21,0.6666666666666666,7.194221929690814,0
2020-06-16-170118,170118,0,0,0,21,1.3333333333333333,7.687751478777576,1
2020-06-17-170118,170118,0,0,0,21,0.8333333333333334,8.877691789510898,2
2020-06-18-170118,170118,1,0,0,22,0.6666666666666666,8.114385047218317,3
2020-06-19-170118,170118,1,0,0,23,1.6666666666666667,8.423932679610513,4
2020-06-20-170118,170118,0,0,0,23,0.3333333333333333,14.045211921691982,5
2020-06-21-170118,170118,0,0,0,23,0.3333333333333333,14.610180291161816,6
2020-06-22-170118,170118,0,0,0,23,0.6666666666666666,14.031356346908497,0
2020-06-23-170118,170118,0,0,0,23,1.0,13.677895859329407,1
2020-06-24-170118,170118,0,0,0,23,0.8333333333333334,15.592382212370692,2
2020-06-25-170118,170118,0,1,0,23,0.6666666666666666,16.540858816437293,3
2020-06-26-170118,170118,0,0,0,23,0.6666666666666666,15.148644563320127,4
2020-06-27-170118,170118,0,0,0,23,0.3333333333333333,10.815547525874363,5
2020-06-28-170118,170118,0,0,0,23,0.6666666666666666,11.500328787045074,6
2020-06-29-170118,170118,0,0,0,23,0.5,12.695928687196792,0
2020-06-30-170118,170118,0,0,0,23,0.5,10.972977873512065,1
2020-07-01-170118,170118,0,0,0,23,0.5,10.768533066449564,2
2020-07-02-170118,170118,0,0,0,23,0.16666666666666666,7.800821787921205,3
2020-07-03-170118,170118,0,0,0,23,0.16666666666666666,5.405258099649328,4
2020-07-04-170118,170118,0,0,0,23,0.3333333333333333,6.088660452825458,5
2020-07-05-170118,170118,0,0,0,23,0.0,6.011677954181023,6
2020-07-06-170118,170118,0,0,0,23,0.5,6.169384806189175,0
2020-07-07-170118,170118,0,0,0,23,0.5,7.021573344069278,1
2020-07-08-170118,170118,0,0,0,23,0.3333333333333333,6.8010862717569305,2
2020-07-09-170118,170118,0,0,0,23,0.8333333333333334,7.222612424240546,3
2020-07-10-170118,170118,0,0,0,23,0.3333333333333333,11.47733787369677,4
2020-07-11-170118,170118,0,0,0,23,0.16666666666666666,9.622755994468122,5
2020-07-12-170118,170118,0,0,0,23,0.16666666666666666,9.02803864831736,6
2020-07-13-170118,170118,0,0,0,23,0.16666666666666666,8.676988185377724,0
2020-07-14-170118,170118,0,0,0,23,0.0,10.070599328634916,1
2020-07-15-170118,170118,0,0,0,23,0.0,9.08375190943248,2
2020-07-16-170118,170118,0,0,0,23,0.5,8.067885275786448,3
2020-07-17-170118,170118,0,0,1,23,0.16666666666666666,7.181141913060658,4
2020-07-18-170118,170118,0,0,0,23,0.16666666666666666,7.233005210795957,5
2020-07-19-170118,170118,0,0,0,23,0.0,5.929466342668402,6
2020-07-20-170118,170118,0,0,0,23,0.0,7.159849774253681,0
2020-07-21-170118,170118,0,0,0,23,0.0,7.610754913338228,1
2020-07-22-170118,170118,0,0,1,23,0.16666666666666666,7.15316703874808,2
2020-07-23-170118,170118,0,0,0,23,0.16666666666666666,6.778170047814977,3
2020-07-24-170118,170118,0,0,0,23,0.16666666666666666,7.124747550385948,4
2020-07-25-170118,170118,0,0,0,23,0.0,7.3117952315187305,5
2020-07-26-170118,170118,0,0,0,23,0.0,5.428236662015321,6
2020-07-27-170118,170118,0,0,1,23,0.0,5.270029398842992,0
2020-07-28-170118,170118,0,0,0,23,0.0,4.641055343762773,1
2020-07-29-170118,170118,0,0,0,23,0.5,4.420237942932564,2
2020-07-30-170118,170118,0,0,0,23,0.3333333333333333,4.099438563376571,3
2020-07-31-170118,170118,1,0,0,24,0.5,4.445561409105354,4
2020-08-01-170118,170118,0,0,0,24,0.16666666666666666,7.753968673018873,5
2020-08-02-170118,170118,0,0,0,24,0.16666666666666666,28.11508855156363,6
2020-08-03-170118,170118,0,0,0,24,0.5,49.82727910217653,0
2020-08-04-170118,170118,0,0,0,24,0.3333333333333333,32.83950060426125,1
2020-08-05-170118,170118,1,1,0,25,0.16666666666666666,29.291789605760663,2
2020-08-06-170118,170118,0,0,0,25,0.3333333333333333,26.318127116270517,3
2020-08-07-170118,170118,0,0,0,25,0.3333333333333333,20.29391486802948,4
2020-08-08-170118,170118,0,0,1,25,0.0,16.711644004002654,5
2020-08-09-170118,170118,0,0,0,25,0.16666666666666666,15.36950323747818,6
2020-08-10-170118,170118,1,0,1,26,0.8333333333333334,6.583860038475799,0
2020-08-11-170118,170118,0,0,4,26,2.1666666666666665,8.673773754006692,1
2020-08-12-170118,170118,0,0,0,26,2.333333333333333,12.526716868333168,2
2020-08-13-170118,170118,0,0,2,26,1.5,16.0245788657944,3
2020-08-14-170118,170118,0,0,0,26,2.333333333333333,17.431206405753795,4
2020-08-15-170118,170118,0,0,0,26,1.8333333333333333,20.97811304236682,5
2020-08-16-170118,170118,0,0,0,26,0.5,24.17228207141215,6
2020-08-17-170118,170118,0,0,0,26,1.0,24.41567342045298,0
2020-08-18-170118,170118,0,0,0,26,2.0,24.683580448936375,1
2020-08-19-170118,170118,0,0,0,26,2.1666666666666665,25.394375702326446,2
2020-08-20-170118,170118,0,0,0,26,1.8333333333333333,26.253717867904438,3
2020-08-21-170118,170118,0,0,0,26,4.0,26.042755707346103,4
2020-08-22-170118,170118,1,0,0,27,1.0,31.81813099617858,5
2020-08-23-170118,170118,0,0,0,27,1.1666666666666667,34.406966820798786,6
2020-08-24-170118,170118,1,0,0,28,2.333333333333333,34.5780460220708,0
2020-08-25-170118,170118,4,0,0,32,4.0,39.00419440543585,1
2020-08-26-170118,170118,0,0,0,32,4.333333333333333,42.88388169556577,2
2020-08-27-170118,170118,2,0,1,34,3.6666666666666665,47.49367844546916,3
2020-08-28-170118,170118,0,0,1,34,4.5,49.04273762512622,4
2020-08-29-170118,170118,0,0,0,34,2.1666666666666665,45.22611344843183,5
2020-08-30-170118,170118,0,0,0,34,1.6666666666666667,45.90256403070237,6
2020-08-31-170118,170118,0,0,1,34,2.6666666666666665,38.359156922825775,0
2020-09-01-170118,170118,0,0,1,34,3.333333333333333,12.891938107574228,1
2020-09-02-170118,170118,0,0,4,34,2.0,40.66453222019831,2
2020-09-03-170118,170118,0,0,0,34,1.5,45.83114007186633,3
2020-09-04-170118,170118,0,0,0,34,3.6666666666666665,36.13463674743153,4
2020-09-05-170118,170118,0,0,3,34,2.833333333333333,33.12639377976828,5
2020-09-06-170118,170118,0,0,0,34,2.1666666666666665,31.094240065598537,6
2020-09-07-170118,170118,0,0,1,34,3.0,32.258799467454665,0
2020-09-08-170118,170118,0,0,1,34,1.8333333333333333,32.213095567302126,1
2020-09-09-170118,170118,0,0,0,34,1.5,33.792827612591566,2
2020-09-10-170118,170118,1,0,0,35,2.6666666666666665,11.88308405171459,3
2020-09-11-170118,170118,1,0,0,36,5.833333333333332,14.555435250639304,4
2020-09-12-170118,170118,0,0,0,36,1.1666666666666667,21.13805957314043,5
2020-09-13-170118,170118,0,0,0,36,2.6666666666666665,21.093808880327558,6
2020-09-14-170118,170118,1,0,0,37,3.5,21.956231308396305,0
2020-09-15-170118,170118,1,0,0,38,2.333333333333333,27.950828453564768,1
2020-09-16-170118,170118,4,0,0,42,2.333333333333333,30.753028557566914,2
2020-09-17-170118,170118,0,0,0,42,3.0,33.434029546752946,3
2020-09-18-170118,170118,0,0,0,42,13.833333333333336,35.47980573473423,4
2020-09-19-170118,170118,3,0,0,45,4.833333333333333,25.410170279383475,5
2020-09-20-170118,170118,0,0,0,45,4.666666666666667,30.411849544782974,6
2020-09-21-170118,170118,1,0,0,46,3.0,27.446843059256047,0
2020-09-22-170118,170118,1,1,0,47,2.6666666666666665,27.562021219466754,1
2020-09-23-170118,170118,0,0,0,47,4.333333333333333,27.33620546294303,2
2020-09-24-170118,170118,0,1,0,47,5.0,29.40138711815194,3
2020-09-25-170118,170118,0,0,1,47,3.8333333333333335,32.96231077737773,4
2020-09-26-170118,170118,0,0,0,47,1.5,43.81057217274795,5
2020-09-27-170118,170118,0,0,0,47,1.5,43.89879269946763,6
2020-09-28-170118,170118,0,0,0,47,2.6666666666666665,41.486084828207055,0
2020-09-29-170118,170118,0,0,1,47,1.1666666666666667,42.81052623767198,1
2020-09-30-170118,170118,0,0,0,47,3.6666666666666665,36.70827151869471,2
2020-10-01-170118,170118,0,0,1,47,4.666666666666667,0.0,3
2020-10-02-170118,170118,0,0,0,47,4.833333333333333,38.632103987401436,4
2020-10-03-170118,170118,0,0,0,47,2.333333333333333,88.95967255730301,5
2020-10-04-170118,170118,0,1,0,47,2.833333333333333,88.46580680231963,6
2020-10-05-170118,170118,0,0,0,47,3.5,82.03735783097449,0
2020-10-06-170118,170118,0,0,0,47,3.1666666666666665,75.62457205932856,1
2020-10-07-170118,170118,0,0,0,47,3.6666666666666665,67.61731086180421,2
2020-10-08-170118,170118,0,1,0,47,1.6666666666666667,53.47489968411746,3
2020-10-09-170118,170118,1,0,1,48,4.166666666666667,52.956958347036974,4
2020-10-10-170118,170118,0,0,0,48,2.333333333333333,7.50451578149777,5
2020-10-11-170118,170118,0,0,0,48,0.3333333333333333,11.696366149271956,6
2020-10-12-170118,170118,0,0,1,48,1.6666666666666667,13.624507582016715,0
2020-10-13-170118,170118,1,0,0,49,3.8333333333333335,16.05417200354412,1
2020-10-14-170118,170118,0,0,0,49,4.0,22.29683024226679,2
2020-10-15-170118,170118,1,0,1,50,2.5,27.54080450886412,3
2020-10-16-170118,170118,0,0,0,50,5.5,30.331378291523798,4
2020-10-17-170118,170118,0,0,0,50,3.333333333333333,26.13412477753564,5
2020-10-18-170118,170118,0,0,0,50,3.0,29.65916428912373,6
2020-10-19-170118,170118,0,0,1,50,7.666666666666668,31.12579550440529,0
2020-10-20-170118,170118,0,0,0,50,4.333333333333333,37.879621701283675,1
2020-10-21-170118,170118,0,0,0,50,5.166666666666667,41.091058831435724,2
2020-10-22-170118,170118,0,0,0,50,6.5,45.32786457972847,3
2020-10-23-170118,170118,1,0,1,51,8.0,51.07669365964844,4
2020-10-24-170118,170118,0,0,0,51,5.833333333333332,53.20418106307349,5
2020-10-25-170118,170118,0,0,0,51,7.166666666666668,60.84453490959911,6
2020-10-26-170118,170118,1,0,2,52,7.5,62.77755428092148,0
2020-10-27-170118,170118,0,0,1,52,7.166666666666668,65.35408221795943,1
2020-10-28-170118,170118,0,0,1,52,7.666666666666668,69.80990105670598,2
2020-10-29-170118,170118,1,0,3,53,10.333333333333334,76.79335086521809,3
2020-10-30-170118,170118,0,0,4,53,8.666666666666666,81.17023025569878,4
2020-10-31-170118,170118,0,0,0,53,4.166666666666667,87.68908208340574,5
2020-11-01-170118,170118,0,0,0,53,4.0,43.64167081514559,6
2020-11-02-170118,170118,1,0,0,54,2.333333333333333,49.99981579819755,0
2020-11-03-170118,170118,0,0,0,54,5.833333333333332,44.693618971002294,1
2020-11-04-170118,170118,0,0,0,54,8.0,50.28831813771876,2
2020-11-05-170118,170118,0,0,0,54,7.0,50.86672765737996,3
2020-11-06-170118,170118,1,0,0,55,10.333333333333334,50.775664621464955,4
2020-11-07-170118,170118,0,0,0,55,3.8333333333333335,52.66002727832447,5
2020-11-08-170118,170118,0,0,0,55,2.6666666666666665,55.43146025271756,6
2020-11-09-170118,170118,2,0,0,57,5.333333333333333,54.68402697778173,0
2020-11-10-170118,170118,1,1,0,58,5.0,39.77978269050509,1
2020-11-11-170118,170118,1,0,0,59,3.8333333333333335,41.88421648545327,2
2020-11-12-170118,170118,3,0,0,62,6.0,43.58614156166723,3
2020-11-13-170118,170118,4,0,0,66,5.333333333333333,48.256090125673076,4
2020-03-01-170119,170119,0,0,0,0,0.0,0.0,6
2020-03-02-170119,170119,0,0,2,0,0.0,13.193934036294419,0
2020-03-03-170119,170119,0,0,2,0,0.0,68.13892452862586,1
2020-03-04-170119,170119,0,0,1,0,0.0,92.38310614675095,2
2020-03-05-170119,170119,1,2,1,1,0.0,91.58890162995546,3
2020-03-06-170119,170119,0,0,1,1,0.0,94.7934022579309,4
2020-03-07-170119,170119,0,0,0,1,0.0,95.59660391704168,5
2020-03-08-170119,170119,0,1,0,1,0.0,87.21590052766526,6
2020-03-09-170119,170119,0,0,3,1,0.0,87.80911195016415,0
2020-03-10-170119,170119,0,0,3,1,0.0,550.6601097315358,1
2020-03-11-170119,170119,0,0,2,1,0.5,402.5167048194729,2
2020-03-12-170119,170119,0,0,6,1,1.0,244.28382338399814,3
2020-03-13-170119,170119,0,0,4,1,1.5,126.42627577317873,4
2020-03-14-170119,170119,0,0,3,1,0.5,64.82372282313256,5
2020-03-15-170119,170119,0,0,3,1,0.25,43.38510744906936,6
2020-03-16-170119,170119,2,0,2,3,3.0,13.100878508497374,0
2020-03-17-170119,170119,2,0,4,5,1.5,34.01022301279896,1
2020-03-18-170119,170119,1,0,7,6,5.75,51.36230210837823,2
2020-03-19-170119,170119,1,1,15,7,7.0,67.19138307037834,3
2020-03-20-170119,170119,1,1,6,8,5.25,80.60905225387138,4
2020-03-21-170119,170119,0,0,6,8,1.0,92.81129759425295,5
2020-03-22-170119,170119,0,0,1,8,1.25,92.24083324792821,6
2020-03-23-170119,170119,3,0,8,11,7.5,79.66897089146364,0
2020-03-24-170119,170119,3,0,12,14,4.25,97.38826174867704,1
2020-03-25-170119,170119,2,0,9,16,4.5,97.45756982050045,2
2020-03-26-170119,170119,6,0,0,22,5.25,99.6161061886634,3
2020-03-27-170119,170119,4,0,11,26,3.25,143.06228661259385,4
2020-03-28-170119,170119,3,0,1,29,1.25,152.87200182925943,5
2020-03-29-170119,170119,3,0,0,32,1.75,163.60963217642575,6
2020-03-30-170119,170119,2,0,6,34,4.75,144.7402722962877,0
2020-03-31-170119,170119,4,0,3,38,5.25,145.61734098425774,1
2020-04-01-170119,170119,7,0,2,45,5.75,36.51036449499953,2
2020-04-02-170119,170119,15,0,2,60,6.0,128.42344032234612,3
2020-04-03-170119,170119,6,0,5,66,2.75,96.99809847823326,4
2020-04-04-170119,170119,6,0,0,72,0.75,127.94755975984475,5
2020-04-05-170119,170119,1,0,1,73,1.5,145.7861074853813,6
2020-04-06-170119,170119,8,0,4,81,5.0,155.26229109544778,0
2020-04-07-170119,170119,12,1,5,93,3.0,172.04440959807079,1
2020-04-08-170119,170119,9,0,1,102,2.0,242.4707687129412,2
2020-04-09-170119,170119,0,2,0,102,4.25,270.93158870554544,3
2020-04-10-170119,170119,11,0,2,113,12.5,55.49526213898578,4
2020-04-11-170119,170119,1,0,1,114,0.75,154.18353147323805,5
2020-04-12-170119,170119,0,0,0,114,2.5,159.08265570580312,6
2020-04-13-170119,170119,6,0,5,120,5.75,161.74557099713064,0
2020-04-14-170119,170119,3,0,0,123,5.5,205.46120756994836,1
2020-04-15-170119,170119,2,0,5,125,1.75,227.66604694984142,2
2020-04-16-170119,170119,2,0,2,127,3.5,243.03350768018012,3
2020-04-17-170119,170119,5,0,0,132,3.0,211.45571552226423,4
2020-04-18-170119,170119,0,0,0,132,0.5,145.92202573621253,5
2020-04-19-170119,170119,1,0,0,133,1.5,136.70263613357108,6
2020-04-20-170119,170119,4,0,2,137,4.0,196.7508838419743,0
2020-04-21-170119,170119,5,0,0,142,2.75,209.9173581482356,1
2020-04-22-170119,170119,1,0,1,143,2.0,231.35839376844612,2
2020-04-23-170119,170119,0,0,1,143,0.0,224.35407780395954,3
2020-04-24-170119,170119,2,0,18,145,3.25,191.40478932568442,4
2020-04-25-170119,170119,1,0,2,146,2.75,213.95353028363553,5
2020-04-26-170119,170119,0,0,0,146,0.5,226.8895575676949,6
2020-04-27-170119,170119,5,1,0,151,3.5,119.2067420443037,0
2020-04-28-170119,170119,0,0,3,151,1.5,122.79539484141355,1
2020-04-29-170119,170119,5,0,3,156,2.0,89.9045910461456,2
2020-04-30-170119,170119,2,0,2,158,0.75,152.45312408014905,3
2020-05-01-170119,170119,0,0,2,158,0.5,249.71468712959827,4
2020-05-02-170119,170119,0,0,0,158,1.75,57.92223840086651,5
2020-05-03-170119,170119,0,0,1,158,1.5,118.50454144445798,6
2020-05-04-170119,170119,2,0,1,160,1.5,103.94597657621371,0
2020-05-05-170119,170119,0,0,0,160,1.0,97.50059717372608,1
2020-05-06-170119,170119,1,0,1,161,2.0,96.24982022163344,2
2020-05-07-170119,170119,1,0,2,162,2.0,32.576967913573505,3
2020-05-08-170119,170119,18,0,3,180,2.75,46.39116674815744,4
2020-05-09-170119,170119,2,0,0,182,1.5,148.48817444015725,5
2020-05-10-170119,170119,0,0,0,182,1.0,248.4772884802932,6
2020-05-11-170119,170119,0,0,4,182,3.25,218.3424611505315,0
2020-05-12-170119,170119,3,0,3,185,2.75,215.42152716207912,1
2020-05-13-170119,170119,3,0,1,188,0.25,180.3639859139749,2
2020-05-14-170119,170119,2,0,14,190,0.5,123.24683587763394,3
2020-05-15-170119,170119,2,0,0,192,1.25,78.25388550817155,4
2020-05-16-170119,170119,0,1,1,192,0.0,74.24112755140476,5
2020-05-17-170119,170119,1,0,0,193,0.25,70.78018353137024,6
2020-05-18-170119,170119,1,0,2,194,2.0,71.66771142180264,0
2020-05-19-170119,170119,0,0,4,194,1.25,72.33015006653895,1
2020-05-20-170119,170119,1,0,3,195,0.5,43.863936484927194,2
2020-05-21-170119,170119,2,0,0,197,1.0,40.17157204486537,3
2020-05-22-170119,170119,3,1,1,200,1.75,38.64532332569274,4
2020-05-23-170119,170119,0,0,2,200,0.25,57.77201113123019,5
2020-05-24-170119,170119,0,0,0,200,0.25,53.506204777531586,6
2020-05-25-170119,170119,4,0,1,204,0.5,44.94784941328611,0
2020-05-26-170119,170119,3,0,1,207,1.0,63.61939587277913,1
2020-05-27-170119,170119,1,0,1,208,0.5,75.63337506750429,2
2020-05-28-170119,170119,14,0,2,222,1.25,75.21650734348059,3
2020-05-29-170119,170119,0,2,0,222,0.25,137.7705030366314,4
2020-05-30-170119,170119,1,0,0,223,0.0,128.0704953939176,5
2020-05-31-170119,170119,0,1,1,223,0.5,137.66554065025136,6
2020-06-01-170119,170119,2,0,0,225,0.5,169.88045344920727,0
2020-06-02-170119,170119,4,1,1,229,1.5,85.03009394680417,1
2020-06-03-170119,170119,3,0,5,232,0.75,21.405362790564475,2
2020-06-04-170119,170119,0,0,6,232,0.5,37.71841008544864,3
2020-06-05-170119,170119,1,1,0,233,0.0,31.52418778790741,4
2020-06-06-170119,170119,2,0,0,235,0.0,35.799387876945225,5
2020-06-07-170119,170119,0,0,4,235,0.0,39.127270874320565,6
2020-06-08-170119,170119,1,0,1,236,2.0,38.7042391338747,0
2020-06-09-170119,170119,1,0,0,237,0.25,43.679985767441295,1
2020-06-10-170119,170119,1,0,0,238,0.25,173.61396605862157,2
2020-06-11-170119,170119,2,0,1,240,0.25,174.61087934984897,3
2020-06-12-170119,170119,0,0,0,240,1.0,188.9135691127172,4
2020-06-13-170119,170119,0,0,1,240,0.0,176.9114121426227,5
2020-06-14-170119,170119,1,0,0,241,0.25,164.46551583697774,6
2020-06-15-170119,170119,0,0,1,241,0.75,55.901832942027724,0
2020-06-16-170119,170119,1,0,0,242,0.75,38.31877241457336,1
2020-06-17-170119,170119,5,0,0,247,0.75,32.71125518246612,2
2020-06-18-170119,170119,6,0,1,253,0.75,60.22449140776476,3
2020-06-19-170119,170119,0,0,0,253,0.0,95.06830704208609,4
2020-06-20-170119,170119,0,0,0,253,0.75,124.04733783803219,5
2020-06-21-170119,170119,4,0,0,257,0.0,124.16566839108279,6
2020-06-22-170119,170119,1,0,0,258,0.25,150.49779155971618,0
2020-06-23-170119,170119,0,0,0,258,0.25,151.95948475134193,1
2020-06-24-170119,170119,0,0,0,258,0.5,117.02722758329985,2
2020-06-25-170119,170119,1,1,1,259,0.0,74.42771179799941,3
2020-06-26-170119,170119,0,0,1,259,0.5,82.81478224025687,4
2020-06-27-170119,170119,1,0,0,260,0.25,54.22954194845868,5
2020-06-28-170119,170119,0,0,1,260,0.25,61.70253372424705,6
2020-06-29-170119,170119,1,0,0,261,0.0,31.4080147007576,0
2020-06-30-170119,170119,0,0,1,261,0.25,56.637869316526235,1
2020-07-01-170119,170119,0,0,0,261,1.25,51.16637808233428,2
2020-07-02-170119,170119,1,0,0,262,0.5,20.803258045421238,3
2020-07-03-170119,170119,0,0,0,262,0.5,17.032988161634343,4
2020-07-04-170119,170119,0,0,0,262,0.0,17.50103788598507,5
2020-07-05-170119,170119,0,0,0,262,0.0,9.442552244529107,6
2020-07-06-170119,170119,0,0,0,262,0.5,7.845975395857657,0
2020-07-07-170119,170119,0,0,0,262,0.0,8.864538685530624,1
2020-07-08-170119,170119,0,2,0,262,0.0,8.98870994410256,2
2020-07-09-170119,170119,1,0,0,263,0.25,7.552042724844377,3
2020-07-10-170119,170119,1,0,0,264,1.0,52.86253887739021,4
2020-07-11-170119,170119,0,0,0,264,0.5,61.407248447116146,5
2020-07-12-170119,170119,1,0,1,265,0.0,54.679744359916135,6
2020-07-13-170119,170119,0,0,0,265,1.5,46.79139029590584,0
2020-07-14-170119,170119,1,0,0,266,0.25,50.010544252820345,1
2020-07-15-170119,170119,0,0,0,266,0.5,44.54912092500764,2
2020-07-16-170119,170119,0,0,0,266,0.25,36.70470621066855,3
2020-07-17-170119,170119,0,1,0,266,0.75,34.70797023065142,4
2020-07-18-170119,170119,0,0,0,266,0.5,27.214530814933386,5
2020-07-19-170119,170119,0,0,0,266,0.0,27.80911918757107,6
2020-07-20-170119,170119,0,0,0,266,0.75,26.503898328169626,0
2020-07-21-170119,170119,0,0,0,266,0.25,19.40039591967959,1
2020-07-22-170119,170119,0,0,0,266,0.75,20.92047919759359,2
2020-07-23-170119,170119,0,0,0,266,0.5,21.655887615830153,3
2020-07-24-170119,170119,0,0,1,266,0.5,22.25489036933927,4
2020-07-25-170119,170119,0,0,0,266,0.25,20.77033937593869,5
2020-07-26-170119,170119,1,0,0,267,0.0,21.08541252014645,6
2020-07-27-170119,170119,0,1,0,267,0.5,19.641313607104756,0
2020-07-28-170119,170119,0,0,3,267,0.25,19.521768127426512,1
2020-07-29-170119,170119,0,0,2,267,0.0,18.187505512674974,2
2020-07-30-170119,170119,0,0,4,267,0.75,13.96473315599503,3
2020-07-31-170119,170119,0,0,0,267,0.75,15.773112974519048,4
2020-08-01-170119,170119,0,0,0,267,0.0,14.403990614305904,5
2020-08-02-170119,170119,0,0,1,267,0.0,139.0527162386697,6
2020-08-03-170119,170119,0,0,1,267,1.0,159.92843407098934,0
2020-08-04-170119,170119,0,0,0,267,0.75,137.90817343196022,1
2020-08-05-170119,170119,0,0,1,267,1.25,117.5429109869369,2
2020-08-06-170119,170119,0,0,2,267,1.75,77.22656647222419,3
2020-08-07-170119,170119,1,0,4,268,1.0,69.78288898615065,4
2020-08-08-170119,170119,0,0,0,268,2.5,68.76664772526456,5
2020-08-09-170119,170119,0,0,1,268,0.75,77.28911033387318,6
2020-08-10-170119,170119,0,0,2,268,2.0,12.36637377115246,0
2020-08-11-170119,170119,3,0,2,271,2.0,22.39073579042803,1
2020-08-12-170119,170119,2,0,2,273,2.0,62.03302711211147,2
2020-08-13-170119,170119,4,0,4,277,3.0,94.62584609198498,3
2020-08-14-170119,170119,0,0,1,277,4.75,146.71491768679766,4
2020-08-15-170119,170119,0,0,1,277,1.25,184.48248234680136,5
2020-08-16-170119,170119,1,0,1,278,0.75,180.51628118606328,6
2020-08-17-170119,170119,1,0,1,279,2.0,189.90825374247436,0
2020-08-18-170119,170119,0,0,0,279,1.5,195.86449851375903,1
2020-08-19-170119,170119,1,0,0,280,2.0,163.84308179264113,2
2020-08-20-170119,170119,2,0,0,282,1.5,94.86726122171515,3
2020-08-21-170119,170119,4,0,4,286,1.75,87.5530735693987,4
2020-08-22-170119,170119,0,0,10,286,1.0,118.08698195488424,5
2020-08-23-170119,170119,1,0,6,287,1.25,111.96316736609808,6
2020-08-24-170119,170119,2,0,0,289,1.25,105.4899333497557,0
2020-08-25-170119,170119,2,0,5,291,1.5,117.91404345421911,1
2020-08-26-170119,170119,2,0,3,293,2.75,122.58122524514101,2
2020-08-27-170119,170119,4,0,3,297,2.0,143.14222669551657,3
2020-08-28-170119,170119,1,0,0,298,1.75,160.96357636556291,4
2020-08-29-170119,170119,1,0,2,299,2.25,139.35013316816352,5
2020-08-30-170119,170119,1,0,0,300,1.25,139.98517809146273,6
2020-08-31-170119,170119,1,0,2,301,2.0,131.98132973691722,0
2020-09-01-170119,170119,0,0,2,301,1.0,56.60209425791663,1
2020-09-02-170119,170119,0,0,3,301,1.75,118.93841315477718,2
2020-09-03-170119,170119,0,0,0,301,3.25,361.7115110720561,3
2020-09-04-170119,170119,4,0,7,305,4.25,210.64150309530433,4
2020-09-05-170119,170119,10,0,0,315,0.25,194.07173537608224,5
2020-09-06-170119,170119,6,0,6,321,1.75,238.12443956703055,6
2020-09-07-170119,170119,0,0,5,321,2.0,281.70657992948225,0
2020-09-08-170119,170119,5,0,5,326,3.25,250.63975019092408,1
2020-09-09-170119,170119,3,0,13,329,2.75,260.1220791598862,2
2020-09-10-170119,170119,3,0,8,332,1.5,38.40340755591345,3
2020-09-11-170119,170119,0,0,10,332,2.0,61.77349217985079,4
2020-09-12-170119,170119,2,0,4,334,0.25,66.3275815697269,5
2020-09-13-170119,170119,0,0,0,334,0.25,77.7443847621362,6
2020-09-14-170119,170119,2,0,4,336,4.25,68.39830184850881,0
2020-09-15-170119,170119,2,0,3,338,1.5,84.58681489047264,1
2020-09-16-170119,170119,3,0,4,341,2.25,103.18331497414935,2
2020-09-17-170119,170119,0,0,6,341,2.75,127.25605258924264,3
2020-09-18-170119,170119,7,0,4,348,3.5,111.70644802477055,4
2020-09-19-170119,170119,0,0,0,348,1.75,115.3185009768589,5
2020-09-20-170119,170119,6,0,5,354,0.5,102.76481165085143,6
2020-09-21-170119,170119,5,0,3,359,1.75,120.98912979165247,0
2020-09-22-170119,170119,5,0,5,364,1.75,141.07832424249898,1
2020-09-23-170119,170119,13,1,0,377,3.5,156.43521428559015,2
2020-09-24-170119,170119,8,0,4,385,4.25,245.7510425616255,3
2020-09-25-170119,170119,10,1,1,395,3.0,296.60371890340997,4
2020-09-26-170119,170119,4,0,0,399,1.0,341.54778913128996,5
2020-09-27-170119,170119,0,0,1,399,0.75,365.0358054411115,6
2020-09-28-170119,170119,4,0,1,403,1.75,322.52965029697583,0
2020-09-29-170119,170119,3,0,5,406,2.0,315.97576545614623,1
2020-09-30-170119,170119,4,0,3,410,4.0,216.56578297623446,2
2020-10-01-170119,170119,6,0,3,416,2.5,0.0,3
2020-10-02-170119,170119,4,0,1,420,3.0,124.34956945219332,4
2020-10-03-170119,170119,0,1,1,420,1.0,351.84716477812105,5
2020-10-04-170119,170119,5,1,2,425,0.25,406.0877058224487,6
2020-10-05-170119,170119,3,1,2,428,1.0,367.0758112257396,0
2020-10-06-170119,170119,5,0,5,433,1.5,321.58431660599706,1
2020-10-07-170119,170119,0,0,0,433,2.0,308.38322144130296,2
2020-10-08-170119,170119,4,0,3,437,1.0,267.8939428326577,3
2020-10-09-170119,170119,1,0,9,438,2.75,305.4581578862942,4
2020-10-10-170119,170119,0,0,2,438,0.75,49.113445536108145,5
2020-10-11-170119,170119,1,0,4,439,0.5,50.76749017580403,6
2020-10-12-170119,170119,1,0,10,440,2.0,59.503248905146314,0
2020-10-13-170119,170119,5,0,9,445,1.25,70.60206116156638,1
2020-10-14-170119,170119,3,0,7,448,3.0,106.48575133469102,2
2020-10-15-170119,170119,3,0,9,451,0.75,119.86897796328337,3
2020-10-16-170119,170119,1,0,17,452,1.5,136.57586942647606,4
2020-10-17-170119,170119,1,0,5,453,0.75,97.77276351952318,5
2020-10-18-170119,170119,2,0,21,455,0.75,102.74697265885946,6
2020-10-19-170119,170119,2,1,3,457,3.25,109.01025164720042,0
2020-10-20-170119,170119,5,0,7,462,1.25,122.08951754041854,1
2020-10-21-170119,170119,0,1,21,462,3.75,139.84582311882048,2
2020-10-22-170119,170119,3,0,22,465,3.25,139.76063859450002,3
2020-10-23-170119,170119,9,0,14,474,3.5,159.9555953808289,4
2020-10-24-170119,170119,2,0,8,476,0.75,213.0630155616566,5
2020-10-25-170119,170119,4,0,2,480,3.5,211.92905811796447,6
2020-10-26-170119,170119,10,1,3,490,3.25,228.42546145854476,0
2020-10-27-170119,170119,9,0,5,499,1.0,266.8722894366463,1
2020-10-28-170119,170119,7,1,5,506,3.5,300.1392394624054,2
2020-10-29-170119,170119,9,0,7,515,6.25,338.76394970885843,3
2020-10-30-170119,170119,17,0,7,532,4.75,299.2127920174644,4
2020-10-31-170119,170119,5,1,0,537,2.0,408.8929681532349,5
2020-11-01-170119,170119,21,0,0,558,2.5,214.56689776005635,6
2020-11-02-170119,170119,3,0,0,561,0.75,205.3866992062147,0
2020-11-03-170119,170119,7,0,0,568,4.0,142.30087795432132,1
2020-11-04-170119,170119,21,2,0,589,3.75,190.6070175425009,2
2020-11-05-170119,170119,22,1,0,611,6.5,296.119911847144,3
2020-11-06-170119,170119,14,3,0,625,4.75,424.66422023355113,4
2020-11-07-170119,170119,8,1,0,633,1.75,498.17979674706976,5
2020-11-08-170119,170119,2,2,0,635,2.0,527.9857584028565,6
2020-11-09-170119,170119,3,1,0,638,1.75,514.22744958047,0
2020-11-10-170119,170119,5,0,0,643,1.25,305.11818967683485,1
2020-11-11-170119,170119,5,1,0,648,4.25,310.8607804175755,2
2020-11-12-170119,170119,7,0,0,655,3.0,349.2746561606469,3
2020-11-13-170119,170119,7,0,0,662,3.0,381.08486739014694,4
2020-03-01-170120,170120,0,0,0,0,0.0,0.0,6
2020-03-02-170120,170120,0,0,1,0,0.0,7.784541622647161,0
2020-03-03-170120,170120,0,0,0,0,0.25,41.56582230860767,1
2020-03-04-170120,170120,0,0,0,0,0.0,40.559726125797155,2
2020-03-05-170120,170120,0,0,1,0,0.0,44.49610971871408,3
2020-03-06-170120,170120,0,0,3,0,0.0,49.5950306232029,4
2020-03-07-170120,170120,0,0,0,0,0.0,51.051926248235645,5
2020-03-08-170120,170120,0,0,1,0,0.0,51.07768357086605,6
2020-03-09-170120,170120,0,0,6,0,0.0,50.67989698030069,0
2020-03-10-170120,170120,0,0,3,0,0.0,60.76302634713964,1
2020-03-11-170120,170120,0,0,2,0,0.25,51.6314139110561,2
2020-03-12-170120,170120,0,0,0,0,0.0,37.18320704549252,3
2020-03-13-170120,170120,0,0,1,0,0.5,24.149752125797853,4
2020-03-14-170120,170120,0,0,1,0,0.25,17.93979806583056,5
2020-03-15-170120,170120,0,0,2,0,0.25,9.135053630119742,6
2020-03-16-170120,170120,1,0,1,1,1.0,4.9817743048619985,0
2020-03-17-170120,170120,0,0,1,1,0.25,10.117808837082856,1
2020-03-18-170120,170120,0,0,2,1,3.5,15.299948316513952,2
2020-03-19-170120,170120,1,0,4,2,2.5,28.041358045371254,3
2020-03-20-170120,170120,3,0,1,5,1.25,47.48464318053009,4
2020-03-21-170120,170120,0,3,0,5,0.5,60.097685621762935,5
2020-03-22-170120,170120,1,0,0,6,1.0,62.53457093915301,6
2020-03-23-170120,170120,6,0,0,12,6.0,70.97441835294737,0
2020-03-24-170120,170120,3,0,2,15,1.5,99.91415628212151,1
2020-03-25-170120,170120,2,0,1,17,4.25,93.97240477139985,2
2020-03-26-170120,170120,0,0,0,17,2.5,98.96920268037874,3
2020-03-27-170120,170120,1,0,2,18,1.75,110.38888580831699,4
2020-03-28-170120,170120,1,0,0,19,1.0,109.637519252927,5
2020-03-29-170120,170120,2,0,1,21,0.75,107.5456095732529,6
2020-03-30-170120,170120,1,0,2,22,3.0,69.13043512031456,0
2020-03-31-170120,170120,1,0,0,23,3.75,67.53056985434822,1
2020-04-01-170120,170120,2,0,0,25,2.0,16.278449149281197,2
2020-04-02-170120,170120,4,0,0,29,3.5,35.83302185918203,3
2020-04-03-170120,170120,1,0,1,30,1.5,14.204074823527527,4
2020-04-04-170120,170120,0,0,1,30,0.5,22.525540278832537,5
2020-04-05-170120,170120,0,0,1,30,0.25,24.156301093477744,6
2020-04-06-170120,170120,0,0,0,30,4.5,25.78394013700438,0
2020-04-07-170120,170120,2,0,1,32,1.75,34.952011842261,1
2020-04-08-170120,170120,1,5,0,33,1.0,41.486410993442334,2
2020-04-09-170120,170120,0,0,0,33,1.25,42.862447222290555,3
2020-04-10-170120,170120,2,0,0,35,1.5,9.39996305390899,4
2020-04-11-170120,170120,0,0,0,35,0.0,16.077935382186936,5
2020-04-12-170120,170120,1,0,0,36,2.0,17.804128702443325,6
2020-04-13-170120,170120,2,0,0,38,1.25,20.251323402801603,0
2020-04-14-170120,170120,0,0,1,38,4.25,27.546483621777735,1
2020-04-15-170120,170120,0,0,0,38,1.0,34.56484189546837,2
2020-04-16-170120,170120,0,0,0,38,2.25,48.63610855312666,3
2020-04-17-170120,170120,1,0,0,39,0.75,51.7786647473035,4
2020-04-18-170120,170120,1,0,0,40,0.5,50.70697682876383,5
2020-04-19-170120,170120,1,0,0,41,1.25,50.112306180247046,6
2020-04-20-170120,170120,0,1,1,41,2.5,55.89563140040744,0
2020-04-21-170120,170120,1,1,0,42,2.5,56.61557290313043,1
2020-04-22-170120,170120,0,0,0,42,0.5,52.89220134122512,2
2020-04-23-170120,170120,0,0,1,42,0.0,50.70191525115469,3
2020-04-24-170120,170120,0,0,3,42,0.0,43.2793353468032,4
2020-04-25-170120,170120,0,0,0,42,0.0,45.84894573410247,5
2020-04-26-170120,170120,0,0,0,42,0.0,48.6106918324865,6
2020-04-27-170120,170120,0,0,0,42,0.5,33.625692920355434,0
2020-04-28-170120,170120,1,0,0,43,0.25,25.319789703038097,1
2020-04-29-170120,170120,0,0,0,43,1.25,21.836980954602772,2
2020-04-30-170120,170120,0,0,0,43,0.5,34.413996973469466,3
2020-05-01-170120,170120,0,0,0,43,0.0,56.9449537160703,4
2020-05-02-170120,170120,0,0,1,43,1.25,29.27460478713467,5
2020-05-03-170120,170120,0,0,0,43,0.25,16.83607749803371,6
2020-05-04-170120,170120,1,0,0,44,1.0,12.171807290569443,0
2020-05-05-170120,170120,0,0,0,44,0.5,19.221579415551496,1
2020-05-06-170120,170120,0,0,0,44,1.0,24.785975847527794,2
2020-05-07-170120,170120,1,0,0,45,1.25,28.19617035897751,3
2020-05-08-170120,170120,3,0,1,48,1.0,32.66597394200984,4
2020-05-09-170120,170120,0,0,0,48,0.25,41.880024651324476,5
2020-05-10-170120,170120,0,0,0,48,0.5,68.13502848283544,6
2020-05-11-170120,170120,0,0,0,48,1.75,61.56960737089517,0
2020-05-12-170120,170120,0,0,0,48,1.0,59.1055109384289,1
2020-05-13-170120,170120,0,0,0,48,0.25,39.81482616195086,2
2020-05-14-170120,170120,0,0,0,48,0.75,30.372185368208534,3
2020-05-15-170120,170120,0,0,1,48,0.25,22.93590993656559,4
2020-05-16-170120,170120,1,0,0,49,0.0,18.363879325082447,5
2020-05-17-170120,170120,0,0,0,49,0.25,19.779845729234108,6
2020-05-18-170120,170120,0,0,0,49,2.25,19.204779607985344,0
2020-05-19-170120,170120,0,0,0,49,0.25,25.116005970669733,1
2020-05-20-170120,170120,0,0,0,49,1.0,22.389058166139332,2
2020-05-21-170120,170120,0,0,0,49,1.25,23.94770980614002,3
2020-05-22-170120,170120,1,0,0,50,0.75,26.210885899471748,4
2020-05-23-170120,170120,0,0,0,50,0.25,31.3889130182813,5
2020-05-24-170120,170120,0,0,0,50,0.0,32.00535960769417,6
2020-05-25-170120,170120,0,0,0,50,0.5,19.28045839680283,0
2020-05-26-170120,170120,0,0,0,50,0.5,21.713730167126037,1
2020-05-27-170120,170120,0,0,0,50,0.0,23.003730828442304,2
2020-05-28-170120,170120,0,0,0,50,0.75,19.916384235996098,3
2020-05-29-170120,170120,1,0,0,51,0.25,17.747186891823446,4
2020-05-30-170120,170120,0,0,0,51,0.0,17.027022888731228,5
2020-05-31-170120,170120,0,1,0,51,0.0,16.25534619860168,6
2020-06-01-170120,170120,0,0,0,51,0.0,38.52105853240784,0
2020-06-02-170120,170120,0,0,0,51,1.5,8.447147597006309,1
2020-06-03-170120,170120,0,0,0,51,0.25,11.768881496930334,2
2020-06-04-170120,170120,0,0,0,51,0.5,11.140247655990322,3
2020-06-05-170120,170120,0,0,0,51,0.25,10.45050964846571,4
2020-06-06-170120,170120,0,2,0,51,0.0,11.835892193697706,5
2020-06-07-170120,170120,0,0,0,51,0.0,11.993590628444709,6
2020-06-08-170120,170120,0,0,0,51,0.25,11.706508685356479,0
2020-06-09-170120,170120,0,0,1,51,0.75,10.115779082354422,1
2020-06-10-170120,170120,0,0,1,51,0.0,39.97140067141477,2
2020-06-11-170120,170120,0,0,0,51,0.0,32.54315366305436,3
2020-06-12-170120,170120,0,0,0,51,0.5,26.946410697172475,4
2020-06-13-170120,170120,0,0,0,51,0.0,20.69082911607895,5
2020-06-14-170120,170120,0,0,0,51,0.0,15.166192938225409,6
2020-06-15-170120,170120,0,1,0,51,0.25,6.0340855886306075,0
2020-06-16-170120,170120,0,0,0,51,0.5,6.133772371796556,1
2020-06-17-170120,170120,0,0,0,51,0.25,7.108596662692996,2
2020-06-18-170120,170120,0,0,0,51,0.0,7.846705072426902,3
2020-06-19-170120,170120,0,0,0,51,0.25,8.993728498028055,4
2020-06-20-170120,170120,0,0,0,51,0.0,13.75914215665327,5
2020-06-21-170120,170120,0,0,0,51,0.0,14.546622738053362,6
2020-06-22-170120,170120,0,0,0,51,0.25,13.34706672826899,0
2020-06-23-170120,170120,1,0,0,52,0.25,12.979785668273912,1
2020-06-24-170120,170120,1,0,0,53,0.0,13.00288198145579,2
2020-06-25-170120,170120,0,0,0,53,0.25,13.089449199086854,3
2020-06-26-170120,170120,0,0,0,53,0.0,15.040389344620191,4
2020-06-27-170120,170120,0,1,1,53,0.0,12.117997765857165,5
2020-06-28-170120,170120,0,0,0,53,0.25,11.519339112654052,6
2020-06-29-170120,170120,0,0,1,53,1.0,12.208670424151027,0
2020-06-30-170120,170120,0,0,1,53,0.0,14.138677966072969,1
2020-07-01-170120,170120,0,0,0,53,0.5,14.2978265349578,2
2020-07-02-170120,170120,0,1,0,53,0.25,13.429072052959658,3
2020-07-03-170120,170120,0,0,1,53,0.0,10.963311874239064,4
2020-07-04-170120,170120,0,0,0,53,0.0,9.064463952395158,5
2020-07-05-170120,170120,0,0,0,53,0.0,9.339992774403573,6
2020-07-06-170120,170120,0,0,0,53,0.5,6.621629699566359,0
2020-07-07-170120,170120,0,0,0,53,0.5,5.991259211993215,1
2020-07-08-170120,170120,0,0,0,53,0.25,9.121885895911248,2
2020-07-09-170120,170120,0,0,0,53,0.0,9.269415612584329,3
2020-07-10-170120,170120,0,0,0,53,0.5,14.059920973195783,4
2020-07-11-170120,170120,1,0,0,54,0.0,12.857466403527798,5
2020-07-12-170120,170120,0,0,0,54,0.25,11.399865389603084,6
2020-07-13-170120,170120,1,0,0,55,0.25,12.202845468236962,0
2020-07-14-170120,170120,1,0,0,56,0.75,13.779357165106497,1
2020-07-15-170120,170120,0,0,0,56,0.5,14.97628946294817,2
2020-07-16-170120,170120,0,0,0,56,0.0,15.184634176926354,3
2020-07-17-170120,170120,1,0,0,57,0.25,14.800946953531382,4
2020-07-18-170120,170120,0,0,0,57,0.0,15.861290290010347,5
2020-07-19-170120,170120,0,0,0,57,0.0,15.018791991793766,6
2020-07-20-170120,170120,0,0,0,57,0.0,13.879491443780841,0
2020-07-21-170120,170120,0,0,0,57,0.0,10.660649416011143,1
2020-07-22-170120,170120,0,0,0,57,0.5,6.799819066273153,2
2020-07-23-170120,170120,0,0,0,57,0.75,7.276979878934733,3
2020-07-24-170120,170120,0,0,1,57,0.0,8.790311114736111,4
2020-07-25-170120,170120,0,0,0,57,0.0,8.2668842555831,5
2020-07-26-170120,170120,0,0,0,57,0.0,7.9717612975007315,6
2020-07-27-170120,170120,0,0,0,57,0.5,6.822181915109853,0
2020-07-28-170120,170120,0,0,0,57,0.75,9.247945366033237,1
2020-07-29-170120,170120,0,0,0,57,0.5,12.296425441136208,2
2020-07-30-170120,170120,0,0,0,57,0.0,9.006042398233099,3
2020-07-31-170120,170120,0,0,0,57,0.5,9.203321591978064,4
2020-08-01-170120,170120,0,0,0,57,0.0,10.494677428273725,5
2020-08-02-170120,170120,0,0,0,57,0.0,39.285979921386335,6
2020-08-03-170120,170120,0,0,0,57,0.0,44.25506048501167,0
2020-08-04-170120,170120,0,0,0,57,0.25,41.064955364095105,1
2020-08-05-170120,170120,0,0,2,57,1.0,37.21413925476986,2
2020-08-06-170120,170120,0,0,1,57,1.0,38.640275783993054,3
2020-08-07-170120,170120,1,0,0,58,1.75,37.70087511619711,4
2020-08-08-170120,170120,0,0,0,58,0.0,43.32086697155735,5
2020-08-09-170120,170120,0,0,0,58,0.25,46.85062134886195,6
2020-08-10-170120,170120,0,0,0,58,0.75,9.869218855703537,0
2020-08-11-170120,170120,0,0,0,58,2.5,13.69670243171597,1
2020-08-12-170120,170120,0,0,0,58,0.75,28.73327620875221,2
2020-08-13-170120,170120,0,0,0,58,0.75,39.019395736936055,3
2020-08-14-170120,170120,0,0,0,58,1.25,44.49292147392864,4
2020-08-15-170120,170120,0,0,0,58,0.25,56.804634687212385,5
2020-08-16-170120,170120,0,0,1,58,0.25,59.592794432454916,6
2020-08-17-170120,170120,0,0,0,58,0.5,60.90869253108306,0
2020-08-18-170120,170120,0,0,0,58,0.0,65.96282300750696,1
2020-08-19-170120,170120,2,0,0,60,0.25,52.31857195129935,2
2020-08-20-170120,170120,1,0,5,61,0.0,36.12127076408686,3
2020-08-21-170120,170120,0,0,2,61,0.5,31.049023952771723,4
2020-08-22-170120,170120,0,0,0,61,0.25,35.43730230626069,5
2020-08-23-170120,170120,0,0,0,61,0.5,37.325047634009586,6
2020-08-24-170120,170120,0,0,0,61,0.75,29.853052654487676,0
2020-08-25-170120,170120,0,0,0,61,1.0,34.06341782710486,1
2020-08-26-170120,170120,0,0,0,61,0.5,35.8506453524209,2
2020-08-27-170120,170120,0,0,0,61,0.75,40.886537527026334,3
2020-08-28-170120,170120,0,0,1,61,0.25,40.34739823256337,4
2020-08-29-170120,170120,0,0,0,61,1.25,40.72401880085684,5
2020-08-30-170120,170120,1,0,0,62,1.5,43.20235217731568,6
2020-08-31-170120,170120,0,0,0,62,0.5,45.88936942699519,0
2020-09-01-170120,170120,0,0,0,62,0.25,35.879887927084305,1
2020-09-02-170120,170120,0,0,0,62,0.5,62.947820737516736,2
2020-09-03-170120,170120,5,0,1,67,1.0,60.450358053677306,3
2020-09-04-170120,170120,2,0,0,69,1.0,60.56952359066671,4
2020-09-05-170120,170120,0,0,0,69,0.0,57.204590753743325,5
2020-09-06-170120,170120,0,0,0,69,0.75,53.994737512501864,6
2020-09-07-170120,170120,0,0,0,69,0.5,53.06113009023693,0
2020-09-08-170120,170120,0,0,1,69,1.5,51.11628356620592,1
2020-09-09-170120,170120,0,0,3,69,2.25,51.79730124155981,2
2020-09-10-170120,170120,0,0,2,69,0.75,28.84785524441223,3
2020-09-11-170120,170120,1,0,5,70,2.0,32.26917579478126,4
2020-09-12-170120,170120,0,0,5,70,0.0,38.025282479936955,5
2020-09-13-170120,170120,0,0,0,70,0.5,34.00066368706917,6
2020-09-14-170120,170120,0,0,1,70,1.5,29.158679338423482,0
2020-09-15-170120,170120,0,0,2,70,1.25,34.54854399973716,1
2020-09-16-170120,170120,0,0,2,70,1.5,38.90174029768017,2
2020-09-17-170120,170120,1,0,0,71,0.5,48.863370894908584,3
2020-09-18-170120,170120,0,0,2,71,3.25,51.65281640563245,4
2020-09-19-170120,170120,0,1,0,71,0.0,45.993508523203076,5
2020-09-20-170120,170120,0,0,5,71,0.25,41.07275991344318,6
2020-09-21-170120,170120,0,1,1,71,0.75,39.49527948133012,0
2020-09-22-170120,170120,1,0,2,72,1.75,39.50692925044433,1
2020-09-23-170120,170120,3,0,0,75,2.0,35.491817582640316,2
2020-09-24-170120,170120,2,0,4,77,2.25,34.74582756646023,3
2020-09-25-170120,170120,5,0,0,82,1.75,32.612529821271565,4
2020-09-26-170120,170120,5,0,4,87,0.25,46.61653882061057,5
2020-09-27-170120,170120,0,0,3,87,0.25,51.64879609390826,6
2020-09-28-170120,170120,1,0,0,88,2.25,48.23646985474337,0
2020-09-29-170120,170120,2,0,3,90,0.75,51.02183505748013,1
2020-09-30-170120,170120,2,0,1,92,1.75,52.06467738059268,2
2020-10-01-170120,170120,0,0,0,92,1.25,0.0,3
2020-10-02-170120,170120,2,0,0,94,2.0,49.66946916862351,4
2020-10-03-170120,170120,0,1,1,94,1.0,80.98901269018464,5
2020-10-04-170120,170120,5,0,0,99,0.25,76.1541525837544,6
2020-10-05-170120,170120,1,0,0,100,1.0,70.17530602682658,0
2020-10-06-170120,170120,2,0,0,102,0.5,65.72084549975118,1
2020-10-07-170120,170120,0,0,1,102,0.5,59.12814751335311,2
2020-10-08-170120,170120,4,0,0,106,1.0,54.12755914410124,3
2020-10-09-170120,170120,0,0,0,106,1.75,55.43482701050044,4
2020-10-10-170120,170120,4,0,1,110,1.75,7.863150354907594,5
2020-10-11-170120,170120,3,0,0,113,0.5,16.526277498890625,6
2020-10-12-170120,170120,0,0,1,113,2.0,22.34393841882271,0
2020-10-13-170120,170120,3,0,0,116,0.75,25.585489932532926,1
2020-10-14-170120,170120,1,0,3,117,1.25,35.861888577100345,2
2020-10-15-170120,170120,0,0,1,117,0.0,45.01594299131461,3
2020-10-16-170120,170120,0,0,1,117,1.0,46.15057864660761,4
2020-10-17-170120,170120,1,0,3,118,0.5,42.540774948627096,5
2020-10-18-170120,170120,0,0,5,118,0.5,36.36772828802882,6
2020-10-19-170120,170120,0,0,0,118,2.5,36.02636064797535,0
2020-10-20-170120,170120,0,0,0,118,0.5,42.09570204862466,1
2020-10-21-170120,170120,1,0,1,119,1.0,37.06644790843582,2
2020-10-22-170120,170120,0,0,4,119,1.75,47.042024756095444,3
2020-10-23-170120,170120,0,0,5,119,2.0,50.83469499011248,4
2020-10-24-170120,170120,1,0,4,120,0.75,59.108060027931145,5
2020-10-25-170120,170120,0,0,0,120,2.0,59.47900842954158,6
2020-10-26-170120,170120,1,0,0,121,0.5,59.91972713893941,0
2020-10-27-170120,170120,0,0,1,121,2.5,65.97810330865428,1
2020-10-28-170120,170120,3,0,0,124,1.5,72.41396126880119,2
2020-10-29-170120,170120,1,0,0,125,5.25,72.7825588678588,3
2020-10-30-170120,170120,1,0,1,126,2.75,70.12183090507517,4
2020-10-31-170120,170120,3,0,0,129,1.25,80.23753162163274,5
2020-11-01-170120,170120,5,0,0,134,0.75,51.09210846870879,6
2020-11-02-170120,170120,0,0,0,134,0.75,36.06932645794646,0
2020-11-03-170120,170120,0,0,0,134,2.5,31.054294824983664,1
2020-11-04-170120,170120,1,0,0,135,2.75,39.020572836835285,2
2020-11-05-170120,170120,4,0,0,139,3.75,45.11361483654187,3
2020-11-06-170120,170120,5,0,0,144,2.5,56.308487025085924,4
2020-11-07-170120,170120,4,0,0,148,0.75,60.879376270179975,5
2020-11-08-170120,170120,0,0,0,148,2.0,63.95764872991544,6
2020-11-09-170120,170120,0,0,0,148,0.0,68.10053034111445,0
2020-11-10-170120,170120,1,0,0,149,0.25,52.54892544869129,1
2020-11-11-170120,170120,0,0,0,149,0.5,52.136700725213,2
2020-11-12-170120,170120,0,0,0,149,0.5,55.32910695404142,3
2020-11-13-170120,170120,1,0,0,150,1.0,62.525897278863596,4
2020-03-01-170121,170121,0,0,0,0,0.2,0.0,6
2020-03-02-170121,170121,0,0,0,0,0.0,0.0019918833851540274,0
2020-03-03-170121,170121,0,0,0,0,0.2,0.011609086513525435,1
2020-03-04-170121,170121,0,0,2,0,0.0,0.013217827587962501,2
2020-03-05-170121,170121,0,0,0,0,0.0,0.014867139465636739,3
2020-03-06-170121,170121,0,0,1,0,0.0,14.400367955583654,4
2020-03-07-170121,170121,0,0,0,0,0.0,11.750610574978232,5
2020-03-08-170121,170121,0,0,0,0,0.0,9.819499956293633,6
2020-03-09-170121,170121,0,0,1,0,0.0,9.791368194491387,0
2020-03-10-170121,170121,0,0,0,0,0.0,13.457227822712232,1
2020-03-11-170121,170121,0,0,1,0,0.2,11.137615627107593,2
2020-03-12-170121,170121,0,0,1,0,0.2,8.00246592804456,3
2020-03-13-170121,170121,0,0,0,0,0.6,0.009190865060761137,4
2020-03-14-170121,170121,0,0,1,0,0.4,0.00802854487012563,5
2020-03-15-170121,170121,0,0,0,0,0.2,0.00543793342073027,6
2020-03-16-170121,170121,0,0,0,0,2.6,0.0024331978773430743,0
2020-03-17-170121,170121,0,0,0,0,1.2,0.004609661574917625,1
2020-03-18-170121,170121,2,0,0,2,3.0,3.1639410196548545,2
2020-03-19-170121,170121,0,0,1,2,2.0,5.879238662705685,3
2020-03-20-170121,170121,1,0,0,3,2.2,9.076352428203046,4
2020-03-21-170121,170121,0,0,0,3,1.2,12.349689701788321,5
2020-03-22-170121,170121,0,0,0,3,1.6,13.52856916211298,6
2020-03-23-170121,170121,1,0,0,4,6.6,23.365513696078327,0
2020-03-24-170121,170121,0,0,0,4,3.0,32.95689125550175,1
2020-03-25-170121,170121,1,0,0,5,4.0,14.13395464590207,2
2020-03-26-170121,170121,1,0,0,6,3.2,15.360479913895398,3
2020-03-27-170121,170121,0,0,0,6,3.0,17.40870412624139,4
2020-03-28-170121,170121,1,0,0,7,1.2,17.13829010344655,5
2020-03-29-170121,170121,0,0,0,7,1.4,17.762099824473,6
2020-03-30-170121,170121,0,0,0,7,4.4,0.019925415094931356,0
2020-03-31-170121,170121,0,0,0,7,4.4,0.02124372109622774,1
2020-04-01-170121,170121,0,0,0,7,3.6,0.004431167940646691,2
2020-04-02-170121,170121,1,0,2,8,3.8,0.012991502314914865,3
2020-04-03-170121,170121,0,0,0,8,2.6,0.005648182861164018,4
2020-04-04-170121,170121,0,0,0,8,0.8,0.007800575267630004,5
2020-04-05-170121,170121,0,0,0,8,0.6,0.008192687315640046,6
2020-04-06-170121,170121,0,0,0,8,4.4,0.008653776249231384,0
2020-04-07-170121,170121,0,1,0,8,2.4,0.01140850321928164,1
2020-04-08-170121,170121,0,0,0,8,1.8,0.012345656597533387,2
2020-04-09-170121,170121,0,0,0,8,1.4,0.012516590497466736,3
2020-04-10-170121,170121,0,0,0,8,1.8,0.0031984737381631073,4
2020-04-11-170121,170121,0,0,0,8,0.4,0.004247271925555904,5
2020-04-12-170121,170121,0,0,0,8,1.8,0.004747669728821855,6
2020-04-13-170121,170121,0,0,0,8,2.4,0.005190120854274893,0
2020-04-14-170121,170121,0,0,0,8,4.0,0.00746021605482476,1
2020-04-15-170121,170121,0,0,0,8,0.8,0.00943513880338859,2
2020-04-16-170121,170121,2,0,0,10,2.2,11.731474198738663,3
2020-04-17-170121,170121,0,0,0,10,1.6,22.677189742346002,4
2020-04-18-170121,170121,0,0,0,10,0.6,20.725705025045748,5
2020-04-19-170121,170121,0,0,0,10,1.6,20.674868763652423,6
2020-04-20-170121,170121,0,0,0,10,2.4,23.494922843505606,0
2020-04-21-170121,170121,0,0,0,10,2.8,22.8836286533533,1
2020-04-22-170121,170121,0,0,0,10,1.0,20.831110915627914,2
2020-04-23-170121,170121,0,0,0,10,0.2,19.11201533546467,3
2020-04-24-170121,170121,0,0,0,10,0.6,15.879067568739128,4
2020-04-25-170121,170121,0,0,0,10,0.2,16.520623118219767,5
2020-04-26-170121,170121,0,0,0,10,0.2,23.4349231715769,6
2020-04-27-170121,170121,0,0,0,10,0.4,18.003853157481327,0
2020-04-28-170121,170121,0,1,0,10,1.4,13.746172110180792,1
2020-04-29-170121,170121,0,0,0,10,1.4,12.339672529849313,2
2020-04-30-170121,170121,0,0,0,10,0.8,14.447117104913104,3
2020-05-01-170121,170121,0,0,0,10,0.2,25.780824011228383,4
2020-05-02-170121,170121,0,0,0,10,1.2,16.298798844045596,5
2020-05-03-170121,170121,0,1,0,10,0.2,9.97920413043382,6
2020-05-04-170121,170121,0,1,1,10,0.8,7.506132739536061,0
2020-05-05-170121,170121,0,0,0,10,0.4,13.075995997826944,1
2020-05-06-170121,170121,0,0,0,10,0.8,17.868098900450256,2
2020-05-07-170121,170121,0,0,0,10,1.4,20.380483192434603,3
2020-05-08-170121,170121,0,0,0,10,1.4,23.698377170143804,4
2020-05-09-170121,170121,0,1,0,10,0.4,26.920732502829864,5
2020-05-10-170121,170121,0,0,0,10,0.4,38.702637689575894,6
2020-05-11-170121,170121,0,0,0,10,1.8,30.53810547155099,0
2020-05-12-170121,170121,0,0,0,10,0.8,22.356165111672595,1
2020-05-13-170121,170121,0,0,0,10,0.2,8.88756504308473,2
2020-05-14-170121,170121,0,1,0,10,0.6,6.856990818481854,3
2020-05-15-170121,170121,0,0,0,10,0.6,0.0069513749267273595,4
2020-05-16-170121,170121,0,0,0,10,0.2,0.00542600145033887,5
2020-05-17-170121,170121,0,0,0,10,0.2,0.005180073303828141,6
2020-05-18-170121,170121,1,0,0,11,2.0,0.005003211250950576,0
2020-05-19-170121,170121,0,0,0,11,0.2,0.005728396873985473,1
2020-05-20-170121,170121,0,0,0,11,0.6,0.005287776937183152,2
2020-05-21-170121,170121,0,0,0,11,0.8,0.0058061420854726275,3
2020-05-22-170121,170121,0,0,0,11,1.2,0.006620226954094175,4
2020-05-23-170121,170121,0,0,0,11,0.2,6.619638251132912,5
2020-05-24-170121,170121,0,0,0,11,0.0,6.633550330312832,6
2020-05-25-170121,170121,0,0,0,11,0.6,3.651973579667809,0
2020-05-26-170121,170121,0,0,1,11,0.4,4.090726955517367,1
2020-05-27-170121,170121,0,0,0,11,0.2,4.197836445566914,2
2020-05-28-170121,170121,0,0,0,11,1.0,4.02986490169548,3
2020-05-29-170121,170121,0,1,0,11,0.4,3.8023826604931785,4
2020-05-30-170121,170121,0,0,0,11,0.0,4.2095253164119955,5
2020-05-31-170121,170121,0,0,0,11,0.0,3.9693274178850553,6
2020-06-01-170121,170121,0,0,0,11,0.0,7.8773919553340495,0
2020-06-02-170121,170121,0,0,1,11,1.4,2.7845165754154246,1
2020-06-03-170121,170121,0,0,0,11,0.4,2.59709681477784,2
2020-06-04-170121,170121,0,0,0,11,0.2,2.136055833746479,3
2020-06-05-170121,170121,0,0,1,11,0.4,2.1315481330149195,4
2020-06-06-170121,170121,0,0,0,11,0.0,2.4705530552779784,5
2020-06-07-170121,170121,0,0,0,11,0.0,2.4049412947554853,6
2020-06-08-170121,170121,0,0,0,11,0.4,2.216485265317369,0
2020-06-09-170121,170121,1,0,0,12,0.2,2.10412123248507,1
2020-06-10-170121,170121,0,0,0,12,0.2,8.2094158390162,2
2020-06-11-170121,170121,0,0,0,12,0.0,6.663098148186148,3
2020-06-12-170121,170121,0,0,0,12,0.4,5.607294495991403,4
2020-06-13-170121,170121,0,0,0,12,0.0,4.037084991286127,5
2020-06-14-170121,170121,0,0,0,12,0.0,2.981422518502201,6
2020-06-15-170121,170121,0,4,0,12,0.2,1.2422300355559583,0
2020-06-16-170121,170121,1,0,0,13,0.2,1.288068678792794,1
2020-06-17-170121,170121,0,0,0,13,0.4,1.6928746284234146,2
2020-06-18-170121,170121,0,0,0,13,0.6,1.7438851437731286,3
2020-06-19-170121,170121,1,0,0,14,0.8,2.0522816624724474,4
2020-06-20-170121,170121,0,0,0,14,0.0,4.029656150216509,5
2020-06-21-170121,170121,0,0,0,14,0.0,4.129782204268657,6
2020-06-22-170121,170121,0,0,1,14,0.2,3.8420571869159175,0
2020-06-23-170121,170121,0,0,0,14,0.8,3.4296060341059906,1
2020-06-24-170121,170121,0,0,0,14,0.2,3.7009577368324384,2
2020-06-25-170121,170121,0,3,0,14,0.2,3.6480747325343783,3
2020-06-26-170121,170121,0,0,0,14,0.0,3.313828066024869,4
2020-06-27-170121,170121,0,0,0,14,0.0,2.6892683486363254,5
2020-06-28-170121,170121,0,0,0,14,0.2,2.6476286232820896,6
2020-06-29-170121,170121,0,0,0,14,0.6,2.864038827933905,0
2020-06-30-170121,170121,0,0,0,14,0.0,2.6142597061333896,1
2020-07-01-170121,170121,0,0,0,14,0.2,3.0351899552652,2
2020-07-02-170121,170121,0,0,0,14,0.2,2.6736239916820566,3
2020-07-03-170121,170121,0,0,0,14,0.0,1.4335137322237932,4
2020-07-04-170121,170121,0,0,0,14,0.0,1.4868802474611151,5
2020-07-05-170121,170121,0,0,0,14,0.0,1.4926946092017448,6
2020-07-06-170121,170121,1,0,0,15,0.2,1.1832232985375324,0
2020-07-07-170121,170121,0,0,0,15,0.0,1.680035553135696,1
2020-07-08-170121,170121,0,1,0,15,0.4,2.1980136559636727,2
2020-07-09-170121,170121,0,0,0,15,0.2,2.2291240933520227,3
2020-07-10-170121,170121,0,0,0,15,0.4,3.136118803002013,4
2020-07-11-170121,170121,0,0,0,15,0.2,3.013072567829437,5
2020-07-12-170121,170121,0,0,0,15,0.2,2.8479503873107888,6
2020-07-13-170121,170121,0,0,0,15,0.4,2.933888250646953,0
2020-07-14-170121,170121,0,0,0,15,0.4,3.401600563757084,1
2020-07-15-170121,170121,0,0,0,15,0.0,3.561518067895954,2
2020-07-16-170121,170121,0,0,0,15,0.4,3.160790192591796,3
2020-07-17-170121,170121,0,0,0,15,0.4,3.1141370757299347,4
2020-07-18-170121,170121,0,0,0,15,0.0,2.964364486702026,5
2020-07-19-170121,170121,0,0,0,15,0.0,2.6372447679076547,6
2020-07-20-170121,170121,0,0,0,15,0.0,2.4648505954970403,0
2020-07-21-170121,170121,0,0,0,15,0.0,1.9799497018502255,1
2020-07-22-170121,170121,0,0,0,15,0.4,1.4062622237355984,2
2020-07-23-170121,170121,0,0,0,15,0.4,1.3854215033313635,3
2020-07-24-170121,170121,0,0,0,15,0.0,1.4336186784680116,4
2020-07-25-170121,170121,0,0,0,15,0.0,1.6267408213072208,5
2020-07-26-170121,170121,0,0,0,15,0.0,1.3661442258785441,6
2020-07-27-170121,170121,0,0,0,15,0.2,1.2302140282658645,0
2020-07-28-170121,170121,0,0,0,15,0.6,1.4680455827883827,1
2020-07-29-170121,170121,0,0,0,15,0.4,1.5755839551907027,2
2020-07-30-170121,170121,0,0,0,15,0.2,1.195553100577984,3
2020-07-31-170121,170121,0,0,0,15,0.6,1.2180699475860268,4
2020-08-01-170121,170121,0,0,0,15,0.0,2.688894413086409,5
2020-08-02-170121,170121,0,0,0,15,0.0,7.196022071497231,6
2020-08-03-170121,170121,0,0,0,15,0.0,13.02261201732836,0
2020-08-04-170121,170121,0,0,0,15,0.6,9.65974995247843,1
2020-08-05-170121,170121,0,1,0,15,0.6,8.626403595895002,2
2020-08-06-170121,170121,0,0,0,15,0.6,7.778036362758364,3
2020-08-07-170121,170121,0,0,0,15,1.0,6.860176312318856,4
2020-08-08-170121,170121,0,0,0,15,0.0,6.8949267692255924,5
2020-08-09-170121,170121,0,0,0,15,0.2,7.142685038062488,6
2020-08-10-170121,170121,0,0,0,15,1.0,2.14705373432239,0
2020-08-11-170121,170121,0,0,2,15,1.6,2.9335919326855366,1
2020-08-12-170121,170121,0,0,0,15,0.8,4.848357435032025,2
2020-08-13-170121,170121,0,0,2,15,0.8,6.023004915411849,3
2020-08-14-170121,170121,0,0,0,15,2.0,6.607639033920648,4
2020-08-15-170121,170121,0,0,0,15,0.4,8.912368963051243,5
2020-08-16-170121,170121,0,0,0,15,0.6,9.25116526165421,6
2020-08-17-170121,170121,0,0,0,15,0.2,9.511113959138346,0
2020-08-18-170121,170121,0,0,0,15,0.4,9.91568805698017,1
2020-08-19-170121,170121,0,0,0,15,1.0,8.209990297495633,2
2020-08-20-170121,170121,0,0,0,15,1.0,6.313717821376463,3
2020-08-21-170121,170121,0,0,0,15,1.0,5.724138245048753,4
2020-08-22-170121,170121,0,0,0,15,0.6,6.243830101332193,5
2020-08-23-170121,170121,0,0,0,15,0.6,6.7145147901671685,6
2020-08-24-170121,170121,0,0,0,15,1.8,5.88268001554051,0
2020-08-25-170121,170121,2,0,0,17,3.2,7.176612308598869,1
2020-08-26-170121,170121,0,0,0,17,3.0,9.108718102228295,2
2020-08-27-170121,170121,2,0,0,19,3.4,10.49228098125573,3
2020-08-28-170121,170121,0,0,0,19,1.8,11.344291306658324,4
2020-08-29-170121,170121,0,0,0,19,1.0,10.908569191505853,5
2020-08-30-170121,170121,0,0,0,19,2.2,11.476064941187673,6
2020-08-31-170121,170121,0,0,0,19,2.4,11.563714525838368,0
2020-09-01-170121,170121,0,0,0,19,2.4,5.740809012357262,1
2020-09-02-170121,170121,0,0,1,19,1.4,14.314519110871247,2
2020-09-03-170121,170121,0,0,0,19,2.4,14.728544642046057,3
2020-09-04-170121,170121,0,0,0,19,3.2,15.023374353344323,4
2020-09-05-170121,170121,0,0,0,19,1.8,12.026977111156077,5
2020-09-06-170121,170121,0,0,0,19,2.6,11.224395147349338,6
2020-09-07-170121,170121,0,0,0,19,2.2,11.39214906748439,0
2020-09-08-170121,170121,0,0,0,19,1.6,11.081544945318623,1
2020-09-09-170121,170121,0,0,0,19,1.2,10.96189369557235,2
2020-09-10-170121,170121,0,0,0,19,2.4,4.827963298197626,3
2020-09-11-170121,170121,0,0,0,19,5.2,5.7350732616468285,4
2020-09-12-170121,170121,0,0,0,19,1.2,7.483178575215442,5
2020-09-13-170121,170121,0,0,0,19,2.6,7.105955121301344,6
2020-09-14-170121,170121,0,0,1,19,2.8,6.663176394083214,0
2020-09-15-170121,170121,0,0,1,19,2.4,8.020431339026608,1
2020-09-16-170121,170121,1,0,1,20,1.8,8.984056616138648,2
2020-09-17-170121,170121,0,0,0,20,1.8,11.419308282559452,3
2020-09-18-170121,170121,0,0,3,20,15.2,12.053910541961319,4
2020-09-19-170121,170121,0,1,0,20,6.0,0.021857098740058353,5
2020-09-20-170121,170121,0,0,0,20,4.0,0.02214902257468575,6
2020-09-21-170121,170121,0,0,0,20,2.8,0.021545227053167013,0
2020-09-22-170121,170121,0,0,0,20,2.6,0.022060583665873473,1
2020-09-23-170121,170121,0,0,0,20,3.6,0.02068708928774824,2
2020-09-24-170121,170121,0,0,0,20,3.8,0.02066554485141195,3
2020-09-25-170121,170121,0,0,0,20,2.6,0.020047205907939913,4
2020-09-26-170121,170121,0,0,0,20,1.2,12.614190979867697,5
2020-09-27-170121,170121,0,0,0,20,1.4,13.230785435685114,6
2020-09-28-170121,170121,1,0,0,21,2.6,12.193656230303977,0
2020-09-29-170121,170121,1,0,0,22,1.0,12.663436673734948,1
2020-09-30-170121,170121,1,0,0,23,3.8,12.58499965362553,2
2020-10-01-170121,170121,0,0,0,23,1.8,0.0,3
2020-10-02-170121,170121,3,0,0,26,1.8,12.708425335304584,4
2020-10-03-170121,170121,0,0,0,26,0.8,20.29793595992932,5
2020-10-04-170121,170121,0,0,0,26,1.8,18.98794562930495,6
2020-10-05-170121,170121,0,0,0,26,2.0,17.79270601435281,0
2020-10-06-170121,170121,0,0,0,26,1.2,16.906832811963543,1
2020-10-07-170121,170121,0,0,3,26,2.6,15.076791554550958,2
2020-10-08-170121,170121,0,0,0,26,2.8,12.490999250461098,3
2020-10-09-170121,170121,0,0,1,26,2.4,12.834500916207864,4
2020-10-10-170121,170121,0,0,0,26,2.6,1.6678963816505614,5
2020-10-11-170121,170121,0,0,1,26,1.2,3.57632652197323,6
2020-10-12-170121,170121,0,0,0,26,2.2,4.578084979216127,0
2020-10-13-170121,170121,0,0,0,26,2.4,5.3295583067633245,1
2020-10-14-170121,170121,0,0,1,26,2.6,7.690336793747454,2
2020-10-15-170121,170121,0,0,1,26,2.2,9.699407205405208,3
2020-10-16-170121,170121,0,0,0,26,3.2,10.431539717090406,4
2020-10-17-170121,170121,0,0,0,26,1.0,9.62240216726807,5
2020-10-18-170121,170121,0,0,1,26,1.8,8.990896574676482,6
2020-10-19-170121,170121,0,0,1,26,5.8,9.159456487626894,0
2020-10-20-170121,170121,0,0,0,26,1.6,11.4686280869738,1
2020-10-21-170121,170121,3,0,0,29,2.4,10.887934765589186,2
2020-10-22-170121,170121,0,0,0,29,4.4,13.484785207890662,3
2020-10-23-170121,170121,1,0,1,30,5.0,14.531653962799707,4
2020-10-24-170121,170121,0,0,0,30,1.8,16.687532767279823,5
2020-10-25-170121,170121,1,0,1,31,1.6,17.09286549749047,6
2020-10-26-170121,170121,0,0,0,31,5.0,17.589080166480016,0
2020-10-27-170121,170121,0,0,0,31,4.0,18.31841783803079,1
2020-10-28-170121,170121,1,0,0,32,2.6,19.43647913604339,2
2020-10-29-170121,170121,1,1,0,33,7.2,19.0473977206357,3
2020-10-30-170121,170121,0,0,0,33,3.8,18.886105155306623,4
2020-10-31-170121,170121,0,0,0,33,2.6,21.683463796659783,5
2020-11-01-170121,170121,1,0,0,34,1.6,12.449677510084147,6
2020-11-02-170121,170121,1,0,0,35,1.6,11.4388938243615,0
2020-11-03-170121,170121,0,0,0,35,4.2,10.47728723784495,1
2020-11-04-170121,170121,0,0,0,35,6.6,11.88486809128099,2
2020-11-05-170121,170121,0,0,0,35,4.8,13.592604740664889,3
2020-11-06-170121,170121,1,0,0,36,6.2,15.70555496990053,4
2020-11-07-170121,170121,0,0,0,36,1.8,14.28680142507817,5
2020-11-08-170121,170121,1,0,0,37,1.8,15.148047481310854,6
2020-11-09-170121,170121,0,0,0,37,4.4,16.00770947390398,0
2020-11-10-170121,170121,0,0,0,37,2.8,11.338060475960459,1
2020-11-11-170121,170121,0,0,0,37,1.6,11.242904987044025,2
2020-11-12-170121,170121,0,0,0,37,3.4,11.930044899457517,3
2020-11-13-170121,170121,0,0,0,37,4.2,13.757342914487573,4
2020-03-01-170122,170122,0,0,2,0,0.0,0.0,6
2020-03-02-170122,170122,0,0,12,0,0.0,184.81136668865804,0
2020-03-03-170122,170122,0,0,8,0,0.0,1044.1445868692738,1
2020-03-04-170122,170122,0,0,30,0,0.2,1073.8784662624305,2
2020-03-05-170122,170122,0,0,23,0,0.0,1154.9618910866345,3
2020-03-06-170122,170122,0,0,29,0,0.2,1015.239910864021,4
2020-03-07-170122,170122,0,0,13,0,0.0,1048.961273485599,5
2020-03-08-170122,170122,0,0,17,0,0.0,1019.841317095653,6
2020-03-09-170122,170122,1,0,45,1,0.2,1020.3350991235326,0
2020-03-10-170122,170122,0,0,35,1,0.6,1092.5493898318716,1
2020-03-11-170122,170122,1,0,23,2,1.2,884.3315063583036,2
2020-03-12-170122,170122,0,0,22,2,0.8,684.6460849245361,3
2020-03-13-170122,170122,3,0,33,5,2.0,515.1995675870775,4
2020-03-14-170122,170122,3,0,10,8,1.2,372.9718099497373,5
2020-03-15-170122,170122,2,0,9,10,1.2,250.8591369358684,6
2020-03-16-170122,170122,12,0,25,22,7.6,123.02643647296912,0
2020-03-17-170122,170122,8,0,14,30,7.4,279.715953016474,1
2020-03-18-170122,170122,30,0,24,60,18.6,384.6574997062576,2
2020-03-19-170122,170122,23,0,14,83,24.4,710.5458152568596,3
2020-03-20-170122,170122,29,0,11,112,24.8,1100.6627198452657,4
2020-03-21-170122,170122,13,0,4,125,8.8,1407.4826947357824,5
2020-03-22-170122,170122,17,0,6,142,11.0,1468.7545964512808,6
2020-03-23-170122,170122,45,0,20,187,30.2,1538.85994361647,0
2020-03-24-170122,170122,35,0,17,222,26.4,1956.577376063575,1
2020-03-25-170122,170122,23,0,16,245,23.8,2097.4180704317914,2
2020-03-26-170122,170122,22,0,11,267,21.2,2028.4337937968232,3
2020-03-27-170122,170122,33,0,11,300,21.6,2314.224881140578,4
2020-03-28-170122,170122,10,0,7,310,7.6,2267.3305455236764,5
2020-03-29-170122,170122,9,0,2,319,6.8,2246.9942344840865,6
2020-03-30-170122,170122,25,0,10,344,16.0,1630.579174777042,0
2020-03-31-170122,170122,14,0,15,358,18.6,1441.634258938329,1
2020-04-01-170122,170122,24,0,11,382,11.6,274.77847961299847,2
2020-04-02-170122,170122,14,0,11,396,13.8,639.7958975277918,3
2020-04-03-170122,170122,11,0,5,407,15.4,296.468931999287,4
2020-04-04-170122,170122,4,0,0,411,4.4,443.08417830506073,5
2020-04-05-170122,170122,6,0,1,417,3.6,493.18708510932584,6
2020-04-06-170122,170122,20,0,9,437,13.4,535.5981274003072,0
2020-04-07-170122,170122,17,0,6,454,9.8,668.2895392779798,1
2020-04-08-170122,170122,16,1,8,470,7.8,801.9663502355147,2
2020-04-09-170122,170122,11,0,4,481,9.0,885.147210405732,3
2020-04-10-170122,170122,11,0,6,492,6.0,177.13689792124995,4
2020-04-11-170122,170122,7,0,1,499,2.8,267.8088762625937,5
2020-04-12-170122,170122,2,0,4,501,3.2,315.8656179200202,6
2020-04-13-170122,170122,10,0,7,511,7.6,353.3238522694097,0
2020-04-14-170122,170122,15,0,3,526,11.0,494.0393541468139,1
2020-04-15-170122,170122,11,0,5,537,7.6,646.217296355565,2
2020-04-16-170122,170122,11,0,2,548,6.0,780.6521664683681,3
2020-04-17-170122,170122,5,0,1,553,7.8,727.1736257778413,4
2020-04-18-170122,170122,0,1,3,553,0.6,745.2918507645786,5
2020-04-19-170122,170122,1,0,0,554,1.8,701.837447577251,6
2020-04-20-170122,170122,9,0,6,563,13.2,729.3000725684258,0
2020-04-21-170122,170122,6,0,7,569,5.2,800.8510610854329,1
2020-04-22-170122,170122,8,0,11,577,5.4,734.6573976731961,2
2020-04-23-170122,170122,4,0,7,581,1.4,725.4704920482691,3
2020-04-24-170122,170122,6,0,10,587,4.6,624.9638067313645,4
2020-04-25-170122,170122,1,0,1,588,0.8,694.4203690002525,5
2020-04-26-170122,170122,4,0,1,592,0.6,685.7074798554435,6
2020-04-27-170122,170122,7,0,14,599,5.0,510.0884111956109,0
2020-04-28-170122,170122,3,0,9,602,2.4,374.4208665803586,1
2020-04-29-170122,170122,5,0,3,607,4.0,342.37822261373816,2
2020-04-30-170122,170122,2,0,2,609,3.2,502.211598132245,3
2020-05-01-170122,170122,1,0,8,610,0.4,867.1783633873198,4
2020-05-02-170122,170122,3,0,2,613,1.8,469.24686752840853,5
2020-05-03-170122,170122,0,1,0,613,0.8,214.9910346945705,6
2020-05-04-170122,170122,6,0,26,619,6.8,152.67939762225777,0
2020-05-05-170122,170122,7,0,2,626,4.2,231.71895237147248,1
2020-05-06-170122,170122,11,0,3,637,4.8,284.5701991853134,2
2020-05-07-170122,170122,7,0,4,644,2.0,341.605740289386,3
2020-05-08-170122,170122,10,0,4,654,4.8,355.74888695511646,4
2020-05-09-170122,170122,1,0,0,655,0.8,463.8532867678258,5
2020-05-10-170122,170122,1,0,0,656,1.2,935.1879770423752,6
2020-05-11-170122,170122,14,0,5,670,7.0,876.4376840053194,0
2020-05-12-170122,170122,9,0,2,679,3.4,936.5188622282459,1
2020-05-13-170122,170122,3,0,1,682,2.8,750.1386557936145,2
2020-05-14-170122,170122,2,0,2,684,3.6,588.1022335481555,3
2020-05-15-170122,170122,8,0,4,692,3.6,501.44578428877577,4
2020-05-16-170122,170122,2,0,0,694,1.4,419.2537583307742,5
2020-05-17-170122,170122,0,0,0,694,0.8,452.5401010431608,6
2020-05-18-170122,170122,26,0,4,720,15.6,445.2440010070401,0
2020-05-19-170122,170122,2,0,2,722,2.0,606.3283551597185,1
2020-05-20-170122,170122,3,0,3,725,2.0,547.6351121706255,2
2020-05-21-170122,170122,4,0,0,729,3.8,535.7737809704315,3
2020-05-22-170122,170122,4,0,3,733,2.2,537.9241889467811,4
2020-05-23-170122,170122,0,0,0,733,0.6,554.5255419856388,5
2020-05-24-170122,170122,0,0,0,733,1.0,557.9228565319473,6
2020-05-25-170122,170122,5,0,2,738,2.6,273.92291216983375,0
2020-05-26-170122,170122,2,0,1,740,2.4,304.1746494192711,1
2020-05-27-170122,170122,1,0,1,741,2.0,332.9808715828009,2
2020-05-28-170122,170122,2,0,0,743,4.0,321.5759669677607,3
2020-05-29-170122,170122,4,0,3,747,1.6,304.2853741497602,4
2020-05-30-170122,170122,0,0,1,747,0.0,295.09161839199066,5
2020-05-31-170122,170122,0,0,0,747,0.0,272.8307854848101,6
2020-06-01-170122,170122,4,0,3,751,1.6,583.158491355759,0
2020-06-02-170122,170122,2,0,3,753,4.2,150.48830251108643,1
2020-06-03-170122,170122,3,0,2,756,1.6,124.89760632654801,2
2020-06-04-170122,170122,0,0,0,756,3.2,144.821555898692,3
2020-06-05-170122,170122,3,0,2,759,1.4,163.76352814246113,4
2020-06-06-170122,170122,0,0,0,759,0.0,175.4776329973826,5
2020-06-07-170122,170122,0,0,0,759,0.4,176.23990281729638,6
2020-06-08-170122,170122,2,0,1,761,1.4,171.90290556098213,0
2020-06-09-170122,170122,1,0,1,762,1.4,182.6065304872132,1
2020-06-10-170122,170122,1,0,1,763,1.0,638.8078510357224,2
2020-06-11-170122,170122,0,0,0,763,0.8,514.0246258689322,3
2020-06-12-170122,170122,3,0,1,766,1.2,420.39816283886194,4
2020-06-13-170122,170122,1,0,0,767,0.2,307.88953534252687,5
2020-06-14-170122,170122,0,0,1,767,0.0,252.79036578134028,6
2020-06-15-170122,170122,3,0,0,770,0.8,126.83232271166224,0
2020-06-16-170122,170122,3,0,4,773,1.8,137.09935000323998,1
2020-06-17-170122,170122,2,0,2,775,1.4,151.5180656151634,2
2020-06-18-170122,170122,0,0,0,775,1.0,159.60719082314722,3
2020-06-19-170122,170122,2,0,1,777,0.2,172.0089816111179,4
2020-06-20-170122,170122,0,0,0,777,0.2,232.39161854270992,5
2020-06-21-170122,170122,0,0,0,777,0.0,240.121265950368,6
2020-06-22-170122,170122,1,0,0,778,2.4,212.02484409896044,0
2020-06-23-170122,170122,1,0,0,779,1.2,205.71544314521844,1
2020-06-24-170122,170122,1,0,1,780,0.8,194.39824239735714,2
2020-06-25-170122,170122,0,2,0,780,1.4,182.95736103966243,3
2020-06-26-170122,170122,1,0,1,781,1.0,201.3278007374071,4
2020-06-27-170122,170122,0,0,0,781,0.0,149.28372606322705,5
2020-06-28-170122,170122,1,0,0,782,0.4,141.86688065093128,6
2020-06-29-170122,170122,0,0,0,782,1.2,149.22921638708155,0
2020-06-30-170122,170122,4,0,0,786,0.8,138.9717385234751,1
2020-07-01-170122,170122,2,0,0,788,1.0,194.0126946523851,2
2020-07-02-170122,170122,0,0,0,788,0.6,55.56698342791353,3
2020-07-03-170122,170122,1,0,0,789,0.4,48.79243608561359,4
2020-07-04-170122,170122,0,0,0,789,0.2,48.822023912761054,5
2020-07-05-170122,170122,0,0,0,789,0.2,55.75112810709706,6
2020-07-06-170122,170122,0,0,0,789,0.8,45.57011860068628,0
2020-07-07-170122,170122,0,0,0,789,0.6,57.10825048900323,1
2020-07-08-170122,170122,1,0,1,790,0.4,68.58412955725626,2
2020-07-09-170122,170122,0,0,0,790,1.0,61.624950894355365,3
2020-07-10-170122,170122,1,0,1,791,1.8,173.88747341715623,4
2020-07-11-170122,170122,0,0,0,791,0.4,135.25761723615983,5
2020-07-12-170122,170122,0,0,0,791,0.2,113.26936568587459,6
2020-07-13-170122,170122,0,0,0,791,0.6,119.66339052580899,0
2020-07-14-170122,170122,0,0,0,791,0.0,125.81868122011406,1
2020-07-15-170122,170122,0,0,0,791,0.4,95.10531989423473,2
2020-07-16-170122,170122,0,0,0,791,0.2,78.07783857091599,3
2020-07-17-170122,170122,0,1,0,791,0.6,65.71684966088918,4
2020-07-18-170122,170122,0,0,0,791,0.2,64.17508115708316,5
2020-07-19-170122,170122,0,0,0,791,0.0,61.08716788548239,6
2020-07-20-170122,170122,0,0,0,791,0.2,56.076937855394796,0
2020-07-21-170122,170122,0,0,0,791,0.2,47.87395420304427,1
2020-07-22-170122,170122,1,0,0,792,0.6,43.43648739706382,2
2020-07-23-170122,170122,0,0,0,792,0.8,40.82036287927488,3
2020-07-24-170122,170122,1,0,1,793,0.2,42.12869695129038,4
2020-07-25-170122,170122,0,0,0,793,0.0,40.731790280238684,5
2020-07-26-170122,170122,0,0,0,793,0.0,39.64767670071818,6
2020-07-27-170122,170122,0,0,1,793,0.6,31.770512871652947,0
2020-07-28-170122,170122,0,0,0,793,0.2,40.517450677128295,1
2020-07-29-170122,170122,0,0,5,793,0.2,44.412351051245004,2
2020-07-30-170122,170122,0,0,3,793,0.4,43.576477043670046,3
2020-07-31-170122,170122,0,0,0,793,0.8,43.922294373190816,4
2020-08-01-170122,170122,0,0,1,793,0.0,68.50629158002059,5
2020-08-02-170122,170122,0,0,0,793,0.2,225.89015486736218,6
2020-08-03-170122,170122,0,0,1,793,0.0,341.7461986835863,0
2020-08-04-170122,170122,0,0,1,793,0.2,286.89922058724585,1
2020-08-05-170122,170122,0,0,4,793,0.2,239.59765931571616,2
2020-08-06-170122,170122,0,0,5,793,0.8,181.49774806966172,3
2020-08-07-170122,170122,1,0,0,794,0.2,108.92168553343262,4
2020-08-08-170122,170122,0,0,0,794,1.2,120.59160560220812,5
2020-08-09-170122,170122,0,0,1,794,1.2,127.3607565748274,6
2020-08-10-170122,170122,1,1,3,795,1.8,63.23611095665519,0
2020-08-11-170122,170122,0,0,3,795,2.0,90.73328850865477,1
2020-08-12-170122,170122,5,0,1,800,2.0,146.9218553705023,2
2020-08-13-170122,170122,3,0,8,803,1.4,217.891226858798,3
2020-08-14-170122,170122,0,0,3,803,1.8,265.76397925759983,4
2020-08-15-170122,170122,1,0,0,804,0.4,306.11144484495304,5
2020-08-16-170122,170122,0,0,1,804,0.4,305.7593221916047,6
2020-08-17-170122,170122,1,0,0,805,0.8,310.82650497649473,0
2020-08-18-170122,170122,1,0,0,806,0.2,309.6552423682122,1
2020-08-19-170122,170122,4,0,4,810,1.8,266.98803485362913,2
2020-08-20-170122,170122,5,0,7,815,2.8,155.23497624660774,3
2020-08-21-170122,170122,0,0,3,815,0.4,164.12049695676748,4
2020-08-22-170122,170122,0,0,2,815,0.4,166.12003241114235,5
2020-08-23-170122,170122,1,0,1,816,0.4,183.15378423356788,6
2020-08-24-170122,170122,3,0,10,819,1.4,161.5098431929836,0
2020-08-25-170122,170122,3,0,6,822,1.4,195.12147712962542,1
2020-08-26-170122,170122,1,0,2,823,2.0,202.378775569474,2
2020-08-27-170122,170122,8,0,5,831,2.2,253.00584035622137,3
2020-08-28-170122,170122,3,0,2,834,2.0,266.4954201566546,4
2020-08-29-170122,170122,0,0,0,834,0.4,338.1499594061394,5
2020-08-30-170122,170122,1,0,5,835,1.8,321.9722559348321,6
2020-08-31-170122,170122,0,0,3,835,3.0,304.7208960488829,0
2020-09-01-170122,170122,0,0,1,835,1.2,110.46880538489967,1
2020-09-02-170122,170122,4,0,5,839,2.4,474.04210406470924,2
2020-09-03-170122,170122,7,0,3,846,2.0,587.4376685069989,3
2020-09-04-170122,170122,3,0,8,849,3.4,521.9247982810421,4
2020-09-05-170122,170122,2,0,2,851,2.0,534.5861407251153,5
2020-09-06-170122,170122,1,0,9,852,1.8,540.8249940546954,6
2020-09-07-170122,170122,10,0,4,862,4.4,515.7132581506166,0
2020-09-08-170122,170122,6,0,1,868,4.0,511.1009256664243,1
2020-09-09-170122,170122,2,0,2,870,2.0,552.6077468162523,2
2020-09-10-170122,170122,5,0,7,875,1.2,120.37055769799125,3
2020-09-11-170122,170122,2,0,4,877,4.6,159.84707186076338,4
2020-09-12-170122,170122,0,0,4,877,1.2,239.39246328070823,5
2020-09-13-170122,170122,5,0,3,882,3.8,238.91523854981108,6
2020-09-14-170122,170122,3,0,9,885,5.4,297.0861522544398,0
2020-09-15-170122,170122,1,0,2,886,2.2,358.0363174936475,1
2020-09-16-170122,170122,5,0,3,891,4.4,382.41988960585377,2
2020-09-17-170122,170122,3,0,3,894,3.0,442.0891974826882,3
2020-09-18-170122,170122,8,0,8,902,7.2,520.0778849621378,4
2020-09-19-170122,170122,2,0,7,904,1.8,496.8504774997667,5
2020-09-20-170122,170122,9,1,1,913,4.2,461.3094435856111,6
2020-09-21-170122,170122,4,0,4,917,5.4,499.23628810033347,0
2020-09-22-170122,170122,1,0,3,918,3.4,572.7938665702547,1
2020-09-23-170122,170122,2,0,8,920,4.0,524.4203440463847,2
2020-09-24-170122,170122,7,1,1,927,7.4,482.03430212434273,3
2020-09-25-170122,170122,4,0,8,931,5.4,584.250825196779,4
2020-09-26-170122,170122,4,0,3,935,2.0,659.3408318262807,5
2020-09-27-170122,170122,3,0,3,938,1.4,679.6077863080869,6
2020-09-28-170122,170122,9,0,0,947,5.4,616.9033829238587,0
2020-09-29-170122,170122,2,0,4,949,1.8,625.6379751426966,1
2020-09-30-170122,170122,3,0,6,952,4.4,614.1633440111706,2
2020-10-01-170122,170122,3,0,0,955,4.8,0.0,3
2020-10-02-170122,170122,8,0,3,963,6.0,735.5127290849179,4
2020-10-03-170122,170122,7,0,0,970,4.2,1408.246204641408,5
2020-10-04-170122,170122,1,0,10,971,3.8,1229.322743998423,6
2020-10-05-170122,170122,4,0,11,975,3.0,1071.5780866638188,0
2020-10-06-170122,170122,3,0,6,978,2.8,1021.9029019937159,1
2020-10-07-170122,170122,8,0,5,986,4.4,933.8798351251035,2
2020-10-08-170122,170122,1,1,11,987,2.2,847.9624792586877,3
2020-10-09-170122,170122,8,1,25,995,5.8,803.0061218718278,4
2020-10-10-170122,170122,3,0,5,998,3.6,104.76576461173315,5
2020-10-11-170122,170122,3,0,10,1001,1.6,187.60295024660536,6
2020-10-12-170122,170122,0,0,20,1001,1.4,223.7710196670871,0
2020-10-13-170122,170122,4,0,4,1005,4.0,223.91765471422536,1
2020-10-14-170122,170122,6,0,5,1011,5.6,345.360600284405,2
2020-10-15-170122,170122,0,0,17,1011,0.0,487.9846301007449,3
2020-10-16-170122,170122,3,0,22,1014,3.4,468.73975895198,4
2020-10-17-170122,170122,0,0,5,1014,0.6,466.8249565106162,5
2020-10-18-170122,170122,10,0,10,1024,4.2,408.74030195140784,6
2020-10-19-170122,170122,11,0,5,1035,7.4,481.6835281549329,0
2020-10-20-170122,170122,6,0,4,1041,3.4,647.6097025233948,1
2020-10-21-170122,170122,5,0,14,1046,6.8,593.7147293625422,2
2020-10-22-170122,170122,11,0,11,1057,8.4,761.1206653527131,3
2020-10-23-170122,170122,25,0,14,1082,9.8,890.5165248682029,4
2020-10-24-170122,170122,5,0,5,1087,4.4,1125.299941966184,5
2020-10-25-170122,170122,10,0,9,1097,11.2,1108.4358398495328,6
2020-10-26-170122,170122,20,0,9,1117,6.8,1153.624507044002,0
2020-10-27-170122,170122,4,0,9,1121,6.6,1336.2573165193708,1
2020-10-28-170122,170122,5,0,12,1126,6.8,1397.5954403819803,2
2020-10-29-170122,170122,17,0,9,1143,11.6,1378.6879603083191,3
2020-10-30-170122,170122,22,0,6,1165,9.0,1259.2585471716804,4
2020-10-31-170122,170122,5,0,0,1170,5.4,1387.2704234422124,5
2020-11-01-170122,170122,10,1,0,1180,4.6,706.3200471599464,6
2020-11-02-170122,170122,5,0,0,1185,2.8,551.8972989934682,0
2020-11-03-170122,170122,4,0,0,1189,6.0,491.099536538988,1
2020-11-04-170122,170122,14,0,0,1203,7.8,593.432664920231,2
2020-11-05-170122,170122,11,0,0,1214,7.8,695.3578848138924,3
2020-11-06-170122,170122,14,2,0,1228,9.0,810.6910142010714,4
2020-11-07-170122,170122,5,3,0,1233,7.2,857.2611567003015,5
2020-11-08-170122,170122,9,1,0,1242,4.4,901.9070904021053,6
2020-11-09-170122,170122,9,0,0,1251,5.6,948.0693949451232,0
2020-11-10-170122,170122,9,0,0,1260,3.2,730.0324934535104,1
2020-11-11-170122,170122,12,0,0,1272,3.8,747.8392218603865,2
2020-11-12-170122,170122,9,0,0,1281,7.0,794.0318304467105,3
2020-11-13-170122,170122,6,1,0,1287,3.4,926.0958962544121,4
2020-03-01-170201,170201,0,0,0,0,0.0,0.0,6
2020-03-02-170201,170201,0,0,4,0,0.5,136.8689839599004,0
2020-03-03-170201,170201,0,0,8,0,0.0,602.7954158048933,1
2020-03-04-170201,170201,1,0,27,1,0.0,634.8490497194991,2
2020-03-05-170201,170201,0,1,25,1,0.0,707.6541612965552,3
2020-03-06-170201,170201,0,0,15,1,0.0,657.7969268430318,4
2020-03-07-170201,170201,0,2,15,1,0.0,682.0974541396856,5
2020-03-08-170201,170201,0,0,10,1,0.0,677.1567890796422,6
2020-03-09-170201,170201,0,0,29,1,0.0,676.6955994092453,0
2020-03-10-170201,170201,1,1,27,2,0.5,1773.1651142494818,1
2020-03-11-170201,170201,0,0,23,2,0.5,1487.703932743511,2
2020-03-12-170201,170201,0,0,9,2,2.5,1081.5344132506298,3
2020-03-13-170201,170201,5,0,16,7,1.5,712.7470357557263,4
2020-03-14-170201,170201,6,0,7,13,6.0,530.4873940517008,5
2020-03-15-170201,170201,0,0,6,13,2.0,470.05333188184767,6
2020-03-16-170201,170201,4,0,17,17,6.5,208.15166455091713,0
2020-03-17-170201,170201,8,0,16,25,9.0,303.6026009854518,1
2020-03-18-170201,170201,27,0,13,52,13.0,434.72115830661176,2
2020-03-19-170201,170201,25,2,7,77,11.5,646.5538918368666,3
2020-03-20-170201,170201,15,1,7,92,12.0,799.0154672397232,4
2020-03-21-170201,170201,15,0,2,107,5.5,812.7702471310323,5
2020-03-22-170201,170201,10,0,1,117,3.0,870.902259515664,6
2020-03-23-170201,170201,29,0,12,146,24.5,853.3472835576952,0
2020-03-24-170201,170201,27,2,8,173,13.5,1077.244061447085,1
2020-03-25-170201,170201,23,0,11,196,19.5,1103.8306790455038,2
2020-03-26-170201,170201,9,0,3,205,15.5,1132.2580027278084,3
2020-03-27-170201,170201,16,0,4,221,13.5,1265.1854375595208,4
2020-03-28-170201,170201,7,0,1,228,4.0,1307.1995263798906,5
2020-03-29-170201,170201,6,0,1,234,3.0,1280.4825431212835,6
2020-03-30-170201,170201,17,0,10,251,22.0,926.6424091395218,0
2020-03-31-170201,170201,16,0,42,267,13.0,878.5239949749487,1
2020-04-01-170201,170201,13,0,5,280,13.0,169.06065960961374,2
2020-04-02-170201,170201,7,0,4,287,3.0,665.5905697503988,3
2020-04-03-170201,170201,7,0,5,294,9.0,192.5412435295712,4
2020-04-04-170201,170201,2,0,1,296,2.0,232.2531328170945,5
2020-04-05-170201,170201,1,0,2,297,0.5,255.04881855593894,6
2020-04-06-170201,170201,12,0,5,309,9.0,247.17396934095942,0
2020-04-07-170201,170201,8,0,5,317,7.5,283.6735620119524,1
2020-04-08-170201,170201,11,0,3,328,5.0,344.8813872837327,2
2020-04-09-170201,170201,3,0,0,331,3.5,386.1755654093615,3
2020-04-10-170201,170201,4,0,6,335,2.0,150.82897443683072,4
2020-04-11-170201,170201,1,0,0,336,1.5,173.22676388411548,5
2020-04-12-170201,170201,1,0,0,337,2.0,187.03321150582013,6
2020-04-13-170201,170201,10,0,7,347,7.0,203.17232151133825,0
2020-04-14-170201,170201,42,0,3,389,47.5,290.9099635856294,1
2020-04-15-170201,170201,5,0,6,394,2.0,612.9491260385611,2
2020-04-16-170201,170201,4,0,3,398,2.5,647.91409446998,3
2020-04-17-170201,170201,5,0,1,403,13.5,568.7115735085632,4
2020-04-18-170201,170201,1,0,0,404,0.5,740.4778818853003,5
2020-04-19-170201,170201,2,0,1,406,2.0,732.3094479823684,6
2020-04-20-170201,170201,5,0,7,411,5.5,710.7846524141066,0
2020-04-21-170201,170201,5,0,3,416,1.5,431.65947396370524,1
2020-04-22-170201,170201,3,0,2,419,1.0,427.2841492285122,2
2020-04-23-170201,170201,0,0,2,419,1.0,410.851523391521,3
2020-04-24-170201,170201,6,0,6,425,3.0,228.40069429253475,4
2020-04-25-170201,170201,0,0,3,425,0.5,274.9273922910029,5
2020-04-26-170201,170201,0,0,0,425,1.0,251.27442898485157,6
2020-04-27-170201,170201,7,1,3,432,4.5,204.26776355590977,0
2020-04-28-170201,170201,3,0,3,435,4.0,194.5330623798588,1
2020-04-29-170201,170201,6,0,7,441,2.5,193.1691090422031,2
2020-04-30-170201,170201,3,1,2,444,1.0,306.2553363654821,3
2020-05-01-170201,170201,1,0,6,445,0.0,402.95755780857735,4
2020-05-02-170201,170201,0,0,0,445,0.5,255.6707772470952,5
2020-05-03-170201,170201,1,1,0,446,0.0,178.58378221930343,6
2020-05-04-170201,170201,7,0,4,453,4.5,134.51566422868132,0
2020-05-05-170201,170201,3,0,6,456,2.0,162.60974576871138,1
2020-05-06-170201,170201,2,0,4,458,3.0,174.4750059043586,2
2020-05-07-170201,170201,2,0,4,460,3.0,179.67459353770087,3
2020-05-08-170201,170201,6,0,3,466,3.5,178.56573447353486,4
2020-05-09-170201,170201,3,0,1,469,0.0,234.0157065227698,5
2020-05-10-170201,170201,0,0,0,469,0.5,435.34785799943626,6
2020-05-11-170201,170201,3,0,4,472,2.0,413.0504759475429,0
2020-05-12-170201,170201,3,0,5,475,2.5,440.3608617802468,1
2020-05-13-170201,170201,7,0,1,482,4.5,345.1748409307737,2
2020-05-14-170201,170201,2,0,3,484,2.0,317.05109722544205,3
2020-05-15-170201,170201,6,0,3,490,5.5,234.81264892146552,4
2020-05-16-170201,170201,0,0,0,490,0.5,240.78977307013244,5
2020-05-17-170201,170201,0,0,0,490,0.0,233.7799269046516,6
2020-05-18-170201,170201,4,1,2,494,5.5,223.49827089550163,0
2020-05-19-170201,170201,6,0,12,500,4.0,263.83293184337526,1
2020-05-20-170201,170201,4,0,2,504,5.0,217.6613398444696,2
2020-05-21-170201,170201,4,0,1,508,2.5,262.12512821416897,3
2020-05-22-170201,170201,3,0,2,511,2.5,259.1003838929206,4
2020-05-23-170201,170201,1,0,0,512,0.0,287.83656173934367,5
2020-05-24-170201,170201,0,0,0,512,0.0,297.5015133930316,6
2020-05-25-170201,170201,4,0,1,516,2.5,223.0234531029821,0
2020-05-26-170201,170201,5,0,3,521,4.0,223.67020158778604,1
2020-05-27-170201,170201,1,0,1,522,1.5,285.92674031372525,2
2020-05-28-170201,170201,3,2,2,525,1.5,235.63360589138995,3
2020-05-29-170201,170201,3,0,0,528,1.5,227.59011761595494,4
2020-05-30-170201,170201,0,0,0,528,0.0,245.19116742078367,5
2020-05-31-170201,170201,0,0,0,528,0.0,249.56287034431836,6
2020-06-01-170201,170201,2,0,4,530,1.5,323.842615544345,0
2020-06-02-170201,170201,12,0,0,542,0.5,68.12908251616419,1
2020-06-03-170201,170201,2,0,0,544,2.5,85.1407027843614,2
2020-06-04-170201,170201,1,0,0,545,3.0,127.48855608865014,3
2020-06-05-170201,170201,2,0,2,547,0.5,128.17076629879426,4
2020-06-06-170201,170201,0,2,1,547,0.0,129.9668436807564,5
2020-06-07-170201,170201,0,0,0,547,0.0,131.4720527598995,6
2020-06-08-170201,170201,1,0,0,548,1.0,131.38016626087418,0
2020-06-09-170201,170201,3,0,2,551,0.0,132.95448991362488,1
2020-06-10-170201,170201,1,1,2,552,0.5,349.6206423510321,2
2020-06-11-170201,170201,2,0,2,554,0.0,259.6671278547286,3
2020-06-12-170201,170201,0,0,1,554,0.5,237.75228846782326,4
2020-06-13-170201,170201,0,0,0,554,0.0,193.34311193359156,5
2020-06-14-170201,170201,0,0,0,554,0.0,154.0237032797392,6
2020-06-15-170201,170201,4,0,1,558,0.0,87.98378539005097,0
2020-06-16-170201,170201,0,1,5,558,0.0,85.4883642776035,1
2020-06-17-170201,170201,0,0,1,558,1.0,58.124554436419324,2
2020-06-18-170201,170201,0,0,0,558,0.5,51.12236104254096,3
2020-06-19-170201,170201,2,0,0,560,0.5,39.10377285601196,4
2020-06-20-170201,170201,1,0,0,561,0.0,160.46738324087048,5
2020-06-21-170201,170201,0,0,0,561,0.0,173.57358428243958,6
2020-06-22-170201,170201,0,0,1,561,0.5,146.70914391175802,0
2020-06-23-170201,170201,2,0,3,563,0.5,163.697306260414,1
2020-06-24-170201,170201,2,0,1,565,0.5,189.3234546659142,2
2020-06-25-170201,170201,2,0,2,567,1.0,205.96073384074583,3
2020-06-26-170201,170201,1,0,1,568,0.5,190.2757382772864,4
2020-06-27-170201,170201,0,0,0,568,0.0,110.4548635055738,5
2020-06-28-170201,170201,0,0,0,568,0.0,97.90528787050802,6
2020-06-29-170201,170201,1,0,0,569,0.5,97.75486139470303,0
2020-06-30-170201,170201,5,0,0,574,0.5,114.22763041910049,1
2020-07-01-170201,170201,1,0,0,575,1.5,123.52891119211799,2
2020-07-02-170201,170201,0,0,2,575,0.0,47.222586908470156,3
2020-07-03-170201,170201,0,0,0,575,0.0,243.84732720211701,4
2020-07-04-170201,170201,0,0,1,575,0.5,453.00954403273363,5
2020-07-05-170201,170201,0,0,2,575,1.0,437.03069904624266,6
2020-07-06-170201,170201,1,0,1,576,1.5,395.4314229232772,0
2020-07-07-170201,170201,3,0,2,579,0.5,341.1128565964147,1
2020-07-08-170201,170201,1,0,1,580,0.5,309.6751584747151,2
2020-07-09-170201,170201,2,0,2,582,0.5,306.9175831924307,3
2020-07-10-170201,170201,1,0,0,583,1.0,99.21249976720507,4
2020-07-11-170201,170201,0,0,0,583,0.0,101.32099252152862,5
2020-07-12-170201,170201,0,0,3,583,0.0,84.98380539554138,6
2020-07-13-170201,170201,0,0,6,583,0.5,84.35818452256808,0
2020-07-14-170201,170201,0,0,7,583,0.5,88.07841313937891,1
2020-07-15-170201,170201,0,0,5,583,1.0,77.56324476727757,2
2020-07-16-170201,170201,2,0,8,585,1.0,62.482467018900174,3
2020-07-17-170201,170201,0,0,33,585,1.5,52.66628712829444,4
2020-07-18-170201,170201,1,0,7,586,0.0,32.1423917481668,5
2020-07-19-170201,170201,2,0,4,588,0.0,39.51741025778971,6
2020-07-20-170201,170201,1,0,38,589,1.0,44.15830309353558,0
2020-07-21-170201,170201,2,0,27,591,0.5,55.9268773822087,1
2020-07-22-170201,170201,1,0,28,592,1.0,77.6840807440879,2
2020-07-23-170201,170201,2,0,49,594,0.5,79.42937103667616,3
2020-07-24-170201,170201,0,0,34,594,0.5,99.77239177230408,4
2020-07-25-170201,170201,0,0,11,594,0.5,105.06257244452593,5
2020-07-26-170201,170201,3,0,17,597,1.5,116.64158414582019,6
2020-07-27-170201,170201,6,0,46,603,0.0,136.79536030665585,0
2020-07-28-170201,170201,7,0,31,610,2.0,166.73704479564805,1
2020-07-29-170201,170201,5,0,15,615,3.0,199.8469600660954,2
2020-07-30-170201,170201,8,0,29,623,2.5,218.0802745426557,3
2020-07-31-170201,170201,33,0,33,656,3.5,358.7946844340501,4
2020-08-01-170201,170201,7,0,7,663,6.0,179.4943485317335,5
2020-08-02-170201,170201,4,0,5,667,0.5,2201.730824675673,6
2020-08-03-170201,170201,38,0,31,705,11.0,809.6173320351863,0
2020-08-04-170201,170201,27,0,37,732,14.0,960.1726311290367,1
2020-08-05-170201,170201,28,0,28,760,16.0,1113.953382465537,2
2020-08-06-170201,170201,49,0,20,809,25.0,1338.5931426831849,3
2020-08-07-170201,170201,34,0,17,843,12.0,1786.259888439539,4
2020-08-08-170201,170201,11,0,7,854,19.0,2038.0928904720115,5
2020-08-09-170201,170201,17,0,3,871,17.5,1866.0203981722746,6
2020-08-10-170201,170201,46,0,8,917,35.5,144.33458577984868,0
2020-08-11-170201,170201,31,0,16,948,13.0,689.9366790902324,1
2020-08-12-170201,170201,15,0,5,963,11.5,1092.5654288142143,2
2020-08-13-170201,170201,29,0,13,992,17.0,1243.1983884900249,3
2020-08-14-170201,170201,33,0,7,1025,12.5,1359.173815603082,4
2020-08-15-170201,170201,7,0,4,1032,8.0,1669.1567580423193,5
2020-08-16-170201,170201,5,0,2,1037,1.5,1782.2387983562267,6
2020-08-17-170201,170201,31,0,8,1068,26.0,1764.032522788137,0
2020-08-18-170201,170201,37,0,5,1105,15.5,1758.825617217812,1
2020-08-19-170201,170201,28,0,7,1133,13.0,1710.0658021571967,2
2020-08-20-170201,170201,20,1,10,1153,8.0,1669.4883729269304,3
2020-08-21-170201,170201,17,0,2,1170,12.5,1584.2027800566063,4
2020-08-22-170201,170201,7,0,6,1177,0.5,1634.383496774723,5
2020-08-23-170201,170201,3,1,3,1180,4.5,1670.7274543908784,6
2020-08-24-170201,170201,8,0,8,1188,6.0,1223.8568379750282,0
2020-08-25-170201,170201,16,0,5,1204,6.0,977.2699865666594,1
2020-08-26-170201,170201,5,0,12,1209,10.0,829.8730709220163,2
2020-08-27-170201,170201,13,0,11,1222,7.0,940.4190320960024,3
2020-08-28-170201,170201,7,0,6,1229,6.0,848.7393470276484,4
2020-08-29-170201,170201,4,0,0,1233,0.5,760.3561475470123,5
2020-08-30-170201,170201,2,0,4,1235,1.0,995.0316438032745,6
2020-08-31-170201,170201,8,0,7,1243,5.5,933.7081855405997,0
2020-09-01-170201,170201,5,1,1,1248,0.5,2117.498330412968,1
2020-09-02-170201,170201,7,0,3,1255,14.0,729.1983881334594,2
2020-09-03-170201,170201,10,1,12,1265,4.5,624.7525968519485,3
2020-09-04-170201,170201,2,0,4,1267,5.0,722.5471445095534,4
2020-09-05-170201,170201,6,1,5,1273,1.5,691.6486020587748,5
2020-09-06-170201,170201,3,0,4,1276,2.5,673.5791306439888,6
2020-09-07-170201,170201,8,0,7,1284,5.5,736.5859341453797,0
2020-09-08-170201,170201,5,1,17,1289,4.0,716.5200802084502,1
2020-09-09-170201,170201,12,0,9,1301,3.5,714.7561657619517,2
2020-09-10-170201,170201,11,0,8,1312,16.0,2199.1078792934904,3
2020-09-11-170201,170201,6,0,6,1318,13.5,2195.88937690097,4
2020-09-12-170201,170201,0,0,4,1318,3.5,2037.1034127483795,5
2020-09-13-170201,170201,4,0,3,1322,6.5,1485.8464338912008,6
2020-09-14-170201,170201,7,0,9,1329,7.0,1225.9557988436222,0
2020-09-15-170201,170201,1,0,2,1330,5.5,1053.093516828706,1
2020-09-16-170201,170201,3,0,10,1333,7.0,898.6149923422421,2
2020-09-17-170201,170201,12,0,12,1345,7.5,933.8091086399684,3
2020-09-18-170201,170201,4,0,6,1349,11.5,794.7265639922477,4
2020-09-19-170201,170201,5,0,3,1354,6.0,633.0853992903624,5
2020-09-20-170201,170201,4,1,7,1358,7.0,658.0871465719181,6
2020-09-21-170201,170201,7,1,21,1365,9.0,689.8520225832203,0
2020-09-22-170201,170201,17,0,13,1382,7.5,734.7200846904889,1
2020-09-23-170201,170201,9,1,19,1391,8.0,816.6953988873481,2
2020-09-24-170201,170201,8,0,16,1399,8.0,769.4142224292395,3
2020-09-25-170201,170201,6,0,29,1405,6.0,789.3260344538487,4
2020-09-26-170201,170201,4,1,4,1409,3.0,825.609997405287,5
2020-09-27-170201,170201,3,0,7,1412,1.5,784.6764243640528,6
2020-09-28-170201,170201,9,0,10,1421,6.5,697.9563401981818,0
2020-09-29-170201,170201,2,0,17,1423,3.5,658.4897704726708,1
2020-09-30-170201,170201,10,0,22,1433,5.5,695.6202872409705,2
2020-10-01-170201,170201,12,0,24,1445,3.5,0.0,3
2020-10-02-170201,170201,6,0,40,1451,4.5,1352.6170248573255,4
2020-10-03-170201,170201,3,2,5,1454,3.5,1644.476021432781,5
2020-10-04-170201,170201,7,1,15,1461,5.5,1683.3970205746737,6
2020-10-05-170201,170201,21,0,33,1482,5.0,1462.1302973321558,0
2020-10-06-170201,170201,13,0,20,1495,7.5,1387.363295650248,1
2020-10-07-170201,170201,19,1,31,1514,7.0,1189.4605605880777,2
2020-10-08-170201,170201,16,0,21,1530,9.0,1098.0124086415888,3
2020-10-09-170201,170201,29,0,31,1559,8.5,1212.9851286432083,4
2020-10-10-170201,170201,4,0,6,1563,3.0,119.01529031418744,5
2020-10-11-170201,170201,7,0,9,1570,3.5,183.5359616032195,6
2020-10-12-170201,170201,10,0,23,1580,6.0,272.32281346573683,0
2020-10-13-170201,170201,17,0,19,1597,9.0,412.0066583902329,1
2020-10-14-170201,170201,22,0,27,1619,7.5,590.2904441147634,2
2020-10-15-170201,170201,24,0,22,1643,11.0,810.4800150593637,3
2020-10-16-170201,170201,40,0,31,1683,4.5,1002.9669586502625,4
2020-10-17-170201,170201,5,0,9,1688,0.0,1071.693966404699,5
2020-10-18-170201,170201,15,0,8,1703,5.5,1054.1352267646985,6
2020-10-19-170201,170201,33,0,6,1736,14.5,1134.169401498396,0
2020-10-20-170201,170201,20,0,22,1756,8.5,1269.7898505743512,1
2020-10-21-170201,170201,31,0,23,1787,15.5,1218.995534501118,2
2020-10-22-170201,170201,21,0,19,1808,15.0,1301.441224836939,3
2020-10-23-170201,170201,31,0,17,1839,19.5,1345.5772973398678,4
2020-10-24-170201,170201,6,2,14,1845,4.5,1528.0480886380735,5
2020-10-25-170201,170201,9,2,8,1854,5.0,1434.034973228151,6
2020-10-26-170201,170201,23,0,16,1877,14.0,1224.8234887978374,0
2020-10-27-170201,170201,19,1,13,1896,10.5,1402.1880377613725,1
2020-10-28-170201,170201,27,2,32,1923,12.0,1437.629007494434,2
2020-10-29-170201,170201,22,0,19,1945,16.5,1486.5391368068128,3
2020-10-30-170201,170201,31,0,19,1976,11.0,1373.7082366544691,4
2020-10-31-170201,170201,9,0,0,1985,5.0,1609.1500540103436,5
2020-11-01-170201,170201,8,0,0,1993,4.5,1081.6570801572025,6
2020-11-02-170201,170201,6,1,0,1999,8.5,1211.300331576192,0
2020-11-03-170201,170201,22,0,0,2021,18.5,1032.8154289184608,1
2020-11-04-170201,170201,23,0,0,2044,10.0,1346.375010818004,2
2020-11-05-170201,170201,19,0,0,2063,19.5,1383.5420042513872,3
2020-11-06-170201,170201,17,0,0,2080,16.0,1566.1703621828335,4
2020-11-07-170201,170201,14,0,0,2094,5.5,1672.7076964880423,5
2020-11-08-170201,170201,8,0,0,2102,3.0,1636.2128885528168,6
2020-11-09-170201,170201,16,1,0,2118,9.5,1582.3409083172396,0
2020-11-10-170201,170201,13,0,0,2131,6.0,1067.4227706666154,1
2020-11-11-170201,170201,32,0,0,2163,10.5,1135.5820900064907,2
2020-11-12-170201,170201,19,0,0,2182,12.5,1284.03861125353,3
2020-11-13-170201,170201,19,1,0,2201,6.0,1385.2518453981884,4
2020-03-01-170202,170202,0,0,0,0,0.0,0.0,6
2020-03-02-170202,170202,0,0,5,0,0.1111111111111111,87.5230436478932,0
2020-03-03-170202,170202,0,0,9,0,0.0,386.916304939747,1
2020-03-04-170202,170202,0,1,6,0,0.1111111111111111,401.56698695590364,2
2020-03-05-170202,170202,0,0,10,0,0.0,444.7561195363479,3
2020-03-06-170202,170202,0,0,4,0,0.0,411.5106712098925,4
2020-03-07-170202,170202,0,0,1,0,0.0,423.9750307129866,5
2020-03-08-170202,170202,0,0,1,0,0.0,421.5356521130477,6
2020-03-09-170202,170202,0,0,25,0,0.1111111111111111,421.9299290904148,0
2020-03-10-170202,170202,0,0,12,0,0.3333333333333333,1184.4332805161791,1
2020-03-11-170202,170202,1,0,18,1,0.0,1004.624268949229,2
2020-03-12-170202,170202,1,0,9,2,0.6666666666666666,726.7181128406578,3
2020-03-13-170202,170202,0,0,10,2,1.3333333333333333,476.49827349559934,4
2020-03-14-170202,170202,5,0,4,7,1.5555555555555556,354.1691410001925,5
2020-03-15-170202,170202,0,0,3,7,1.4444444444444444,300.9383454725553,6
2020-03-16-170202,170202,5,0,11,12,3.0,132.17020412843164,0
2020-03-17-170202,170202,9,0,11,21,3.0,199.6102170061003,1
2020-03-18-170202,170202,6,0,14,27,7.5555555555555545,283.89196855979424,2
2020-03-19-170202,170202,10,1,2,37,7.333333333333332,416.47733499962874,3
2020-03-20-170202,170202,4,0,4,41,5.777777777777778,517.9593782885246,4
2020-03-21-170202,170202,1,0,2,42,4.777777777777779,533.2107264294614,5
2020-03-22-170202,170202,1,0,0,43,4.4444444444444455,562.1551784271018,6
2020-03-23-170202,170202,25,0,3,68,9.444444444444443,549.2697245449313,0
2020-03-24-170202,170202,12,0,5,80,7.888888888888888,697.4637992715086,1
2020-03-25-170202,170202,18,0,4,98,6.4444444444444455,724.6095814054735,2
2020-03-26-170202,170202,9,0,2,107,5.4444444444444455,744.4175648390733,3
2020-03-27-170202,170202,10,0,1,117,5.4444444444444455,848.111043559328,4
2020-03-28-170202,170202,4,0,1,121,2.4444444444444446,881.109165356563,5
2020-03-29-170202,170202,3,0,1,124,1.6666666666666667,871.9602517882267,6
2020-03-30-170202,170202,11,0,5,135,6.666666666666668,632.8403945401444,0
2020-03-31-170202,170202,11,0,6,146,4.888888888888889,596.7953022779998,1
2020-04-01-170202,170202,14,0,1,160,4.888888888888889,112.17175393870744,2
2020-04-02-170202,170202,2,0,3,162,2.888888888888889,424.3884560220504,3
2020-04-03-170202,170202,4,0,19,166,3.2222222222222223,131.56104810806139,4
2020-04-04-170202,170202,2,0,0,168,1.1111111111111112,156.7153939691461,5
2020-04-05-170202,170202,0,0,2,168,0.6666666666666666,172.26473535837852,6
2020-04-06-170202,170202,3,0,6,171,4.222222222222221,166.30851705798216,0
2020-04-07-170202,170202,5,1,1,176,2.6666666666666665,186.106863242665,1
2020-04-08-170202,170202,4,1,0,180,2.6666666666666665,227.97535627684806,2
2020-04-09-170202,170202,2,0,0,182,1.3333333333333333,253.0885150960738,3
2020-04-10-170202,170202,1,0,2,183,1.8888888888888888,100.31839551164548,4
2020-04-11-170202,170202,1,2,0,184,0.7777777777777778,115.20162130753215,5
2020-04-12-170202,170202,1,0,2,185,2.333333333333333,123.78377286099177,6
2020-04-13-170202,170202,5,0,3,190,3.0,138.80132339882732,0
2020-04-14-170202,170202,6,0,2,196,15.333333333333336,194.18859205970386,1
2020-04-15-170202,170202,1,0,4,197,2.1111111111111107,376.26766112446865,2
2020-04-16-170202,170202,3,0,0,200,1.8888888888888888,399.43407522230706,3
2020-04-17-170202,170202,19,0,0,219,2.6666666666666665,349.9466745753615,4
2020-04-18-170202,170202,0,0,0,219,0.7777777777777778,466.9709634155598,5
2020-04-19-170202,170202,2,0,0,221,0.4444444444444444,465.3623207038587,6
2020-04-20-170202,170202,6,0,5,227,1.6666666666666667,449.8762133388842,0
2020-04-21-170202,170202,1,2,0,228,1.6666666666666667,297.8604143588365,1
2020-04-22-170202,170202,0,0,2,228,0.8888888888888888,291.13355799198035,2
2020-04-23-170202,170202,0,1,0,228,1.0,279.40428779761305,3
2020-04-24-170202,170202,2,0,0,230,1.7777777777777777,159.70963470430485,4
2020-04-25-170202,170202,0,0,0,230,0.2222222222222222,186.66991295471394,5
2020-04-26-170202,170202,2,0,0,232,0.4444444444444444,171.43740235260353,6
2020-04-27-170202,170202,3,0,1,235,1.5555555555555556,139.4480470347893,0
2020-04-28-170202,170202,2,0,0,237,1.6666666666666667,132.00107694049356,1
2020-04-29-170202,170202,4,0,4,241,1.3333333333333333,129.86626463986204,2
2020-04-30-170202,170202,0,0,1,241,1.6666666666666667,202.21090095783742,3
2020-05-01-170202,170202,0,0,1,241,0.7777777777777778,265.3941936535853,4
2020-05-02-170202,170202,0,0,0,241,0.3333333333333333,164.61399649714352,5
2020-05-03-170202,170202,0,0,0,241,0.5555555555555556,122.97729864043333,6
2020-05-04-170202,170202,5,0,5,246,2.0,92.84228700311093,0
2020-05-05-170202,170202,0,1,2,246,1.1111111111111112,112.9671739709386,1
2020-05-06-170202,170202,2,0,4,248,1.0,118.33767407047868,2
2020-05-07-170202,170202,0,0,2,248,1.7777777777777777,120.62694845139183,3
2020-05-08-170202,170202,0,0,0,248,2.0,122.31764031767602,4
2020-05-09-170202,170202,0,0,0,248,0.4444444444444444,158.41705592534043,5
2020-05-10-170202,170202,0,2,0,248,0.3333333333333333,292.2807170028302,6
2020-05-11-170202,170202,1,1,3,249,1.1111111111111112,277.11639735658116,0
2020-05-12-170202,170202,0,0,2,249,1.0,294.12683851818446,1
2020-05-13-170202,170202,4,0,0,253,1.8888888888888888,232.26260840086672,2
2020-05-14-170202,170202,1,2,0,254,1.3333333333333333,212.7255182466464,3
2020-05-15-170202,170202,1,0,2,255,1.8888888888888888,161.5540273861535,4
2020-05-16-170202,170202,0,0,0,255,0.3333333333333333,160.0712985754727,5
2020-05-17-170202,170202,0,0,0,255,0.2222222222222222,154.92000067107597,6
2020-05-18-170202,170202,5,0,1,260,1.8888888888888888,147.87350812357647,0
2020-05-19-170202,170202,2,0,0,262,2.1111111111111107,174.9018086585243,1
2020-05-20-170202,170202,4,0,2,266,1.8888888888888888,147.88656267524436,2
2020-05-21-170202,170202,2,0,1,268,1.1111111111111112,175.68273731962614,3
2020-05-22-170202,170202,0,0,0,268,1.1111111111111112,177.05721268128653,4
2020-05-23-170202,170202,0,0,0,268,0.7777777777777778,194.93777257966204,5
2020-05-24-170202,170202,0,0,0,268,0.3333333333333333,202.22068640767606,6
2020-05-25-170202,170202,3,0,0,271,1.1111111111111112,151.58951260252633,0
2020-05-26-170202,170202,2,0,0,273,2.1111111111111107,154.87080553440686,1
2020-05-27-170202,170202,0,1,0,273,1.4444444444444444,193.56621409028133,2
2020-05-28-170202,170202,0,1,0,273,1.2222222222222223,164.2500738766765,3
2020-05-29-170202,170202,2,2,0,275,0.5555555555555556,161.30609098990362,4
2020-05-30-170202,170202,0,0,0,275,0.0,173.5798014916204,5
2020-05-31-170202,170202,0,0,0,275,0.1111111111111111,175.40618601084913,6
2020-06-01-170202,170202,1,0,0,276,0.6666666666666666,221.0537885325042,0
2020-06-02-170202,170202,0,0,0,276,1.8888888888888888,49.36429084942105,1
2020-06-03-170202,170202,2,0,0,278,0.8888888888888888,59.14662428412551,2
2020-06-04-170202,170202,1,0,0,279,1.2222222222222223,86.83144982396384,3
2020-06-05-170202,170202,0,0,1,279,0.4444444444444444,88.70701114752104,4
2020-06-06-170202,170202,0,0,0,279,0.3333333333333333,88.4667210048052,5
2020-06-07-170202,170202,0,0,0,279,0.0,91.06580927342816,6
2020-06-08-170202,170202,0,0,1,279,0.4444444444444444,90.81125445808351,0
2020-06-09-170202,170202,0,0,1,279,0.6666666666666666,91.19547131316594,1
2020-06-10-170202,170202,0,0,0,279,0.2222222222222222,236.4728981334191,2
2020-06-11-170202,170202,0,0,0,279,0.6666666666666666,175.7456368501654,3
2020-06-12-170202,170202,0,0,0,279,0.3333333333333333,160.51426577033632,4
2020-06-13-170202,170202,0,0,0,279,0.0,129.47236811172678,5
2020-06-14-170202,170202,0,0,0,279,0.1111111111111111,100.82997716687758,6
2020-06-15-170202,170202,0,0,1,279,0.4444444444444444,58.19292661566767,0
2020-06-16-170202,170202,0,0,0,279,0.3333333333333333,55.692134614388074,1
2020-06-17-170202,170202,0,0,2,279,0.3333333333333333,39.53156994216386,2
2020-06-18-170202,170202,0,1,0,279,0.3333333333333333,35.35625852713271,3
2020-06-19-170202,170202,1,0,0,280,0.7777777777777778,27.738708047035608,4
2020-06-20-170202,170202,0,0,0,280,0.3333333333333333,104.85852437427246,5
2020-06-21-170202,170202,0,0,0,280,0.0,114.09611012814938,6
2020-06-22-170202,170202,1,0,0,281,0.2222222222222222,97.97750104228565,0
2020-06-23-170202,170202,1,0,0,282,0.4444444444444444,108.57734025297168,1
2020-06-24-170202,170202,0,0,0,282,0.8888888888888888,124.86530166047004,2
2020-06-25-170202,170202,0,0,0,282,0.4444444444444444,135.6706085972861,3
2020-06-26-170202,170202,0,0,1,282,0.6666666666666666,122.11828018326321,4
2020-06-27-170202,170202,0,0,0,282,0.0,76.28423919794193,5
2020-06-28-170202,170202,0,0,0,282,0.0,68.00753236728863,6
2020-06-29-170202,170202,1,0,0,283,0.3333333333333333,68.46055549061012,0
2020-06-30-170202,170202,0,0,1,283,1.1111111111111112,79.92314030156774,1
2020-07-01-170202,170202,2,0,1,285,0.3333333333333333,85.38061318797165,2
2020-07-02-170202,170202,0,0,1,285,0.3333333333333333,36.496092022250465,3
2020-07-03-170202,170202,0,0,0,285,0.7777777777777778,155.53893776109584,4
2020-07-04-170202,170202,0,0,0,285,0.2222222222222222,281.4692161323562,5
2020-07-05-170202,170202,0,0,0,285,0.2222222222222222,273.24794206584073,6
2020-07-06-170202,170202,0,0,1,285,0.7777777777777778,248.59929198710313,0
2020-07-07-170202,170202,0,1,0,285,0.5555555555555556,215.2621289323559,1
2020-07-08-170202,170202,0,0,0,285,0.4444444444444444,196.3774670877346,2
2020-07-09-170202,170202,0,0,0,285,0.4444444444444444,193.9744984015304,3
2020-07-10-170202,170202,1,0,1,286,0.5555555555555556,70.84416239951291,4
2020-07-11-170202,170202,0,0,1,286,0.1111111111111111,73.02010914658494,5
2020-07-12-170202,170202,0,0,0,286,0.2222222222222222,62.05620864574281,6
2020-07-13-170202,170202,0,0,0,286,0.3333333333333333,60.857347823486585,0
2020-07-14-170202,170202,1,0,1,287,0.3333333333333333,64.6106322999735,1
2020-07-15-170202,170202,1,0,0,288,0.6666666666666666,59.03002156346537,2
2020-07-16-170202,170202,1,0,1,289,0.6666666666666666,49.616241907333375,3
2020-07-17-170202,170202,0,0,2,289,0.3333333333333333,43.8613515846686,4
2020-07-18-170202,170202,0,0,3,289,0.1111111111111111,28.8296031111381,5
2020-07-19-170202,170202,0,1,0,289,0.4444444444444444,33.98488831473712,6
2020-07-20-170202,170202,1,0,6,290,0.2222222222222222,36.09886997632291,0
2020-07-21-170202,170202,0,1,5,290,0.5555555555555556,43.15535858436266,1
2020-07-22-170202,170202,0,0,12,290,0.5555555555555556,57.61832430421659,2
2020-07-23-170202,170202,0,0,15,290,0.7777777777777778,58.632983686244295,3
2020-07-24-170202,170202,1,0,10,291,0.0,71.68519158752241,4
2020-07-25-170202,170202,1,0,8,292,0.2222222222222222,77.29592978001885,5
2020-07-26-170202,170202,0,0,14,292,0.8888888888888888,84.5374367961668,6
2020-07-27-170202,170202,0,0,27,292,0.6666666666666666,95.94368692129775,0
2020-07-28-170202,170202,1,0,18,293,1.1111111111111112,112.46224407429472,1
2020-07-29-170202,170202,0,0,9,293,1.7777777777777777,132.25544639959,2
2020-07-30-170202,170202,1,0,11,294,1.5555555555555556,145.6355060797022,3
2020-07-31-170202,170202,2,0,9,296,5.0,229.5541545807663,4
2020-08-01-170202,170202,3,0,10,299,2.1111111111111107,116.10922052495502,5
2020-08-02-170202,170202,0,0,1,299,0.7777777777777778,1492.0652516527412,6
2020-08-03-170202,170202,6,0,35,305,6.222222222222222,600.9965569336398,0
2020-08-04-170202,170202,5,0,11,310,5.888888888888888,678.9423199451178,1
2020-08-05-170202,170202,12,0,11,322,5.5555555555555545,769.7851833829454,2
2020-08-06-170202,170202,15,1,9,337,9.888888888888891,915.8037246582447,3
2020-08-07-170202,170202,10,0,8,347,5.5555555555555545,1202.7577661691391,4
2020-08-08-170202,170202,8,0,1,355,5.0,1348.833125432705,5
2020-08-09-170202,170202,14,0,4,369,4.4444444444444455,1233.8814002050165,6
2020-08-10-170202,170202,27,0,5,396,10.555555555555557,94.99209255033824,0
2020-08-11-170202,170202,18,0,3,414,5.111111111111111,444.89339127671656,1
2020-08-12-170202,170202,9,0,6,423,5.222222222222221,709.6261851267041,2
2020-08-13-170202,170202,11,0,7,434,8.11111111111111,818.041514378556,3
2020-08-14-170202,170202,9,0,4,443,8.555555555555555,889.3872294180142,4
2020-08-15-170202,170202,10,0,0,453,2.888888888888889,1094.8029872763545,5
2020-08-16-170202,170202,1,0,1,454,2.2222222222222223,1185.1418176831726,6
2020-08-17-170202,170202,35,0,1,489,6.333333333333332,1182.1334252800577,0
2020-08-18-170202,170202,11,1,0,500,7.888888888888888,1201.4597362443888,1
2020-08-19-170202,170202,11,0,1,511,6.5555555555555545,1162.57268260423,2
2020-08-20-170202,170202,9,1,3,520,4.666666666666667,1117.9859146023227,3
2020-08-21-170202,170202,8,0,3,528,5.4444444444444455,1071.4196205806074,4
2020-08-22-170202,170202,1,0,1,529,2.2222222222222223,1097.0481270943262,5
2020-08-23-170202,170202,4,0,1,533,2.333333333333333,1126.2784309123888,6
2020-08-24-170202,170202,5,0,2,538,3.333333333333333,835.1434882821641,0
2020-08-25-170202,170202,3,0,3,541,5.222222222222221,689.7397725284461,1
2020-08-26-170202,170202,6,0,2,547,3.4444444444444446,595.6811532439824,2
2020-08-27-170202,170202,7,0,20,554,4.111111111111111,677.4284816852454,3
2020-08-28-170202,170202,4,0,17,558,3.0,613.8932265343893,4
2020-08-29-170202,170202,0,0,1,558,2.888888888888889,561.1398287945885,5
2020-08-30-170202,170202,1,0,8,559,2.555555555555556,703.0435248623568,6
2020-08-31-170202,170202,1,1,2,560,2.7777777777777777,663.9014289818817,0
2020-09-01-170202,170202,0,1,8,560,1.8888888888888888,1360.4012307980493,1
2020-09-02-170202,170202,1,0,0,561,4.666666666666667,551.640590719215,2
2020-09-03-170202,170202,3,0,4,564,5.0,459.66735487407186,3
2020-09-04-170202,170202,3,0,6,567,3.0,530.9625248756939,4
2020-09-05-170202,170202,1,0,5,568,1.3333333333333333,500.06279841268685,5
2020-09-06-170202,170202,1,0,8,569,2.7777777777777777,483.7667396066596,6
2020-09-07-170202,170202,2,1,7,571,3.2222222222222223,533.3687174944482,0
2020-09-08-170202,170202,3,0,2,574,3.111111111111111,518.2985731467211,1
2020-09-09-170202,170202,2,0,1,576,3.4444444444444446,510.0953785560373,2
2020-09-10-170202,170202,20,0,4,596,4.4444444444444455,1353.9472619210883,3
2020-09-11-170202,170202,17,1,3,613,4.777777777777779,1378.7821735722953,4
2020-09-12-170202,170202,1,0,2,614,2.888888888888889,1306.2668311620957,5
2020-09-13-170202,170202,8,0,2,622,2.0,980.2228573465984,6
2020-09-14-170202,170202,2,0,1,624,4.0,828.2551474837672,0
2020-09-15-170202,170202,8,0,1,632,3.4444444444444446,729.5782730030553,1
2020-09-16-170202,170202,0,0,1,632,5.333333333333333,660.6423746657387,2
2020-09-17-170202,170202,4,0,3,636,4.666666666666667,698.6542630637808,3
2020-09-18-170202,170202,6,0,1,642,4.4444444444444455,598.6984292207151,4
2020-09-19-170202,170202,5,2,1,647,2.1111111111111107,482.08355821107483,5
2020-09-20-170202,170202,8,1,4,655,2.555555555555556,475.27202740655014,6
2020-09-21-170202,170202,7,1,0,662,3.6666666666666665,496.4678403005568,0
2020-09-22-170202,170202,2,1,1,664,5.111111111111111,506.24344218435726,1
2020-09-23-170202,170202,1,1,2,665,4.333333333333333,537.3562293162621,2
2020-09-24-170202,170202,4,2,2,669,3.555555555555556,503.01940643994357,3
2020-09-25-170202,170202,3,0,1,672,4.888888888888889,512.179130288456,4
2020-09-26-170202,170202,2,2,4,674,1.7777777777777777,548.9528632577253,5
2020-09-27-170202,170202,2,0,4,676,1.1111111111111112,533.447868464859,6
2020-09-28-170202,170202,1,1,6,677,4.333333333333333,478.9334694109997,0
2020-09-29-170202,170202,1,0,5,678,3.0,458.28277647862603,1
2020-09-30-170202,170202,1,0,2,679,3.888888888888889,504.7203993599174,2
2020-10-01-170202,170202,3,0,3,682,3.6666666666666665,0.0,3
2020-10-02-170202,170202,1,1,4,683,5.111111111111111,931.3946578622301,4
2020-10-03-170202,170202,1,0,0,684,2.555555555555556,1181.523162515088,5
2020-10-04-170202,170202,4,0,6,688,3.111111111111111,1217.2455119498106,6
2020-10-05-170202,170202,0,0,9,688,4.666666666666667,1060.2169581963958,0
2020-10-06-170202,170202,1,0,2,689,4.888888888888889,998.5756789509654,1
2020-10-07-170202,170202,2,0,7,691,4.888888888888889,855.5773633881811,2
2020-10-08-170202,170202,2,1,8,693,8.11111111111111,780.4407380510966,3
2020-10-09-170202,170202,1,1,5,694,6.777777777777778,858.4145500363711,4
2020-10-10-170202,170202,4,0,1,698,2.1111111111111107,83.40371350422316,5
2020-10-11-170202,170202,4,0,3,702,2.4444444444444446,132.1193347472789,6
2020-10-12-170202,170202,6,0,8,708,3.0,200.34311345841212,0
2020-10-13-170202,170202,5,0,4,713,5.0,301.966188252042,1
2020-10-14-170202,170202,2,0,10,715,7.111111111111112,424.4638071203526,2
2020-10-15-170202,170202,3,0,11,718,6.111111111111112,575.3490923345255,3
2020-10-16-170202,170202,4,0,15,722,7.888888888888888,708.2068694883421,4
2020-10-17-170202,170202,0,0,3,722,2.0,747.908507253437,5
2020-10-18-170202,170202,6,2,5,728,3.4444444444444446,730.4131205134643,6
2020-10-19-170202,170202,9,0,9,737,7.5555555555555545,770.3980694975702,0
2020-10-20-170202,170202,2,0,17,739,4.888888888888889,855.6130277782421,1
2020-10-21-170202,170202,7,0,2,746,8.777777777777779,814.734064573453,2
2020-10-22-170202,170202,8,0,8,754,7.0,867.5622722392942,3
2020-10-23-170202,170202,5,0,17,759,9.888888888888891,892.8177679455605,4
2020-10-24-170202,170202,1,0,5,760,3.0,1009.1260388635461,5
2020-10-25-170202,170202,3,1,3,763,3.0,951.7556377410111,6
2020-10-26-170202,170202,8,1,9,771,7.222222222222222,820.3242652160434,0
2020-10-27-170202,170202,4,1,3,775,6.0,927.2620704808353,1
2020-10-28-170202,170202,10,1,10,785,10.888888888888891,962.3736090581618,2
2020-10-29-170202,170202,11,1,18,796,9.111111111111109,1007.7956672120556,3
2020-10-30-170202,170202,15,0,3,811,9.0,938.2517084146834,4
2020-10-31-170202,170202,3,0,0,814,5.4444444444444455,1090.6703396514356,5
2020-11-01-170202,170202,5,2,0,819,4.4444444444444455,721.4232403955127,6
2020-11-02-170202,170202,9,1,0,828,3.888888888888889,834.654300626753,0
2020-11-03-170202,170202,17,0,0,845,8.444444444444445,715.3195789227974,1
2020-11-04-170202,170202,2,2,0,847,8.0,922.9734928452751,2
2020-11-05-170202,170202,8,2,0,855,9.555555555555557,946.4944914644996,3
2020-11-06-170202,170202,17,1,0,872,7.888888888888888,1070.2714346107516,4
2020-11-07-170202,170202,5,1,0,877,4.888888888888889,1152.1242321764237,5
2020-11-08-170202,170202,3,1,0,880,5.222222222222221,1119.6367228624472,6
2020-11-09-170202,170202,9,0,0,889,4.888888888888889,1079.6106500801166,0
2020-11-10-170202,170202,3,0,0,892,5.888888888888888,698.9959149892373,1
2020-11-11-170202,170202,10,0,0,902,7.0,758.8941507220699,2
2020-11-12-170202,170202,18,0,0,920,5.0,869.6274357756772,3
2020-11-13-170202,170202,3,1,0,923,6.333333333333332,948.0337295620616,4
2020-03-01-170203,170203,0,0,4,0,0.0,0.0,6
2020-03-02-170203,170203,1,0,8,1,0.0,30.654701122205744,0
2020-03-03-170203,170203,0,0,9,1,0.0,135.00896336274096,1
2020-03-04-170203,170203,0,1,20,1,0.5,142.18792538253703,2
2020-03-05-170203,170203,0,1,13,1,0.0,158.49418912537683,3
2020-03-06-170203,170203,0,0,20,1,0.0,147.32759845541543,4
2020-03-07-170203,170203,0,0,10,1,0.0,152.77027129186476,5
2020-03-08-170203,170203,0,0,5,1,0.0,151.66362476019793,6
2020-03-09-170203,170203,0,0,24,1,0.0,151.56030983562593,0
2020-03-10-170203,170203,1,0,15,2,0.5,397.1392965374027,1
2020-03-11-170203,170203,0,0,21,2,0.5,333.2040740514063,2
2020-03-12-170203,170203,4,1,22,6,0.5,242.23315404530175,3
2020-03-13-170203,170203,3,0,17,9,2.5,159.6350056723117,4
2020-03-14-170203,170203,7,0,4,16,5.5,118.8138756181384,5
2020-03-15-170203,170203,4,0,3,20,0.0,105.2783400678007,6
2020-03-16-170203,170203,8,0,33,28,4.5,46.62001583469788,0
2020-03-17-170203,170203,9,0,15,37,8.5,67.99850367637592,1
2020-03-18-170203,170203,20,0,12,57,16.5,97.36535361345058,2
2020-03-19-170203,170203,13,0,4,70,17.5,144.80999864621276,3
2020-03-20-170203,170203,20,0,14,90,9.5,178.95732579583316,4
2020-03-21-170203,170203,10,0,2,100,8.0,182.03830242951378,5
2020-03-22-170203,170203,5,0,1,105,5.5,195.05809274261588,6
2020-03-23-170203,170203,24,0,15,129,27.0,191.12620973855616,0
2020-03-24-170203,170203,15,0,10,144,19.5,241.2730315715138,1
2020-03-25-170203,170203,21,1,6,165,20.5,247.22794917057294,2
2020-03-26-170203,170203,22,0,5,187,9.0,253.5948278548272,3
2020-03-27-170203,170203,17,1,3,204,13.0,283.3674391198602,4
2020-03-28-170203,170203,4,0,2,208,5.5,292.77749956484394,5
2020-03-29-170203,170203,3,0,3,211,4.5,286.7936865236689,6
2020-03-30-170203,170203,33,0,9,244,14.0,207.54313684577153,0
2020-03-31-170203,170203,15,0,89,259,13.5,196.76566023278616,1
2020-04-01-170203,170203,12,0,3,271,13.5,37.864932425769126,2
2020-04-02-170203,170203,4,0,2,275,4.5,149.0735975611558,3
2020-04-03-170203,170203,14,0,8,289,5.5,43.123798961321825,4
2020-04-04-170203,170203,2,0,1,291,2.0,52.018152200102676,5
2020-04-05-170203,170203,1,0,2,292,0.5,57.12372757090178,6
2020-04-06-170203,170203,15,0,5,307,7.5,55.35992526194423,0
2020-04-07-170203,170203,10,3,2,317,6.5,63.53475084329949,1
2020-04-08-170203,170203,6,0,2,323,7.5,77.24373746955496,2
2020-04-09-170203,170203,5,0,2,328,2.5,86.49257890542853,3
2020-04-10-170203,170203,3,0,4,331,2.5,33.78144420206936,4
2020-04-11-170203,170203,2,0,1,333,1.0,38.79792213715582,5
2020-04-12-170203,170203,3,0,0,336,1.0,41.890172775603624,6
2020-04-13-170203,170203,9,0,6,345,7.5,45.50496307820054,0
2020-04-14-170203,170203,89,0,6,434,24.0,65.15575222593327,1
2020-04-15-170203,170203,3,0,1,437,3.0,137.28319690847906,2
2020-04-16-170203,170203,2,0,2,439,3.5,145.11427731845274,3
2020-04-17-170203,170203,8,1,0,447,12.0,127.3751428068432,4
2020-04-18-170203,170203,1,0,1,448,0.5,165.8461804190405,5
2020-04-19-170203,170203,2,0,0,450,2.0,164.01673725969903,6
2020-04-20-170203,170203,5,0,4,455,5.5,159.19581606047535,0
2020-04-21-170203,170203,2,0,4,457,3.0,96.67982652887815,1
2020-04-22-170203,170203,2,0,4,459,1.5,95.69975989412833,2
2020-04-23-170203,170203,2,0,6,461,0.0,92.01937806940074,3
2020-04-24-170203,170203,4,0,7,465,4.0,51.15557941918134,4
2020-04-25-170203,170203,1,0,0,466,0.0,61.57616445478849,5
2020-04-26-170203,170203,0,0,1,466,1.0,56.278558981656225,6
2020-04-27-170203,170203,6,0,3,472,5.0,45.75033226815132,0
2020-04-28-170203,170203,6,0,5,478,2.5,43.57003169768865,1
2020-04-29-170203,170203,1,0,5,479,5.0,43.26452657272672,2
2020-04-30-170203,170203,2,0,3,481,1.5,68.59258810577022,3
2020-05-01-170203,170203,0,1,10,481,0.5,90.2513966437118,4
2020-05-02-170203,170203,1,0,1,482,0.0,57.263142875664485,5
2020-05-03-170203,170203,0,0,0,482,0.5,39.997997743196564,6
2020-05-04-170203,170203,4,0,6,486,6.0,30.12792308993464,0
2020-05-05-170203,170203,4,0,6,490,1.5,36.4202987561613,1
2020-05-06-170203,170203,4,0,6,494,2.0,39.07767357812163,2
2020-05-07-170203,170203,6,0,3,500,1.0,40.24222768871052,3
2020-05-08-170203,170203,7,0,5,507,3.0,39.99394254639337,4
2020-05-09-170203,170203,0,0,0,507,1.5,52.41324453758389,5
2020-05-10-170203,170203,1,0,0,508,0.0,97.50625779120585,6
2020-05-11-170203,170203,3,0,2,511,2.0,92.5122503980485,0
2020-05-12-170203,170203,5,0,6,516,1.5,98.62901857719201,1
2020-05-13-170203,170203,5,0,3,521,5.5,77.30991612909526,2
2020-05-14-170203,170203,3,0,3,524,1.5,71.01088255109295,3
2020-05-15-170203,170203,10,0,1,534,3.5,52.59177046743679,4
2020-05-16-170203,170203,1,0,0,535,0.0,53.930389869503074,5
2020-05-17-170203,170203,0,0,0,535,0.0,52.36032306771709,6
2020-05-18-170203,170203,6,0,2,541,4.5,50.05749217811163,0
2020-05-19-170203,170203,6,0,1,547,4.0,59.09134317279144,1
2020-05-20-170203,170203,6,0,3,553,4.0,48.75023828632668,2
2020-05-21-170203,170203,3,0,5,556,3.0,58.70881736265671,3
2020-05-22-170203,170203,5,0,1,561,1.5,58.031352781531524,4
2020-05-23-170203,170203,0,0,0,561,0.5,64.46741186242298,5
2020-05-24-170203,170203,0,0,0,561,0.0,66.63210684589276,6
2020-05-25-170203,170203,2,0,2,563,3.5,49.95105596013059,0
2020-05-26-170203,170203,6,0,0,569,3.5,50.09600294212032,1
2020-05-27-170203,170203,3,0,1,572,0.5,64.03966530125882,2
2020-05-28-170203,170203,3,1,0,575,1.5,52.77559868948127,3
2020-05-29-170203,170203,1,0,1,576,2.5,50.97409371598247,4
2020-05-30-170203,170203,0,0,0,576,0.0,54.916237994646465,5
2020-05-31-170203,170203,0,0,0,576,0.0,55.89535545453319,6
2020-06-01-170203,170203,2,2,0,578,1.5,72.53190727446616,0
2020-06-02-170203,170203,1,0,0,579,6.0,15.259112704759794,1
2020-06-03-170203,170203,3,0,2,582,2.0,19.06921088556139,2
2020-06-04-170203,170203,5,0,1,587,1.0,28.554003336515102,3
2020-06-05-170203,170203,1,0,0,588,1.0,28.706817079381505,4
2020-06-06-170203,170203,0,0,0,588,0.0,29.10904546845882,5
2020-06-07-170203,170203,0,2,0,588,0.0,29.446203371376942,6
2020-06-08-170203,170203,2,0,0,590,0.5,29.425620471127523,0
2020-06-09-170203,170203,0,2,0,590,1.5,29.778235573228947,1
2020-06-10-170203,170203,1,0,1,591,0.5,78.30540466696874,2
2020-06-11-170203,170203,0,0,2,591,1.0,58.15830576814008,3
2020-06-12-170203,170203,1,0,1,592,0.0,53.25002866175416,4
2020-06-13-170203,170203,0,0,0,592,0.0,43.303576950481485,5
2020-06-14-170203,170203,0,0,0,592,0.0,34.49703117085477,6
2020-06-15-170203,170203,0,0,0,592,2.0,19.70589006443247,0
2020-06-16-170203,170203,0,0,1,592,0.0,19.14698589771661,1
2020-06-17-170203,170203,2,0,1,594,0.0,13.018286873618269,2
2020-06-18-170203,170203,1,0,0,595,0.0,11.449982155215729,3
2020-06-19-170203,170203,0,0,0,595,1.5,8.758159315883987,4
2020-06-20-170203,170203,0,0,1,595,0.5,35.940242847017345,5
2020-06-21-170203,170203,0,0,2,595,0.0,38.875708101603756,6
2020-06-22-170203,170203,0,0,3,595,0.5,32.85883870766193,0
2020-06-23-170203,170203,0,0,1,595,1.5,36.663730890612605,1
2020-06-24-170203,170203,1,0,1,596,1.0,42.40325370231137,2
2020-06-25-170203,170203,2,0,1,598,1.0,46.129538709421965,3
2020-06-26-170203,170203,1,0,1,599,0.5,42.61645667028147,4
2020-06-27-170203,170203,0,0,0,599,0.0,24.738905804412443,5
2020-06-28-170203,170203,0,0,0,599,0.0,21.928118190899383,6
2020-06-29-170203,170203,0,0,1,599,1.0,21.894427773797066,0
2020-06-30-170203,170203,1,0,0,600,2.5,25.58387093490337,1
2020-07-01-170203,170203,1,0,1,601,1.5,27.667101244413544,2
2020-07-02-170203,170203,0,0,1,601,0.0,10.576577371878221,3
2020-07-03-170203,170203,0,0,3,601,0.0,54.61482108584713,4
2020-07-04-170203,170203,1,0,0,602,0.0,101.461153186772,5
2020-07-05-170203,170203,2,0,0,604,0.0,97.88241565869335,6
2020-07-06-170203,170203,3,0,1,607,0.5,88.56535843659178,0
2020-07-07-170203,170203,1,0,1,608,1.5,76.3995545959959,1
2020-07-08-170203,170203,1,0,2,609,0.5,69.35843872398826,2
2020-07-09-170203,170203,1,0,1,610,1.0,68.74082506269461,3
2020-07-10-170203,170203,1,0,0,611,1.0,22.2209057403633,4
2020-07-11-170203,170203,0,0,0,611,0.0,22.693188149448073,5
2020-07-12-170203,170203,0,0,3,611,0.0,19.03410539906171,6
2020-07-13-170203,170203,1,0,0,612,0.0,18.893969686294543,0
2020-07-14-170203,170203,0,0,3,612,0.5,19.727209728653,1
2020-07-15-170203,170203,1,0,6,613,0.5,17.3721141824271,2
2020-07-16-170203,170203,1,0,4,614,1.5,13.994444364493262,3
2020-07-17-170203,170203,3,0,5,617,0.0,11.795907807201587,4
2020-07-18-170203,170203,0,0,9,617,0.5,7.1990817604635104,5
2020-07-19-170203,170203,0,0,1,617,1.0,8.850880724708201,6
2020-07-20-170203,170203,1,0,16,618,1.0,9.890297553001899,0
2020-07-21-170203,170203,1,0,23,619,1.0,12.526099491555962,1
2020-07-22-170203,170203,2,0,20,621,0.5,17.399110996180497,2
2020-07-23-170203,170203,1,0,35,622,1.0,17.790006978590732,3
2020-07-24-170203,170203,0,1,14,622,0.5,22.346265298207037,4
2020-07-25-170203,170203,0,0,30,622,0.5,23.531103016390166,5
2020-07-26-170203,170203,3,0,21,625,1.5,26.124441182283856,6
2020-07-27-170203,170203,0,0,44,625,3.0,30.638316222883848,0
2020-07-28-170203,170203,3,0,8,628,4.0,37.34438296664229,1
2020-07-29-170203,170203,6,0,14,634,2.5,44.75999624599657,2
2020-07-30-170203,170203,4,0,23,638,4.5,48.843728696048075,3
2020-07-31-170203,170203,5,1,16,643,17.5,80.35962724516838,4
2020-08-01-170203,170203,9,0,6,652,5.0,40.201577106399576,5
2020-08-02-170203,170203,1,0,2,653,2.0,493.1251570172824,6
2020-08-03-170203,170203,16,0,17,669,22.0,181.33238910985008,0
2020-08-04-170203,170203,23,0,20,692,16.0,215.05236993095622,1
2020-08-05-170203,170203,20,0,15,712,20.0,249.49489090070418,2
2020-08-06-170203,170203,35,0,7,747,32.0,299.80821660782703,3
2020-08-07-170203,170203,14,0,17,761,22.0,400.07308099321335,4
2020-08-08-170203,170203,30,0,0,791,9.5,456.47656334088845,5
2020-08-09-170203,170203,21,0,5,812,15.5,417.9369697432607,6
2020-08-10-170203,170203,44,0,7,856,36.5,32.32689902650765,0
2020-08-11-170203,170203,8,0,9,864,24.5,154.52632386753774,1
2020-08-12-170203,170203,14,0,14,878,12.0,244.70381219788285,2
2020-08-13-170203,170203,23,0,7,901,20.0,278.441639465839,3
2020-08-14-170203,170203,16,0,8,917,21.0,304.4163629371231,4
2020-08-15-170203,170203,6,0,1,923,8.5,373.84336293847446,5
2020-08-16-170203,170203,2,1,1,925,3.0,399.1705472816599,6
2020-08-17-170203,170203,17,0,10,942,33.0,395.0928476068036,0
2020-08-18-170203,170203,20,0,1,962,24.0,393.9266602505493,1
2020-08-19-170203,170203,15,0,27,977,19.5,383.0055194610695,2
2020-08-20-170203,170203,7,0,6,984,14.5,373.9168334106582,3
2020-08-21-170203,170203,17,0,7,1001,12.5,354.8157740719562,4
2020-08-22-170203,170203,0,0,2,1001,4.0,366.05484098791413,5
2020-08-23-170203,170203,5,0,4,1006,3.5,374.19501125738225,6
2020-08-24-170203,170203,7,0,9,1013,6.5,274.108996831356,0
2020-08-25-170203,170203,9,0,5,1022,9.5,218.88088941668258,1
2020-08-26-170203,170203,14,0,5,1036,5.5,185.86844035160829,2
2020-08-27-170203,170203,7,0,12,1043,10.0,210.62784493151153,3
2020-08-28-170203,170203,8,0,10,1051,5.5,190.09411966758083,4
2020-08-29-170203,170203,1,0,6,1052,2.0,170.29894711480026,5
2020-08-30-170203,170203,1,0,5,1053,1.5,222.85969919887702,6
2020-08-31-170203,170203,10,0,12,1063,4.5,209.12502470929888,0
2020-09-01-170203,170203,1,0,3,1064,2.5,474.25941785385146,1
2020-09-02-170203,170203,27,0,14,1091,4.0,163.32073925012494,2
2020-09-03-170203,170203,6,0,11,1097,6.5,139.9278191506419,3
2020-09-04-170203,170203,7,0,17,1104,2.5,161.83120114015185,4
2020-09-05-170203,170203,2,0,7,1106,3.5,154.91049192124893,5
2020-09-06-170203,170203,4,0,6,1110,2.0,150.86349432198057,6
2020-09-07-170203,170203,9,0,11,1119,5.0,164.97555009313345,0
2020-09-08-170203,170203,5,0,13,1124,4.0,160.48138739797923,1
2020-09-09-170203,170203,5,0,15,1129,7.0,160.08597960360814,2
2020-09-10-170203,170203,12,0,12,1141,15.5,492.53574148204393,3
2020-09-11-170203,170203,10,1,9,1151,11.5,491.81544335396376,4
2020-09-12-170203,170203,6,0,4,1157,0.5,456.2524982326049,5
2020-09-13-170203,170203,5,0,1,1162,6.0,332.7869028607332,6
2020-09-14-170203,170203,12,0,12,1174,4.5,274.5789088070473,0
2020-09-15-170203,170203,3,0,6,1177,4.5,235.8627826051283,1
2020-09-16-170203,170203,14,0,10,1191,1.5,201.26446872094328,2
2020-09-17-170203,170203,11,0,4,1202,8.0,209.14725960188863,3
2020-09-18-170203,170203,17,0,8,1219,5.0,177.99666136649697,4
2020-09-19-170203,170203,7,1,6,1226,5.0,141.7935585343125,5
2020-09-20-170203,170203,6,1,7,1232,6.0,147.39313280621008,6
2020-09-21-170203,170203,11,1,10,1243,7.0,154.50753594014913,0
2020-09-22-170203,170203,13,1,14,1256,9.5,164.55646894288896,1
2020-09-23-170203,170203,15,0,12,1271,5.0,182.916214082872,2
2020-09-24-170203,170203,12,0,16,1283,6.0,172.32645954129532,3
2020-09-25-170203,170203,9,1,16,1292,4.5,176.7861075425181,4
2020-09-26-170203,170203,4,1,2,1296,3.0,184.9129834758291,5
2020-09-27-170203,170203,1,0,3,1297,2.5,175.74526606010141,6
2020-09-28-170203,170203,12,0,6,1309,5.0,156.32257554905883,0
2020-09-29-170203,170203,6,0,13,1315,1.5,147.48353577590927,1
2020-09-30-170203,170203,10,0,13,1325,5.5,155.80035145744068,2
2020-10-01-170203,170203,4,0,19,1329,7.5,0.0,3
2020-10-02-170203,170203,8,0,5,1337,3.5,302.94879684347995,4
2020-10-03-170203,170203,6,0,0,1343,2.0,368.31606132227046,5
2020-10-04-170203,170203,7,0,5,1350,5.5,377.03345950443577,6
2020-10-05-170203,170203,10,0,20,1360,10.5,327.47614507219896,0
2020-10-06-170203,170203,14,0,15,1374,7.0,310.73021244482067,1
2020-10-07-170203,170203,12,1,24,1386,10.5,266.40551164393514,2
2020-10-08-170203,170203,16,0,22,1402,9.0,245.92379886126733,3
2020-10-09-170203,170203,16,2,34,1418,15.0,271.67447582540007,4
2020-10-10-170203,170203,2,0,8,1420,4.0,26.656142236459218,5
2020-10-11-170203,170203,3,0,7,1423,5.5,41.106995914459425,6
2020-10-12-170203,170203,6,0,20,1429,8.0,60.99267641917705,0
2020-10-13-170203,170203,13,0,17,1442,11.0,92.2778353309213,1
2020-10-14-170203,170203,13,0,14,1455,12.0,132.2082035418036,2
2020-10-15-170203,170203,19,0,22,1474,13.5,181.5245427577488,3
2020-10-16-170203,170203,5,0,7,1479,22.0,224.6363888077393,4
2020-10-17-170203,170203,0,0,7,1479,2.5,240.02900589330676,5
2020-10-18-170203,170203,5,0,4,1484,10.5,236.0962419365208,6
2020-10-19-170203,170203,20,0,8,1504,21.0,254.0215880946751,0
2020-10-20-170203,170203,15,0,20,1519,11.0,284.3969857982431,1
2020-10-21-170203,170203,24,0,18,1543,19.0,273.02047269532466,2
2020-10-22-170203,170203,22,0,31,1565,14.5,291.4855541647915,3
2020-10-23-170203,170203,34,0,15,1599,18.0,301.3703571660925,4
2020-10-24-170203,170203,8,0,6,1607,3.5,342.2382527210377,5
2020-10-25-170203,170203,7,0,3,1614,6.0,321.1824357414821,6
2020-10-26-170203,170203,20,1,10,1634,15.5,274.3248966153524,0
2020-10-27-170203,170203,17,0,9,1651,11.5,314.0494560537078,1
2020-10-28-170203,170203,14,1,11,1665,18.5,321.986956368536,2
2020-10-29-170203,170203,22,1,7,1687,16.5,332.9416805911481,3
2020-10-30-170203,170203,7,0,9,1694,23.0,307.6710946532627,4
2020-10-31-170203,170203,7,0,0,1701,6.0,360.4033216355209,5
2020-11-01-170203,170203,4,0,0,1705,6.5,242.26017916954325,6
2020-11-02-170203,170203,8,2,0,1713,7.5,271.2964558394556,0
2020-11-03-170203,170203,20,0,0,1733,19.5,231.32057277414492,1
2020-11-04-170203,170203,18,0,0,1751,12.5,301.5488079657225,2
2020-11-05-170203,170203,31,0,0,1782,13.5,309.87307808029146,3
2020-11-06-170203,170203,15,0,0,1797,17.0,350.7767265924959,4
2020-11-07-170203,170203,6,0,0,1803,9.5,374.63801833765575,5
2020-11-08-170203,170203,3,2,0,1806,5.5,366.4644228591733,6
2020-11-09-170203,170203,10,0,0,1816,12.5,354.39923714494665,0
2020-11-10-170203,170203,9,0,0,1825,8.0,239.07188333295883,1
2020-11-11-170203,170203,11,2,0,1836,21.0,254.33814974152432,2
2020-11-12-170203,170203,7,0,0,1843,18.5,287.58847001972,3
2020-11-13-170203,170203,9,2,0,1852,11.0,310.25759556159664,4
2020-03-01-170204,170204,0,0,1,0,0.0,0.0,6
2020-03-02-170204,170204,1,0,6,1,0.0,10.175277216062923,0
2020-03-03-170204,170204,2,1,8,3,0.0,43.68542237292937,1
2020-03-04-170204,170204,0,0,10,3,0.25,45.7543649962341,2
2020-03-05-170204,170204,0,0,10,3,0.0,48.01562162929734,3
2020-03-06-170204,170204,0,0,6,3,0.5,44.619254930227136,4
2020-03-07-170204,170204,0,0,4,3,1.75,43.233594449264835,5
2020-03-08-170204,170204,0,0,1,3,0.25,44.18111445910351,6
2020-03-09-170204,170204,1,0,18,4,1.0,37.76288407211119,0
2020-03-10-170204,170204,0,0,6,4,3.5,95.19991489438257,1
2020-03-11-170204,170204,0,0,9,4,0.5,81.28073985221161,2
2020-03-12-170204,170204,2,0,9,6,1.25,65.359566580049,3
2020-03-13-170204,170204,2,0,8,8,2.25,50.87614941466414,4
2020-03-14-170204,170204,6,0,7,14,1.5,42.599917105485574,5
2020-03-15-170204,170204,1,0,1,15,0.75,40.196069651855986,6
2020-03-16-170204,170204,6,0,9,21,4.0,23.087281141190044,0
2020-03-17-170204,170204,8,0,4,29,3.75,33.270638174564965,1
2020-03-18-170204,170204,10,0,3,39,4.75,43.999239686050345,2
2020-03-19-170204,170204,10,0,2,49,7.25,57.70292990229716,3
2020-03-20-170204,170204,6,0,4,55,8.25,64.45828945165215,4
2020-03-21-170204,170204,4,0,0,59,3.5,66.31324562672143,5
2020-03-22-170204,170204,1,0,5,60,2.75,63.27819598726738,6
2020-03-23-170204,170204,18,0,3,78,11.0,57.59637705516054,0
2020-03-24-170204,170204,6,0,3,84,11.75,72.124962972723,1
2020-03-25-170204,170204,9,0,4,93,9.25,73.42162303017365,2
2020-03-26-170204,170204,9,0,2,102,7.75,72.94750509009289,3
2020-03-27-170204,170204,8,0,1,110,6.75,84.74352279046755,4
2020-03-28-170204,170204,7,0,1,117,2.5,85.29537695329526,5
2020-03-29-170204,170204,1,0,0,118,1.0,86.98406752917813,6
2020-03-30-170204,170204,9,0,0,127,8.0,65.90046715361768,0
2020-03-31-170204,170204,4,0,2,131,6.75,62.172624404018705,1
2020-04-01-170204,170204,3,0,1,134,4.5,10.222562030773185,2
2020-04-02-170204,170204,2,0,1,136,7.0,25.325477628254028,3
2020-04-03-170204,170204,4,0,2,140,6.25,16.040973641850435,4
2020-04-04-170204,170204,0,0,0,140,1.75,26.44722949948177,5
2020-04-05-170204,170204,5,0,0,145,0.75,23.659547577528308,6
2020-04-06-170204,170204,3,1,1,148,6.5,25.71530025869287,0
2020-04-07-170204,170204,3,0,2,151,5.25,30.815558332013413,1
2020-04-08-170204,170204,4,1,0,155,4.5,33.69678448104585,2
2020-04-09-170204,170204,2,0,0,157,5.5,29.390689977225783,3
2020-04-10-170204,170204,1,0,1,158,2.5,5.070088399736182,4
2020-04-11-170204,170204,1,0,2,159,1.0,6.224101221645005,5
2020-04-12-170204,170204,0,0,1,159,0.25,8.77222587748943,6
2020-04-13-170204,170204,0,0,1,159,3.25,9.736762551766343,0
2020-04-14-170204,170204,2,0,3,161,3.0,13.041277062162562,1
2020-04-15-170204,170204,1,0,3,162,4.25,11.367472517470956,2
2020-04-16-170204,170204,1,0,0,163,6.0,18.63244252004569,3
2020-04-17-170204,170204,2,0,1,165,3.25,22.059934109149403,4
2020-04-18-170204,170204,0,0,0,165,1.0,19.60283109093627,5
2020-04-19-170204,170204,0,0,0,165,0.75,18.555887817688145,6
2020-04-20-170204,170204,1,0,0,166,2.25,20.82517829186755,0
2020-04-21-170204,170204,2,0,0,168,2.75,22.18590317803613,1
2020-04-22-170204,170204,0,0,0,168,2.0,26.71371678500451,2
2020-04-23-170204,170204,0,0,3,168,1.0,25.429981174683356,3
2020-04-24-170204,170204,1,0,1,169,1.5,20.346231856847734,4
2020-04-25-170204,170204,2,0,0,171,1.0,26.57688375777286,5
2020-04-26-170204,170204,1,0,0,172,1.0,24.600516953935934,6
2020-04-27-170204,170204,1,0,1,173,1.25,15.688202286562511,0
2020-04-28-170204,170204,3,0,1,176,2.75,14.728914539153283,1
2020-04-29-170204,170204,3,0,4,179,1.5,14.551637166621791,2
2020-04-30-170204,170204,0,1,2,179,2.25,25.238904729164645,3
2020-05-01-170204,170204,1,0,1,180,0.75,29.1937435734988,4
2020-05-02-170204,170204,0,0,0,180,0.75,10.849504507580836,5
2020-05-03-170204,170204,0,0,0,180,0.5,6.036533445412473,6
2020-05-04-170204,170204,0,0,1,180,2.75,3.9559039236471136,0
2020-05-05-170204,170204,0,0,0,180,2.75,3.0200482731121863,1
2020-05-06-170204,170204,0,0,0,180,2.75,1.7850695784009818,2
2020-05-07-170204,170204,3,0,2,183,3.5,0.004663033228923818,3
2020-05-08-170204,170204,1,0,2,184,1.5,2.447762969531611,4
2020-05-09-170204,170204,0,0,0,184,0.0,6.202616678745824,5
2020-05-10-170204,170204,0,0,0,184,0.5,21.900199030095393,6
2020-05-11-170204,170204,1,0,3,185,3.0,21.54241228229572,0
2020-05-12-170204,170204,1,0,0,186,2.0,28.527451294716,1
2020-05-13-170204,170204,4,0,0,190,3.75,23.445698107752378,2
2020-05-14-170204,170204,2,0,0,192,2.75,28.204165891414572,3
2020-05-15-170204,170204,1,0,2,193,2.25,25.64714305696409,4
2020-05-16-170204,170204,0,1,0,193,0.0,17.17248230587723,5
2020-05-17-170204,170204,0,0,0,193,0.0,15.923933669782675,6
2020-05-18-170204,170204,1,0,1,194,2.5,17.5440107214416,0
2020-05-19-170204,170204,0,0,0,194,0.75,13.311484112348445,1
2020-05-20-170204,170204,0,1,2,194,1.5,12.102031271763332,2
2020-05-21-170204,170204,2,0,0,196,1.5,10.698108013744342,3
2020-05-22-170204,170204,2,0,0,198,1.0,10.234055303854786,4
2020-05-23-170204,170204,0,0,0,198,0.0,13.770132969097062,5
2020-05-24-170204,170204,0,0,0,198,0.0,14.940757565447427,6
2020-05-25-170204,170204,3,0,0,201,2.0,11.715328156823784,0
2020-05-26-170204,170204,0,0,0,201,2.25,14.97826160621949,1
2020-05-27-170204,170204,0,0,0,201,1.75,16.279304022718605,2
2020-05-28-170204,170204,0,0,0,201,1.0,14.38484730072129,3
2020-05-29-170204,170204,2,1,2,203,0.5,10.822806482920576,4
2020-05-30-170204,170204,0,0,0,203,0.0,10.618985849047549,5
2020-05-31-170204,170204,0,0,0,203,0.0,10.72788769529328,6
2020-06-01-170204,170204,1,0,0,204,2.0,13.440379419406483,0
2020-06-02-170204,170204,0,0,0,204,0.5,3.7037680427569706,1
2020-06-03-170204,170204,2,0,0,206,0.75,2.0329359008861165,2
2020-06-04-170204,170204,0,0,0,206,1.75,3.7248739120422676,3
2020-06-05-170204,170204,0,0,0,206,0.5,4.733564414505361,4
2020-06-06-170204,170204,0,0,0,206,0.0,5.06907548295567,5
2020-06-07-170204,170204,0,0,1,206,0.0,5.0004564015626025,6
2020-06-08-170204,170204,0,0,0,206,0.75,5.102653944954174,0
2020-06-09-170204,170204,0,0,0,206,0.0,5.968615621365272,1
2020-06-10-170204,170204,0,1,0,206,0.75,14.609645021245319,2
2020-06-11-170204,170204,0,0,0,206,0.75,13.951223443768374,3
2020-06-12-170204,170204,2,0,0,208,1.0,11.77505243914708,4
2020-06-13-170204,170204,0,0,0,208,0.0,11.85364297026873,5
2020-06-14-170204,170204,0,0,0,208,0.0,8.859400854509351,6
2020-06-15-170204,170204,0,0,0,208,0.0,7.0394254813750345,0
2020-06-16-170204,170204,0,0,0,208,0.5,7.422957058773685,1
2020-06-17-170204,170204,0,0,0,208,0.25,6.530177180319769,2
2020-06-18-170204,170204,0,0,0,208,0.25,5.235551418848168,3
2020-06-19-170204,170204,0,0,0,208,0.0,3.796095693849354,4
2020-06-20-170204,170204,0,0,0,208,0.0,2.926241869917493,5
2020-06-21-170204,170204,1,0,0,209,0.0,3.1724518822897014,6
2020-06-22-170204,170204,0,0,0,209,0.0,3.3621252427639554,0
2020-06-23-170204,170204,0,0,0,209,0.25,2.5445888747341017,1
2020-06-24-170204,170204,0,0,0,209,0.0,2.7546074795587208,2
2020-06-25-170204,170204,0,0,0,209,0.25,3.0304716995512413,3
2020-06-26-170204,170204,0,1,0,209,0.75,3.7905145114077796,4
2020-06-27-170204,170204,0,0,0,209,0.25,3.3114423860027005,5
2020-06-28-170204,170204,0,0,0,209,0.0,3.5713842541050593,6
2020-06-29-170204,170204,0,0,0,209,0.0,2.853655932132196,0
2020-06-30-170204,170204,0,0,0,209,0.75,5.177648439904798,1
2020-07-01-170204,170204,0,0,0,209,0.75,5.132571854096395,2
2020-07-02-170204,170204,0,0,0,209,0.0,4.355148995731942,3
2020-07-03-170204,170204,0,0,1,209,1.25,4.769387391358879,4
2020-07-04-170204,170204,0,0,0,209,0.0,8.116631374462544,5
2020-07-05-170204,170204,0,0,0,209,0.0,8.003571779365224,6
2020-07-06-170204,170204,0,0,1,209,0.75,7.156173950760191,0
2020-07-07-170204,170204,0,0,0,209,0.0,7.013111533735114,1
2020-07-08-170204,170204,0,0,0,209,1.0,6.252446364793528,2
2020-07-09-170204,170204,0,0,0,209,1.0,5.116891568822297,3
2020-07-10-170204,170204,0,0,0,209,0.25,5.681443613684986,4
2020-07-11-170204,170204,0,0,0,209,0.25,4.952911633570307,5
2020-07-12-170204,170204,0,0,0,209,0.0,3.894296967787037,6
2020-07-13-170204,170204,0,0,0,209,0.0,3.86823779514397,0
2020-07-14-170204,170204,0,0,0,209,0.25,4.189892343000789,1
2020-07-15-170204,170204,0,0,0,209,0.25,3.5895983882600873,2
2020-07-16-170204,170204,0,0,0,209,0.5,3.7892252339326955,3
2020-07-17-170204,170204,1,0,0,210,0.0,3.2752005594644724,4
2020-07-18-170204,170204,0,0,0,210,0.5,3.180662404267566,5
2020-07-19-170204,170204,0,0,0,210,0.0,4.04637969940646,6
2020-07-20-170204,170204,1,0,2,211,0.0,4.588775757054898,0
2020-07-21-170204,170204,0,0,1,211,0.0,5.215788411921878,1
2020-07-22-170204,170204,0,0,10,211,0.25,5.326943420171735,2
2020-07-23-170204,170204,0,0,3,211,1.0,4.939360571760391,3
2020-07-24-170204,170204,0,0,10,211,0.75,5.328176421676762,4
2020-07-25-170204,170204,0,0,1,211,0.5,4.7698277567866105,5
2020-07-26-170204,170204,0,0,1,211,1.25,4.263113057058483,6
2020-07-27-170204,170204,0,0,0,211,0.25,4.58568075443177,0
2020-07-28-170204,170204,0,0,2,211,0.5,3.913716357045839,1
2020-07-29-170204,170204,0,0,4,211,1.0,3.968656435184828,2
2020-07-30-170204,170204,0,0,4,211,1.75,6.757712657388635,3
2020-07-31-170204,170204,0,0,0,211,1.0,7.80702515164118,4
2020-08-01-170204,170204,0,0,1,211,0.5,4.732262350205657,5
2020-08-02-170204,170204,0,0,1,211,0.5,46.01088130808563,6
2020-08-03-170204,170204,2,0,4,213,0.5,24.460505249291966,0
2020-08-04-170204,170204,1,0,8,214,1.0,22.133586637661793,1
2020-08-05-170204,170204,10,0,2,224,1.25,24.773138374800453,2
2020-08-06-170204,170204,3,0,0,227,1.0,36.09938070626002,3
2020-08-07-170204,170204,10,0,2,237,0.75,39.48285819305842,4
2020-08-08-170204,170204,1,0,2,238,2.25,53.84106970568128,5
2020-08-09-170204,170204,1,0,0,239,0.0,52.503786636139715,6
2020-08-10-170204,170204,0,0,1,239,4.0,4.514993953935776,0
2020-08-11-170204,170204,2,0,1,241,2.0,9.536028126244712,1
2020-08-12-170204,170204,4,0,0,245,3.0,16.318236151798136,2
2020-08-13-170204,170204,4,0,1,249,2.75,20.14120893539833,3
2020-08-14-170204,170204,0,0,0,249,2.5,27.324525501527816,4
2020-08-15-170204,170204,1,0,0,250,1.0,28.020974629103968,5
2020-08-16-170204,170204,1,0,0,251,2.5,29.623356175039326,6
2020-08-17-170204,170204,4,0,0,255,4.0,32.73466867295283,0
2020-08-18-170204,170204,8,0,1,263,3.25,34.8365332552566,1
2020-08-19-170204,170204,2,0,2,265,4.5,33.80103249272872,2
2020-08-20-170204,170204,0,0,0,265,4.5,31.136468826556786,3
2020-08-21-170204,170204,2,0,0,267,4.25,33.14977425683665,4
2020-08-22-170204,170204,2,0,1,269,2.5,38.50915052133115,5
2020-08-23-170204,170204,0,0,0,269,0.75,37.22440624718421,6
2020-08-24-170204,170204,1,0,3,270,5.0,34.40267342877087,0
2020-08-25-170204,170204,1,0,1,271,4.5,28.148985848297876,1
2020-08-26-170204,170204,0,0,3,271,3.25,32.04274194867713,2
2020-08-27-170204,170204,1,0,1,272,4.0,32.07297285260586,3
2020-08-28-170204,170204,0,0,0,272,4.0,31.665231819551096,4
2020-08-29-170204,170204,0,0,0,272,1.0,28.546129961256998,5
2020-08-30-170204,170204,0,0,0,272,3.25,28.651114231061214,6
2020-08-31-170204,170204,0,0,0,272,1.25,18.248763710372025,0
2020-09-01-170204,170204,1,0,3,273,4.5,37.58086615716154,1
2020-09-02-170204,170204,2,0,0,275,5.0,21.01156882383264,2
2020-09-03-170204,170204,0,0,3,275,3.75,20.33612725696664,3
2020-09-04-170204,170204,0,0,0,275,3.5,20.429015167063877,4
2020-09-05-170204,170204,1,0,0,276,3.0,19.49897048131878,5
2020-09-06-170204,170204,0,0,1,276,1.0,18.673401620861355,6
2020-09-07-170204,170204,3,0,4,279,6.25,18.908271165655385,0
2020-09-08-170204,170204,1,0,3,280,3.0,17.016496850898395,1
2020-09-09-170204,170204,3,0,4,283,4.0,24.725998593803588,2
2020-09-10-170204,170204,1,0,2,284,4.0,36.931924709389286,3
2020-09-11-170204,170204,0,0,2,284,5.5,25.065404271556023,4
2020-09-12-170204,170204,0,0,0,284,5.25,21.83983559766496,5
2020-09-13-170204,170204,0,0,0,284,3.25,24.426695092232272,6
2020-09-14-170204,170204,0,0,1,284,6.25,18.6553424745216,0
2020-09-15-170204,170204,3,0,3,287,12.5,18.660667213877907,1
2020-09-16-170204,170204,0,0,3,287,10.25,19.03843578644518,2
2020-09-17-170204,170204,3,0,1,290,11.5,18.691898561250667,3
2020-09-18-170204,170204,0,0,1,290,11.5,28.112525153691376,4
2020-09-19-170204,170204,0,0,0,290,3.25,30.009889523053374,5
2020-09-20-170204,170204,1,0,0,291,3.25,26.068839912124808,6
2020-09-21-170204,170204,4,0,2,295,16.75,24.19461243042791,0
2020-09-22-170204,170204,3,1,1,298,11.75,22.521986422365508,1
2020-09-23-170204,170204,4,0,2,302,10.75,23.819801368033435,2
2020-09-24-170204,170204,2,0,2,304,11.75,22.9559588096983,3
2020-09-25-170204,170204,2,0,2,306,22.25,20.380684838029794,4
2020-09-26-170204,170204,0,0,1,306,4.0,23.218129850975245,5
2020-09-27-170204,170204,0,0,0,306,2.25,25.125492713537533,6
2020-09-28-170204,170204,1,0,4,307,12.25,29.32755853680549,0
2020-09-29-170204,170204,3,0,4,310,8.25,30.882951260270044,1
2020-09-30-170204,170204,3,0,6,313,9.0,28.10898655309689,2
2020-10-01-170204,170204,1,0,14,314,15.0,0.0,3
2020-10-02-170204,170204,1,0,12,315,10.25,108.19873487177965,4
2020-10-03-170204,170204,0,0,3,315,3.0,94.47102984517812,5
2020-10-04-170204,170204,0,0,3,315,4.5,80.28490458240358,6
2020-10-05-170204,170204,2,1,12,317,6.5,70.51996038578214,0
2020-10-06-170204,170204,1,0,9,318,7.25,62.03888044673916,1
2020-10-07-170204,170204,2,0,11,320,8.75,53.47250008495794,2
2020-10-08-170204,170204,2,0,9,322,7.25,47.19316340223526,3
2020-10-09-170204,170204,2,0,6,324,4.25,51.56217353982838,4
2020-10-10-170204,170204,1,0,11,325,1.25,5.9306843853990605,5
2020-10-11-170204,170204,0,0,11,325,0.75,9.555548086020611,6
2020-10-12-170204,170204,4,0,3,329,2.75,12.05260816871845,0
2020-10-13-170204,170204,4,0,5,333,8.25,17.629260221673988,1
2020-10-14-170204,170204,6,0,4,339,6.5,25.897404456451667,2
2020-10-15-170204,170204,14,0,4,353,5.0,37.73940840144064,3
2020-10-16-170204,170204,12,0,3,365,7.5,80.19829767614954,4
2020-10-17-170204,170204,3,0,2,368,2.5,99.63070453867451,5
2020-10-18-170204,170204,3,0,2,371,0.75,108.43211426631497,6
2020-10-19-170204,170204,12,0,0,383,6.5,115.17071885060159,0
2020-10-20-170204,170204,9,0,1,392,4.75,127.85258964344649,1
2020-10-21-170204,170204,11,0,3,403,7.75,130.59122360885934,2
2020-10-22-170204,170204,9,0,0,412,8.5,111.77214600755622,3
2020-10-23-170204,170204,6,0,2,418,8.0,99.29336244644595,4
2020-10-24-170204,170204,11,3,1,429,2.0,108.18525211097167,5
2020-10-25-170204,170204,11,1,0,440,6.0,109.23990994074015,6
2020-10-26-170204,170204,3,1,3,443,7.5,83.95754524300276,0
2020-10-27-170204,170204,5,0,1,448,7.0,90.32672783360618,1
2020-10-28-170204,170204,4,0,1,452,13.5,72.28395683959523,2
2020-10-29-170204,170204,4,0,1,456,8.75,65.79329484643095,3
2020-10-30-170204,170204,3,0,1,459,8.75,55.143873319331604,4
2020-10-31-170204,170204,2,0,0,461,5.75,57.60316424230305,5
2020-11-01-170204,170204,2,0,0,463,2.75,21.754163435981237,6
2020-11-02-170204,170204,0,0,0,463,4.75,46.93866578692081,0
2020-11-03-170204,170204,1,0,0,464,7.25,41.800497737940915,1
2020-11-04-170204,170204,3,1,0,467,5.25,46.93651225650409,2
2020-11-05-170204,170204,0,2,0,467,4.25,47.71800431937734,3
2020-11-06-170204,170204,2,0,0,469,6.25,46.016110255657125,4
2020-11-07-170204,170204,1,0,0,470,4.75,45.17372539205088,5
2020-11-08-170204,170204,0,1,0,470,6.0,44.7997527591555,6
2020-11-09-170204,170204,3,0,0,473,9.0,28.288568814592345,0
2020-11-10-170204,170204,1,1,0,474,9.75,19.93655263642634,1
2020-11-11-170204,170204,1,0,0,475,4.25,23.820266765495454,2
2020-11-12-170204,170204,1,1,0,476,7.75,23.16060184296707,3
2020-11-13-170204,170204,1,0,0,477,7.5,10.429814634055655,4
2020-03-01-170205,170205,0,0,1,0,0.0,0.0,6
2020-03-02-170205,170205,0,0,0,0,0.14285714285714285,27.21360262676501,0
2020-03-03-170205,170205,0,0,2,0,0.2857142857142857,156.91505586696982,1
2020-03-04-170205,170205,0,0,4,0,0.14285714285714285,150.82408754947318,2
2020-03-05-170205,170205,0,2,8,0,0.0,159.029856864752,3
2020-03-06-170205,170205,0,0,8,0,0.2857142857142857,147.6018959100893,4
2020-03-07-170205,170205,0,0,6,0,1.0,147.776389602934,5
2020-03-08-170205,170205,0,0,1,0,0.14285714285714285,162.2313946608241,6
2020-03-09-170205,170205,2,0,18,2,0.42857142857142855,158.28147587991975,0
2020-03-10-170205,170205,0,0,18,2,2.0,290.9595591944399,1
2020-03-11-170205,170205,1,0,12,3,0.14285714285714285,251.5970306341651,2
2020-03-12-170205,170205,0,0,8,3,0.7142857142857143,213.86492873881127,3
2020-03-13-170205,170205,2,0,9,5,1.1428571428571428,168.47632930207914,4
2020-03-14-170205,170205,1,0,6,6,1.7142857142857142,131.77498051670295,5
2020-03-15-170205,170205,1,0,1,7,0.5714285714285714,114.17073030625914,6
2020-03-16-170205,170205,0,0,11,7,3.2857142857142856,63.2866566620243,0
2020-03-17-170205,170205,2,0,8,9,3.2857142857142856,83.47703430836347,1
2020-03-18-170205,170205,4,1,8,13,4.0,99.14150478424943,2
2020-03-19-170205,170205,8,0,13,21,5.0,128.50897076449897,3
2020-03-20-170205,170205,8,1,11,29,5.428571428571429,164.83022913982202,4
2020-03-21-170205,170205,6,0,1,35,2.0,194.8468198492912,5
2020-03-22-170205,170205,1,0,1,36,2.7142857142857144,204.27477886874112,6
2020-03-23-170205,170205,18,0,8,54,6.571428571428571,198.46930644988274,0
2020-03-24-170205,170205,18,1,7,72,5.428571428571429,263.55179638551687,1
2020-03-25-170205,170205,12,0,3,84,6.0,310.793407580166,2
2020-03-26-170205,170205,8,0,11,92,5.428571428571429,330.7945475691308,3
2020-03-27-170205,170205,9,0,3,101,3.7142857142857135,369.9712044303558,4
2020-03-28-170205,170205,6,0,1,107,1.5714285714285714,363.7617371759751,5
2020-03-29-170205,170205,1,0,0,108,0.5714285714285714,364.9857205213277,6
2020-03-30-170205,170205,11,0,7,119,5.0,270.12780293772056,0
2020-03-31-170205,170205,8,0,3,127,3.2857142857142856,253.998946054006,1
2020-04-01-170205,170205,8,0,3,135,2.7142857142857144,51.88061810366658,2
2020-04-02-170205,170205,13,0,4,148,2.4285714285714284,112.9172977086495,3
2020-04-03-170205,170205,11,0,2,159,3.571428571428572,57.51219653086897,4
2020-04-04-170205,170205,1,0,1,160,1.0,106.14769453169131,5
2020-04-05-170205,170205,1,0,2,161,1.0,107.96144203943659,6
2020-04-06-170205,170205,8,0,3,169,3.571428571428572,109.76715454863256,0
2020-04-07-170205,170205,7,0,2,176,2.8571428571428568,145.1941545220569,1
2020-04-08-170205,170205,3,1,4,179,2.7142857142857144,164.05812043473014,2
2020-04-09-170205,170205,11,2,0,190,2.142857142857143,172.63150026770913,3
2020-04-10-170205,170205,3,2,2,193,1.2857142857142858,45.73230628858377,4
2020-04-11-170205,170205,1,0,0,194,0.8571428571428571,58.14626665475796,5
2020-04-12-170205,170205,0,0,2,194,0.14285714285714285,64.08596967408693,6
2020-04-13-170205,170205,7,0,1,201,1.1428571428571428,63.93957950110544,0
2020-04-14-170205,170205,3,0,1,204,1.4285714285714286,87.68731959204811,1
2020-04-15-170205,170205,3,0,1,207,2.142857142857143,103.93076902597585,2
2020-04-16-170205,170205,4,0,0,211,2.2857142857142856,123.41724662054696,3
2020-04-17-170205,170205,2,0,1,213,1.7142857142857142,124.5919830101104,4
2020-04-18-170205,170205,1,0,0,214,0.42857142857142855,125.27953574162466,5
2020-04-19-170205,170205,2,0,0,216,0.14285714285714285,123.46003181660394,6
2020-04-20-170205,170205,3,1,2,219,1.8571428571428568,154.77997171753367,0
2020-04-21-170205,170205,2,0,3,221,1.5714285714285714,157.57680312749673,1
2020-04-22-170205,170205,4,1,2,225,0.5714285714285714,149.0793709281803,2
2020-04-23-170205,170205,0,0,0,225,0.42857142857142855,133.68275492889063,3
2020-04-24-170205,170205,2,0,1,227,0.7142857142857143,115.60132183592458,4
2020-04-25-170205,170205,0,0,0,227,0.8571428571428571,120.60658582448428,5
2020-04-26-170205,170205,2,0,2,229,0.7142857142857143,116.56832369664116,6
2020-04-27-170205,170205,1,0,1,230,0.8571428571428571,73.3097236121517,0
2020-04-28-170205,170205,1,0,1,231,2.4285714285714284,63.47425270446798,1
2020-04-29-170205,170205,1,0,2,232,1.2857142857142858,66.64758221592135,2
2020-04-30-170205,170205,0,1,2,232,0.8571428571428571,115.75113276031877,3
2020-05-01-170205,170205,1,0,2,233,0.5714285714285714,170.47070263584123,4
2020-05-02-170205,170205,0,0,0,233,0.5714285714285714,73.16746010387894,5
2020-05-03-170205,170205,0,0,0,233,0.14285714285714285,37.5204800531621,6
2020-05-04-170205,170205,2,0,2,235,1.2857142857142858,28.417777823848116,0
2020-05-05-170205,170205,3,0,0,238,1.1428571428571428,35.38016071870598,1
2020-05-06-170205,170205,2,0,1,240,1.2857142857142858,45.96714290406174,2
2020-05-07-170205,170205,0,0,1,240,2.7142857142857144,54.70865425746831,3
2020-05-08-170205,170205,1,0,1,241,1.1428571428571428,50.33628248425052,4
2020-05-09-170205,170205,0,0,0,241,0.14285714285714285,62.74753433093029,5
2020-05-10-170205,170205,2,0,0,243,0.0,196.7124856068765,6
2020-05-11-170205,170205,1,0,2,244,1.8571428571428568,192.27093331438084,0
2020-05-12-170205,170205,1,0,0,245,1.2857142857142858,200.42174524036093,1
2020-05-13-170205,170205,2,0,0,247,3.1428571428571432,162.7301816641027,2
2020-05-14-170205,170205,2,0,0,249,2.2857142857142856,143.8537793772133,3
2020-05-15-170205,170205,2,0,1,251,1.4285714285714286,139.93256249358268,4
2020-05-16-170205,170205,0,0,0,251,0.0,109.93554369306577,5
2020-05-17-170205,170205,0,0,0,251,0.0,103.19066446545251,6
2020-05-18-170205,170205,2,0,2,253,1.4285714285714286,99.00241460462868,0
2020-05-19-170205,170205,0,0,0,253,0.7142857142857143,103.4187692331985,1
2020-05-20-170205,170205,1,0,1,254,0.8571428571428571,76.32610871378867,2
2020-05-21-170205,170205,1,0,1,255,1.2857142857142858,64.1762490837323,3
2020-05-22-170205,170205,1,0,1,256,1.0,45.37825260374012,4
2020-05-23-170205,170205,0,0,0,256,0.14285714285714285,60.1216814839498,5
2020-05-24-170205,170205,0,0,0,256,0.0,62.427383337517455,6
2020-05-25-170205,170205,2,0,1,258,1.2857142857142858,45.28824113635852,0
2020-05-26-170205,170205,0,0,0,258,1.2857142857142858,58.49997309213898,1
2020-05-27-170205,170205,0,0,2,258,1.2857142857142858,64.41295445665952,2
2020-05-28-170205,170205,0,1,1,258,1.0,60.20014981297875,3
2020-05-29-170205,170205,1,1,3,259,0.8571428571428571,53.29276881572024,4
2020-05-30-170205,170205,0,0,0,259,0.0,62.41045852639397,5
2020-05-31-170205,170205,0,0,0,259,0.14285714285714285,65.12234699141393,6
2020-06-01-170205,170205,2,0,0,261,1.2857142857142858,90.30975326031947,0
2020-06-02-170205,170205,0,0,1,261,0.5714285714285714,32.58162430404323,1
2020-06-03-170205,170205,1,1,0,262,0.8571428571428571,14.999693451841345,2
2020-06-04-170205,170205,1,0,1,263,1.0,27.34336473258037,3
2020-06-05-170205,170205,1,0,0,264,0.2857142857142857,38.8341867034666,4
2020-06-06-170205,170205,0,1,0,264,0.2857142857142857,42.29153961387662,5
2020-06-07-170205,170205,0,0,0,264,0.14285714285714285,42.567070288591395,6
2020-06-08-170205,170205,1,0,0,265,0.5714285714285714,42.51750946087317,0
2020-06-09-170205,170205,0,0,0,265,0.14285714285714285,49.00457579619935,1
2020-06-10-170205,170205,2,0,0,267,0.42857142857142855,101.2704775281743,2
2020-06-11-170205,170205,1,0,0,268,0.5714285714285714,109.0412429560088,3
2020-06-12-170205,170205,3,0,0,271,0.2857142857142857,94.19300719118567,4
2020-06-13-170205,170205,0,0,0,271,0.0,89.59912889890231,5
2020-06-14-170205,170205,0,0,0,271,0.2857142857142857,72.8334278386858,6
2020-06-15-170205,170205,0,0,0,271,0.14285714285714285,69.91506780006702,0
2020-06-16-170205,170205,1,0,1,272,0.42857142857142855,73.36593285170187,1
2020-06-17-170205,170205,0,0,2,272,0.2857142857142857,69.39189633005023,2
2020-06-18-170205,170205,1,0,0,273,0.0,48.08309297042241,3
2020-06-19-170205,170205,0,0,4,273,0.14285714285714285,45.31923189131422,4
2020-06-20-170205,170205,0,0,0,273,0.0,40.71448528427828,5
2020-06-21-170205,170205,0,0,0,273,0.2857142857142857,34.42919485637463,6
2020-06-22-170205,170205,0,0,0,273,0.0,33.21462548552866,0
2020-06-23-170205,170205,0,0,0,273,0.2857142857142857,20.418377797857797,1
2020-06-24-170205,170205,0,0,2,273,0.14285714285714285,20.551263903601033,2
2020-06-25-170205,170205,0,1,2,273,0.14285714285714285,23.62892194057432,3
2020-06-26-170205,170205,0,0,1,273,0.42857142857142855,23.076153944528883,4
2020-06-27-170205,170205,0,0,0,273,0.14285714285714285,17.750644177595877,5
2020-06-28-170205,170205,0,0,0,273,0.0,19.5274654906743,6
2020-06-29-170205,170205,0,0,0,273,0.0,18.20458508143232,0
2020-06-30-170205,170205,1,0,1,274,0.2857142857142857,35.836539359121616,1
2020-07-01-170205,170205,2,0,0,276,0.14285714285714285,48.351438553453406,2
2020-07-02-170205,170205,0,0,0,276,0.14285714285714285,43.153092159460684,3
2020-07-03-170205,170205,4,0,0,280,0.14285714285714285,38.37472761904452,4
2020-07-04-170205,170205,0,0,1,280,0.14285714285714285,60.69779300827262,5
2020-07-05-170205,170205,0,0,0,280,0.2857142857142857,56.828049365849296,6
2020-07-06-170205,170205,0,0,0,280,0.5714285714285714,55.56206083973566,0
2020-07-07-170205,170205,0,0,0,280,0.14285714285714285,58.56148833747257,1
2020-07-08-170205,170205,2,0,0,282,0.42857142857142855,50.620105933236815,2
2020-07-09-170205,170205,2,0,0,284,0.42857142857142855,41.69090163639379,3
2020-07-10-170205,170205,1,4,0,285,0.0,53.40593881795565,4
2020-07-11-170205,170205,0,0,0,285,0.14285714285714285,44.52321648357349,5
2020-07-12-170205,170205,0,0,0,285,0.0,36.496456560526646,6
2020-07-13-170205,170205,0,0,0,285,0.0,35.35424845923932,0
2020-07-14-170205,170205,1,0,1,286,0.14285714285714285,35.53414732651871,1
2020-07-15-170205,170205,0,0,1,286,0.5714285714285714,33.57272078040967,2
2020-07-16-170205,170205,0,0,1,286,0.2857142857142857,37.46430089670005,3
2020-07-17-170205,170205,0,0,0,286,0.14285714285714285,32.321187758446094,4
2020-07-18-170205,170205,1,0,0,287,0.14285714285714285,26.65205075399612,5
2020-07-19-170205,170205,0,0,0,287,0.14285714285714285,33.3361326671214,6
2020-07-20-170205,170205,0,0,2,287,0.5714285714285714,47.094927235374115,0
2020-07-21-170205,170205,0,0,0,287,0.14285714285714285,43.349408187412166,1
2020-07-22-170205,170205,0,0,2,287,0.14285714285714285,51.602451596240684,2
2020-07-23-170205,170205,0,0,3,287,0.5714285714285714,47.41244934944329,3
2020-07-24-170205,170205,0,0,0,287,0.5714285714285714,49.968403130387635,4
2020-07-25-170205,170205,0,0,1,287,0.42857142857142855,46.40891596451044,5
2020-07-26-170205,170205,0,0,0,287,0.5714285714285714,35.555212376567255,6
2020-07-27-170205,170205,0,0,2,287,0.2857142857142857,39.14881492283604,0
2020-07-28-170205,170205,1,0,1,288,0.7142857142857143,37.89932382511252,1
2020-07-29-170205,170205,1,0,0,289,0.5714285714285714,33.445001623420154,2
2020-07-30-170205,170205,1,0,0,290,1.0,64.84831805754803,3
2020-07-31-170205,170205,0,0,0,290,1.1428571428571428,67.19150015345346,4
2020-08-01-170205,170205,0,0,1,290,0.5714285714285714,57.0460818169133,5
2020-08-02-170205,170205,0,1,0,290,1.0,284.71320825041335,6
2020-08-03-170205,170205,2,0,1,292,1.2857142857142858,226.55951754740158,0
2020-08-04-170205,170205,0,0,6,292,2.0,232.7505757422586,1
2020-08-05-170205,170205,2,0,3,294,3.2857142857142856,275.8269918753278,2
2020-08-06-170205,170205,3,0,0,297,2.2857142857142856,297.38978466343264,3
2020-08-07-170205,170205,0,0,5,297,3.1428571428571432,292.45656977133103,4
2020-08-08-170205,170205,1,0,0,298,1.5714285714285714,334.46434758646274,5
2020-08-09-170205,170205,0,0,0,298,1.0,319.76812583554806,6
2020-08-10-170205,170205,2,0,3,300,2.4285714285714284,58.19317995312112,0
2020-08-11-170205,170205,1,0,2,301,3.4285714285714284,90.91732225235565,1
2020-08-12-170205,170205,0,0,0,301,4.0,131.93252894904342,2
2020-08-13-170205,170205,0,0,1,301,3.2857142857142856,155.26908532777347,3
2020-08-14-170205,170205,0,0,2,301,1.1428571428571428,207.2619327655861,4
2020-08-15-170205,170205,1,0,1,302,1.1428571428571428,207.71799305821116,5
2020-08-16-170205,170205,0,0,0,302,1.0,208.51635928780354,6
2020-08-17-170205,170205,1,0,4,303,2.8571428571428568,215.16756056420107,0
2020-08-18-170205,170205,6,0,0,309,2.571428571428572,225.18809575365867,1
2020-08-19-170205,170205,3,0,3,312,3.0,239.20158795787972,2
2020-08-20-170205,170205,0,0,1,312,4.285714285714286,241.1022232446724,3
2020-08-21-170205,170205,5,0,1,317,3.2857142857142856,261.3153760776828,4
2020-08-22-170205,170205,0,0,4,317,0.8571428571428571,331.2017298974931,5
2020-08-23-170205,170205,0,0,2,317,1.5714285714285714,336.9723585073742,6
2020-08-24-170205,170205,3,0,0,320,2.7142857142857144,302.5648420596517,0
2020-08-25-170205,170205,2,0,4,322,2.2857142857142856,305.3386911220342,1
2020-08-26-170205,170205,0,0,2,322,3.2857142857142856,264.1060234235341,2
2020-08-27-170205,170205,1,0,0,323,3.1428571428571432,261.2394121848644,3
2020-08-28-170205,170205,2,0,1,325,4.857142857142857,269.4301220583715,4
2020-08-29-170205,170205,1,0,1,326,0.5714285714285714,228.94054539129127,5
2020-08-30-170205,170205,0,0,0,326,2.7142857142857144,245.69910444750246,6
2020-08-31-170205,170205,4,0,0,330,0.7142857142857143,196.0401908325863,0
2020-09-01-170205,170205,0,0,4,330,3.4285714285714284,290.1788853131309,1
2020-09-02-170205,170205,3,0,1,333,3.2857142857142856,304.9632777364077,2
2020-09-03-170205,170205,1,0,1,334,1.4285714285714286,328.63389175082966,3
2020-09-04-170205,170205,1,0,3,335,1.8571428571428568,291.302923828146,4
2020-09-05-170205,170205,4,0,0,339,1.4285714285714286,259.90276827289233,5
2020-09-06-170205,170205,2,0,1,341,0.2857142857142857,259.1347366292801,6
2020-09-07-170205,170205,0,0,2,341,4.142857142857143,255.86346462370454,0
2020-09-08-170205,170205,4,0,2,345,1.1428571428571428,217.09309044488688,1
2020-09-09-170205,170205,2,0,0,347,2.8571428571428568,230.6619077681707,2
2020-09-10-170205,170205,0,0,0,347,2.8571428571428568,221.1500629853431,3
2020-09-11-170205,170205,1,0,2,348,4.142857142857143,194.87862935057083,4
2020-09-12-170205,170205,1,0,5,349,3.571428571428572,198.58314056251703,5
2020-09-13-170205,170205,0,0,0,349,2.4285714285714284,222.20823456232898,6
2020-09-14-170205,170205,0,0,0,349,4.714285714285714,206.30359925176444,0
2020-09-15-170205,170205,4,0,0,353,8.857142857142858,217.4552505655628,1
2020-09-16-170205,170205,1,0,3,354,6.857142857142858,254.37907868912998,2
2020-09-17-170205,170205,1,0,1,355,8.142857142857142,266.1368610231846,3
2020-09-18-170205,170205,3,0,3,358,7.142857142857142,283.02792395504133,4
2020-09-19-170205,170205,0,0,0,358,2.2857142857142856,309.28704333844337,5
2020-09-20-170205,170205,1,0,1,359,3.0,280.68003936727683,6
2020-09-21-170205,170205,2,1,2,361,10.714285714285714,267.5339235842074,0
2020-09-22-170205,170205,2,0,3,363,8.0,273.19689163573673,1
2020-09-23-170205,170205,0,1,3,363,7.7142857142857135,299.03095966802823,2
2020-09-24-170205,170205,0,0,1,363,8.0,296.31849612896565,3
2020-09-25-170205,170205,2,1,0,365,13.571428571428573,273.6938333183039,4
2020-09-26-170205,170205,5,0,0,370,1.8571428571428568,308.5175549107348,5
2020-09-27-170205,170205,0,0,0,370,1.4285714285714286,312.394165300654,6
2020-09-28-170205,170205,0,1,0,370,7.2857142857142865,301.8682772664276,0
2020-09-29-170205,170205,0,1,1,370,5.428571428571429,297.92365213638504,1
2020-09-30-170205,170205,3,0,5,373,5.285714285714286,259.28027930487144,2
2020-10-01-170205,170205,1,0,1,374,9.285714285714286,0.0,3
2020-10-02-170205,170205,3,0,2,377,6.428571428571429,340.56246507985827,4
2020-10-03-170205,170205,0,0,0,377,1.7142857142857142,384.3723948078658,5
2020-10-04-170205,170205,1,0,1,378,2.571428571428572,408.5778508179758,6
2020-10-05-170205,170205,2,0,2,380,4.285714285714286,364.88514684436126,0
2020-10-06-170205,170205,3,2,2,383,5.428571428571429,334.18385544355095,1
2020-10-07-170205,170205,3,0,4,386,5.0,296.53563726916843,2
2020-10-08-170205,170205,1,0,5,387,4.285714285714286,288.732432997192,3
2020-10-09-170205,170205,0,0,1,387,2.7142857142857144,316.17285845818185,4
2020-10-10-170205,170205,0,0,0,387,0.7142857142857143,55.89133050855158,5
2020-10-11-170205,170205,0,0,1,387,0.5714285714285714,66.6750851656177,6
2020-10-12-170205,170205,0,0,0,387,2.2857142857142856,76.00323370373965,0
2020-10-13-170205,170205,1,0,4,388,5.571428571428571,90.63190290024725,1
2020-10-14-170205,170205,5,0,5,393,3.1428571428571432,143.06804909142943,2
2020-10-15-170205,170205,1,0,4,394,5.142857142857143,190.7042836371705,3
2020-10-16-170205,170205,2,0,4,396,5.7142857142857135,266.2976259552505,4
2020-10-17-170205,170205,0,0,5,396,1.8571428571428568,276.7409877414808,5
2020-10-18-170205,170205,1,0,0,397,1.1428571428571428,284.1355965748339,6
2020-10-19-170205,170205,2,0,0,399,5.142857142857143,289.8839840767761,0
2020-10-20-170205,170205,2,0,3,401,4.285714285714286,322.13897997768083,1
2020-10-21-170205,170205,4,0,3,405,6.0,314.40950794310385,2
2020-10-22-170205,170205,5,0,1,410,6.571428571428571,307.7278489616846,3
2020-10-23-170205,170205,1,0,3,411,6.142857142857142,303.16079085805814,4
2020-10-24-170205,170205,0,0,2,411,2.571428571428572,327.30867342711633,5
2020-10-25-170205,170205,1,0,1,412,4.714285714285714,324.78753166619924,6
2020-10-26-170205,170205,0,0,0,412,4.142857142857143,298.2578909726604,0
2020-10-27-170205,170205,4,1,4,416,4.571428571428571,308.2815618007084,1
2020-10-28-170205,170205,5,0,4,421,4.714285714285714,315.9957120999622,2
2020-10-29-170205,170205,4,1,1,425,4.142857142857143,333.616576370688,3
2020-10-30-170205,170205,4,0,4,429,3.8571428571428568,296.5680764371941,4
2020-10-31-170205,170205,5,0,0,434,1.4285714285714286,347.44258581577634,5
2020-11-01-170205,170205,0,1,0,434,1.4285714285714286,247.70727555183475,6
2020-11-02-170205,170205,0,0,0,434,2.8571428571428568,332.94272671375313,0
2020-11-03-170205,170205,3,0,0,437,4.0,275.98536544097567,1
2020-11-04-170205,170205,3,1,0,440,3.2857142857142856,308.3326060620617,2
2020-11-05-170205,170205,1,0,0,441,2.142857142857143,325.42352532620055,3
2020-11-06-170205,170205,3,0,0,444,3.571428571428572,294.0845369881278,4
2020-11-07-170205,170205,2,0,0,446,2.7142857142857144,290.8770200215296,5
2020-11-08-170205,170205,1,0,0,447,1.7142857142857142,288.5804972997461,6
2020-11-09-170205,170205,0,0,0,447,6.2857142857142865,282.22551648026996,0
2020-11-10-170205,170205,4,0,0,451,5.0,230.37606972859828,1
2020-11-11-170205,170205,4,0,0,455,3.8571428571428568,265.51736365453655,2
2020-11-12-170205,170205,1,0,0,456,4.0,283.619370636862,3
2020-11-13-170205,170205,4,0,0,460,5.285714285714286,268.4215845201577,4
2020-03-01-170206,170206,0,0,1,0,0.2,0.0,6
2020-03-02-170206,170206,0,0,10,0,0.0,73.65414736183027,0
2020-03-03-170206,170206,0,1,4,0,0.2,260.3366761115494,1
2020-03-04-170206,170206,0,1,19,0,0.2,269.964373879183,2
2020-03-05-170206,170206,0,0,18,0,0.6,289.1851652369833,3
2020-03-06-170206,170206,1,0,35,1,0.2,248.40586997943495,4
2020-03-07-170206,170206,0,0,7,1,0.2,262.129564439878,5
2020-03-08-170206,170206,0,0,10,1,0.2,260.1625127233167,6
2020-03-09-170206,170206,0,1,22,1,0.4,260.21481910997227,0
2020-03-10-170206,170206,0,0,15,1,2.4,1393.489075486659,1
2020-03-11-170206,170206,1,0,21,2,1.6,1168.852487459539,2
2020-03-12-170206,170206,2,0,14,4,1.4,932.5102194756707,3
2020-03-13-170206,170206,1,0,31,5,3.6,648.8697700011004,4
2020-03-14-170206,170206,2,0,7,7,1.2,505.23350514436055,5
2020-03-15-170206,170206,1,0,4,8,4.2,344.16625474443686,6
2020-03-16-170206,170206,10,0,23,18,10.4,105.33238435362831,0
2020-03-17-170206,170206,4,0,21,22,10.6,158.51105173781548,1
2020-03-18-170206,170206,19,0,13,41,20.2,192.41722583233042,2
2020-03-19-170206,170206,18,0,11,59,19.2,244.44049363210956,3
2020-03-20-170206,170206,35,0,12,94,22.6,265.0372104847578,4
2020-03-21-170206,170206,7,0,1,101,9.2,297.64222781189847,5
2020-03-22-170206,170206,10,0,1,111,9.6,296.07911536037665,6
2020-03-23-170206,170206,22,0,8,133,28.2,287.1998809813938,0
2020-03-24-170206,170206,15,0,11,148,21.4,330.3971046094249,1
2020-03-25-170206,170206,21,0,9,169,18.8,336.020640352987,2
2020-03-26-170206,170206,14,0,4,183,19.0,318.03897790064127,3
2020-03-27-170206,170206,31,0,8,214,15.4,369.55658874060964,4
2020-03-28-170206,170206,7,0,2,221,7.6,363.458181288343,5
2020-03-29-170206,170206,4,0,0,225,6.2,358.9877158580341,6
2020-03-30-170206,170206,23,0,7,248,16.2,266.8925252366395,0
2020-03-31-170206,170206,21,0,8,269,10.4,245.56274237429386,1
2020-04-01-170206,170206,13,0,9,282,12.4,38.03211464604178,2
2020-04-02-170206,170206,11,0,15,293,10.8,173.36018890703946,3
2020-04-03-170206,170206,12,0,2,305,12.6,84.4656728359939,4
2020-04-04-170206,170206,1,0,4,306,5.2,110.86298910974358,5
2020-04-05-170206,170206,1,0,3,307,3.2,117.16585471012463,6
2020-04-06-170206,170206,8,0,3,315,10.8,122.57395315870548,0
2020-04-07-170206,170206,11,10,8,326,7.4,135.19469333715884,1
2020-04-08-170206,170206,9,1,4,335,8.2,143.65225662932852,2
2020-04-09-170206,170206,4,0,3,339,5.8,152.71072851446752,3
2020-04-10-170206,170206,8,0,6,347,15.4,34.3217651112456,4
2020-04-11-170206,170206,2,0,2,349,5.8,57.833403810293575,5
2020-04-12-170206,170206,0,0,0,349,3.8,78.62674456606518,6
2020-04-13-170206,170206,7,0,8,356,10.2,87.88358393335454,0
2020-04-14-170206,170206,8,0,6,364,9.6,121.37244874888168,1
2020-04-15-170206,170206,9,0,5,373,15.6,150.12356516329862,2
2020-04-16-170206,170206,15,0,3,388,6.4,186.12219105880285,3
2020-04-17-170206,170206,2,0,2,390,17.8,187.24868798841453,4
2020-04-18-170206,170206,4,0,2,394,3.4,204.82316177683276,5
2020-04-19-170206,170206,3,0,0,397,5.2,190.3721495080943,6
2020-04-20-170206,170206,3,0,2,400,8.8,187.99816658832526,0
2020-04-21-170206,170206,8,0,1,408,6.4,183.60440298915256,1
2020-04-22-170206,170206,4,0,5,412,10.6,164.7514217109029,2
2020-04-23-170206,170206,3,0,3,415,3.6,169.8612322470322,3
2020-04-24-170206,170206,6,0,6,421,5.0,132.78084597232476,4
2020-04-25-170206,170206,2,0,0,423,2.0,141.76095265681187,5
2020-04-26-170206,170206,0,0,1,423,1.4,136.530286481478,6
2020-04-27-170206,170206,8,0,5,431,6.0,111.68184615087331,0
2020-04-28-170206,170206,6,0,3,437,5.0,108.9152017908811,1
2020-04-29-170206,170206,5,0,7,442,5.2,104.32637374624571,2
2020-04-30-170206,170206,3,0,6,445,2.8,124.97479527826408,3
2020-05-01-170206,170206,2,0,11,447,1.2,161.6755666978934,4
2020-05-02-170206,170206,2,0,5,449,1.6,127.40394080743091,5
2020-05-03-170206,170206,0,0,0,449,1.2,66.50097345085479,6
2020-05-04-170206,170206,2,0,9,451,4.2,52.83663149580855,0
2020-05-05-170206,170206,1,0,4,452,4.4,53.93824583112267,1
2020-05-06-170206,170206,5,0,5,457,5.0,57.60746969261006,2
2020-05-07-170206,170206,3,0,4,460,3.2,66.3435817147751,3
2020-05-08-170206,170206,6,0,6,466,4.4,68.29157429683056,4
2020-05-09-170206,170206,0,0,1,466,0.4,91.95386439591704,5
2020-05-10-170206,170206,1,0,0,467,0.6,183.66178240014295,6
2020-05-11-170206,170206,5,0,11,472,7.0,162.4720531812556,0
2020-05-12-170206,170206,3,0,6,475,4.4,173.80416544043334,1
2020-05-13-170206,170206,7,0,5,482,8.4,146.83749496503282,2
2020-05-14-170206,170206,6,0,3,488,8.8,151.62151597262192,3
2020-05-15-170206,170206,11,0,0,499,6.6,160.1354824658917,4
2020-05-16-170206,170206,5,0,0,504,1.8,162.8538347530705,5
2020-05-17-170206,170206,0,0,0,504,0.0,162.1312915726731,6
2020-05-18-170206,170206,9,0,0,513,5.8,163.48031307257014,0
2020-05-19-170206,170206,4,0,2,517,5.2,168.73885340343907,1
2020-05-20-170206,170206,5,0,1,522,4.4,143.1931967627787,2
2020-05-21-170206,170206,4,0,7,526,3.8,130.2076714164124,3
2020-05-22-170206,170206,6,0,7,532,3.4,121.57935675631501,4
2020-05-23-170206,170206,1,0,0,533,0.8,141.34200414522536,5
2020-05-24-170206,170206,0,0,0,533,0.0,146.5655365127567,6
2020-05-25-170206,170206,11,0,5,544,6.6,112.24538756503365,0
2020-05-26-170206,170206,6,0,2,550,3.6,115.88410470595346,1
2020-05-27-170206,170206,5,0,1,555,3.6,134.30563683867416,2
2020-05-28-170206,170206,3,0,2,558,2.8,124.46996818846011,3
2020-05-29-170206,170206,0,0,4,558,3.0,116.02009417500204,4
2020-05-30-170206,170206,0,0,0,558,0.0,115.19603370403469,5
2020-05-31-170206,170206,0,0,0,558,0.0,117.79359857958235,6
2020-06-01-170206,170206,0,2,1,558,3.6,128.8210466998398,0
2020-06-02-170206,170206,2,0,0,560,1.4,37.56680610445987,1
2020-06-03-170206,170206,1,0,0,561,2.4,27.779350715438625,2
2020-06-04-170206,170206,7,0,0,568,1.6,29.732444172781186,3
2020-06-05-170206,170206,7,0,0,575,2.0,35.84998200900547,4
2020-06-06-170206,170206,0,0,1,575,1.6,43.90899278867507,5
2020-06-07-170206,170206,0,0,0,575,0.4,46.23121426577843,6
2020-06-08-170206,170206,5,0,1,580,2.2,46.68731822409249,0
2020-06-09-170206,170206,2,0,0,582,1.4,58.44082293769452,1
2020-06-10-170206,170206,1,0,0,583,2.8,146.52654138954134,2
2020-06-11-170206,170206,2,0,0,585,0.8,138.06437479236476,3
2020-06-12-170206,170206,4,0,2,589,1.4,125.94847853709777,4
2020-06-13-170206,170206,0,0,0,589,0.0,98.77072767373932,5
2020-06-14-170206,170206,0,1,0,589,0.0,81.54988199556408,6
2020-06-15-170206,170206,1,0,0,590,1.8,48.41499678954723,0
2020-06-16-170206,170206,0,0,0,590,1.6,60.43888536964421,1
2020-06-17-170206,170206,0,0,0,590,2.2,52.863694900244454,2
2020-06-18-170206,170206,0,0,0,590,1.2,49.75433157697263,3
2020-06-19-170206,170206,0,0,0,590,0.2,46.57102646501663,4
2020-06-20-170206,170206,1,0,0,591,0.2,54.01207319077818,5
2020-06-21-170206,170206,0,0,2,591,0.4,54.71582496798311,6
2020-06-22-170206,170206,1,0,0,592,1.4,43.7825202494537,0
2020-06-23-170206,170206,0,0,0,592,1.2,42.41235891026221,1
2020-06-24-170206,170206,0,0,0,592,1.4,38.841342261372525,2
2020-06-25-170206,170206,0,1,1,592,2.2,39.37409753782962,3
2020-06-26-170206,170206,2,0,2,594,1.6,43.593220007660655,4
2020-06-27-170206,170206,0,0,0,594,0.0,39.98016734390501,5
2020-06-28-170206,170206,0,0,1,594,0.2,42.18013779610574,6
2020-06-29-170206,170206,0,0,0,594,0.2,41.37018816241792,0
2020-06-30-170206,170206,0,0,0,594,0.8,38.80677391804958,1
2020-07-01-170206,170206,0,0,1,594,1.0,70.59206176176738,2
2020-07-02-170206,170206,0,0,0,594,0.2,50.40360264151674,3
2020-07-03-170206,170206,0,0,3,594,0.6,55.93909588678528,4
2020-07-04-170206,170206,0,0,4,594,0.0,75.0229234080457,5
2020-07-05-170206,170206,2,0,0,596,0.0,73.45683165871674,6
2020-07-06-170206,170206,0,0,0,596,0.2,60.81459291065305,0
2020-07-07-170206,170206,0,0,0,596,0.6,57.21237656766225,1
2020-07-08-170206,170206,0,0,1,596,0.4,48.03021060826199,2
2020-07-09-170206,170206,1,0,1,597,0.2,44.778192242836525,3
2020-07-10-170206,170206,2,0,4,599,0.4,72.94489650860393,4
2020-07-11-170206,170206,0,0,0,599,0.0,63.43500367466489,5
2020-07-12-170206,170206,1,0,0,600,0.2,46.49147986648146,6
2020-07-13-170206,170206,0,0,1,600,0.8,42.26298879735101,0
2020-07-14-170206,170206,0,0,3,600,0.6,47.971580558692054,1
2020-07-15-170206,170206,1,0,0,601,3.4,38.198716537125826,2
2020-07-16-170206,170206,0,0,0,601,0.8,35.42082729449804,3
2020-07-17-170206,170206,3,0,4,604,1.6,32.752201445251316,4
2020-07-18-170206,170206,4,0,0,608,0.8,41.60812933611153,5
2020-07-19-170206,170206,0,0,0,608,0.6,49.514021324086556,6
2020-07-20-170206,170206,0,0,3,608,1.2,43.387972161346156,0
2020-07-21-170206,170206,0,1,4,608,1.0,48.137549193967395,1
2020-07-22-170206,170206,1,0,3,609,0.8,44.347135457520196,2
2020-07-23-170206,170206,1,0,3,610,0.8,49.814472059563,3
2020-07-24-170206,170206,4,0,2,614,0.4,45.012946640290366,4
2020-07-25-170206,170206,0,0,4,614,0.4,42.17117492801917,5
2020-07-26-170206,170206,0,0,0,614,0.2,42.982247839463426,6
2020-07-27-170206,170206,1,0,1,615,3.6,44.48777664259927,0
2020-07-28-170206,170206,3,0,1,618,1.2,48.345358133147094,1
2020-07-29-170206,170206,0,0,5,618,2.2,49.26608942507677,2
2020-07-30-170206,170206,0,0,3,618,3.6,52.312308727802204,3
2020-07-31-170206,170206,4,1,2,622,3.8,66.22176691181693,4
2020-08-01-170206,170206,0,0,3,622,0.8,27.972558498838914,5
2020-08-02-170206,170206,0,0,2,622,0.0,177.96533975943532,6
2020-08-03-170206,170206,3,0,2,625,2.8,184.32371523315084,0
2020-08-04-170206,170206,4,0,4,629,1.4,185.75014803289622,1
2020-08-05-170206,170206,3,0,3,632,3.0,173.56754829257324,2
2020-08-06-170206,170206,3,0,2,635,3.4,180.28259574808814,3
2020-08-07-170206,170206,2,0,5,637,2.6,166.86825568230955,4
2020-08-08-170206,170206,4,0,0,641,2.0,171.15854823012228,5
2020-08-09-170206,170206,0,0,0,641,2.2,169.36182911455555,6
2020-08-10-170206,170206,1,0,10,642,3.0,20.64892260061167,0
2020-08-11-170206,170206,1,0,6,643,3.8,44.104192649598865,1
2020-08-12-170206,170206,5,0,1,648,4.4,69.06028807863049,2
2020-08-13-170206,170206,3,0,2,651,5.4,92.27298534521822,3
2020-08-14-170206,170206,2,0,5,653,3.0,117.13574761379441,4
2020-08-15-170206,170206,3,0,2,656,2.6,136.72248110206974,5
2020-08-16-170206,170206,2,0,1,658,0.8,140.24918825573403,6
2020-08-17-170206,170206,2,0,8,660,2.4,152.80525154192293,0
2020-08-18-170206,170206,4,0,5,664,5.8,147.77180725713578,1
2020-08-19-170206,170206,3,0,6,667,3.6,162.17745571705666,2
2020-08-20-170206,170206,2,0,4,669,2.6,140.10020242459967,3
2020-08-21-170206,170206,5,0,2,674,3.2,142.2871842789385,4
2020-08-22-170206,170206,0,0,2,674,2.8,156.9144850003077,5
2020-08-23-170206,170206,0,0,2,674,1.4,165.5647289560299,6
2020-08-24-170206,170206,10,0,3,684,8.0,155.82403250317697,0
2020-08-25-170206,170206,6,0,3,690,6.0,160.27587455267613,1
2020-08-26-170206,170206,1,0,3,691,6.0,163.36003516812283,2
2020-08-27-170206,170206,2,0,2,693,6.4,184.59797644405157,3
2020-08-28-170206,170206,5,1,8,698,4.8,181.69765037746956,4
2020-08-29-170206,170206,2,0,2,700,0.6,182.79706500858208,5
2020-08-30-170206,170206,1,0,5,701,3.0,177.46392653185998,6
2020-08-31-170206,170206,8,0,6,709,5.2,157.84000615495705,0
2020-09-01-170206,170206,5,0,4,714,4.8,154.9789603462349,1
2020-09-02-170206,170206,6,0,3,720,6.4,292.9908291829688,2
2020-09-03-170206,170206,4,0,8,724,6.6,257.93217332128125,3
2020-09-04-170206,170206,2,0,0,726,7.4,259.5278267088576,4
2020-09-05-170206,170206,2,1,1,728,3.8,247.96267559523744,5
2020-09-06-170206,170206,2,0,2,730,1.6,260.04534382083045,6
2020-09-07-170206,170206,3,0,3,733,5.6,260.3522273397691,0
2020-09-08-170206,170206,3,0,10,736,6.6,256.81159798565994,1
2020-09-09-170206,170206,3,0,5,739,6.4,263.28059424430904,2
2020-09-10-170206,170206,2,0,7,741,12.2,192.3079127111132,3
2020-09-11-170206,170206,8,0,1,749,8.4,208.5027859903022,4
2020-09-12-170206,170206,2,0,0,751,2.6,232.23102366511955,5
2020-09-13-170206,170206,5,0,1,756,2.8,241.2028217343009,6
2020-09-14-170206,170206,6,0,7,762,9.0,262.910427791014,0
2020-09-15-170206,170206,4,0,2,766,15.2,304.54181948588507,1
2020-09-16-170206,170206,3,0,3,769,11.0,349.5879040718562,2
2020-09-17-170206,170206,8,0,5,777,15.0,323.0391331586909,3
2020-09-18-170206,170206,0,0,4,777,15.8,344.82506198776196,4
2020-09-19-170206,170206,1,2,3,778,2.8,353.8243362386569,5
2020-09-20-170206,170206,2,0,2,780,1.4,340.42008027247846,6
2020-09-21-170206,170206,3,0,4,783,18.0,291.02668562967983,0
2020-09-22-170206,170206,10,2,3,793,14.6,286.60595330394096,1
2020-09-23-170206,170206,5,1,5,798,15.8,288.05786943695034,2
2020-09-24-170206,170206,7,1,5,805,10.0,290.24947421715603,3
2020-09-25-170206,170206,1,0,17,806,15.8,266.7019724868894,4
2020-09-26-170206,170206,0,0,4,806,0.0,310.05982844306106,5
2020-09-27-170206,170206,1,0,3,807,1.4,279.2085339478622,6
2020-09-28-170206,170206,7,0,7,814,8.2,281.1603962653634,0
2020-09-29-170206,170206,2,0,13,816,3.8,294.14801288511165,1
2020-09-30-170206,170206,3,0,14,819,9.2,266.26004533815683,2
2020-10-01-170206,170206,5,0,16,824,8.0,0.0,3
2020-10-02-170206,170206,4,1,10,828,12.8,723.3730821311567,4
2020-10-03-170206,170206,3,0,5,831,3.0,1119.857686007896,5
2020-10-04-170206,170206,2,0,1,833,6.0,1143.9076643018088,6
2020-10-05-170206,170206,4,0,13,837,6.8,939.3045584423677,0
2020-10-06-170206,170206,3,1,16,840,6.6,796.4174206352488,1
2020-10-07-170206,170206,5,0,19,845,10.4,645.0173617577211,2
2020-10-08-170206,170206,5,0,10,850,10.8,537.3826413146662,3
2020-10-09-170206,170206,17,0,9,867,18.0,582.4142810029657,4
2020-10-10-170206,170206,4,0,2,871,2.2,41.460993769899055,5
2020-10-11-170206,170206,3,0,5,874,5.4,67.44605633404117,6
2020-10-12-170206,170206,7,0,23,881,6.2,108.81650181104035,0
2020-10-13-170206,170206,13,0,25,894,16.0,166.6312945206405,1
2020-10-14-170206,170206,14,0,22,908,11.4,293.89555683707,2
2020-10-15-170206,170206,16,0,9,924,18.2,365.3749950560572,3
2020-10-16-170206,170206,10,0,12,934,18.6,512.3776765605044,4
2020-10-17-170206,170206,5,0,8,939,4.8,594.4444858202185,5
2020-10-18-170206,170206,1,0,27,940,4.2,601.5585533867942,6
2020-10-19-170206,170206,13,0,16,953,23.4,585.4846320441272,0
2020-10-20-170206,170206,16,0,26,969,17.0,640.9930691984594,1
2020-10-21-170206,170206,19,0,18,988,19.8,706.8037442002312,2
2020-10-22-170206,170206,10,0,20,998,17.8,716.4671300148857,3
2020-10-23-170206,170206,9,0,32,1007,18.6,755.8072626967567,4
2020-10-24-170206,170206,2,3,10,1009,5.8,862.5495193634966,5
2020-10-25-170206,170206,5,0,21,1014,9.2,873.0169791534809,6
2020-10-26-170206,170206,23,1,28,1037,30.2,766.3185762777491,0
2020-10-27-170206,170206,25,0,17,1062,19.2,926.9334440001758,1
2020-10-28-170206,170206,22,0,19,1084,21.2,967.6714421083244,2
2020-10-29-170206,170206,9,0,16,1093,22.4,993.9539127964069,3
2020-10-30-170206,170206,12,0,35,1105,24.8,905.7812608957505,4
2020-10-31-170206,170206,8,0,0,1113,9.6,1030.3875872584467,5
2020-11-01-170206,170206,27,0,0,1140,19.8,405.0727230934158,6
2020-11-02-170206,170206,16,1,0,1156,12.6,981.2522204563519,0
2020-11-03-170206,170206,26,0,0,1182,25.4,860.6829212706898,1
2020-11-04-170206,170206,18,1,0,1200,28.4,1029.303697758049,2
2020-11-05-170206,170206,20,1,0,1220,26.4,1058.546895059254,3
2020-11-06-170206,170206,32,2,0,1252,37.2,1132.9205454327994,4
2020-11-07-170206,170206,10,1,0,1262,13.2,1174.263163807425,5
2020-11-08-170206,170206,21,0,0,1283,16.0,1105.7679486693696,6
2020-11-09-170206,170206,28,0,0,1311,29.0,1090.6966093671651,0
2020-11-10-170206,170206,17,2,0,1328,21.2,448.7125739050927,1
2020-11-11-170206,170206,19,1,0,1347,18.4,562.4733539373967,2
2020-11-12-170206,170206,16,1,0,1363,27.0,661.5896049636051,3
2020-11-13-170206,170206,35,2,0,1398,25.6,773.2907648235314,4
2020-03-01-170207,170207,0,0,6,0,0.25,0.0,6
2020-03-02-170207,170207,0,0,12,0,0.0,23.640570385969912,0
2020-03-03-170207,170207,0,0,11,0,0.0,92.82389894726748,1
2020-03-04-170207,170207,0,0,23,0,0.25,99.20069503851724,2
2020-03-05-170207,170207,0,0,26,0,0.5,108.50841886006116,3
2020-03-06-170207,170207,0,2,26,0,0.5,92.55786778566834,4
2020-03-07-170207,170207,0,0,8,0,0.25,97.06466365049639,5
2020-03-08-170207,170207,0,0,6,0,0.25,92.14467064369154,6
2020-03-09-170207,170207,0,0,26,0,0.75,91.93491570700482,0
2020-03-10-170207,170207,4,0,25,4,1.25,494.59257891683103,1
2020-03-11-170207,170207,0,0,22,4,2.0,414.8746201029013,2
2020-03-12-170207,170207,1,0,17,5,1.75,330.40631434408414,3
2020-03-13-170207,170207,0,1,13,5,2.0,230.9620799272286,4
2020-03-14-170207,170207,2,0,6,7,1.5,183.37443043524775,5
2020-03-15-170207,170207,6,0,8,13,2.5,133.2868400337602,6
2020-03-16-170207,170207,12,0,15,25,9.25,42.44962769077263,0
2020-03-17-170207,170207,11,0,15,36,7.25,66.72678265354898,1
2020-03-18-170207,170207,23,1,16,59,12.75,82.87550995868699,2
2020-03-19-170207,170207,26,0,12,85,14.75,109.61510875137536,3
2020-03-20-170207,170207,26,0,7,111,22.0,125.52335678713457,4
2020-03-21-170207,170207,8,0,2,119,7.5,143.5031517206279,5
2020-03-22-170207,170207,6,0,1,125,8.5,143.77258614064755,6
2020-03-23-170207,170207,26,0,12,151,18.5,137.0743569498233,0
2020-03-24-170207,170207,25,0,8,176,15.5,153.6050367681991,1
2020-03-25-170207,170207,22,0,13,198,13.25,154.5452847393783,2
2020-03-26-170207,170207,17,0,6,215,15.5,147.4668685559424,3
2020-03-27-170207,170207,13,0,48,228,16.25,168.58930398301425,4
2020-03-28-170207,170207,6,0,1,234,5.75,166.3029151300147,5
2020-03-29-170207,170207,8,0,0,242,3.75,163.16765175694832,6
2020-03-30-170207,170207,15,0,15,257,11.75,123.90797629982177,0
2020-03-31-170207,170207,15,0,7,272,11.25,112.52040857684048,1
2020-04-01-170207,170207,16,0,12,288,9.0,18.24124310403911,2
2020-04-02-170207,170207,12,0,6,300,8.25,75.27745534204385,3
2020-04-03-170207,170207,7,0,5,307,10.75,37.9871972487211,4
2020-04-04-170207,170207,2,0,3,309,2.75,50.467830270555254,5
2020-04-05-170207,170207,1,0,1,310,2.5,53.421754802989966,6
2020-04-06-170207,170207,12,0,3,322,9.0,56.95561618216815,0
2020-04-07-170207,170207,8,2,5,330,6.5,63.48951961170721,1
2020-04-08-170207,170207,13,0,3,343,6.75,66.99854060355624,2
2020-04-09-170207,170207,6,0,0,349,4.25,72.02708610606024,3
2020-04-10-170207,170207,48,1,4,397,5.75,14.85931488481313,4
2020-04-11-170207,170207,1,0,0,398,1.75,25.633796875323902,5
2020-04-12-170207,170207,0,0,1,398,1.0,33.51256529513569,6
2020-04-13-170207,170207,15,0,3,413,5.75,36.348996358834654,0
2020-04-14-170207,170207,7,0,2,420,7.5,50.76752794853403,1
2020-04-15-170207,170207,12,0,3,432,7.25,62.8739525448122,2
2020-04-16-170207,170207,6,0,1,438,6.5,79.7177469419222,3
2020-04-17-170207,170207,5,0,0,443,5.75,82.11029255618615,4
2020-04-18-170207,170207,3,0,2,446,2.75,87.81057253724397,5
2020-04-19-170207,170207,1,0,0,447,2.25,82.43189516491768,6
2020-04-20-170207,170207,3,0,3,450,5.25,83.39202555456062,0
2020-04-21-170207,170207,5,0,4,455,4.75,82.74350610353869,1
2020-04-22-170207,170207,3,0,4,458,3.5,73.84775564842077,2
2020-04-23-170207,170207,0,0,5,458,3.0,74.10105897251856,3
2020-04-24-170207,170207,4,0,5,462,4.25,58.56125373000787,4
2020-04-25-170207,170207,0,0,2,462,1.75,62.638039364601354,5
2020-04-26-170207,170207,1,0,1,463,1.25,60.61426026743041,6
2020-04-27-170207,170207,3,1,11,466,5.75,48.67098421681587,0
2020-04-28-170207,170207,2,0,4,468,4.0,48.23512965230076,1
2020-04-29-170207,170207,3,0,9,471,3.5,47.10616904911207,2
2020-04-30-170207,170207,1,0,3,472,2.25,57.94053996965565,3
2020-05-01-170207,170207,0,0,9,472,0.75,78.47131814256079,4
2020-05-02-170207,170207,2,0,4,474,0.5,61.34372467997281,5
2020-05-03-170207,170207,0,0,0,474,0.5,29.424138168439722,6
2020-05-04-170207,170207,3,0,4,477,3.0,23.032063640619985,0
2020-05-05-170207,170207,4,0,2,481,2.25,23.309053989396574,1
2020-05-06-170207,170207,4,0,1,485,4.25,25.7047528546412,2
2020-05-07-170207,170207,5,0,4,490,2.25,28.13972816143669,3
2020-05-08-170207,170207,5,0,3,495,4.25,29.838171364262262,4
2020-05-09-170207,170207,2,0,1,497,0.0,39.76263735408895,5
2020-05-10-170207,170207,1,0,0,498,0.25,83.57748757268809,6
2020-05-11-170207,170207,11,1,7,509,4.5,75.49667488988966,0
2020-05-12-170207,170207,4,0,1,513,3.5,78.3283663615399,1
2020-05-13-170207,170207,9,0,1,522,6.75,64.24480772174975,2
2020-05-14-170207,170207,3,0,3,525,7.75,67.2857750706746,3
2020-05-15-170207,170207,9,0,2,534,6.0,69.51722419575992,4
2020-05-16-170207,170207,4,0,0,538,2.0,70.21839836445429,5
2020-05-17-170207,170207,0,0,0,538,0.0,70.30907045703441,6
2020-05-18-170207,170207,4,1,3,542,5.0,70.41997064868727,0
2020-05-19-170207,170207,2,0,0,544,4.75,74.3244726452652,1
2020-05-20-170207,170207,1,0,3,545,4.25,62.55990910071677,2
2020-05-21-170207,170207,4,0,2,549,3.75,56.016010466491984,3
2020-05-22-170207,170207,3,0,2,552,2.5,52.82345810661285,4
2020-05-23-170207,170207,1,0,1,553,0.25,61.75816231441879,5
2020-05-24-170207,170207,0,0,0,553,0.0,63.00956520756442,6
2020-05-25-170207,170207,7,0,3,560,6.5,47.6309206613342,0
2020-05-26-170207,170207,1,0,0,561,2.25,48.19353865620504,1
2020-05-27-170207,170207,1,0,1,562,4.0,55.37020504455617,2
2020-05-28-170207,170207,3,3,1,565,3.0,51.47154023025455,3
2020-05-29-170207,170207,2,1,4,567,1.0,46.90799142479011,4
2020-05-30-170207,170207,0,0,0,567,0.0,45.066942969859895,5
2020-05-31-170207,170207,0,0,0,567,0.0,45.53128451904517,6
2020-06-01-170207,170207,3,0,2,570,1.0,50.67253260270513,0
2020-06-02-170207,170207,0,0,2,570,1.25,14.355262426712304,1
2020-06-03-170207,170207,3,0,5,573,1.5,11.117739164308015,2
2020-06-04-170207,170207,2,0,1,575,2.25,11.526289980240431,3
2020-06-05-170207,170207,2,0,0,577,2.25,14.469537244392024,4
2020-06-06-170207,170207,1,0,0,578,1.25,16.934255060844816,5
2020-06-07-170207,170207,0,0,1,578,0.0,17.624911473622582,6
2020-06-08-170207,170207,3,0,3,581,2.25,17.81242066501872,0
2020-06-09-170207,170207,0,0,2,581,1.25,22.14249455399921,1
2020-06-10-170207,170207,1,0,3,582,2.25,56.761953590238875,2
2020-06-11-170207,170207,1,0,6,583,1.5,52.779434387145415,3
2020-06-12-170207,170207,4,0,4,587,1.25,48.03388431568587,4
2020-06-13-170207,170207,0,0,0,587,0.0,38.734392825693,5
2020-06-14-170207,170207,0,1,1,587,0.0,30.7393265141042,6
2020-06-15-170207,170207,2,0,0,589,0.75,17.8939227006407,0
2020-06-16-170207,170207,2,0,2,591,0.25,22.43945597600579,1
2020-06-17-170207,170207,5,0,2,596,1.25,20.37579411810148,2
2020-06-18-170207,170207,1,0,1,597,0.5,19.355238354474174,3
2020-06-19-170207,170207,0,0,0,597,0.25,17.358011206240896,4
2020-06-20-170207,170207,0,0,0,597,0.25,20.060207574444984,5
2020-06-21-170207,170207,1,0,0,598,0.0,20.079073570295893,6
2020-06-22-170207,170207,3,0,1,601,1.0,15.928693622966602,0
2020-06-23-170207,170207,2,0,1,603,0.75,15.598973712881719,1
2020-06-24-170207,170207,3,0,1,606,0.5,14.131572585723756,2
2020-06-25-170207,170207,6,0,0,612,0.5,14.596382348215936,3
2020-06-26-170207,170207,4,0,0,616,1.25,15.89652096273079,4
2020-06-27-170207,170207,0,0,0,616,0.25,14.61814220254298,5
2020-06-28-170207,170207,1,1,0,617,0.0,15.498538559942007,6
2020-06-29-170207,170207,0,0,0,617,0.0,15.073603871708043,0
2020-06-30-170207,170207,2,0,0,619,0.5,13.56123785131106,1
2020-07-01-170207,170207,2,0,1,621,0.5,24.137251239078388,2
2020-07-02-170207,170207,1,0,2,622,0.0,18.740005321213523,3
2020-07-03-170207,170207,0,0,0,622,0.25,20.605032394404894,4
2020-07-04-170207,170207,0,0,0,622,0.0,27.09928122130367,5
2020-07-05-170207,170207,0,0,0,622,0.5,26.274001650170895,6
2020-07-06-170207,170207,1,0,0,623,0.0,22.061310397054495,0
2020-07-07-170207,170207,1,0,2,624,0.25,20.879215105574858,1
2020-07-08-170207,170207,1,0,0,625,0.25,17.8309268996262,2
2020-07-09-170207,170207,0,0,1,625,0.75,16.61616550525595,3
2020-07-10-170207,170207,0,0,1,625,0.75,24.986537407972637,4
2020-07-11-170207,170207,0,0,0,625,0.0,21.141118315504258,5
2020-07-12-170207,170207,0,0,0,625,0.25,15.607251634570614,6
2020-07-13-170207,170207,0,0,4,625,0.75,14.501438369077437,0
2020-07-14-170207,170207,0,0,1,625,0.5,17.274583173411024,1
2020-07-15-170207,170207,1,0,3,626,3.75,14.197670575925118,2
2020-07-16-170207,170207,2,0,2,628,0.0,13.60174536824507,3
2020-07-17-170207,170207,0,0,5,628,1.25,12.509198779477815,4
2020-07-18-170207,170207,0,0,1,628,1.75,15.969750503645649,5
2020-07-19-170207,170207,0,0,0,628,0.5,18.81824814138773,6
2020-07-20-170207,170207,0,0,1,628,1.0,15.93670934635169,0
2020-07-21-170207,170207,2,0,2,630,0.5,17.786217830668843,1
2020-07-22-170207,170207,0,0,1,630,0.75,16.479453264785317,2
2020-07-23-170207,170207,1,0,2,631,0.5,18.66231326629482,3
2020-07-24-170207,170207,1,0,6,632,1.0,17.315786873467516,4
2020-07-25-170207,170207,0,0,2,632,0.5,16.509069528700948,5
2020-07-26-170207,170207,0,0,2,632,0.25,16.8278340830096,6
2020-07-27-170207,170207,4,0,2,636,2.25,17.686555473512378,0
2020-07-28-170207,170207,1,0,6,637,1.0,18.830874195471516,1
2020-07-29-170207,170207,3,0,5,640,1.25,18.791342418591782,2
2020-07-30-170207,170207,2,0,9,642,3.75,19.386889655023502,3
2020-07-31-170207,170207,5,0,4,647,2.75,24.735606331328647,4
2020-08-01-170207,170207,1,0,2,648,0.25,10.330056995448672,5
2020-08-02-170207,170207,0,0,1,648,0.25,64.24883844539637,6
2020-08-03-170207,170207,1,0,1,649,1.5,67.21555017908052,0
2020-08-04-170207,170207,2,0,2,651,2.75,66.6260190472176,1
2020-08-05-170207,170207,1,0,1,652,2.75,63.65589073797534,2
2020-08-06-170207,170207,2,0,3,654,2.75,66.0002850956779,3
2020-08-07-170207,170207,6,0,1,660,2.5,62.085380240034645,4
2020-08-08-170207,170207,2,0,2,662,1.75,63.61330714087656,5
2020-08-09-170207,170207,2,0,1,664,1.0,63.68750422800326,6
2020-08-10-170207,170207,2,0,4,666,3.25,7.462402718045803,0
2020-08-11-170207,170207,6,0,3,672,2.25,16.44032648480631,1
2020-08-12-170207,170207,5,0,4,677,3.75,26.067839794641266,2
2020-08-13-170207,170207,9,0,8,686,3.25,34.604342703115535,3
2020-08-14-170207,170207,4,0,4,690,0.75,42.322561150229234,4
2020-08-15-170207,170207,2,0,0,692,2.5,48.77684929270083,5
2020-08-16-170207,170207,1,0,0,693,1.25,49.80178745380842,6
2020-08-17-170207,170207,1,0,1,694,1.25,54.42376857332411,0
2020-08-18-170207,170207,2,0,0,696,4.5,52.834782254119006,1
2020-08-19-170207,170207,1,0,2,697,3.0,57.482852561140675,2
2020-08-20-170207,170207,3,0,4,700,2.0,50.15513733765438,3
2020-08-21-170207,170207,1,0,1,701,3.25,51.17078002369967,4
2020-08-22-170207,170207,2,0,2,703,0.75,57.24849443453215,5
2020-08-23-170207,170207,1,0,1,704,1.0,60.57315186476623,6
2020-08-24-170207,170207,4,0,7,708,6.75,57.67003525738915,0
2020-08-25-170207,170207,3,0,1,711,5.5,59.11316344297191,1
2020-08-26-170207,170207,4,0,3,715,5.5,60.71739390946772,2
2020-08-27-170207,170207,8,0,14,723,4.5,68.46894372451608,3
2020-08-28-170207,170207,4,0,10,727,5.75,67.62063519703298,4
2020-08-29-170207,170207,0,0,2,727,1.0,67.48413221181093,5
2020-08-30-170207,170207,0,0,1,727,2.25,65.05453101675329,6
2020-08-31-170207,170207,1,0,9,728,5.0,57.28280949298559,0
2020-09-01-170207,170207,0,0,7,728,6.25,59.20815887922343,1
2020-09-02-170207,170207,2,0,11,730,4.75,114.007282501312,2
2020-09-03-170207,170207,4,0,9,734,4.5,96.88873951262191,3
2020-09-04-170207,170207,1,0,12,735,6.5,96.88111021383287,4
2020-09-05-170207,170207,2,0,1,737,3.25,92.87032615892285,5
2020-09-06-170207,170207,1,0,2,738,2.0,95.36774504081836,6
2020-09-07-170207,170207,7,0,20,745,2.0,97.20644694663157,0
2020-09-08-170207,170207,1,0,15,746,4.75,94.91348528880522,1
2020-09-09-170207,170207,3,0,12,749,3.5,96.81408871779306,2
2020-09-10-170207,170207,14,0,10,763,8.25,72.4396906616883,3
2020-09-11-170207,170207,10,0,15,773,7.25,78.18112954871238,4
2020-09-12-170207,170207,2,0,0,775,1.75,88.040008909462,5
2020-09-13-170207,170207,1,0,1,776,2.0,92.53771214082047,6
2020-09-14-170207,170207,9,1,3,785,4.75,100.80591064002589,0
2020-09-15-170207,170207,7,0,2,792,14.0,116.422517289835,1
2020-09-16-170207,170207,11,0,2,803,9.75,134.6153534330826,2
2020-09-17-170207,170207,9,0,10,812,13.0,125.01420616259742,3
2020-09-18-170207,170207,12,0,10,824,11.0,132.0269008847588,4
2020-09-19-170207,170207,1,0,0,825,2.5,136.54277283158103,5
2020-09-20-170207,170207,2,0,2,827,1.25,131.23187578645118,6
2020-09-21-170207,170207,20,0,4,847,12.0,112.19613194656925,0
2020-09-22-170207,170207,15,1,4,862,13.0,111.09152716492314,1
2020-09-23-170207,170207,12,0,12,874,10.75,110.58074405446634,2
2020-09-24-170207,170207,10,0,10,884,7.75,111.16773763709972,3
2020-09-25-170207,170207,15,0,11,899,10.75,100.7064284663798,4
2020-09-26-170207,170207,0,0,2,899,0.75,116.63565297235654,5
2020-09-27-170207,170207,1,0,5,900,0.5,103.59264866544335,6
2020-09-28-170207,170207,3,0,5,903,7.0,103.46951670743356,0
2020-09-29-170207,170207,2,0,14,905,3.75,107.99317301627781,1
2020-09-30-170207,170207,2,0,16,907,4.75,100.4941128903852,2
2020-10-01-170207,170207,10,0,12,917,5.75,0.0,3
2020-10-02-170207,170207,10,0,13,927,10.0,271.24940110404714,4
2020-10-03-170207,170207,0,0,9,927,2.5,409.1923681726037,5
2020-10-04-170207,170207,2,0,2,929,3.5,417.02512269602954,6
2020-10-05-170207,170207,4,0,25,933,6.5,342.53195575247656,0
2020-10-06-170207,170207,4,1,12,937,6.75,293.29660918727336,1
2020-10-07-170207,170207,12,0,19,949,8.75,241.7575480866176,2
2020-10-08-170207,170207,10,1,11,959,6.75,207.5261458706527,3
2020-10-09-170207,170207,11,0,17,970,17.75,223.404609504004,4
2020-10-10-170207,170207,2,0,6,972,2.5,16.81445830989344,5
2020-10-11-170207,170207,5,0,11,977,3.5,27.898743489436704,6
2020-10-12-170207,170207,5,0,14,982,5.5,43.834840679768405,0
2020-10-13-170207,170207,14,0,20,996,10.0,65.93930235804875,1
2020-10-14-170207,170207,16,0,12,1012,8.25,115.38085329998498,2
2020-10-15-170207,170207,12,0,17,1024,16.0,140.96303139772067,3
2020-10-16-170207,170207,13,0,19,1037,15.25,197.1855408954965,4
2020-10-17-170207,170207,9,0,5,1046,3.75,228.72610748263614,5
2020-10-18-170207,170207,2,0,6,1048,2.25,231.25463686697302,6
2020-10-19-170207,170207,25,0,21,1073,15.5,227.45843268488767,0
2020-10-20-170207,170207,12,0,23,1085,13.0,249.47987550154144,1
2020-10-21-170207,170207,19,0,27,1104,20.0,274.35411482636755,2
2020-10-22-170207,170207,11,0,24,1115,16.25,276.5775020816567,3
2020-10-23-170207,170207,17,0,30,1132,13.25,293.4736566925657,4
2020-10-24-170207,170207,6,0,14,1138,4.0,337.05358119578676,5
2020-10-25-170207,170207,11,0,10,1149,6.5,348.11644415657304,6
2020-10-26-170207,170207,14,0,30,1163,24.5,309.6737110557849,0
2020-10-27-170207,170207,20,3,17,1183,16.5,371.90576838346067,1
2020-10-28-170207,170207,12,0,13,1195,21.25,388.6671633416945,2
2020-10-29-170207,170207,17,1,30,1212,14.5,399.61348703393077,3
2020-10-30-170207,170207,19,2,22,1231,19.0,361.1754995880846,4
2020-10-31-170207,170207,5,1,0,1236,8.75,411.1038130842578,5
2020-11-01-170207,170207,6,1,0,1242,18.75,166.3811663737709,6
2020-11-02-170207,170207,21,1,0,1263,8.75,395.75205966087447,0
2020-11-03-170207,170207,23,2,0,1286,19.75,349.6176636037273,1
2020-11-04-170207,170207,27,1,0,1313,15.5,413.5599151888181,2
2020-11-05-170207,170207,24,2,0,1337,20.75,422.9622214551582,3
2020-11-06-170207,170207,30,1,0,1367,20.75,449.7664464226293,4
2020-11-07-170207,170207,14,1,0,1381,11.75,464.681553181343,5
2020-11-08-170207,170207,10,0,0,1391,14.0,445.12606448404296,6
2020-11-09-170207,170207,30,1,0,1421,23.75,445.9064823512489,0
2020-11-10-170207,170207,17,2,0,1438,18.5,187.21268020042703,1
2020-11-11-170207,170207,13,1,0,1451,17.25,237.9885682511945,2
2020-11-12-170207,170207,30,1,0,1481,18.25,282.5816919197388,3
2020-11-13-170207,170207,22,1,0,1503,23.25,327.9766337369231,4
2020-03-01-170208,170208,0,0,0,0,0.08333333333333333,0.0,6
2020-03-02-170208,170208,0,0,1,0,0.3333333333333333,148.89827472411494,0
2020-03-03-170208,170208,0,0,3,0,0.3333333333333333,605.3143038644495,1
2020-03-04-170208,170208,1,2,3,1,0.08333333333333333,651.2296124156532,2
2020-03-05-170208,170208,0,0,6,1,0.16666666666666666,716.7728151979125,3
2020-03-06-170208,170208,1,0,11,2,0.0,609.9323895308607,4
2020-03-07-170208,170208,0,0,1,2,0.08333333333333333,641.234061337037,5
2020-03-08-170208,170208,0,0,0,2,0.16666666666666666,603.2323248230666,6
2020-03-09-170208,170208,1,0,6,3,0.6666666666666666,598.809571049678,0
2020-03-10-170208,170208,0,0,7,3,1.5,3206.2181555578727,1
2020-03-11-170208,170208,0,0,7,3,1.0833333333333333,2699.4366616894195,2
2020-03-12-170208,170208,0,0,9,3,1.5,2149.346375119042,3
2020-03-13-170208,170208,0,1,5,3,2.25,1531.1378679620145,4
2020-03-14-170208,170208,2,0,2,5,2.25,1218.6383331133566,5
2020-03-15-170208,170208,0,0,0,5,2.9166666666666665,905.7878307590549,6
2020-03-16-170208,170208,1,0,2,6,7.25,288.9489308932995,0
2020-03-17-170208,170208,3,0,1,9,7.583333333333332,452.5425727222895,1
2020-03-18-170208,170208,3,0,3,12,11.666666666666664,571.2462862950036,2
2020-03-19-170208,170208,6,0,2,18,13.666666666666664,761.7538008850263,3
2020-03-20-170208,170208,11,1,3,29,12.25,888.7107371734605,4
2020-03-21-170208,170208,1,0,0,30,5.75,1028.3690515044918,5
2020-03-22-170208,170208,0,0,1,30,5.333333333333333,1017.893614589599,6
2020-03-23-170208,170208,6,0,7,36,16.833333333333332,965.8414022413259,0
2020-03-24-170208,170208,7,0,4,43,14.5,1085.8286166709984,1
2020-03-25-170208,170208,7,0,6,50,11.083333333333336,1101.4941463224586,2
2020-03-26-170208,170208,9,0,1,59,9.5,1050.984847179194,3
2020-03-27-170208,170208,5,0,1,64,11.75,1202.4504204499513,4
2020-03-28-170208,170208,2,0,1,66,4.25,1175.9749195452462,5
2020-03-29-170208,170208,0,0,0,66,4.0,1153.60429182501,6
2020-03-30-170208,170208,2,0,1,68,10.083333333333334,886.070908988796,0
2020-03-31-170208,170208,1,0,2,69,8.083333333333334,799.7406663383649,1
2020-04-01-170208,170208,3,0,2,72,6.666666666666668,129.61827979615924,2
2020-04-02-170208,170208,2,0,0,74,7.666666666666668,501.3029885812207,3
2020-04-03-170208,170208,3,0,1,77,7.416666666666668,256.96845549600243,4
2020-04-04-170208,170208,0,0,1,77,2.1666666666666665,345.10440407477563,5
2020-04-05-170208,170208,1,1,1,78,2.833333333333333,358.83933214966123,6
2020-04-06-170208,170208,7,0,1,85,7.083333333333332,381.74009433624786,0
2020-04-07-170208,170208,4,0,0,89,4.416666666666667,429.9488822678096,1
2020-04-08-170208,170208,6,0,0,95,5.666666666666668,462.70795243282544,2
2020-04-09-170208,170208,1,1,0,96,6.916666666666668,503.6979208800239,3
2020-04-10-170208,170208,1,0,2,97,9.0,103.56738551068824,4
2020-04-11-170208,170208,1,0,2,98,1.9166666666666667,170.6320387488129,5
2020-04-12-170208,170208,0,0,1,98,1.0,217.9709277330495,6
2020-04-13-170208,170208,1,0,3,99,7.25,234.23240693582017,0
2020-04-14-170208,170208,2,0,0,101,5.083333333333333,329.45100044015396,1
2020-04-15-170208,170208,2,0,0,103,6.833333333333332,408.46876978914236,2
2020-04-16-170208,170208,0,0,2,103,5.166666666666667,525.6579468479156,3
2020-04-17-170208,170208,1,0,0,104,4.416666666666667,550.558736254191,4
2020-04-18-170208,170208,1,0,0,105,1.0833333333333333,590.0349494166901,5
2020-04-19-170208,170208,1,0,0,106,1.8333333333333333,559.2557969008399,6
2020-04-20-170208,170208,1,1,3,107,4.583333333333333,577.6842561684301,0
2020-04-21-170208,170208,0,0,1,107,3.8333333333333335,580.8752575763526,1
2020-04-22-170208,170208,0,0,1,107,3.8333333333333335,519.493195962489,2
2020-04-23-170208,170208,0,0,1,107,1.0833333333333333,514.3662531635258,3
2020-04-24-170208,170208,2,0,4,109,2.833333333333333,407.05823883767914,4
2020-04-25-170208,170208,2,0,0,111,0.9166666666666666,437.9234215513585,5
2020-04-26-170208,170208,1,0,0,112,1.1666666666666667,423.4185743268496,6
2020-04-27-170208,170208,3,0,2,115,3.8333333333333335,335.06550704069025,0
2020-04-28-170208,170208,0,0,1,115,3.083333333333333,333.6375602377051,1
2020-04-29-170208,170208,0,0,4,115,3.083333333333333,326.263055681957,2
2020-04-30-170208,170208,2,0,5,117,2.4166666666666665,414.9508931383833,3
2020-05-01-170208,170208,0,0,2,117,0.5,595.0208467687394,4
2020-05-02-170208,170208,0,0,0,117,0.5,432.5826498727216,5
2020-05-03-170208,170208,0,0,0,117,0.5833333333333334,204.33925139794874,6
2020-05-04-170208,170208,3,0,1,120,2.0,159.74449259614758,0
2020-05-05-170208,170208,1,0,1,121,2.6666666666666665,165.7703066083759,1
2020-05-06-170208,170208,1,0,2,122,2.5,185.81462595733234,2
2020-05-07-170208,170208,1,0,1,123,2.4166666666666665,198.53235981865993,3
2020-05-08-170208,170208,4,0,0,127,2.6666666666666665,214.15275353193763,4
2020-05-09-170208,170208,0,0,0,127,0.25,293.3125503090567,5
2020-05-10-170208,170208,0,0,0,127,0.4166666666666667,632.2011714412324,6
2020-05-11-170208,170208,2,1,2,129,3.1666666666666665,579.5567177583754,0
2020-05-12-170208,170208,1,0,1,130,2.75,596.4978348202227,1
2020-05-13-170208,170208,4,0,2,134,5.0,484.35721966587545,2
2020-05-14-170208,170208,5,0,3,139,4.666666666666667,502.4003663701943,3
2020-05-15-170208,170208,2,0,0,141,4.666666666666667,506.68282763439316,4
2020-05-16-170208,170208,0,0,0,141,0.8333333333333334,488.9249757750397,5
2020-05-17-170208,170208,0,0,0,141,0.08333333333333333,488.74301749745143,6
2020-05-18-170208,170208,1,0,0,142,4.666666666666667,490.3300587143435,0
2020-05-19-170208,170208,1,0,0,143,3.083333333333333,518.4176019997486,1
2020-05-20-170208,170208,2,0,1,145,2.25,435.24276145232466,2
2020-05-21-170208,170208,1,0,0,146,3.4166666666666665,383.09851458148694,3
2020-05-22-170208,170208,0,0,0,146,2.6666666666666665,361.32665939609,4
2020-05-23-170208,170208,0,0,0,146,0.08333333333333333,424.393616395647,5
2020-05-24-170208,170208,0,0,0,146,0.08333333333333333,430.65401257555715,6
2020-05-25-170208,170208,2,0,1,148,3.1666666666666665,326.0930785196453,0
2020-05-26-170208,170208,1,0,0,149,1.5833333333333333,330.43682747627736,1
2020-05-27-170208,170208,2,0,0,151,1.5833333333333333,380.53826947030007,2
2020-05-28-170208,170208,3,2,1,154,1.4166666666666667,357.46677764829224,3
2020-05-29-170208,170208,0,0,0,154,1.75,330.39687585277863,4
2020-05-30-170208,170208,0,0,0,154,0.0,319.2907677324923,5
2020-05-31-170208,170208,0,0,0,154,0.0,327.20730826422425,6
2020-06-01-170208,170208,0,0,0,154,1.0833333333333333,385.96608808383326,0
2020-06-02-170208,170208,0,0,0,154,1.0833333333333333,106.95866422609865,1
2020-06-03-170208,170208,1,0,1,155,1.25,86.48063670371792,2
2020-06-04-170208,170208,0,0,0,155,1.1666666666666667,88.8079223114578,3
2020-06-05-170208,170208,0,0,0,155,1.25,110.69724383616328,4
2020-06-06-170208,170208,0,0,0,155,0.5833333333333334,123.26769389949004,5
2020-06-07-170208,170208,0,0,0,155,0.0,124.6731376893223,6
2020-06-08-170208,170208,1,0,0,156,1.0,125.70627525190338,0
2020-06-09-170208,170208,0,0,1,156,0.8333333333333334,156.71505974044305,1
2020-06-10-170208,170208,0,0,0,156,1.1666666666666667,417.17659918406736,2
2020-06-11-170208,170208,1,0,0,157,1.25,383.0751162006802,3
2020-06-12-170208,170208,0,0,1,157,1.0833333333333333,349.9427637498144,4
2020-06-13-170208,170208,0,0,1,157,0.0,285.5779930765916,5
2020-06-14-170208,170208,0,0,0,157,0.25,225.70254821220712,6
2020-06-15-170208,170208,0,0,0,157,1.0,130.5477165797422,0
2020-06-16-170208,170208,0,0,1,157,0.6666666666666666,161.23577168443495,1
2020-06-17-170208,170208,1,0,0,158,1.0,150.29116241531642,2
2020-06-18-170208,170208,0,0,0,158,0.8333333333333334,143.68955002069993,3
2020-06-19-170208,170208,0,0,1,158,0.16666666666666666,125.01077871483035,4
2020-06-20-170208,170208,0,0,0,158,0.0,148.4419045379778,5
2020-06-21-170208,170208,0,0,0,158,0.25,148.64902477060699,6
2020-06-22-170208,170208,0,0,0,158,0.8333333333333334,120.96556103748458,0
2020-06-23-170208,170208,1,0,0,159,0.4166666666666667,117.30642012478178,1
2020-06-24-170208,170208,0,0,0,159,1.0,108.37575989553616,2
2020-06-25-170208,170208,0,1,1,159,0.8333333333333334,113.71447878286084,3
2020-06-26-170208,170208,1,0,0,160,0.75,122.23939304731745,4
2020-06-27-170208,170208,1,0,0,161,0.16666666666666666,109.45056044608913,5
2020-06-28-170208,170208,0,0,0,161,0.08333333333333333,119.15751888469092,6
2020-06-29-170208,170208,0,0,0,161,0.0,115.06536167747772,0
2020-06-30-170208,170208,1,0,0,162,0.5,102.9011306009107,1
2020-07-01-170208,170208,0,0,1,162,0.75,169.08444029738504,2
2020-07-02-170208,170208,0,0,0,162,0.08333333333333333,138.47444848414466,3
2020-07-03-170208,170208,1,0,0,163,0.4166666666666667,154.4672818000559,4
2020-07-04-170208,170208,0,0,1,163,0.0,212.5280094881153,5
2020-07-05-170208,170208,0,0,0,163,0.0,205.96852420095635,6
2020-07-06-170208,170208,0,0,0,163,0.25,173.27883862614146,0
2020-07-07-170208,170208,0,0,0,163,0.5833333333333334,166.79424673535937,1
2020-07-08-170208,170208,0,0,0,163,0.5,145.01687443205253,2
2020-07-09-170208,170208,1,0,1,164,0.6666666666666666,136.40067717073242,3
2020-07-10-170208,170208,0,0,0,164,0.25,174.2585843762962,4
2020-07-11-170208,170208,0,0,0,164,0.08333333333333333,146.0859185700889,5
2020-07-12-170208,170208,0,0,0,164,0.25,109.81314551871631,6
2020-07-13-170208,170208,0,0,1,164,0.75,105.46593779259888,0
2020-07-14-170208,170208,0,0,0,164,0.5,125.70098998347513,1
2020-07-15-170208,170208,1,0,1,165,1.5833333333333333,104.84123882940594,2
2020-07-16-170208,170208,0,0,3,165,0.4166666666666667,105.14850176777091,3
2020-07-17-170208,170208,0,0,1,165,0.8333333333333334,97.43363948661214,4
2020-07-18-170208,170208,1,0,0,166,0.5833333333333334,121.61540501754416,5
2020-07-19-170208,170208,0,0,1,166,0.25,143.2604402321571,6
2020-07-20-170208,170208,0,0,0,166,0.8333333333333334,124.83304168628764,0
2020-07-21-170208,170208,0,0,2,166,0.9166666666666666,137.40605895296758,1
2020-07-22-170208,170208,0,0,2,166,0.6666666666666666,129.1519582403106,2
2020-07-23-170208,170208,1,0,0,167,0.4166666666666667,144.3860742251707,3
2020-07-24-170208,170208,0,0,3,167,0.5,138.09921554358232,4
2020-07-25-170208,170208,0,0,2,167,0.3333333333333333,132.24559221583928,5
2020-07-26-170208,170208,0,0,0,167,0.3333333333333333,129.7368259380279,6
2020-07-27-170208,170208,1,0,7,168,1.3333333333333333,136.16538236210548,0
2020-07-28-170208,170208,0,0,1,168,0.6666666666666666,147.2514054887314,1
2020-07-29-170208,170208,1,0,5,169,1.25,142.9578329301057,2
2020-07-30-170208,170208,3,0,2,172,2.333333333333333,153.41446833398322,3
2020-07-31-170208,170208,1,0,0,173,1.75,200.683144314301,4
2020-08-01-170208,170208,0,0,0,173,0.4166666666666667,88.40180155838526,5
2020-08-02-170208,170208,1,0,2,174,0.3333333333333333,553.189485497445,6
2020-08-03-170208,170208,0,0,1,174,1.4166666666666667,569.1691894863901,0
2020-08-04-170208,170208,2,0,3,176,2.4166666666666665,540.4217603595426,1
2020-08-05-170208,170208,2,0,4,178,3.333333333333333,544.6539226026853,2
2020-08-06-170208,170208,0,0,3,178,2.1666666666666665,570.0657042816656,3
2020-08-07-170208,170208,3,0,3,181,2.1666666666666665,532.9018593656996,4
2020-08-08-170208,170208,2,0,2,183,1.5833333333333333,566.0271170806895,5
2020-08-09-170208,170208,0,0,1,183,0.6666666666666666,569.0821145558036,6
2020-08-10-170208,170208,7,0,6,190,1.6666666666666667,64.32828518616155,0
2020-08-11-170208,170208,1,0,3,191,3.25,150.79896995718138,1
2020-08-12-170208,170208,5,0,4,196,3.75,233.0796298816764,2
2020-08-13-170208,170208,2,0,6,198,3.333333333333333,312.15389075269354,3
2020-08-14-170208,170208,0,0,5,198,2.083333333333333,386.2950338674062,4
2020-08-15-170208,170208,0,0,1,198,1.3333333333333333,437.0042191083492,5
2020-08-16-170208,170208,2,0,1,200,1.6666666666666667,450.32835884683834,6
2020-08-17-170208,170208,1,0,0,201,2.1666666666666665,496.5328617859392,0
2020-08-18-170208,170208,3,0,11,204,4.333333333333333,473.89817809516893,1
2020-08-19-170208,170208,4,0,1,208,2.083333333333333,515.4778018369082,2
2020-08-20-170208,170208,3,0,0,211,1.8333333333333333,449.55435956782,3
2020-08-21-170208,170208,3,0,1,214,2.833333333333333,464.811697952557,4
2020-08-22-170208,170208,2,0,1,216,2.4166666666666665,529.8267507644131,5
2020-08-23-170208,170208,1,0,0,217,1.0833333333333333,551.9346546389979,6
2020-08-24-170208,170208,6,0,0,223,4.416666666666667,523.3891074185086,0
2020-08-25-170208,170208,3,0,1,226,3.75,524.5269732761035,1
2020-08-26-170208,170208,4,0,1,230,3.4166666666666665,539.7753100155178,2
2020-08-27-170208,170208,6,0,1,236,2.833333333333333,585.8683366033573,3
2020-08-28-170208,170208,5,0,1,241,2.25,578.9894903240972,4
2020-08-29-170208,170208,1,0,2,242,0.9166666666666666,570.8843493668655,5
2020-08-30-170208,170208,1,0,0,243,1.5,543.6231643656349,6
2020-08-31-170208,170208,0,0,3,243,3.6666666666666665,471.51576262381644,0
2020-09-01-170208,170208,11,0,10,254,3.083333333333333,508.3561998603413,1
2020-09-02-170208,170208,1,0,9,255,4.666666666666667,857.2693336676336,2
2020-09-03-170208,170208,0,0,12,255,4.0,718.3673651008291,3
2020-09-04-170208,170208,1,0,7,256,4.333333333333333,716.4797169355033,4
2020-09-05-170208,170208,1,0,1,257,2.4166666666666665,684.7973229984501,5
2020-09-06-170208,170208,0,0,1,257,1.5,693.0772403766712,6
2020-09-07-170208,170208,0,0,5,257,3.9166666666666665,709.5291658606193,0
2020-09-08-170208,170208,1,0,7,258,4.916666666666667,682.6839101038902,1
2020-09-09-170208,170208,1,0,5,259,3.75,699.3897455471968,2
2020-09-10-170208,170208,1,0,3,260,7.333333333333332,603.8566759858834,3
2020-09-11-170208,170208,1,0,5,261,5.333333333333333,620.2806140179691,4
2020-09-12-170208,170208,2,0,3,263,2.1666666666666665,687.3176476059373,5
2020-09-13-170208,170208,0,0,0,263,2.333333333333333,733.273798360832,6
2020-09-14-170208,170208,3,0,3,266,4.666666666666667,774.2923118558081,0
2020-09-15-170208,170208,10,0,7,276,9.583333333333334,874.3498446630953,1
2020-09-16-170208,170208,9,0,5,285,6.666666666666668,1017.0699203842418,2
2020-09-17-170208,170208,12,0,3,297,7.583333333333332,926.541164985166,3
2020-09-18-170208,170208,7,0,4,304,7.583333333333332,972.3196857832011,4
2020-09-19-170208,170208,1,0,2,305,1.25,998.7544678542031,5
2020-09-20-170208,170208,1,0,2,306,1.25,944.6527023916663,6
2020-09-21-170208,170208,5,0,5,311,8.916666666666666,811.0407121132309,0
2020-09-22-170208,170208,7,0,6,318,7.916666666666668,789.5270157236939,1
2020-09-23-170208,170208,5,0,9,323,8.25,788.8211476274782,2
2020-09-24-170208,170208,3,1,4,326,5.25,786.9188190088553,3
2020-09-25-170208,170208,5,0,5,331,6.916666666666668,702.4924543202034,4
2020-09-26-170208,170208,3,0,1,334,0.75,809.46405283685,5
2020-09-27-170208,170208,0,0,1,334,0.5833333333333334,727.5075087105215,6
2020-09-28-170208,170208,3,0,3,337,4.5,724.4838692848294,0
2020-09-29-170208,170208,7,0,2,344,2.833333333333333,755.6295472327786,1
2020-09-30-170208,170208,5,0,4,349,4.0,709.899498462052,2
2020-10-01-170208,170208,3,0,10,352,5.25,0.0,3
2020-10-02-170208,170208,4,0,9,356,7.416666666666668,1962.9255080169457,4
2020-10-03-170208,170208,2,0,5,358,1.5,2823.1320910369923,5
2020-10-04-170208,170208,2,0,1,360,1.9166666666666667,2860.2293267326777,6
2020-10-05-170208,170208,5,0,9,365,3.9166666666666665,2347.399802990735,0
2020-10-06-170208,170208,6,0,8,371,4.916666666666667,2025.3356696997869,1
2020-10-07-170208,170208,9,0,11,380,6.333333333333332,1690.4221186859359,2
2020-10-08-170208,170208,4,0,14,384,5.583333333333332,1483.1965063241419,3
2020-10-09-170208,170208,5,2,10,389,10.25,1586.3418437424568,4
2020-10-10-170208,170208,1,0,3,390,2.1666666666666665,117.91891729171184,5
2020-10-11-170208,170208,1,0,4,391,3.083333333333333,197.1821125752922,6
2020-10-12-170208,170208,3,0,10,394,4.75,311.7080832945988,0
2020-10-13-170208,170208,2,0,10,396,9.416666666666666,467.65401323948424,1
2020-10-14-170208,170208,4,0,11,400,6.0,799.6215373393013,2
2020-10-15-170208,170208,10,0,7,410,10.333333333333334,985.0862766832615,3
2020-10-16-170208,170208,9,0,8,419,9.75,1398.035958670656,4
2020-10-17-170208,170208,5,0,2,424,2.25,1654.4797902948708,5
2020-10-18-170208,170208,1,0,2,425,2.0,1683.0723862019552,6
2020-10-19-170208,170208,9,0,9,434,12.833333333333336,1664.0311360458227,0
2020-10-20-170208,170208,8,0,6,442,8.916666666666666,1824.4493712149451,1
2020-10-21-170208,170208,11,0,5,453,14.416666666666664,2005.5452300791972,2
2020-10-22-170208,170208,14,0,8,467,13.083333333333336,1993.9907277918371,3
2020-10-23-170208,170208,10,0,7,477,10.0,2067.295560536954,4
2020-10-24-170208,170208,3,0,10,480,5.583333333333332,2335.096613255384,5
2020-10-25-170208,170208,4,0,5,484,6.333333333333332,2407.703302378613,6
2020-10-26-170208,170208,10,0,18,494,15.416666666666664,2129.5506987034287,0
2020-10-27-170208,170208,10,0,10,504,12.333333333333336,2546.6613410962036,1
2020-10-28-170208,170208,11,1,6,515,15.333333333333336,2635.667723274184,2
2020-10-29-170208,170208,7,0,11,522,12.916666666666664,2721.289675480709,3
2020-10-30-170208,170208,8,0,14,530,15.333333333333336,2454.502034678308,4
2020-10-31-170208,170208,2,0,0,532,8.083333333333334,2809.9852124095983,5
2020-11-01-170208,170208,2,0,0,534,11.416666666666664,1190.995388569221,6
2020-11-02-170208,170208,9,0,0,543,8.333333333333334,2776.411616079452,0
2020-11-03-170208,170208,6,0,0,549,15.25,2457.963505767895,1
2020-11-04-170208,170208,5,0,0,554,12.916666666666664,2866.6582037138264,2
2020-11-05-170208,170208,8,1,0,562,14.0,2921.226312791089,3
2020-11-06-170208,170208,7,1,0,569,18.5,3062.179207471916,4
2020-11-07-170208,170208,10,0,0,579,8.333333333333334,3121.9960449231753,5
2020-11-08-170208,170208,5,0,0,584,9.833333333333334,2984.8273148852595,6
2020-11-09-170208,170208,18,0,0,602,18.0,2982.5402294592513,0
2020-11-10-170208,170208,10,1,0,612,13.75,1294.6511193956933,1
2020-11-11-170208,170208,6,1,0,618,12.5,1649.9970479113626,2
2020-11-12-170208,170208,11,1,0,629,15.916666666666664,1939.9375202824772,3
2020-11-13-170208,170208,14,0,0,643,18.58333333333333,2252.909554349655,4
2020-03-01-170209,170209,0,0,3,0,0.0,0.0,6
2020-03-02-170209,170209,0,0,3,0,0.0,134.73213590290064,0
2020-03-03-170209,170209,0,0,7,0,0.1,529.3702194697692,1
2020-03-04-170209,170209,0,0,6,0,0.2,525.9119124009972,2
2020-03-05-170209,170209,0,0,12,0,0.1,599.3242548277938,3
2020-03-06-170209,170209,0,1,11,0,0.2,484.3938844015072,4
2020-03-07-170209,170209,0,0,4,0,0.1,525.436446697552,5
2020-03-08-170209,170209,0,0,7,0,0.0,503.45515570472617,6
2020-03-09-170209,170209,2,0,16,2,0.2,498.5023607632794,0
2020-03-10-170209,170209,1,0,11,3,1.1,2359.3178510821754,1
2020-03-11-170209,170209,1,1,11,4,0.9,2078.580587210833,2
2020-03-12-170209,170209,0,0,4,4,0.9,1681.4142988096942,3
2020-03-13-170209,170209,4,0,14,8,2.0,1253.542473023815,4
2020-03-14-170209,170209,5,0,2,13,0.7,1034.978824999391,5
2020-03-15-170209,170209,3,0,5,16,1.5,712.7892023112995,6
2020-03-16-170209,170209,3,0,18,19,4.3,253.33438551839976,0
2020-03-17-170209,170209,7,0,8,26,6.3,368.08871981893867,1
2020-03-18-170209,170209,6,0,9,32,10.3,481.3510265448341,2
2020-03-19-170209,170209,12,2,11,44,8.5,623.7570565536234,3
2020-03-20-170209,170209,11,3,9,55,9.5,685.0389351470739,4
2020-03-21-170209,170209,4,0,0,59,4.6,833.2157944248964,5
2020-03-22-170209,170209,7,1,2,66,4.9,831.7318936104089,6
2020-03-23-170209,170209,16,0,2,82,13.6,783.7084908839306,0
2020-03-24-170209,170209,11,0,7,93,11.1,849.0461028946127,1
2020-03-25-170209,170209,11,0,9,104,8.9,820.8678749816688,2
2020-03-26-170209,170209,4,0,32,108,9.3,763.335766503983,3
2020-03-27-170209,170209,14,0,11,122,10.5,873.5329786213521,4
2020-03-28-170209,170209,2,0,3,124,3.4,829.2590233530725,5
2020-03-29-170209,170209,5,0,2,129,3.2,808.0754277486617,6
2020-03-30-170209,170209,18,0,10,147,8.3,606.7531487838531,0
2020-03-31-170209,170209,8,0,4,155,5.8,585.0918655947752,1
2020-04-01-170209,170209,9,0,15,164,5.4,95.45375595937332,2
2020-04-02-170209,170209,11,0,8,175,5.9,407.1851350212499,3
2020-04-03-170209,170209,9,0,3,184,6.6,175.3985207159103,4
2020-04-04-170209,170209,0,0,0,184,3.7,248.61189862273812,5
2020-04-05-170209,170209,2,0,8,186,2.0,262.9400548355858,6
2020-04-06-170209,170209,2,0,8,188,5.0,276.04463137644507,0
2020-04-07-170209,170209,7,0,6,195,3.9,316.7429708721605,1
2020-04-08-170209,170209,9,6,3,204,4.5,355.0003153129752,2
2020-04-09-170209,170209,32,0,0,236,3.0,388.3814808239056,3
2020-04-10-170209,170209,11,0,3,247,4.0,96.77452546398922,4
2020-04-11-170209,170209,3,0,0,250,5.4,154.53828732499738,5
2020-04-12-170209,170209,2,0,1,252,2.6,195.08199491495157,6
2020-04-13-170209,170209,10,0,6,262,5.2,230.2939572202115,0
2020-04-14-170209,170209,4,0,3,266,5.0,289.8068033190295,1
2020-04-15-170209,170209,15,0,6,281,6.9,374.2487312341473,2
2020-04-16-170209,170209,8,0,0,289,3.8,477.6913768774184,3
2020-04-17-170209,170209,3,0,0,292,8.6,490.5321671763264,4
2020-04-18-170209,170209,0,0,0,292,1.1,540.8756214994864,5
2020-04-19-170209,170209,8,0,0,300,2.7,498.45998914169877,6
2020-04-20-170209,170209,8,0,1,308,4.9,530.7456346212261,0
2020-04-21-170209,170209,6,0,3,314,4.1,588.0344231348232,1
2020-04-22-170209,170209,3,0,0,317,5.7,490.2786449672058,2
2020-04-23-170209,170209,0,0,1,317,1.8,465.201410850252,3
2020-04-24-170209,170209,3,0,5,320,2.8,384.54061609962093,4
2020-04-25-170209,170209,0,0,0,320,1.3,392.5854289723894,5
2020-04-26-170209,170209,1,0,1,321,0.9,356.22004619666046,6
2020-04-27-170209,170209,6,0,0,327,3.2,256.964247219772,0
2020-04-28-170209,170209,3,0,3,330,2.9,214.18764061032329,1
2020-04-29-170209,170209,6,0,4,336,3.0,209.52999026143468,2
2020-04-30-170209,170209,0,0,5,336,3.0,313.01628669312413,3
2020-05-01-170209,170209,0,0,3,336,0.7,531.6727010315503,4
2020-05-02-170209,170209,0,0,0,336,1.1,326.2840073472022,5
2020-05-03-170209,170209,0,0,0,336,0.8,153.3865124524873,6
2020-05-04-170209,170209,1,0,5,337,2.7,121.55315347904009,0
2020-05-05-170209,170209,3,0,4,340,2.8,127.63351532694807,1
2020-05-06-170209,170209,0,0,1,340,3.3,139.9961526872921,2
2020-05-07-170209,170209,1,0,2,341,2.2,139.04133506565375,3
2020-05-08-170209,170209,5,0,3,346,2.8,136.7105094488066,4
2020-05-09-170209,170209,0,0,0,346,0.1,185.44909257268054,5
2020-05-10-170209,170209,1,1,0,347,0.2,519.0043746466812,6
2020-05-11-170209,170209,0,0,2,347,3.8,489.3098881439281,0
2020-05-12-170209,170209,3,0,1,350,2.3,500.5840286471491,1
2020-05-13-170209,170209,4,0,1,354,4.5,452.6812266318158,2
2020-05-14-170209,170209,5,0,1,359,4.8,445.5560325685774,3
2020-05-15-170209,170209,3,0,1,362,3.4,436.7069578532736,4
2020-05-16-170209,170209,0,0,0,362,0.4,319.9676079611316,5
2020-05-17-170209,170209,0,0,0,362,0.3,305.20786616685115,6
2020-05-18-170209,170209,5,0,0,367,3.8,303.20107424367234,0
2020-05-19-170209,170209,4,0,3,371,2.9,307.2470568729135,1
2020-05-20-170209,170209,1,0,0,372,3.4,258.7710401507661,2
2020-05-21-170209,170209,2,0,2,374,2.3,246.31668491214626,3
2020-05-22-170209,170209,3,0,1,377,2.1,228.52803340035618,4
2020-05-23-170209,170209,0,0,0,377,0.3,284.14927727553635,5
2020-05-24-170209,170209,0,0,0,377,0.0,287.4334933808402,6
2020-05-25-170209,170209,2,0,0,379,2.5,212.8780550641365,0
2020-05-26-170209,170209,1,0,1,380,2.8,206.3884855786672,1
2020-05-27-170209,170209,1,0,0,381,2.1,240.98481667410823,2
2020-05-28-170209,170209,1,1,1,382,1.6,227.21136386621498,3
2020-05-29-170209,170209,1,1,2,383,1.9,214.47778508872085,4
2020-05-30-170209,170209,0,0,0,383,0.0,216.94534425551825,5
2020-05-31-170209,170209,0,0,1,383,0.0,227.2875349136942,6
2020-06-01-170209,170209,0,0,0,383,1.7,272.06545583900083,0
2020-06-02-170209,170209,3,0,1,386,1.4,88.28406553015782,1
2020-06-03-170209,170209,0,0,1,386,1.3,83.76054938146609,2
2020-06-04-170209,170209,2,0,2,388,1.2,70.49856865477415,3
2020-06-05-170209,170209,1,0,0,389,1.1,82.9560324871398,4
2020-06-06-170209,170209,0,1,0,389,0.7,91.77011209226201,5
2020-06-07-170209,170209,0,0,0,389,0.2,91.00326828259333,6
2020-06-08-170209,170209,0,1,1,389,1.0,91.6483744221145,0
2020-06-09-170209,170209,1,0,1,390,0.9,112.44273851151621,1
2020-06-10-170209,170209,0,0,3,390,1.4,287.89273801182657,2
2020-06-11-170209,170209,1,0,1,391,0.7,264.50096303347124,3
2020-06-12-170209,170209,2,0,1,393,0.3,234.99982179367203,4
2020-06-13-170209,170209,0,0,1,393,0.2,197.20222677902547,5
2020-06-14-170209,170209,1,0,0,394,0.0,159.48233739286377,6
2020-06-15-170209,170209,0,0,0,394,1.1,91.47639999225731,0
2020-06-16-170209,170209,1,0,1,395,1.0,108.04765950752598,1
2020-06-17-170209,170209,1,0,1,396,0.7,107.21424507758752,2
2020-06-18-170209,170209,2,0,0,398,0.7,105.59526025664272,3
2020-06-19-170209,170209,0,0,0,398,0.2,103.60080333607453,4
2020-06-20-170209,170209,0,0,0,398,0.2,124.3280943044524,5
2020-06-21-170209,170209,0,0,0,398,0.2,127.35492211048711,6
2020-06-22-170209,170209,1,0,0,399,0.4,112.54926848681862,0
2020-06-23-170209,170209,1,0,2,400,0.6,106.865505705401,1
2020-06-24-170209,170209,3,0,0,403,0.6,106.15450588006999,2
2020-06-25-170209,170209,1,1,0,404,0.3,112.09428287018156,3
2020-06-26-170209,170209,1,0,0,405,0.6,121.22408055924636,4
2020-06-27-170209,170209,1,0,0,406,0.1,100.27809341099693,5
2020-06-28-170209,170209,0,0,1,406,0.0,106.84597042123248,6
2020-06-29-170209,170209,0,0,0,406,0.1,103.08773664883907,0
2020-06-30-170209,170209,1,0,1,407,0.3,87.12529147899501,1
2020-07-01-170209,170209,1,0,0,408,0.5,122.98361554079881,2
2020-07-02-170209,170209,0,0,0,408,0.0,91.91799461418913,3
2020-07-03-170209,170209,0,0,1,408,0.6,119.3023740233719,4
2020-07-04-170209,170209,0,0,0,408,0.1,180.3715056800624,5
2020-07-05-170209,170209,0,0,0,408,0.0,177.8442983829105,6
2020-07-06-170209,170209,0,0,0,408,0.4,144.98210212814246,0
2020-07-07-170209,170209,2,0,0,410,0.4,138.38292269380247,1
2020-07-08-170209,170209,0,0,0,410,0.3,126.94517212290368,2
2020-07-09-170209,170209,0,0,0,410,0.6,121.25479886623503,3
2020-07-10-170209,170209,0,0,0,410,0.2,125.46729391118866,4
2020-07-11-170209,170209,0,0,0,410,0.1,104.63727189052247,5
2020-07-12-170209,170209,1,0,0,411,0.4,77.45315755576681,6
2020-07-13-170209,170209,0,1,3,411,0.4,77.71011345578744,0
2020-07-14-170209,170209,1,0,1,412,0.7,90.00176396969655,1
2020-07-15-170209,170209,0,0,3,412,0.9,79.89895285094512,2
2020-07-16-170209,170209,0,0,3,412,0.8,73.00230479211149,3
2020-07-17-170209,170209,1,0,5,413,1.0,70.4653784301967,4
2020-07-18-170209,170209,0,0,3,413,0.3,89.56033659660127,5
2020-07-19-170209,170209,0,0,2,413,0.4,100.29146725630545,6
2020-07-20-170209,170209,0,0,3,413,0.7,85.15310463729006,0
2020-07-21-170209,170209,0,0,14,413,0.2,90.29152973568722,1
2020-07-22-170209,170209,0,0,9,413,0.5,83.71548991215204,2
2020-07-23-170209,170209,0,0,3,413,0.7,91.02801498987947,3
2020-07-24-170209,170209,0,1,1,413,0.6,83.98526250077599,4
2020-07-25-170209,170209,0,0,5,413,0.2,83.02861529296156,5
2020-07-26-170209,170209,0,0,0,413,0.4,81.96402639340508,6
2020-07-27-170209,170209,3,0,2,416,1.3,84.50804351956123,0
2020-07-28-170209,170209,1,0,6,417,0.6,102.14944885054014,1
2020-07-29-170209,170209,3,0,10,420,1.2,106.27143496950029,2
2020-07-30-170209,170209,3,0,4,423,1.7,118.34609870458591,3
2020-07-31-170209,170209,5,0,5,428,1.6,159.50971844059006,4
2020-08-01-170209,170209,3,0,3,431,0.4,83.7034605001776,5
2020-08-02-170209,170209,2,0,7,433,0.3,553.1698666493605,6
2020-08-03-170209,170209,3,0,5,436,1.8,445.59406109745396,0
2020-08-04-170209,170209,14,0,13,450,0.5,377.44466092830805,1
2020-08-05-170209,170209,9,0,2,459,1.5,427.4756491492073,2
2020-08-06-170209,170209,3,0,3,462,1.4,465.24756392516053,3
2020-08-07-170209,170209,1,0,10,463,1.1,443.42933801034957,4
2020-08-08-170209,170209,5,0,5,468,1.4,451.49478554773356,5
2020-08-09-170209,170209,0,0,1,468,0.6,462.1143835883016,6
2020-08-10-170209,170209,2,0,10,470,2.4,61.60872212070461,0
2020-08-11-170209,170209,6,0,6,476,2.3,121.88837324075706,1
2020-08-12-170209,170209,10,0,5,486,3.2,205.0792179604524,2
2020-08-13-170209,170209,4,0,4,490,3.4,288.75008044465415,3
2020-08-14-170209,170209,5,0,3,495,2.6,362.16225710325295,4
2020-08-15-170209,170209,3,0,2,498,1.3,424.99312690112515,5
2020-08-16-170209,170209,7,0,0,505,1.6,453.4252377775681,6
2020-08-17-170209,170209,5,0,3,510,1.8,513.9760843188578,0
2020-08-18-170209,170209,13,0,8,523,3.9,518.4029936503754,1
2020-08-19-170209,170209,2,0,6,525,3.0,569.9208382759862,2
2020-08-20-170209,170209,3,0,4,528,2.3,507.27621905437206,3
2020-08-21-170209,170209,10,0,4,538,2.7,493.4482000903697,4
2020-08-22-170209,170209,5,0,2,543,2.4,556.703628399235,5
2020-08-23-170209,170209,1,0,1,544,1.7,559.6554224808644,6
2020-08-24-170209,170209,10,0,5,554,5.2,528.2048238510943,0
2020-08-25-170209,170209,6,1,15,560,4.0,502.308041695081,1
2020-08-26-170209,170209,5,0,2,565,2.6,522.5419232648287,2
2020-08-27-170209,170209,4,1,9,569,3.5,511.6327540921686,3
2020-08-28-170209,170209,3,0,4,572,2.2,501.38037317793555,4
2020-08-29-170209,170209,2,0,5,574,0.6,465.18517679408467,5
2020-08-30-170209,170209,0,0,3,574,1.7,432.8093571077659,6
2020-08-31-170209,170209,3,0,4,577,2.9,355.34282847435543,0
2020-09-01-170209,170209,8,0,21,585,3.7,432.9680048420929,1
2020-09-02-170209,170209,6,0,9,591,3.3,674.8661997755808,2
2020-09-03-170209,170209,4,1,6,595,5.7,544.7937856328225,3
2020-09-04-170209,170209,4,0,3,599,4.1,524.5965545407457,4
2020-09-05-170209,170209,2,0,3,601,2.4,484.27282257424366,5
2020-09-06-170209,170209,1,0,6,602,0.9,494.55822301743336,6
2020-09-07-170209,170209,5,0,9,607,3.9,494.8013792672296,0
2020-09-08-170209,170209,15,1,6,622,4.0,494.35884104148124,1
2020-09-09-170209,170209,2,0,13,624,4.2,551.4668054059864,2
2020-09-10-170209,170209,9,0,4,633,5.0,512.2417459978412,3
2020-09-11-170209,170209,4,0,9,637,3.8,501.40457583342516,4
2020-09-12-170209,170209,5,0,0,642,2.4,530.0684617550505,5
2020-09-13-170209,170209,3,0,2,645,2.1,556.8050121260699,6
2020-09-14-170209,170209,4,0,2,649,4.8,605.3836302789848,0
2020-09-15-170209,170209,21,1,3,670,6.6,653.7741350310566,1
2020-09-16-170209,170209,9,0,2,679,4.9,826.8800391776197,2
2020-09-17-170209,170209,6,0,6,685,7.6,760.2543021858688,3
2020-09-18-170209,170209,3,0,6,688,7.4,758.173218817228,4
2020-09-19-170209,170209,3,1,2,691,1.0,767.9941500561854,5
2020-09-20-170209,170209,6,0,4,697,1.3,710.5332217200089,6
2020-09-21-170209,170209,9,1,9,706,6.8,632.7069923840404,0
2020-09-22-170209,170209,6,0,9,712,6.2,559.2910980610031,1
2020-09-23-170209,170209,13,0,13,725,7.7,543.2714159392445,2
2020-09-24-170209,170209,4,0,7,729,5.1,571.0072591731898,3
2020-09-25-170209,170209,9,0,13,738,5.5,522.6528108577575,4
2020-09-26-170209,170209,0,0,2,738,0.7,609.5829864634117,5
2020-09-27-170209,170209,2,0,3,740,1.0,546.5607918506535,6
2020-09-28-170209,170209,2,0,4,742,5.1,540.4759234595376,0
2020-09-29-170209,170209,3,1,4,745,3.5,539.0180792134688,1
2020-09-30-170209,170209,2,0,7,747,6.0,489.67031662711105,2
2020-10-01-170209,170209,6,1,10,753,3.4,0.0,3
2020-10-02-170209,170209,6,0,9,759,5.3,1228.4846798909862,4
2020-10-03-170209,170209,2,0,2,761,2.0,1900.9196829163757,5
2020-10-04-170209,170209,4,0,3,765,2.4,1954.8213782141672,6
2020-10-05-170209,170209,9,3,15,774,2.8,1598.0385354706284,0
2020-10-06-170209,170209,9,1,8,783,4.1,1387.927026611785,1
2020-10-07-170209,170209,13,1,12,796,5.7,1160.825121009967,2
2020-10-08-170209,170209,7,0,16,803,5.2,1092.41872964667,3
2020-10-09-170209,170209,13,2,13,816,9.0,1159.8924924431558,4
2020-10-10-170209,170209,2,0,9,818,1.7,80.36663063726785,5
2020-10-11-170209,170209,3,0,6,821,3.9,131.10016584628943,6
2020-10-12-170209,170209,4,0,21,825,4.3,209.89515766684832,0
2020-10-13-170209,170209,4,0,18,829,7.3,315.5346716133522,1
2020-10-14-170209,170209,7,0,13,836,6.1,518.2206689690186,2
2020-10-15-170209,170209,10,0,4,846,9.0,680.072443440243,3
2020-10-16-170209,170209,9,0,13,855,9.5,940.8218395214781,4
2020-10-17-170209,170209,2,0,10,857,2.5,1080.7378771492404,5
2020-10-18-170209,170209,3,0,10,860,1.6,1096.7004395662773,6
2020-10-19-170209,170209,15,1,8,875,10.8,1083.755135981203,0
2020-10-20-170209,170209,8,1,16,883,9.4,1194.499905318734,1
2020-10-21-170209,170209,12,0,12,895,9.5,1277.823541765785,2
2020-10-22-170209,170209,16,0,9,911,9.5,1280.299875029793,3
2020-10-23-170209,170209,13,0,17,924,18.1,1343.1027941247794,4
2020-10-24-170209,170209,9,1,2,933,3.9,1495.4013307534,5
2020-10-25-170209,170209,6,0,18,939,5.8,1535.051630861557,6
2020-10-26-170209,170209,21,0,19,960,17.5,1365.2374701353988,0
2020-10-27-170209,170209,18,0,11,978,12.6,1662.2137279361696,1
2020-10-28-170209,170209,13,1,5,991,16.1,1734.959431021317,2
2020-10-29-170209,170209,4,0,29,995,16.5,1822.0158465768752,3
2020-10-30-170209,170209,13,1,18,1008,15.5,1658.3373490908975,4
2020-10-31-170209,170209,10,0,0,1018,6.2,1913.895185027136,5
2020-11-01-170209,170209,10,1,0,1028,10.3,888.8421968225257,6
2020-11-02-170209,170209,8,0,0,1036,6.4,2084.49523673054,0
2020-11-03-170209,170209,16,1,0,1052,13.3,1784.033299146629,1
2020-11-04-170209,170209,12,3,0,1064,14.2,2029.8610892359839,2
2020-11-05-170209,170209,9,0,0,1073,13.1,2051.273221638961,3
2020-11-06-170209,170209,17,0,0,1090,21.4,2123.9507496870497,4
2020-11-07-170209,170209,2,0,0,1092,7.6,2052.7768287510717,5
2020-11-08-170209,170209,18,1,0,1110,10.6,1897.4483463103386,6
2020-11-09-170209,170209,19,1,0,1129,16.6,1952.8678549535543,0
2020-11-10-170209,170209,11,0,0,1140,13.1,925.4190825212696,1
2020-11-11-170209,170209,5,0,0,1145,9.7,1143.3654030278394,2
2020-11-12-170209,170209,29,0,0,1174,13.6,1262.4904129350189,3
2020-11-13-170209,170209,18,0,0,1192,17.5,1482.3248732383308,4
2020-03-01-170210,170210,0,0,1,0,0.0,0.0,6
2020-03-02-170210,170210,1,0,4,1,1.0,22.48659241641453,0
2020-03-03-170210,170210,0,0,2,1,0.0,43.51405468680248,1
2020-03-04-170210,170210,0,0,4,1,0.0,31.92405296102559,2
2020-03-05-170210,170210,0,0,0,1,0.0,33.753888074177404,3
2020-03-06-170210,170210,0,0,1,1,0.0,31.859056956519137,4
2020-03-07-170210,170210,0,2,2,1,0.0,27.438190347402553,5
2020-03-08-170210,170210,0,0,0,1,0.0,20.178445400446275,6
2020-03-09-170210,170210,0,0,5,1,0.0,20.27937906571943,0
2020-03-10-170210,170210,0,0,2,1,0.0,37.30577936941519,1
2020-03-11-170210,170210,2,0,1,3,2.0,35.49887873863735,2
2020-03-12-170210,170210,1,1,1,4,1.0,57.93265617328649,3
2020-03-13-170210,170210,1,0,1,5,1.0,67.26772664617766,4
2020-03-14-170210,170210,1,0,1,6,1.0,77.24981311363476,5
2020-03-15-170210,170210,1,0,1,7,1.0,85.56019306126282,6
2020-03-16-170210,170210,4,0,1,11,4.0,68.76814759294695,0
2020-03-17-170210,170210,2,0,0,13,2.0,108.77493105642617,1
2020-03-18-170210,170210,4,0,4,17,4.0,126.4216469471184,2
2020-03-19-170210,170210,0,0,0,17,0.0,138.24376846660326,3
2020-03-20-170210,170210,1,0,2,18,1.0,122.86077767560724,4
2020-03-21-170210,170210,2,0,0,20,2.0,119.43967446505204,5
2020-03-22-170210,170210,0,0,0,20,0.0,124.84327608128224,6
2020-03-23-170210,170210,5,1,0,25,5.0,89.0051388503083,0
2020-03-24-170210,170210,2,0,1,27,2.0,116.25095120663529,1
2020-03-25-170210,170210,1,0,0,28,1.0,98.59926546680921,2
2020-03-26-170210,170210,1,0,0,29,1.0,107.95979950068558,3
2020-03-27-170210,170210,1,0,1,30,1.0,110.17615694043037,4
2020-03-28-170210,170210,1,0,0,31,1.0,109.68562961322958,5
2020-03-29-170210,170210,1,0,2,32,1.0,100.40607680987162,6
2020-03-30-170210,170210,1,0,0,33,1.0,63.492497166137596,0
2020-03-31-170210,170210,0,0,0,33,0.0,54.9718260583382,1
2020-04-01-170210,170210,4,0,0,37,4.0,1.5219379182233461,2
2020-04-02-170210,170210,0,0,0,37,0.0,2.9444739491630365,3
2020-04-03-170210,170210,2,0,0,39,2.0,9.205686602050944,4
2020-04-04-170210,170210,0,0,0,39,0.0,25.198508245134224,5
2020-04-05-170210,170210,0,0,0,39,0.0,25.065092629003196,6
2020-04-06-170210,170210,0,0,0,39,0.0,25.86840645299203,0
2020-04-07-170210,170210,1,0,0,40,1.0,25.94015241073279,1
2020-04-08-170210,170210,0,0,1,40,0.0,26.511086544153112,2
2020-04-09-170210,170210,0,0,0,40,0.0,27.135576369347845,3
2020-04-10-170210,170210,1,0,0,41,1.0,32.91071576313323,4
2020-04-11-170210,170210,0,0,0,41,0.0,40.61009763781447,5
2020-04-12-170210,170210,2,0,0,43,2.0,40.91077624608386,6
2020-04-13-170210,170210,0,0,0,43,0.0,54.87930515021613,0
2020-04-14-170210,170210,0,0,1,43,0.0,54.82874394348822,1
2020-04-15-170210,170210,0,0,0,43,0.0,56.95582305341725,2
2020-04-16-170210,170210,0,0,0,43,0.0,57.887434121450596,3
2020-04-17-170210,170210,0,0,1,43,0.0,27.169604503369914,4
2020-04-18-170210,170210,0,0,0,43,0.0,20.21850082576242,5
2020-04-19-170210,170210,0,0,0,43,0.0,20.64859880470781,6
2020-04-20-170210,170210,0,0,0,43,0.0,3.2252617511117334,0
2020-04-21-170210,170210,0,1,0,43,0.0,3.4178390300634836,1
2020-04-22-170210,170210,1,0,1,44,1.0,3.2003222938558817,2
2020-04-23-170210,170210,0,0,0,44,0.0,11.712754279666528,3
2020-04-24-170210,170210,0,0,0,44,0.0,11.243930808221986,4
2020-04-25-170210,170210,0,0,0,44,0.0,11.284333625737112,5
2020-04-26-170210,170210,0,0,0,44,0.0,11.14881076885364,6
2020-04-27-170210,170210,0,0,0,44,0.0,10.549151531965645,0
2020-04-28-170210,170210,1,0,0,45,1.0,10.286897953875874,1
2020-04-29-170210,170210,0,0,1,45,0.0,18.72375058336245,2
2020-04-30-170210,170210,0,0,0,45,0.0,29.55278723356208,3
2020-05-01-170210,170210,1,0,0,46,1.0,13.178792934884235,4
2020-05-02-170210,170210,0,0,0,46,0.0,20.420015045393185,5
2020-05-03-170210,170210,0,0,0,46,0.0,11.124289796637418,6
2020-05-04-170210,170210,0,0,1,46,0.0,11.235764516993749,0
2020-05-05-170210,170210,0,0,0,46,0.0,11.592998625334843,1
2020-05-06-170210,170210,1,0,0,47,1.0,12.384062547922126,2
2020-05-07-170210,170210,0,0,1,47,0.0,23.326535544859208,3
2020-05-08-170210,170210,0,0,0,47,0.0,13.277233279133672,4
2020-05-09-170210,170210,0,0,0,47,0.0,13.800161829108438,5
2020-05-10-170210,170210,0,0,0,47,0.0,25.696986942960333,6
2020-05-11-170210,170210,0,0,0,47,0.0,24.74224383842266,0
2020-05-12-170210,170210,0,0,0,47,0.0,25.464556000372,1
2020-05-13-170210,170210,1,0,0,48,1.0,24.810120185419674,2
2020-05-14-170210,170210,0,0,0,48,0.0,25.511963256393337,3
2020-05-15-170210,170210,0,0,1,48,0.0,25.39873476324511,4
2020-05-16-170210,170210,0,0,0,48,0.0,25.83038611043775,5
2020-05-17-170210,170210,0,0,0,48,0.0,14.881743327866955,6
2020-05-18-170210,170210,1,0,0,49,1.0,15.062211915991934,0
2020-05-19-170210,170210,0,0,0,49,0.0,27.23808714475774,1
2020-05-20-170210,170210,0,0,0,49,0.0,14.617326563516663,2
2020-05-21-170210,170210,1,0,0,50,1.0,14.412466965106805,3
2020-05-22-170210,170210,0,0,0,50,0.0,26.83380492625782,4
2020-05-23-170210,170210,0,0,0,50,0.0,28.012618298261927,5
2020-05-24-170210,170210,0,0,0,50,0.0,29.48472890959565,6
2020-05-25-170210,170210,0,0,0,50,0.0,16.04118780059536,0
2020-05-26-170210,170210,0,0,0,50,0.0,16.090251687566006,1
2020-05-27-170210,170210,0,0,0,50,0.0,16.16192978077027,2
2020-05-28-170210,170210,0,1,0,50,0.0,16.34598029309937,3
2020-05-29-170210,170210,1,0,0,51,1.0,2.120202951179483,4
2020-05-30-170210,170210,0,0,0,51,0.0,16.25425050333862,5
2020-05-31-170210,170210,0,0,0,51,0.0,16.729203868799495,6
2020-06-01-170210,170210,0,0,0,51,0.0,18.198219731025908,0
2020-06-02-170210,170210,0,0,0,51,0.0,0.4451908219488384,1
2020-06-03-170210,170210,0,0,0,51,0.0,0.5395469328613782,2
2020-06-04-170210,170210,0,0,0,51,0.0,0.7997764946600432,3
2020-06-05-170210,170210,0,0,0,51,0.0,1.2618780008305543,4
2020-06-06-170210,170210,0,0,0,51,0.0,1.2133879121810747,5
2020-06-07-170210,170210,0,0,0,51,0.0,1.12431112852676,6
2020-06-08-170210,170210,0,0,0,51,0.0,1.0761990448140555,0
2020-06-09-170210,170210,0,1,0,51,0.0,1.1550479413460466,1
2020-06-10-170210,170210,0,0,0,51,0.0,17.715448655246362,2
2020-06-11-170210,170210,0,0,0,51,0.0,17.992545136098617,3
2020-06-12-170210,170210,0,0,0,51,0.0,17.25404806032168,4
2020-06-13-170210,170210,0,0,0,51,0.0,2.7131139488468206,5
2020-06-14-170210,170210,0,1,0,51,0.0,1.4752455025217337,6
2020-06-15-170210,170210,0,2,0,51,0.0,1.4042072210939165,0
2020-06-16-170210,170210,0,0,0,51,0.0,1.3885301516292472,1
2020-06-17-170210,170210,0,0,0,51,0.0,0.8559315333529012,2
2020-06-18-170210,170210,0,0,0,51,0.0,0.606561642286175,3
2020-06-19-170210,170210,0,0,0,51,0.0,0.5507813428109835,4
2020-06-20-170210,170210,0,0,0,51,0.0,0.6986281973285926,5
2020-06-21-170210,170210,0,1,0,51,0.0,0.6371562769190829,6
2020-06-22-170210,170210,0,0,0,51,0.0,0.6723432354816756,0
2020-06-23-170210,170210,0,0,0,51,0.0,0.5790317703955965,1
2020-06-24-170210,170210,0,0,0,51,0.0,0.5825685446600709,2
2020-06-25-170210,170210,0,0,0,51,0.0,0.667888179271237,3
2020-06-26-170210,170210,0,0,0,51,0.0,0.6633803365562974,4
2020-06-27-170210,170210,0,0,0,51,0.0,0.6375999418414453,5
2020-06-28-170210,170210,0,0,0,51,0.0,0.6960131687423383,6
2020-06-29-170210,170210,0,0,0,51,0.0,0.7410491268268102,0
2020-06-30-170210,170210,0,0,0,51,0.0,1.1378916204257044,1
2020-07-01-170210,170210,0,0,0,51,0.0,1.7707507715672142,2
2020-07-02-170210,170210,0,0,1,51,0.0,30.029389950664953,3
2020-07-03-170210,170210,0,0,1,51,0.0,2.5535450734294955,4
2020-07-04-170210,170210,0,0,0,51,0.0,2.1462218978706598,5
2020-07-05-170210,170210,0,0,0,51,0.0,1.5341075136127595,6
2020-07-06-170210,170210,0,0,0,51,0.0,1.4550686705225424,0
2020-07-07-170210,170210,0,0,0,51,0.0,1.5720435332490328,1
2020-07-08-170210,170210,0,0,0,51,0.0,1.0411509274703814,2
2020-07-09-170210,170210,0,0,0,51,0.0,0.9675442740638219,3
2020-07-10-170210,170210,0,0,0,51,0.0,1.6501956126825823,4
2020-07-11-170210,170210,0,0,0,51,0.0,0.9872412296535906,5
2020-07-12-170210,170210,0,0,0,51,0.0,0.8724009390139985,6
2020-07-13-170210,170210,0,0,0,51,0.0,0.8446880457946162,0
2020-07-14-170210,170210,0,0,0,51,0.0,0.8715050602207057,1
2020-07-15-170210,170210,0,0,0,51,0.0,0.6366348302807359,2
2020-07-16-170210,170210,1,0,1,52,1.0,0.5990746797144045,3
2020-07-17-170210,170210,1,0,0,53,1.0,15.312665047132315,4
2020-07-18-170210,170210,0,0,0,53,0.0,28.191555400570476,5
2020-07-19-170210,170210,0,0,0,53,0.0,28.30419013774347,6
2020-07-20-170210,170210,0,0,0,53,0.0,29.302923264278615,0
2020-07-21-170210,170210,0,0,0,53,0.0,29.5131434848771,1
2020-07-22-170210,170210,0,0,1,53,0.0,30.068690360609242,2
2020-07-23-170210,170210,0,0,1,53,0.0,15.283042231579826,3
2020-07-24-170210,170210,0,0,0,53,0.0,0.7037083370678855,4
2020-07-25-170210,170210,0,0,0,53,0.0,1.064345658761225,5
2020-07-26-170210,170210,0,0,0,53,0.0,1.290446455046822,6
2020-07-27-170210,170210,0,0,1,53,0.0,1.9880389670001402,0
2020-07-28-170210,170210,0,0,2,53,0.0,1.9448631060418013,1
2020-07-29-170210,170210,0,0,0,53,0.0,2.093432445754538,2
2020-07-30-170210,170210,1,0,0,54,1.0,2.376962096533065,3
2020-07-31-170210,170210,0,0,0,54,0.0,2.265786672236064,4
2020-08-01-170210,170210,0,0,0,54,0.0,0.9806688508606575,5
2020-08-02-170210,170210,0,0,0,54,0.0,8.157662338685084,6
2020-08-03-170210,170210,0,0,0,54,0.0,22.986373117047556,0
2020-08-04-170210,170210,0,0,0,54,0.0,20.910433592868102,1
2020-08-05-170210,170210,1,0,0,55,1.0,6.051595511294972,2
2020-08-06-170210,170210,1,0,0,56,1.0,20.92725597780221,3
2020-08-07-170210,170210,0,0,0,56,0.0,34.96468405562255,4
2020-08-08-170210,170210,0,0,0,56,0.0,35.00025233129129,5
2020-08-09-170210,170210,0,0,0,56,0.0,34.562465355594725,6
2020-08-10-170210,170210,1,0,0,57,1.0,1.0378745244559293,0
2020-08-11-170210,170210,2,0,0,59,2.0,16.805316245260602,1
2020-08-12-170210,170210,0,0,0,59,0.0,32.954758059538634,2
2020-08-13-170210,170210,0,0,0,59,0.0,33.17359813663046,3
2020-08-14-170210,170210,0,0,0,59,0.0,34.244041831902294,4
2020-08-15-170210,170210,0,0,0,59,0.0,34.6912094105221,5
2020-08-16-170210,170210,0,0,0,59,0.0,36.17055148403658,6
2020-08-17-170210,170210,0,0,0,59,0.0,37.547451394650736,0
2020-08-18-170210,170210,0,0,0,59,0.0,23.47748680377889,1
2020-08-19-170210,170210,0,0,1,59,0.0,7.139063109642466,2
2020-08-20-170210,170210,0,0,0,59,0.0,6.5109872199964425,3
2020-08-21-170210,170210,0,0,0,59,0.0,6.9702624483093345,4
2020-08-22-170210,170210,0,0,0,59,0.0,8.030804312228668,5
2020-08-23-170210,170210,0,0,2,59,0.0,8.404406635879033,6
2020-08-24-170210,170210,0,0,0,59,0.0,6.188171486728658,0
2020-08-25-170210,170210,0,0,0,59,0.0,7.398146457667227,1
2020-08-26-170210,170210,0,0,0,59,0.0,7.8975003731785485,2
2020-08-27-170210,170210,0,0,0,59,0.0,25.245318356461386,3
2020-08-28-170210,170210,0,0,0,59,0.0,24.85078001645519,4
2020-08-29-170210,170210,0,0,0,59,0.0,24.16191653332078,5
2020-08-30-170210,170210,0,0,1,59,0.0,22.52894602158017,6
2020-08-31-170210,170210,0,0,0,59,0.0,21.620935808714083,0
2020-09-01-170210,170210,0,0,0,59,0.0,31.350706451211924,1
2020-09-02-170210,170210,1,0,1,60,1.0,32.14527979793804,2
2020-09-03-170210,170210,0,0,1,60,0.0,51.783687252995215,3
2020-09-04-170210,170210,0,0,0,60,0.0,35.316198840548324,4
2020-09-05-170210,170210,0,0,0,60,0.0,19.421074712376633,5
2020-09-06-170210,170210,2,0,0,62,2.0,19.503539850383355,6
2020-09-07-170210,170210,0,0,0,62,0.0,17.960247305549686,0
2020-09-08-170210,170210,0,0,0,62,0.0,14.857306994767189,1
2020-09-09-170210,170210,0,0,2,62,0.0,12.542245723578453,2
2020-09-10-170210,170210,0,0,4,62,0.0,31.95222797290935,3
2020-09-11-170210,170210,0,0,1,62,0.0,33.12671017538463,4
2020-09-12-170210,170210,0,0,0,62,0.0,21.31002792607461,5
2020-09-13-170210,170210,1,0,0,63,1.0,10.253641490082753,6
2020-09-14-170210,170210,0,0,0,63,0.0,26.370645943010615,0
2020-09-15-170210,170210,0,0,0,63,0.0,28.193011203206925,1
2020-09-16-170210,170210,1,0,0,64,1.0,32.15443144272572,2
2020-09-17-170210,170210,1,0,0,65,1.0,34.35579264619551,3
2020-09-18-170210,170210,0,0,0,65,0.0,34.2778350281505,4
2020-09-19-170210,170210,0,0,0,65,0.0,35.50636492742682,5
2020-09-20-170210,170210,0,0,0,65,0.0,32.043648526144324,6
2020-09-21-170210,170210,0,0,0,65,0.0,30.11057676370166,0
2020-09-22-170210,170210,0,0,1,65,0.0,32.807666816018575,1
2020-09-23-170210,170210,2,0,2,67,2.0,33.99309037410256,2
2020-09-24-170210,170210,4,0,1,71,4.0,34.54752116245149,3
2020-09-25-170210,170210,1,0,3,72,1.0,46.90913777238928,4
2020-09-26-170210,170210,0,0,1,72,0.0,63.523147930633584,5
2020-09-27-170210,170210,0,0,0,72,0.0,49.87996915233748,6
2020-09-28-170210,170210,0,0,0,72,0.0,47.87177715484453,0
2020-09-29-170210,170210,0,0,0,72,0.0,47.72391538710872,1
2020-09-30-170210,170210,0,0,0,72,0.0,44.63800478482999,2
2020-10-01-170210,170210,0,0,1,72,0.0,0.0,3
2020-10-02-170210,170210,0,0,0,72,0.0,26.37597862076374,4
2020-10-03-170210,170210,0,0,0,72,0.0,26.02253551250412,5
2020-10-04-170210,170210,0,0,1,72,0.0,51.01566357900141,6
2020-10-05-170210,170210,0,0,0,72,0.0,36.892057776085956,0
2020-10-06-170210,170210,1,0,0,73,1.0,36.31381876513665,1
2020-10-07-170210,170210,2,2,1,75,2.0,47.40765479699889,2
2020-10-08-170210,170210,1,0,1,76,1.0,47.30063123362231,3
2020-10-09-170210,170210,3,0,1,79,3.0,60.34096981529899,4
2020-10-10-170210,170210,1,0,0,80,1.0,5.212820694590552,5
2020-10-11-170210,170210,0,0,0,80,0.0,18.403483342019904,6
2020-10-12-170210,170210,0,0,1,80,0.0,19.20101919565327,0
2020-10-13-170210,170210,0,0,0,80,0.0,19.887490363192615,1
2020-10-14-170210,170210,0,0,0,80,0.0,23.485212622874705,2
2020-10-15-170210,170210,1,0,1,81,1.0,25.09006928669852,3
2020-10-16-170210,170210,0,0,2,81,0.0,26.98508843343987,4
2020-10-17-170210,170210,0,0,1,81,0.0,23.832287083741612,5
2020-10-18-170210,170210,1,0,0,82,1.0,11.578030002616856,6
2020-10-19-170210,170210,0,0,0,82,0.0,24.972417188664906,0
2020-10-20-170210,170210,0,0,1,82,0.0,26.65649353963943,1
2020-10-21-170210,170210,1,0,0,83,1.0,25.219579552701962,2
2020-10-22-170210,170210,1,0,1,84,1.0,39.012008794916696,3
2020-10-23-170210,170210,1,0,1,85,1.0,37.89492548794826,4
2020-10-24-170210,170210,0,0,0,85,0.0,38.90715201459474,5
2020-10-25-170210,170210,0,0,0,85,0.0,25.398243291544198,6
2020-10-26-170210,170210,1,0,2,86,1.0,24.630298793886027,0
2020-10-27-170210,170210,0,0,1,86,0.0,36.376354100714096,1
2020-10-28-170210,170210,0,1,0,86,0.0,37.54128974791622,2
2020-10-29-170210,170210,1,0,1,87,1.0,25.605016275421914,3
2020-10-30-170210,170210,2,0,0,89,2.0,24.803755429192293,4
2020-10-31-170210,170210,1,0,0,90,1.0,40.43099785880722,5
2020-11-01-170210,170210,0,0,0,90,0.0,52.924684234956636,6
2020-11-02-170210,170210,0,0,0,90,0.0,68.95948846201492,0
2020-11-03-170210,170210,1,0,0,91,1.0,67.6771162586111,1
2020-11-04-170210,170210,0,0,0,91,0.0,70.24084153467486,2
2020-11-05-170210,170210,1,0,0,92,1.0,69.27146899951438,3
2020-11-06-170210,170210,1,0,0,93,1.0,44.54612959403377,4
2020-11-07-170210,170210,0,0,0,93,0.0,8.325096118192876,5
2020-11-08-170210,170210,0,0,0,93,0.0,8.094424997801699,6
2020-11-09-170210,170210,2,0,0,95,2.0,7.2262580528908105,0
2020-11-10-170210,170210,1,0,0,96,1.0,34.708610461862996,1
2020-11-11-170210,170210,0,0,0,96,0.0,46.07692780020393,2
2020-11-12-170210,170210,1,0,0,97,1.0,45.670057363925544,3
2020-11-13-170210,170210,0,0,0,97,0.0,31.46566901429643,4
2020-03-01-170211,170211,0,0,0,0,0.0,0.0,6
2020-03-02-170211,170211,0,0,0,0,0.0,5.809742467058175,0
2020-03-03-170211,170211,0,0,0,0,0.0,48.773813270781034,1
2020-03-04-170211,170211,0,0,0,0,0.0,41.02822043266074,2
2020-03-05-170211,170211,0,0,0,0,0.0,28.789068127221732,3
2020-03-06-170211,170211,0,0,3,0,0.0,23.834120315216143,4
2020-03-07-170211,170211,0,0,0,0,0.0,26.539094574841315,5
2020-03-08-170211,170211,0,0,1,0,0.0,29.57055106762514,6
2020-03-09-170211,170211,0,0,2,0,0.2,29.56089323318956,0
2020-03-10-170211,170211,0,0,2,0,0.0,409.8443640081984,1
2020-03-11-170211,170211,0,0,1,0,0.0,350.1327452049226,2
2020-03-12-170211,170211,1,0,3,1,0.0,291.39182327874875,3
2020-03-13-170211,170211,0,0,1,1,0.4,239.40626197881338,4
2020-03-14-170211,170211,0,0,0,1,0.2,176.14248392289255,5
2020-03-15-170211,170211,0,0,0,1,0.4,126.6540688715124,6
2020-03-16-170211,170211,0,0,0,1,0.4,17.73038314033087,0
2020-03-17-170211,170211,0,0,0,1,0.8,20.61144295715536,1
2020-03-18-170211,170211,0,1,7,1,1.6,26.763792673152597,2
2020-03-19-170211,170211,0,0,1,1,1.2,35.30240037872283,3
2020-03-20-170211,170211,3,0,2,4,2.2,31.830460990410785,4
2020-03-21-170211,170211,0,0,2,4,0.6,59.48127449582563,5
2020-03-22-170211,170211,1,0,0,5,2.2,62.02103625471247,6
2020-03-23-170211,170211,2,0,0,7,1.4,73.40167929961933,0
2020-03-24-170211,170211,2,1,0,9,1.2,91.27986540453556,1
2020-03-25-170211,170211,1,0,1,10,1.8,105.88057774974453,2
2020-03-26-170211,170211,3,0,0,13,1.8,115.2771625351842,3
2020-03-27-170211,170211,1,0,1,14,1.2,143.24968328609748,4
2020-03-28-170211,170211,0,1,0,14,0.0,123.80237312279512,5
2020-03-29-170211,170211,0,0,0,14,0.2,118.98054944252146,6
2020-03-30-170211,170211,0,0,2,14,1.0,81.1569613206111,0
2020-03-31-170211,170211,0,0,2,14,1.4,66.74034591390384,1
2020-04-01-170211,170211,7,0,1,21,1.6,8.228369677180249,2
2020-04-02-170211,170211,1,0,0,22,0.4,39.60697599184298,3
2020-04-03-170211,170211,2,0,0,24,1.2,17.33376163396957,4
2020-04-04-170211,170211,2,0,0,26,0.6,36.29650911806975,5
2020-04-05-170211,170211,0,0,0,26,0.2,48.303679348532235,6
2020-04-06-170211,170211,0,0,0,26,1.4,46.81840422548196,0
2020-04-07-170211,170211,0,0,1,26,0.8,56.40065689178785,1
2020-04-08-170211,170211,1,2,1,27,1.4,59.22341074077113,2
2020-04-09-170211,170211,0,0,0,27,0.6,67.5604869399246,3
2020-04-10-170211,170211,1,0,0,28,1.0,52.6213059934758,4
2020-04-11-170211,170211,0,0,0,28,0.4,59.40582101429392,5
2020-04-12-170211,170211,0,0,0,28,0.2,63.219407430968026,6
2020-04-13-170211,170211,2,0,0,30,0.6,64.47270737968996,0
2020-04-14-170211,170211,2,0,0,32,0.2,79.36867140384607,1
2020-04-15-170211,170211,1,0,0,33,0.4,93.61467618013903,2
2020-04-16-170211,170211,0,0,0,33,0.4,102.30107972961993,3
2020-04-17-170211,170211,0,0,0,33,0.0,55.47355471906741,4
2020-04-18-170211,170211,0,0,0,33,0.0,49.120210773335444,5
2020-04-19-170211,170211,0,0,0,33,0.0,44.99691087940211,6
2020-04-20-170211,170211,0,0,0,33,1.2,40.99384082552845,0
2020-04-21-170211,170211,1,0,0,34,0.2,43.12402582126875,1
2020-04-22-170211,170211,1,0,0,35,0.4,41.67874119241293,2
2020-04-23-170211,170211,0,0,0,35,0.2,46.97818499924832,3
2020-04-24-170211,170211,0,0,0,35,0.2,46.590515713339144,4
2020-04-25-170211,170211,0,0,0,35,0.6,47.01592511196811,5
2020-04-26-170211,170211,0,0,0,35,0.4,49.39270107576493,6
2020-04-27-170211,170211,0,0,0,35,0.4,39.917726633437915,0
2020-04-28-170211,170211,0,0,1,35,0.8,28.18842581424998,1
2020-04-29-170211,170211,0,0,0,35,0.4,25.03229893269014,2
2020-04-30-170211,170211,0,0,0,35,0.0,41.4576152970333,3
2020-05-01-170211,170211,0,0,0,35,0.4,55.769545479140206,4
2020-05-02-170211,170211,0,0,0,35,0.2,20.061320011764664,5
2020-05-03-170211,170211,0,0,0,35,0.0,10.56641065750188,6
2020-05-04-170211,170211,0,0,0,35,0.2,9.968159839735485,0
2020-05-05-170211,170211,0,0,0,35,0.0,8.778972916067627,1
2020-05-06-170211,170211,0,0,1,35,0.2,7.117828573331894,2
2020-05-07-170211,170211,0,0,0,35,0.4,6.360001719095788,3
2020-05-08-170211,170211,0,0,0,35,0.4,7.924734870468971,4
2020-05-09-170211,170211,0,0,0,35,0.2,10.991517791006405,5
2020-05-10-170211,170211,0,1,0,35,0.0,63.5015367869967,6
2020-05-11-170211,170211,0,0,0,35,0.4,46.25732132170201,0
2020-05-12-170211,170211,1,2,0,36,0.0,48.23728245273329,1
2020-05-13-170211,170211,0,0,0,36,1.2,38.91912129293604,2
2020-05-14-170211,170211,0,0,0,36,0.8,42.03392968524507,3
2020-05-15-170211,170211,0,0,0,36,0.0,34.730262585855826,4
2020-05-16-170211,170211,0,0,0,36,0.0,29.348139307238732,5
2020-05-17-170211,170211,0,0,0,36,0.0,27.383294555885076,6
2020-05-18-170211,170211,0,0,0,36,0.4,27.465960992921087,0
2020-05-19-170211,170211,0,0,0,36,0.4,28.70326755662381,1
2020-05-20-170211,170211,1,0,0,37,0.2,16.286859744042257,2
2020-05-21-170211,170211,0,0,2,37,0.4,19.878099607239292,3
2020-05-22-170211,170211,0,0,0,37,0.6,21.903607367674528,4
2020-05-23-170211,170211,0,0,0,37,0.2,27.56568143783753,5
2020-05-24-170211,170211,0,0,0,37,0.0,28.557954588611093,6
2020-05-25-170211,170211,0,0,1,37,0.0,25.516893533016503,0
2020-05-26-170211,170211,0,0,0,37,1.0,21.543612956670053,1
2020-05-27-170211,170211,0,0,0,37,0.4,24.754634525705004,2
2020-05-28-170211,170211,0,0,0,37,0.6,19.997720157564444,3
2020-05-29-170211,170211,0,1,0,37,0.2,19.896920039524872,4
2020-05-30-170211,170211,0,0,0,37,0.0,16.095056073722585,5
2020-05-31-170211,170211,0,0,0,37,0.2,16.89189100154364,6
2020-06-01-170211,170211,0,0,1,37,0.6,17.903944591220846,0
2020-06-02-170211,170211,0,0,0,37,0.6,27.04632040505829,1
2020-06-03-170211,170211,0,0,0,37,0.2,2.656796371342109,2
2020-06-04-170211,170211,2,0,0,39,0.4,11.494511525260615,3
2020-06-05-170211,170211,0,0,1,39,0.2,31.570511595507647,4
2020-06-06-170211,170211,0,1,0,39,0.4,32.50651263550767,5
2020-06-07-170211,170211,0,1,0,39,0.2,34.53872544674298,6
2020-06-08-170211,170211,1,0,0,40,0.4,35.637501121934044,0
2020-06-09-170211,170211,0,0,0,40,0.2,39.86776969903238,1
2020-06-10-170211,170211,0,0,0,40,0.0,19.759978885337013,2
2020-06-11-170211,170211,0,0,0,40,0.4,18.688714813534254,3
2020-06-12-170211,170211,0,0,0,40,0.0,22.85381785394503,4
2020-06-13-170211,170211,0,2,0,40,0.0,21.653670488653386,5
2020-06-14-170211,170211,0,0,0,40,0.2,17.211455740634868,6
2020-06-15-170211,170211,1,0,0,41,0.2,15.287846869208947,0
2020-06-16-170211,170211,0,0,1,41,0.4,25.530004791238618,1
2020-06-17-170211,170211,0,0,0,41,0.2,24.832054463478396,2
2020-06-18-170211,170211,0,0,0,41,0.0,24.063553219168554,3
2020-06-19-170211,170211,1,0,0,42,0.2,18.61455132413051,4
2020-06-20-170211,170211,0,0,0,42,0.0,31.424735877891827,5
2020-06-21-170211,170211,0,0,0,42,0.2,30.11859239568097,6
2020-06-22-170211,170211,0,0,1,42,0.0,20.479198452315437,0
2020-06-23-170211,170211,0,0,1,42,0.2,17.703516809167773,1
2020-06-24-170211,170211,0,0,1,42,0.0,18.1085135986699,2
2020-06-25-170211,170211,0,1,0,42,0.0,19.126283928902,3
2020-06-26-170211,170211,0,0,1,42,0.0,8.862199626751853,4
2020-06-27-170211,170211,0,0,0,42,0.0,4.60624713404442,5
2020-06-28-170211,170211,0,0,0,42,0.0,4.9584511574993355,6
2020-06-29-170211,170211,0,0,0,42,0.0,3.595818935304912,0
2020-06-30-170211,170211,1,1,1,43,0.0,4.396924365546088,1
2020-07-01-170211,170211,0,0,0,43,0.0,54.081843611362636,2
2020-07-02-170211,170211,0,0,0,43,0.2,24.430483857947962,3
2020-07-03-170211,170211,0,0,0,43,0.0,18.113123690800453,4
2020-07-04-170211,170211,0,0,0,43,0.2,20.31631124121116,5
2020-07-05-170211,170211,0,0,0,43,0.4,20.052673171702835,6
2020-07-06-170211,170211,1,0,0,44,0.4,19.331419799490025,0
2020-07-07-170211,170211,1,0,0,45,0.2,20.160225751603303,1
2020-07-08-170211,170211,1,0,1,46,0.4,29.96286731275971,2
2020-07-09-170211,170211,0,0,0,46,0.2,46.060059024691924,3
2020-07-10-170211,170211,1,0,0,47,0.0,43.299297998968946,4
2020-07-11-170211,170211,0,0,0,47,0.0,28.01754453787805,5
2020-07-12-170211,170211,0,0,0,47,0.0,25.48466966922727,6
2020-07-13-170211,170211,0,0,0,47,0.0,22.355017480647057,0
2020-07-14-170211,170211,1,0,0,48,0.2,20.964552322876372,1
2020-07-15-170211,170211,0,0,0,48,0.8,29.211998517223243,2
2020-07-16-170211,170211,0,0,0,48,0.2,27.741642734834983,3
2020-07-17-170211,170211,0,0,0,48,0.0,27.543707467102365,4
2020-07-18-170211,170211,0,0,1,48,0.0,17.44555297737861,5
2020-07-19-170211,170211,0,0,0,48,0.0,18.482729716854323,6
2020-07-20-170211,170211,0,0,0,48,0.6,26.45366616790939,0
2020-07-21-170211,170211,0,0,1,48,0.0,20.753956428042844,1
2020-07-22-170211,170211,1,1,4,49,0.2,24.794054501201373,2
2020-07-23-170211,170211,0,0,0,49,0.0,38.33952128606392,3
2020-07-24-170211,170211,0,0,9,49,0.2,38.48187716568241,4
2020-07-25-170211,170211,0,0,0,49,0.2,41.12453585832321,5
2020-07-26-170211,170211,0,0,2,49,0.0,36.151670530745754,6
2020-07-27-170211,170211,0,0,1,49,0.2,35.291558070778954,0
2020-07-28-170211,170211,0,0,3,49,0.8,31.174579524478396,1
2020-07-29-170211,170211,0,0,5,49,0.2,30.252591505163338,2
2020-07-30-170211,170211,0,0,2,49,0.4,21.069779776494126,3
2020-07-31-170211,170211,0,0,0,49,0.4,22.142044706632547,4
2020-08-01-170211,170211,1,0,0,50,0.4,49.90730200408724,5
2020-08-02-170211,170211,0,0,0,50,0.8,251.19525286265682,6
2020-08-03-170211,170211,0,0,1,50,1.2,209.09393329648256,0
2020-08-04-170211,170211,1,0,1,51,1.4,240.61847847957415,1
2020-08-05-170211,170211,4,0,2,55,2.4,256.21850862121664,2
2020-08-06-170211,170211,0,0,2,55,2.4,304.66782191860517,3
2020-08-07-170211,170211,9,0,11,64,1.6,275.50018657329406,4
2020-08-08-170211,170211,0,0,5,64,1.2,381.17347270979815,5
2020-08-09-170211,170211,2,0,0,66,1.0,378.57086256292723,6
2020-08-10-170211,170211,1,0,0,67,1.4,61.383520270432896,0
2020-08-11-170211,170211,3,0,1,70,4.8,93.76301496405921,1
2020-08-12-170211,170211,5,0,3,75,3.4,166.42112768768288,2
2020-08-13-170211,170211,2,0,1,77,2.8,272.6010588750068,3
2020-08-14-170211,170211,0,0,0,77,1.2,371.1507869156546,4
2020-08-15-170211,170211,0,0,1,77,0.8,361.3026358338137,5
2020-08-16-170211,170211,0,0,1,77,0.2,359.9012800096905,6
2020-08-17-170211,170211,1,0,2,78,0.4,349.5677045852446,0
2020-08-18-170211,170211,1,0,0,79,1.2,325.8955388721398,1
2020-08-19-170211,170211,2,0,2,81,2.6,274.62036070895397,2
2020-08-20-170211,170211,2,0,0,83,3.6,150.72478630877254,3
2020-08-21-170211,170211,11,0,0,94,2.2,207.7561752823807,4
2020-08-22-170211,170211,5,0,1,99,0.2,337.7236661386447,5
2020-08-23-170211,170211,0,0,0,99,1.2,385.7981417713567,6
2020-08-24-170211,170211,0,0,1,99,0.6,381.0864405624956,0
2020-08-25-170211,170211,1,0,0,100,0.8,391.4627310889346,1
2020-08-26-170211,170211,3,0,9,103,2.4,339.4090594205095,2
2020-08-27-170211,170211,1,0,0,104,2.4,364.1166052181013,3
2020-08-28-170211,170211,0,0,1,104,4.2,322.2933838457319,4
2020-08-29-170211,170211,1,0,0,105,0.6,237.99358816888585,5
2020-08-30-170211,170211,1,0,1,106,1.2,203.23216690196614,6
2020-08-31-170211,170211,2,0,3,108,1.8,203.8162530480269,0
2020-09-01-170211,170211,0,0,7,108,1.6,335.12210187511704,1
2020-09-02-170211,170211,2,0,1,110,1.6,282.02208463388723,2
2020-09-03-170211,170211,0,0,3,110,1.2,116.17511966050779,3
2020-09-04-170211,170211,0,0,2,110,0.6,106.74916519551768,4
2020-09-05-170211,170211,1,0,2,111,1.8,103.2893887555245,5
2020-09-06-170211,170211,0,0,0,111,0.2,113.83529057709697,6
2020-09-07-170211,170211,1,0,1,112,1.0,110.34093349804348,0
2020-09-08-170211,170211,0,0,1,112,0.6,102.37321336808756,1
2020-09-09-170211,170211,9,0,2,121,1.0,108.0722695232665,2
2020-09-10-170211,170211,0,0,2,121,1.2,271.10913838358755,3
2020-09-11-170211,170211,1,0,1,122,1.8,236.01382517627903,4
2020-09-12-170211,170211,0,0,0,122,0.8,204.6832005412705,5
2020-09-13-170211,170211,1,0,0,123,1.0,202.750749557712,6
2020-09-14-170211,170211,3,0,2,126,2.0,123.15614233005002,0
2020-09-15-170211,170211,7,0,0,133,3.0,152.8981200207512,1
2020-09-16-170211,170211,1,0,3,134,2.0,207.48916166431863,2
2020-09-17-170211,170211,3,0,1,137,2.0,219.04828799944258,3
2020-09-18-170211,170211,2,0,0,139,1.4,252.64020061373887,4
2020-09-19-170211,170211,2,0,0,141,0.6,255.6536167011333,5
2020-09-20-170211,170211,0,0,0,141,1.6,272.617858073604,6
2020-09-21-170211,170211,1,0,0,142,1.2,233.37628316323168,0
2020-09-22-170211,170211,1,0,3,143,1.6,177.67660661258196,1
2020-09-23-170211,170211,2,0,0,145,1.4,179.04004571146743,2
2020-09-24-170211,170211,2,0,1,147,2.2,161.87284341737978,3
2020-09-25-170211,170211,1,1,1,148,0.8,157.43487702825456,4
2020-09-26-170211,170211,0,0,1,148,0.4,143.10824179849723,5
2020-09-27-170211,170211,0,0,0,148,0.2,112.00469199829321,6
2020-09-28-170211,170211,2,0,0,150,0.4,108.04702193297047,0
2020-09-29-170211,170211,0,0,0,150,0.6,111.23876798980646,1
2020-09-30-170211,170211,3,0,2,153,0.4,84.64628070261519,2
2020-10-01-170211,170211,1,0,1,154,1.0,0.0,3
2020-10-02-170211,170211,0,0,1,154,1.0,150.84088748766843,4
2020-10-03-170211,170211,0,0,0,154,0.0,226.58775224275502,5
2020-10-04-170211,170211,0,0,3,154,0.4,276.9294487441327,6
2020-10-05-170211,170211,0,0,0,154,1.0,253.04863594365878,0
2020-10-06-170211,170211,3,0,0,157,2.2,251.00527950802024,1
2020-10-07-170211,170211,0,1,3,157,0.8,181.37357502040493,2
2020-10-08-170211,170211,1,0,1,158,0.2,164.54616182741358,3
2020-10-09-170211,170211,1,0,0,159,0.4,175.60886550319637,4
2020-10-10-170211,170211,1,0,2,160,0.0,12.793954777259684,5
2020-10-11-170211,170211,0,0,0,160,0.2,22.189946993042287,6
2020-10-12-170211,170211,0,0,1,160,0.2,26.88126016013596,0
2020-10-13-170211,170211,0,0,0,160,1.4,30.44424809081276,1
2020-10-14-170211,170211,2,0,12,162,0.2,65.45400686553087,2
2020-10-15-170211,170211,1,0,3,163,0.8,91.23291000741165,3
2020-10-16-170211,170211,1,0,3,164,0.8,113.50769297928935,4
2020-10-17-170211,170211,0,0,5,164,0.4,128.01632494168217,5
2020-10-18-170211,170211,3,0,4,167,0.8,122.11416721239092,6
2020-10-19-170211,170211,0,0,1,167,0.0,142.91374222604486,0
2020-10-20-170211,170211,0,0,8,167,1.8,130.59475590887462,1
2020-10-21-170211,170211,3,0,6,170,1.8,119.88871241715927,2
2020-10-22-170211,170211,1,0,6,171,3.0,140.96888545843382,3
2020-10-23-170211,170211,0,0,4,171,1.4,137.84820389721082,4
2020-10-24-170211,170211,2,1,3,173,0.4,156.44193774523953,5
2020-10-25-170211,170211,0,0,4,173,0.4,143.7681678957132,6
2020-10-26-170211,170211,1,0,12,174,1.0,134.2443326017384,0
2020-10-27-170211,170211,0,0,6,174,1.2,150.48351587937512,1
2020-10-28-170211,170211,12,1,7,186,1.0,152.6679539563386,2
2020-10-29-170211,170211,3,0,5,189,1.8,215.61081721416096,3
2020-10-30-170211,170211,3,0,5,192,1.6,197.1882574189768,4
2020-10-31-170211,170211,5,0,0,197,1.0,225.28524418934086,5
2020-11-01-170211,170211,4,0,0,201,1.6,139.37131743019162,6
2020-11-02-170211,170211,1,0,0,202,1.4,250.25554751571934,0
2020-11-03-170211,170211,8,0,0,210,1.0,204.41973684879875,1
2020-11-04-170211,170211,6,0,0,216,2.0,261.0936148705166,2
2020-11-05-170211,170211,6,0,0,222,1.4,311.0269461142954,3
2020-11-06-170211,170211,4,0,0,226,1.8,325.49562380700155,4
2020-11-07-170211,170211,3,0,0,229,0.2,335.95569975946984,5
2020-11-08-170211,170211,4,0,0,233,1.0,333.24604454444153,6
2020-11-09-170211,170211,12,0,0,245,1.6,345.5340614755484,0
2020-11-10-170211,170211,6,0,0,251,2.2,162.95686522205034,1
2020-11-11-170211,170211,7,1,0,258,2.4,206.51054854018895,2
2020-11-12-170211,170211,5,0,0,263,3.0,255.23212867621407,3
2020-11-13-170211,170211,5,0,0,268,3.4,252.01662941645333,4
2020-03-01-170212,170212,0,0,4,0,0.25,0.0,6
2020-03-02-170212,170212,0,0,16,0,0.75,224.46297822898447,0
2020-03-03-170212,170212,0,0,9,0,0.5,853.5568539940202,1
2020-03-04-170212,170212,0,0,16,0,0.75,898.2010107961514,2
2020-03-05-170212,170212,0,0,15,0,0.25,991.8103218784449,3
2020-03-06-170212,170212,0,0,10,0,0.25,836.7858023809852,4
2020-03-07-170212,170212,0,1,2,0,0.0,876.5979331066706,5
2020-03-08-170212,170212,0,0,4,0,0.25,815.9976634342909,6
2020-03-09-170212,170212,0,0,21,0,0.5,815.6107335590523,0
2020-03-10-170212,170212,1,0,13,1,2.25,4509.830401067216,1
2020-03-11-170212,170212,1,0,13,2,0.75,3807.690290069768,2
2020-03-12-170212,170212,1,0,10,3,1.75,3051.8170143071266,3
2020-03-13-170212,170212,4,0,11,7,2.5,2158.054461248849,4
2020-03-14-170212,170212,5,0,3,12,2.5,1737.326902518324,5
2020-03-15-170212,170212,4,0,7,16,3.25,1306.90037111416,6
2020-03-16-170212,170212,16,0,10,32,9.0,421.1674032615681,0
2020-03-17-170212,170212,9,0,12,41,13.0,674.348635733812,1
2020-03-18-170212,170212,16,0,6,57,17.25,844.5113106715818,2
2020-03-19-170212,170212,15,0,12,72,20.0,1146.8740252489588,3
2020-03-20-170212,170212,10,0,7,82,17.25,1347.4725921586792,4
2020-03-21-170212,170212,2,0,1,84,7.0,1544.622952173147,5
2020-03-22-170212,170212,4,0,5,88,8.75,1550.0736024625128,6
2020-03-23-170212,170212,21,0,13,109,19.5,1456.789965648181,0
2020-03-24-170212,170212,13,0,6,122,21.5,1623.9812813948904,1
2020-03-25-170212,170212,13,0,6,135,16.5,1626.1931674795624,2
2020-03-26-170212,170212,10,0,3,145,12.5,1550.3556284431343,3
2020-03-27-170212,170212,11,0,6,156,20.0,1742.0598028598047,4
2020-03-28-170212,170212,3,0,3,159,5.75,1724.3533318842894,5
2020-03-29-170212,170212,7,0,2,166,3.75,1690.068062706855,6
2020-03-30-170212,170212,10,0,8,176,13.0,1301.580047199681,0
2020-03-31-170212,170212,12,0,6,188,8.0,1161.7802899816,1
2020-04-01-170212,170212,6,0,10,194,6.25,187.88514493051318,2
2020-04-02-170212,170212,12,0,6,206,7.25,756.763200479896,3
2020-04-03-170212,170212,7,0,1,213,8.5,379.6202528047644,4
2020-04-04-170212,170212,1,0,2,214,3.0,508.96033989396415,5
2020-04-05-170212,170212,5,0,1,219,3.75,534.2310310000154,6
2020-04-06-170212,170212,13,1,4,232,9.0,583.1789658834402,0
2020-04-07-170212,170212,6,0,4,238,5.0,661.4666824201036,1
2020-04-08-170212,170212,6,0,4,244,7.0,695.6238451679657,2
2020-04-09-170212,170212,3,0,0,247,4.75,758.166279209993,3
2020-04-10-170212,170212,6,0,4,253,7.0,145.123262471523,4
2020-04-11-170212,170212,3,0,1,256,3.25,254.3032047168657,5
2020-04-12-170212,170212,2,0,1,258,1.0,326.6774470546238,6
2020-04-13-170212,170212,8,0,4,266,8.75,352.69611574620876,0
2020-04-14-170212,170212,6,0,2,272,5.75,500.74073157121126,1
2020-04-15-170212,170212,10,0,4,282,14.75,617.0091718785748,2
2020-04-16-170212,170212,6,0,3,288,7.0,787.1150460978785,3
2020-04-17-170212,170212,1,0,0,289,5.5,811.6561303790407,4
2020-04-18-170212,170212,2,0,0,291,1.0,849.9487815437384,5
2020-04-19-170212,170212,1,0,1,292,1.75,797.1526249653382,6
2020-04-20-170212,170212,4,0,0,296,6.5,808.2593691762446,0
2020-04-21-170212,170212,4,0,1,300,3.75,806.304826576554,1
2020-04-22-170212,170212,4,0,0,304,5.5,693.4448560012229,2
2020-04-23-170212,170212,0,0,1,304,0.5,686.313423140939,3
2020-04-24-170212,170212,4,0,0,308,4.0,542.2891694714845,4
2020-04-25-170212,170212,1,0,0,309,1.5,579.5601890241835,5
2020-04-26-170212,170212,1,0,1,310,1.5,555.4724141834024,6
2020-04-27-170212,170212,4,0,4,314,5.75,436.87746852544444,0
2020-04-28-170212,170212,2,0,4,316,5.0,432.5765477826457,1
2020-04-29-170212,170212,4,0,9,320,2.5,430.8725428604421,2
2020-04-30-170212,170212,3,0,5,323,5.75,529.5789697129001,3
2020-05-01-170212,170212,0,0,6,323,0.75,756.8443949331297,4
2020-05-02-170212,170212,0,0,2,323,0.75,579.317948674213,5
2020-05-03-170212,170212,1,0,0,324,0.75,269.4490508671888,6
2020-05-04-170212,170212,0,0,4,324,3.75,212.49898822800742,0
2020-05-05-170212,170212,1,0,5,325,4.75,213.5299484288374,1
2020-05-06-170212,170212,0,0,3,325,3.75,245.46317803557093,2
2020-05-07-170212,170212,1,0,5,326,4.25,259.1954063562631,3
2020-05-08-170212,170212,0,0,4,326,5.25,279.74897060778557,4
2020-05-09-170212,170212,0,0,0,326,0.0,364.9703190548539,5
2020-05-10-170212,170212,1,0,0,327,0.0,800.3558036347874,6
2020-05-11-170212,170212,4,0,3,331,3.25,733.5440004198261,0
2020-05-12-170212,170212,4,0,7,335,3.25,736.7137848373843,1
2020-05-13-170212,170212,9,0,3,344,5.5,592.5859577360246,2
2020-05-14-170212,170212,5,0,3,349,7.0,625.0013011905774,3
2020-05-15-170212,170212,6,0,2,355,6.25,637.1203219379813,4
2020-05-16-170212,170212,2,0,0,357,0.5,638.2431355394081,5
2020-05-17-170212,170212,0,0,0,357,0.0,638.6964924812694,6
2020-05-18-170212,170212,4,0,3,361,8.75,635.6160629546116,0
2020-05-19-170212,170212,5,0,1,366,3.25,689.0921220807998,1
2020-05-20-170212,170212,3,0,0,369,4.0,573.7415084756856,2
2020-05-21-170212,170212,5,0,1,374,5.25,504.9875996680649,3
2020-05-22-170212,170212,4,0,2,378,6.25,474.3132007442393,4
2020-05-23-170212,170212,0,0,0,378,0.0,564.8748874765273,5
2020-05-24-170212,170212,0,0,0,378,0.25,573.0994737145238,6
2020-05-25-170212,170212,3,0,0,381,3.5,427.12660109990486,0
2020-05-26-170212,170212,7,0,3,388,1.75,428.16023538366767,1
2020-05-27-170212,170212,3,0,2,391,1.75,495.60214262787713,2
2020-05-28-170212,170212,3,1,1,394,2.0,464.95390720631224,3
2020-05-29-170212,170212,2,0,0,396,2.25,422.3816456416161,4
2020-05-30-170212,170212,0,0,0,396,0.0,396.67372340312056,5
2020-05-31-170212,170212,0,0,0,396,0.0,400.9427046050957,6
2020-06-01-170212,170212,3,0,1,399,0.5,446.4304929078683,0
2020-06-02-170212,170212,1,0,1,400,1.0,125.15654889437342,1
2020-06-03-170212,170212,0,0,1,400,1.5,100.6476348766054,2
2020-06-04-170212,170212,1,0,0,401,1.5,99.67611118012641,3
2020-06-05-170212,170212,2,0,0,403,2.5,126.55311673482385,4
2020-06-06-170212,170212,0,0,0,403,0.25,143.58504384967983,5
2020-06-07-170212,170212,0,0,0,403,0.0,145.27181902150426,6
2020-06-08-170212,170212,0,0,2,403,1.75,146.50808496961992,0
2020-06-09-170212,170212,3,0,0,406,1.25,181.70638933605412,1
2020-06-10-170212,170212,2,0,1,408,0.75,488.4399216245753,2
2020-06-11-170212,170212,1,0,0,409,3.25,448.89104330468456,3
2020-06-12-170212,170212,0,0,2,409,0.0,403.2201322117164,4
2020-06-13-170212,170212,0,0,0,409,0.0,328.1370427774357,5
2020-06-14-170212,170212,0,0,0,409,0.5,249.71608081031076,6
2020-06-15-170212,170212,1,0,0,410,2.0,144.39283408000458,0
2020-06-16-170212,170212,1,0,1,411,0.5,183.26844182597324,1
2020-06-17-170212,170212,1,0,1,412,0.5,170.28730579333626,2
2020-06-18-170212,170212,0,0,0,412,1.0,164.45026290484273,3
2020-06-19-170212,170212,0,0,0,412,0.75,144.90998775795114,4
2020-06-20-170212,170212,0,1,0,412,0.0,171.77714850162698,5
2020-06-21-170212,170212,0,0,0,412,0.0,170.89729689763158,6
2020-06-22-170212,170212,2,0,0,414,0.5,135.31325861363598,0
2020-06-23-170212,170212,0,0,2,414,0.25,129.5595734169762,1
2020-06-24-170212,170212,1,0,1,415,0.75,118.38018060895223,2
2020-06-25-170212,170212,0,0,1,415,0.25,123.65939010837991,3
2020-06-26-170212,170212,2,0,0,417,0.25,135.94951631144,4
2020-06-27-170212,170212,0,0,0,417,0.5,123.98480104018088,5
2020-06-28-170212,170212,0,0,0,417,0.25,133.18839689330426,6
2020-06-29-170212,170212,0,0,5,417,0.0,129.56467095856,0
2020-06-30-170212,170212,1,0,0,418,0.25,115.1749938734574,1
2020-07-01-170212,170212,1,0,2,419,0.5,197.21711764752627,2
2020-07-02-170212,170212,0,0,0,419,0.0,164.4481975686557,3
2020-07-03-170212,170212,0,1,4,419,1.0,181.17623460160928,4
2020-07-04-170212,170212,0,0,1,419,0.0,233.11592553783038,5
2020-07-05-170212,170212,0,0,0,419,0.0,223.4047319330419,6
2020-07-06-170212,170212,0,0,2,419,0.0,189.64854617086127,0
2020-07-07-170212,170212,2,0,2,421,0.25,178.08032248616354,1
2020-07-08-170212,170212,1,0,3,422,0.0,154.92907195519976,2
2020-07-09-170212,170212,1,0,2,423,1.0,144.07143457819933,3
2020-07-10-170212,170212,0,0,0,423,0.25,203.30176775992018,4
2020-07-11-170212,170212,0,0,0,423,0.25,167.8939991975049,5
2020-07-12-170212,170212,0,0,0,423,0.0,125.51308854043532,6
2020-07-13-170212,170212,5,0,1,428,0.25,120.27782754474265,0
2020-07-14-170212,170212,0,0,0,428,0.5,149.03357952396863,1
2020-07-15-170212,170212,2,0,1,430,1.75,125.65186234105494,2
2020-07-16-170212,170212,0,0,4,430,0.75,122.08757126566329,3
2020-07-17-170212,170212,4,0,2,434,0.75,113.57834959189931,4
2020-07-18-170212,170212,1,0,0,435,1.0,146.0800382342583,5
2020-07-19-170212,170212,0,0,0,435,0.25,169.04818291761217,6
2020-07-20-170212,170212,2,0,2,437,1.0,137.50018720382988,0
2020-07-21-170212,170212,2,0,3,439,1.0,154.54771505249585,1
2020-07-22-170212,170212,3,0,5,442,0.75,144.53654026115916,2
2020-07-23-170212,170212,2,0,2,444,1.5,163.81566020742721,3
2020-07-24-170212,170212,0,0,1,444,1.25,155.77560329539753,4
2020-07-25-170212,170212,0,0,2,444,0.75,150.91064910416412,5
2020-07-26-170212,170212,0,0,1,444,0.5,153.4176671737385,6
2020-07-27-170212,170212,1,0,1,445,0.75,162.29891154819518,0
2020-07-28-170212,170212,0,0,2,445,2.0,169.23252663021168,1
2020-07-29-170212,170212,1,0,5,446,2.5,167.0606247252161,2
2020-07-30-170212,170212,4,0,2,450,2.5,167.93413707298544,3
2020-07-31-170212,170212,2,0,1,452,1.75,216.1922410178347,4
2020-08-01-170212,170212,0,0,0,452,0.0,87.07030952987385,5
2020-08-02-170212,170212,0,0,0,452,0.5,545.3193142885796,6
2020-08-03-170212,170212,2,0,4,454,0.75,574.1003579183418,0
2020-08-04-170212,170212,3,0,1,457,1.25,567.9641242935047,1
2020-08-05-170212,170212,5,0,3,462,2.25,560.0841823412943,2
2020-08-06-170212,170212,2,0,2,464,1.25,586.4441870314918,3
2020-08-07-170212,170212,1,0,4,465,1.25,560.6381983950434,4
2020-08-08-170212,170212,2,0,3,467,1.75,572.5199734768781,5
2020-08-09-170212,170212,1,0,3,468,0.25,576.782275401081,6
2020-08-10-170212,170212,1,0,10,469,4.5,62.12080390594953,0
2020-08-11-170212,170212,2,0,4,471,4.25,143.87893374862642,1
2020-08-12-170212,170212,5,0,6,476,5.25,231.58479918499995,2
2020-08-13-170212,170212,2,0,0,478,2.5,308.60337797555314,3
2020-08-14-170212,170212,1,0,2,479,2.0,366.61271906490055,4
2020-08-15-170212,170212,0,0,2,479,0.25,418.9102344278035,5
2020-08-16-170212,170212,0,0,5,479,2.0,428.87887498141333,6
2020-08-17-170212,170212,4,0,6,483,3.25,471.2136965336719,0
2020-08-18-170212,170212,1,0,5,484,4.0,458.0611670489155,1
2020-08-19-170212,170212,3,0,8,487,2.75,493.1176185802979,2
2020-08-20-170212,170212,2,0,3,489,2.5,434.48767292348896,3
2020-08-21-170212,170212,4,0,2,493,2.25,445.9719727223784,4
2020-08-22-170212,170212,3,0,1,496,3.5,500.9082299039204,5
2020-08-23-170212,170212,3,0,3,499,1.0,528.4027964150002,6
2020-08-24-170212,170212,10,0,9,509,5.5,506.9283736611283,0
2020-08-25-170212,170212,4,0,2,513,3.5,523.7362749867298,1
2020-08-26-170212,170212,6,0,3,519,3.0,538.7619851050199,2
2020-08-27-170212,170212,0,0,13,519,6.5,600.2626385780022,3
2020-08-28-170212,170212,2,0,6,521,2.75,591.9035447486804,4
2020-08-29-170212,170212,2,0,9,523,2.75,583.8463782414564,5
2020-08-30-170212,170212,5,0,12,528,2.75,557.3052583766754,6
2020-08-31-170212,170212,6,0,18,534,6.75,488.42597487511625,0
2020-09-01-170212,170212,5,0,18,539,7.5,531.2889889225714,1
2020-09-02-170212,170212,8,0,15,547,5.5,1044.7229326705442,2
2020-09-03-170212,170212,3,0,14,550,5.75,848.1130981465565,3
2020-09-04-170212,170212,2,0,17,552,6.0,850.0517616896088,4
2020-09-05-170212,170212,1,0,0,553,2.25,827.7579570114095,5
2020-09-06-170212,170212,3,0,3,556,1.75,842.7749458139505,6
2020-09-07-170212,170212,9,0,17,565,4.5,865.9087459341674,0
2020-09-08-170212,170212,2,0,13,567,6.5,848.7933803356311,1
2020-09-09-170212,170212,3,0,13,570,8.0,861.1284588181654,2
2020-09-10-170212,170212,13,0,9,583,5.75,640.4776955491706,3
2020-09-11-170212,170212,6,1,8,589,6.5,690.3407284099501,4
2020-09-12-170212,170212,9,0,2,598,2.0,788.7263183726484,5
2020-09-13-170212,170212,12,0,0,610,2.75,840.5059752879937,6
2020-09-14-170212,170212,18,0,11,628,7.75,919.6371554005801,0
2020-09-15-170212,170212,18,0,9,646,9.25,1066.2191965339234,1
2020-09-16-170212,170212,15,0,12,661,6.5,1239.1941110342304,2
2020-09-17-170212,170212,14,0,9,675,12.5,1155.4873059192523,3
2020-09-18-170212,170212,17,0,13,692,7.25,1217.6329583617826,4
2020-09-19-170212,170212,0,0,5,692,1.0,1260.9598757167446,5
2020-09-20-170212,170212,3,1,3,695,1.0,1196.5470185174925,6
2020-09-21-170212,170212,17,0,5,712,8.5,1014.3810113330732,0
2020-09-22-170212,170212,13,0,15,725,8.75,1005.7945729211174,1
2020-09-23-170212,170212,13,0,7,738,7.5,982.7674139581829,2
2020-09-24-170212,170212,9,0,6,747,5.0,976.2284215245917,3
2020-09-25-170212,170212,8,0,11,755,4.5,863.1354908723396,4
2020-09-26-170212,170212,2,0,7,757,1.25,992.5703871751288,5
2020-09-27-170212,170212,0,0,2,757,1.0,877.5665238538425,6
2020-09-28-170212,170212,11,0,12,768,6.0,872.761296900401,0
2020-09-29-170212,170212,9,0,36,777,5.5,904.2713223986073,1
2020-09-30-170212,170212,12,0,7,789,5.25,876.9649148366036,2
2020-10-01-170212,170212,9,0,21,798,7.25,0.0,3
2020-10-02-170212,170212,13,1,12,811,8.75,2371.447558530742,4
2020-10-03-170212,170212,5,0,2,816,2.5,3449.936123816531,5
2020-10-04-170212,170212,3,0,5,819,1.25,3494.8547490095884,6
2020-10-05-170212,170212,5,1,23,824,4.0,2879.510294144883,0
2020-10-06-170212,170212,15,0,14,839,5.0,2467.4376577273797,1
2020-10-07-170212,170212,7,0,19,846,6.75,2069.2050904484704,2
2020-10-08-170212,170212,6,1,17,852,8.0,1820.726952382587,3
2020-10-09-170212,170212,11,3,8,863,13.5,1956.682310877126,4
2020-10-10-170212,170212,7,0,7,870,2.25,156.10261126114716,5
2020-10-11-170212,170212,2,0,4,872,4.5,261.2918440149616,6
2020-10-12-170212,170212,12,0,22,884,7.75,402.3216873912396,0
2020-10-13-170212,170212,36,0,18,920,8.25,606.2840794005529,1
2020-10-14-170212,170212,7,0,18,927,4.75,1056.385908051333,2
2020-10-15-170212,170212,21,0,25,948,13.25,1274.1281833187486,3
2020-10-16-170212,170212,12,0,17,960,10.75,1769.811818647947,4
2020-10-17-170212,170212,2,0,4,962,2.5,2023.7346397489928,5
2020-10-18-170212,170212,5,0,14,967,1.5,2031.9973994098054,6
2020-10-19-170212,170212,23,0,4,990,14.25,2006.2803927688306,0
2020-10-20-170212,170212,14,0,30,1004,12.5,2176.6630351646145,1
2020-10-21-170212,170212,19,0,21,1023,21.5,2377.8090431632254,2
2020-10-22-170212,170212,17,0,15,1040,19.75,2376.982735065883,3
2020-10-23-170212,170212,8,1,28,1048,16.75,2540.6892432201766,4
2020-10-24-170212,170212,7,0,10,1055,6.0,2920.192605148668,5
2020-10-25-170212,170212,4,0,11,1059,11.0,3050.8625718946396,6
2020-10-26-170212,170212,22,1,33,1081,18.75,2710.003588588803,0
2020-10-27-170212,170212,18,0,11,1099,19.75,3216.3333954016935,1
2020-10-28-170212,170212,18,1,16,1117,21.25,3370.8812040050034,2
2020-10-29-170212,170212,25,1,15,1142,19.0,3471.8841110424105,3
2020-10-30-170212,170212,17,1,19,1159,21.25,3116.402877138606,4
2020-10-31-170212,170212,4,0,0,1163,9.0,3554.3205601080926,5
2020-11-01-170212,170212,14,3,0,1177,17.5,1495.5056021518417,6
2020-11-02-170212,170212,4,1,0,1181,20.0,3572.4290705290314,0
2020-11-03-170212,170212,30,0,0,1211,20.0,3208.425598037705,1
2020-11-04-170212,170212,21,0,0,1232,17.0,3754.17562745779,2
2020-11-05-170212,170212,15,0,0,1247,22.5,3847.3184336838194,3
2020-11-06-170212,170212,28,0,0,1275,32.25,4046.1293884240445,4
2020-11-07-170212,170212,10,0,0,1285,16.75,4163.373386295042,5
2020-11-08-170212,170212,11,0,0,1296,12.75,3983.4539934752456,6
2020-11-09-170212,170212,33,0,0,1329,26.25,3980.090065124301,0
2020-11-10-170212,170212,11,1,0,1340,23.25,1680.5126476916316,1
2020-11-11-170212,170212,16,1,0,1356,22.5,2163.623349101565,2
2020-11-12-170212,170212,15,3,0,1371,22.0,2567.326986020369,3
2020-11-13-170212,170212,19,0,0,1390,38.5,2962.6828521879524,4
2020-03-01-170213,170213,1,0,3,1,0.25,0.0,6
2020-03-02-170213,170213,0,0,12,1,0.75,18.487941883113862,0
2020-03-03-170213,170213,0,0,20,1,0.5,69.85583443796894,1
2020-03-04-170213,170213,1,0,16,2,0.25,73.27851713796606,2
2020-03-05-170213,170213,1,2,19,3,0.5,80.95847697367881,3
2020-03-06-170213,170213,0,0,16,3,0.0,68.17187301418656,4
2020-03-07-170213,170213,0,0,6,3,0.0,71.38744561988428,5
2020-03-08-170213,170213,0,0,16,3,0.5,66.28736362627872,6
2020-03-09-170213,170213,0,0,19,3,0.75,66.28151791651584,0
2020-03-10-170213,170213,2,0,20,5,2.75,367.98513145824165,1
2020-03-11-170213,170213,0,0,19,5,2.5,311.0947333823823,2
2020-03-12-170213,170213,1,0,16,6,2.5,249.6484365325426,3
2020-03-13-170213,170213,4,0,22,10,3.5,176.9003630726507,4
2020-03-14-170213,170213,2,0,8,12,3.25,142.74716454287233,5
2020-03-15-170213,170213,3,0,3,15,5.0,107.82119645582698,6
2020-03-16-170213,170213,12,0,16,27,12.75,34.807257014202044,0
2020-03-17-170213,170213,20,0,9,47,12.0,55.8623731864577,1
2020-03-18-170213,170213,16,0,6,63,20.25,70.08210621979202,2
2020-03-19-170213,170213,19,0,8,82,22.75,95.50578198147537,3
2020-03-20-170213,170213,16,0,8,98,21.25,112.56079137458994,4
2020-03-21-170213,170213,6,0,2,104,9.75,129.1046522915751,5
2020-03-22-170213,170213,16,1,3,120,8.75,129.59358100873845,6
2020-03-23-170213,170213,19,0,4,139,25.75,121.61301116655403,0
2020-03-24-170213,170213,20,2,5,159,23.5,135.5133087876852,1
2020-03-25-170213,170213,19,0,5,178,17.25,135.64957308583212,2
2020-03-26-170213,170213,16,0,2,194,14.25,129.27224840816598,3
2020-03-27-170213,170213,22,0,4,216,20.0,144.95594219574247,4
2020-03-28-170213,170213,8,1,5,224,6.0,143.57263394839546,5
2020-03-29-170213,170213,3,0,1,227,6.75,140.73182297110424,6
2020-03-30-170213,170213,16,0,5,243,14.5,108.53640726446251,0
2020-03-31-170213,170213,9,0,3,252,11.0,96.64756847126993,1
2020-04-01-170213,170213,6,0,35,258,8.5,15.624799268643358,2
2020-04-02-170213,170213,8,0,9,266,10.0,62.63180538452872,3
2020-04-03-170213,170213,8,0,3,274,10.75,31.439987054473242,4
2020-04-04-170213,170213,2,0,2,276,3.25,42.207737500729394,5
2020-04-05-170213,170213,3,0,2,279,6.0,44.274529008646645,6
2020-04-06-170213,170213,4,0,7,283,13.75,48.43381427504332,0
2020-04-07-170213,170213,5,2,0,288,6.0,55.01638895871666,1
2020-04-08-170213,170213,5,1,2,293,7.5,57.84335600113803,2
2020-04-09-170213,170213,2,0,0,295,6.5,63.11924690915657,3
2020-04-10-170213,170213,4,0,3,299,9.0,11.968863105557208,4
2020-04-11-170213,170213,5,0,0,304,3.0,21.004007974642033,5
2020-04-12-170213,170213,1,0,1,305,2.0,26.96275186942073,6
2020-04-13-170213,170213,5,0,1,310,11.25,29.104112428574155,0
2020-04-14-170213,170213,3,0,5,313,8.25,41.40487246768272,1
2020-04-15-170213,170213,35,0,0,348,11.75,51.02100254124284,2
2020-04-16-170213,170213,9,0,3,357,8.0,65.0314030345067,3
2020-04-17-170213,170213,3,0,1,360,7.5,67.01413837596155,4
2020-04-18-170213,170213,2,0,0,362,1.75,69.93194304196612,5
2020-04-19-170213,170213,2,0,0,364,2.0,65.49595696425118,6
2020-04-20-170213,170213,7,0,4,371,7.25,66.39450232687727,0
2020-04-21-170213,170213,0,0,6,371,6.0,66.24887502300176,1
2020-04-22-170213,170213,2,0,4,373,7.25,56.67642776828592,2
2020-04-23-170213,170213,0,0,2,373,1.75,55.99472572502648,3
2020-04-24-170213,170213,3,1,4,376,4.0,44.26179177203428,4
2020-04-25-170213,170213,0,0,0,376,1.5,47.29846618349002,5
2020-04-26-170213,170213,1,0,0,377,1.25,45.25339310996214,6
2020-04-27-170213,170213,1,0,2,378,7.25,35.48509694250414,0
2020-04-28-170213,170213,5,0,2,383,5.75,35.0889974239635,1
2020-04-29-170213,170213,0,1,2,383,4.75,35.02461927926689,2
2020-04-30-170213,170213,3,0,4,386,5.75,43.102845384705326,3
2020-05-01-170213,170213,1,0,1,387,0.75,62.039174799772795,4
2020-05-02-170213,170213,0,0,1,387,0.75,47.31773034674077,5
2020-05-03-170213,170213,0,0,0,387,1.5,21.93807210802111,6
2020-05-04-170213,170213,4,0,5,391,3.25,17.341195710689842,0
2020-05-05-170213,170213,6,0,1,397,4.5,17.407983935333515,1
2020-05-06-170213,170213,4,0,3,401,4.25,20.11846756378477,2
2020-05-07-170213,170213,2,0,3,403,4.5,21.167295198466736,3
2020-05-08-170213,170213,4,0,10,407,3.5,22.8796623169851,4
2020-05-09-170213,170213,0,0,0,407,0.0,29.77915029542269,5
2020-05-10-170213,170213,0,0,0,407,0.25,65.60988313668213,6
2020-05-11-170213,170213,2,0,4,409,5.25,60.20537966849825,0
2020-05-12-170213,170213,2,2,2,411,5.0,60.24290097945256,1
2020-05-13-170213,170213,2,0,0,413,8.0,48.39920001345822,2
2020-05-14-170213,170213,4,0,1,417,9.25,51.08055459582333,3
2020-05-15-170213,170213,1,0,1,418,8.5,51.97636858602408,4
2020-05-16-170213,170213,1,0,0,419,1.0,51.94031826597952,5
2020-05-17-170213,170213,0,0,0,419,0.0,51.96941644391268,6
2020-05-18-170213,170213,5,0,2,424,10.25,51.665484069886475,0
2020-05-19-170213,170213,1,0,0,425,5.5,56.16170518172794,1
2020-05-20-170213,170213,3,0,1,428,4.75,46.67636772125637,2
2020-05-21-170213,170213,3,0,1,431,6.0,41.01352165076554,3
2020-05-22-170213,170213,10,0,3,441,5.75,38.51308974811215,4
2020-05-23-170213,170213,0,0,0,441,0.0,45.96486441904629,5
2020-05-24-170213,170213,0,0,0,441,0.25,46.59138647850495,6
2020-05-25-170213,170213,4,0,1,445,5.0,34.690438654438935,0
2020-05-26-170213,170213,2,0,2,447,3.25,34.68712678789626,1
2020-05-27-170213,170213,0,0,2,447,3.25,40.1894088465793,2
2020-05-28-170213,170213,1,0,5,448,3.0,37.716911241530376,3
2020-05-29-170213,170213,1,2,0,449,3.0,34.25454863868691,4
2020-05-30-170213,170213,0,0,0,449,0.0,32.07598571244111,5
2020-05-31-170213,170213,0,0,0,449,0.0,32.43572514592128,6
2020-06-01-170213,170213,2,0,2,451,1.5,36.149877309540386,0
2020-06-02-170213,170213,0,0,1,451,1.5,10.130012683837698,1
2020-06-03-170213,170213,1,0,0,452,1.5,8.184929034559321,2
2020-06-04-170213,170213,1,0,0,453,1.5,8.047829524634299,3
2020-06-05-170213,170213,3,0,2,456,2.5,10.225088519296719,4
2020-06-06-170213,170213,0,2,0,456,0.75,11.548022305571827,5
2020-06-07-170213,170213,0,0,0,456,0.0,11.635061211072879,6
2020-06-08-170213,170213,1,0,1,457,2.0,11.726381195042709,0
2020-06-09-170213,170213,2,0,0,459,2.0,14.533145061818848,1
2020-06-10-170213,170213,2,0,0,461,1.0,39.42787984794485,2
2020-06-11-170213,170213,5,0,0,466,2.25,36.18443555977137,3
2020-06-12-170213,170213,0,0,0,466,0.25,32.413263403878716,4
2020-06-13-170213,170213,0,0,0,466,0.0,26.385501452454633,5
2020-06-14-170213,170213,0,0,1,466,0.5,19.96692753883821,6
2020-06-15-170213,170213,2,0,0,468,1.75,11.53996914766741,0
2020-06-16-170213,170213,1,0,0,469,0.75,14.665834255296573,1
2020-06-17-170213,170213,0,0,1,469,0.75,13.656382658162718,2
2020-06-18-170213,170213,0,0,0,469,1.5,13.218353317679785,3
2020-06-19-170213,170213,2,0,2,471,0.25,11.625171282276241,4
2020-06-20-170213,170213,0,0,0,471,0.0,13.845755432990183,5
2020-06-21-170213,170213,0,0,0,471,0.0,13.763067060674105,6
2020-06-22-170213,170213,1,0,0,472,1.0,10.902432483588079,0
2020-06-23-170213,170213,0,0,0,472,0.0,10.403709093559247,1
2020-06-24-170213,170213,0,0,0,472,1.25,9.523960819580388,2
2020-06-25-170213,170213,0,0,0,472,0.75,9.965605407127349,3
2020-06-26-170213,170213,0,0,0,472,1.0,10.971851819456461,4
2020-06-27-170213,170213,0,0,0,472,0.25,9.98507173710885,5
2020-06-28-170213,170213,1,0,0,473,0.0,10.751214552455648,6
2020-06-29-170213,170213,0,0,0,473,0.0,10.459190301518671,0
2020-06-30-170213,170213,0,0,0,473,0.5,9.280339344281996,1
2020-07-01-170213,170213,1,0,3,474,0.5,15.771913041896958,2
2020-07-02-170213,170213,0,0,1,474,0.0,13.288229803433598,3
2020-07-03-170213,170213,2,0,1,476,0.25,14.657315538254254,4
2020-07-04-170213,170213,0,0,0,476,0.0,18.82206537659717,5
2020-07-05-170213,170213,0,0,1,476,0.0,18.00822892104022,6
2020-07-06-170213,170213,0,0,1,476,0.0,15.300676028187087,0
2020-07-07-170213,170213,0,0,0,476,1.0,14.353907771416115,1
2020-07-08-170213,170213,0,1,1,476,0.25,12.524834758698308,2
2020-07-09-170213,170213,0,0,3,476,1.0,11.651719287734014,3
2020-07-10-170213,170213,0,0,1,476,0.5,16.25667048661872,4
2020-07-11-170213,170213,0,0,1,476,0.25,13.382392585942558,5
2020-07-12-170213,170213,0,0,0,476,0.0,10.031176867562593,6
2020-07-13-170213,170213,0,0,1,476,2.0,9.656151110928999,0
2020-07-14-170213,170213,0,0,4,476,0.75,12.029720155318184,1
2020-07-15-170213,170213,3,0,6,479,3.75,10.18665066573379,2
2020-07-16-170213,170213,1,0,2,480,0.5,9.90910773704469,3
2020-07-17-170213,170213,1,0,5,481,1.5,9.232456940816245,4
2020-07-18-170213,170213,0,0,0,481,1.5,11.889904888032271,5
2020-07-19-170213,170213,1,0,0,482,0.25,13.713536762192925,6
2020-07-20-170213,170213,1,0,0,483,1.5,11.090537720859881,0
2020-07-21-170213,170213,0,0,2,483,1.75,12.47484919386039,1
2020-07-22-170213,170213,1,0,1,484,1.25,11.677232554510358,2
2020-07-23-170213,170213,3,0,0,487,1.0,13.236184945432123,3
2020-07-24-170213,170213,1,0,0,488,1.0,12.62298369551235,4
2020-07-25-170213,170213,1,0,0,489,0.5,12.261360769823682,5
2020-07-26-170213,170213,0,0,1,489,0.5,12.45871342751273,6
2020-07-27-170213,170213,1,0,7,490,1.25,13.18991228373892,0
2020-07-28-170213,170213,4,0,3,494,1.25,13.726140281070556,1
2020-07-29-170213,170213,6,0,5,500,1.25,13.530614550817013,2
2020-07-30-170213,170213,2,0,3,502,4.0,13.56467519763029,3
2020-07-31-170213,170213,5,0,2,507,1.75,17.491501690811795,4
2020-08-01-170213,170213,0,0,0,507,0.0,7.0115431806552,5
2020-08-02-170213,170213,0,0,1,507,0.25,43.93932642249776,6
2020-08-03-170213,170213,0,0,4,507,1.75,46.24800779679308,0
2020-08-04-170213,170213,2,0,4,509,2.25,45.75052462445307,1
2020-08-05-170213,170213,1,0,2,510,3.25,45.35864413377685,2
2020-08-06-170213,170213,0,0,0,510,3.0,47.57726245434835,3
2020-08-07-170213,170213,0,0,3,510,2.0,45.57210538004537,4
2020-08-08-170213,170213,0,0,4,510,2.0,46.51221077240234,5
2020-08-09-170213,170213,1,0,0,511,1.0,46.889749502161294,6
2020-08-10-170213,170213,7,0,4,518,2.25,4.99990760621221,0
2020-08-11-170213,170213,3,0,2,521,4.5,11.647125710594018,1
2020-08-12-170213,170213,5,0,1,526,5.0,18.786410709602546,2
2020-08-13-170213,170213,3,0,13,529,2.75,25.04902171059222,3
2020-08-14-170213,170213,2,0,3,531,1.75,29.641398967138237,4
2020-08-15-170213,170213,0,0,7,531,1.25,33.82307692449663,5
2020-08-16-170213,170213,1,0,4,532,1.5,34.65842143102892,6
2020-08-17-170213,170213,4,0,10,536,3.25,38.110873117882946,0
2020-08-18-170213,170213,4,0,5,540,3.5,37.04311720264475,1
2020-08-19-170213,170213,2,0,1,542,2.5,39.82228858693048,2
2020-08-20-170213,170213,0,0,8,542,2.75,35.13948197385339,3
2020-08-21-170213,170213,3,0,6,545,2.5,36.1034448843005,4
2020-08-22-170213,170213,4,0,1,549,2.75,40.553939065461904,5
2020-08-23-170213,170213,0,0,2,549,2.0,42.724950310173114,6
2020-08-24-170213,170213,4,0,3,553,7.25,41.02866736925049,0
2020-08-25-170213,170213,2,0,8,555,5.25,42.42906192453912,1
2020-08-26-170213,170213,1,0,11,556,6.25,43.656624606359756,2
2020-08-27-170213,170213,13,0,7,569,3.5,48.53460166959529,3
2020-08-28-170213,170213,3,0,5,572,3.75,47.84435059531653,4
2020-08-29-170213,170213,7,0,2,579,1.5,47.13026844006675,5
2020-08-30-170213,170213,4,0,3,583,4.5,44.92411712108064,6
2020-08-31-170213,170213,10,0,14,593,6.75,39.36360803936846,0
2020-09-01-170213,170213,5,0,11,598,6.0,43.10318544297175,1
2020-09-02-170213,170213,1,0,4,599,9.25,84.97320546375256,2
2020-09-03-170213,170213,8,0,16,607,7.0,68.60411962296641,3
2020-09-04-170213,170213,6,0,4,613,8.0,68.76926673269588,4
2020-09-05-170213,170213,1,0,0,614,3.25,67.11237667579404,5
2020-09-06-170213,170213,2,0,3,616,2.25,68.27931619737586,6
2020-09-07-170213,170213,3,0,16,619,7.25,70.20877197165875,0
2020-09-08-170213,170213,8,0,7,627,7.0,68.8898535979134,1
2020-09-09-170213,170213,11,0,2,638,7.0,69.86069657297068,2
2020-09-10-170213,170213,7,0,3,645,12.5,51.916886472634644,3
2020-09-11-170213,170213,5,0,3,650,10.0,55.91999648789829,4
2020-09-12-170213,170213,2,0,0,652,3.5,63.97764552703448,5
2020-09-13-170213,170213,3,0,1,655,5.25,68.29842534924833,6
2020-09-14-170213,170213,14,0,4,669,9.75,74.77121248685347,0
2020-09-15-170213,170213,11,0,5,680,16.75,86.73234561100034,1
2020-09-16-170213,170213,4,0,2,684,12.5,100.89872947476448,2
2020-09-17-170213,170213,16,0,5,700,14.75,94.11458135955536,3
2020-09-18-170213,170213,4,2,8,704,14.75,99.18056137473768,4
2020-09-19-170213,170213,0,0,2,704,2.5,102.75700907498228,5
2020-09-20-170213,170213,3,1,0,707,1.0,97.29419866970885,6
2020-09-21-170213,170213,16,0,3,723,16.25,82.3926647017337,0
2020-09-22-170213,170213,7,0,6,730,14.75,81.70088874356036,1
2020-09-23-170213,170213,2,0,3,732,14.0,79.6174494585157,2
2020-09-24-170213,170213,3,1,6,735,8.75,78.97381627346884,3
2020-09-25-170213,170213,3,1,15,738,10.75,69.57772600042841,4
2020-09-26-170213,170213,0,0,1,738,1.0,79.934870233245,5
2020-09-27-170213,170213,1,0,3,739,1.0,70.6791647752681,6
2020-09-28-170213,170213,4,0,8,743,9.5,70.25261875873454,0
2020-09-29-170213,170213,5,0,5,748,5.5,72.69324231943861,1
2020-09-30-170213,170213,2,0,5,750,8.25,70.90308073967796,2
2020-10-01-170213,170213,5,0,15,755,10.75,0.0,3
2020-10-02-170213,170213,8,0,13,763,16.75,191.65675596356996,4
2020-10-03-170213,170213,2,1,1,765,3.75,277.6146572374494,5
2020-10-04-170213,170213,0,0,2,765,3.75,280.87525476161886,6
2020-10-05-170213,170213,3,0,12,768,6.75,231.48443439398872,0
2020-10-06-170213,170213,6,0,10,774,8.0,198.25459269051564,1
2020-10-07-170213,170213,3,0,21,777,9.75,166.67180248098396,2
2020-10-08-170213,170213,6,0,11,783,10.25,147.12929138005217,3
2020-10-09-170213,170213,15,1,17,798,16.25,158.05745613488702,4
2020-10-10-170213,170213,1,0,1,799,4.25,12.691615817434243,5
2020-10-11-170213,170213,3,0,17,802,4.5,21.265482976318992,6
2020-10-12-170213,170213,8,0,13,810,8.75,32.67760002455181,0
2020-10-13-170213,170213,5,0,20,815,18.25,49.29595275842553,1
2020-10-14-170213,170213,5,0,22,820,6.75,85.8088911929923,2
2020-10-15-170213,170213,15,0,25,835,20.5,103.33999185866637,3
2020-10-16-170213,170213,13,0,21,848,13.25,143.4278647442051,4
2020-10-17-170213,170213,1,0,3,849,2.25,163.6469610029765,5
2020-10-18-170213,170213,2,0,20,851,3.5,164.14593181758713,6
2020-10-19-170213,170213,12,0,16,863,21.25,162.1504503835078,0
2020-10-20-170213,170213,10,0,15,873,14.25,175.5900278142276,1
2020-10-21-170213,170213,21,0,19,894,25.25,191.65726898644596,2
2020-10-22-170213,170213,11,0,21,905,24.75,191.42757437049403,3
2020-10-23-170213,170213,17,0,31,922,16.75,204.8626119764489,4
2020-10-24-170213,170213,1,0,17,923,8.5,235.48606507385426,5
2020-10-25-170213,170213,17,0,17,940,10.0,246.40558991359433,6
2020-10-26-170213,170213,13,0,12,953,26.0,218.79007167015314,0
2020-10-27-170213,170213,20,0,22,973,21.0,259.30971745598686,1
2020-10-28-170213,170213,22,1,17,995,24.5,271.9322168508245,2
2020-10-29-170213,170213,25,0,19,1020,23.5,280.12518127743704,3
2020-10-30-170213,170213,21,1,30,1041,26.75,251.26831114271238,4
2020-10-31-170213,170213,3,1,0,1044,13.0,286.7075687071448,5
2020-11-01-170213,170213,20,1,0,1064,22.75,121.21243606113164,6
2020-11-02-170213,170213,16,1,0,1080,16.5,289.6697467450472,0
2020-11-03-170213,170213,15,0,0,1095,28.5,260.69556200056206,1
2020-11-04-170213,170213,19,1,0,1114,23.0,304.52906055399603,2
2020-11-05-170213,170213,21,0,0,1135,28.25,312.2846285197278,3
2020-11-06-170213,170213,31,2,0,1166,35.5,327.88393101932525,4
2020-11-07-170213,170213,17,1,0,1183,16.0,337.2783870777355,5
2020-11-08-170213,170213,17,1,0,1200,13.75,322.52568970021855,6
2020-11-09-170213,170213,12,0,0,1212,33.5,322.14406453183545,0
2020-11-10-170213,170213,22,1,0,1234,25.0,136.1106973928538,1
2020-11-11-170213,170213,17,0,0,1251,27.25,175.61748517349332,2
2020-11-12-170213,170213,19,0,0,1270,25.25,208.30019635475242,3
2020-11-13-170213,170213,30,1,0,1300,38.25,240.31856673465936,4
2020-03-01-170214,170214,0,0,1,0,0.3333333333333333,0.0,6
2020-03-02-170214,170214,0,0,7,0,0.0,208.4904674113446,0
2020-03-03-170214,170214,0,0,11,0,0.0,784.2416200699367,1
2020-03-04-170214,170214,0,0,22,0,0.3333333333333333,820.691230171497,2
2020-03-05-170214,170214,0,0,14,0,0.6666666666666666,907.0214273284366,3
2020-03-06-170214,170214,0,1,14,0,0.3333333333333333,762.6622454508622,4
2020-03-07-170214,170214,0,0,9,0,0.0,798.3855104843695,5
2020-03-08-170214,170214,0,0,4,0,0.16666666666666666,740.0770439262599,6
2020-03-09-170214,170214,0,0,14,0,0.8333333333333334,740.219000813116,0
2020-03-10-170214,170214,5,0,21,5,1.1666666666666667,4120.995217610168,1
2020-03-11-170214,170214,2,0,14,7,1.5,3487.2324288455975,2
2020-03-12-170214,170214,0,0,5,7,0.8333333333333334,2801.0081057825428,3
2020-03-13-170214,170214,2,0,25,9,3.1666666666666665,1987.7511707207093,4
2020-03-14-170214,170214,1,0,3,10,2.6666666666666665,1606.838663439653,5
2020-03-15-170214,170214,1,0,6,11,3.0,1217.0999054978251,6
2020-03-16-170214,170214,7,0,10,18,8.333333333333334,393.4206621428782,0
2020-03-17-170214,170214,11,0,8,29,9.833333333333334,632.3456844511262,1
2020-03-18-170214,170214,22,0,4,51,13.666666666666664,794.292384558384,2
2020-03-19-170214,170214,14,0,7,65,13.5,1085.0173472529248,3
2020-03-20-170214,170214,14,0,7,79,16.5,1281.4498444084522,4
2020-03-21-170214,170214,9,0,5,88,5.666666666666668,1470.4041189866412,5
2020-03-22-170214,170214,4,1,5,92,7.666666666666668,1476.1550862466406,6
2020-03-23-170214,170214,14,0,6,106,19.5,1383.850236293336,0
2020-03-24-170214,170214,21,0,5,127,14.333333333333336,1541.7354753915115,1
2020-03-25-170214,170214,14,0,7,141,14.166666666666664,1542.9666884407252,2
2020-03-26-170214,170214,5,0,7,146,13.166666666666664,1470.1264990035695,3
2020-03-27-170214,170214,25,0,4,171,14.5,1646.1420704614775,4
2020-03-28-170214,170214,3,0,4,174,5.833333333333332,1631.182219285024,5
2020-03-29-170214,170214,6,0,0,180,5.0,1599.0450964807023,6
2020-03-30-170214,170214,10,0,7,190,13.166666666666664,1234.3910309432235,0
2020-03-31-170214,170214,8,0,3,198,8.0,1097.4452529439727,1
2020-04-01-170214,170214,4,0,4,202,7.833333333333332,177.32773994917255,2
2020-04-02-170214,170214,7,0,3,209,8.166666666666666,708.557745965261,3
2020-04-03-170214,170214,7,0,4,216,8.833333333333334,355.8282136376987,4
2020-04-04-170214,170214,5,0,0,221,2.1666666666666665,478.14182414975716,5
2020-04-05-170214,170214,5,0,3,226,3.8333333333333335,501.35135150826005,6
2020-04-06-170214,170214,6,0,9,232,7.833333333333332,549.2412745763681,0
2020-04-07-170214,170214,5,0,4,237,5.833333333333332,624.533542925999,1
2020-04-08-170214,170214,7,20,5,244,6.333333333333332,656.5871248580263,2
2020-04-09-170214,170214,7,0,0,251,8.333333333333334,717.0245117480982,3
2020-04-10-170214,170214,4,0,5,255,5.666666666666668,135.1144209008911,4
2020-04-11-170214,170214,4,0,0,259,5.833333333333332,237.33778294253682,5
2020-04-12-170214,170214,0,0,1,259,3.333333333333333,304.5897119956783,6
2020-04-13-170214,170214,7,0,6,266,7.0,328.74699991796706,0
2020-04-14-170214,170214,3,0,5,269,5.333333333333333,468.29177753976023,1
2020-04-15-170214,170214,4,0,3,273,18.5,577.051228592839,2
2020-04-16-170214,170214,3,0,6,276,6.333333333333332,734.9632770890788,3
2020-04-17-170214,170214,4,0,1,280,12.833333333333336,756.8851701656262,4
2020-04-18-170214,170214,0,0,1,280,2.833333333333333,787.8874101064132,5
2020-04-19-170214,170214,3,0,0,283,5.666666666666668,737.0282903689906,6
2020-04-20-170214,170214,9,1,3,292,6.833333333333332,747.012152738351,0
2020-04-21-170214,170214,4,0,9,296,3.8333333333333335,745.4535080919823,1
2020-04-22-170214,170214,5,0,4,301,7.5,635.2919628853388,2
2020-04-23-170214,170214,0,0,8,301,1.6666666666666667,626.8545567821584,3
2020-04-24-170214,170214,5,0,3,306,3.6666666666666665,495.6857997172359,4
2020-04-25-170214,170214,0,0,0,306,1.1666666666666667,529.6254529607322,5
2020-04-26-170214,170214,1,0,0,307,0.6666666666666666,506.0421689363294,6
2020-04-27-170214,170214,6,0,2,313,5.166666666666667,395.960408885697,0
2020-04-28-170214,170214,5,0,4,318,3.8333333333333335,391.11238986566366,1
2020-04-29-170214,170214,3,0,6,321,3.6666666666666665,390.94337308476236,2
2020-04-30-170214,170214,6,0,5,327,2.5,481.61453867266727,3
2020-05-01-170214,170214,1,0,6,328,0.6666666666666666,696.7522002661917,4
2020-05-02-170214,170214,1,0,0,329,0.0,529.977480346231,5
2020-05-03-170214,170214,0,0,0,329,0.8333333333333334,245.24259801132553,6
2020-05-04-170214,170214,3,0,10,332,3.1666666666666665,194.20102987639117,0
2020-05-05-170214,170214,9,0,4,341,3.5,194.76057062808786,1
2020-05-06-170214,170214,4,0,3,345,2.833333333333333,225.95912429247346,2
2020-05-07-170214,170214,8,0,4,353,1.6666666666666667,237.16954400614333,3
2020-05-08-170214,170214,3,0,7,356,3.0,256.608289629761,4
2020-05-09-170214,170214,0,0,0,356,0.0,333.4208052028607,5
2020-05-10-170214,170214,0,0,0,356,0.5,737.0833089232832,6
2020-05-11-170214,170214,2,0,2,358,3.1666666666666665,676.9142337286372,0
2020-05-12-170214,170214,4,0,1,362,3.0,675.6382344891047,1
2020-05-13-170214,170214,6,0,3,368,5.333333333333333,542.4791602501446,2
2020-05-14-170214,170214,5,0,1,373,7.333333333333332,572.7043866439528,3
2020-05-15-170214,170214,6,1,2,379,4.166666666666667,581.9509627116013,4
2020-05-16-170214,170214,0,0,0,379,0.6666666666666666,580.4381025917105,5
2020-05-17-170214,170214,0,0,0,379,0.0,580.7222275866429,6
2020-05-18-170214,170214,10,0,0,389,4.666666666666667,576.8987738984804,0
2020-05-19-170214,170214,4,0,3,393,3.6666666666666665,628.1939291650995,1
2020-05-20-170214,170214,3,0,1,396,3.0,521.4131787976046,2
2020-05-21-170214,170214,4,0,3,400,2.5,457.6631520583614,3
2020-05-22-170214,170214,7,0,1,407,4.5,429.66762297639264,4
2020-05-23-170214,170214,0,0,0,407,0.3333333333333333,513.5673397959126,5
2020-05-24-170214,170214,0,0,0,407,0.0,520.1904191865594,6
2020-05-25-170214,170214,2,0,1,409,5.333333333333333,387.0619952695671,0
2020-05-26-170214,170214,1,0,0,410,3.1666666666666665,386.2797498258714,1
2020-05-27-170214,170214,3,1,0,413,2.5,447.8857897882862,2
2020-05-28-170214,170214,1,1,2,414,2.5,420.38390628702825,3
2020-05-29-170214,170214,2,0,0,416,2.0,381.7536361101638,4
2020-05-30-170214,170214,0,0,0,416,0.0,356.7082762725796,5
2020-05-31-170214,170214,0,0,0,416,0.0,360.8406453212774,6
2020-06-01-170214,170214,0,0,2,416,2.1666666666666665,402.4103739250788,0
2020-06-02-170214,170214,3,2,0,419,1.3333333333333333,112.7333114084819,1
2020-06-03-170214,170214,1,0,0,420,0.6666666666666666,91.3968380529355,2
2020-06-04-170214,170214,3,0,1,423,1.1666666666666667,89.40063709733904,3
2020-06-05-170214,170214,1,0,1,424,1.6666666666666667,113.63992112972923,4
2020-06-06-170214,170214,0,0,0,424,0.5,127.92356671168021,5
2020-06-07-170214,170214,0,4,0,424,0.3333333333333333,128.4935569329057,6
2020-06-08-170214,170214,1,0,0,425,1.1666666666666667,129.43995933215797,0
2020-06-09-170214,170214,0,0,0,425,1.5,160.33667710354024,1
2020-06-10-170214,170214,0,0,1,425,1.1666666666666667,437.93994296610765,2
2020-06-11-170214,170214,2,0,0,427,1.5,401.52049786824205,3
2020-06-12-170214,170214,0,0,0,427,0.6666666666666666,358.91798414578193,4
2020-06-13-170214,170214,0,0,0,427,0.0,292.20420458751676,5
2020-06-14-170214,170214,0,0,0,427,0.16666666666666666,220.2068195055475,6
2020-06-15-170214,170214,2,0,0,429,0.8333333333333334,127.23238556231763,0
2020-06-16-170214,170214,0,0,0,429,1.1666666666666667,161.8505282664778,1
2020-06-17-170214,170214,0,0,1,429,0.8333333333333334,150.915873069636,2
2020-06-18-170214,170214,1,0,0,430,1.1666666666666667,146.31879036550848,3
2020-06-19-170214,170214,1,0,1,431,0.3333333333333333,128.52226902139577,4
2020-06-20-170214,170214,0,0,0,431,0.0,153.61426392375125,5
2020-06-21-170214,170214,0,0,0,431,0.0,152.61036157209102,6
2020-06-22-170214,170214,0,0,0,431,1.0,120.94654432724622,0
2020-06-23-170214,170214,0,0,1,431,0.5,115.11370410936357,1
2020-06-24-170214,170214,1,0,0,432,1.0,105.5383369891838,2
2020-06-25-170214,170214,0,1,0,432,1.0,110.5723780948083,3
2020-06-26-170214,170214,0,0,0,432,1.0,121.86708159217247,4
2020-06-27-170214,170214,0,0,1,432,0.3333333333333333,110.72851064654881,5
2020-06-28-170214,170214,0,0,0,432,0.16666666666666666,119.41912857198848,6
2020-06-29-170214,170214,0,0,0,432,0.0,116.17441538060211,0
2020-06-30-170214,170214,0,0,1,432,0.8333333333333334,102.96339235290722,1
2020-07-01-170214,170214,1,0,1,433,0.6666666666666666,174.01285658297616,2
2020-07-02-170214,170214,0,0,1,433,0.0,147.70510035759105,3
2020-07-03-170214,170214,1,0,2,434,0.8333333333333334,163.07344856040453,4
2020-07-04-170214,170214,0,0,0,434,0.0,209.11204986134993,5
2020-07-05-170214,170214,0,0,0,434,0.0,199.8336195495284,6
2020-07-06-170214,170214,0,0,1,434,0.0,169.88687583818955,0
2020-07-07-170214,170214,1,0,0,435,1.0,159.25080288658887,1
2020-07-08-170214,170214,0,0,0,435,0.16666666666666666,139.26495556274233,2
2020-07-09-170214,170214,0,0,2,435,0.3333333333333333,129.60562431255556,3
2020-07-10-170214,170214,0,0,3,435,0.3333333333333333,179.3282362048474,4
2020-07-11-170214,170214,1,0,0,436,0.0,147.27899988566105,5
2020-07-12-170214,170214,0,0,2,436,0.16666666666666666,110.60999424235688,6
2020-07-13-170214,170214,0,0,1,436,1.1666666666666667,106.83918014830033,0
2020-07-14-170214,170214,1,0,2,437,0.3333333333333333,133.62338273603052,1
2020-07-15-170214,170214,1,0,2,438,2.833333333333333,113.51960369715901,2
2020-07-16-170214,170214,1,0,3,439,0.16666666666666666,110.48481295866264,3
2020-07-17-170214,170214,2,0,1,441,1.1666666666666667,103.06252152502164,4
2020-07-18-170214,170214,0,0,0,441,0.6666666666666666,132.8616279218324,5
2020-07-19-170214,170214,0,0,0,441,0.5,152.85913240349868,6
2020-07-20-170214,170214,1,0,2,442,0.6666666666666666,123.10359962756458,0
2020-07-21-170214,170214,0,0,1,442,0.5,138.53866730002795,1
2020-07-22-170214,170214,0,0,0,442,0.6666666666666666,129.7661121645194,2
2020-07-23-170214,170214,2,0,1,444,1.3333333333333333,147.1014439073304,3
2020-07-24-170214,170214,3,0,1,447,0.16666666666666666,140.55227394716613,4
2020-07-25-170214,170214,0,0,1,447,0.16666666666666666,136.80705159957216,5
2020-07-26-170214,170214,2,0,0,449,0.0,138.94667872696746,6
2020-07-27-170214,170214,1,0,2,450,2.0,147.1772070959815,0
2020-07-28-170214,170214,2,0,6,452,1.3333333333333333,152.95368447297483,1
2020-07-29-170214,170214,2,0,2,454,2.1666666666666665,150.6368843825916,2
2020-07-30-170214,170214,3,0,1,457,3.5,150.7355811663166,3
2020-07-31-170214,170214,1,0,2,458,3.5,194.59460453095602,4
2020-08-01-170214,170214,0,0,0,458,0.5,77.76409888141848,5
2020-08-02-170214,170214,0,0,1,458,0.5,487.57597797502746,6
2020-08-03-170214,170214,2,0,1,460,2.1666666666666665,512.8956102986551,0
2020-08-04-170214,170214,1,0,3,461,4.333333333333333,507.3363690069481,1
2020-08-05-170214,170214,0,0,0,461,3.8333333333333335,505.03056148744076,2
2020-08-06-170214,170214,1,0,0,462,2.0,530.4107113632157,3
2020-08-07-170214,170214,1,0,0,463,1.6666666666666667,508.75825856584737,4
2020-08-08-170214,170214,1,0,0,464,2.5,519.0378085243939,5
2020-08-09-170214,170214,0,0,1,464,1.3333333333333333,523.4616190145994,6
2020-08-10-170214,170214,2,0,3,466,4.166666666666667,55.45215640810362,0
2020-08-11-170214,170214,6,0,4,472,2.6666666666666665,129.63196812394727,1
2020-08-12-170214,170214,2,0,1,474,5.666666666666668,209.4242804995107,2
2020-08-13-170214,170214,1,0,2,475,2.833333333333333,279.3746450943314,3
2020-08-14-170214,170214,2,0,1,477,1.5,329.6831199568668,4
2020-08-15-170214,170214,0,0,0,477,1.5,375.8337839901012,5
2020-08-16-170214,170214,1,0,1,478,1.8333333333333333,385.3851480032163,6
2020-08-17-170214,170214,1,0,5,479,3.0,424.0186929827791,0
2020-08-18-170214,170214,3,0,3,482,4.833333333333333,412.12158726292967,1
2020-08-19-170214,170214,0,0,2,482,3.0,442.59142153409385,2
2020-08-20-170214,170214,0,0,8,482,1.6666666666666667,390.95538755692587,3
2020-08-21-170214,170214,0,0,3,482,4.333333333333333,401.9563656530479,4
2020-08-22-170214,170214,0,0,3,482,2.6666666666666665,451.487679769956,5
2020-08-23-170214,170214,1,0,3,483,1.6666666666666667,475.15684243594546,6
2020-08-24-170214,170214,3,0,4,486,7.666666666666668,456.6092859003805,0
2020-08-25-170214,170214,4,0,9,490,4.833333333333333,472.5429201458763,1
2020-08-26-170214,170214,1,0,8,491,5.166666666666667,486.2855898223798,2
2020-08-27-170214,170214,2,0,9,493,5.833333333333332,539.7332638180703,3
2020-08-28-170214,170214,1,0,7,494,4.333333333333333,531.926428718281,4
2020-08-29-170214,170214,0,0,1,494,2.333333333333333,523.4882636224588,5
2020-08-30-170214,170214,1,0,2,495,3.5,498.48414280026725,6
2020-08-31-170214,170214,5,0,5,500,5.166666666666667,436.686333466693,0
2020-09-01-170214,170214,3,0,7,503,6.833333333333332,480.429300404263,1
2020-09-02-170214,170214,2,0,4,505,5.833333333333332,948.8280683915914,2
2020-09-03-170214,170214,8,0,7,513,5.666666666666668,763.14228455278,3
2020-09-04-170214,170214,3,0,11,516,5.5,765.0537197026702,4
2020-09-05-170214,170214,3,0,1,519,2.0,747.737630774163,5
2020-09-06-170214,170214,3,0,0,522,1.3333333333333333,760.4077566214532,6
2020-09-07-170214,170214,4,0,9,526,4.833333333333333,782.3065267654225,0
2020-09-08-170214,170214,9,0,10,535,7.166666666666668,768.2343565575595,1
2020-09-09-170214,170214,8,0,12,543,4.833333333333333,778.8618192943695,2
2020-09-10-170214,170214,9,0,7,552,9.833333333333334,578.3686623678879,3
2020-09-11-170214,170214,7,0,3,559,5.5,622.6292178339393,4
2020-09-12-170214,170214,1,0,1,560,4.166666666666667,712.95776330303,5
2020-09-13-170214,170214,2,0,1,562,3.1666666666666665,762.0234608399351,6
2020-09-14-170214,170214,5,0,10,567,9.5,834.6489440316723,0
2020-09-15-170214,170214,7,0,6,574,17.166666666666668,968.5462199641098,1
2020-09-16-170214,170214,4,0,9,578,10.833333333333336,1127.5777654438853,2
2020-09-17-170214,170214,7,0,9,585,14.0,1052.0411587600993,3
2020-09-18-170214,170214,11,0,14,596,11.5,1108.7166351175674,4
2020-09-19-170214,170214,1,2,2,597,2.6666666666666665,1149.1548458601012,5
2020-09-20-170214,170214,0,1,1,597,2.5,1086.282024566006,6
2020-09-21-170214,170214,9,0,2,606,15.833333333333336,919.1834942552945,0
2020-09-22-170214,170214,10,1,5,616,10.833333333333336,911.4850856800361,1
2020-09-23-170214,170214,12,1,11,628,11.0,886.551012495798,2
2020-09-24-170214,170214,7,0,7,635,6.5,878.5584032282112,3
2020-09-25-170214,170214,3,0,19,638,9.833333333333334,772.0814420552291,4
2020-09-26-170214,170214,1,0,4,639,0.8333333333333334,886.4602501120053,5
2020-09-27-170214,170214,1,0,11,640,1.0,783.9311417368858,6
2020-09-28-170214,170214,10,0,10,650,5.666666666666668,778.9066874578239,0
2020-09-29-170214,170214,6,0,4,656,5.0,805.1502145533836,1
2020-09-30-170214,170214,9,0,7,665,6.166666666666668,788.5159317468648,2
2020-10-01-170214,170214,9,0,11,674,6.666666666666668,0.0,3
2020-10-02-170214,170214,14,0,7,688,11.666666666666664,2130.317961919097,4
2020-10-03-170214,170214,2,0,2,690,2.833333333333333,3076.9694365671767,5
2020-10-04-170214,170214,1,0,0,691,4.166666666666667,3110.116779847629,6
2020-10-05-170214,170214,2,0,12,693,6.833333333333332,2563.6975730818185,0
2020-10-06-170214,170214,5,0,5,698,8.833333333333334,2194.652511982103,1
2020-10-07-170214,170214,11,1,13,709,10.166666666666666,1848.411111384833,2
2020-10-08-170214,170214,7,0,13,716,9.0,1635.4518162468294,3
2020-10-09-170214,170214,19,1,20,735,14.166666666666664,1756.3454489055493,4
2020-10-10-170214,170214,4,0,11,739,2.5,141.6670243308422,5
2020-10-11-170214,170214,11,0,11,750,3.1666666666666665,237.5537903246548,6
2020-10-12-170214,170214,10,0,22,760,5.833333333333332,364.5182682966159,0
2020-10-13-170214,170214,4,0,18,764,12.333333333333336,550.3745660799132,1
2020-10-14-170214,170214,7,0,15,771,7.333333333333332,957.2849628240044,2
2020-10-15-170214,170214,11,0,9,782,17.666666666666668,1151.654842421412,3
2020-10-16-170214,170214,7,0,21,789,13.666666666666664,1597.5366562965423,4
2020-10-17-170214,170214,2,0,9,791,2.5,1819.7775364168344,5
2020-10-18-170214,170214,0,0,14,791,3.5,1823.977274811194,6
2020-10-19-170214,170214,12,0,16,803,17.833333333333332,1802.3967292276436,0
2020-10-20-170214,170214,5,0,19,808,11.0,1949.0924492168267,1
2020-10-21-170214,170214,13,0,18,821,17.333333333333332,2126.0935494290184,2
2020-10-22-170214,170214,13,0,23,834,16.166666666666668,2122.2854359512594,3
2020-10-23-170214,170214,20,1,29,854,13.666666666666664,2273.351941253712,4
2020-10-24-170214,170214,11,0,14,865,4.833333333333333,2613.353880676126,5
2020-10-25-170214,170214,11,0,14,876,8.833333333333334,2737.6963346108623,6
2020-10-26-170214,170214,22,0,28,898,20.5,2430.2675247613306,0
2020-10-27-170214,170214,18,0,28,916,16.333333333333332,2877.6322911940006,1
2020-10-28-170214,170214,15,1,15,931,18.166666666666668,3019.1313761004385,2
2020-10-29-170214,170214,9,1,13,940,18.0,3110.4909884577864,3
2020-10-30-170214,170214,21,0,24,961,18.666666666666668,2788.810173220084,4
2020-10-31-170214,170214,9,0,0,970,7.333333333333332,3183.148691162981,5
2020-11-01-170214,170214,14,0,0,984,14.0,1350.0245575578442,6
2020-11-02-170214,170214,16,0,0,1000,9.833333333333334,3227.2245543407616,0
2020-11-03-170214,170214,19,1,0,1019,18.83333333333333,2908.6976232616175,1
2020-11-04-170214,170214,18,0,0,1037,19.5,3393.945309137748,2
2020-11-05-170214,170214,23,0,0,1060,19.666666666666668,3482.228597671745,3
2020-11-06-170214,170214,29,0,0,1089,24.0,3651.864267567015,4
2020-11-07-170214,170214,14,0,0,1103,10.333333333333334,3755.7134639004053,5
2020-11-08-170214,170214,14,2,0,1117,13.833333333333336,3589.9984425264693,6
2020-11-09-170214,170214,28,0,0,1145,22.83333333333333,3585.0203197965743,0
2020-11-10-170214,170214,28,1,0,1173,16.833333333333332,1515.2441961279474,1
2020-11-11-170214,170214,15,1,0,1188,14.833333333333336,1957.9985214786734,2
2020-11-12-170214,170214,13,2,0,1201,22.0,2321.158641263267,3
2020-11-13-170214,170214,24,3,0,1225,23.0,2676.9840004323164,4
2020-03-01-170215,170215,0,0,0,0,0.0,0.0,6
2020-03-02-170215,170215,0,0,0,0,0.0,6.848104847542552,0
2020-03-03-170215,170215,0,1,0,0,0.0,29.889707323914596,1
2020-03-04-170215,170215,0,0,0,0,0.0,30.508119716924643,2
2020-03-05-170215,170215,0,0,0,0,0.0,34.04908405796981,3
2020-03-06-170215,170215,0,0,0,0,0.0,31.28131682141202,4
2020-03-07-170215,170215,0,0,0,0,0.0,31.528096173700128,5
2020-03-08-170215,170215,0,0,0,0,0.0,32.138229945681914,6
2020-03-09-170215,170215,0,0,1,0,0.0,32.621875206575076,0
2020-03-10-170215,170215,0,0,0,0,0.0,93.55094940886251,1
2020-03-11-170215,170215,0,0,0,0,0.25,82.29003640571439,2
2020-03-12-170215,170215,0,0,0,0,1.0,60.85083612801904,3
2020-03-13-170215,170215,0,0,1,0,0.5,41.053525298884985,4
2020-03-14-170215,170215,0,0,1,0,1.25,31.780972866771595,5
2020-03-15-170215,170215,0,0,0,0,1.75,25.6878400497748,6
2020-03-16-170215,170215,0,0,0,0,2.75,10.364708230527562,0
2020-03-17-170215,170215,0,0,0,0,3.75,15.051220523753557,1
2020-03-18-170215,170215,0,0,0,0,5.25,21.482050460601794,2
2020-03-19-170215,170215,0,0,0,0,6.25,29.566026896350138,3
2020-03-20-170215,170215,0,1,0,0,3.25,36.06956584338397,4
2020-03-21-170215,170215,0,0,0,0,2.25,36.03462964078507,5
2020-03-22-170215,170215,0,0,0,0,3.5,36.43475545579009,6
2020-03-23-170215,170215,1,0,0,1,9.5,35.41533761145245,0
2020-03-24-170215,170215,0,0,0,1,6.5,46.67867606426172,1
2020-03-25-170215,170215,0,0,0,1,6.5,49.655665731415176,2
2020-03-26-170215,170215,0,0,0,1,3.75,52.830798199262276,3
2020-03-27-170215,170215,1,0,0,2,3.75,61.005761111520115,4
2020-03-28-170215,170215,1,0,0,3,1.5,65.3873095511068,5
2020-03-29-170215,170215,0,0,0,3,1.75,67.01830580004957,6
2020-03-30-170215,170215,0,0,0,3,4.0,48.00527164984596,0
2020-03-31-170215,170215,0,0,0,3,4.25,46.52241168495211,1
2020-04-01-170215,170215,0,0,0,3,5.0,8.819486905370534,2
2020-04-02-170215,170215,0,0,0,3,2.5,30.546660578675933,3
2020-04-03-170215,170215,0,0,0,3,1.5,10.446147973788696,4
2020-04-04-170215,170215,0,0,0,3,1.0,11.949802053490757,5
2020-04-05-170215,170215,0,0,0,3,0.25,13.067245343411429,6
2020-04-06-170215,170215,0,0,0,3,1.25,12.418085144905401,0
2020-04-07-170215,170215,0,0,0,3,2.5,13.650659713500024,1
2020-04-08-170215,170215,0,3,0,3,2.0,16.778374627892138,2
2020-04-09-170215,170215,0,0,0,3,1.0,17.358288237400455,3
2020-04-10-170215,170215,0,1,0,3,2.25,7.745718933995472,4
2020-04-11-170215,170215,0,0,0,3,0.75,8.503359544491655,5
2020-04-12-170215,170215,0,0,0,3,1.75,8.832256611035037,6
2020-04-13-170215,170215,0,0,0,3,2.25,9.594632844785394,0
2020-04-14-170215,170215,0,0,0,3,2.25,13.02101152933659,1
2020-04-15-170215,170215,0,0,1,3,0.5,23.32452941983325,2
2020-04-16-170215,170215,0,0,0,3,2.75,25.054549152958174,3
2020-04-17-170215,170215,0,0,0,3,5.0,22.414427015310228,4
2020-04-18-170215,170215,0,0,0,3,0.0,32.42575231863235,5
2020-04-19-170215,170215,0,0,0,3,0.75,32.749531526437515,6
2020-04-20-170215,170215,0,0,0,3,1.75,31.543572270616647,0
2020-04-21-170215,170215,0,2,0,3,1.25,24.0624654506095,1
2020-04-22-170215,170215,0,0,0,3,0.75,23.337285152730214,2
2020-04-23-170215,170215,0,0,0,3,0.75,21.650904626008494,3
2020-04-24-170215,170215,0,0,0,3,1.75,11.002555238759767,4
2020-04-25-170215,170215,0,0,0,3,0.5,13.200030399859294,5
2020-04-26-170215,170215,0,0,0,3,0.75,12.014759744094302,6
2020-04-27-170215,170215,0,0,0,3,1.0,10.240174971874877,0
2020-04-28-170215,170215,0,0,0,3,1.5,8.767027302673888,1
2020-04-29-170215,170215,1,0,0,4,1.75,8.840433365284005,2
2020-04-30-170215,170215,0,0,0,4,1.25,15.276421845167782,3
2020-05-01-170215,170215,0,0,0,4,1.5,18.116047284787527,4
2020-05-02-170215,170215,0,0,0,4,0.0,10.72068589142599,5
2020-05-03-170215,170215,0,0,0,4,0.5,7.9402315545416045,6
2020-05-04-170215,170215,0,0,0,4,2.0,6.1338120478306255,0
2020-05-05-170215,170215,0,0,0,4,0.0,7.551654761426096,1
2020-05-06-170215,170215,0,0,0,4,1.0,8.909399578259112,2
2020-05-07-170215,170215,0,0,0,4,0.5,8.961503368248168,3
2020-05-08-170215,170215,0,0,0,4,0.0,8.817193729566839,4
2020-05-09-170215,170215,0,1,0,4,0.0,11.28721253311912,5
2020-05-10-170215,170215,0,1,0,4,0.0,20.183489593506092,6
2020-05-11-170215,170215,0,0,0,4,0.5,19.207823387126545,0
2020-05-12-170215,170215,0,0,0,4,0.5,20.542875611571237,1
2020-05-13-170215,170215,0,0,0,4,1.5,16.43934513403735,2
2020-05-14-170215,170215,0,0,1,4,1.0,15.051116224275665,3
2020-05-15-170215,170215,0,0,0,4,1.0,11.2060025851969,4
2020-05-16-170215,170215,0,0,0,4,0.0,10.975840225706763,5
2020-05-17-170215,170215,0,0,0,4,0.0,10.779415820681695,6
2020-05-18-170215,170215,0,0,0,4,2.0,10.34498756359876,0
2020-05-19-170215,170215,0,0,0,4,0.75,12.529824244126878,1
2020-05-20-170215,170215,0,0,0,4,1.5,10.536056442408574,2
2020-05-21-170215,170215,0,0,0,4,0.5,13.257996668296073,3
2020-05-22-170215,170215,0,0,0,4,0.5,13.872415171717494,4
2020-05-23-170215,170215,0,0,0,4,0.0,15.459732162672964,5
2020-05-24-170215,170215,0,0,0,4,0.0,15.983021131524476,6
2020-05-25-170215,170215,0,0,0,4,0.75,11.698724408528696,0
2020-05-26-170215,170215,0,0,0,4,1.5,12.149237918228144,1
2020-05-27-170215,170215,0,0,0,4,1.0,15.226249434693054,2
2020-05-28-170215,170215,1,0,0,5,0.0,11.872596470404327,3
2020-05-29-170215,170215,0,1,0,5,0.5,12.171795719219551,4
2020-05-30-170215,170215,0,0,0,5,0.0,13.709304220974872,5
2020-05-31-170215,170215,0,1,0,5,0.25,13.96034078689753,6
2020-06-01-170215,170215,0,0,0,5,0.5,17.9773374396432,0
2020-06-02-170215,170215,0,0,0,5,1.0,3.464678568918543,1
2020-06-03-170215,170215,0,1,0,5,0.75,4.269153775666524,2
2020-06-04-170215,170215,0,0,0,5,0.5,6.132151533891547,3
2020-06-05-170215,170215,0,0,0,5,0.0,6.147515577125226,4
2020-06-06-170215,170215,0,6,0,5,0.0,6.3004148786385725,5
2020-06-07-170215,170215,0,0,0,5,0.0,6.436735080440702,6
2020-06-08-170215,170215,0,0,0,5,0.0,6.384809301125867,0
2020-06-09-170215,170215,0,0,0,5,0.5,6.22716878670568,1
2020-06-10-170215,170215,0,0,0,5,0.0,19.17958747957429,2
2020-06-11-170215,170215,0,0,0,5,0.25,14.229716627652568,3
2020-06-12-170215,170215,0,0,0,5,0.25,12.342465605126046,4
2020-06-13-170215,170215,0,0,0,5,0.0,9.466247284812427,5
2020-06-14-170215,170215,0,0,0,5,0.25,7.558090507640474,6
2020-06-15-170215,170215,0,1,0,5,0.0,4.691715052593714,0
2020-06-16-170215,170215,0,0,0,5,0.5,4.262692162188517,1
2020-06-17-170215,170215,0,0,0,5,0.0,2.9795636639797136,2
2020-06-18-170215,170215,0,0,0,5,0.25,2.679821988589621,3
2020-06-19-170215,170215,0,0,0,5,0.75,2.1870038004525876,4
2020-06-20-170215,170215,0,0,0,5,0.0,7.541984673974982,5
2020-06-21-170215,170215,0,0,0,5,0.0,8.041751746258777,6
2020-06-22-170215,170215,0,0,0,5,0.5,6.917779233218939,0
2020-06-23-170215,170215,0,0,0,5,0.5,7.659194459457872,1
2020-06-24-170215,170215,0,0,0,5,0.0,8.938490985248398,2
2020-06-25-170215,170215,0,1,0,5,0.25,9.743396003751918,3
2020-06-26-170215,170215,0,0,0,5,0.0,8.919923185369754,4
2020-06-27-170215,170215,0,0,0,5,0.0,5.51567230512725,5
2020-06-28-170215,170215,0,0,0,5,0.0,5.130590896245899,6
2020-06-29-170215,170215,0,0,0,5,0.25,5.139329181691366,0
2020-06-30-170215,170215,0,0,0,5,0.0,6.091360283892054,1
2020-07-01-170215,170215,0,0,0,5,0.5,5.952971023169143,2
2020-07-02-170215,170215,0,0,0,5,0.75,2.781588606348275,3
2020-07-03-170215,170215,0,0,0,5,0.5,12.843122600422301,4
2020-07-04-170215,170215,0,0,0,5,0.0,21.903946883636525,5
2020-07-05-170215,170215,0,0,0,5,0.0,21.202186230397327,6
2020-07-06-170215,170215,0,0,0,5,0.75,19.63520909810462,0
2020-07-07-170215,170215,0,1,0,5,0.5,17.130303067911036,1
2020-07-08-170215,170215,0,0,0,5,0.25,15.922130214254985,2
2020-07-09-170215,170215,0,0,0,5,0.0,15.856345920871359,3
2020-07-10-170215,170215,0,0,0,5,0.25,5.644796422173613,4
2020-07-11-170215,170215,0,0,0,5,0.0,5.767899048409471,5
2020-07-12-170215,170215,0,0,0,5,0.0,4.913229997578986,6
2020-07-13-170215,170215,0,0,0,5,0.0,4.832786076307135,0
2020-07-14-170215,170215,0,0,0,5,0.25,5.205270176100263,1
2020-07-15-170215,170215,0,0,0,5,0.25,4.7631895305006475,2
2020-07-16-170215,170215,0,0,0,5,0.75,4.014429999024769,3
2020-07-17-170215,170215,0,0,0,5,0.0,3.512848936510415,4
2020-07-18-170215,170215,0,0,0,5,0.0,2.4644776371907646,5
2020-07-19-170215,170215,0,0,0,5,0.0,2.893168579452055,6
2020-07-20-170215,170215,0,0,0,5,0.25,3.1984353776419114,0
2020-07-21-170215,170215,0,0,0,5,0.25,4.114275153983534,1
2020-07-22-170215,170215,0,0,0,5,0.25,5.54722394673313,2
2020-07-23-170215,170215,0,0,0,5,0.75,5.627314168137549,3
2020-07-24-170215,170215,0,0,0,5,0.5,6.923310797480318,4
2020-07-25-170215,170215,0,0,0,5,0.75,7.617405195571844,5
2020-07-26-170215,170215,0,0,1,5,0.5,8.568541931807866,6
2020-07-27-170215,170215,0,0,0,5,0.0,9.36550691476905,0
2020-07-28-170215,170215,0,0,0,5,0.25,10.536532993568981,1
2020-07-29-170215,170215,0,0,0,5,0.25,12.53150113648575,2
2020-07-30-170215,170215,0,0,0,5,1.0,13.466602643759769,3
2020-07-31-170215,170215,0,0,2,5,1.25,20.287216108249567,4
2020-08-01-170215,170215,0,0,0,5,1.25,10.266419468907705,5
2020-08-02-170215,170215,0,0,0,5,0.0,141.59136849757203,6
2020-08-03-170215,170215,0,0,0,5,1.5,51.00501083138873,0
2020-08-04-170215,170215,0,0,0,5,2.0,56.795869208425415,1
2020-08-05-170215,170215,0,0,1,5,3.0,64.26027900522502,2
2020-08-06-170215,170215,0,0,0,5,4.25,76.95035038021203,3
2020-08-07-170215,170215,0,0,0,5,2.5,104.29566437894783,4
2020-08-08-170215,170215,0,0,1,5,2.5,116.15266367819842,5
2020-08-09-170215,170215,1,0,0,6,5.0,104.67200160142067,6
2020-08-10-170215,170215,0,0,0,6,8.0,8.035371427302781,0
2020-08-11-170215,170215,0,0,0,6,5.25,38.71913028778758,1
2020-08-12-170215,170215,0,0,0,6,4.0,62.13083493255792,2
2020-08-13-170215,170215,0,0,1,6,4.25,68.8545546298159,3
2020-08-14-170215,170215,2,0,0,8,4.75,74.54974222647425,4
2020-08-15-170215,170215,0,0,0,8,2.75,94.05171625059316,5
2020-08-16-170215,170215,0,0,0,8,1.5,104.36463957574279,6
2020-08-17-170215,170215,0,0,0,8,9.0,104.6054956804545,0
2020-08-18-170215,170215,0,0,0,8,3.25,111.33651930935676,1
2020-08-19-170215,170215,1,0,0,9,3.75,107.12010608155295,2
2020-08-20-170215,170215,0,0,0,9,3.5,105.0070867909712,3
2020-08-21-170215,170215,0,0,0,9,3.0,100.67676064894997,4
2020-08-22-170215,170215,1,0,0,10,2.0,102.17528799806321,5
2020-08-23-170215,170215,0,0,0,10,1.0,106.80570642997347,6
2020-08-24-170215,170215,0,0,0,10,1.75,77.57852293773021,0
2020-08-25-170215,170215,0,0,0,10,2.75,65.03445963368243,1
2020-08-26-170215,170215,0,0,2,10,2.25,54.15283790916067,2
2020-08-27-170215,170215,1,0,0,11,2.0,62.1010500904039,3
2020-08-28-170215,170215,0,0,1,11,1.0,55.98042566248262,4
2020-08-29-170215,170215,0,0,1,11,0.75,50.02520631429624,5
2020-08-30-170215,170215,0,0,0,11,0.25,59.1433780725183,6
2020-08-31-170215,170215,0,0,0,11,0.75,54.724966099465526,0
2020-09-01-170215,170215,0,0,1,11,0.25,121.71689008209123,1
2020-09-02-170215,170215,0,0,0,11,1.5,48.48054176514114,2
2020-09-03-170215,170215,0,0,0,11,2.75,36.00091014866386,3
2020-09-04-170215,170215,0,0,0,11,1.5,40.13435291962645,4
2020-09-05-170215,170215,0,0,0,11,0.75,38.19572590293138,5
2020-09-06-170215,170215,0,0,1,11,0.25,35.48031113430709,6
2020-09-07-170215,170215,0,0,1,11,2.25,37.98991360352995,0
2020-09-08-170215,170215,0,0,0,11,2.25,36.97332353569957,1
2020-09-09-170215,170215,2,0,0,13,1.0,37.86451275050765,2
2020-09-10-170215,170215,0,0,0,13,6.0,115.76531946866507,3
2020-09-11-170215,170215,1,0,0,14,5.5,120.20051720355421,4
2020-09-12-170215,170215,1,0,0,15,1.0,115.70025302050189,5
2020-09-13-170215,170215,0,0,0,15,3.0,89.60988222799074,6
2020-09-14-170215,170215,0,0,0,15,1.0,77.45176515354592,0
2020-09-15-170215,170215,1,0,0,16,2.75,70.38007022884788,1
2020-09-16-170215,170215,0,0,0,16,0.75,65.00347599030876,2
2020-09-17-170215,170215,0,0,0,16,2.0,67.25186862332255,3
2020-09-18-170215,170215,0,0,0,16,2.5,55.40970605952704,4
2020-09-19-170215,170215,0,0,1,16,1.75,42.360197538794836,5
2020-09-20-170215,170215,1,0,0,17,2.0,38.64802365275908,6
2020-09-21-170215,170215,1,0,0,18,2.0,41.36583710307343,0
2020-09-22-170215,170215,0,0,3,18,1.0,40.83695695287338,1
2020-09-23-170215,170215,0,2,0,18,0.25,43.616996927459056,2
2020-09-24-170215,170215,0,0,0,18,1.25,40.932673157355445,3
2020-09-25-170215,170215,0,0,0,18,1.5,41.66266155608874,4
2020-09-26-170215,170215,0,0,0,18,1.75,43.93387782671342,5
2020-09-27-170215,170215,0,0,1,18,0.5,43.602068671636474,6
2020-09-28-170215,170215,0,0,1,18,1.5,38.985501972142224,0
2020-09-29-170215,170215,0,0,0,18,0.75,35.38753932775768,1
2020-09-30-170215,170215,0,0,1,18,1.5,36.94387316275932,2
2020-10-01-170215,170215,0,0,0,18,0.75,0.0,3
2020-10-02-170215,170215,0,0,0,18,0.5,79.24838864517722,4
2020-10-03-170215,170215,1,0,0,19,0.25,124.14946688466071,5
2020-10-04-170215,170215,0,0,0,19,1.25,127.00708127010651,6
2020-10-05-170215,170215,0,0,0,19,0.25,107.44608833775948,0
2020-10-06-170215,170215,3,0,0,22,0.5,100.58643075517574,1
2020-10-07-170215,170215,0,0,3,22,1.75,87.01333358442938,2
2020-10-08-170215,170215,0,0,1,22,2.75,77.90014071392892,3
2020-10-09-170215,170215,0,0,3,22,1.75,82.42645066683639,4
2020-10-10-170215,170215,0,0,0,22,1.75,7.061003395243677,5
2020-10-11-170215,170215,1,0,4,23,2.0,11.614522121659544,6
2020-10-12-170215,170215,1,0,2,24,1.5,19.690466508615767,0
2020-10-13-170215,170215,0,0,6,24,2.25,30.67831176785683,1
2020-10-14-170215,170215,1,0,1,25,2.0,42.300394018624374,2
2020-10-15-170215,170215,0,0,2,25,1.0,54.175542321529846,3
2020-10-16-170215,170215,0,0,0,25,3.25,65.29711537839019,4
2020-10-17-170215,170215,0,0,7,25,1.0,68.34468731514275,5
2020-10-18-170215,170215,0,0,6,25,2.5,65.69560716957814,6
2020-10-19-170215,170215,0,0,5,25,2.25,67.55981358147658,0
2020-10-20-170215,170215,0,0,3,25,1.5,70.7450185071457,1
2020-10-21-170215,170215,3,0,0,28,3.5,66.8696034039214,2
2020-10-22-170215,170215,1,0,2,29,3.5,72.91035369366264,3
2020-10-23-170215,170215,3,0,0,32,3.5,78.84659064771495,4
2020-10-24-170215,170215,0,0,0,32,1.0,92.07297116917053,5
2020-10-25-170215,170215,4,0,1,36,1.75,83.59899177703895,6
2020-10-26-170215,170215,2,0,1,38,4.5,74.9248724499743,0
2020-10-27-170215,170215,6,0,2,44,2.25,85.12012691497938,1
2020-10-28-170215,170215,1,0,2,45,10.5,92.91970280673706,2
2020-10-29-170215,170215,2,0,0,47,6.5,98.54812753292882,3
2020-10-30-170215,170215,0,0,2,47,9.25,87.87696926716187,4
2020-10-31-170215,170215,7,1,0,54,4.25,101.70431636503135,5
2020-11-01-170215,170215,6,0,0,60,3.0,60.01343160706294,6
2020-11-02-170215,170215,5,0,0,65,6.0,80.93543532141129,0
2020-11-03-170215,170215,3,0,0,68,6.0,73.9886425929622,1
2020-11-04-170215,170215,0,0,0,68,4.75,92.03141173012378,2
2020-11-05-170215,170215,2,0,0,70,3.25,93.30077041345297,3
2020-11-06-170215,170215,0,0,0,70,7.75,101.67858727572161,4
2020-11-07-170215,170215,0,0,0,70,5.0,110.45803886854046,5
2020-11-08-170215,170215,1,0,0,71,8.75,103.42613654728386,6
2020-11-09-170215,170215,1,0,0,72,4.75,93.33026091390983,0
2020-11-10-170215,170215,2,0,0,74,5.0,56.82132927859333,1
2020-11-11-170215,170215,2,0,0,76,4.0,62.733773567161876,2
2020-11-12-170215,170215,0,0,0,76,7.75,73.97388017446575,3
2020-11-13-170215,170215,2,0,0,78,2.75,83.54076730277473,4
2020-03-01-170216,170216,0,0,0,0,0.0,0.0,6
2020-03-02-170216,170216,0,0,2,0,0.0,29.464916883267627,0
2020-03-03-170216,170216,0,0,4,0,0.0,128.59778842655862,1
2020-03-04-170216,170216,0,0,3,0,0.0,130.38730973393993,2
2020-03-05-170216,170216,0,0,6,0,0.0,139.05300935942358,3
2020-03-06-170216,170216,0,0,4,0,0.0,123.1546790880361,4
2020-03-07-170216,170216,0,0,7,0,0.0,127.01060025735315,5
2020-03-08-170216,170216,0,0,5,0,0.0,127.23862345395017,6
2020-03-09-170216,170216,0,0,11,0,0.42857142857142855,126.7829754383471,0
2020-03-10-170216,170216,1,0,8,1,0.14285714285714285,587.2131113611351,1
2020-03-11-170216,170216,0,0,4,1,0.2857142857142857,497.639921013309,2
2020-03-12-170216,170216,0,0,5,1,0.42857142857142855,375.14919121676155,3
2020-03-13-170216,170216,1,0,3,2,1.0,240.24034385733216,4
2020-03-14-170216,170216,0,0,2,2,1.8571428571428568,195.78367935052125,5
2020-03-15-170216,170216,0,0,1,2,0.7142857142857143,126.16872326654374,6
2020-03-16-170216,170216,2,0,5,4,2.2857142857142856,50.22640414101024,0
2020-03-17-170216,170216,4,0,4,8,2.7142857142857144,83.57834215468209,1
2020-03-18-170216,170216,3,0,6,11,2.2857142857142856,116.07519805943,2
2020-03-19-170216,170216,6,0,5,17,4.142857142857143,138.51999832760757,3
2020-03-20-170216,170216,4,0,6,21,2.8571428571428568,164.49778131527313,4
2020-03-21-170216,170216,7,0,1,28,1.1428571428571428,182.47875503577876,5
2020-03-22-170216,170216,5,0,2,33,2.142857142857143,200.0309882601948,6
2020-03-23-170216,170216,11,0,6,44,6.7142857142857135,199.53219980850002,0
2020-03-24-170216,170216,8,0,0,52,4.142857142857143,240.46619833288673,1
2020-03-25-170216,170216,4,0,3,56,5.0,270.8349341248228,2
2020-03-26-170216,170216,5,0,2,61,3.0,294.0259520691732,3
2020-03-27-170216,170216,3,0,2,64,5.0,339.90078994841633,4
2020-03-28-170216,170216,2,1,2,66,1.2857142857142858,347.851997327176,5
2020-03-29-170216,170216,1,0,8,67,1.4285714285714286,329.922008236735,6
2020-03-30-170216,170216,5,0,1,72,4.714285714285714,234.53998966303885,0
2020-03-31-170216,170216,4,0,3,76,3.7142857142857135,210.80949498498046,1
2020-04-01-170216,170216,6,0,7,82,3.7142857142857135,35.850090967606604,2
2020-04-02-170216,170216,5,0,2,87,2.4285714285714284,136.1044880311729,3
2020-04-03-170216,170216,6,0,4,93,2.0,45.69771222737157,4
2020-04-04-170216,170216,1,0,0,94,0.5714285714285714,75.0060460284883,5
2020-04-05-170216,170216,2,0,0,96,0.8571428571428571,81.59141878880665,6
2020-04-06-170216,170216,6,1,0,102,0.8571428571428571,87.9074752739424,0
2020-04-07-170216,170216,0,0,3,102,2.7142857142857144,107.93517290495693,1
2020-04-08-170216,170216,3,1,0,105,2.2857142857142856,116.509542039217,2
2020-04-09-170216,170216,2,1,2,107,5.142857142857143,130.68414609902914,3
2020-04-10-170216,170216,2,0,0,109,2.142857142857143,33.65569885277753,4
2020-04-11-170216,170216,2,0,0,111,0.5714285714285714,48.859913056721894,5
2020-04-12-170216,170216,8,0,0,119,0.7142857142857143,59.88387198926488,6
2020-04-13-170216,170216,1,0,0,120,2.2857142857142856,89.24344070488155,0
2020-04-14-170216,170216,3,0,2,123,1.7142857142857142,98.58833450065478,1
2020-04-15-170216,170216,7,1,1,130,2.4285714285714284,113.96014834851405,2
2020-04-16-170216,170216,2,0,3,132,3.0,138.19690302366035,3
2020-04-17-170216,170216,4,0,0,136,3.4285714285714284,134.2107755482579,4
2020-04-18-170216,170216,0,0,1,136,0.14285714285714285,155.79170223643976,5
2020-04-19-170216,170216,0,0,2,136,1.4285714285714286,146.67396881608363,6
2020-04-20-170216,170216,0,0,0,136,2.4285714285714284,138.41630191690626,0
2020-04-21-170216,170216,3,0,2,139,1.2857142857142858,140.9324597051583,1
2020-04-22-170216,170216,0,0,2,139,0.7142857142857143,136.13902367982263,2
2020-04-23-170216,170216,2,0,3,141,0.2857142857142857,124.33082801233346,3
2020-04-24-170216,170216,0,0,1,141,0.8571428571428571,93.08683732968942,4
2020-04-25-170216,170216,0,0,0,141,0.14285714285714285,98.37738469703518,5
2020-04-26-170216,170216,0,0,0,141,0.42857142857142855,94.49340420277184,6
2020-04-27-170216,170216,0,0,3,141,1.2857142857142858,63.76336373632524,0
2020-04-28-170216,170216,2,0,0,143,0.8571428571428571,53.02026273128045,1
2020-04-29-170216,170216,1,0,2,144,1.5714285714285714,45.49066606077713,2
2020-04-30-170216,170216,3,0,3,147,0.5714285714285714,74.51757368627963,3
2020-05-01-170216,170216,0,0,0,147,0.2857142857142857,135.06222368210348,4
2020-05-02-170216,170216,1,0,0,148,0.0,69.73568314979707,5
2020-05-03-170216,170216,2,0,1,150,0.2857142857142857,43.74724086548578,6
2020-05-04-170216,170216,0,0,3,150,1.2857142857142858,41.89120034737854,0
2020-05-05-170216,170216,2,0,1,152,0.5714285714285714,46.550983462005235,1
2020-05-06-170216,170216,2,0,2,154,0.42857142857142855,46.63241918883433,2
2020-05-07-170216,170216,3,0,0,157,0.2857142857142857,49.29166511076298,3
2020-05-08-170216,170216,1,0,0,158,0.8571428571428571,56.52477236653549,4
2020-05-09-170216,170216,0,0,0,158,0.0,60.0846374056201,5
2020-05-10-170216,170216,0,0,0,158,0.2857142857142857,127.9912503639029,6
2020-05-11-170216,170216,3,0,1,161,0.42857142857142855,119.0455782798304,0
2020-05-12-170216,170216,0,0,2,161,0.7142857142857143,125.47727024888644,1
2020-05-13-170216,170216,2,0,2,163,1.2857142857142858,98.47452019026562,2
2020-05-14-170216,170216,3,0,0,166,0.8571428571428571,96.74772217868203,3
2020-05-15-170216,170216,0,0,0,166,0.7142857142857143,87.04913886860857,4
2020-05-16-170216,170216,0,0,0,166,0.0,69.42515693632244,5
2020-05-17-170216,170216,1,0,0,167,0.0,65.98757347069716,6
2020-05-18-170216,170216,3,0,0,170,1.8571428571428568,67.35872927409415,0
2020-05-19-170216,170216,1,0,1,171,1.0,69.75688735225464,1
2020-05-20-170216,170216,2,0,1,173,0.8571428571428571,59.75706450237335,2
2020-05-21-170216,170216,0,0,2,173,1.1428571428571428,60.05578300226309,3
2020-05-22-170216,170216,0,0,1,173,0.8571428571428571,61.82543488754978,4
2020-05-23-170216,170216,0,0,2,173,0.0,68.45437648106841,5
2020-05-24-170216,170216,0,0,0,173,0.0,66.86082140963032,6
2020-05-25-170216,170216,1,0,1,174,0.8571428571428571,43.40087447108908,0
2020-05-26-170216,170216,2,0,1,176,0.8571428571428571,46.30867809697804,1
2020-05-27-170216,170216,2,0,0,178,0.42857142857142855,49.14910700179583,2
2020-05-28-170216,170216,0,1,0,178,0.7142857142857143,46.521421945469115,3
2020-05-29-170216,170216,0,0,0,178,0.8571428571428571,48.87023236217695,4
2020-05-30-170216,170216,0,0,0,178,0.0,60.19052432516696,5
2020-05-31-170216,170216,0,0,0,178,0.0,62.946904802050874,6
2020-06-01-170216,170216,0,1,0,178,0.14285714285714285,71.68591273910815,0
2020-06-02-170216,170216,1,0,1,179,0.5714285714285714,22.85080572952965,1
2020-06-03-170216,170216,1,0,0,180,0.42857142857142855,18.40805447882918,2
2020-06-04-170216,170216,2,0,2,182,0.5714285714285714,23.006484745116,3
2020-06-05-170216,170216,1,0,0,183,0.2857142857142857,31.671573246286815,4
2020-06-06-170216,170216,2,1,1,185,0.0,31.269670398577553,5
2020-06-07-170216,170216,0,3,0,185,0.0,37.84956469467684,6
2020-06-08-170216,170216,1,0,0,186,0.0,37.75478677673836,0
2020-06-09-170216,170216,1,0,0,187,0.14285714285714285,42.63841420094353,1
2020-06-10-170216,170216,0,1,2,187,0.14285714285714285,76.572520611074,2
2020-06-11-170216,170216,0,0,0,187,0.2857142857142857,65.85310253817852,3
2020-06-12-170216,170216,0,0,2,187,0.5714285714285714,54.12094060602429,4
2020-06-13-170216,170216,0,0,0,187,0.14285714285714285,42.175399439122,5
2020-06-14-170216,170216,0,0,0,187,0.14285714285714285,28.312771469583893,6
2020-06-15-170216,170216,0,0,0,187,0.0,15.843160657274815,0
2020-06-16-170216,170216,1,0,0,188,0.5714285714285714,16.484956919594723,1
2020-06-17-170216,170216,0,0,0,188,0.14285714285714285,20.297439678346873,2
2020-06-18-170216,170216,2,0,0,190,1.0,18.61031363225768,3
2020-06-19-170216,170216,0,0,0,190,0.5714285714285714,20.911238653302902,4
2020-06-20-170216,170216,1,0,0,191,0.14285714285714285,33.761954501671255,5
2020-06-21-170216,170216,0,0,0,191,0.0,39.806082971862125,6
2020-06-22-170216,170216,0,0,1,191,0.42857142857142855,38.150190345848095,0
2020-06-23-170216,170216,0,0,1,191,0.2857142857142857,34.18166751120891,1
2020-06-24-170216,170216,2,0,0,193,0.7142857142857143,35.47760876965052,2
2020-06-25-170216,170216,0,0,0,193,0.14285714285714285,37.65854535647409,3
2020-06-26-170216,170216,2,0,0,195,0.2857142857142857,34.21773752345287,4
2020-06-27-170216,170216,0,0,0,195,0.14285714285714285,29.61558038720386,5
2020-06-28-170216,170216,0,1,1,195,0.0,23.4126329786843,6
2020-06-29-170216,170216,0,0,1,195,0.14285714285714285,23.48423088636747,0
2020-06-30-170216,170216,0,0,2,195,0.2857142857142857,27.174389146769414,1
2020-07-01-170216,170216,0,0,1,195,0.42857142857142855,41.261439524073495,2
2020-07-02-170216,170216,0,0,1,195,0.14285714285714285,29.741408919803696,3
2020-07-03-170216,170216,0,0,0,195,0.0,25.31627700130217,4
2020-07-04-170216,170216,0,0,0,195,0.0,35.22465879449931,5
2020-07-05-170216,170216,0,0,1,195,0.0,36.94008565573198,6
2020-07-06-170216,170216,1,0,0,196,0.42857142857142855,32.070105735379535,0
2020-07-07-170216,170216,1,0,0,197,0.2857142857142857,30.39033058143088,1
2020-07-08-170216,170216,0,0,0,197,0.14285714285714285,28.702725049739467,2
2020-07-09-170216,170216,0,0,0,197,0.2857142857142857,29.76492026255228,3
2020-07-10-170216,170216,0,0,0,197,0.2857142857142857,43.95374556259058,4
2020-07-11-170216,170216,0,0,0,197,0.14285714285714285,37.08503957735528,5
2020-07-12-170216,170216,1,0,0,198,0.14285714285714285,30.12336957489658,6
2020-07-13-170216,170216,1,0,0,199,0.0,26.573429391818408,0
2020-07-14-170216,170216,2,1,0,201,0.42857142857142855,31.665553736952354,1
2020-07-15-170216,170216,1,0,2,202,0.14285714285714285,33.34569450467275,2
2020-07-16-170216,170216,1,0,0,203,0.2857142857142857,31.787961002395285,3
2020-07-17-170216,170216,0,0,0,203,0.14285714285714285,35.417099325237466,4
2020-07-18-170216,170216,0,0,0,203,0.0,33.194000667439504,5
2020-07-19-170216,170216,1,0,1,204,0.0,34.64046104896934,6
2020-07-20-170216,170216,0,0,0,204,0.14285714285714285,34.14416312024239,0
2020-07-21-170216,170216,0,0,0,204,0.2857142857142857,28.223605169609268,1
2020-07-22-170216,170216,0,0,1,204,0.14285714285714285,27.55626075175233,2
2020-07-23-170216,170216,0,0,2,204,0.14285714285714285,24.15148995869096,3
2020-07-24-170216,170216,0,0,1,204,0.14285714285714285,26.683900258472967,4
2020-07-25-170216,170216,0,0,0,204,0.14285714285714285,28.270673159258394,5
2020-07-26-170216,170216,0,0,0,204,0.14285714285714285,25.04752121629965,6
2020-07-27-170216,170216,0,0,0,204,0.5714285714285714,21.65577269482236,0
2020-07-28-170216,170216,0,0,1,204,0.42857142857142855,24.052950441680906,1
2020-07-29-170216,170216,2,0,2,206,0.42857142857142855,24.11977798165859,2
2020-07-30-170216,170216,0,0,4,206,0.7142857142857143,27.522351958378543,3
2020-07-31-170216,170216,0,0,2,206,1.0,36.0215303574011,4
2020-08-01-170216,170216,0,0,5,206,1.0,28.051067470169226,5
2020-08-02-170216,170216,1,0,3,207,0.42857142857142855,335.5011586270169,6
2020-08-03-170216,170216,0,0,5,207,1.4285714285714286,244.88120927437595,0
2020-08-04-170216,170216,0,0,3,207,3.0,168.08369815218785,1
2020-08-05-170216,170216,1,0,4,208,3.1428571428571432,176.09372035314306,2
2020-08-06-170216,170216,2,0,2,210,2.8571428571428568,194.92976573691163,3
2020-08-07-170216,170216,1,0,7,211,1.7142857142857142,199.22192011563368,4
2020-08-08-170216,170216,0,0,1,211,2.2857142857142856,204.12048791455598,5
2020-08-09-170216,170216,0,0,8,211,2.142857142857143,202.9454107153845,6
2020-08-10-170216,170216,0,0,9,211,4.571428571428571,25.716990612047876,0
2020-08-11-170216,170216,1,0,3,212,3.8571428571428568,65.48987430994595,1
2020-08-12-170216,170216,2,0,2,214,4.0,110.96598722790128,2
2020-08-13-170216,170216,4,0,0,218,3.571428571428572,159.8653860842649,3
2020-08-14-170216,170216,2,0,4,220,3.1428571428571432,190.26853589336906,4
2020-08-15-170216,170216,5,0,1,225,2.4285714285714284,230.23842451549135,5
2020-08-16-170216,170216,3,0,1,228,1.8571428571428568,269.2255675877244,6
2020-08-17-170216,170216,5,0,0,233,6.142857142857142,295.4367243018441,0
2020-08-18-170216,170216,3,0,1,236,4.571428571428571,325.6297970860032,1
2020-08-19-170216,170216,4,0,2,240,2.571428571428572,325.06952554517176,2
2020-08-20-170216,170216,2,0,0,242,3.571428571428572,287.55998102821434,3
2020-08-21-170216,170216,7,0,1,249,3.7142857142857135,298.5838964614934,4
2020-08-22-170216,170216,1,0,1,250,1.8571428571428568,311.5037214550059,5
2020-08-23-170216,170216,8,0,0,258,1.0,306.7364788651855,6
2020-08-24-170216,170216,9,0,4,267,2.8571428571428568,278.4582806770196,0
2020-08-25-170216,170216,3,0,1,270,2.142857142857143,281.6514706624266,1
2020-08-26-170216,170216,2,0,4,272,1.8571428571428568,270.1106421591324,2
2020-08-27-170216,170216,0,0,9,272,2.142857142857143,273.6637387409725,3
2020-08-28-170216,170216,4,0,7,276,1.7142857142857142,239.71280493542338,4
2020-08-29-170216,170216,1,0,11,277,1.0,220.36229657866932,5
2020-08-30-170216,170216,1,0,2,278,1.1428571428571428,191.95243804568872,6
2020-08-31-170216,170216,0,0,5,278,1.2857142857142858,155.39900602588764,0
2020-09-01-170216,170216,1,0,7,279,1.4285714285714286,186.73214776267253,1
2020-09-02-170216,170216,2,0,3,281,1.8571428571428568,245.9095485188077,2
2020-09-03-170216,170216,0,0,5,281,5.428571428571429,196.00188276433704,3
2020-09-04-170216,170216,1,0,3,282,2.0,221.00767279540884,4
2020-09-05-170216,170216,1,0,1,283,0.7142857142857143,209.604682737917,5
2020-09-06-170216,170216,0,0,3,283,3.1428571428571432,206.13002079729452,6
2020-09-07-170216,170216,4,0,5,287,1.8571428571428568,228.57134428181388,0
2020-09-08-170216,170216,1,0,3,288,5.142857142857143,224.17390291507456,1
2020-09-09-170216,170216,4,0,4,292,1.8571428571428568,209.10538447459072,2
2020-09-10-170216,170216,9,0,6,301,5.0,183.8476189714192,3
2020-09-11-170216,170216,7,0,0,308,4.714285714285714,217.89334484713464,4
2020-09-12-170216,170216,11,0,2,319,1.4285714285714286,243.9530472717841,5
2020-09-13-170216,170216,2,0,1,321,2.0,250.91847838747913,6
2020-09-14-170216,170216,5,0,3,326,1.2857142857142858,250.14621078147317,0
2020-09-15-170216,170216,7,0,2,333,6.428571428571429,242.80761368418501,1
2020-09-16-170216,170216,3,0,4,336,3.4285714285714284,291.0842199517126,2
2020-09-17-170216,170216,5,0,3,341,2.2857142857142856,317.23058317061003,3
2020-09-18-170216,170216,3,0,5,344,3.2857142857142856,291.5646720856938,4
2020-09-19-170216,170216,1,0,1,345,1.4285714285714286,261.23225593461893,5
2020-09-20-170216,170216,3,0,1,348,3.0,207.18552355332682,6
2020-09-21-170216,170216,5,0,1,353,3.2857142857142856,211.10480838525848,0
2020-09-22-170216,170216,3,0,4,356,1.4285714285714286,192.34151890045212,1
2020-09-23-170216,170216,4,1,2,360,2.571428571428572,164.0243054227153,2
2020-09-24-170216,170216,6,0,2,366,1.4285714285714286,159.16014161366576,3
2020-09-25-170216,170216,0,0,1,366,3.0,149.83708769901187,4
2020-09-26-170216,170216,2,0,2,368,0.7142857142857143,164.12873596142475,5
2020-09-27-170216,170216,1,0,1,369,1.1428571428571428,171.78926855126514,6
2020-09-28-170216,170216,3,0,1,372,1.8571428571428568,160.56414187693923,0
2020-09-29-170216,170216,2,0,1,374,2.8571428571428568,154.30559225629204,1
2020-09-30-170216,170216,4,0,8,378,1.5714285714285714,197.9002396072319,2
2020-10-01-170216,170216,3,0,2,381,2.4285714285714284,0.0,3
2020-10-02-170216,170216,5,0,4,386,1.5714285714285714,304.0217680612409,4
2020-10-03-170216,170216,1,2,1,387,1.1428571428571428,470.8047701214156,5
2020-10-04-170216,170216,1,1,1,388,1.8571428571428568,509.3571640255791,6
2020-10-05-170216,170216,1,1,6,389,1.8571428571428568,444.90271739319155,0
2020-10-06-170216,170216,4,0,1,393,2.8571428571428568,402.97087547817273,1
2020-10-07-170216,170216,2,1,3,395,3.1428571428571432,322.82053551666513,2
2020-10-08-170216,170216,2,1,3,397,2.142857142857143,276.31510099019033,3
2020-10-09-170216,170216,1,0,6,398,2.571428571428572,292.0884386870635,4
2020-10-10-170216,170216,2,0,1,400,1.4285714285714286,21.734607425299682,5
2020-10-11-170216,170216,1,0,0,401,1.1428571428571428,41.128630937452265,6
2020-10-12-170216,170216,1,0,4,402,2.0,58.67290064259012,0
2020-10-13-170216,170216,1,0,3,403,1.8571428571428568,89.83474290736626,1
2020-10-14-170216,170216,8,0,14,411,3.7142857142857135,125.4728844371221,2
2020-10-15-170216,170216,2,0,10,413,3.0,197.5482466541431,3
2020-10-16-170216,170216,4,0,13,417,3.4285714285714284,245.59499387916975,4
2020-10-17-170216,170216,1,0,3,418,1.0,242.79935470755686,5
2020-10-18-170216,170216,1,0,6,419,1.4285714285714286,232.84072435514497,6
2020-10-19-170216,170216,6,0,0,425,4.571428571428571,225.73930790090466,0
2020-10-20-170216,170216,1,0,7,426,2.571428571428572,265.545219366244,1
2020-10-21-170216,170216,3,1,10,429,4.714285714285714,242.9229975670073,2
2020-10-22-170216,170216,3,0,6,432,4.857142857142857,255.8124067151146,3
2020-10-23-170216,170216,6,0,15,438,3.8571428571428568,260.06880082833027,4
2020-10-24-170216,170216,1,0,1,439,2.8571428571428568,314.37296650670305,5
2020-10-25-170216,170216,0,0,2,439,2.2857142857142856,311.7129195096974,6
2020-10-26-170216,170216,4,1,4,443,6.428571428571429,264.70904179402953,0
2020-10-27-170216,170216,3,1,4,446,4.714285714285714,291.3052472788676,1
2020-10-28-170216,170216,14,0,5,460,9.857142857142858,313.5868498570133,2
2020-10-29-170216,170216,10,0,2,470,5.857142857142858,360.3417908186967,3
2020-10-30-170216,170216,13,0,6,483,8.428571428571429,351.4670781846895,4
2020-10-31-170216,170216,3,0,0,486,5.285714285714286,414.9885154413483,5
2020-11-01-170216,170216,6,2,0,492,4.714285714285714,197.31831489348997,6
2020-11-02-170216,170216,0,0,0,492,3.1428571428571432,450.51171093971755,0
2020-11-03-170216,170216,7,1,0,499,7.7142857142857135,349.00138280829765,1
2020-11-04-170216,170216,10,0,0,509,5.0,419.5794617342949,2
2020-11-05-170216,170216,6,1,0,515,7.2857142857142865,440.12501144368866,3
2020-11-06-170216,170216,15,0,0,530,10.0,489.7609057042125,4
2020-11-07-170216,170216,1,0,0,531,3.4285714285714284,525.4688971493408,5
2020-11-08-170216,170216,2,0,0,533,6.7142857142857135,481.6217948581416,6
2020-11-09-170216,170216,4,0,0,537,5.285714285714286,479.4147418720516,0
2020-11-10-170216,170216,4,1,0,541,6.2857142857142865,194.81338758615092,1
2020-11-11-170216,170216,5,0,0,546,3.2857142857142856,249.14908788364238,2
2020-11-12-170216,170216,2,0,0,548,9.714285714285714,290.68554717281825,3
2020-11-13-170216,170216,6,1,0,554,9.142857142857142,312.32573002650594,4
2020-03-01-170217,170217,1,0,6,1,0.14285714285714285,0.0,6
2020-03-02-170217,170217,0,0,12,1,0.42857142857142855,72.69593244061036,0
2020-03-03-170217,170217,0,0,10,1,0.2857142857142857,286.23436897815196,1
2020-03-04-170217,170217,0,0,15,1,0.42857142857142855,306.26249012018957,2
2020-03-05-170217,170217,2,1,21,3,0.2857142857142857,337.2401489553106,3
2020-03-06-170217,170217,0,0,33,3,0.42857142857142855,287.4265928253527,4
2020-03-07-170217,170217,0,0,16,3,0.0,301.7116300318228,5
2020-03-08-170217,170217,1,0,12,4,0.14285714285714285,284.46528207885666,6
2020-03-09-170217,170217,2,0,29,6,0.2857142857142857,283.77037446395076,0
2020-03-10-170217,170217,3,1,22,9,1.8571428571428568,1536.4908184082224,1
2020-03-11-170217,170217,6,0,16,15,0.7142857142857143,1288.4824673617381,2
2020-03-12-170217,170217,3,0,22,18,1.4285714285714286,1025.9210958362014,3
2020-03-13-170217,170217,4,0,16,22,2.0,717.4865539529479,4
2020-03-14-170217,170217,2,0,8,24,2.0,570.2803187362249,5
2020-03-15-170217,170217,6,0,8,30,3.1428571428571432,419.36183853512523,6
2020-03-16-170217,170217,12,0,14,42,9.142857142857142,133.82491297521682,0
2020-03-17-170217,170217,10,0,10,52,11.0,211.40466072927282,1
2020-03-18-170217,170217,15,0,12,67,19.571428571428573,262.043449413386,2
2020-03-19-170217,170217,21,0,9,88,18.857142857142858,348.5966876254886,3
2020-03-20-170217,170217,33,0,13,121,21.142857142857142,401.9038133210521,4
2020-03-21-170217,170217,16,0,2,137,6.857142857142858,459.0658083524535,5
2020-03-22-170217,170217,12,0,8,149,8.285714285714286,459.9562031011824,6
2020-03-23-170217,170217,29,0,17,178,21.714285714285715,436.2512304098566,0
2020-03-24-170217,170217,22,0,7,200,19.857142857142858,487.562842372653,1
2020-03-25-170217,170217,16,0,7,216,18.285714285714285,489.28408084482203,2
2020-03-26-170217,170217,22,0,7,238,14.142857142857142,467.5893849416591,3
2020-03-27-170217,170217,16,0,7,254,20.428571428571427,531.9970223707586,4
2020-03-28-170217,170217,8,0,2,262,6.857142857142858,524.6191733122531,5
2020-03-29-170217,170217,8,0,3,270,4.857142857142857,513.8852205146214,6
2020-03-30-170217,170217,14,0,8,284,15.571428571428573,392.39096419619966,0
2020-03-31-170217,170217,10,0,9,294,10.857142857142858,355.30571522900505,1
2020-04-01-170217,170217,12,0,15,306,9.285714285714286,57.57479998796071,2
2020-04-02-170217,170217,9,0,7,315,8.428571428571429,238.5045404253209,3
2020-04-03-170217,170217,13,0,11,328,9.428571428571429,119.17035132973486,4
2020-04-04-170217,170217,2,0,4,330,3.2857142857142856,158.5500324890392,5
2020-04-05-170217,170217,8,0,3,338,3.0,167.05476636693615,6
2020-04-06-170217,170217,17,0,7,355,8.571428571428571,180.11270035279267,0
2020-04-07-170217,170217,7,3,5,362,6.428571428571429,202.5257420238837,1
2020-04-08-170217,170217,7,1,5,369,7.857142857142858,213.29002818176755,2
2020-04-09-170217,170217,7,0,5,376,4.857142857142857,230.81853127160076,3
2020-04-10-170217,170217,7,0,1,383,12.714285714285715,46.655473791394044,4
2020-04-11-170217,170217,2,0,1,385,5.285714285714286,81.08463614810238,5
2020-04-12-170217,170217,3,0,0,388,2.2857142857142856,104.57623137983003,6
2020-04-13-170217,170217,8,0,6,396,9.571428571428571,113.03942102819852,0
2020-04-14-170217,170217,9,0,6,405,6.571428571428571,158.64318034993585,1
2020-04-15-170217,170217,15,0,5,420,16.285714285714285,195.4304543984166,2
2020-04-16-170217,170217,7,0,2,427,8.142857142857142,250.53075194952504,3
2020-04-17-170217,170217,11,0,1,438,12.428571428571427,259.32341830621124,4
2020-04-18-170217,170217,4,0,0,442,2.7142857142857144,276.8946514474924,5
2020-04-19-170217,170217,3,0,2,445,4.285714285714286,261.7092920669894,6
2020-04-20-170217,170217,7,0,5,452,6.571428571428571,265.6621201900957,0
2020-04-21-170217,170217,5,0,5,457,5.142857142857143,264.69277119898413,1
2020-04-22-170217,170217,5,0,7,462,8.571428571428571,234.19824558566884,2
2020-04-23-170217,170217,5,0,3,467,1.4285714285714286,233.95331668325775,3
2020-04-24-170217,170217,1,0,1,468,5.0,184.47088428545658,4
2020-04-25-170217,170217,1,0,0,469,1.5714285714285714,197.26746927083366,5
2020-04-26-170217,170217,0,0,0,469,1.0,190.8032434581987,6
2020-04-27-170217,170217,6,1,8,475,6.428571428571429,152.39892008083737,0
2020-04-28-170217,170217,6,0,6,481,5.0,151.9221162372353,1
2020-04-29-170217,170217,5,0,7,486,3.571428571428572,149.70735388405168,2
2020-04-30-170217,170217,2,0,13,488,4.571428571428571,182.80727768462663,3
2020-05-01-170217,170217,1,0,6,489,1.0,251.64754997119317,4
2020-05-02-170217,170217,0,0,1,489,1.0,196.3305805129224,5
2020-05-03-170217,170217,2,0,0,491,0.7142857142857143,92.8501624963679,6
2020-05-04-170217,170217,5,0,8,496,3.7142857142857135,72.35224644523744,0
2020-05-05-170217,170217,5,0,6,501,4.142857142857143,73.08281514722552,1
2020-05-06-170217,170217,7,0,5,508,4.142857142857143,81.66723628026489,2
2020-05-07-170217,170217,3,0,2,511,3.8571428571428568,87.91458969418636,3
2020-05-08-170217,170217,1,0,4,512,5.142857142857143,94.14497030423654,4
2020-05-09-170217,170217,0,0,0,512,0.2857142857142857,124.36684343883553,5
2020-05-10-170217,170217,0,5,0,512,0.42857142857142855,266.0263716730242,6
2020-05-11-170217,170217,8,0,9,520,4.571428571428571,242.2330942188433,0
2020-05-12-170217,170217,6,1,2,526,3.1428571428571432,248.15307795659055,1
2020-05-13-170217,170217,7,0,5,533,6.2857142857142865,200.87516227444235,2
2020-05-14-170217,170217,13,0,5,546,7.0,211.12267171693213,3
2020-05-15-170217,170217,6,0,2,552,7.428571428571429,217.28861170446743,4
2020-05-16-170217,170217,1,0,0,553,1.5714285714285714,220.4662758724648,5
2020-05-17-170217,170217,0,0,0,553,0.0,220.7935376960023,6
2020-05-18-170217,170217,8,0,3,561,7.571428571428571,220.8949630730691,0
2020-05-19-170217,170217,6,0,1,567,3.4285714285714284,236.20787159877912,1
2020-05-20-170217,170217,5,0,2,572,3.7142857142857135,198.50972467612138,2
2020-05-21-170217,170217,2,0,0,574,4.428571428571429,176.24101241647418,3
2020-05-22-170217,170217,4,0,1,578,5.7142857142857135,165.73593055431226,4
2020-05-23-170217,170217,0,0,2,578,0.5714285714285714,195.22681240707473,5
2020-05-24-170217,170217,0,0,0,578,0.14285714285714285,199.00461292298635,6
2020-05-25-170217,170217,9,0,3,587,6.2857142857142865,149.05551922830267,0
2020-05-26-170217,170217,2,0,2,589,2.8571428571428568,151.3263215847885,1
2020-05-27-170217,170217,5,0,1,594,2.4285714285714284,174.31940877021236,2
2020-05-28-170217,170217,5,0,1,599,2.2857142857142856,163.2585035711976,3
2020-05-29-170217,170217,2,0,1,601,2.4285714285714284,148.50515147475494,4
2020-05-30-170217,170217,0,0,0,601,0.0,141.51709489772753,5
2020-05-31-170217,170217,0,0,0,601,0.0,142.72169671577575,6
2020-06-01-170217,170217,3,0,0,604,1.4285714285714286,158.1634919540703,0
2020-06-02-170217,170217,1,0,1,605,1.2857142857142858,44.441506997493924,1
2020-06-03-170217,170217,2,0,1,607,1.4285714285714286,34.892859617298626,2
2020-06-04-170217,170217,0,0,2,607,2.571428571428572,35.827669101546746,3
2020-06-05-170217,170217,1,0,0,608,3.1428571428571432,45.3304895496961,4
2020-06-06-170217,170217,2,0,0,610,0.42857142857142855,52.59564918668367,5
2020-06-07-170217,170217,0,0,0,610,0.2857142857142857,54.27787516629306,6
2020-06-08-170217,170217,3,0,1,613,2.4285714285714284,54.908217920973094,0
2020-06-09-170217,170217,2,0,0,615,1.1428571428571428,68.32915293695977,1
2020-06-10-170217,170217,1,0,1,616,1.0,175.75528330760724,2
2020-06-11-170217,170217,1,0,2,617,2.2857142857142856,162.64032836294734,3
2020-06-12-170217,170217,1,0,2,618,1.2857142857142858,148.05661153429054,4
2020-06-13-170217,170217,0,0,0,618,0.0,120.31492028190779,5
2020-06-14-170217,170217,0,0,0,618,0.2857142857142857,94.0288255386081,6
2020-06-15-170217,170217,0,0,0,618,1.8571428571428568,54.48984124882734,0
2020-06-16-170217,170217,1,0,1,619,1.0,68.74676962352981,1
2020-06-17-170217,170217,1,0,0,620,1.1428571428571428,63.23491213924625,2
2020-06-18-170217,170217,2,0,0,622,1.1428571428571428,60.408946186088144,3
2020-06-19-170217,170217,0,0,0,622,0.42857142857142855,53.724777225732815,4
2020-06-20-170217,170217,0,0,0,622,0.14285714285714285,62.258224270129936,5
2020-06-21-170217,170217,0,0,0,622,0.14285714285714285,62.1969462355334,6
2020-06-22-170217,170217,1,0,0,623,1.0,49.134752465161384,0
2020-06-23-170217,170217,0,0,1,623,0.5714285714285714,47.81461583856065,1
2020-06-24-170217,170217,1,0,0,624,1.0,43.295553724739655,2
2020-06-25-170217,170217,2,0,0,626,1.4285714285714286,44.85594303460536,3
2020-06-26-170217,170217,2,0,1,628,1.0,48.9683327816967,4
2020-06-27-170217,170217,0,0,0,628,0.2857142857142857,45.12199822495671,5
2020-06-28-170217,170217,0,0,0,628,0.2857142857142857,47.92561537117565,6
2020-06-29-170217,170217,0,0,2,628,0.0,46.61096620468591,0
2020-06-30-170217,170217,1,0,1,629,0.5714285714285714,41.81158815632803,1
2020-07-01-170217,170217,0,0,10,629,0.7142857142857143,74.20130290462863,2
2020-07-02-170217,170217,0,0,0,629,0.14285714285714285,58.8750780792808,3
2020-07-03-170217,170217,0,0,0,629,0.8571428571428571,64.48348860693407,4
2020-07-04-170217,170217,0,0,2,629,0.0,83.7839473641165,5
2020-07-05-170217,170217,0,0,1,629,0.2857142857142857,80.94467840438377,6
2020-07-06-170217,170217,0,0,1,629,0.14285714285714285,68.41925545158635,0
2020-07-07-170217,170217,1,0,1,630,0.42857142857142855,64.5402276454034,1
2020-07-08-170217,170217,0,0,0,630,0.14285714285714285,55.33977288497012,2
2020-07-09-170217,170217,0,0,0,630,0.7142857142857143,51.359845695343935,3
2020-07-10-170217,170217,1,0,0,631,0.5714285714285714,76.53102501554741,4
2020-07-11-170217,170217,0,0,0,631,0.14285714285714285,64.14240007572278,5
2020-07-12-170217,170217,0,1,0,631,0.14285714285714285,47.36325404691067,6
2020-07-13-170217,170217,2,0,3,633,0.14285714285714285,44.43803158618541,0
2020-07-14-170217,170217,1,0,1,634,0.2857142857142857,53.63946389921398,1
2020-07-15-170217,170217,10,0,1,644,1.4285714285714286,44.25520404355208,2
2020-07-16-170217,170217,0,0,7,644,0.7142857142857143,42.74988641084602,3
2020-07-17-170217,170217,0,0,4,644,1.0,39.46406291453755,4
2020-07-18-170217,170217,2,0,0,646,1.1428571428571428,50.418345766374436,5
2020-07-19-170217,170217,1,0,0,647,0.2857142857142857,59.348475726788564,6
2020-07-20-170217,170217,1,0,2,648,0.5714285714285714,49.66835707227645,0
2020-07-21-170217,170217,1,0,5,649,0.8571428571428571,55.623112013862496,1
2020-07-22-170217,170217,0,0,2,649,0.5714285714285714,51.79084991031372,2
2020-07-23-170217,170217,0,0,5,649,1.4285714285714286,58.66893140923477,3
2020-07-24-170217,170217,0,0,5,649,1.4285714285714286,54.992013993068014,4
2020-07-25-170217,170217,0,0,1,649,0.42857142857142855,52.56103079591145,5
2020-07-26-170217,170217,0,0,3,649,0.2857142857142857,53.573064518515416,6
2020-07-27-170217,170217,3,0,4,652,1.5714285714285714,56.4560969897507,0
2020-07-28-170217,170217,1,0,3,653,2.0,59.46458607963818,1
2020-07-29-170217,170217,1,0,4,654,2.0,59.12538656072807,2
2020-07-30-170217,170217,7,0,4,661,2.0,60.23740801313616,3
2020-07-31-170217,170217,4,0,0,665,2.8571428571428568,76.91604695578326,4
2020-08-01-170217,170217,0,0,4,665,0.14285714285714285,31.701324636500267,5
2020-08-02-170217,170217,0,0,1,665,0.2857142857142857,197.97109539210183,6
2020-08-03-170217,170217,2,0,1,667,1.8571428571428568,208.64682196424252,0
2020-08-04-170217,170217,5,0,4,672,1.5714285714285714,206.4866643683498,1
2020-08-05-170217,170217,2,0,2,674,2.4285714285714284,198.30545107095503,2
2020-08-06-170217,170217,5,0,2,679,1.7142857142857142,205.80331205897687,3
2020-08-07-170217,170217,5,0,3,684,1.8571428571428568,194.81146499852088,4
2020-08-08-170217,170217,1,0,0,685,2.571428571428572,199.5027832374849,5
2020-08-09-170217,170217,3,0,2,688,0.8571428571428571,200.30360004690147,6
2020-08-10-170217,170217,4,0,7,692,3.571428571428572,22.67261669489497,0
2020-08-11-170217,170217,3,1,8,695,3.571428571428572,51.05074869782334,1
2020-08-12-170217,170217,4,0,12,699,5.142857142857143,81.30769384016187,2
2020-08-13-170217,170217,4,0,7,703,3.4285714285714284,108.02476956255595,3
2020-08-14-170217,170217,0,0,10,703,2.142857142857143,130.8735395430965,4
2020-08-15-170217,170217,4,0,1,707,1.1428571428571428,150.5646991437304,5
2020-08-16-170217,170217,1,0,7,708,1.5714285714285714,153.4805296744291,6
2020-08-17-170217,170217,1,0,4,709,2.7142857142857144,167.94529570803317,0
2020-08-18-170217,170217,4,0,5,713,3.7142857142857135,163.3454989656032,1
2020-08-19-170217,170217,2,0,9,715,2.8571428571428568,177.06835349437222,2
2020-08-20-170217,170217,2,0,10,717,2.142857142857143,154.87899207237206,3
2020-08-21-170217,170217,3,0,13,720,2.571428571428572,158.20296333138847,4
2020-08-22-170217,170217,0,0,5,720,2.571428571428572,177.62171453605106,5
2020-08-23-170217,170217,2,0,1,722,1.1428571428571428,188.5748042598197,6
2020-08-24-170217,170217,7,0,5,729,6.428571428571429,180.0340951072363,0
2020-08-25-170217,170217,8,0,9,737,4.142857142857143,185.1274241028003,1
2020-08-26-170217,170217,12,0,5,749,2.8571428571428568,190.21325708953506,2
2020-08-27-170217,170217,7,0,22,756,5.857142857142858,214.23630992130776,3
2020-08-28-170217,170217,10,0,14,766,3.2857142857142856,211.56755566850595,4
2020-08-29-170217,170217,1,0,1,767,2.0,210.0625214395639,5
2020-08-30-170217,170217,7,0,1,774,2.2857142857142856,201.90671992377537,6
2020-08-31-170217,170217,4,0,7,778,6.2857142857142865,177.13159877213738,0
2020-09-01-170217,170217,5,0,33,783,6.0,186.4350516375465,1
2020-09-02-170217,170217,9,0,22,792,5.7142857142857135,361.89184076974885,2
2020-09-03-170217,170217,10,0,23,802,5.7142857142857135,302.0534120866151,3
2020-09-04-170217,170217,13,0,24,815,4.857142857142857,302.56161591876435,4
2020-09-05-170217,170217,5,0,7,820,2.142857142857143,291.415989057844,5
2020-09-06-170217,170217,1,0,1,821,1.5714285714285714,297.8104705791933,6
2020-09-07-170217,170217,5,0,35,826,5.0,304.77653594739616,0
2020-09-08-170217,170217,9,0,25,835,5.428571428571429,297.24635550606456,1
2020-09-09-170217,170217,5,0,20,840,6.428571428571429,302.2292019399479,2
2020-09-10-170217,170217,22,0,12,862,6.571428571428571,225.72921626936204,3
2020-09-11-170217,170217,14,0,25,876,6.7142857142857135,244.15211554357393,4
2020-09-12-170217,170217,1,0,0,877,2.571428571428572,277.0205632108464,5
2020-09-13-170217,170217,1,0,1,878,2.4285714285714284,292.56553651655037,6
2020-09-14-170217,170217,7,0,10,885,8.142857142857142,319.17575975307363,0
2020-09-15-170217,170217,33,0,3,918,8.285714285714286,369.103135074928,1
2020-09-16-170217,170217,22,0,7,940,6.571428571428571,426.8903365390822,2
2020-09-17-170217,170217,23,1,13,963,11.428571428571427,397.36532122590626,3
2020-09-18-170217,170217,24,0,31,987,7.857142857142858,418.64491842497466,4
2020-09-19-170217,170217,7,2,4,994,1.5714285714285714,432.5059295127671,5
2020-09-20-170217,170217,1,0,9,995,1.2857142857142858,415.0912665686676,6
2020-09-21-170217,170217,35,2,14,1030,10.0,353.84810412294223,0
2020-09-22-170217,170217,25,0,9,1055,9.571428571428571,350.72945770529236,1
2020-09-23-170217,170217,20,0,17,1075,8.571428571428571,347.36050724830204,2
2020-09-24-170217,170217,12,0,13,1087,6.428571428571429,347.5421220993261,3
2020-09-25-170217,170217,25,1,20,1112,6.142857142857142,312.6921538095131,4
2020-09-26-170217,170217,0,0,3,1112,0.7142857142857143,361.26109670516513,5
2020-09-27-170217,170217,1,0,2,1113,1.1428571428571428,319.2737351293042,6
2020-09-28-170217,170217,10,1,3,1123,5.428571428571429,318.3909079614634,0
2020-09-29-170217,170217,3,0,11,1126,4.142857142857143,331.9822290333219,1
2020-09-30-170217,170217,7,0,10,1133,5.0,313.0930754876166,2
2020-10-01-170217,170217,13,0,33,1146,6.857142857142858,0.0,3
2020-10-02-170217,170217,31,0,20,1177,8.142857142857142,848.3152098030023,4
2020-10-03-170217,170217,4,0,3,1181,2.142857142857143,1260.466334051586,5
2020-10-04-170217,170217,9,0,6,1190,2.2857142857142856,1284.626438766016,6
2020-10-05-170217,170217,14,0,26,1204,4.142857142857143,1057.0545040915106,0
2020-10-06-170217,170217,9,0,11,1213,5.0,908.0441477262062,1
2020-10-07-170217,170217,17,2,28,1230,8.0,752.4159877300947,2
2020-10-08-170217,170217,13,1,28,1243,9.285714285714286,651.7290731823207,3
2020-10-09-170217,170217,20,1,19,1263,14.714285714285715,701.6666177491682,4
2020-10-10-170217,170217,3,0,7,1266,2.2857142857142856,54.18556809718224,5
2020-10-11-170217,170217,2,0,13,1268,4.857142857142857,90.22412192475606,6
2020-10-12-170217,170217,3,0,30,1271,6.857142857142858,140.36036978573733,0
2020-10-13-170217,170217,11,0,17,1282,10.857142857142858,210.37958284819143,1
2020-10-14-170217,170217,10,0,28,1292,8.571428571428571,368.4053920072177,2
2020-10-15-170217,170217,33,0,25,1325,14.0,447.75177943150345,3
2020-10-16-170217,170217,20,0,34,1345,12.142857142857142,624.4663665231988,4
2020-10-17-170217,170217,3,0,17,1348,3.7142857142857135,721.921609620303,5
2020-10-18-170217,170217,6,1,29,1354,1.8571428571428568,728.5722100139042,6
2020-10-19-170217,170217,26,0,7,1380,16.714285714285715,717.5573974309996,0
2020-10-20-170217,170217,11,0,25,1391,13.285714285714285,785.7406768754543,1
2020-10-21-170217,170217,28,0,27,1419,19.571428571428573,861.8330825579742,2
2020-10-22-170217,170217,28,0,37,1447,15.857142857142858,865.1039794728365,3
2020-10-23-170217,170217,19,0,23,1466,15.428571428571427,919.1895281723806,4
2020-10-24-170217,170217,7,1,14,1473,4.857142857142857,1055.9849387742968,5
2020-10-25-170217,170217,13,0,15,1486,9.857142857142858,1094.871061782018,6
2020-10-26-170217,170217,30,0,26,1516,19.857142857142858,974.4233086466334,0
2020-10-27-170217,170217,17,0,28,1533,19.857142857142858,1164.3290866304192,1
2020-10-28-170217,170217,28,1,26,1561,19.428571428571427,1216.7213620048447,2
2020-10-29-170217,170217,25,0,28,1586,17.714285714285715,1252.1938696683214,3
2020-10-30-170217,170217,34,0,24,1620,19.285714285714285,1127.8195640851277,4
2020-10-31-170217,170217,17,0,0,1637,8.142857142857142,1283.433665956787,5
2020-11-01-170217,170217,29,0,0,1666,16.0,527.3568421339564,6
2020-11-02-170217,170217,7,0,0,1673,18.857142857142858,1257.1063328339092,0
2020-11-03-170217,170217,25,1,0,1698,21.428571428571427,1117.1756233312362,1
2020-11-04-170217,170217,27,0,0,1725,20.857142857142858,1318.3824479999917,2
2020-11-05-170217,170217,37,0,0,1762,23.142857142857146,1346.7131829881196,3
2020-11-06-170217,170217,23,1,0,1785,32.714285714285715,1428.0834345659132,4
2020-11-07-170217,170217,14,0,0,1799,14.285714285714285,1471.7986427927092,5
2020-11-08-170217,170217,15,0,0,1814,14.142857142857142,1412.075959159269,6
2020-11-09-170217,170217,26,0,0,1840,27.42857142857143,1413.2750993697027,0
2020-11-10-170217,170217,28,0,0,1868,20.857142857142858,594.7149177122951,1
2020-11-11-170217,170217,26,1,0,1894,20.142857142857142,757.4098884634395,2
2020-11-12-170217,170217,28,1,0,1922,23.42857142857143,900.598089874104,3
2020-11-13-170217,170217,24,4,0,1946,34.857142857142854,1040.5734141881435,4
2020-03-01-170218,170218,0,0,3,0,0.0,0.0,6
2020-03-02-170218,170218,0,0,14,0,0.0,124.06146481556023,0
2020-03-03-170218,170218,0,0,12,0,0.14285714285714285,547.1436019477773,1
2020-03-04-170218,170218,0,0,14,0,0.2857142857142857,600.1134048073166,2
2020-03-05-170218,170218,0,2,14,0,0.14285714285714285,643.7754622502014,3
2020-03-06-170218,170218,0,0,9,0,0.42857142857142855,547.7471735888109,4
2020-03-07-170218,170218,1,0,6,1,0.0,566.8298752888334,5
2020-03-08-170218,170218,0,0,12,1,0.0,534.3954718259599,6
2020-03-09-170218,170218,0,0,17,1,0.5714285714285714,532.2086172223574,0
2020-03-10-170218,170218,2,0,18,3,1.1428571428571428,2758.422190244722,1
2020-03-11-170218,170218,1,0,9,4,1.1428571428571428,2318.63584745582,2
2020-03-12-170218,170218,2,0,17,6,1.0,1845.724821612872,3
2020-03-13-170218,170218,3,0,13,9,2.2857142857142856,1293.540942858393,4
2020-03-14-170218,170218,0,0,6,9,2.142857142857143,1044.063996053801,5
2020-03-15-170218,170218,3,0,3,12,2.8571428571428568,755.8987388690441,6
2020-03-16-170218,170218,14,0,8,26,6.2857142857142865,247.98600759085193,0
2020-03-17-170218,170218,12,0,13,38,7.571428571428571,394.2228381344079,1
2020-03-18-170218,170218,14,0,8,52,15.714285714285715,507.0702636501055,2
2020-03-19-170218,170218,14,0,11,66,14.714285714285715,670.929816492225,3
2020-03-20-170218,170218,9,0,15,75,19.714285714285715,771.5427680035003,4
2020-03-21-170218,170218,6,0,8,81,5.7142857142857135,900.2441883360027,5
2020-03-22-170218,170218,12,0,0,93,6.857142857142858,906.7443104849594,6
2020-03-23-170218,170218,17,0,4,110,22.0,880.3546534880495,0
2020-03-24-170218,170218,18,0,4,128,15.857142857142858,981.7843953156466,1
2020-03-25-170218,170218,9,0,5,137,16.285714285714285,994.4135391055081,2
2020-03-26-170218,170218,17,0,5,154,13.857142857142858,946.5839530184921,3
2020-03-27-170218,170218,13,0,7,167,16.714285714285715,1098.8190906824902,4
2020-03-28-170218,170218,6,0,2,173,5.428571428571429,1088.7042793759051,5
2020-03-29-170218,170218,3,0,1,176,5.142857142857143,1072.8186311574946,6
2020-03-30-170218,170218,8,0,7,184,16.285714285714285,802.2797617361356,0
2020-03-31-170218,170218,13,0,11,197,10.142857142857142,733.282508895473,1
2020-04-01-170218,170218,8,0,3,205,10.285714285714286,123.44225996073251,2
2020-04-02-170218,170218,11,0,4,216,9.571428571428571,458.58626171761586,3
2020-04-03-170218,170218,15,0,9,231,9.428571428571429,253.18084592480383,4
2020-04-04-170218,170218,8,0,2,239,3.2857142857142856,336.9121082335836,5
2020-04-05-170218,170218,0,0,2,239,2.142857142857143,366.5977940593026,6
2020-04-06-170218,170218,4,0,10,243,7.857142857142858,372.0508369638513,0
2020-04-07-170218,170218,4,0,6,247,7.857142857142858,396.83004001766506,1
2020-04-08-170218,170218,5,0,5,252,8.142857142857142,421.6610095444804,2
2020-04-09-170218,170218,5,0,4,257,8.0,438.8595343757695,3
2020-04-10-170218,170218,7,0,8,264,13.142857142857142,95.42833251806867,4
2020-04-11-170218,170218,2,0,2,266,7.0,160.64488114667557,5
2020-04-12-170218,170218,1,0,4,267,2.571428571428572,220.33050862764645,6
2020-04-13-170218,170218,7,0,6,274,9.285714285714286,237.42269194121462,0
2020-04-14-170218,170218,11,0,4,285,7.142857142857142,325.5384661310446,1
2020-04-15-170218,170218,3,0,4,288,12.857142857142858,416.36794922153854,2
2020-04-16-170218,170218,4,1,2,292,7.0,504.45439327697613,3
2020-04-17-170218,170218,9,0,0,301,10.857142857142858,514.6411180513132,4
2020-04-18-170218,170218,2,0,0,303,2.2857142857142856,544.4130158623612,5
2020-04-19-170218,170218,2,0,0,305,4.714285714285714,493.6789977176258,6
2020-04-20-170218,170218,10,0,2,315,5.857142857142858,499.4910119196723,0
2020-04-21-170218,170218,6,0,2,321,6.428571428571429,489.2689511255413,1
2020-04-22-170218,170218,5,0,4,326,7.857142857142858,459.1702804029791,2
2020-04-23-170218,170218,4,0,2,330,1.8571428571428568,462.54878812858027,3
2020-04-24-170218,170218,8,0,6,338,4.0,374.2278080186785,4
2020-04-25-170218,170218,2,0,0,340,1.7142857142857142,401.4422126339442,5
2020-04-26-170218,170218,4,0,0,344,0.8571428571428571,391.03896054894915,6
2020-04-27-170218,170218,6,1,3,350,5.285714285714286,318.8570852259847,0
2020-04-28-170218,170218,4,0,4,354,4.0,309.315838405543,1
2020-04-29-170218,170218,4,0,9,358,5.0,290.5952657899582,2
2020-04-30-170218,170218,2,0,7,360,2.8571428571428568,381.8612291922544,3
2020-05-01-170218,170218,0,0,5,360,1.0,486.02692055091137,4
2020-05-02-170218,170218,0,0,2,360,1.7142857142857142,382.06910803950416,5
2020-05-03-170218,170218,0,0,0,360,0.5714285714285714,186.4448986678567,6
2020-05-04-170218,170218,2,0,2,362,3.571428571428572,148.0881180003168,0
2020-05-05-170218,170218,2,0,8,364,3.0,150.3810123188525,1
2020-05-06-170218,170218,4,0,5,368,4.142857142857143,157.3252472624236,2
2020-05-07-170218,170218,2,0,8,370,2.571428571428572,182.48808840709708,3
2020-05-08-170218,170218,6,0,0,376,4.857142857142857,187.16422908965922,4
2020-05-09-170218,170218,0,0,0,376,0.2857142857142857,260.39260217300387,5
2020-05-10-170218,170218,0,1,0,376,0.7142857142857143,514.351325078524,6
2020-05-11-170218,170218,3,0,4,379,6.428571428571429,449.36295528184786,0
2020-05-12-170218,170218,4,0,0,383,3.571428571428572,492.16010170468894,1
2020-05-13-170218,170218,9,0,4,392,6.7142857142857135,425.92679065777975,2
2020-05-14-170218,170218,7,0,1,399,6.7142857142857135,442.2362623898744,3
2020-05-15-170218,170218,5,0,2,404,6.2857142857142865,458.57729768611296,4
2020-05-16-170218,170218,2,0,0,406,1.5714285714285714,448.25923737301423,5
2020-05-17-170218,170218,0,0,0,406,0.14285714285714285,450.5883631748295,6
2020-05-18-170218,170218,2,0,1,408,5.571428571428571,451.6219178923001,0
2020-05-19-170218,170218,8,0,2,416,3.571428571428572,448.367930357055,1
2020-05-20-170218,170218,5,0,2,421,4.285714285714286,378.2888220539305,2
2020-05-21-170218,170218,8,0,2,429,3.0,352.29908632467686,3
2020-05-22-170218,170218,0,1,1,429,3.7142857142857135,340.7581830646494,4
2020-05-23-170218,170218,0,0,3,429,0.7142857142857143,382.54721188669043,5
2020-05-24-170218,170218,0,0,0,429,0.0,386.6770635783229,6
2020-05-25-170218,170218,4,0,0,433,5.428571428571429,305.64857124032847,0
2020-05-26-170218,170218,0,0,1,433,4.142857142857143,297.3150208952462,1
2020-05-27-170218,170218,4,0,7,437,2.7142857142857144,333.1996725655355,2
2020-05-28-170218,170218,1,1,2,438,2.8571428571428568,295.7534363340942,3
2020-05-29-170218,170218,2,0,0,440,2.142857142857143,266.6933194474926,4
2020-05-30-170218,170218,0,0,0,440,0.0,261.28929236697877,5
2020-05-31-170218,170218,0,0,0,440,0.0,263.67136639653825,6
2020-06-01-170218,170218,1,0,2,441,2.7142857142857144,307.15972475677245,0
2020-06-02-170218,170218,2,0,0,443,1.4285714285714286,88.90331714838862,1
2020-06-03-170218,170218,2,0,3,445,1.7142857142857142,66.2647218599441,2
2020-06-04-170218,170218,2,0,0,447,2.142857142857143,70.63628719703362,3
2020-06-05-170218,170218,1,0,1,448,2.571428571428572,87.90892560854624,4
2020-06-06-170218,170218,3,0,0,451,0.42857142857142855,103.70937557262332,5
2020-06-07-170218,170218,0,0,0,451,0.2857142857142857,112.28644167714575,6
2020-06-08-170218,170218,0,0,2,451,2.2857142857142856,112.92139329999253,0
2020-06-09-170218,170218,1,0,2,452,1.4285714285714286,138.4877387093714,1
2020-06-10-170218,170218,7,0,1,459,1.1428571428571428,355.8920279397149,2
2020-06-11-170218,170218,2,0,0,461,0.7142857142857143,336.07901504396904,3
2020-06-12-170218,170218,0,0,0,461,1.7142857142857142,304.5660765927338,4
2020-06-13-170218,170218,0,0,0,461,0.14285714285714285,241.06710354755793,5
2020-06-14-170218,170218,0,0,0,461,0.14285714285714285,201.33093732787125,6
2020-06-15-170218,170218,2,0,0,463,1.2857142857142858,117.92560109477648,0
2020-06-16-170218,170218,0,0,0,463,1.2857142857142858,143.47093837686072,1
2020-06-17-170218,170218,3,0,2,466,1.4285714285714286,125.24030337078568,2
2020-06-18-170218,170218,0,0,0,466,0.8571428571428571,115.92685595962601,3
2020-06-19-170218,170218,1,0,0,467,0.0,104.76603025780213,4
2020-06-20-170218,170218,0,0,0,467,0.2857142857142857,118.58616172872817,5
2020-06-21-170218,170218,0,0,0,467,0.2857142857142857,118.57917643935714,6
2020-06-22-170218,170218,2,0,0,469,1.0,95.6976052671383,0
2020-06-23-170218,170218,2,0,0,471,1.0,98.50997507045876,1
2020-06-24-170218,170218,1,1,1,472,1.1428571428571428,88.50838343367909,2
2020-06-25-170218,170218,0,0,1,472,1.4285714285714286,91.56248302489445,3
2020-06-26-170218,170218,0,0,0,472,1.5714285714285714,96.57991273996137,4
2020-06-27-170218,170218,0,2,0,472,0.2857142857142857,87.9149694079847,5
2020-06-28-170218,170218,0,0,0,472,0.14285714285714285,92.6652262654034,6
2020-06-29-170218,170218,0,0,1,472,0.14285714285714285,89.28302137446443,0
2020-06-30-170218,170218,0,0,1,472,0.8571428571428571,77.97185780418971,1
2020-07-01-170218,170218,2,0,3,474,0.7142857142857143,137.70214650718862,2
2020-07-02-170218,170218,0,0,0,474,0.14285714285714285,102.1233379388838,3
2020-07-03-170218,170218,0,0,2,474,0.7142857142857143,114.14033996709162,4
2020-07-04-170218,170218,0,0,0,474,0.14285714285714285,159.0979206332031,5
2020-07-05-170218,170218,0,0,1,474,0.2857142857142857,156.01968439700428,6
2020-07-06-170218,170218,0,0,3,474,0.2857142857142857,127.56265447754305,0
2020-07-07-170218,170218,0,0,1,474,0.7142857142857143,124.14357827800154,1
2020-07-08-170218,170218,1,0,2,475,0.2857142857142857,105.3470989683021,2
2020-07-09-170218,170218,1,0,0,476,0.5714285714285714,100.6975606997826,3
2020-07-10-170218,170218,0,0,0,476,0.5714285714285714,146.28299918474926,4
2020-07-11-170218,170218,0,0,2,476,0.0,127.06142140493836,5
2020-07-12-170218,170218,0,0,1,476,0.42857142857142855,94.50173499152808,6
2020-07-13-170218,170218,1,0,4,477,0.2857142857142857,84.84425894725408,0
2020-07-14-170218,170218,1,0,0,478,0.5714285714285714,98.24149199342207,1
2020-07-15-170218,170218,3,0,3,481,0.8571428571428571,81.67432236224036,2
2020-07-16-170218,170218,0,0,5,481,1.0,76.7574510397423,3
2020-07-17-170218,170218,2,0,2,483,1.4285714285714286,68.36055225351751,4
2020-07-18-170218,170218,0,0,1,483,1.0,87.33256611922161,5
2020-07-19-170218,170218,1,0,0,484,0.2857142857142857,102.4643078162992,6
2020-07-20-170218,170218,3,0,1,487,0.42857142857142855,90.45424709685446,0
2020-07-21-170218,170218,1,0,0,488,0.42857142857142855,99.31009844531195,1
2020-07-22-170218,170218,2,0,4,490,0.42857142857142855,89.52721500341353,2
2020-07-23-170218,170218,0,0,3,490,0.8571428571428571,102.1497368002419,3
2020-07-24-170218,170218,0,0,0,490,1.0,90.90538795011724,4
2020-07-25-170218,170218,2,0,0,492,0.0,86.91483421044856,5
2020-07-26-170218,170218,1,0,1,493,0.0,88.61931581559313,6
2020-07-27-170218,170218,4,0,1,497,2.2857142857142856,92.98659602405027,0
2020-07-28-170218,170218,0,0,4,497,1.2857142857142858,104.50964491632891,1
2020-07-29-170218,170218,3,0,1,500,1.5714285714285714,104.44703496366026,2
2020-07-30-170218,170218,5,0,4,505,1.8571428571428568,113.48448071848537,3
2020-07-31-170218,170218,2,0,1,507,3.7142857142857135,145.33636729964766,4
2020-08-01-170218,170218,1,0,3,508,1.0,65.08832972633734,5
2020-08-02-170218,170218,0,0,0,508,0.42857142857142855,385.3636960197972,6
2020-08-03-170218,170218,1,0,1,509,3.1428571428571432,388.61551718416024,0
2020-08-04-170218,170218,0,0,7,509,3.4285714285714284,381.8764234528819,1
2020-08-05-170218,170218,4,0,3,513,3.2857142857142856,362.0409198648307,2
2020-08-06-170218,170218,3,0,1,516,2.2857142857142856,372.2647637467123,3
2020-08-07-170218,170218,0,0,2,516,2.571428571428572,341.998896211497,4
2020-08-08-170218,170218,0,0,1,516,3.1428571428571432,351.21799144077056,5
2020-08-09-170218,170218,1,0,1,517,1.0,349.5172354177716,6
2020-08-10-170218,170218,1,0,4,518,3.1428571428571432,48.76295817250222,0
2020-08-11-170218,170218,4,0,5,522,3.2857142857142856,97.27640198629402,1
2020-08-12-170218,170218,1,0,5,523,6.0,151.96478835449585,2
2020-08-13-170218,170218,4,0,3,527,4.571428571428571,199.22055032387473,3
2020-08-14-170218,170218,1,0,3,528,3.4285714285714284,248.47508431169183,4
2020-08-15-170218,170218,3,0,0,531,1.7142857142857142,285.42650379459633,5
2020-08-16-170218,170218,0,0,0,531,2.4285714285714284,292.9271233517282,6
2020-08-17-170218,170218,1,0,8,532,2.571428571428572,318.51228222742816,0
2020-08-18-170218,170218,7,0,4,539,6.0,306.9066929224982,1
2020-08-19-170218,170218,3,0,3,542,3.571428571428572,338.410687691583,2
2020-08-20-170218,170218,1,0,4,543,3.1428571428571432,293.98618012472116,3
2020-08-21-170218,170218,2,0,10,545,4.142857142857143,299.21963570948026,4
2020-08-22-170218,170218,1,0,5,546,3.0,332.5533439256425,5
2020-08-23-170218,170218,1,0,5,547,0.8571428571428571,345.084034870211,6
2020-08-24-170218,170218,4,0,0,551,8.285714285714286,326.8940283618196,0
2020-08-25-170218,170218,5,0,6,556,5.142857142857143,326.54719531572937,1
2020-08-26-170218,170218,5,0,5,561,3.7142857142857135,337.7084842177701,2
2020-08-27-170218,170218,3,0,8,564,5.571428571428571,382.96587388231217,3
2020-08-28-170218,170218,3,0,6,567,3.7142857142857135,379.8519306728956,4
2020-08-29-170218,170218,0,0,2,567,1.0,388.6997029852996,5
2020-08-30-170218,170218,0,0,2,567,2.2857142857142856,378.92503221319294,6
2020-08-31-170218,170218,8,0,3,575,3.8571428571428568,337.8181572242663,0
2020-09-01-170218,170218,4,0,9,579,6.0,328.1528261591179,1
2020-09-02-170218,170218,3,0,5,582,5.0,609.5304884489351,2
2020-09-03-170218,170218,4,0,9,586,6.571428571428571,563.4239289503544,3
2020-09-04-170218,170218,10,0,13,596,4.285714285714286,552.9531899933277,4
2020-09-05-170218,170218,5,0,1,601,2.7142857142857144,515.1744201989752,5
2020-09-06-170218,170218,5,0,1,606,0.7142857142857143,533.5624428804967,6
2020-09-07-170218,170218,0,0,5,606,6.0,540.2640196237295,0
2020-09-08-170218,170218,6,0,10,612,5.571428571428571,525.536983895587,1
2020-09-09-170218,170218,5,0,13,617,4.285714285714286,544.781832278288,2
2020-09-10-170218,170218,8,0,9,625,6.142857142857142,423.9335082194426,3
2020-09-11-170218,170218,6,0,12,631,5.0,448.61104842293275,4
2020-09-12-170218,170218,2,0,0,633,2.7142857142857144,485.85523056276077,5
2020-09-13-170218,170218,2,0,0,635,3.2857142857142856,500.6917321623016,6
2020-09-14-170218,170218,3,0,8,638,7.571428571428571,539.380600349348,0
2020-09-15-170218,170218,9,0,3,647,10.0,614.888264835226,1
2020-09-16-170218,170218,5,0,4,652,7.7142857142857135,715.9463000650762,2
2020-09-17-170218,170218,9,0,2,661,10.571428571428571,657.5723853105083,3
2020-09-18-170218,170218,13,0,1,674,8.571428571428571,697.9885031698104,4
2020-09-19-170218,170218,1,0,1,675,1.7142857142857142,734.3956341861293,5
2020-09-20-170218,170218,1,0,1,676,2.571428571428572,712.027423685026,6
2020-09-21-170218,170218,5,1,3,681,11.285714285714285,621.3781308217716,0
2020-09-22-170218,170218,10,2,9,691,10.0,614.5440213028139,1
2020-09-23-170218,170218,13,0,4,704,11.0,626.3821850343461,2
2020-09-24-170218,170218,9,0,5,713,6.7142857142857135,648.4252218238241,3
2020-09-25-170218,170218,12,1,29,725,9.285714285714286,604.4116739689885,4
2020-09-26-170218,170218,0,0,2,725,0.5714285714285714,708.0363102117825,5
2020-09-27-170218,170218,0,0,8,725,1.7142857142857142,639.0582375718633,6
2020-09-28-170218,170218,8,0,9,733,5.428571428571429,638.897783253457,0
2020-09-29-170218,170218,3,1,14,736,4.285714285714286,669.0324495876558,1
2020-09-30-170218,170218,4,0,5,740,7.0,589.9021157176838,2
2020-10-01-170218,170218,2,0,5,742,5.857142857142858,0.0,3
2020-10-02-170218,170218,1,0,22,743,7.428571428571429,1541.0363718617089,4
2020-10-03-170218,170218,1,0,2,744,3.0,2491.025156990365,5
2020-10-04-170218,170218,1,0,1,745,4.142857142857143,2531.563238823913,6
2020-10-05-170218,170218,3,1,14,748,5.428571428571429,2056.710560145474,0
2020-10-06-170218,170218,9,0,17,757,4.857142857142857,1744.0853079874505,1
2020-10-07-170218,170218,4,0,22,761,9.571428571428571,1417.4868263285325,2
2020-10-08-170218,170218,5,0,13,766,8.428571428571429,1184.9567315063405,3
2020-10-09-170218,170218,29,1,15,795,11.285714285714285,1265.1149983682633,4
2020-10-10-170218,170218,2,0,4,797,2.142857142857143,84.16043225888865,5
2020-10-11-170218,170218,8,0,4,805,3.8571428571428568,139.0282667237075,6
2020-10-12-170218,170218,9,0,35,814,5.428571428571429,228.67671172079432,0
2020-10-13-170218,170218,14,0,14,828,11.571428571428573,346.2308477195777,1
2020-10-14-170218,170218,5,0,24,833,10.0,596.624885041341,2
2020-10-15-170218,170218,5,0,17,838,15.285714285714285,742.1932645578609,3
2020-10-16-170218,170218,22,0,22,860,12.428571428571427,1058.0428302386213,4
2020-10-17-170218,170218,2,0,8,862,4.857142857142857,1256.5233523044117,5
2020-10-18-170218,170218,1,1,17,863,2.8571428571428568,1285.2574495091312,6
2020-10-19-170218,170218,14,0,3,877,18.142857142857142,1267.7186889119916,0
2020-10-20-170218,170218,17,0,22,894,14.857142857142858,1408.8232724666805,1
2020-10-21-170218,170218,22,0,12,916,14.714285714285715,1572.0780070596268,2
2020-10-22-170218,170218,13,0,18,929,14.0,1620.6497757567554,3
2020-10-23-170218,170218,15,0,21,944,25.285714285714285,1715.4998964593874,4
2020-10-24-170218,170218,4,0,13,948,5.285714285714286,1979.9315308362231,5
2020-10-25-170218,170218,4,0,15,952,8.714285714285714,2036.8767942443963,6
2020-10-26-170218,170218,35,0,23,987,23.57142857142857,1831.3721183410003,0
2020-10-27-170218,170218,14,1,19,1001,21.142857142857142,2255.807226637033,1
2020-10-28-170218,170218,24,1,18,1025,18.142857142857142,2361.202315571825,2
2020-10-29-170218,170218,17,0,18,1042,20.0,2415.441264186162,3
2020-10-30-170218,170218,22,1,20,1064,17.428571428571427,2213.3035347382283,4
2020-10-31-170218,170218,8,0,0,1072,6.857142857142858,2524.4332917739243,5
2020-11-01-170218,170218,17,0,0,1089,13.857142857142858,953.6635871107676,6
2020-11-02-170218,170218,3,1,0,1092,12.428571428571427,2191.5784332052726,0
2020-11-03-170218,170218,22,0,0,1114,20.714285714285715,1870.4193359525718,1
2020-11-04-170218,170218,12,0,0,1126,21.714285714285715,2223.1922799571275,2
2020-11-05-170218,170218,18,0,0,1144,18.714285714285715,2279.9087570920847,3
2020-11-06-170218,170218,21,0,0,1165,31.57142857142857,2454.9322504006504,4
2020-11-07-170218,170218,13,0,0,1178,10.0,2571.8891313722797,5
2020-11-08-170218,170218,15,0,0,1193,14.857142857142858,2482.7563001451904,6
2020-11-09-170218,170218,23,0,0,1216,25.714285714285715,2544.423132877291,0
2020-11-10-170218,170218,19,0,0,1235,15.571428571428573,1073.8127957330103,1
2020-11-11-170218,170218,18,1,0,1253,13.714285714285715,1367.349589447204,2
2020-11-12-170218,170218,18,0,0,1271,23.714285714285715,1622.8097105609586,3
2020-11-13-170218,170218,20,2,0,1291,24.285714285714285,1927.4539283104837,4
2020-03-01-170219,170219,0,0,1,0,0.0,0.0,6
2020-03-02-170219,170219,0,0,2,0,0.0,4.644205829142599,0
2020-03-03-170219,170219,0,0,1,0,0.0,29.32912460011273,1
2020-03-04-170219,170219,0,0,3,0,0.0,27.042311699150446,2
2020-03-05-170219,170219,0,1,3,0,0.0,23.745166850177924,3
2020-03-06-170219,170219,0,0,5,0,0.0,21.364001505684943,4
2020-03-07-170219,170219,0,0,1,0,0.0,23.302895625220316,5
2020-03-08-170219,170219,0,0,9,0,0.0,26.515625630381983,6
2020-03-09-170219,170219,0,1,3,0,0.4,26.65744456349115,0
2020-03-10-170219,170219,0,0,2,0,0.0,156.12384181995986,1
2020-03-11-170219,170219,0,0,6,0,0.2,133.8643091580357,2
2020-03-12-170219,170219,0,0,4,0,0.2,109.47918645969393,3
2020-03-13-170219,170219,0,0,1,0,0.6,90.42759691666087,4
2020-03-14-170219,170219,0,0,0,0,0.4,70.80770804199334,5
2020-03-15-170219,170219,1,0,0,1,0.2,53.150110831131016,6
2020-03-16-170219,170219,2,0,2,3,0.0,12.143913919602236,0
2020-03-17-170219,170219,1,0,2,4,0.8,15.329813504797084,1
2020-03-18-170219,170219,3,1,5,7,1.2,17.636732575101217,2
2020-03-19-170219,170219,3,3,1,10,2.0,23.365424833416746,3
2020-03-20-170219,170219,5,0,4,15,2.6,26.42942684941011,4
2020-03-21-170219,170219,1,0,1,16,1.6,37.92245005714514,5
2020-03-22-170219,170219,9,0,0,25,0.6,37.633906739539654,6
2020-03-23-170219,170219,3,0,3,28,4.4,43.28706612580201,0
2020-03-24-170219,170219,2,0,1,30,4.4,52.909821808329525,1
2020-03-25-170219,170219,6,0,0,36,3.2,59.07147331170187,2
2020-03-26-170219,170219,4,0,1,40,2.8,64.70393697460447,3
2020-03-27-170219,170219,1,0,2,41,2.0,76.2932512650399,4
2020-03-28-170219,170219,0,0,0,41,1.2,69.28551233836093,5
2020-03-29-170219,170219,0,0,1,41,0.2,67.54469438855448,6
2020-03-30-170219,170219,2,0,2,43,3.0,45.88089272592164,0
2020-03-31-170219,170219,2,0,0,45,2.0,41.53252196664522,1
2020-04-01-170219,170219,5,0,1,50,3.6,7.362931614942381,2
2020-04-02-170219,170219,1,0,0,51,3.0,19.512462577798434,3
2020-04-03-170219,170219,4,0,0,55,3.2,11.01981684260884,4
2020-04-04-170219,170219,1,0,0,56,0.8,19.6487703504823,5
2020-04-05-170219,170219,0,0,0,56,0.2,22.905133640265326,6
2020-04-06-170219,170219,3,0,3,59,2.0,22.279274065222268,0
2020-04-07-170219,170219,1,0,1,60,1.8,32.99300929452286,1
2020-04-08-170219,170219,0,1,1,60,1.0,33.589854100191005,2
2020-04-09-170219,170219,1,0,1,61,2.4,36.654164513503034,3
2020-04-10-170219,170219,2,0,0,63,0.8,17.326411320931406,4
2020-04-11-170219,170219,0,0,0,63,0.6,20.707217827325636,5
2020-04-12-170219,170219,1,0,1,64,0.0,21.95508273261744,6
2020-04-13-170219,170219,2,0,0,66,1.8,22.52796761940959,0
2020-04-14-170219,170219,0,0,3,66,1.0,28.448525957205565,1
2020-04-15-170219,170219,1,0,1,67,0.8,32.94540018274121,2
2020-04-16-170219,170219,0,0,0,67,1.2,36.63974489627788,3
2020-04-17-170219,170219,0,0,2,67,0.4,24.725298391866325,4
2020-04-18-170219,170219,0,0,1,67,0.2,22.695010063920144,5
2020-04-19-170219,170219,0,0,0,67,0.4,21.675001231127297,6
2020-04-20-170219,170219,3,0,1,70,1.2,21.51491098756904,0
2020-04-21-170219,170219,1,0,0,71,0.6,23.470998192381472,1
2020-04-22-170219,170219,1,0,1,72,1.0,22.33606247901995,2
2020-04-23-170219,170219,1,0,1,73,0.0,22.40484853948787,3
2020-04-24-170219,170219,0,0,2,73,0.4,21.15406870845665,4
2020-04-25-170219,170219,0,0,1,73,0.2,22.16555221428441,5
2020-04-26-170219,170219,1,0,0,74,0.6,22.884270437130972,6
2020-04-27-170219,170219,0,1,1,74,0.4,18.22616981400319,0
2020-04-28-170219,170219,3,0,0,77,0.6,13.304625370842787,1
2020-04-29-170219,170219,1,0,3,78,0.4,14.361428132720551,2
2020-04-30-170219,170219,0,0,4,78,0.0,23.09759121646146,3
2020-05-01-170219,170219,2,0,0,80,0.2,34.49164932942735,4
2020-05-02-170219,170219,1,0,0,81,0.0,15.967049952658652,5
2020-05-03-170219,170219,0,0,0,81,0.0,9.9413555129935,6
2020-05-04-170219,170219,1,0,2,82,0.4,9.212307196919053,0
2020-05-05-170219,170219,0,0,0,82,0.6,8.526044094493866,1
2020-05-06-170219,170219,1,0,1,83,0.4,8.5766217316669,2
2020-05-07-170219,170219,1,0,1,84,0.2,8.670879328792306,3
2020-05-08-170219,170219,2,0,1,86,0.2,8.583092491955295,4
2020-05-09-170219,170219,1,0,1,87,0.0,11.219400814555783,5
2020-05-10-170219,170219,0,0,0,87,0.4,41.85745937815936,6
2020-05-11-170219,170219,1,0,0,88,0.2,35.66917296080674,0
2020-05-12-170219,170219,0,0,3,88,0.6,37.146688004831546,1
2020-05-13-170219,170219,3,0,1,91,0.8,25.86488356736651,2
2020-05-14-170219,170219,4,0,3,95,0.6,26.222336170454625,3
2020-05-15-170219,170219,0,0,1,95,1.0,25.617693214326348,4
2020-05-16-170219,170219,0,0,0,95,0.0,23.426949144129892,5
2020-05-17-170219,170219,0,0,1,95,0.0,21.77663426724503,6
2020-05-18-170219,170219,2,0,2,97,0.4,21.62615059661722,0
2020-05-19-170219,170219,0,0,2,97,0.4,22.65768949711329,1
2020-05-20-170219,170219,1,0,1,98,0.4,15.707693079581803,2
2020-05-21-170219,170219,1,0,1,99,0.4,14.103603199956297,3
2020-05-22-170219,170219,1,0,1,100,0.4,12.194853899790346,4
2020-05-23-170219,170219,1,0,2,101,0.0,15.439819540048628,5
2020-05-24-170219,170219,0,0,1,101,0.0,16.308060777370258,6
2020-05-25-170219,170219,0,0,1,101,0.4,13.216668880589346,0
2020-05-26-170219,170219,3,0,0,104,0.0,13.069787305265237,1
2020-05-27-170219,170219,1,0,0,105,0.2,16.37651942257367,2
2020-05-28-170219,170219,3,1,0,108,0.0,14.669341602521214,3
2020-05-29-170219,170219,1,0,0,109,0.6,15.315936795788481,4
2020-05-30-170219,170219,0,0,0,109,0.0,16.005523872943584,5
2020-05-31-170219,170219,1,0,1,110,0.0,16.853355214013938,6
2020-06-01-170219,170219,2,1,0,112,0.4,17.458776350347804,0
2020-06-02-170219,170219,2,0,2,114,0.0,15.509990039733088,1
2020-06-03-170219,170219,1,0,1,115,0.4,3.2598597871464796,2
2020-06-04-170219,170219,1,0,0,116,0.8,6.997695620118188,3
2020-06-05-170219,170219,1,0,1,117,0.2,15.093014397318754,4
2020-06-06-170219,170219,2,3,0,119,0.0,16.019616491845728,5
2020-06-07-170219,170219,1,0,1,120,0.0,17.56313777286946,6
2020-06-08-170219,170219,1,0,0,121,0.6,18.329357009539972,0
2020-06-09-170219,170219,0,0,1,121,0.2,20.62749393762612,1
2020-06-10-170219,170219,0,0,0,121,0.8,19.342474626993926,2
2020-06-11-170219,170219,0,0,0,121,0.6,20.450441005005203,3
2020-06-12-170219,170219,0,0,0,121,0.6,20.189723504010896,4
2020-06-13-170219,170219,0,0,0,121,0.0,18.517066136896887,5
2020-06-14-170219,170219,1,0,0,122,0.2,14.642717123670172,6
2020-06-15-170219,170219,0,0,0,122,0.4,14.50462661440437,0
2020-06-16-170219,170219,2,0,0,124,0.4,17.45549877765786,1
2020-06-17-170219,170219,1,0,0,125,0.0,16.894747516037217,2
2020-06-18-170219,170219,0,0,1,125,0.2,13.993193757453813,3
2020-06-19-170219,170219,1,0,0,126,0.2,12.301638650023245,4
2020-06-20-170219,170219,0,0,1,126,0.0,17.546499688551954,5
2020-06-21-170219,170219,1,0,2,127,0.0,15.386965880689209,6
2020-06-22-170219,170219,0,0,0,127,0.0,12.94176946267747,0
2020-06-23-170219,170219,1,0,1,128,0.0,9.376585352471249,1
2020-06-24-170219,170219,0,0,0,128,0.2,9.650764644453584,2
2020-06-25-170219,170219,0,0,1,128,0.0,11.369048614610605,3
2020-06-26-170219,170219,0,0,0,128,0.0,7.620524437373474,4
2020-06-27-170219,170219,0,2,0,128,0.0,4.9451570260813416,5
2020-06-28-170219,170219,0,0,0,128,0.0,5.5352156352239685,6
2020-06-29-170219,170219,0,0,0,128,0.0,4.474495660471421,0
2020-06-30-170219,170219,0,0,0,128,0.4,7.363184301529367,1
2020-07-01-170219,170219,0,0,0,128,0.4,25.52394548484918,2
2020-07-02-170219,170219,1,0,1,129,0.0,9.935257579452454,3
2020-07-03-170219,170219,0,0,0,129,0.8,12.581103146665335,4
2020-07-04-170219,170219,1,0,0,130,0.0,14.439782822275372,5
2020-07-05-170219,170219,2,0,0,132,0.0,13.668176015754453,6
2020-07-06-170219,170219,0,0,1,132,0.8,14.82005686614131,0
2020-07-07-170219,170219,1,0,0,133,0.2,15.130763400781754,1
2020-07-08-170219,170219,0,0,0,133,1.0,17.802053164192067,2
2020-07-09-170219,170219,1,0,0,134,0.4,22.60264421218307,3
2020-07-10-170219,170219,0,0,0,134,0.4,23.71485146178599,4
2020-07-11-170219,170219,0,0,1,134,0.0,16.686016466210653,5
2020-07-12-170219,170219,0,0,0,134,0.0,14.45011357244297,6
2020-07-13-170219,170219,0,0,0,134,0.0,11.68459213949378,0
2020-07-14-170219,170219,0,0,2,134,0.6,10.275826118368917,1
2020-07-15-170219,170219,0,0,1,134,0.6,11.932751457569953,2
2020-07-16-170219,170219,1,0,0,135,0.0,11.704592905163494,3
2020-07-17-170219,170219,0,0,2,135,0.0,11.307232261998575,4
2020-07-18-170219,170219,0,0,1,135,0.2,7.539843684621017,5
2020-07-19-170219,170219,0,0,2,135,0.0,8.188788655992374,6
2020-07-20-170219,170219,1,0,5,136,0.4,12.279163001919976,0
2020-07-21-170219,170219,0,0,3,136,0.0,11.08098892910483,1
2020-07-22-170219,170219,0,0,4,136,0.4,12.782296220028952,2
2020-07-23-170219,170219,0,0,7,136,0.0,16.849574464474486,3
2020-07-24-170219,170219,0,0,2,136,0.2,17.131499316969162,4
2020-07-25-170219,170219,1,0,0,137,0.0,18.084012914281736,5
2020-07-26-170219,170219,0,0,4,137,0.0,17.54766419357452,6
2020-07-27-170219,170219,0,0,3,137,0.2,16.74191040789816,0
2020-07-28-170219,170219,2,0,6,139,0.6,14.060852448528525,1
2020-07-29-170219,170219,1,0,6,140,0.2,16.739440938345204,2
2020-07-30-170219,170219,0,0,10,140,0.6,17.127901284095714,3
2020-07-31-170219,170219,2,0,3,142,0.2,17.42952325192108,4
2020-08-01-170219,170219,1,0,3,143,0.4,28.459460053347133,5
2020-08-02-170219,170219,2,0,1,145,0.4,157.94942473535377,6
2020-08-03-170219,170219,5,0,1,150,0.6,112.5709668892465,0
2020-08-04-170219,170219,3,0,5,153,0.8,116.83579948571077,1
2020-08-05-170219,170219,4,0,3,157,2.2,126.81929586652572,2
2020-08-06-170219,170219,7,0,6,164,1.6,144.91736582294604,3
2020-08-07-170219,170219,2,0,7,166,3.0,141.07562469026485,4
2020-08-08-170219,170219,0,0,1,166,1.0,177.37681708790734,5
2020-08-09-170219,170219,4,1,1,170,0.8,169.33744653899012,6
2020-08-10-170219,170219,3,0,1,173,1.2,32.98029861546557,0
2020-08-11-170219,170219,6,0,1,179,2.8,48.273327383815136,1
2020-08-12-170219,170219,6,0,8,185,2.8,80.94816666808731,2
2020-08-13-170219,170219,10,0,4,195,0.8,136.2109977351526,3
2020-08-14-170219,170219,3,0,5,198,0.2,174.4316358293255,4
2020-08-15-170219,170219,3,0,2,201,0.4,176.6574655049173,5
2020-08-16-170219,170219,1,0,1,202,0.0,175.60240193769508,6
2020-08-17-170219,170219,1,0,3,203,0.6,173.68879165277764,0
2020-08-18-170219,170219,5,0,4,208,1.4,172.65301469549766,1
2020-08-19-170219,170219,3,0,3,211,2.2,154.81378278786602,2
2020-08-20-170219,170219,6,0,1,217,2.4,123.35575322496611,3
2020-08-21-170219,170219,7,0,2,224,4.4,148.20318558444941,4
2020-08-22-170219,170219,1,0,3,225,1.0,203.37384156331711,5
2020-08-23-170219,170219,1,0,0,226,1.4,222.22318845983125,6
2020-08-24-170219,170219,1,0,4,227,1.0,213.19122004503163,0
2020-08-25-170219,170219,1,0,1,228,1.0,222.28599070383143,1
2020-08-26-170219,170219,8,0,4,236,1.2,169.16099854972515,2
2020-08-27-170219,170219,4,0,3,240,0.8,173.37275456102788,3
2020-08-28-170219,170219,5,0,4,245,3.4,154.1115412014964,4
2020-08-29-170219,170219,2,0,3,247,0.6,117.92008655078735,5
2020-08-30-170219,170219,1,0,3,248,1.2,111.79536091637851,6
2020-08-31-170219,170219,3,0,4,251,1.6,96.61512578179838,0
2020-09-01-170219,170219,4,0,11,255,0.2,151.5419151236312,1
2020-09-02-170219,170219,3,0,6,258,1.8,150.50051306849255,2
2020-09-03-170219,170219,1,0,9,259,0.6,99.9425723902532,3
2020-09-04-170219,170219,2,0,3,261,0.2,86.52245762057777,4
2020-09-05-170219,170219,3,0,0,264,1.0,73.81176504085838,5
2020-09-06-170219,170219,0,0,7,264,0.4,83.39995759143349,6
2020-09-07-170219,170219,4,0,3,268,0.2,81.80962037174999,0
2020-09-08-170219,170219,1,0,5,269,1.0,75.1934503738791,1
2020-09-09-170219,170219,4,0,3,273,2.2,75.32375639530159,2
2020-09-10-170219,170219,3,0,6,276,0.4,124.740003051603,3
2020-09-11-170219,170219,4,0,3,280,1.0,115.15756508896021,4
2020-09-12-170219,170219,3,0,0,283,0.2,104.69267229873554,5
2020-09-13-170219,170219,3,0,0,286,0.6,102.64553966478341,6
2020-09-14-170219,170219,4,0,1,290,1.6,76.38097948138576,0
2020-09-15-170219,170219,11,0,3,301,3.0,90.17716071365119,1
2020-09-16-170219,170219,6,0,1,307,1.2,113.26835806361439,2
2020-09-17-170219,170219,9,0,5,316,0.8,117.6649738335091,3
2020-09-18-170219,170219,3,0,3,319,2.0,131.4974323490407,4
2020-09-19-170219,170219,0,0,0,319,1.0,137.26536811253197,5
2020-09-20-170219,170219,7,1,1,326,0.4,139.2693280323073,6
2020-09-21-170219,170219,3,0,1,329,1.4,123.27166831850275,0
2020-09-22-170219,170219,5,0,5,334,1.2,100.41107348764726,1
2020-09-23-170219,170219,3,1,3,337,1.2,102.96191158052721,2
2020-09-24-170219,170219,6,0,1,343,0.8,93.32988189080672,3
2020-09-25-170219,170219,3,0,1,346,1.4,91.36733439171309,4
2020-09-26-170219,170219,0,0,0,346,1.4,99.33829278461769,5
2020-09-27-170219,170219,0,0,0,346,0.2,87.09497456765688,6
2020-09-28-170219,170219,1,0,1,347,0.8,84.5596155992686,0
2020-09-29-170219,170219,3,0,3,350,0.0,86.62930039771018,1
2020-09-30-170219,170219,1,0,0,351,1.4,75.50796294559896,2
2020-10-01-170219,170219,5,0,1,356,0.4,0.0,3
2020-10-02-170219,170219,3,0,2,359,1.2,95.0944166005613,4
2020-10-03-170219,170219,0,0,1,359,0.0,118.62362704973353,5
2020-10-04-170219,170219,1,1,2,360,0.2,134.253122674732,6
2020-10-05-170219,170219,1,0,0,361,1.0,120.5215327515183,0
2020-10-06-170219,170219,5,0,5,366,2.4,114.48384361966527,1
2020-10-07-170219,170219,3,3,5,369,0.8,91.63242218960531,2
2020-10-08-170219,170219,1,0,10,370,0.4,85.39237522592035,3
2020-10-09-170219,170219,1,0,4,371,0.2,91.5589347278243,4
2020-10-10-170219,170219,0,0,0,371,0.2,12.766872276984827,5
2020-10-11-170219,170219,0,0,2,371,0.2,16.725892709158085,6
2020-10-12-170219,170219,1,0,2,372,0.0,19.127397144665192,0
2020-10-13-170219,170219,3,0,3,375,1.0,22.393852250804983,1
2020-10-14-170219,170219,0,0,4,375,1.6,57.489618872599046,2
2020-10-15-170219,170219,1,0,5,376,1.0,70.40928191767757,3
2020-10-16-170219,170219,2,0,5,378,1.2,82.58539237656785,4
2020-10-17-170219,170219,1,0,3,379,0.2,83.63716514977688,5
2020-10-18-170219,170219,2,0,3,381,1.0,80.98827822642238,6
2020-10-19-170219,170219,0,0,1,381,0.4,88.51776996715176,0
2020-10-20-170219,170219,5,0,4,386,0.6,73.92923977793001,1
2020-10-21-170219,170219,5,0,4,391,1.8,70.36762406563778,2
2020-10-22-170219,170219,10,0,2,401,1.6,79.81506163056697,3
2020-10-23-170219,170219,4,0,3,405,0.8,81.59726599476744,4
2020-10-24-170219,170219,0,0,0,405,0.6,90.40351407922768,5
2020-10-25-170219,170219,2,1,0,407,0.2,84.83882821747602,6
2020-10-26-170219,170219,2,1,4,409,0.2,80.56227842498132,0
2020-10-27-170219,170219,3,0,3,412,1.2,85.83586772794698,1
2020-10-28-170219,170219,4,1,4,416,3.8,87.13486855778321,2
2020-10-29-170219,170219,5,0,3,421,2.0,111.7438954146038,3
2020-10-30-170219,170219,5,1,9,426,1.4,98.10314489729744,4
2020-10-31-170219,170219,3,0,0,429,2.0,111.58986800117502,5
2020-11-01-170219,170219,3,0,0,432,1.6,75.79934251407765,6
2020-11-02-170219,170219,1,1,0,433,0.8,116.0383632976297,0
2020-11-03-170219,170219,4,0,0,437,2.4,95.96988465419648,1
2020-11-04-170219,170219,4,0,0,441,2.4,118.7299188741103,2
2020-11-05-170219,170219,2,0,0,443,1.6,136.68375968366598,3
2020-11-06-170219,170219,3,0,0,446,2.2,143.74663502329793,4
2020-11-07-170219,170219,0,0,0,446,1.2,154.051020082442,5
2020-11-08-170219,170219,0,0,0,446,2.2,149.1116897421429,6
2020-11-09-170219,170219,4,0,0,450,3.2,143.70825940991318,0
2020-11-10-170219,170219,3,0,0,453,3.2,107.14907697349321,1
2020-11-11-170219,170219,4,0,0,457,4.0,126.80476857137769,2
2020-11-12-170219,170219,3,1,0,460,1.8,146.89456426425232,3
2020-11-13-170219,170219,9,0,0,469,3.0,136.95941089517189,4
2020-03-01-170220,170220,0,0,1,0,0.0,0.0,6
2020-03-02-170220,170220,0,0,2,0,0.0,8.683025904346664,0
2020-03-03-170220,170220,0,0,1,0,0.0,33.40829595215499,1
2020-03-04-170220,170220,0,1,0,0,0.0,42.01481469037842,2
2020-03-05-170220,170220,0,0,1,0,0.0,46.29758896593767,3
2020-03-06-170220,170220,0,0,1,0,0.0,39.00487528277618,4
2020-03-07-170220,170220,0,0,0,0,0.0,41.91524462474384,5
2020-03-08-170220,170220,0,0,0,0,0.16666666666666666,37.30804167340534,6
2020-03-09-170220,170220,0,0,1,0,0.0,37.11109183064981,0
2020-03-10-170220,170220,0,0,0,0,0.0,171.13797147883258,1
2020-03-11-170220,170220,0,0,0,0,0.0,142.9393100350379,2
2020-03-12-170220,170220,0,0,1,0,0.6666666666666666,115.1054553008762,3
2020-03-13-170220,170220,1,0,2,1,0.3333333333333333,91.16635225324103,4
2020-03-14-170220,170220,0,0,1,1,0.8333333333333334,74.21964426846047,5
2020-03-15-170220,170220,1,0,0,2,0.3333333333333333,52.52569270141528,6
2020-03-16-170220,170220,2,0,2,4,1.0,19.5162151142736,0
2020-03-17-170220,170220,1,0,0,5,0.6666666666666666,27.194885978281338,1
2020-03-18-170220,170220,0,0,0,5,0.5,36.5426021494111,2
2020-03-19-170220,170220,1,0,0,6,1.5,42.16150840638713,3
2020-03-20-170220,170220,1,1,0,7,1.5,47.107186994165176,4
2020-03-21-170220,170220,0,0,0,7,0.6666666666666666,53.95365884771532,5
2020-03-22-170220,170220,0,0,0,7,0.6666666666666666,51.46339782907987,6
2020-03-23-170220,170220,1,0,0,8,1.5,49.17691638738955,0
2020-03-24-170220,170220,0,0,2,8,1.3333333333333333,54.12699324037288,1
2020-03-25-170220,170220,0,0,0,8,1.0,60.53052542171142,2
2020-03-26-170220,170220,1,0,1,9,1.6666666666666667,57.21715192828613,3
2020-03-27-170220,170220,2,0,1,11,3.1666666666666665,67.75656251138119,4
2020-03-28-170220,170220,1,0,0,12,0.3333333333333333,72.02436565456989,5
2020-03-29-170220,170220,0,0,0,12,1.6666666666666667,69.9768281331207,6
2020-03-30-170220,170220,2,0,0,14,1.0,57.945106606569624,0
2020-03-31-170220,170220,0,0,3,14,0.8333333333333334,60.14584735623578,1
2020-04-01-170220,170220,0,0,3,14,0.8333333333333334,7.823940706288159,2
2020-04-02-170220,170220,0,0,0,14,1.1666666666666667,37.58889842897078,3
2020-04-03-170220,170220,0,0,2,14,0.0,10.773962235071435,4
2020-04-04-170220,170220,0,0,0,14,0.6666666666666666,14.02960575111111,5
2020-04-05-170220,170220,0,0,0,14,1.0,16.39076208997984,6
2020-04-06-170220,170220,0,0,0,14,1.3333333333333333,18.559209875123834,0
2020-04-07-170220,170220,2,0,0,16,0.6666666666666666,21.2393941246214,1
2020-04-08-170220,170220,0,1,0,16,2.6666666666666665,25.324237315808507,2
2020-04-09-170220,170220,1,0,1,17,1.6666666666666667,32.17605469665389,3
2020-04-10-170220,170220,1,0,0,18,2.0,5.794766425854634,4
2020-04-11-170220,170220,0,0,0,18,0.6666666666666666,13.221674454554215,5
2020-04-12-170220,170220,0,0,0,18,0.0,18.35617463717731,6
2020-04-13-170220,170220,0,1,0,18,1.1666666666666667,19.743590258045373,0
2020-04-14-170220,170220,3,0,0,21,0.8333333333333334,28.0385511202373,1
2020-04-15-170220,170220,3,0,0,24,0.8333333333333334,33.2384665054294,2
2020-04-16-170220,170220,0,0,0,24,0.6666666666666666,36.806331987436224,3
2020-04-17-170220,170220,2,0,0,26,0.5,36.445399344390836,4
2020-04-18-170220,170220,0,0,0,26,0.0,36.577106360330745,5
2020-04-19-170220,170220,0,0,0,26,0.3333333333333333,31.448860569972908,6
2020-04-20-170220,170220,0,0,0,26,1.0,31.143576826785722,0
2020-04-21-170220,170220,0,0,0,26,0.6666666666666666,34.013356116022365,1
2020-04-22-170220,170220,0,0,0,26,0.6666666666666666,33.26902666383665,2
2020-04-23-170220,170220,1,0,0,27,0.0,34.01036296289475,3
2020-04-24-170220,170220,0,0,0,27,0.3333333333333333,27.23029450041416,4
2020-04-25-170220,170220,0,0,0,27,0.16666666666666666,29.594522713229555,5
2020-04-26-170220,170220,0,0,0,27,0.0,27.098070747436328,6
2020-04-27-170220,170220,0,0,0,27,0.5,20.892254523851733,0
2020-04-28-170220,170220,0,0,0,27,0.5,15.40077115586416,1
2020-04-29-170220,170220,0,0,0,27,0.16666666666666666,12.627638322588522,2
2020-04-30-170220,170220,0,0,0,27,0.6666666666666666,16.212489035523397,3
2020-05-01-170220,170220,0,0,0,27,0.6666666666666666,42.044533462208705,4
2020-05-02-170220,170220,0,0,0,27,0.16666666666666666,18.002553198411366,5
2020-05-03-170220,170220,0,0,0,27,0.16666666666666666,12.02834088414036,6
2020-05-04-170220,170220,0,0,0,27,0.8333333333333334,11.480675069458808,0
2020-05-05-170220,170220,0,0,0,27,0.5,12.990845891722756,1
2020-05-06-170220,170220,0,0,1,27,0.6666666666666666,15.902977430181672,2
2020-05-07-170220,170220,0,0,0,27,0.3333333333333333,17.396809830902395,3
2020-05-08-170220,170220,0,0,0,27,0.3333333333333333,15.627367257721444,4
2020-05-09-170220,170220,0,0,0,27,0.16666666666666666,19.428897148646307,5
2020-05-10-170220,170220,0,0,0,27,0.16666666666666666,44.750688753085456,6
2020-05-11-170220,170220,0,2,0,27,0.5,40.83566518429234,0
2020-05-12-170220,170220,0,1,0,27,0.5,41.52532139363454,1
2020-05-13-170220,170220,0,0,0,27,0.3333333333333333,36.856762870441244,2
2020-05-14-170220,170220,0,1,1,27,0.16666666666666666,33.08589176143843,3
2020-05-15-170220,170220,0,0,0,27,0.5,27.834438819434183,4
2020-05-16-170220,170220,0,0,0,27,0.0,19.381472041424892,5
2020-05-17-170220,170220,0,0,0,27,0.3333333333333333,18.897151974562572,6
2020-05-18-170220,170220,0,0,0,27,0.3333333333333333,20.30372678603695,0
2020-05-19-170220,170220,0,0,0,27,0.16666666666666666,21.05638773456821,1
2020-05-20-170220,170220,1,0,1,28,0.5,20.760818072165346,2
2020-05-21-170220,170220,0,0,0,28,0.8333333333333334,22.33783276786653,3
2020-05-22-170220,170220,0,0,0,28,1.5,20.910998607657906,4
2020-05-23-170220,170220,0,0,0,28,0.16666666666666666,25.07504722734499,5
2020-05-24-170220,170220,0,0,0,28,0.0,24.026601749986522,6
2020-05-25-170220,170220,0,0,0,28,0.16666666666666666,19.93949993258274,0
2020-05-26-170220,170220,0,0,0,28,0.5,18.242288478453485,1
2020-05-27-170220,170220,0,0,0,28,0.3333333333333333,20.235605192387737,2
2020-05-28-170220,170220,1,0,0,29,0.5,16.21187463959538,3
2020-05-29-170220,170220,0,0,0,29,1.3333333333333333,17.745285266963073,4
2020-05-30-170220,170220,0,0,0,29,0.0,20.196263815218188,5
2020-05-31-170220,170220,0,0,0,29,0.5,21.382068324584747,6
2020-06-01-170220,170220,0,0,0,29,0.16666666666666666,31.96901003225711,0
2020-06-02-170220,170220,0,0,1,29,0.6666666666666666,13.375215303645614,1
2020-06-03-170220,170220,1,0,0,30,0.3333333333333333,5.891956886253739,2
2020-06-04-170220,170220,0,0,0,30,0.3333333333333333,8.148451183179732,3
2020-06-05-170220,170220,0,0,0,30,0.5,9.063804844849457,4
2020-06-06-170220,170220,0,2,0,30,0.3333333333333333,10.357259376391111,5
2020-06-07-170220,170220,0,0,0,30,0.0,10.487834257210274,6
2020-06-08-170220,170220,0,0,0,30,0.0,10.41535266997849,0
2020-06-09-170220,170220,0,0,0,30,0.3333333333333333,11.76478483376195,1
2020-06-10-170220,170220,0,0,0,30,0.3333333333333333,29.435097556983514,2
2020-06-11-170220,170220,0,0,0,30,0.8333333333333334,25.96222805560241,3
2020-06-12-170220,170220,0,0,0,30,0.5,23.587168326574535,4
2020-06-13-170220,170220,0,0,0,30,0.3333333333333333,18.081577385804657,5
2020-06-14-170220,170220,0,0,0,30,0.0,16.497257225496103,6
2020-06-15-170220,170220,0,0,0,30,0.3333333333333333,12.37187265788426,0
2020-06-16-170220,170220,1,0,0,31,0.3333333333333333,15.057978195284289,1
2020-06-17-170220,170220,0,0,0,31,0.0,16.870608648809274,2
2020-06-18-170220,170220,0,0,0,31,0.8333333333333334,15.552080225390629,3
2020-06-19-170220,170220,0,0,0,31,0.0,14.352510629873379,4
2020-06-20-170220,170220,0,0,0,31,0.0,19.732364539792442,5
2020-06-21-170220,170220,0,0,0,31,0.3333333333333333,20.320649704879415,6
2020-06-22-170220,170220,0,0,0,31,0.0,18.215906979246448,0
2020-06-23-170220,170220,0,0,0,31,0.0,15.317671614958552,1
2020-06-24-170220,170220,0,0,0,31,0.16666666666666666,15.48560229410582,2
2020-06-25-170220,170220,0,1,0,31,0.3333333333333333,14.934960789601266,3
2020-06-26-170220,170220,0,0,0,31,0.0,15.447034355796895,4
2020-06-27-170220,170220,0,0,0,31,0.16666666666666666,9.059101988208225,5
2020-06-28-170220,170220,0,0,0,31,0.0,9.789263963009187,6
2020-06-29-170220,170220,0,0,0,31,0.0,7.490379115326164,0
2020-06-30-170220,170220,0,0,0,31,0.0,10.404932280975716,1
2020-07-01-170220,170220,0,0,0,31,0.0,11.607519662292319,2
2020-07-02-170220,170220,0,0,0,31,0.16666666666666666,7.792838559478162,3
2020-07-03-170220,170220,0,0,0,31,0.0,14.29977049885428,4
2020-07-04-170220,170220,0,0,0,31,0.0,16.05780537594698,5
2020-07-05-170220,170220,0,0,0,31,0.16666666666666666,16.328131760528755,6
2020-07-06-170220,170220,0,0,0,31,0.0,13.176966591365023,0
2020-07-07-170220,170220,0,0,0,31,0.16666666666666666,13.018021740840798,1
2020-07-08-170220,170220,0,0,0,31,0.0,12.032345888668734,2
2020-07-09-170220,170220,0,0,0,31,0.3333333333333333,12.014863911454391,3
2020-07-10-170220,170220,0,0,0,31,0.0,11.461242570594198,4
2020-07-11-170220,170220,0,0,0,31,0.0,9.988313251650887,5
2020-07-12-170220,170220,0,0,0,31,0.3333333333333333,6.719961261329026,6
2020-07-13-170220,170220,0,0,0,31,0.0,10.431137787137168,0
2020-07-14-170220,170220,0,0,0,31,0.0,11.190305649763332,1
2020-07-15-170220,170220,0,1,0,31,0.0,10.417198677181032,2
2020-07-16-170220,170220,0,0,0,31,0.0,10.31114620195492,3
2020-07-17-170220,170220,0,0,0,31,0.0,10.912837416276986,4
2020-07-18-170220,170220,0,0,0,31,0.0,11.720471183680521,5
2020-07-19-170220,170220,0,0,0,31,0.16666666666666666,12.608315182595547,6
2020-07-20-170220,170220,0,0,0,31,0.0,8.417284240586474,0
2020-07-21-170220,170220,0,0,2,31,0.16666666666666666,8.215287593428485,1
2020-07-22-170220,170220,0,0,1,31,0.16666666666666666,8.236867307459931,2
2020-07-23-170220,170220,0,0,0,31,0.5,8.052807492386863,3
2020-07-24-170220,170220,0,0,1,31,0.3333333333333333,9.349409200291596,4
2020-07-25-170220,170220,0,0,4,31,0.0,11.808216917150812,5
2020-07-26-170220,170220,0,0,0,31,0.0,11.471416381673018,6
2020-07-27-170220,170220,0,0,1,31,0.16666666666666666,11.098668538811381,0
2020-07-28-170220,170220,0,0,0,31,0.16666666666666666,13.992708172304102,1
2020-07-29-170220,170220,0,0,1,31,0.0,14.070629326637704,2
2020-07-30-170220,170220,0,0,1,31,0.0,15.094412116074782,3
2020-07-31-170220,170220,0,0,2,31,0.16666666666666666,15.572973540909707,4
2020-08-01-170220,170220,0,0,1,31,0.0,13.845979172349235,5
2020-08-02-170220,170220,0,0,3,31,0.16666666666666666,71.08004651817721,6
2020-08-03-170220,170220,0,0,1,31,0.0,82.92145583673638,0
2020-08-04-170220,170220,2,0,2,33,0.0,59.91216410693333,1
2020-08-05-170220,170220,1,0,0,34,0.3333333333333333,66.70629089382594,2
2020-08-06-170220,170220,0,0,1,34,0.3333333333333333,62.2676957072166,3
2020-08-07-170220,170220,1,0,2,35,0.0,52.08179744508246,4
2020-08-08-170220,170220,4,0,0,39,0.0,51.87151657795911,5
2020-08-09-170220,170220,0,0,0,39,0.0,57.41916811610841,6
2020-08-10-170220,170220,1,0,4,40,0.3333333333333333,10.595774494919496,0
2020-08-11-170220,170220,0,0,0,40,0.8333333333333334,17.526619112045736,1
2020-08-12-170220,170220,1,0,0,41,0.3333333333333333,24.728272868828817,2
2020-08-13-170220,170220,1,0,3,42,1.1666666666666667,37.75090467987205,3
2020-08-14-170220,170220,2,0,1,44,0.6666666666666666,49.780078972300764,4
2020-08-15-170220,170220,1,0,2,45,0.3333333333333333,60.393446926296015,5
2020-08-16-170220,170220,3,0,1,48,0.8333333333333334,63.3914195638122,6
2020-08-17-170220,170220,1,0,0,49,0.8333333333333334,72.62790480123017,0
2020-08-18-170220,170220,2,0,3,51,0.3333333333333333,72.47218722384301,1
2020-08-19-170220,170220,0,0,2,51,0.16666666666666666,78.58814754599317,2
2020-08-20-170220,170220,1,0,2,52,1.0,63.335486201909504,3
2020-08-21-170220,170220,2,0,2,54,2.1666666666666665,58.30112573027678,4
2020-08-22-170220,170220,0,0,1,54,1.5,65.99043638665736,5
2020-08-23-170220,170220,0,0,1,54,0.6666666666666666,65.44168769334966,6
2020-08-24-170220,170220,4,0,1,58,0.16666666666666666,62.69955519345615,0
2020-08-25-170220,170220,0,0,1,58,0.6666666666666666,64.8437659223223,1
2020-08-26-170220,170220,0,0,4,58,0.3333333333333333,77.53168327281888,2
2020-08-27-170220,170220,3,0,6,61,1.3333333333333333,76.05295713161725,3
2020-08-28-170220,170220,1,0,3,62,0.16666666666666666,86.27293705031407,4
2020-08-29-170220,170220,2,0,1,64,0.0,85.56983221229808,5
2020-08-30-170220,170220,1,0,0,65,1.3333333333333333,78.44540839372404,6
2020-08-31-170220,170220,0,0,3,65,0.3333333333333333,66.55506119922183,0
2020-09-01-170220,170220,3,0,4,68,0.3333333333333333,49.03831627539569,1
2020-09-02-170220,170220,2,0,3,70,0.3333333333333333,80.23704630712732,2
2020-09-03-170220,170220,2,0,0,72,1.1666666666666667,53.70475062048182,3
2020-09-04-170220,170220,2,0,2,74,1.3333333333333333,52.39792915103579,4
2020-09-05-170220,170220,1,0,0,75,0.3333333333333333,50.696829243112916,5
2020-09-06-170220,170220,1,0,0,76,1.0,50.25306020528343,6
2020-09-07-170220,170220,1,0,0,77,0.16666666666666666,50.0724933111571,0
2020-09-08-170220,170220,1,0,2,78,2.333333333333333,47.69825248561432,1
2020-09-09-170220,170220,4,0,4,82,1.5,52.75684898630825,2
2020-09-10-170220,170220,6,0,0,88,1.6666666666666667,49.89672620172881,3
2020-09-11-170220,170220,3,0,1,91,2.1666666666666665,54.86097615397979,4
2020-09-12-170220,170220,1,0,0,92,0.8333333333333334,57.43993529307751,5
2020-09-13-170220,170220,0,0,0,92,0.8333333333333334,62.742347046227906,6
2020-09-14-170220,170220,3,0,0,95,0.8333333333333334,63.24013538242477,0
2020-09-15-170220,170220,4,0,1,99,0.8333333333333334,68.06217469709873,1
2020-09-16-170220,170220,3,0,2,102,1.6666666666666667,88.48462292076334,2
2020-09-17-170220,170220,0,0,0,102,0.8333333333333334,87.25668439083478,3
2020-09-18-170220,170220,2,0,0,104,0.5,81.4790994055318,4
2020-09-19-170220,170220,0,0,2,104,0.0,78.596821463458,5
2020-09-20-170220,170220,0,0,1,104,0.6666666666666666,74.57090597758457,6
2020-09-21-170220,170220,0,0,0,104,0.5,67.70238116436458,0
2020-09-22-170220,170220,2,1,1,106,0.0,55.005513749648095,1
2020-09-23-170220,170220,4,0,1,110,1.0,48.58157944632964,2
2020-09-24-170220,170220,0,1,2,110,1.0,50.21212989887529,3
2020-09-25-170220,170220,1,1,1,111,0.3333333333333333,45.944864876286815,4
2020-09-26-170220,170220,0,0,0,111,0.6666666666666666,50.87704825029003,5
2020-09-27-170220,170220,0,0,0,111,0.3333333333333333,46.22206116941146,6
2020-09-28-170220,170220,0,0,2,111,1.1666666666666667,44.761065424131765,0
2020-09-29-170220,170220,1,0,5,112,0.3333333333333333,46.866193151917244,1
2020-09-30-170220,170220,2,0,3,114,1.0,43.03158107619885,2
2020-10-01-170220,170220,0,0,1,114,1.1666666666666667,0.0,3
2020-10-02-170220,170220,0,0,5,114,2.0,136.96904080535884,4
2020-10-03-170220,170220,2,0,7,116,1.6666666666666667,176.26320880562696,5
2020-10-04-170220,170220,1,0,0,117,1.1666666666666667,180.77025453752765,6
2020-10-05-170220,170220,0,0,5,117,1.0,151.68868240921665,0
2020-10-06-170220,170220,1,0,10,118,2.0,130.70017595964617,1
2020-10-07-170220,170220,1,0,4,119,0.5,117.78034515104198,2
2020-10-08-170220,170220,2,0,6,121,0.5,99.79706849972531,3
2020-10-09-170220,170220,1,0,6,122,1.0,105.34189118991952,4
2020-10-10-170220,170220,0,0,3,122,1.3333333333333333,5.815183029840956,5
2020-10-11-170220,170220,0,0,3,122,1.0,11.320022263043514,6
2020-10-12-170220,170220,2,0,6,124,0.5,22.234940117247262,0
2020-10-13-170220,170220,5,0,2,129,0.5,32.121336849349184,1
2020-10-14-170220,170220,3,0,1,132,1.5,53.438903733278686,2
2020-10-15-170220,170220,1,0,3,133,1.0,73.69312580983825,3
2020-10-16-170220,170220,5,0,6,138,0.6666666666666666,93.04979792806424,4
2020-10-17-170220,170220,7,0,0,145,0.3333333333333333,113.31864013141674,5
2020-10-18-170220,170220,0,0,2,145,0.5,121.1960815116159,6
2020-10-19-170220,170220,5,0,2,150,1.1666666666666667,120.9703415991219,0
2020-10-20-170220,170220,10,0,6,160,1.0,124.66164905876698,1
2020-10-21-170220,170220,4,0,3,164,0.16666666666666666,134.01213768346514,2
2020-10-22-170220,170220,6,0,2,170,1.6666666666666667,137.61904634669776,3
2020-10-23-170220,170220,6,0,1,176,2.1666666666666665,139.91521146340077,4
2020-10-24-170220,170220,3,0,5,179,0.8333333333333334,140.78320860896483,5
2020-10-25-170220,170220,3,0,2,182,1.5,137.32832183856328,6
2020-10-26-170220,170220,6,0,2,188,0.5,126.92191485959891,0
2020-10-27-170220,170220,2,1,3,190,2.333333333333333,144.80172785422263,1
2020-10-28-170220,170220,1,0,0,191,1.3333333333333333,142.62627605741483,2
2020-10-29-170220,170220,3,1,2,194,2.1666666666666665,146.13703903825675,3
2020-10-30-170220,170220,6,1,4,200,3.333333333333333,136.18119365502886,4
2020-10-31-170220,170220,0,0,0,200,1.8333333333333333,155.10252826856618,5
2020-11-01-170220,170220,2,1,0,202,1.5,74.07269490289661,6
2020-11-02-170220,170220,2,0,0,204,0.8333333333333334,207.70374391587723,0
2020-11-03-170220,170220,6,0,0,210,1.6666666666666667,162.4142864811127,1
2020-11-04-170220,170220,3,0,0,213,0.6666666666666666,173.95252107140507,2
2020-11-05-170220,170220,2,0,0,215,2.5,177.64027281534567,3
2020-11-06-170220,170220,1,0,0,216,0.16666666666666666,175.52386346771016,4
2020-11-07-170220,170220,5,0,0,221,0.8333333333333334,160.2104291959255,5
2020-11-08-170220,170220,2,0,0,223,1.8333333333333333,146.24718132381327,6
2020-11-09-170220,170220,2,0,0,225,1.3333333333333333,145.05362391369113,0
2020-11-10-170220,170220,3,0,0,228,2.0,74.34800752722603,1
2020-11-11-170220,170220,0,0,0,228,0.3333333333333333,92.435969977805,2
2020-11-12-170220,170220,2,0,0,230,1.5,96.2261246586651,3
2020-11-13-170220,170220,4,0,0,234,4.833333333333333,108.43910523253652,4
2020-03-01-170221,170221,0,0,2,0,0.0,0.0,6
2020-03-02-170221,170221,0,0,14,0,0.25,217.12647502072662,0
2020-03-03-170221,170221,0,0,9,0,0.5,772.0431096008444,1
2020-03-04-170221,170221,0,0,10,0,0.0,840.1303858567957,2
2020-03-05-170221,170221,0,0,14,0,0.75,926.7992383879912,3
2020-03-06-170221,170221,1,1,14,1,0.0,868.356569428004,4
2020-03-07-170221,170221,7,0,6,8,0.5,992.856597280932,5
2020-03-08-170221,170221,1,0,8,9,1.75,1259.106985390491,6
2020-03-09-170221,170221,1,0,17,10,1.0,1288.8675879447885,0
2020-03-10-170221,170221,14,0,21,24,3.0,1448.7232474737525,1
2020-03-11-170221,170221,1,0,17,25,0.75,1522.9914814435892,2
2020-03-12-170221,170221,3,0,13,28,3.5,1418.6085383616946,3
2020-03-13-170221,170221,5,0,12,33,2.25,1234.2790531443104,4
2020-03-14-170221,170221,3,0,2,36,2.5,1171.019041002968,5
2020-03-15-170221,170221,2,0,3,38,1.25,1167.7279601856371,6
2020-03-16-170221,170221,14,0,18,52,3.75,736.07771858062,0
2020-03-17-170221,170221,9,0,14,61,4.75,994.2146006486362,1
2020-03-18-170221,170221,10,0,5,71,6.5,822.7399417629517,2
2020-03-19-170221,170221,14,0,11,85,7.75,947.8245472193115,3
2020-03-20-170221,170221,14,1,11,99,10.0,1027.470406554663,4
2020-03-21-170221,170221,6,0,5,105,3.5,1209.6752933533821,5
2020-03-22-170221,170221,8,0,1,113,2.0,1248.7795252832589,6
2020-03-23-170221,170221,17,0,11,130,14.25,1158.8183413945103,0
2020-03-24-170221,170221,21,0,10,151,12.75,1313.755133067613,1
2020-03-25-170221,170221,17,0,8,168,9.25,1536.8187113900392,2
2020-03-26-170221,170221,13,0,10,181,8.75,1586.5926549220865,3
2020-03-27-170221,170221,12,0,5,193,9.25,1806.2267756741255,4
2020-03-28-170221,170221,2,0,2,195,4.75,1756.158553111495,5
2020-03-29-170221,170221,3,0,0,198,0.75,1694.505995993117,6
2020-03-30-170221,170221,18,0,5,216,10.0,1265.654897437221,0
2020-03-31-170221,170221,14,0,6,230,6.5,1186.938685749078,1
2020-04-01-170221,170221,5,0,11,235,5.75,429.0966513236461,2
2020-04-02-170221,170221,11,0,13,246,6.75,795.2563275346305,3
2020-04-03-170221,170221,11,0,9,257,5.25,373.3889638288327,4
2020-04-04-170221,170221,5,0,2,262,0.75,568.9990830802568,5
2020-04-05-170221,170221,1,0,0,263,3.0,628.5614226780967,6
2020-04-06-170221,170221,11,0,5,274,4.75,633.0673873192285,0
2020-04-07-170221,170221,10,0,8,284,4.5,771.5856431830942,1
2020-04-08-170221,170221,8,0,3,292,4.5,781.4173755169446,2
2020-04-09-170221,170221,10,0,2,302,4.75,846.8428001569661,3
2020-04-10-170221,170221,5,0,2,307,3.75,274.3884379441441,4
2020-04-11-170221,170221,2,0,1,309,1.25,357.6310647821672,5
2020-04-12-170221,170221,0,0,1,309,0.25,392.81902329646266,6
2020-04-13-170221,170221,5,0,1,314,7.25,376.77421114113906,0
2020-04-14-170221,170221,6,0,9,320,4.25,335.8480666839124,1
2020-04-15-170221,170221,11,0,4,331,4.5,444.14990433881655,2
2020-04-16-170221,170221,13,0,4,344,6.5,619.7492339178727,3
2020-04-17-170221,170221,9,0,1,353,11.75,793.350910323208,4
2020-04-18-170221,170221,2,0,3,355,0.5,859.5474210877433,5
2020-04-19-170221,170221,0,0,1,355,0.75,842.5211710926835,6
2020-04-20-170221,170221,5,0,5,360,3.5,985.8672035386369,0
2020-04-21-170221,170221,8,0,7,368,3.25,951.0491894876352,1
2020-04-22-170221,170221,3,0,7,371,4.0,891.2871850379614,2
2020-04-23-170221,170221,2,0,13,373,1.0,691.2064686909088,3
2020-04-24-170221,170221,2,0,1,375,3.25,579.4230439216013,4
2020-04-25-170221,170221,1,0,0,376,2.5,604.0236304859375,5
2020-04-26-170221,170221,1,0,0,377,0.75,624.9230769097551,6
2020-04-27-170221,170221,1,0,9,378,3.75,436.80090219650765,0
2020-04-28-170221,170221,9,0,6,387,3.0,367.7716264601886,1
2020-04-29-170221,170221,4,0,9,391,2.25,393.3124742423033,2
2020-04-30-170221,170221,4,0,4,395,1.5,587.6541500414411,3
2020-05-01-170221,170221,1,0,4,396,0.5,907.146173775926,4
2020-05-02-170221,170221,3,0,0,399,0.5,511.8248018402548,5
2020-05-03-170221,170221,1,0,0,400,0.0,339.89745910866156,6
2020-05-04-170221,170221,5,0,6,405,2.75,269.5705105670856,0
2020-05-05-170221,170221,7,0,2,412,1.5,281.4428528815293,1
2020-05-06-170221,170221,7,0,3,419,1.5,349.16987088244804,2
2020-05-07-170221,170221,13,0,4,432,3.0,461.9235135789107,3
2020-05-08-170221,170221,1,0,3,433,2.5,707.5934600024478,4
2020-05-09-170221,170221,0,0,0,433,0.75,746.3517372124509,5
2020-05-10-170221,170221,0,0,0,433,0.75,986.6234464868564,6
2020-05-11-170221,170221,9,0,4,442,2.0,865.7742203475258,0
2020-05-12-170221,170221,6,0,5,448,2.0,1011.1166926801051,1
2020-05-13-170221,170221,9,1,5,457,3.5,909.4514132128049,2
2020-05-14-170221,170221,4,0,1,461,3.25,899.5829630010294,3
2020-05-15-170221,170221,4,0,1,465,2.5,838.20045326103,4
2020-05-16-170221,170221,0,0,0,465,0.5,696.7614781032883,5
2020-05-17-170221,170221,0,0,0,465,0.25,676.7360738216952,6
2020-05-18-170221,170221,6,0,6,471,4.75,685.0239308181845,0
2020-05-19-170221,170221,2,0,2,473,1.5,657.425344615562,1
2020-05-20-170221,170221,3,0,1,476,2.0,477.96892672727466,2
2020-05-21-170221,170221,4,0,5,480,1.0,452.6853412593643,3
2020-05-22-170221,170221,3,0,1,483,1.25,459.48522566276347,4
2020-05-23-170221,170221,0,0,0,483,0.0,511.8573727394608,5
2020-05-24-170221,170221,0,0,0,483,0.25,515.6368547062377,6
2020-05-25-170221,170221,4,0,1,487,2.25,363.39767293066467,0
2020-05-26-170221,170221,5,0,0,492,0.5,417.066437996317,1
2020-05-27-170221,170221,5,0,1,497,0.75,471.63990527668216,2
2020-05-28-170221,170221,1,3,1,498,0.5,519.1694110376593,3
2020-05-29-170221,170221,1,1,0,499,1.5,453.49653365863026,4
2020-05-30-170221,170221,0,1,0,499,0.25,475.02600957862325,5
2020-05-31-170221,170221,0,0,0,499,0.0,485.4773736784482,6
2020-06-01-170221,170221,6,0,0,505,1.75,877.9844576524408,0
2020-06-02-170221,170221,2,1,0,507,0.75,28.179066921519333,1
2020-06-03-170221,170221,1,0,0,508,1.75,86.43663687871046,2
2020-06-04-170221,170221,5,0,0,513,0.5,140.33174949467244,3
2020-06-05-170221,170221,1,0,0,514,0.25,265.93275322754806,4
2020-06-06-170221,170221,0,0,0,514,0.25,245.13724377937916,5
2020-06-07-170221,170221,0,0,0,514,0.0,244.73103166690396,6
2020-06-08-170221,170221,1,0,0,515,0.75,242.77698919489302,0
2020-06-09-170221,170221,0,0,0,515,0.0,248.95872158832609,1
2020-06-10-170221,170221,1,0,0,516,1.0,1025.1270614504297,2
2020-06-11-170221,170221,1,0,1,517,0.25,952.8918498249122,3
2020-06-12-170221,170221,0,0,2,517,1.25,769.7332531676625,4
2020-06-13-170221,170221,0,0,0,517,0.0,610.7940158896649,5
2020-06-14-170221,170221,0,0,0,517,0.25,279.1134294907403,6
2020-06-15-170221,170221,0,0,0,517,0.0,255.52979612382748,0
2020-06-16-170221,170221,0,0,1,517,1.0,254.77374366608458,1
2020-06-17-170221,170221,0,0,1,517,0.25,102.79991128717502,2
2020-06-18-170221,170221,0,0,0,517,0.5,58.11575366426318,3
2020-06-19-170221,170221,0,0,0,517,0.0,32.8717649754975,4
2020-06-20-170221,170221,0,0,0,517,0.0,87.16153116155633,5
2020-06-21-170221,170221,0,0,0,517,0.5,79.03201714368733,6
2020-06-22-170221,170221,0,0,1,517,0.0,80.20693727028839,0
2020-06-23-170221,170221,0,0,0,517,0.25,67.04340970219273,1
2020-06-24-170221,170221,0,0,1,517,0.25,67.70584006286543,2
2020-06-25-170221,170221,1,0,1,518,0.0,74.45463587769991,3
2020-06-26-170221,170221,2,1,0,520,0.0,74.25055032032837,4
2020-06-27-170221,170221,0,0,1,520,0.0,68.96513127626855,5
2020-06-28-170221,170221,0,0,0,520,0.0,68.66334377216876,6
2020-06-29-170221,170221,0,0,0,520,0.0,66.95854485123019,0
2020-06-30-170221,170221,1,0,0,521,0.25,132.9141347322502,1
2020-07-01-170221,170221,1,0,0,522,0.5,227.94543544675162,2
2020-07-02-170221,170221,0,0,1,522,0.25,45.28247211025644,3
2020-07-03-170221,170221,0,0,0,522,1.25,377.2278438177252,4
2020-07-04-170221,170221,0,0,0,522,0.0,280.15083321568176,5
2020-07-05-170221,170221,0,0,0,522,0.0,175.5452892975149,6
2020-07-06-170221,170221,1,0,0,523,0.25,174.1357903834779,0
2020-07-07-170221,170221,0,0,0,523,0.0,178.92532281414913,1
2020-07-08-170221,170221,1,1,0,524,0.75,100.36469420650798,2
2020-07-09-170221,170221,1,0,3,525,0.5,95.95222524916218,3
2020-07-10-170221,170221,0,0,3,525,0.5,217.23225766612197,4
2020-07-11-170221,170221,1,0,2,526,0.25,92.80939516328142,5
2020-07-12-170221,170221,0,0,4,526,0.0,90.79646626671574,6
2020-07-13-170221,170221,0,0,0,526,0.75,89.24885532991924,0
2020-07-14-170221,170221,0,0,1,526,0.25,92.19379014505778,1
2020-07-15-170221,170221,0,0,2,526,0.25,64.96953433029623,2
2020-07-16-170221,170221,1,0,2,527,0.75,65.48896823001232,3
2020-07-17-170221,170221,0,0,3,527,0.25,64.81921351503533,4
2020-07-18-170221,170221,0,0,2,527,0.5,63.42000047968253,5
2020-07-19-170221,170221,0,0,1,527,0.25,41.07195045768564,6
2020-07-20-170221,170221,0,0,0,527,0.5,41.299668570944405,0
2020-07-21-170221,170221,0,0,2,527,0.0,41.27424091215606,1
2020-07-22-170221,170221,0,0,1,527,0.0,42.42505436619646,2
2020-07-23-170221,170221,3,0,1,530,0.25,14.925222899341946,3
2020-07-24-170221,170221,3,0,0,533,0.5,63.784237881480145,4
2020-07-25-170221,170221,2,0,4,535,0.0,112.30993749207083,5
2020-07-26-170221,170221,4,0,0,539,0.0,159.72505421577853,6
2020-07-27-170221,170221,0,1,4,539,0.0,259.6224733115947,0
2020-07-28-170221,170221,1,0,5,540,0.25,259.1764002834104,1
2020-07-29-170221,170221,2,0,4,542,0.5,286.75597561754057,2
2020-07-30-170221,170221,2,0,5,544,0.5,321.6380563492262,3
2020-07-31-170221,170221,3,0,4,547,0.75,295.60874542948244,4
2020-08-01-170221,170221,2,0,3,549,0.75,100.91956097666697,5
2020-08-02-170221,170221,1,0,3,550,0.0,979.2564599249608,6
2020-08-03-170221,170221,0,0,13,550,1.0,1079.5620417339546,0
2020-08-04-170221,170221,2,0,2,552,1.0,836.3313733995609,1
2020-08-05-170221,170221,1,0,8,553,3.25,765.7566785273273,2
2020-08-06-170221,170221,1,0,11,554,1.5,718.5388826824868,3
2020-08-07-170221,170221,0,1,5,554,2.5,501.9917822020507,4
2020-08-08-170221,170221,4,0,1,558,0.75,497.43139512494645,5
2020-08-09-170221,170221,0,0,2,558,0.5,580.2508168421236,6
2020-08-10-170221,170221,4,0,10,562,2.25,122.44622721941505,0
2020-08-11-170221,170221,5,0,9,567,1.25,207.70039808110548,1
2020-08-12-170221,170221,4,0,8,571,4.75,311.2487387851164,2
2020-08-13-170221,170221,5,0,9,576,1.75,381.0415159456903,3
2020-08-14-170221,170221,4,0,9,580,0.5,535.1865497637972,4
2020-08-15-170221,170221,3,0,0,583,0.5,627.310165032133,5
2020-08-16-170221,170221,3,0,12,586,0.75,670.8221652824437,6
2020-08-17-170221,170221,13,0,0,599,4.75,673.084790586374,0
2020-08-18-170221,170221,2,0,7,601,4.75,928.4011591782255,1
2020-08-19-170221,170221,8,0,13,609,4.75,844.2962756116647,2
2020-08-20-170221,170221,11,0,7,620,1.25,773.002436982216,3
2020-08-21-170221,170221,5,0,10,625,4.5,846.4243285777387,4
2020-08-22-170221,170221,1,0,5,626,1.0,966.6687503962672,5
2020-08-23-170221,170221,2,0,2,628,1.75,934.3151174310694,6
2020-08-24-170221,170221,10,0,22,638,5.0,661.6958174225775,0
2020-08-25-170221,170221,9,0,4,647,1.75,868.7282616594294,1
2020-08-26-170221,170221,8,0,12,655,2.5,950.9533272211823,2
2020-08-27-170221,170221,9,0,13,664,3.5,1072.1809603119236,3
2020-08-28-170221,170221,9,0,19,673,1.75,986.4559245671387,4
2020-08-29-170221,170221,0,0,18,673,2.0,1034.6667004870355,5
2020-08-30-170221,170221,12,0,12,685,2.0,992.7344464907586,6
2020-08-31-170221,170221,0,0,21,685,1.25,1031.347098065742,0
2020-09-01-170221,170221,7,0,34,692,3.25,315.66654811177733,1
2020-09-02-170221,170221,13,0,29,705,3.0,3137.8298323786635,2
2020-09-03-170221,170221,7,0,32,712,1.0,4873.324370318947,3
2020-09-04-170221,170221,10,0,35,722,1.25,4015.145719537299,4
2020-09-05-170221,170221,5,0,12,727,1.5,3284.8410841470773,5
2020-09-06-170221,170221,2,0,11,729,0.75,3220.5484876721753,6
2020-09-07-170221,170221,22,0,59,751,3.25,3091.300625760785,0
2020-09-08-170221,170221,4,0,38,755,3.75,2581.896312241631,1
2020-09-09-170221,170221,12,0,38,767,3.75,2076.6186402436897,2
2020-09-10-170221,170221,13,0,43,780,4.0,449.6216481300701,3
2020-09-11-170221,170221,19,0,82,799,2.75,706.454843248287,4
2020-09-12-170221,170221,18,0,8,817,2.25,948.2567987843231,5
2020-09-13-170221,170221,12,0,9,829,3.0,1367.2977387690419,6
2020-09-14-170221,170221,21,0,44,850,4.75,1676.1563062211853,0
2020-09-15-170221,170221,34,0,25,884,9.5,1914.4013310439727,1
2020-09-16-170221,170221,29,0,27,913,11.75,2566.675403011861,2
2020-09-17-170221,170221,32,0,56,945,12.0,2993.4231721652154,3
2020-09-18-170221,170221,35,0,34,980,10.25,3058.386165838703,4
2020-09-19-170221,170221,12,0,10,992,2.25,3628.8341327787994,5
2020-09-20-170221,170221,11,0,15,1003,4.75,3350.448255333392,6
2020-09-21-170221,170221,59,1,19,1062,17.25,3160.106415906362,0
2020-09-22-170221,170221,38,0,20,1100,13.0,3771.5102205961384,1
2020-09-23-170221,170221,38,1,20,1138,13.25,3928.5974214174853,2
2020-09-24-170221,170221,43,0,23,1181,10.0,4400.3073944001935,3
2020-09-25-170221,170221,82,3,11,1263,10.0,4356.670120628176,4
2020-09-26-170221,170221,8,0,3,1271,3.5,5226.200313152146,5
2020-09-27-170221,170221,9,0,2,1280,2.5,5175.338413106119,6
2020-09-28-170221,170221,44,0,8,1324,9.25,5144.287837255986,0
2020-09-29-170221,170221,25,0,28,1349,6.75,4958.412847600553,1
2020-09-30-170221,170221,27,0,11,1376,7.25,4235.505948353207,2
2020-10-01-170221,170221,56,0,9,1432,9.5,0.0,3
2020-10-02-170221,170221,34,2,14,1466,8.25,2053.6892914795535,4
2020-10-03-170221,170221,10,0,3,1476,1.5,1848.7141307712498,5
2020-10-04-170221,170221,15,1,1,1491,2.25,1734.1255761671548,6
2020-10-05-170221,170221,19,0,15,1510,8.75,1758.232662161514,0
2020-10-06-170221,170221,20,1,7,1530,9.0,1882.8097711698506,1
2020-10-07-170221,170221,20,0,13,1550,6.0,2048.8534230140363,2
2020-10-08-170221,170221,23,2,11,1573,8.25,2389.876479798265,3
2020-10-09-170221,170221,11,0,20,1584,7.0,2629.9455045864456,4
2020-10-10-170221,170221,3,0,3,1587,2.25,1394.2337643561398,5
2020-10-11-170221,170221,2,0,16,1589,0.25,1492.9128920964997,6
2020-10-12-170221,170221,8,0,13,1597,2.0,1559.6522775820042,0
2020-10-13-170221,170221,28,0,12,1625,4.75,1694.3759443952126,1
2020-10-14-170221,170221,11,0,12,1636,8.5,2390.7967086433373,2
2020-10-15-170221,170221,9,0,10,1645,8.25,2663.257099536267,3
2020-10-16-170221,170221,14,0,10,1659,9.5,2955.524565421853,4
2020-10-17-170221,170221,3,0,3,1662,2.0,1960.9997838376867,5
2020-10-18-170221,170221,1,0,2,1663,2.0,1953.1527077535002,6
2020-10-19-170221,170221,15,1,8,1678,8.5,1917.5396346485722,0
2020-10-20-170221,170221,7,0,16,1685,7.25,2133.535546365466,1
2020-10-21-170221,170221,13,0,8,1698,7.5,2030.0783749721702,2
2020-10-22-170221,170221,11,0,5,1709,8.0,2077.901850399299,3
2020-10-23-170221,170221,20,0,9,1729,4.5,1980.4850192069755,4
2020-10-24-170221,170221,3,0,5,1732,3.25,2230.621231737523,5
2020-10-25-170221,170221,16,0,1,1748,4.5,2296.51968576916,6
2020-10-26-170221,170221,13,0,15,1761,5.0,2227.2473019176637,0
2020-10-27-170221,170221,12,1,15,1773,3.75,1933.396959202592,1
2020-10-28-170221,170221,12,2,7,1785,7.25,2090.1861528363565,2
2020-10-29-170221,170221,10,0,10,1795,5.0,2099.0633323360707,3
2020-10-30-170221,170221,10,0,7,1805,4.25,1907.407250046378,4
2020-10-31-170221,170221,3,0,0,1808,1.75,2133.833076045816,5
2020-11-01-170221,170221,2,0,0,1810,2.0,2712.581681948517,6
2020-11-02-170221,170221,8,1,0,1818,1.75,679.0551653164906,0
2020-11-03-170221,170221,16,0,0,1834,4.75,749.7442610992416,1
2020-11-04-170221,170221,8,0,0,1842,4.25,1155.0553900630084,2
2020-11-05-170221,170221,5,0,0,1847,2.75,1384.553063936671,3
2020-11-06-170221,170221,9,1,0,1856,5.0,1298.293786013959,4
2020-11-07-170221,170221,5,0,0,1861,2.25,1426.9631418844763,5
2020-11-08-170221,170221,1,0,0,1862,0.75,1424.3477169262155,6
2020-11-09-170221,170221,15,0,0,1877,2.5,1238.028107981825,0
2020-11-10-170221,170221,15,0,0,1892,7.5,2633.7405589795526,1
2020-11-11-170221,170221,7,2,0,1899,3.25,2653.055139538141,2
2020-11-12-170221,170221,10,0,0,1909,2.25,2381.681003070939,3
2020-11-13-170221,170221,7,1,0,1916,5.0,2035.154661389527,4
2020-03-01-170222,170222,0,0,3,0,0.0,0.0,6
2020-03-02-170222,170222,0,0,9,0,0.0,7.902254967677547,0
2020-03-03-170222,170222,0,0,9,0,0.0,27.79684697929114,1
2020-03-04-170222,170222,0,0,12,0,0.0,30.327385144499125,2
2020-03-05-170222,170222,3,0,12,3,0.0,33.515029079853036,3
2020-03-06-170222,170222,0,0,26,3,1.0,31.40092269015842,4
2020-03-07-170222,170222,2,0,4,5,7.0,35.97587293020154,5
2020-03-08-170222,170222,7,0,6,12,1.0,45.719690582235295,6
2020-03-09-170222,170222,1,0,21,13,1.0,46.82665723570154,0
2020-03-10-170222,170222,12,0,27,25,14.0,52.22474784478529,1
2020-03-11-170222,170222,2,0,15,27,1.0,55.15103765929173,2
2020-03-12-170222,170222,12,0,18,39,3.0,51.43990295954986,3
2020-03-13-170222,170222,5,0,20,44,5.0,44.82578324159723,4
2020-03-14-170222,170222,3,0,6,47,3.0,42.63471498085334,5
2020-03-15-170222,170222,3,0,1,50,2.0,42.61978679350189,6
2020-03-16-170222,170222,9,0,18,59,14.0,26.90009225956567,0
2020-03-17-170222,170222,9,0,14,68,9.0,36.34194736819712,1
2020-03-18-170222,170222,12,1,12,80,10.0,29.943568066314466,2
2020-03-19-170222,170222,12,0,12,92,14.0,34.437825231249,3
2020-03-20-170222,170222,26,2,5,118,14.0,37.170953202865874,4
2020-03-21-170222,170222,4,0,2,122,6.0,43.77182762647997,5
2020-03-22-170222,170222,6,0,6,128,8.0,45.200824990713016,6
2020-03-23-170222,170222,21,0,8,149,17.0,41.89040168452775,0
2020-03-24-170222,170222,27,0,8,176,21.0,47.28397132594723,1
2020-03-25-170222,170222,15,0,11,191,17.0,55.25956285985772,2
2020-03-26-170222,170222,18,0,6,209,13.0,56.9401142556493,3
2020-03-27-170222,170222,20,0,11,229,12.0,64.86024966736694,4
2020-03-28-170222,170222,6,0,3,235,2.0,63.01091165627761,5
2020-03-29-170222,170222,1,1,1,236,3.0,60.708453840381566,6
2020-03-30-170222,170222,18,0,22,254,18.0,45.35156238374662,0
2020-03-31-170222,170222,14,0,12,268,14.0,42.47414786856883,1
2020-04-01-170222,170222,12,0,14,280,5.0,15.579658572361165,2
2020-04-02-170222,170222,12,0,20,292,11.0,28.80354329750994,3
2020-04-03-170222,170222,5,0,43,297,11.0,13.496382597954108,4
2020-04-04-170222,170222,2,0,1,299,5.0,20.48105538074384,5
2020-04-05-170222,170222,6,0,1,305,1.0,22.67596466482521,6
2020-04-06-170222,170222,8,1,10,313,11.0,22.84162316143867,0
2020-04-07-170222,170222,8,0,9,321,10.0,27.807252147455646,1
2020-04-08-170222,170222,11,1,12,332,8.0,28.112199275080684,2
2020-04-09-170222,170222,6,0,4,338,10.0,30.475816021963393,3
2020-04-10-170222,170222,11,0,10,349,5.0,9.923792821239504,4
2020-04-11-170222,170222,3,0,8,352,2.0,12.934748147783793,5
2020-04-12-170222,170222,1,0,0,353,0.0,14.215799074721312,6
2020-04-13-170222,170222,22,0,13,375,5.0,13.633083485100666,0
2020-04-14-170222,170222,12,0,7,387,6.0,12.019239599086344,1
2020-04-15-170222,170222,14,0,5,401,11.0,15.957884109510461,2
2020-04-16-170222,170222,20,0,6,421,13.0,22.37576434729323,3
2020-04-17-170222,170222,43,0,0,464,9.0,28.767276778211812,4
2020-04-18-170222,170222,1,0,2,465,2.0,31.212365886450495,5
2020-04-19-170222,170222,1,0,0,466,0.0,30.582399524066876,6
2020-04-20-170222,170222,10,0,9,476,5.0,35.74328869888844,0
2020-04-21-170222,170222,9,0,3,485,8.0,34.4282227618694,1
2020-04-22-170222,170222,12,0,4,497,3.0,32.26250204284471,2
2020-04-23-170222,170222,4,0,9,501,2.0,24.961427872638986,3
2020-04-24-170222,170222,10,0,8,511,2.0,20.89326217396633,4
2020-04-25-170222,170222,8,0,3,519,1.0,21.771239620462296,5
2020-04-26-170222,170222,0,0,1,519,1.0,22.562954897590192,6
2020-04-27-170222,170222,13,0,6,532,1.0,15.807610533605757,0
2020-04-28-170222,170222,7,0,5,539,9.0,13.306826936518966,1
2020-04-29-170222,170222,5,0,8,544,4.0,14.208755910207888,2
2020-04-30-170222,170222,6,0,8,550,4.0,21.139295333271733,3
2020-05-01-170222,170222,0,0,4,550,1.0,32.742115237067765,4
2020-05-02-170222,170222,2,0,2,552,3.0,18.478876661960463,5
2020-05-03-170222,170222,0,0,1,552,1.0,12.328123421611545,6
2020-05-04-170222,170222,9,0,16,561,5.0,9.767168888138421,0
2020-05-05-170222,170222,3,0,6,564,7.0,10.175194703607183,1
2020-05-06-170222,170222,4,0,7,568,7.0,12.626077530050246,2
2020-05-07-170222,170222,9,0,1,577,13.0,16.746077961791574,3
2020-05-08-170222,170222,8,0,2,585,1.0,25.883105369579607,4
2020-05-09-170222,170222,3,0,0,588,0.0,27.260602387370117,5
2020-05-10-170222,170222,1,0,1,589,0.0,35.517877524289176,6
2020-05-11-170222,170222,6,1,4,595,9.0,31.087410059140858,0
2020-05-12-170222,170222,5,0,2,600,6.0,36.45065295009773,1
2020-05-13-170222,170222,8,0,3,608,9.0,32.854069081697375,2
2020-05-14-170222,170222,8,0,2,616,4.0,32.57657330756589,3
2020-05-15-170222,170222,4,0,1,620,4.0,30.296430665456175,4
2020-05-16-170222,170222,2,0,1,622,0.0,25.100985446324444,5
2020-05-17-170222,170222,1,0,0,623,0.0,24.391691484529375,6
2020-05-18-170222,170222,16,0,4,639,6.0,24.716352372663735,0
2020-05-19-170222,170222,6,0,3,645,2.0,23.660556361304685,1
2020-05-20-170222,170222,7,1,3,652,3.0,17.176739828958368,2
2020-05-21-170222,170222,1,0,1,653,4.0,16.33824028497842,3
2020-05-22-170222,170222,2,0,0,655,3.0,16.75497540809227,4
2020-05-23-170222,170222,0,0,1,655,0.0,18.621643567495727,5
2020-05-24-170222,170222,1,0,0,656,0.0,18.750440020713807,6
2020-05-25-170222,170222,4,0,2,660,4.0,13.211712833443785,0
2020-05-26-170222,170222,2,0,0,662,5.0,15.141050815537994,1
2020-05-27-170222,170222,3,0,0,665,5.0,17.128495825194417,2
2020-05-28-170222,170222,2,0,0,667,1.0,18.8927345590403,3
2020-05-29-170222,170222,1,0,0,668,1.0,16.489350056015983,4
2020-05-30-170222,170222,1,0,0,669,0.0,17.17810040934623,5
2020-05-31-170222,170222,0,0,0,669,0.0,17.531058637032793,6
2020-06-01-170222,170222,4,0,0,673,6.0,31.949565821224887,0
2020-06-02-170222,170222,3,0,2,676,2.0,0.810906117152165,1
2020-06-03-170222,170222,3,0,1,679,1.0,3.083377401472884,2
2020-06-04-170222,170222,1,0,1,680,5.0,5.018917600915298,3
2020-06-05-170222,170222,0,0,0,680,1.0,9.595549043153309,4
2020-06-06-170222,170222,1,0,0,681,0.0,8.811262866787105,5
2020-06-07-170222,170222,0,0,1,681,0.0,8.795066043801542,6
2020-06-08-170222,170222,2,0,0,683,1.0,8.724100812994736,0
2020-06-09-170222,170222,0,0,1,683,0.0,8.92227704739744,1
2020-06-10-170222,170222,0,0,0,683,1.0,37.3643151996541,2
2020-06-11-170222,170222,0,0,0,683,1.0,34.60140704445591,3
2020-06-12-170222,170222,0,0,0,683,0.0,27.913940110237057,4
2020-06-13-170222,170222,0,0,0,683,0.0,22.073923026588986,5
2020-06-14-170222,170222,0,0,0,683,0.0,9.90430445713258,6
2020-06-15-170222,170222,0,0,0,683,0.0,9.004738836042584,0
2020-06-16-170222,170222,2,0,0,685,0.0,8.966776533182104,1
2020-06-17-170222,170222,1,0,0,686,0.0,3.350724018888568,2
2020-06-18-170222,170222,1,0,1,687,0.0,1.8634636186701226,3
2020-06-19-170222,170222,0,0,1,687,0.0,0.9447823125811807,4
2020-06-20-170222,170222,0,0,0,687,0.0,2.95318616334742,5
2020-06-21-170222,170222,1,0,0,688,0.0,2.7167157639290718,6
2020-06-22-170222,170222,0,0,0,688,0.0,2.7602191275277845,0
2020-06-23-170222,170222,1,0,0,689,0.0,2.366762665205297,1
2020-06-24-170222,170222,0,0,1,689,0.0,2.389309112043694,2
2020-06-25-170222,170222,0,0,0,689,1.0,2.585358281306175,3
2020-06-26-170222,170222,0,0,1,689,2.0,2.5821176465171027,4
2020-06-27-170222,170222,0,0,1,689,0.0,2.4162264896993184,5
2020-06-28-170222,170222,0,0,0,689,0.0,2.3900965992590066,6
2020-06-29-170222,170222,0,0,3,689,0.0,2.32999999009246,0
2020-06-30-170222,170222,0,0,0,689,1.0,4.631415030555198,1
2020-07-01-170222,170222,0,0,1,689,1.0,8.149427510132206,2
2020-07-02-170222,170222,1,0,3,690,0.0,1.477547183124544,3
2020-07-03-170222,170222,1,0,0,691,0.0,13.698586426590152,4
2020-07-04-170222,170222,0,0,1,691,0.0,10.021572395447887,5
2020-07-05-170222,170222,0,0,1,691,0.0,6.188425615965476,6
2020-07-06-170222,170222,0,0,1,691,1.0,6.129670294538645,0
2020-07-07-170222,170222,0,0,0,691,0.0,6.252405807250251,1
2020-07-08-170222,170222,1,0,0,692,1.0,3.3968896173935548,2
2020-07-09-170222,170222,0,0,1,692,1.0,3.280206629500198,3
2020-07-10-170222,170222,1,0,2,693,0.0,7.719751795656618,4
2020-07-11-170222,170222,1,0,0,694,1.0,3.1818126115343075,5
2020-07-12-170222,170222,0,2,0,694,0.0,3.1517649272694186,6
2020-07-13-170222,170222,3,0,0,697,0.0,3.110144225126237,0
2020-07-14-170222,170222,0,0,0,697,0.0,3.220141186833392,1
2020-07-15-170222,170222,1,0,1,698,0.0,2.2307517104150496,2
2020-07-16-170222,170222,3,0,1,701,1.0,2.233168554166006,3
2020-07-17-170222,170222,0,0,2,701,0.0,2.2345175840323996,4
2020-07-18-170222,170222,1,0,3,702,0.0,2.2110765536291583,5
2020-07-19-170222,170222,1,0,0,703,0.0,1.355064943564073,6
2020-07-20-170222,170222,1,0,0,704,0.0,1.3018597485269068,0
2020-07-21-170222,170222,0,0,3,704,0.0,1.3149758301752232,1
2020-07-22-170222,170222,0,0,1,704,0.0,1.3202131089716307,2
2020-07-23-170222,170222,1,0,0,705,3.0,0.33239212886654523,3
2020-07-24-170222,170222,2,0,0,707,3.0,2.1136164400928656,4
2020-07-25-170222,170222,0,0,1,707,2.0,3.916642550969985,5
2020-07-26-170222,170222,0,1,0,707,4.0,5.701906515105668,6
2020-07-27-170222,170222,0,0,7,707,0.0,9.363143866763146,0
2020-07-28-170222,170222,0,0,0,707,1.0,9.358612634606184,1
2020-07-29-170222,170222,1,0,14,708,2.0,10.376350786959906,2
2020-07-30-170222,170222,1,0,3,709,2.0,11.4768750628703,3
2020-07-31-170222,170222,2,0,2,711,3.0,10.50634157963513,4
2020-08-01-170222,170222,3,0,0,714,2.0,3.319543726000249,5
2020-08-02-170222,170222,0,0,2,714,1.0,34.251584320498054,6
2020-08-03-170222,170222,0,0,13,714,0.0,38.476304225375145,0
2020-08-04-170222,170222,3,0,5,717,2.0,29.580804464529407,1
2020-08-05-170222,170222,1,0,12,718,1.0,26.785127262185306,2
2020-08-06-170222,170222,0,0,5,718,1.0,24.95306772052854,3
2020-08-07-170222,170222,0,0,9,718,0.0,16.97656364621411,4
2020-08-08-170222,170222,1,0,2,719,4.0,16.669580315998825,5
2020-08-09-170222,170222,0,0,4,719,0.0,19.799060993226803,6
2020-08-10-170222,170222,7,0,16,726,4.0,4.1082741956261675,0
2020-08-11-170222,170222,0,0,4,726,5.0,7.067146989865744,1
2020-08-12-170222,170222,14,0,10,740,4.0,10.663635760354737,2
2020-08-13-170222,170222,3,0,12,743,5.0,13.142490306387996,3
2020-08-14-170222,170222,2,0,5,745,4.0,18.576040814186353,4
2020-08-15-170222,170222,0,0,7,745,3.0,21.95862165027016,5
2020-08-16-170222,170222,2,0,8,747,3.0,23.53150611365517,6
2020-08-17-170222,170222,13,0,1,760,13.0,23.581488046451028,0
2020-08-18-170222,170222,5,0,12,765,2.0,32.83939175397934,1
2020-08-19-170222,170222,12,0,7,777,8.0,29.663469628534948,2
2020-08-20-170222,170222,5,0,3,782,11.0,26.79678769413589,3
2020-08-21-170222,170222,9,0,4,791,5.0,29.356335029625303,4
2020-08-22-170222,170222,2,0,1,793,1.0,33.342336078055595,5
2020-08-23-170222,170222,4,0,1,797,2.0,32.1416116922701,6
2020-08-24-170222,170222,16,0,10,813,10.0,22.38802029048035,0
2020-08-25-170222,170222,4,0,10,817,9.0,29.921881834461416,1
2020-08-26-170222,170222,10,0,10,827,8.0,33.41285169060268,2
2020-08-27-170222,170222,12,0,14,839,9.0,37.908034542841506,3
2020-08-28-170222,170222,5,0,9,844,9.0,34.74423950061715,4
2020-08-29-170222,170222,7,0,8,851,0.0,36.82345649750292,5
2020-08-30-170222,170222,8,0,12,859,12.0,35.17444285182017,6
2020-08-31-170222,170222,1,1,19,860,0.0,36.963254124456746,0
2020-09-01-170222,170222,12,0,29,872,7.0,10.109971118389437,1
2020-09-02-170222,170222,7,0,46,879,13.0,113.87517096814872,2
2020-09-03-170222,170222,3,0,44,882,7.0,177.657923553769,3
2020-09-04-170222,170222,4,1,36,886,10.0,146.41982462087523,4
2020-09-05-170222,170222,1,0,9,887,5.0,119.71120777714393,5
2020-09-06-170222,170222,1,0,17,888,2.0,117.33147932094089,6
2020-09-07-170222,170222,10,0,62,898,22.0,112.5965989312055,0
2020-09-08-170222,170222,10,0,46,908,4.0,94.06416767036659,1
2020-09-09-170222,170222,10,0,47,918,12.0,75.38917424814991,2
2020-09-10-170222,170222,14,0,36,932,13.0,15.505631658866397,3
2020-09-11-170222,170222,9,0,33,941,19.0,25.011073404268764,4
2020-09-12-170222,170222,8,0,9,949,18.0,33.90200118119855,5
2020-09-13-170222,170222,12,1,10,961,12.0,49.252772458376555,6
2020-09-14-170222,170222,19,0,35,980,21.0,60.68091679504022,0
2020-09-15-170222,170222,29,0,24,1009,34.0,69.40020095633372,1
2020-09-16-170222,170222,46,0,23,1055,29.0,93.3088268116457,2
2020-09-17-170222,170222,44,1,36,1099,32.0,108.9858476849739,3
2020-09-18-170222,170222,36,1,28,1135,35.0,111.33319908766734,4
2020-09-19-170222,170222,9,1,6,1144,12.0,132.1410855737231,5
2020-09-20-170222,170222,17,0,8,1161,11.0,122.11293169265765,6
2020-09-21-170222,170222,62,0,31,1223,59.0,115.08915324618091,0
2020-09-22-170222,170222,46,0,31,1269,38.0,137.6438478376808,1
2020-09-23-170222,170222,47,0,19,1316,38.0,143.2675810452211,2
2020-09-24-170222,170222,36,0,30,1352,43.0,160.6971510154868,3
2020-09-25-170222,170222,33,3,26,1385,82.0,159.17451091164187,4
2020-09-26-170222,170222,9,0,8,1394,8.0,191.0300604388799,5
2020-09-27-170222,170222,10,0,1,1404,9.0,189.09140642975947,6
2020-09-28-170222,170222,35,0,4,1439,44.0,188.14947396266098,0
2020-09-29-170222,170222,24,0,14,1463,25.0,181.28945443500055,1
2020-09-30-170222,170222,23,1,23,1486,27.0,154.82432019237984,2
2020-10-01-170222,170222,36,1,18,1522,56.0,0.0,3
2020-10-02-170222,170222,28,0,22,1550,34.0,74.21884848184943,4
2020-10-03-170222,170222,6,1,5,1556,10.0,66.41304358238435,5
2020-10-04-170222,170222,8,4,4,1564,15.0,62.14705110286359,6
2020-10-05-170222,170222,31,1,20,1595,19.0,63.22656228838686,0
2020-10-06-170222,170222,31,0,18,1626,20.0,68.01212832292141,1
2020-10-07-170222,170222,19,4,15,1645,20.0,74.29689132626042,2
2020-10-08-170222,170222,30,0,18,1675,23.0,86.90004938515573,3
2020-10-09-170222,170222,26,0,11,1701,11.0,95.65473015534293,4
2020-10-10-170222,170222,8,0,1,1709,3.0,51.21873749129067,5
2020-10-11-170222,170222,1,0,6,1710,2.0,54.81196263927139,6
2020-10-12-170222,170222,4,0,17,1714,8.0,57.21931905959802,0
2020-10-13-170222,170222,14,0,5,1728,28.0,62.12287475794209,1
2020-10-14-170222,170222,23,0,19,1751,11.0,87.52096694641321,2
2020-10-15-170222,170222,18,0,12,1769,9.0,97.38739818324355,3
2020-10-16-170222,170222,22,0,10,1791,14.0,107.87837511212514,4
2020-10-17-170222,170222,5,0,0,1796,3.0,71.15294036554522,5
2020-10-18-170222,170222,4,2,5,1800,1.0,70.86207646782248,6
2020-10-19-170222,170222,20,0,7,1820,15.0,69.53993353118888,0
2020-10-20-170222,170222,18,1,15,1838,7.0,77.46353923168235,1
2020-10-21-170222,170222,15,2,11,1853,13.0,73.70651579003601,2
2020-10-22-170222,170222,18,0,10,1871,11.0,75.46188088723805,3
2020-10-23-170222,170222,11,2,15,1882,20.0,71.84413853271673,4
2020-10-24-170222,170222,1,1,6,1883,3.0,80.96675396349015,5
2020-10-25-170222,170222,6,1,1,1889,16.0,83.41987097762077,6
2020-10-26-170222,170222,17,0,7,1906,13.0,80.9561029560097,0
2020-10-27-170222,170222,5,0,25,1911,12.0,70.09980547447756,1
2020-10-28-170222,170222,19,2,7,1930,12.0,75.75896851197271,2
2020-10-29-170222,170222,12,2,7,1942,10.0,75.92365737609308,3
2020-10-30-170222,170222,10,0,15,1952,10.0,69.00768959419327,4
2020-10-31-170222,170222,0,1,0,1952,3.0,77.1250286386014,5
2020-11-01-170222,170222,5,4,0,1957,2.0,98.92829364731382,6
2020-11-02-170222,170222,7,2,0,1964,8.0,23.367538288223425,0
2020-11-03-170222,170222,15,1,0,1979,16.0,26.282771712861766,1
2020-11-04-170222,170222,11,2,0,1990,8.0,41.09853687219163,2
2020-11-05-170222,170222,10,1,0,2000,5.0,49.465412707950044,3
2020-11-06-170222,170222,15,3,0,2015,9.0,46.44556439399702,4
2020-11-07-170222,170222,6,3,0,2021,5.0,51.20634215531778,5
2020-11-08-170222,170222,1,1,0,2022,1.0,51.16794322299685,6
2020-11-09-170222,170222,7,0,0,2029,15.0,44.36857135855812,0
2020-11-10-170222,170222,25,4,0,2054,15.0,95.95816278290472,1
2020-11-11-170222,170222,7,2,0,2061,7.0,96.49221261863897,2
2020-11-12-170222,170222,7,1,0,2068,10.0,86.35767917224338,3
2020-11-13-170222,170222,15,0,0,2083,7.0,73.68505268387015,4
2020-03-01-170223,170223,0,0,0,0,0.0,0.0,6
2020-03-02-170223,170223,0,0,0,0,0.0,11.268404851973983,0
2020-03-03-170223,170223,0,0,2,0,0.0,44.73824518201527,1
2020-03-04-170223,170223,0,0,0,0,0.0,50.40225831796526,2
2020-03-05-170223,170223,0,0,1,0,0.0,55.84285527582378,3
2020-03-06-170223,170223,0,0,0,0,0.0,47.98222658712709,4
2020-03-07-170223,170223,0,0,1,0,0.0,50.83132750676421,5
2020-03-08-170223,170223,0,0,1,0,0.0,48.30769525795658,6
2020-03-09-170223,170223,0,0,0,0,0.4,48.413914860958485,0
2020-03-10-170223,170223,0,0,2,0,0.4,222.21228423745012,1
2020-03-11-170223,170223,0,0,1,0,0.2,187.39834708719383,2
2020-03-12-170223,170223,0,0,2,0,0.2,147.80167456089512,3
2020-03-13-170223,170223,1,0,1,1,1.2,105.63500976267494,4
2020-03-14-170223,170223,0,0,0,1,1.4,87.56650937019937,5
2020-03-15-170223,170223,0,0,0,1,1.0,60.50847518917332,6
2020-03-16-170223,170223,0,0,0,1,1.8,22.818588115805696,0
2020-03-17-170223,170223,2,0,1,3,2.8,33.78940085743628,1
2020-03-18-170223,170223,0,0,0,3,2.0,46.85356069112134,2
2020-03-19-170223,170223,1,0,0,4,4.6,52.02519567608145,3
2020-03-20-170223,170223,0,0,0,4,3.8,59.46360479317749,4
2020-03-21-170223,170223,1,0,1,5,2.4,66.32749124047433,5
2020-03-22-170223,170223,1,0,1,6,2.4,67.89431814187965,6
2020-03-23-170223,170223,0,0,0,6,6.2,67.13647690256244,0
2020-03-24-170223,170223,2,0,1,8,4.2,75.8496283078845,1
2020-03-25-170223,170223,1,0,0,9,3.0,85.60783339975839,2
2020-03-26-170223,170223,2,0,1,11,2.2,94.26540605933658,3
2020-03-27-170223,170223,1,0,0,12,5.0,108.06407108870528,4
2020-03-28-170223,170223,0,0,0,12,1.0,112.3491404843281,5
2020-03-29-170223,170223,0,0,0,12,2.0,106.40257292554736,6
2020-03-30-170223,170223,0,0,1,12,5.2,79.43344455725392,0
2020-03-31-170223,170223,1,0,1,13,2.8,74.6851983199534,1
2020-04-01-170223,170223,0,0,0,13,3.0,11.469370889222073,2
2020-04-02-170223,170223,0,0,2,13,3.6,50.44619075650311,3
2020-04-03-170223,170223,0,0,1,13,3.0,15.197188877099235,4
2020-04-04-170223,170223,1,0,0,14,0.4,22.413596004853108,5
2020-04-05-170223,170223,1,0,0,15,1.6,25.321199694060358,6
2020-04-06-170223,170223,0,0,2,15,2.0,27.94290664037114,0
2020-04-07-170223,170223,1,0,1,16,1.8,33.0331418331935,1
2020-04-08-170223,170223,0,0,0,16,3.2,37.66173947970596,2
2020-04-09-170223,170223,1,0,0,17,7.2,43.98313394683725,3
2020-04-10-170223,170223,0,0,0,17,3.2,9.539154211767556,4
2020-04-11-170223,170223,0,0,0,17,1.6,17.86396170761954,5
2020-04-12-170223,170223,0,0,0,17,2.0,22.86496950151362,6
2020-04-13-170223,170223,1,0,0,18,2.8,29.320220484342986,0
2020-04-14-170223,170223,1,0,0,19,2.0,34.672313174682046,1
2020-04-15-170223,170223,0,0,0,19,5.0,36.876968664829974,2
2020-04-16-170223,170223,2,0,0,21,2.2,44.15716657247315,3
2020-04-17-170223,170223,1,0,0,22,2.0,45.03847118723637,4
2020-04-18-170223,170223,0,0,0,22,0.0,48.0419152913592,5
2020-04-19-170223,170223,0,0,1,22,1.8,43.77557067201252,6
2020-04-20-170223,170223,2,0,0,24,1.8,42.74977594925571,0
2020-04-21-170223,170223,1,1,0,25,1.8,49.907711753142976,1
2020-04-22-170223,170223,0,0,0,25,0.8,50.912965696476036,2
2020-04-23-170223,170223,0,0,0,25,0.6,47.658245187750424,3
2020-04-24-170223,170223,0,0,0,25,0.6,37.27194366198795,4
2020-04-25-170223,170223,0,0,0,25,0.0,39.40461878812166,5
2020-04-26-170223,170223,0,0,0,25,0.2,36.02225063398127,6
2020-04-27-170223,170223,0,0,0,25,1.2,25.918066311594814,0
2020-04-28-170223,170223,0,0,0,25,1.0,19.776539619195265,1
2020-04-29-170223,170223,0,0,1,25,1.4,15.813973560716676,2
2020-04-30-170223,170223,0,0,0,25,0.6,24.160656922098347,3
2020-05-01-170223,170223,0,0,0,25,0.0,53.88245669170967,4
2020-05-02-170223,170223,0,0,0,25,0.4,25.475628477251085,5
2020-05-03-170223,170223,1,0,0,26,0.4,15.262445535431464,6
2020-05-04-170223,170223,0,0,1,26,0.6,14.602730854844149,0
2020-05-05-170223,170223,0,0,0,26,1.4,15.918872632132226,1
2020-05-06-170223,170223,0,0,1,26,0.8,17.89916294622141,2
2020-05-07-170223,170223,0,0,0,26,0.8,18.82846410578214,3
2020-05-08-170223,170223,0,0,0,26,1.2,18.10681578788651,4
2020-05-09-170223,170223,0,0,0,26,0.2,19.519105305259977,5
2020-05-10-170223,170223,0,0,0,26,0.2,52.27419698777331,6
2020-05-11-170223,170223,0,0,0,26,0.8,48.1752226488619,0
2020-05-12-170223,170223,0,0,0,26,0.6,48.35010946505314,1
2020-05-13-170223,170223,1,0,0,27,1.2,41.728898075707164,2
2020-05-14-170223,170223,0,0,1,27,1.6,38.70918472947178,3
2020-05-15-170223,170223,0,0,2,27,0.8,34.625770560791494,4
2020-05-16-170223,170223,0,0,0,27,0.0,24.90251198761363,5
2020-05-17-170223,170223,0,0,0,27,0.4,24.466760190652707,6
2020-05-18-170223,170223,1,0,0,28,1.6,25.459998739925823,0
2020-05-19-170223,170223,0,0,1,28,1.2,25.435334682412453,1
2020-05-20-170223,170223,1,0,0,29,0.8,21.38073433527792,2
2020-05-21-170223,170223,0,0,0,29,0.8,22.546349865922878,3
2020-05-22-170223,170223,0,0,0,29,1.2,21.945595665788208,4
2020-05-23-170223,170223,0,0,0,29,0.0,25.36283461739668,5
2020-05-24-170223,170223,0,0,0,29,0.0,24.675980981385017,6
2020-05-25-170223,170223,0,0,0,29,0.6,18.136436003588386,0
2020-05-26-170223,170223,0,0,0,29,0.8,16.915723452682283,1
2020-05-27-170223,170223,0,0,1,29,0.6,18.022940210070658,2
2020-05-28-170223,170223,1,0,1,30,0.4,15.002070190933685,3
2020-05-29-170223,170223,2,0,0,32,0.6,16.329942152659243,4
2020-05-30-170223,170223,0,0,1,32,0.0,20.2004224710378,5
2020-05-31-170223,170223,0,0,0,32,0.0,21.74651540098495,6
2020-06-01-170223,170223,0,0,0,32,0.0,26.89990354489063,0
2020-06-02-170223,170223,1,0,2,33,1.2,12.11200510475754,1
2020-06-03-170223,170223,0,0,0,33,0.6,6.7435164212295025,2
2020-06-04-170223,170223,0,0,1,33,0.8,7.487675070806134,3
2020-06-05-170223,170223,0,0,0,33,0.6,9.59604542338235,4
2020-06-06-170223,170223,0,0,0,33,0.4,10.56763589977739,5
2020-06-07-170223,170223,0,0,0,33,0.0,11.715786417252371,6
2020-06-08-170223,170223,0,0,0,33,0.2,11.626147664931842,0
2020-06-09-170223,170223,0,0,0,33,0.4,13.357046021781347,1
2020-06-10-170223,170223,1,1,0,34,0.0,27.898773011610352,2
2020-06-11-170223,170223,1,0,0,35,0.4,25.420607351998925,3
2020-06-12-170223,170223,0,0,0,35,0.6,21.624449588886982,4
2020-06-13-170223,170223,1,0,0,36,0.0,17.31690623687694,5
2020-06-14-170223,170223,0,0,0,36,0.2,14.740518297377115,6
2020-06-15-170223,170223,0,0,0,36,0.2,10.465309084505638,0
2020-06-16-170223,170223,2,0,0,38,0.6,11.905980562046976,1
2020-06-17-170223,170223,0,0,0,38,0.2,14.109660150090882,2
2020-06-18-170223,170223,1,0,0,39,1.6,12.784045998843968,3
2020-06-19-170223,170223,0,0,0,39,0.0,13.72749066140349,4
2020-06-20-170223,170223,0,0,0,39,0.2,17.53195398245429,5
2020-06-21-170223,170223,0,0,0,39,0.2,18.7434676753641,6
2020-06-22-170223,170223,0,0,0,39,0.2,17.72507299724525,0
2020-06-23-170223,170223,0,0,0,39,0.2,14.595970993514841,1
2020-06-24-170223,170223,0,0,0,39,1.0,14.761422271233537,2
2020-06-25-170223,170223,0,0,1,39,0.2,14.171103268828379,3
2020-06-26-170223,170223,0,2,0,39,0.6,14.527000071279982,4
2020-06-27-170223,170223,0,1,0,39,0.2,10.089788091023113,5
2020-06-28-170223,170223,0,0,0,39,0.0,8.986893014373784,6
2020-06-29-170223,170223,0,0,0,39,0.0,7.999896754481151,0
2020-06-30-170223,170223,0,0,0,39,0.2,9.439285779339592,1
2020-07-01-170223,170223,0,0,0,39,0.2,12.470286660323229,2
2020-07-02-170223,170223,0,0,0,39,0.2,8.960783753923995,3
2020-07-03-170223,170223,0,0,0,39,0.0,11.20597261231424,4
2020-07-04-170223,170223,0,0,0,39,0.0,13.550053960021419,5
2020-07-05-170223,170223,0,0,0,39,0.0,14.992146049060693,6
2020-07-06-170223,170223,0,0,0,39,0.2,11.857955159661461,0
2020-07-07-170223,170223,0,0,0,39,0.6,11.379509062814748,1
2020-07-08-170223,170223,0,0,0,39,0.0,10.82462191271518,2
2020-07-09-170223,170223,1,0,1,40,0.2,10.945734739226996,3
2020-07-10-170223,170223,0,0,0,40,0.0,14.149094176339418,4
2020-07-11-170223,170223,0,0,0,40,0.0,11.601257118102275,5
2020-07-12-170223,170223,0,0,0,40,0.8,8.460045049775012,6
2020-07-13-170223,170223,0,0,0,40,0.2,9.606917817871835,0
2020-07-14-170223,170223,0,0,0,40,0.6,10.979959372477207,1
2020-07-15-170223,170223,0,0,0,40,0.2,11.038443312916556,2
2020-07-16-170223,170223,0,0,0,40,0.2,10.561908915767047,3
2020-07-17-170223,170223,0,0,0,40,0.2,11.4134456387104,4
2020-07-18-170223,170223,0,0,0,40,0.0,12.205831497262864,5
2020-07-19-170223,170223,0,0,1,40,0.2,13.021996930003029,6
2020-07-20-170223,170223,0,0,0,40,0.0,11.11820901864161,0
2020-07-21-170223,170223,0,0,0,40,0.2,9.853098759500668,1
2020-07-22-170223,170223,0,0,0,40,0.0,9.4802512048595,2
2020-07-23-170223,170223,1,0,0,41,0.0,9.04949221746847,3
2020-07-24-170223,170223,0,0,0,41,0.2,10.64093860955903,4
2020-07-25-170223,170223,0,0,0,41,0.0,11.837852674342983,5
2020-07-26-170223,170223,0,0,0,41,0.0,10.781734226173743,6
2020-07-27-170223,170223,0,0,0,41,0.6,9.821328142648527,0
2020-07-28-170223,170223,0,0,0,41,0.4,12.305076286894726,1
2020-07-29-170223,170223,0,0,0,41,1.0,12.300395850408407,2
2020-07-30-170223,170223,0,0,1,41,0.6,12.52955399468516,3
2020-07-31-170223,170223,0,0,0,41,1.2,14.64514139752422,4
2020-08-01-170223,170223,0,0,0,41,0.6,11.899194918362724,5
2020-08-02-170223,170223,1,0,0,42,0.6,84.70121825291237,6
2020-08-03-170223,170223,0,0,0,42,0.6,82.25449420468439,0
2020-08-04-170223,170223,0,0,1,42,3.2,56.933548248440886,1
2020-08-05-170223,170223,0,0,0,42,2.2,63.87025576175406,2
2020-08-06-170223,170223,0,0,2,42,1.0,63.66040757927411,3
2020-08-07-170223,170223,0,0,1,42,0.6,55.19240572895454,4
2020-08-08-170223,170223,0,0,0,42,1.8,54.061129530864235,5
2020-08-09-170223,170223,0,0,1,42,0.0,57.894464302121165,6
2020-08-10-170223,170223,0,0,0,42,0.8,9.620870107404423,0
2020-08-11-170223,170223,0,0,0,42,1.6,16.101177225913155,1
2020-08-12-170223,170223,0,0,0,42,3.0,25.72397105361953,2
2020-08-13-170223,170223,1,0,2,43,2.6,39.174092950451296,3
2020-08-14-170223,170223,0,0,0,43,2.2,51.14680319135723,4
2020-08-15-170223,170223,0,0,0,43,2.0,62.62573216363931,5
2020-08-16-170223,170223,0,0,0,43,2.6,69.41743603542454,6
2020-08-17-170223,170223,0,0,0,43,2.2,79.53826129508168,0
2020-08-18-170223,170223,1,0,0,44,3.6,85.04094909120272,1
2020-08-19-170223,170223,0,0,2,44,1.4,90.138757531418,2
2020-08-20-170223,170223,2,0,4,46,1.2,77.86024887969211,3
2020-08-21-170223,170223,1,0,0,47,3.8,76.96472245778986,4
2020-08-22-170223,170223,0,0,0,47,1.4,85.73833490930267,5
2020-08-23-170223,170223,1,0,0,48,2.2,82.7742393318488,6
2020-08-24-170223,170223,0,0,1,48,4.8,79.81294597141613,0
2020-08-25-170223,170223,0,0,0,48,2.4,82.81442859778198,1
2020-08-26-170223,170223,0,0,1,48,1.6,87.36831690329689,2
2020-08-27-170223,170223,2,0,0,50,2.0,82.81527515290468,3
2020-08-28-170223,170223,0,0,4,50,1.8,85.51474351172234,4
2020-08-29-170223,170223,0,0,0,50,1.0,79.31526976485264,5
2020-08-30-170223,170223,0,0,0,50,1.4,69.32109550781722,6
2020-08-31-170223,170223,0,0,0,50,1.0,56.50350572418876,0
2020-09-01-170223,170223,0,0,1,50,2.4,49.57450435676377,1
2020-09-02-170223,170223,2,0,2,52,2.0,85.91417410642927,2
2020-09-03-170223,170223,4,0,1,56,1.4,60.27738932086236,3
2020-09-04-170223,170223,0,0,1,56,2.2,58.58434198193526,4
2020-09-05-170223,170223,0,0,0,56,0.8,56.49839055012131,5
2020-09-06-170223,170223,0,0,1,56,0.6,56.34609994000359,6
2020-09-07-170223,170223,1,0,0,57,2.0,57.75814614827455,0
2020-09-08-170223,170223,0,0,0,57,6.0,56.08444741425704,1
2020-09-09-170223,170223,1,0,0,58,2.4,63.065953152302924,2
2020-09-10-170223,170223,0,0,0,58,6.2,52.36985162857678,3
2020-09-11-170223,170223,4,0,0,62,3.0,60.19723861752136,4
2020-09-12-170223,170223,0,0,0,62,3.4,67.73761470661967,5
2020-09-13-170223,170223,0,0,0,62,1.4,74.12295716325761,6
2020-09-14-170223,170223,0,0,2,62,2.4,76.49345316965973,0
2020-09-15-170223,170223,1,0,0,63,6.8,79.37204715328568,1
2020-09-16-170223,170223,2,0,0,65,3.4,101.59365076811673,2
2020-09-17-170223,170223,1,0,0,66,2.6,101.3948366427706,3
2020-09-18-170223,170223,1,0,0,67,1.6,92.59151066972974,4
2020-09-19-170223,170223,0,0,0,67,0.8,86.06265058941231,5
2020-09-20-170223,170223,1,0,0,68,2.0,70.85977323411329,6
2020-09-21-170223,170223,0,0,1,68,3.4,66.07578234931219,0
2020-09-22-170223,170223,0,0,4,68,2.2,55.86016882441663,1
2020-09-23-170223,170223,0,0,0,68,4.4,49.91508155467812,2
2020-09-24-170223,170223,0,0,0,68,2.6,52.06587705443893,3
2020-09-25-170223,170223,0,0,0,68,2.0,48.487213675036564,4
2020-09-26-170223,170223,0,0,0,68,0.4,53.60032235204907,5
2020-09-27-170223,170223,0,0,0,68,0.6,54.44718843819821,6
2020-09-28-170223,170223,2,0,1,70,1.2,51.68705799347657,0
2020-09-29-170223,170223,0,0,1,70,1.2,52.3394926053236,1
2020-09-30-170223,170223,0,1,2,70,2.4,49.96781163352919,2
2020-10-01-170223,170223,0,0,3,70,3.0,0.0,3
2020-10-02-170223,170223,0,0,1,70,2.4,128.529231329995,4
2020-10-03-170223,170223,0,0,0,70,1.6,180.61348267982385,5
2020-10-04-170223,170223,0,0,0,70,2.2,192.87082020750898,6
2020-10-05-170223,170223,1,0,1,71,2.6,163.62514677563988,0
2020-10-06-170223,170223,4,0,1,75,3.8,143.58826761880192,1
2020-10-07-170223,170223,0,0,0,75,3.6,127.4309126455647,2
2020-10-08-170223,170223,0,0,1,75,2.2,110.7555363697499,3
2020-10-09-170223,170223,0,0,1,75,3.6,116.18794353800703,4
2020-10-10-170223,170223,0,0,0,75,1.2,6.931833283194219,5
2020-10-11-170223,170223,0,0,1,75,1.6,13.023867336344306,6
2020-10-12-170223,170223,1,0,0,76,1.4,21.83004575793794,0
2020-10-13-170223,170223,1,0,3,77,2.2,32.3729196558356,1
2020-10-14-170223,170223,2,0,0,79,3.8,52.05754981631323,2
2020-10-15-170223,170223,3,0,4,82,2.6,75.89963879247648,3
2020-10-16-170223,170223,1,0,6,83,3.8,97.15635442218479,4
2020-10-17-170223,170223,0,0,2,83,2.0,100.05120802316662,5
2020-10-18-170223,170223,0,0,1,83,0.8,100.41516870044322,6
2020-10-19-170223,170223,1,0,1,84,5.8,97.44711912538031,0
2020-10-20-170223,170223,1,0,1,85,4.0,105.56199952999353,1
2020-10-21-170223,170223,0,0,1,85,4.0,108.24105812339775,2
2020-10-22-170223,170223,1,0,3,86,5.2,109.75602412495299,3
2020-10-23-170223,170223,1,0,0,87,5.0,113.39050729407968,4
2020-10-24-170223,170223,0,0,2,87,2.8,131.23731345044655,5
2020-10-25-170223,170223,1,0,1,88,1.8,127.68358383988448,6
2020-10-26-170223,170223,0,0,1,88,6.2,112.02704309561953,0
2020-10-27-170223,170223,3,0,3,91,5.0,129.97654764238098,1
2020-10-28-170223,170223,0,0,0,91,6.0,133.84157143946692,2
2020-10-29-170223,170223,4,0,1,95,3.6,142.76756030673158,3
2020-10-30-170223,170223,6,0,25,101,7.4,133.49583747937407,4
2020-10-31-170223,170223,2,0,0,103,3.6,157.31028273771784,5
2020-11-01-170223,170223,1,0,0,104,4.8,80.01980583394614,6
2020-11-02-170223,170223,1,0,0,105,2.0,218.3208388641736,0
2020-11-03-170223,170223,1,1,0,106,6.0,166.65106783758927,1
2020-11-04-170223,170223,1,0,0,107,5.6,183.94945056456055,2
2020-11-05-170223,170223,3,0,0,110,3.6,189.8764128497628,3
2020-11-06-170223,170223,0,1,0,110,6.8,193.90460616665678,4
2020-11-07-170223,170223,2,0,0,112,1.6,185.8076406112369,5
2020-11-08-170223,170223,1,0,0,113,4.8,166.6556793984026,6
2020-11-09-170223,170223,1,0,0,114,5.8,164.97286247094877,0
2020-11-10-170223,170223,3,1,0,117,4.4,80.75646579191803,1
2020-11-11-170223,170223,0,0,0,117,2.0,100.04264049713363,2
2020-11-12-170223,170223,1,0,0,118,7.0,106.01817396942373,3
2020-11-13-170223,170223,25,0,0,143,5.8,116.20247600598687,4
2020-03-01-170224,170224,0,0,0,0,0.0,0.0,6
2020-03-02-170224,170224,0,0,0,0,0.0,6.230523484335051,0
2020-03-03-170224,170224,0,0,0,0,0.0,24.997630452403847,1
2020-03-04-170224,170224,0,0,2,0,0.0,28.448815364867492,2
2020-03-05-170224,170224,0,1,0,0,0.25,30.717149936921793,3
2020-03-06-170224,170224,0,0,3,0,0.0,29.222337061596587,4
2020-03-07-170224,170224,0,0,2,0,0.25,31.24430366122075,5
2020-03-08-170224,170224,0,0,0,0,0.0,34.37670089607869,6
2020-03-09-170224,170224,0,0,4,0,0.75,34.646397992175935,0
2020-03-10-170224,170224,0,0,1,0,0.25,252.4933277820521,1
2020-03-11-170224,170224,0,0,3,0,1.0,226.39958428146505,2
2020-03-12-170224,170224,0,0,3,0,1.0,196.15411010334847,3
2020-03-13-170224,170224,0,0,1,0,0.5,136.69297793938352,4
2020-03-14-170224,170224,0,0,1,0,0.0,123.66457979312474,5
2020-03-15-170224,170224,0,0,0,0,0.75,50.96203557365919,6
2020-03-16-170224,170224,0,0,4,0,6.0,12.20483387164311,0
2020-03-17-170224,170224,0,0,1,0,3.5,17.694864005193367,1
2020-03-18-170224,170224,2,0,2,2,8.25,21.833773895728207,2
2020-03-19-170224,170224,0,1,1,2,3.25,35.66875821304938,3
2020-03-20-170224,170224,3,0,3,5,3.5,34.269902326160086,4
2020-03-21-170224,170224,2,0,1,7,1.75,39.89395994837821,5
2020-03-22-170224,170224,0,0,2,7,2.25,42.307101153964865,6
2020-03-23-170224,170224,4,0,1,11,6.0,41.24010464816208,0
2020-03-24-170224,170224,1,0,2,12,5.75,47.894740673538124,1
2020-03-25-170224,170224,3,0,0,15,5.5,46.03731570293657,2
2020-03-26-170224,170224,3,0,1,18,7.0,48.88909356865845,3
2020-03-27-170224,170224,1,0,5,19,5.0,55.28058797399237,4
2020-03-28-170224,170224,1,2,1,20,1.75,53.751550412029076,5
2020-03-29-170224,170224,0,0,1,20,1.25,49.7277436817634,6
2020-03-30-170224,170224,4,0,1,24,4.5,35.534529651458456,0
2020-03-31-170224,170224,1,0,0,25,5.75,37.79456970469667,1
2020-04-01-170224,170224,2,0,2,27,8.75,6.1817983379851915,2
2020-04-02-170224,170224,1,0,2,28,2.75,23.86626958754713,3
2020-04-03-170224,170224,3,0,1,31,0.75,10.284116458430388,4
2020-04-04-170224,170224,1,0,0,32,1.0,14.957866899411506,5
2020-04-05-170224,170224,2,0,0,34,0.75,14.685180714233327,6
2020-04-06-170224,170224,1,0,1,35,3.25,17.392570002090295,0
2020-04-07-170224,170224,2,0,0,37,4.5,19.44680543766065,1
2020-04-08-170224,170224,0,1,0,37,4.75,22.73763690403778,2
2020-04-09-170224,170224,1,0,0,38,6.25,25.231146231046583,3
2020-04-10-170224,170224,5,0,0,43,2.25,6.793186694072453,4
2020-04-11-170224,170224,1,0,1,44,1.25,17.14696267121388,5
2020-04-12-170224,170224,1,0,0,45,0.75,19.084169450048705,6
2020-04-13-170224,170224,1,0,0,46,4.75,22.099543073065913,0
2020-04-14-170224,170224,0,0,0,46,5.0,25.258972811515488,1
2020-04-15-170224,170224,2,0,0,48,2.25,30.286568531015178,2
2020-04-16-170224,170224,2,0,0,50,7.25,34.92687976896313,3
2020-04-17-170224,170224,1,0,0,51,1.0,37.65645600603062,4
2020-04-18-170224,170224,0,0,0,51,6.0,30.035813546407233,5
2020-04-19-170224,170224,0,0,0,51,1.0,29.68820437672088,6
2020-04-20-170224,170224,1,0,1,52,14.75,29.186177224588043,0
2020-04-21-170224,170224,0,0,1,52,1.25,31.505185854989456,1
2020-04-22-170224,170224,0,0,1,52,2.0,30.28218993923459,2
2020-04-23-170224,170224,0,0,1,52,0.5,22.478776692828696,3
2020-04-24-170224,170224,0,0,0,52,2.5,19.400943258458632,4
2020-04-25-170224,170224,1,0,0,53,1.5,20.56156546989585,5
2020-04-26-170224,170224,0,0,0,53,0.0,21.87304216790216,6
2020-04-27-170224,170224,0,0,0,53,2.0,16.001230472626016,0
2020-04-28-170224,170224,0,0,0,53,1.5,14.316356575807388,1
2020-04-29-170224,170224,0,0,0,53,1.25,13.58640363853575,2
2020-04-30-170224,170224,0,0,0,53,1.5,19.29656637880423,3
2020-05-01-170224,170224,0,0,0,53,0.75,32.440205486129614,4
2020-05-02-170224,170224,0,0,0,53,1.0,8.741924291059398,5
2020-05-03-170224,170224,0,0,0,53,0.25,8.69250408764992,6
2020-05-04-170224,170224,1,0,0,54,2.75,9.608727048347356,0
2020-05-05-170224,170224,1,0,0,55,3.25,8.788471157928774,1
2020-05-06-170224,170224,1,0,1,56,3.0,8.110505578872976,2
2020-05-07-170224,170224,1,0,0,57,1.75,12.458494906618832,3
2020-05-08-170224,170224,0,0,0,57,1.75,15.313238111951549,4
2020-05-09-170224,170224,0,0,0,57,0.25,15.715884615921766,5
2020-05-10-170224,170224,0,0,0,57,0.0,31.827020545902393,6
2020-05-11-170224,170224,0,0,0,57,1.75,27.26640819272497,0
2020-05-12-170224,170224,0,1,0,57,2.5,23.429540530711414,1
2020-05-13-170224,170224,0,0,0,57,3.75,22.352482469723775,2
2020-05-14-170224,170224,0,0,0,57,0.75,15.775226838385633,3
2020-05-15-170224,170224,0,0,0,57,2.5,12.887992612087547,4
2020-05-16-170224,170224,0,0,0,57,0.25,13.233421448853228,5
2020-05-17-170224,170224,0,0,0,57,0.0,11.115018754110643,6
2020-05-18-170224,170224,0,0,0,57,1.5,11.416116626113137,0
2020-05-19-170224,170224,0,1,0,57,2.0,12.323561217662347,1
2020-05-20-170224,170224,1,0,0,58,1.0,9.291303712860525,2
2020-05-21-170224,170224,0,0,0,58,0.25,7.910252211179743,3
2020-05-22-170224,170224,0,0,0,58,0.5,4.657475081553171,4
2020-05-23-170224,170224,0,0,0,58,0.0,6.562535452890126,5
2020-05-24-170224,170224,0,1,0,58,1.0,6.649781879803934,6
2020-05-25-170224,170224,0,0,0,58,1.75,5.0014105267089,0
2020-05-26-170224,170224,0,0,0,58,2.25,5.065937004979491,1
2020-05-27-170224,170224,0,0,0,58,1.25,9.285951020145873,2
2020-05-28-170224,170224,0,0,0,58,1.25,12.28742039254806,3
2020-05-29-170224,170224,0,1,0,58,1.0,12.595224225815233,4
2020-05-30-170224,170224,0,0,0,58,0.75,13.287389263778689,5
2020-05-31-170224,170224,0,0,0,58,0.0,14.150176709302272,6
2020-06-01-170224,170224,0,0,0,58,0.75,21.71220674250884,0
2020-06-02-170224,170224,0,0,0,58,1.25,8.439968069722305,1
2020-06-03-170224,170224,0,0,0,58,0.75,5.37748993934844,2
2020-06-04-170224,170224,0,0,0,58,1.25,5.728488672023907,3
2020-06-05-170224,170224,0,1,1,58,1.0,3.3680504415452646,4
2020-06-06-170224,170224,0,1,0,58,0.5,3.6126303616312616,5
2020-06-07-170224,170224,0,0,0,58,0.25,3.770187380725303,6
2020-06-08-170224,170224,0,0,0,58,0.75,3.8423139380083766,0
2020-06-09-170224,170224,0,0,0,58,1.25,4.089698768954818,1
2020-06-10-170224,170224,0,0,0,58,1.25,23.75366971513778,2
2020-06-11-170224,170224,0,0,1,58,0.0,18.200095029662066,3
2020-06-12-170224,170224,0,0,0,58,0.75,14.422103532256749,4
2020-06-13-170224,170224,0,0,0,58,0.25,8.870569474668013,5
2020-06-14-170224,170224,0,0,0,58,0.25,4.709671470044153,6
2020-06-15-170224,170224,0,0,0,58,0.0,3.706838776125616,0
2020-06-16-170224,170224,0,1,0,58,1.5,3.7427549727800153,1
2020-06-17-170224,170224,0,0,1,58,1.5,6.196311663381515,2
2020-06-18-170224,170224,0,0,1,58,0.75,6.154235294123405,3
2020-06-19-170224,170224,1,0,0,59,1.0,7.323325787040596,4
2020-06-20-170224,170224,0,0,0,59,0.25,11.866942161065076,5
2020-06-21-170224,170224,0,0,0,59,0.0,12.792219848021947,6
2020-06-22-170224,170224,0,0,0,59,0.75,12.690420535441543,0
2020-06-23-170224,170224,0,0,0,59,0.0,10.05020388834421,1
2020-06-24-170224,170224,0,1,0,59,0.0,10.076000773200525,2
2020-06-25-170224,170224,1,0,1,60,0.5,9.362963810909218,3
2020-06-26-170224,170224,0,0,0,60,0.5,10.241719365497413,4
2020-06-27-170224,170224,0,0,0,60,0.25,7.49210696953636,5
2020-06-28-170224,170224,0,0,0,60,0.5,7.5314289066528985,6
2020-06-29-170224,170224,0,0,1,60,0.0,8.039271597202942,0
2020-06-30-170224,170224,0,0,0,60,0.0,7.862845602521146,1
2020-07-01-170224,170224,1,0,0,61,0.25,8.888980810601769,2
2020-07-02-170224,170224,1,0,0,62,0.0,13.950307134508504,3
2020-07-03-170224,170224,0,0,1,62,0.0,23.898653883980877,4
2020-07-04-170224,170224,0,0,0,62,0.0,20.531576465373167,5
2020-07-05-170224,170224,0,0,0,62,0.0,12.676402077932376,6
2020-07-06-170224,170224,0,0,0,62,0.75,8.794464586370228,0
2020-07-07-170224,170224,0,0,1,62,0.75,13.500088803514574,1
2020-07-08-170224,170224,0,0,0,62,0.5,11.778268218330856,2
2020-07-09-170224,170224,1,0,0,63,0.0,13.268034844589163,3
2020-07-10-170224,170224,0,0,1,63,0.25,9.035697436145664,4
2020-07-11-170224,170224,0,0,0,63,0.0,6.177893269305019,5
2020-07-12-170224,170224,0,0,2,63,0.5,5.002119747238243,6
2020-07-13-170224,170224,1,0,1,64,1.25,4.890478956382022,0
2020-07-14-170224,170224,0,0,1,64,0.25,9.018876019091312,1
2020-07-15-170224,170224,0,0,1,64,1.0,9.284874914086554,2
2020-07-16-170224,170224,0,0,0,64,1.5,6.575048679825236,3
2020-07-17-170224,170224,1,0,0,65,0.0,9.847469858230873,4
2020-07-18-170224,170224,0,0,0,65,0.0,14.13185949394509,5
2020-07-19-170224,170224,0,0,0,65,0.0,15.248530253923768,6
2020-07-20-170224,170224,0,0,0,65,0.25,15.047471608306989,0
2020-07-21-170224,170224,1,0,4,66,0.25,15.595106367665542,1
2020-07-22-170224,170224,0,0,2,66,0.25,19.60225671312852,2
2020-07-23-170224,170224,0,0,1,66,0.5,17.631801895326795,3
2020-07-24-170224,170224,1,0,0,67,0.75,14.760080637793921,4
2020-07-25-170224,170224,0,0,0,67,0.0,21.245835215239282,5
2020-07-26-170224,170224,2,0,0,69,0.5,20.826204406578356,6
2020-07-27-170224,170224,1,0,2,70,0.0,24.470379406045133,0
2020-07-28-170224,170224,1,0,1,71,0.0,29.468749375615324,1
2020-07-29-170224,170224,1,0,0,72,0.5,24.98315188334795,2
2020-07-30-170224,170224,0,0,1,72,0.75,26.68789789396883,3
2020-07-31-170224,170224,0,0,1,72,0.5,25.10196798466124,4
2020-08-01-170224,170224,0,0,1,72,1.25,19.545600003855427,5
2020-08-02-170224,170224,0,0,0,72,0.0,128.73321631970288,6
2020-08-03-170224,170224,0,0,2,72,0.0,62.17538552512086,0
2020-08-04-170224,170224,4,0,2,76,1.5,34.71143747627755,1
2020-08-05-170224,170224,2,0,4,78,3.5,49.53709517030519,2
2020-08-06-170224,170224,1,0,0,79,3.0,52.44369727602201,3
2020-08-07-170224,170224,0,0,3,79,0.5,53.84202484306437,4
2020-08-08-170224,170224,0,0,4,79,1.25,49.70663900859956,5
2020-08-09-170224,170224,0,0,1,79,1.5,49.7742884160958,6
2020-08-10-170224,170224,2,1,6,81,1.5,16.96563389756571,0
2020-08-11-170224,170224,1,0,1,82,1.75,34.600690481039,1
2020-08-12-170224,170224,0,0,2,82,2.25,48.62348949737545,2
2020-08-13-170224,170224,1,0,2,83,1.5,53.96188358123536,3
2020-08-14-170224,170224,1,0,0,84,3.75,79.94898986845241,4
2020-08-15-170224,170224,1,0,0,85,0.25,105.47195711852893,5
2020-08-16-170224,170224,0,0,1,85,1.75,107.4253783108254,6
2020-08-17-170224,170224,2,0,0,87,0.5,115.19767751077285,0
2020-08-18-170224,170224,2,0,2,89,2.25,107.51323966994076,1
2020-08-19-170224,170224,4,0,1,93,1.75,109.87283210725126,2
2020-08-20-170224,170224,0,0,1,93,2.5,92.3283500646225,3
2020-08-21-170224,170224,3,0,0,96,1.0,75.8799011240732,4
2020-08-22-170224,170224,4,0,2,100,2.5,81.43984290642513,5
2020-08-23-170224,170224,1,0,0,101,0.25,97.81869937704576,6
2020-08-24-170224,170224,6,0,1,107,1.25,86.9588610128141,0
2020-08-25-170224,170224,1,0,0,108,2.25,87.31996153196204,1
2020-08-26-170224,170224,2,0,0,110,1.75,83.04028881119231,2
2020-08-27-170224,170224,2,0,0,112,1.25,82.10232278362943,3
2020-08-28-170224,170224,0,0,0,112,1.0,79.98506719697892,4
2020-08-29-170224,170224,0,0,1,112,0.5,70.13979304599488,5
2020-08-30-170224,170224,1,0,1,113,0.25,49.659204162066565,6
2020-08-31-170224,170224,0,0,3,113,0.5,40.25671453880599,0
2020-09-01-170224,170224,2,0,0,115,1.75,46.53707955966029,1
2020-09-02-170224,170224,1,0,5,116,1.5,76.44763752843285,2
2020-09-03-170224,170224,1,0,1,117,2.25,46.14399465302657,3
2020-09-04-170224,170224,0,0,0,117,1.5,56.41172845605808,4
2020-09-05-170224,170224,2,0,0,119,0.5,58.22598953354136,5
2020-09-06-170224,170224,0,1,0,119,0.25,48.93028937072762,6
2020-09-07-170224,170224,1,0,0,120,2.0,51.14928619823222,0
2020-09-08-170224,170224,0,0,2,120,1.75,59.26835931210865,1
2020-09-09-170224,170224,0,0,1,120,0.75,63.35265333096495,2
2020-09-10-170224,170224,0,0,3,120,1.25,54.824281292426676,3
2020-09-11-170224,170224,0,0,1,120,1.0,46.46617164883234,4
2020-09-12-170224,170224,1,0,1,121,1.25,46.62645047044628,5
2020-09-13-170224,170224,1,0,0,122,1.0,50.38918060332183,6
2020-09-14-170224,170224,3,0,2,125,1.5,60.84545536277373,0
2020-09-15-170224,170224,0,0,0,125,0.75,63.8926987131784,1
2020-09-16-170224,170224,5,0,0,130,1.25,65.77650434833937,2
2020-09-17-170224,170224,1,0,0,131,1.0,77.80495974165842,3
2020-09-18-170224,170224,0,0,1,131,1.75,83.62393931871085,4
2020-09-19-170224,170224,0,0,0,131,0.25,81.51667653806787,5
2020-09-20-170224,170224,0,0,0,131,1.25,69.3476799843705,6
2020-09-21-170224,170224,0,0,0,131,0.5,64.54230449272062,0
2020-09-22-170224,170224,2,1,0,133,0.5,62.48945165259273,1
2020-09-23-170224,170224,1,0,1,134,1.25,41.04695339822311,2
2020-09-24-170224,170224,3,0,2,137,2.0,33.50666486727443,3
2020-09-25-170224,170224,1,0,1,138,0.5,38.279562622094986,4
2020-09-26-170224,170224,1,0,1,139,2.5,42.17371005799198,5
2020-09-27-170224,170224,0,0,0,139,0.0,41.283221399175275,6
2020-09-28-170224,170224,2,0,2,141,1.75,40.482871890785475,0
2020-09-29-170224,170224,0,0,2,141,1.0,43.120763767942414,1
2020-09-30-170224,170224,0,0,4,141,1.0,54.18303386276262,2
2020-10-01-170224,170224,0,0,4,141,0.25,0.0,3
2020-10-02-170224,170224,1,0,4,142,0.0,124.46177339991861,4
2020-10-03-170224,170224,0,0,0,142,0.0,238.9958517757154,5
2020-10-04-170224,170224,0,1,4,142,0.25,259.4410770152095,6
2020-10-05-170224,170224,0,0,1,142,0.5,214.21749978316635,0
2020-10-06-170224,170224,0,0,8,142,0.5,209.14658832356974,1
2020-10-07-170224,170224,1,0,6,143,1.75,146.0116952838306,2
2020-10-08-170224,170224,2,0,3,145,0.75,96.11583165941283,3
2020-10-09-170224,170224,1,0,1,146,1.0,106.3911956155791,4
2020-10-10-170224,170224,1,0,0,147,1.25,1.5869083059877385,5
2020-10-11-170224,170224,0,0,4,147,1.0,10.370747831881172,6
2020-10-12-170224,170224,2,0,9,149,0.75,14.180798654654602,0
2020-10-13-170224,170224,2,0,0,151,2.0,23.62280137852563,1
2020-10-14-170224,170224,4,0,3,155,2.0,43.52988160873372,2
2020-10-15-170224,170224,4,0,10,159,1.5,67.10029301166324,3
2020-10-16-170224,170224,4,0,8,163,5.75,98.19594018309084,4
2020-10-17-170224,170224,0,0,5,163,9.75,127.32340217800687,5
2020-10-18-170224,170224,4,0,0,167,0.25,128.185782862696,6
2020-10-19-170224,170224,1,0,1,168,0.25,140.35432229636766,0
2020-10-20-170224,170224,8,0,2,176,1.25,129.19498756465788,1
2020-10-21-170224,170224,6,0,5,182,3.75,152.22485149702686,2
2020-10-22-170224,170224,3,0,6,185,3.0,157.63406775657563,3
2020-10-23-170224,170224,1,0,5,186,3.0,153.90071237245985,4
2020-10-24-170224,170224,0,0,2,186,2.0,157.0720700392825,5
2020-10-25-170224,170224,4,0,12,190,2.75,142.9391217549162,6
2020-10-26-170224,170224,9,0,10,199,4.5,149.6554916542477,0
2020-10-27-170224,170224,0,0,10,199,1.75,200.1358613537496,1
2020-10-28-170224,170224,3,0,6,202,10.0,177.99183482575228,2
2020-10-29-170224,170224,10,0,11,212,5.0,204.61693802074723,3
2020-10-30-170224,170224,8,0,16,220,6.0,224.8624267568926,4
2020-10-31-170224,170224,5,0,0,225,5.5,252.21302146793522,5
2020-11-01-170224,170224,0,0,0,225,2.75,76.33299516111973,6
2020-11-02-170224,170224,1,0,0,226,2.0,363.80546412578894,0
2020-11-03-170224,170224,2,0,0,228,2.5,295.93766921910117,1
2020-11-04-170224,170224,5,0,0,233,3.0,257.1663306128572,2
2020-11-05-170224,170224,6,0,0,239,3.0,170.0809153994293,3
2020-11-06-170224,170224,5,0,0,244,6.0,166.7568315483972,4
2020-11-07-170224,170224,2,0,0,246,2.25,185.84751701353707,5
2020-11-08-170224,170224,12,0,0,258,10.5,167.4322996702674,6
2020-11-09-170224,170224,10,0,0,268,1.75,208.89924224961112,0
2020-11-10-170224,170224,10,0,0,278,5.25,43.050459441780305,1
2020-11-11-170224,170224,6,1,0,284,2.75,97.56602127158276,2
2020-11-12-170224,170224,11,0,0,295,4.25,124.8531629543421,3
2020-11-13-170224,170224,16,0,0,311,2.25,166.26798775873,4
2020-03-01-170225,170225,0,0,2,0,0.0,0.0,6
2020-03-02-170225,170225,0,0,5,0,0.0,31.244975852266652,0
2020-03-03-170225,170225,0,0,0,0,0.0,143.5313971840549,1
2020-03-04-170225,170225,0,0,1,0,0.0,147.52182230051852,2
2020-03-05-170225,170225,0,0,3,0,0.0,157.93733590775702,3
2020-03-06-170225,170225,0,0,3,0,0.0,144.29091684135085,4
2020-03-07-170225,170225,0,0,1,0,0.0,147.5628228883256,5
2020-03-08-170225,170225,0,0,3,0,0.0,146.95406702020708,6
2020-03-09-170225,170225,1,0,1,1,0.125,146.62448445896112,0
2020-03-10-170225,170225,0,0,2,1,0.25,551.5970650939691,1
2020-03-11-170225,170225,0,0,2,1,0.125,468.17136423753186,2
2020-03-12-170225,170225,0,0,3,1,0.125,327.1651423051416,3
2020-03-13-170225,170225,0,0,2,1,0.375,205.51793623678037,4
2020-03-14-170225,170225,0,0,2,1,1.0,147.20431427431967,5
2020-03-15-170225,170225,2,0,1,3,0.0,106.92209139669734,6
2020-03-16-170225,170225,5,0,2,8,1.75,48.18104671510858,0
2020-03-17-170225,170225,0,0,1,8,2.0,82.82588355348108,1
2020-03-18-170225,170225,1,0,1,9,2.125,113.24906546518503,2
2020-03-19-170225,170225,3,0,1,12,3.375,155.26712580803837,3
2020-03-20-170225,170225,3,1,0,15,2.25,195.1735969534571,4
2020-03-21-170225,170225,1,1,0,16,1.625,209.58401271023422,5
2020-03-22-170225,170225,3,0,0,19,2.25,219.3751222778118,6
2020-03-23-170225,170225,1,0,0,20,7.25,212.6319393709285,0
2020-03-24-170225,170225,2,0,2,22,5.0,269.29680655453274,1
2020-03-25-170225,170225,2,0,0,24,4.125,291.8399268927757,2
2020-03-26-170225,170225,3,0,1,27,4.0,299.24262454479435,3
2020-03-27-170225,170225,2,0,0,29,4.125,350.75807739025663,4
2020-03-28-170225,170225,2,0,0,31,2.25,360.39367857827955,5
2020-03-29-170225,170225,1,0,1,32,1.25,356.60701982684463,6
2020-03-30-170225,170225,2,0,0,34,3.375,261.7689194024045,0
2020-03-31-170225,170225,1,0,0,35,2.875,246.55564437864504,1
2020-04-01-170225,170225,1,0,0,36,4.0,44.15464377216451,2
2020-04-02-170225,170225,1,0,0,37,2.25,153.49629945275979,3
2020-04-03-170225,170225,0,0,0,37,2.0,48.69647551857581,4
2020-04-04-170225,170225,0,0,1,37,1.125,65.94042209731833,5
2020-04-05-170225,170225,0,0,0,37,1.875,72.34416675692766,6
2020-04-06-170225,170225,0,0,1,37,2.125,71.4959309209431,0
2020-04-07-170225,170225,2,3,0,39,2.375,83.09196560528298,1
2020-04-08-170225,170225,0,0,1,39,1.75,100.0089956674644,2
2020-04-09-170225,170225,1,2,0,40,1.375,112.11030356367422,3
2020-04-10-170225,170225,0,0,1,40,0.875,40.15783251476957,4
2020-04-11-170225,170225,0,0,0,40,0.875,46.91038317725915,5
2020-04-12-170225,170225,1,0,0,41,1.25,52.17369848760404,6
2020-04-13-170225,170225,0,0,0,41,2.0,67.00286847587557,0
2020-04-14-170225,170225,0,0,0,41,1.5,85.04334666004642,1
2020-04-15-170225,170225,0,0,0,41,2.25,136.7561612078303,2
2020-04-16-170225,170225,0,0,1,41,1.25,149.50135007637283,3
2020-04-17-170225,170225,0,0,1,41,3.25,132.15081520289536,4
2020-04-18-170225,170225,1,0,0,42,0.375,176.8295545186802,5
2020-04-19-170225,170225,0,0,0,42,0.375,175.1853063199564,6
2020-04-20-170225,170225,1,0,1,43,1.0,168.21931992344958,0
2020-04-21-170225,170225,0,0,0,43,2.375,128.89192550949474,1
2020-04-22-170225,170225,1,0,0,44,1.0,122.57217199669383,2
2020-04-23-170225,170225,0,0,1,44,0.5,117.52043851993758,3
2020-04-24-170225,170225,1,0,1,45,1.25,72.31702212161683,4
2020-04-25-170225,170225,0,0,0,45,0.0,80.49146347784172,5
2020-04-26-170225,170225,0,0,1,45,2.375,76.02938312635845,6
2020-04-27-170225,170225,0,0,0,45,0.75,58.00804879405784,0
2020-04-28-170225,170225,0,0,0,45,0.875,50.778915655181216,1
2020-04-29-170225,170225,0,0,0,45,1.0,48.60609734617284,2
2020-04-30-170225,170225,1,0,0,46,0.375,75.58180230164353,3
2020-05-01-170225,170225,1,0,0,47,0.0,114.14929303314285,4
2020-05-02-170225,170225,0,0,0,47,0.125,64.75996441623916,5
2020-05-03-170225,170225,0,0,0,47,0.25,53.05492447648194,6
2020-05-04-170225,170225,1,0,1,48,1.0,42.94822991951107,0
2020-05-05-170225,170225,0,0,0,48,0.625,53.951513190775486,1
2020-05-06-170225,170225,0,0,0,48,0.625,51.21006270678518,2
2020-05-07-170225,170225,1,0,2,49,0.625,49.790529716423436,3
2020-05-08-170225,170225,1,0,0,50,0.625,54.883901583063306,4
2020-05-09-170225,170225,0,0,0,50,0.125,67.42132251443334,5
2020-05-10-170225,170225,1,0,0,51,0.0,122.60122467225291,6
2020-05-11-170225,170225,0,0,1,51,1.0,118.19915761168664,0
2020-05-12-170225,170225,0,0,0,51,0.375,127.28225438687576,1
2020-05-13-170225,170225,0,0,2,51,1.0,100.52985856714814,2
2020-05-14-170225,170225,0,0,3,51,0.875,91.6661319850281,3
2020-05-15-170225,170225,0,1,0,51,0.25,73.56726276591155,4
2020-05-16-170225,170225,0,0,0,51,0.125,65.7375322907986,5
2020-05-17-170225,170225,0,0,0,51,0.25,61.68276995222848,6
2020-05-18-170225,170225,1,0,0,52,1.0,58.76554929035136,0
2020-05-19-170225,170225,0,0,0,52,0.875,69.58458193885662,1
2020-05-20-170225,170225,0,0,1,52,1.0,61.1363042941813,2
2020-05-21-170225,170225,2,0,0,54,0.5,68.40171859311647,3
2020-05-22-170225,170225,0,1,0,54,0.5,71.8139381099422,4
2020-05-23-170225,170225,0,0,0,54,0.25,77.67981561594996,5
2020-05-24-170225,170225,0,0,0,54,0.25,78.50956607081686,6
2020-05-25-170225,170225,1,0,0,55,0.75,54.716302244376934,0
2020-05-26-170225,170225,0,0,0,55,0.75,59.809450604230584,1
2020-05-27-170225,170225,2,0,0,57,0.75,69.70653495699506,2
2020-05-28-170225,170225,3,1,0,60,0.125,64.76010953407025,3
2020-05-29-170225,170225,0,1,0,60,0.375,66.82413969825348,4
2020-05-30-170225,170225,0,0,0,60,0.0,75.59826545514964,5
2020-05-31-170225,170225,0,0,0,60,0.0,76.73510579556336,6
2020-06-01-170225,170225,0,0,0,60,0.125,89.84252706173967,0
2020-06-02-170225,170225,0,0,0,60,0.5,22.168342080721434,1
2020-06-03-170225,170225,1,0,0,61,0.375,23.26733647893233,2
2020-06-04-170225,170225,0,0,0,61,0.625,36.94648416410196,3
2020-06-05-170225,170225,0,0,3,61,0.25,40.538900935634615,4
2020-06-06-170225,170225,0,0,1,61,0.375,37.635742691599134,5
2020-06-07-170225,170225,0,0,0,61,0.0,41.23571360489996,6
2020-06-08-170225,170225,0,0,1,61,0.375,40.99519262836283,0
2020-06-09-170225,170225,0,0,0,61,0.125,42.862763147907714,1
2020-06-10-170225,170225,0,0,1,61,0.0,94.52614548029888,2
2020-06-11-170225,170225,0,0,0,61,0.125,70.37629668618241,3
2020-06-12-170225,170225,0,0,1,61,0.125,62.99426639363185,4
2020-06-13-170225,170225,0,0,0,61,0.0,49.756606663736,5
2020-06-14-170225,170225,0,0,0,61,0.0,34.888550334920524,6
2020-06-15-170225,170225,0,0,0,61,0.0,17.916537624126203,0
2020-06-16-170225,170225,0,0,1,61,0.375,16.887513177353238,1
2020-06-17-170225,170225,0,1,0,61,0.125,13.6971610027609,2
2020-06-18-170225,170225,0,0,0,61,1.125,12.244574872512647,3
2020-06-19-170225,170225,3,0,0,64,0.25,10.789475554735906,4
2020-06-20-170225,170225,1,0,0,65,0.125,38.41684041938948,5
2020-06-21-170225,170225,0,0,0,65,0.0,44.87180797152307,6
2020-06-22-170225,170225,1,0,0,66,0.125,40.38680411216236,0
2020-06-23-170225,170225,0,0,0,66,0.25,44.84262939842303,1
2020-06-24-170225,170225,1,1,0,67,0.5,49.558608236457,2
2020-06-25-170225,170225,0,0,1,67,0.0,53.59258304792168,3
2020-06-26-170225,170225,1,0,1,68,0.375,44.52020805358093,4
2020-06-27-170225,170225,0,0,1,68,0.0,34.971580653061004,5
2020-06-28-170225,170225,0,0,0,68,0.0,29.25401630716943,6
2020-06-29-170225,170225,0,0,0,68,0.25,29.38338120699778,0
2020-06-30-170225,170225,1,0,0,69,0.25,34.57796270691685,1
2020-07-01-170225,170225,0,0,0,69,0.375,38.298978785038045,2
2020-07-02-170225,170225,0,1,0,69,0.25,19.463025690583493,3
2020-07-03-170225,170225,0,0,0,69,0.375,46.30126482514226,4
2020-07-04-170225,170225,0,0,0,69,0.0,79.43193495080257,5
2020-07-05-170225,170225,0,0,0,69,0.0,77.11964274591082,6
2020-07-06-170225,170225,0,0,0,69,0.25,69.99606068419052,0
2020-07-07-170225,170225,0,0,1,69,0.125,59.99541622572313,1
2020-07-08-170225,170225,0,0,0,69,0.125,55.80737815416496,2
2020-07-09-170225,170225,1,0,0,70,0.0,56.00576390751859,3
2020-07-10-170225,170225,1,0,0,71,0.375,33.087877484719826,4
2020-07-11-170225,170225,1,0,0,72,0.0,33.884370795575265,5
2020-07-12-170225,170225,0,0,0,72,0.25,29.00476735447213,6
2020-07-13-170225,170225,0,0,0,72,0.125,27.12205517292496,0
2020-07-14-170225,170225,0,0,0,72,0.75,29.929755169109725,1
2020-07-15-170225,170225,0,1,0,72,0.625,29.094514966113053,2
2020-07-16-170225,170225,0,0,0,72,0.625,26.455766330041328,3
2020-07-17-170225,170225,0,0,0,72,0.0,25.705128028722438,4
2020-07-18-170225,170225,0,0,1,72,0.0,18.037845943238132,5
2020-07-19-170225,170225,0,0,0,72,0.125,19.473507569406866,6
2020-07-20-170225,170225,0,0,1,72,0.125,20.250478971461302,0
2020-07-21-170225,170225,1,0,2,73,0.125,19.675591961000926,1
2020-07-22-170225,170225,0,0,1,73,0.125,25.19023560449912,2
2020-07-23-170225,170225,0,0,2,73,0.125,23.874573411427583,3
2020-07-24-170225,170225,0,0,1,73,0.125,27.543817636892506,4
2020-07-25-170225,170225,0,0,1,73,0.25,29.62642935463768,5
2020-07-26-170225,170225,0,0,0,73,0.0,30.505741597083592,6
2020-07-27-170225,170225,0,0,0,73,0.125,31.92486549287556,0
2020-07-28-170225,170225,0,0,2,73,0.25,35.95235540509167,1
2020-07-29-170225,170225,0,0,5,73,0.375,38.678722706715725,2
2020-07-30-170225,170225,0,0,2,73,0.125,43.24362762622013,3
2020-07-31-170225,170225,0,0,1,73,0.625,65.58642540538447,4
2020-08-01-170225,170225,1,0,4,74,0.375,36.96969050500104,5
2020-08-02-170225,170225,0,1,0,74,0.125,519.4523021661106,6
2020-08-03-170225,170225,1,0,1,75,0.75,266.3790085141114,0
2020-08-04-170225,170225,2,0,4,77,0.625,258.58894696051107,1
2020-08-05-170225,170225,1,0,1,78,1.625,285.11457353647967,2
2020-08-06-170225,170225,2,0,6,80,2.125,338.34144556369756,3
2020-08-07-170225,170225,1,0,2,81,1.375,412.85806624028794,4
2020-08-08-170225,170225,1,0,0,82,1.375,455.40784787701995,5
2020-08-09-170225,170225,0,1,1,82,2.125,430.44068322682244,6
2020-08-10-170225,170225,0,0,2,82,3.75,32.51663252236517,0
2020-08-11-170225,170225,2,1,2,84,3.25,141.86904523544422,1
2020-08-12-170225,170225,5,0,1,89,2.5,235.20876435890875,2
2020-08-13-170225,170225,2,0,2,91,3.5,300.7159501194836,3
2020-08-14-170225,170225,1,0,4,92,2.375,320.6680559459823,4
2020-08-15-170225,170225,4,0,3,96,2.75,382.8994069149461,5
2020-08-16-170225,170225,0,0,2,96,1.5,431.4207390558147,6
2020-08-17-170225,170225,1,0,2,97,5.375,440.7757731273374,0
2020-08-18-170225,170225,4,0,1,101,2.875,463.23255374889055,1
2020-08-19-170225,170225,1,0,1,102,3.625,445.53353840698657,2
2020-08-20-170225,170225,6,0,15,108,2.75,405.4645564538675,3
2020-08-21-170225,170225,2,0,3,110,2.875,413.1675453992989,4
2020-08-22-170225,170225,0,0,0,110,0.375,412.2585074494813,5
2020-08-23-170225,170225,1,0,16,111,1.75,416.16365739440226,6
2020-08-24-170225,170225,2,0,0,113,2.5,324.1406568102009,0
2020-08-25-170225,170225,2,0,1,115,1.875,292.12279107452247,1
2020-08-26-170225,170225,1,0,3,116,2.625,260.6315178513339,2
2020-08-27-170225,170225,2,0,1,118,2.25,289.97735274191115,3
2020-08-28-170225,170225,4,0,5,122,2.25,248.10369825339217,4
2020-08-29-170225,170225,3,0,3,125,1.25,237.99805680643564,5
2020-08-30-170225,170225,2,0,0,127,1.875,268.0514194246566,6
2020-08-31-170225,170225,2,0,1,129,1.875,240.5097181264885,0
2020-09-01-170225,170225,1,0,6,130,1.0,429.48799266251837,1
2020-09-02-170225,170225,1,0,10,131,0.75,261.207781015764,2
2020-09-03-170225,170225,15,0,3,146,1.625,229.08818652640397,3
2020-09-04-170225,170225,3,0,5,149,2.875,291.60835864564405,4
2020-09-05-170225,170225,0,0,2,149,1.125,274.600325153678,5
2020-09-06-170225,170225,16,0,4,165,1.0,269.6972181162805,6
2020-09-07-170225,170225,0,0,3,165,1.5,311.9612350581521,0
2020-09-08-170225,170225,1,0,2,166,4.125,305.60830458642107,1
2020-09-09-170225,170225,3,1,1,169,3.625,266.3100770343341,2
2020-09-10-170225,170225,1,0,0,170,5.375,410.85806293329915,3
2020-09-11-170225,170225,5,0,8,175,6.125,435.1361608752132,4
2020-09-12-170225,170225,3,0,2,178,2.75,433.6833860386484,5
2020-09-13-170225,170225,0,1,3,178,1.875,357.7989266661878,6
2020-09-14-170225,170225,1,1,3,179,2.125,318.75947990051225,0
2020-09-15-170225,170225,6,0,15,185,5.125,282.65385784445533,1
2020-09-16-170225,170225,10,1,3,195,2.5,293.3525984346495,2
2020-09-17-170225,170225,3,1,2,198,3.125,337.70762443250806,3
2020-09-18-170225,170225,5,0,4,203,2.75,299.5728679866585,4
2020-09-19-170225,170225,2,1,0,205,1.625,257.65861661217053,5
2020-09-20-170225,170225,4,0,0,209,2.125,234.65021854916648,6
2020-09-21-170225,170225,3,1,0,212,3.25,250.85226094225936,0
2020-09-22-170225,170225,2,0,2,214,3.0,239.0155468986536,1
2020-09-23-170225,170225,1,0,2,215,3.0,218.09687075145314,2
2020-09-24-170225,170225,0,1,5,215,2.375,203.3536114107333,3
2020-09-25-170225,170225,8,0,2,223,2.875,196.55868430278298,4
2020-09-26-170225,170225,2,0,2,225,1.125,219.17617430876115,5
2020-09-27-170225,170225,3,0,0,228,0.875,223.36577413979012,6
2020-09-28-170225,170225,3,0,3,231,1.625,203.0021995387284,0
2020-09-29-170225,170225,15,0,0,246,1.25,195.78444364160077,1
2020-09-30-170225,170225,3,0,8,249,1.375,277.5289041574363,2
2020-10-01-170225,170225,2,0,3,251,2.375,0.0,3
2020-10-02-170225,170225,4,0,4,255,1.25,373.5191769624712,4
2020-10-03-170225,170225,0,1,3,255,1.0,500.2249728025521,5
2020-10-04-170225,170225,0,1,1,255,1.375,518.9870620174457,6
2020-10-05-170225,170225,0,0,4,255,1.5,460.1849202790037,0
2020-10-06-170225,170225,2,0,3,257,1.625,420.49802053346775,1
2020-10-07-170225,170225,2,0,10,259,1.75,337.96286786141786,2
2020-10-08-170225,170225,5,0,4,264,1.375,300.82603904509443,3
2020-10-09-170225,170225,2,0,5,266,1.625,328.4507111971031,4
2020-10-10-170225,170225,2,0,8,268,1.375,30.513777946567764,5
2020-10-11-170225,170225,0,0,3,268,1.25,52.879181498585034,6
2020-10-12-170225,170225,3,0,4,271,1.0,74.37838869564072,0
2020-10-13-170225,170225,0,0,3,271,1.5,115.53140776001932,1
2020-10-14-170225,170225,8,0,11,279,2.0,153.92751238227115,2
2020-10-15-170225,170225,3,0,3,282,1.5,226.17421998715696,3
2020-10-16-170225,170225,4,0,9,286,2.0,277.1814675153909,4
2020-10-17-170225,170225,3,0,4,289,0.75,291.0819266351633,5
2020-10-18-170225,170225,1,0,6,290,1.375,282.8755459667221,6
2020-10-19-170225,170225,4,0,2,294,3.0,291.8290858013271,0
2020-10-20-170225,170225,3,0,14,297,2.0,335.9226867280279,1
2020-10-21-170225,170225,10,0,4,307,2.875,308.0431364993921,2
2020-10-22-170225,170225,4,0,22,311,2.375,332.8082701200872,3
2020-10-23-170225,170225,5,0,10,316,3.625,335.4714578942545,4
2020-10-24-170225,170225,8,0,9,324,0.875,371.3735004182537,5
2020-10-25-170225,170225,3,0,8,327,0.75,369.5245247506387,6
2020-10-26-170225,170225,4,1,2,331,2.75,318.725919691683,0
2020-10-27-170225,170225,3,1,10,334,2.75,350.68595627555885,1
2020-10-28-170225,170225,11,0,8,345,5.375,366.76462387309573,2
2020-10-29-170225,170225,3,0,6,348,4.125,394.44496687823545,3
2020-10-30-170225,170225,9,0,11,357,5.875,376.9580046661657,4
2020-10-31-170225,170225,4,0,0,361,2.125,435.04921085803716,5
2020-11-01-170225,170225,6,0,0,367,2.0,246.99678220194573,6
2020-11-02-170225,170225,2,0,0,369,1.25,367.3872846265211,0
2020-11-03-170225,170225,14,0,0,383,3.75,298.3988239611415,1
2020-11-04-170225,170225,4,1,0,387,4.0,391.6490408017145,2
2020-11-05-170225,170225,22,0,0,409,3.375,410.85362784039575,3
2020-11-06-170225,170225,10,0,0,419,7.625,492.5794101276253,4
2020-11-07-170225,170225,9,2,0,428,2.0,542.3405733385505,5
2020-11-08-170225,170225,8,0,0,436,1.375,534.7028499896485,6
2020-11-09-170225,170225,2,0,0,438,2.375,535.7382092716629,0
2020-11-10-170225,170225,10,1,0,448,2.25,245.4176828064204,1
2020-11-11-170225,170225,8,1,0,456,3.5,289.3407751707408,2
2020-11-12-170225,170225,6,1,0,462,3.75,351.8700404951359,3
2020-11-13-170225,170225,11,0,0,473,4.125,388.8556122803616,4
2020-03-01-170226,170226,0,0,0,0,0.0,0.0,6
2020-03-02-170226,170226,0,0,1,0,0.125,14.299227094783863,0
2020-03-03-170226,170226,0,0,1,0,0.25,46.22561277655013,1
2020-03-04-170226,170226,0,0,2,0,0.125,51.67989303073355,2
2020-03-05-170226,170226,0,0,1,0,0.0,58.48251026075806,3
2020-03-06-170226,170226,0,0,0,0,0.125,52.48218209152406,4
2020-03-07-170226,170226,0,0,1,0,0.0,58.059143174410565,5
2020-03-08-170226,170226,0,0,2,0,0.0,63.37577580699736,6
2020-03-09-170226,170226,0,0,3,0,0.5,63.113163998397226,0
2020-03-10-170226,170226,0,0,1,0,0.25,408.352314858728,1
2020-03-11-170226,170226,0,0,1,0,0.25,356.4657295368449,2
2020-03-12-170226,170226,2,0,1,2,0.5,308.490308824198,3
2020-03-13-170226,170226,2,0,1,4,0.875,220.1375375259519,4
2020-03-14-170226,170226,0,0,0,4,2.25,201.28599299537134,5
2020-03-15-170226,170226,0,0,0,4,0.625,90.89976308862492,6
2020-03-16-170226,170226,1,0,1,5,2.5,34.08419416748823,0
2020-03-17-170226,170226,1,0,4,6,4.125,40.709259263737486,1
2020-03-18-170226,170226,2,0,2,8,4.125,51.41967617906974,2
2020-03-19-170226,170226,1,0,2,9,6.25,70.68143445676711,3
2020-03-20-170226,170226,0,0,0,9,5.125,61.60357490274997,4
2020-03-21-170226,170226,1,0,1,10,2.5,67.32536840393553,5
2020-03-22-170226,170226,2,0,0,12,2.0,70.40962267436241,6
2020-03-23-170226,170226,3,0,0,15,10.25,76.21954872328604,0
2020-03-24-170226,170226,1,0,0,16,6.375,93.14594700490889,1
2020-03-25-170226,170226,1,0,1,17,7.0,91.28236084209047,2
2020-03-26-170226,170226,1,0,0,18,5.25,92.67705444533718,3
2020-03-27-170226,170226,1,0,1,19,5.25,101.06081196030804,4
2020-03-28-170226,170226,0,0,0,19,2.375,109.90821940095199,5
2020-03-29-170226,170226,0,0,1,19,1.375,99.10196925809427,6
2020-03-30-170226,170226,1,0,0,20,6.5,62.23526020348034,0
2020-03-31-170226,170226,4,0,1,24,3.625,60.69179290590961,1
2020-04-01-170226,170226,2,1,1,26,4.875,17.50049687707378,2
2020-04-02-170226,170226,2,0,7,28,3.125,55.6900611204306,3
2020-04-03-170226,170226,0,0,1,28,3.625,25.91247175801982,4
2020-04-04-170226,170226,1,0,0,29,0.5,31.639225637048497,5
2020-04-05-170226,170226,0,0,0,29,1.5,31.35312739661445,6
2020-04-06-170226,170226,0,0,0,29,2.75,31.671688331378128,0
2020-04-07-170226,170226,0,0,1,29,3.0,32.30913463566642,1
2020-04-08-170226,170226,1,1,1,30,3.375,32.165044111645955,2
2020-04-09-170226,170226,0,0,2,30,5.125,37.202144429940425,3
2020-04-10-170226,170226,1,0,0,31,3.0,11.24804900713634,4
2020-04-11-170226,170226,0,0,1,31,1.125,19.738310362873463,5
2020-04-12-170226,170226,1,0,0,32,1.5,21.37805218770055,6
2020-04-13-170226,170226,0,0,0,32,2.5,23.80658937099336,0
2020-04-14-170226,170226,1,0,1,33,2.125,27.624132352569198,1
2020-04-15-170226,170226,1,0,1,34,3.5,35.09715268566441,2
2020-04-16-170226,170226,7,0,3,41,2.0,39.690292793331956,3
2020-04-17-170226,170226,1,0,1,42,3.75,48.52669385466111,4
2020-04-18-170226,170226,0,0,0,42,0.125,49.66773344728317,5
2020-04-19-170226,170226,0,0,1,42,1.5,48.267647606279006,6
2020-04-20-170226,170226,0,0,1,42,2.125,53.88377587068949,0
2020-04-21-170226,170226,1,2,0,43,1.75,55.03908277885761,1
2020-04-22-170226,170226,1,0,1,44,0.625,51.621199664608326,2
2020-04-23-170226,170226,2,1,0,46,0.25,37.07230965485423,3
2020-04-24-170226,170226,0,0,0,46,1.25,31.303230576702514,4
2020-04-25-170226,170226,1,0,0,47,0.75,37.098579694298905,5
2020-04-26-170226,170226,0,0,0,47,0.625,41.30300375129791,6
2020-04-27-170226,170226,0,0,0,47,1.75,29.709557677666133,0
2020-04-28-170226,170226,1,0,0,48,1.25,27.980007867810478,1
2020-04-29-170226,170226,1,0,0,49,2.0,28.659119126964953,2
2020-04-30-170226,170226,3,0,0,52,0.625,29.531817560837734,3
2020-05-01-170226,170226,1,0,1,53,0.25,57.00428465573859,4
2020-05-02-170226,170226,0,0,0,53,0.125,17.806643132147144,5
2020-05-03-170226,170226,1,0,0,54,0.25,17.98947691046451,6
2020-05-04-170226,170226,1,0,1,55,1.25,20.977856200793486,0
2020-05-05-170226,170226,0,0,0,55,0.875,14.20590235249877,1
2020-05-06-170226,170226,1,0,0,56,0.875,14.040014646826217,2
2020-05-07-170226,170226,0,0,0,56,1.125,18.8903769611953,3
2020-05-08-170226,170226,0,0,0,56,1.375,20.489941743306886,4
2020-05-09-170226,170226,0,0,0,56,0.0,19.67691270111743,5
2020-05-10-170226,170226,0,0,0,56,0.125,40.828054928675066,6
2020-05-11-170226,170226,0,1,0,56,0.875,35.17394481682012,0
2020-05-12-170226,170226,0,0,3,56,0.875,33.53058617533071,1
2020-05-13-170226,170226,0,0,0,56,2.375,30.052600701876962,2
2020-05-14-170226,170226,0,0,0,56,2.25,28.30773740685719,3
2020-05-15-170226,170226,1,0,0,57,1.125,23.685523649985228,4
2020-05-16-170226,170226,0,0,0,57,0.0,23.21816913563663,5
2020-05-17-170226,170226,0,0,0,57,0.125,18.95444074797398,6
2020-05-18-170226,170226,1,0,0,58,2.0,19.232215076948357,0
2020-05-19-170226,170226,0,0,0,58,1.0,20.611500815572853,1
2020-05-20-170226,170226,0,0,0,58,1.25,17.79505635954079,2
2020-05-21-170226,170226,0,0,1,58,0.875,15.929536036193053,3
2020-05-22-170226,170226,0,0,0,58,0.875,10.253813098046841,4
2020-05-23-170226,170226,0,0,0,58,0.0,12.413106774368297,5
2020-05-24-170226,170226,0,0,0,58,0.0,12.725786209189145,6
2020-05-25-170226,170226,0,0,0,58,1.375,9.075879503084883,0
2020-05-26-170226,170226,3,0,0,61,0.875,10.160428384773379,1
2020-05-27-170226,170226,0,0,0,61,1.125,29.208398673026643,2
2020-05-28-170226,170226,0,2,0,61,0.625,31.51586380185178,3
2020-05-29-170226,170226,0,0,1,61,0.625,31.998898722215735,4
2020-05-30-170226,170226,0,0,0,61,0.0,40.48956609290613,5
2020-05-31-170226,170226,0,0,0,61,0.0,44.108267116356856,6
2020-06-01-170226,170226,0,0,0,61,0.25,40.4703354533604,0
2020-06-02-170226,170226,0,1,1,61,0.75,14.06414534477164,1
2020-06-03-170226,170226,0,0,0,61,0.75,7.961186961684234,2
2020-06-04-170226,170226,1,0,0,62,0.625,7.362491474414588,3
2020-06-05-170226,170226,0,0,0,62,0.25,11.796326507720103,4
2020-06-06-170226,170226,0,0,0,62,0.25,11.78315277506935,5
2020-06-07-170226,170226,0,0,0,62,0.0,12.180417713428344,6
2020-06-08-170226,170226,0,0,0,62,0.25,12.393490586450195,0
2020-06-09-170226,170226,0,0,0,62,0.5,14.273040890526989,1
2020-06-10-170226,170226,0,0,0,62,0.0,37.73444570255961,2
2020-06-11-170226,170226,0,0,0,62,0.25,29.48558858889485,3
2020-06-12-170226,170226,1,0,0,63,0.5,25.72228664538911,4
2020-06-13-170226,170226,0,0,0,63,0.0,20.244895789154945,5
2020-06-14-170226,170226,0,0,0,63,0.125,15.233422642824179,6
2020-06-15-170226,170226,0,0,0,63,0.0,10.939938191543726,0
2020-06-16-170226,170226,1,0,0,64,0.375,11.678479806689477,1
2020-06-17-170226,170226,0,0,0,64,0.25,16.922713531320746,2
2020-06-18-170226,170226,0,0,0,64,0.625,16.89342157869693,3
2020-06-19-170226,170226,0,0,0,64,0.25,17.65726269150378,4
2020-06-20-170226,170226,0,0,0,64,0.125,19.248935037893666,5
2020-06-21-170226,170226,0,0,0,64,0.125,20.442335789757852,6
2020-06-22-170226,170226,0,0,2,64,0.25,20.102998742903544,0
2020-06-23-170226,170226,0,0,0,64,0.375,13.246144989455626,1
2020-06-24-170226,170226,0,0,1,64,0.625,13.14141429287983,2
2020-06-25-170226,170226,0,0,0,64,0.375,13.685945365377304,3
2020-06-26-170226,170226,0,0,0,64,0.5,14.515554967030859,4
2020-06-27-170226,170226,0,0,0,64,0.25,11.205479916190706,5
2020-06-28-170226,170226,0,0,0,64,0.0,11.189755805378303,6
2020-06-29-170226,170226,0,0,0,64,0.125,11.271739862337917,0
2020-06-30-170226,170226,0,0,0,64,0.25,11.240769932745781,1
2020-07-01-170226,170226,0,0,0,64,0.5,21.70134304707912,2
2020-07-02-170226,170226,0,0,1,64,0.125,21.457042613035526,3
2020-07-03-170226,170226,0,0,0,64,0.125,21.45620914930521,4
2020-07-04-170226,170226,0,0,0,64,0.0,24.924744135979452,5
2020-07-05-170226,170226,0,0,0,64,0.0,21.18778548997704,6
2020-07-06-170226,170226,2,0,0,66,0.25,16.26037138435257,0
2020-07-07-170226,170226,0,0,0,66,0.625,29.882893800604073,1
2020-07-08-170226,170226,1,0,1,67,0.0,26.3298495708406,2
2020-07-09-170226,170226,0,0,0,67,0.25,31.27368078577522,3
2020-07-10-170226,170226,0,0,0,67,0.125,19.65796343800904,4
2020-07-11-170226,170226,0,0,0,67,0.0,11.522399982746798,5
2020-07-12-170226,170226,0,0,1,67,0.25,8.877187183305516,6
2020-07-13-170226,170226,0,0,0,67,0.25,8.564239771932401,0
2020-07-14-170226,170226,0,0,0,67,0.5,11.75966114853563,1
2020-07-15-170226,170226,0,0,0,67,0.375,11.486252466279952,2
2020-07-16-170226,170226,1,0,1,68,0.375,9.457612057955345,3
2020-07-17-170226,170226,0,0,0,68,0.375,16.58156686863051,4
2020-07-18-170226,170226,0,0,0,68,0.125,19.089866481577353,5
2020-07-19-170226,170226,0,0,0,68,0.125,20.29092390909364,6
2020-07-20-170226,170226,0,0,0,68,0.25,19.78732486418812,0
2020-07-21-170226,170226,0,0,0,68,0.125,19.583095503404188,1
2020-07-22-170226,170226,1,0,0,69,0.0,20.124661620663208,2
2020-07-23-170226,170226,0,0,0,69,0.125,19.75870355151793,3
2020-07-24-170226,170226,0,0,0,69,0.375,18.80353254932448,4
2020-07-25-170226,170226,0,0,2,69,0.125,22.349681072436013,5
2020-07-26-170226,170226,1,0,0,70,0.25,22.06525863941016,6
2020-07-27-170226,170226,0,0,3,70,0.625,23.4888805171011,0
2020-07-28-170226,170226,0,0,1,70,0.375,26.620453580556784,1
2020-07-29-170226,170226,0,0,3,70,0.875,25.837907981602687,2
2020-07-30-170226,170226,1,0,4,71,1.0,23.308344211747745,3
2020-07-31-170226,170226,0,0,6,71,1.0,24.75301346820273,4
2020-08-01-170226,170226,0,0,0,71,0.75,34.78004821063059,5
2020-08-02-170226,170226,0,0,5,71,0.5,264.18456049733055,6
2020-08-03-170226,170226,0,0,1,71,1.375,120.26990757971186,0
2020-08-04-170226,170226,0,0,2,71,3.5,74.23652928819769,1
2020-08-05-170226,170226,0,0,3,71,4.5,87.58750972397377,2
2020-08-06-170226,170226,0,0,4,71,3.25,95.25648225777698,3
2020-08-07-170226,170226,0,0,4,71,3.125,95.53345044019233,4
2020-08-08-170226,170226,2,0,7,73,2.0,81.28022782923402,5
2020-08-09-170226,170226,0,0,0,73,2.75,89.5496618455464,6
2020-08-10-170226,170226,3,0,1,76,5.0,38.09521659918658,0
2020-08-11-170226,170226,1,0,4,77,3.875,78.93506461339244,1
2020-08-12-170226,170226,3,0,1,80,4.25,108.11522760330729,2
2020-08-13-170226,170226,4,0,0,84,3.5,115.25031709382841,3
2020-08-14-170226,170226,6,0,0,90,2.875,206.84502000240897,4
2020-08-15-170226,170226,0,0,2,90,2.5,271.9463394077408,5
2020-08-16-170226,170226,5,0,0,95,1.75,264.59989781540304,6
2020-08-17-170226,170226,1,0,1,96,6.5,311.69801418389994,0
2020-08-18-170226,170226,2,0,0,98,5.0,295.8447553799369,1
2020-08-19-170226,170226,3,0,3,101,3.5,297.1430186407639,2
2020-08-20-170226,170226,4,0,7,105,2.125,218.01112370147473,3
2020-08-21-170226,170226,4,0,2,109,4.125,182.89631853058978,4
2020-08-22-170226,170226,7,0,2,116,2.0,229.42323077057426,5
2020-08-23-170226,170226,0,0,0,116,1.875,264.23255107857835,6
2020-08-24-170226,170226,1,0,3,117,4.75,242.01058506158873,0
2020-08-25-170226,170226,4,0,3,121,2.5,231.61011587963338,1
2020-08-26-170226,170226,1,0,1,122,2.5,244.25435617884193,2
2020-08-27-170226,170226,0,0,2,122,2.75,240.46183212324786,3
2020-08-28-170226,170226,0,0,1,122,2.0,213.6921083507906,4
2020-08-29-170226,170226,2,0,0,124,0.5,167.53631098199895,5
2020-08-30-170226,170226,0,0,1,124,0.5,115.84698914083936,6
2020-08-31-170226,170226,1,0,1,125,0.5,99.75577472002415,0
2020-09-01-170226,170226,0,0,2,125,3.0,87.15426781508846,1
2020-09-02-170226,170226,3,0,2,128,1.875,146.53859118854206,2
2020-09-03-170226,170226,7,0,1,135,1.125,100.49701456790321,3
2020-09-04-170226,170226,2,0,1,137,1.25,149.39405183040202,4
2020-09-05-170226,170226,2,0,0,139,1.0,147.3446609432813,5
2020-09-06-170226,170226,0,0,0,139,0.25,135.747419035126,6
2020-09-07-170226,170226,3,0,1,142,2.375,130.57454437158137,0
2020-09-08-170226,170226,3,0,0,145,3.0,142.87851251749314,1
2020-09-09-170226,170226,1,0,0,146,1.875,151.92121817366854,2
2020-09-10-170226,170226,2,0,1,148,5.25,79.54215079426552,3
2020-09-11-170226,170226,1,0,0,149,4.125,87.09805262717164,4
2020-09-12-170226,170226,0,0,0,149,2.875,93.72556961064438,5
2020-09-13-170226,170226,1,0,0,150,2.125,95.46699211324531,6
2020-09-14-170226,170226,1,0,2,151,2.25,109.59505624325817,0
2020-09-15-170226,170226,2,0,1,153,6.375,113.79616123892919,1
2020-09-16-170226,170226,2,0,1,155,3.375,136.9638199703394,2
2020-09-17-170226,170226,1,0,0,156,4.25,147.75880610019317,3
2020-09-18-170226,170226,1,0,0,157,2.75,141.53233148397206,4
2020-09-19-170226,170226,0,0,0,157,1.375,130.92094163657418,5
2020-09-20-170226,170226,0,0,0,157,2.5,123.77242823095146,6
2020-09-21-170226,170226,1,0,0,158,3.875,110.49682558449766,0
2020-09-22-170226,170226,0,0,0,158,3.0,98.2855575371373,1
2020-09-23-170226,170226,0,0,3,158,3.5,77.52770286073785,2
2020-09-24-170226,170226,1,0,1,159,2.75,69.67111048912706,3
2020-09-25-170226,170226,0,0,1,159,2.625,73.98398105732174,4
2020-09-26-170226,170226,0,0,1,159,1.5,81.32825866163284,5
2020-09-27-170226,170226,0,0,0,159,0.625,66.82536731564664,6
2020-09-28-170226,170226,2,0,0,161,1.5,68.70836070902155,0
2020-09-29-170226,170226,1,0,2,162,2.125,68.26520166192753,1
2020-09-30-170226,170226,1,0,6,163,2.25,110.93923614606994,2
2020-10-01-170226,170226,0,0,0,163,2.0,0.0,3
2020-10-02-170226,170226,0,0,5,163,2.25,192.34298408117974,4
2020-10-03-170226,170226,0,0,2,163,0.875,456.11455473589587,5
2020-10-04-170226,170226,0,0,0,163,1.375,507.9184931080117,6
2020-10-05-170226,170226,0,0,0,163,2.125,428.68291100823967,0
2020-10-06-170226,170226,0,0,2,163,3.0,401.86320077752146,1
2020-10-07-170226,170226,3,0,3,166,3.75,266.2980568528738,2
2020-10-08-170226,170226,1,0,4,167,2.375,202.99129431594707,3
2020-10-09-170226,170226,1,0,1,168,2.875,218.44374234278354,4
2020-10-10-170226,170226,1,0,2,169,1.375,5.947648439545132,5
2020-10-11-170226,170226,0,0,3,169,1.375,14.260833154132108,6
2020-10-12-170226,170226,0,0,7,169,2.625,22.74832430943649,0
2020-10-13-170226,170226,2,0,2,171,2.5,36.85122192359605,1
2020-10-14-170226,170226,6,0,26,177,4.0,74.7843514367622,2
2020-10-15-170226,170226,0,0,14,177,5.5,123.61976147529047,3
2020-10-16-170226,170226,5,0,13,182,5.5,156.81635049461067,4
2020-10-17-170226,170226,2,0,13,184,1.625,190.7803552131424,5
2020-10-18-170226,170226,0,0,7,184,2.25,194.22368739357253,6
2020-10-19-170226,170226,0,0,2,184,6.5,194.46431943332715,0
2020-10-20-170226,170226,2,0,4,186,4.75,176.32810784858518,1
2020-10-21-170226,170226,3,0,5,189,6.875,181.36282682489457,2
2020-10-22-170226,170226,4,0,3,193,7.0,192.46154568385867,3
2020-10-23-170226,170226,1,0,6,194,5.75,190.50184813076996,4
2020-10-24-170226,170226,2,0,2,196,3.125,205.27484716186152,5
2020-10-25-170226,170226,3,0,17,199,4.125,210.23021281768672,6
2020-10-26-170226,170226,7,0,3,206,7.5,210.42040656792392,0
2020-10-27-170226,170226,2,0,10,208,6.125,279.9220933466133,1
2020-10-28-170226,170226,26,0,0,234,7.5,274.1687293693196,2
2020-10-29-170226,170226,14,1,9,248,6.125,400.33609531666923,3
2020-10-30-170226,170226,13,1,5,261,7.875,421.4915135306076,4
2020-10-31-170226,170226,13,0,0,274,4.0,472.12998065784416,5
2020-11-01-170226,170226,7,0,0,281,3.875,158.93096635991557,6
2020-11-02-170226,170226,2,0,0,283,4.375,411.6928540799117,0
2020-11-03-170226,170226,4,1,0,287,6.625,344.32552850520455,1
2020-11-04-170226,170226,5,2,0,292,5.125,354.02700005361635,2
2020-11-05-170226,170226,3,0,0,295,5.125,323.080709621128,3
2020-11-06-170226,170226,6,2,0,301,8.625,315.47214601830666,4
2020-11-07-170226,170226,2,0,0,303,3.125,332.1664851500855,5
2020-11-08-170226,170226,17,0,0,320,6.5,280.77954245793927,6
2020-11-09-170226,170226,3,0,0,323,8.125,332.05012906024416,0
2020-11-10-170226,170226,10,1,0,333,6.0,102.93554327394588,1
2020-11-11-170226,170226,0,0,0,333,5.0,184.79195883121085,2
2020-11-12-170226,170226,9,1,0,342,9.25,207.17233533448274,3
2020-11-13-170226,170226,5,1,0,347,7.75,258.1251324595157,4
2020-03-01-170227,170227,0,0,4,0,0.0,0.0,6
2020-03-02-170227,170227,0,0,8,0,0.0,129.37340609168368,0
2020-03-03-170227,170227,1,0,10,1,0.0,514.807160019094,1
2020-03-04-170227,170227,1,0,23,2,0.0,555.9240508822402,2
2020-03-05-170227,170227,0,0,27,2,0.2,594.5282121663736,3
2020-03-06-170227,170227,0,0,27,2,0.4,508.274593575929,4
2020-03-07-170227,170227,0,0,11,2,0.2,523.3853906007153,5
2020-03-08-170227,170227,0,0,11,2,0.0,502.5910581257921,6
2020-03-09-170227,170227,0,0,43,2,0.6,500.094912980782,0
2020-03-10-170227,170227,3,0,29,5,0.6,2566.5777008457285,1
2020-03-11-170227,170227,0,0,28,5,1.8,2146.9219128965706,2
2020-03-12-170227,170227,1,0,21,6,1.4,1715.2295415269248,3
2020-03-13-170227,170227,8,0,16,14,2.2,1188.910191143065,4
2020-03-14-170227,170227,2,0,6,16,1.8,969.7409060724858,5
2020-03-15-170227,170227,4,0,5,20,2.6,687.8837807773468,6
2020-03-16-170227,170227,8,0,25,28,7.4,223.38832609733382,0
2020-03-17-170227,170227,10,0,6,38,8.2,341.65705205423365,1
2020-03-18-170227,170227,23,0,15,61,15.0,437.2115481245027,2
2020-03-19-170227,170227,27,0,15,88,11.6,578.5035739730705,3
2020-03-20-170227,170227,27,0,15,115,16.6,655.3807017132408,4
2020-03-21-170227,170227,11,0,6,126,5.2,767.0434821225306,5
2020-03-22-170227,170227,11,2,3,137,8.6,769.2816418845748,6
2020-03-23-170227,170227,43,0,17,180,19.2,755.9002990055111,0
2020-03-24-170227,170227,29,0,12,209,13.6,873.6443140586275,1
2020-03-25-170227,170227,28,0,11,237,13.2,873.2963368121258,2
2020-03-26-170227,170227,21,0,6,258,13.4,857.6584775735298,3
2020-03-27-170227,170227,16,0,10,274,19.2,991.0100925943758,4
2020-03-28-170227,170227,6,0,3,280,6.0,986.5284141420576,5
2020-03-29-170227,170227,5,0,3,285,5.2,980.0128982713273,6
2020-03-30-170227,170227,25,0,11,310,16.0,722.6580992997663,0
2020-03-31-170227,170227,6,0,13,316,12.4,686.5944822411632,1
2020-04-01-170227,170227,15,0,14,331,9.2,105.8111308897147,2
2020-04-02-170227,170227,15,0,7,346,9.8,482.42676287223924,3
2020-04-03-170227,170227,15,0,6,361,11.2,237.29217068140707,4
2020-04-04-170227,170227,6,0,0,367,4.6,312.054884897991,5
2020-04-05-170227,170227,3,0,1,370,2.0,338.8289366494005,6
2020-04-06-170227,170227,17,0,10,387,4.6,352.54208688737515,0
2020-04-07-170227,170227,12,0,8,399,7.0,379.8628680718591,1
2020-04-08-170227,170227,11,0,9,410,6.4,405.89765150177186,2
2020-04-09-170227,170227,6,0,4,416,9.6,419.2860327168319,3
2020-04-10-170227,170227,10,1,3,426,8.0,96.1192976853143,4
2020-04-11-170227,170227,3,0,4,429,9.2,163.59471619812194,5
2020-04-12-170227,170227,3,0,2,432,3.2,235.9152527152505,6
2020-04-13-170227,170227,11,0,4,443,9.0,259.0047487925149,0
2020-04-14-170227,170227,13,0,6,456,7.8,345.901584180818,1
2020-04-15-170227,170227,14,0,7,470,13.0,426.6433495010949,2
2020-04-16-170227,170227,7,1,4,477,8.0,528.3676758297338,3
2020-04-17-170227,170227,6,0,3,483,14.6,524.9232627189735,4
2020-04-18-170227,170227,0,0,6,483,2.8,576.3018119512972,5
2020-04-19-170227,170227,1,0,2,484,6.4,516.2368204190681,6
2020-04-20-170227,170227,10,0,5,494,7.4,519.4784202087743,0
2020-04-21-170227,170227,8,1,6,502,7.6,508.1023704138431,1
2020-04-22-170227,170227,9,0,5,511,9.6,461.517970216764,2
2020-04-23-170227,170227,4,0,4,515,2.6,478.52222477087605,3
2020-04-24-170227,170227,3,0,6,518,5.4,375.81200973713,4
2020-04-25-170227,170227,4,0,0,522,1.6,398.8058662709702,5
2020-04-26-170227,170227,2,0,1,524,1.2,382.2301353476886,6
2020-04-27-170227,170227,4,0,10,528,6.6,315.7288077200927,0
2020-04-28-170227,170227,6,0,6,534,4.8,302.46578403606117,1
2020-04-29-170227,170227,7,0,11,541,5.8,283.14066530618936,2
2020-04-30-170227,170227,4,0,9,545,3.0,341.3154721499439,3
2020-05-01-170227,170227,3,0,6,548,0.8,421.92269478014765,4
2020-05-02-170227,170227,6,0,2,554,0.8,332.11928663058416,5
2020-05-03-170227,170227,2,0,0,556,0.4,179.20562857022395,6
2020-05-04-170227,170227,5,0,10,561,3.2,140.95831204414702,0
2020-05-05-170227,170227,6,0,5,567,2.4,138.47619464058135,1
2020-05-06-170227,170227,5,0,7,572,4.6,146.19806731321438,2
2020-05-07-170227,170227,4,0,3,576,2.0,172.5413668322789,3
2020-05-08-170227,170227,6,0,4,582,5.0,173.7090004595676,4
2020-05-09-170227,170227,0,0,1,582,0.0,231.05125328966295,5
2020-05-10-170227,170227,1,0,0,583,0.6,459.54892188017556,6
2020-05-11-170227,170227,10,0,1,593,5.0,401.50791934943663,0
2020-05-12-170227,170227,6,0,9,599,3.6,440.3012209202705,1
2020-05-13-170227,170227,11,0,4,610,6.4,383.6523135410196,2
2020-05-14-170227,170227,9,0,3,619,7.4,391.5945746437484,3
2020-05-15-170227,170227,6,0,3,625,6.4,408.1984945892233,4
2020-05-16-170227,170227,2,0,0,627,1.4,403.61430021781075,5
2020-05-17-170227,170227,0,0,0,627,0.2,405.0834347454754,6
2020-05-18-170227,170227,10,0,6,637,5.2,406.2161105554093,0
2020-05-19-170227,170227,5,0,1,642,5.0,404.2565049031017,1
2020-05-20-170227,170227,7,0,5,649,5.0,341.8316040659082,2
2020-05-21-170227,170227,3,0,1,652,4.2,317.9651746665638,3
2020-05-22-170227,170227,4,0,3,656,3.8,299.61774364116377,4
2020-05-23-170227,170227,1,0,1,657,0.6,342.8492118252367,5
2020-05-24-170227,170227,0,0,0,657,0.0,347.2197385000826,6
2020-05-25-170227,170227,1,0,3,658,6.4,270.4460375080348,0
2020-05-26-170227,170227,9,0,3,667,3.6,272.2663294813593,1
2020-05-27-170227,170227,4,0,3,671,3.2,312.78807242672906,2
2020-05-28-170227,170227,3,3,0,674,2.4,280.5569945919858,3
2020-05-29-170227,170227,3,0,1,677,2.4,259.1152581591781,4
2020-05-30-170227,170227,0,0,0,677,0.0,253.0268334250087,5
2020-05-31-170227,170227,0,0,0,677,0.0,255.39377161726884,6
2020-06-01-170227,170227,6,0,3,683,2.2,276.617171068904,0
2020-06-02-170227,170227,1,0,2,684,2.2,82.03508324983224,1
2020-06-03-170227,170227,5,0,1,689,1.0,60.16968900610034,2
2020-06-04-170227,170227,1,0,0,690,2.8,63.45956934373205,3
2020-06-05-170227,170227,3,0,0,693,2.8,77.43113830396834,4
2020-06-06-170227,170227,1,0,1,694,0.8,94.96864462074458,5
2020-06-07-170227,170227,0,0,1,694,0.4,102.03772627005631,6
2020-06-08-170227,170227,3,1,0,697,1.8,103.95493871184054,0
2020-06-09-170227,170227,3,0,1,700,1.6,128.50281512378479,1
2020-06-10-170227,170227,3,0,1,703,2.2,313.08819924708297,2
2020-06-11-170227,170227,0,0,0,703,1.0,296.2222442073233,3
2020-06-12-170227,170227,1,0,2,704,1.4,269.2062692154757,4
2020-06-13-170227,170227,0,0,0,704,0.2,211.90384765528793,5
2020-06-14-170227,170227,0,0,0,704,0.2,175.34323014780983,6
2020-06-15-170227,170227,3,0,1,707,1.2,104.1105681889719,0
2020-06-16-170227,170227,2,1,0,709,1.0,127.99058550680923,1
2020-06-17-170227,170227,1,0,0,710,1.2,110.8031187132053,2
2020-06-18-170227,170227,0,0,0,710,1.0,102.50867879656673,3
2020-06-19-170227,170227,0,0,1,710,0.2,97.29773795641093,4
2020-06-20-170227,170227,1,0,0,711,0.2,111.91552626430827,5
2020-06-21-170227,170227,1,0,0,712,0.0,113.29523505951488,6
2020-06-22-170227,170227,0,0,0,712,1.2,91.96119973202572,0
2020-06-23-170227,170227,1,0,0,713,1.0,89.70434504182641,1
2020-06-24-170227,170227,1,0,0,714,1.0,81.68083063412385,2
2020-06-25-170227,170227,0,0,0,714,0.8,82.61405862191509,3
2020-06-26-170227,170227,2,0,0,716,0.8,90.49708949352083,4
2020-06-27-170227,170227,0,0,0,716,0.2,80.42536865346703,5
2020-06-28-170227,170227,0,0,1,716,0.0,82.97115782332533,6
2020-06-29-170227,170227,1,0,1,717,0.0,79.82736400264062,0
2020-06-30-170227,170227,0,0,1,717,0.6,73.12463523784511,1
2020-07-01-170227,170227,0,0,2,717,1.0,137.45702969011916,2
2020-07-02-170227,170227,0,0,2,717,0.0,92.88793774692115,3
2020-07-03-170227,170227,1,0,5,718,0.6,106.29944690636822,4
2020-07-04-170227,170227,0,0,2,718,0.2,144.26030037340993,5
2020-07-05-170227,170227,0,0,0,718,0.4,142.2278443843051,6
2020-07-06-170227,170227,0,0,2,718,0.2,117.6073913109217,0
2020-07-07-170227,170227,0,0,1,718,0.8,110.35874773202003,1
2020-07-08-170227,170227,0,0,2,718,0.4,93.4475473385393,2
2020-07-09-170227,170227,0,0,1,718,0.8,87.60005358092056,3
2020-07-10-170227,170227,0,0,1,718,0.8,141.17858088360347,4
2020-07-11-170227,170227,0,0,0,718,0.0,122.89995553701402,5
2020-07-12-170227,170227,1,1,0,719,0.4,89.14186885210476,6
2020-07-13-170227,170227,1,0,4,720,0.4,81.95723455416383,0
2020-07-14-170227,170227,1,0,2,721,0.8,91.82698623467056,1
2020-07-15-170227,170227,2,0,3,723,1.0,73.81318890927446,2
2020-07-16-170227,170227,2,0,2,725,0.6,66.14935525490657,3
2020-07-17-170227,170227,5,0,4,730,1.4,59.63688670090646,4
2020-07-18-170227,170227,2,0,2,732,0.8,76.03332781894477,5
2020-07-19-170227,170227,0,0,0,732,0.6,90.01148822832494,6
2020-07-20-170227,170227,2,0,4,734,0.8,80.40008233335814,0
2020-07-21-170227,170227,1,0,0,735,0.2,88.18486913040817,1
2020-07-22-170227,170227,2,0,4,737,0.6,81.36015357451575,2
2020-07-23-170227,170227,1,0,5,738,0.6,91.31888621956534,3
2020-07-24-170227,170227,1,0,2,739,1.0,80.3369721811878,4
2020-07-25-170227,170227,0,0,2,739,0.4,77.32552275415472,5
2020-07-26-170227,170227,0,0,2,739,0.2,77.88106758399832,6
2020-07-27-170227,170227,4,0,4,743,2.2,80.78577334919746,0
2020-07-28-170227,170227,2,0,5,745,1.2,90.40536180532196,1
2020-07-29-170227,170227,3,0,7,748,1.4,94.1671081663746,2
2020-07-30-170227,170227,2,0,8,750,2.2,103.43308468104789,3
2020-07-31-170227,170227,4,0,9,754,3.6,129.5618336077907,4
2020-08-01-170227,170227,2,0,2,756,1.0,59.47953885960257,5
2020-08-02-170227,170227,0,0,2,756,0.4,369.4709237390434,6
2020-08-03-170227,170227,4,0,6,760,3.6,356.7777510601254,0
2020-08-04-170227,170227,0,0,12,760,4.0,357.3078803820955,1
2020-08-05-170227,170227,4,0,7,764,4.0,341.118606972902,2
2020-08-06-170227,170227,5,0,7,769,2.4,351.51488138355535,3
2020-08-07-170227,170227,2,0,7,771,1.4,329.1749267033624,4
2020-08-08-170227,170227,2,0,9,773,3.2,338.7713012098413,5
2020-08-09-170227,170227,2,0,0,775,0.8,335.0315669704426,6
2020-08-10-170227,170227,4,0,16,779,2.0,45.971014587945646,0
2020-08-11-170227,170227,5,0,8,784,3.0,88.50837361405014,1
2020-08-12-170227,170227,7,0,6,791,5.2,138.75113374483914,2
2020-08-13-170227,170227,8,0,9,799,3.4,188.40579918335874,3
2020-08-14-170227,170227,9,0,4,808,2.4,242.54474974907052,4
2020-08-15-170227,170227,2,0,1,810,2.2,281.40129158519073,5
2020-08-16-170227,170227,2,0,4,812,2.4,289.9735372362809,6
2020-08-17-170227,170227,6,0,5,818,2.2,310.584645537126,0
2020-08-18-170227,170227,12,0,8,830,6.4,303.63592068545825,1
2020-08-19-170227,170227,7,0,8,837,3.2,337.3983552587028,2
2020-08-20-170227,170227,7,0,6,844,2.0,287.2477808425494,3
2020-08-21-170227,170227,7,0,6,851,4.0,288.41683476123865,4
2020-08-22-170227,170227,9,0,5,860,1.8,318.09896345388734,5
2020-08-23-170227,170227,0,0,0,860,1.0,332.07416875007135,6
2020-08-24-170227,170227,16,0,9,876,7.2,317.20727068559427,0
2020-08-25-170227,170227,8,0,9,884,5.4,320.2653790664561,1
2020-08-26-170227,170227,6,0,12,890,3.4,326.10978758860676,2
2020-08-27-170227,170227,9,0,10,899,3.8,366.18027032673774,3
2020-08-28-170227,170227,4,0,9,903,3.2,359.7689862880775,4
2020-08-29-170227,170227,1,0,2,904,1.0,365.1410320830415,5
2020-08-30-170227,170227,4,0,10,908,2.2,359.0293588092428,6
2020-08-31-170227,170227,5,0,15,913,5.8,316.93207361931866,0
2020-09-01-170227,170227,8,0,17,921,5.4,311.012083304007,1
2020-09-02-170227,170227,8,0,11,929,5.4,575.055102619284,2
2020-09-03-170227,170227,6,0,21,935,8.0,517.4015071150327,3
2020-09-04-170227,170227,6,0,16,941,6.4,515.9538943288477,4
2020-09-05-170227,170227,5,0,0,946,3.2,479.2508900042082,5
2020-09-06-170227,170227,0,0,2,946,1.8,502.04696255440257,6
2020-09-07-170227,170227,9,0,17,955,5.2,500.7117322974351,0
2020-09-08-170227,170227,9,1,16,964,6.8,499.0395562160169,1
2020-09-09-170227,170227,12,0,21,976,3.8,522.1967511181365,2
2020-09-10-170227,170227,10,0,11,986,5.2,386.34363593529963,3
2020-09-11-170227,170227,9,0,18,995,4.2,409.0963964755446,4
2020-09-12-170227,170227,2,0,0,997,3.0,436.5574940343398,5
2020-09-13-170227,170227,10,0,3,1007,2.8,449.5577377465762,6
2020-09-14-170227,170227,15,0,16,1022,5.8,492.43056172169446,0
2020-09-15-170227,170227,17,0,8,1039,9.0,566.8399904740904,1
2020-09-16-170227,170227,11,0,24,1050,5.6,658.7210770653169,2
2020-09-17-170227,170227,21,0,11,1071,8.2,612.7238574552215,3
2020-09-18-170227,170227,16,0,14,1087,7.6,655.8142089166128,4
2020-09-19-170227,170227,0,0,8,1087,2.2,690.6737181049614,5
2020-09-20-170227,170227,2,0,11,1089,2.8,668.8390116357014,6
2020-09-21-170227,170227,17,1,8,1106,8.4,580.483324440145,0
2020-09-22-170227,170227,16,1,3,1122,8.4,570.8400595445991,1
2020-09-23-170227,170227,21,0,7,1143,10.4,582.690858876487,2
2020-09-24-170227,170227,11,1,8,1154,6.4,597.7907860042467,3
2020-09-25-170227,170227,18,0,9,1172,7.8,560.2548009237557,4
2020-09-26-170227,170227,0,0,3,1172,0.2,652.602286153368,5
2020-09-27-170227,170227,3,0,4,1175,1.6,584.1389589102068,6
2020-09-28-170227,170227,16,0,9,1191,4.8,585.2061272046467,0
2020-09-29-170227,170227,8,0,25,1199,3.2,608.7806764305615,1
2020-09-30-170227,170227,24,0,15,1223,4.4,538.4233253125526,2
2020-10-01-170227,170227,11,0,24,1234,3.8,0.0,3
2020-10-02-170227,170227,14,0,19,1248,5.0,1425.333724850248,4
2020-10-03-170227,170227,8,0,8,1256,2.4,2300.7543067659635,5
2020-10-04-170227,170227,11,1,8,1267,3.0,2339.306108117925,6
2020-10-05-170227,170227,8,1,30,1275,4.8,1908.295609910855,0
2020-10-06-170227,170227,3,0,30,1278,6.0,1612.5172905093586,1
2020-10-07-170227,170227,7,0,17,1285,8.6,1308.193302214983,2
2020-10-08-170227,170227,8,0,26,1293,8.4,1087.984699533647,3
2020-10-09-170227,170227,9,2,27,1302,16.6,1166.798959020135,4
2020-10-10-170227,170227,3,0,10,1305,2.2,77.03095554772119,5
2020-10-11-170227,170227,4,0,9,1309,5.0,127.28376103400998,6
2020-10-12-170227,170227,9,0,45,1318,6.0,210.593100614736,0
2020-10-13-170227,170227,25,0,30,1343,10.8,321.42809313491784,1
2020-10-14-170227,170227,15,0,25,1358,8.0,559.5760170568856,2
2020-10-15-170227,170227,24,0,31,1382,13.2,709.2899646149281,3
2020-10-16-170227,170227,19,0,30,1401,13.6,1010.8090895162586,4
2020-10-17-170227,170227,8,0,10,1409,2.8,1190.2905762179225,5
2020-10-18-170227,170227,8,0,38,1417,2.0,1207.8771066974027,6
2020-10-19-170227,170227,30,0,17,1447,15.4,1190.540315994372,0
2020-10-20-170227,170227,30,0,36,1477,14.2,1314.047511758975,1
2020-10-21-170227,170227,17,0,43,1494,15.6,1453.7229277679344,2
2020-10-22-170227,170227,26,0,25,1520,12.0,1482.3792056969878,3
2020-10-23-170227,170227,27,1,74,1547,27.6,1566.911331016161,4
2020-10-24-170227,170227,10,0,16,1557,4.4,1798.360380037148,5
2020-10-25-170227,170227,9,0,23,1566,8.2,1851.8762450300308,6
2020-10-26-170227,170227,45,0,37,1611,26.2,1658.4221400278957,0
2020-10-27-170227,170227,30,0,23,1641,20.4,2045.7230771064194,1
2020-10-28-170227,170227,25,1,16,1666,20.6,2137.2015475867365,2
2020-10-29-170227,170227,31,0,29,1697,20.4,2204.659273864533,3
2020-10-30-170227,170227,30,1,29,1727,17.4,2039.6345158275922,4
2020-10-31-170227,170227,10,0,0,1737,7.8,2324.8805873419747,5
2020-11-01-170227,170227,38,0,0,1775,13.6,873.8511623288468,6
2020-11-02-170227,170227,17,0,0,1792,8.6,2040.6523450240284,0
2020-11-03-170227,170227,36,0,0,1828,20.4,1767.1784759747331,1
2020-11-04-170227,170227,43,0,0,1871,17.8,2123.608517163285,2
2020-11-05-170227,170227,25,0,0,1896,18.4,2176.5902355738485,3
2020-11-06-170227,170227,74,1,0,1970,26.2,2333.1028554642207,4
2020-11-07-170227,170227,16,2,0,1986,8.6,2448.5200205686056,5
2020-11-08-170227,170227,23,0,0,2009,16.2,2351.5738814183187,6
2020-11-09-170227,170227,37,1,0,2046,23.6,2418.0253505547753,0
2020-11-10-170227,170227,23,0,0,2069,15.6,976.2880098352239,1
2020-11-11-170227,170227,16,2,0,2085,15.8,1213.9989249811574,2
2020-11-12-170227,170227,29,1,0,2114,22.8,1410.027576560779,3
2020-11-13-170227,170227,29,0,0,2143,25.0,1620.2872009297068,4
2020-03-01-170228,170228,0,0,2,0,0.16666666666666666,0.0,6
2020-03-02-170228,170228,0,0,6,0,0.0,119.75013411856676,0
2020-03-03-170228,170228,0,0,10,0,0.16666666666666666,481.1306580635907,1
2020-03-04-170228,170228,0,0,26,0,0.16666666666666666,508.18355242159896,2
2020-03-05-170228,170228,1,0,8,1,0.3333333333333333,554.728576644872,3
2020-03-06-170228,170228,1,0,18,2,0.16666666666666666,471.8995662152653,4
2020-03-07-170228,170228,0,0,5,2,0.16666666666666666,492.6519043208316,5
2020-03-08-170228,170228,0,0,7,2,0.16666666666666666,472.762392289771,6
2020-03-09-170228,170228,0,0,26,2,0.6666666666666666,471.34480213575335,0
2020-03-10-170228,170228,0,0,13,2,2.333333333333333,2469.7138198762063,1
2020-03-11-170228,170228,1,0,19,3,1.8333333333333333,2072.0573717045268,2
2020-03-12-170228,170228,0,0,18,3,1.3333333333333333,1652.0392541658075,3
2020-03-13-170228,170228,3,0,19,6,3.6666666666666665,1151.2822642263832,4
2020-03-14-170228,170228,0,0,12,6,2.0,927.1464757533392,5
2020-03-15-170228,170228,2,0,7,8,3.0,665.071885370761,6
2020-03-16-170228,170228,6,0,19,14,9.0,214.03151122014765,0
2020-03-17-170228,170228,10,0,8,24,9.0,326.7704850573908,1
2020-03-18-170228,170228,26,0,11,50,16.5,403.89517559393437,2
2020-03-19-170228,170228,8,0,7,58,17.666666666666668,527.7409237161319,3
2020-03-20-170228,170228,18,0,13,76,21.5,595.0318595240755,4
2020-03-21-170228,170228,5,0,8,81,8.833333333333334,679.9004053701453,5
2020-03-22-170228,170228,7,0,4,88,9.333333333333334,673.0435725937969,6
2020-03-23-170228,170228,26,0,4,114,23.5,646.01817064962,0
2020-03-24-170228,170228,13,0,6,127,19.33333333333333,740.5279355973535,1
2020-03-25-170228,170228,19,0,5,146,16.5,750.603383379356,2
2020-03-26-170228,170228,18,0,5,164,13.833333333333336,730.3372576703275,3
2020-03-27-170228,170228,19,1,5,183,19.166666666666668,838.7102284568339,4
2020-03-28-170228,170228,12,0,21,195,5.333333333333333,830.9009083743923,5
2020-03-29-170228,170228,7,1,12,202,5.166666666666667,817.2674763805361,6
2020-03-30-170228,170228,19,0,10,221,16.333333333333332,615.4999033490822,0
2020-03-31-170228,170228,8,0,8,229,11.0,570.6446640315046,1
2020-04-01-170228,170228,11,0,34,240,10.166666666666666,87.35843932749977,2
2020-04-02-170228,170228,7,0,8,247,10.666666666666666,382.1213346588094,3
2020-04-03-170228,170228,13,0,58,260,11.833333333333336,187.4955147570088,4
2020-04-04-170228,170228,8,0,8,268,3.6666666666666665,248.24108154712903,5
2020-04-05-170228,170228,4,0,19,272,3.1666666666666665,264.813903830331,6
2020-04-06-170228,170228,4,0,14,276,9.0,281.4428574821959,0
2020-04-07-170228,170228,6,0,8,282,7.666666666666668,314.5428384872904,1
2020-04-08-170228,170228,5,5,31,287,8.0,338.3796267733494,2
2020-04-09-170228,170228,5,0,5,292,10.166666666666666,359.91681125304655,3
2020-04-10-170228,170228,5,1,9,297,7.833333333333332,78.88208843347607,4
2020-04-11-170228,170228,21,0,3,318,2.6666666666666665,135.2010227900742,5
2020-04-12-170228,170228,12,0,0,330,1.5,182.48289674117223,6
2020-04-13-170228,170228,10,0,11,340,8.333333333333334,198.7604975092497,0
2020-04-14-170228,170228,8,0,7,348,8.0,271.28198310461084,1
2020-04-15-170228,170228,34,0,7,382,10.0,331.700316305167,2
2020-04-16-170228,170228,8,0,5,390,7.333333333333332,415.87775548950503,3
2020-04-17-170228,170228,58,0,2,448,5.833333333333332,418.118899757182,4
2020-04-18-170228,170228,8,0,0,456,1.6666666666666667,449.5983335188207,5
2020-04-19-170228,170228,19,0,2,475,3.333333333333333,411.38327026792047,6
2020-04-20-170228,170228,14,0,6,489,7.833333333333332,415.90924351774026,0
2020-04-21-170228,170228,8,1,5,497,6.166666666666668,408.97102341341963,1
2020-04-22-170228,170228,31,0,5,528,5.166666666666667,362.9011232834109,2
2020-04-23-170228,170228,5,0,2,533,2.6666666666666665,365.33040059681014,3
2020-04-24-170228,170228,9,0,4,542,4.333333333333333,290.7388646331482,4
2020-04-25-170228,170228,3,0,0,545,1.5,309.15371945341957,5
2020-04-26-170228,170228,0,0,1,545,1.3333333333333333,295.8989913212025,6
2020-04-27-170228,170228,11,1,3,556,6.0,239.96049273219836,0
2020-04-28-170228,170228,7,0,2,563,5.0,235.39707994685926,1
2020-04-29-170228,170228,7,0,6,570,5.0,225.0683869367113,2
2020-04-30-170228,170228,5,0,12,575,2.833333333333333,278.08586290389275,3
2020-05-01-170228,170228,2,0,7,577,1.1666666666666667,372.410852818446,4
2020-05-02-170228,170228,0,0,0,577,1.5,286.17326527247593,5
2020-05-03-170228,170228,2,0,0,579,0.6666666666666666,146.32442742638312,6
2020-05-04-170228,170228,6,0,5,585,3.0,115.65679947170962,0
2020-05-05-170228,170228,5,0,5,590,4.333333333333333,112.26127862463856,1
2020-05-06-170228,170228,5,0,4,595,4.166666666666667,124.28774022291475,2
2020-05-07-170228,170228,2,0,2,597,3.5,140.1521896894579,3
2020-05-08-170228,170228,4,0,6,601,4.5,147.45312739231326,4
2020-05-09-170228,170228,0,0,2,601,0.0,195.75930523919575,5
2020-05-10-170228,170228,1,0,0,602,0.5,413.74170832497396,6
2020-05-11-170228,170228,3,0,12,605,4.666666666666667,371.6894719105129,0
2020-05-12-170228,170228,2,0,6,607,4.333333333333333,393.3020746278263,1
2020-05-13-170228,170228,6,1,4,613,7.333333333333332,332.8950036213954,2
2020-05-14-170228,170228,12,0,2,625,7.5,339.71803654792143,3
2020-05-15-170228,170228,7,1,6,632,6.166666666666668,348.13757204083674,4
2020-05-16-170228,170228,0,0,0,632,1.6666666666666667,347.8185390314323,5
2020-05-17-170228,170228,0,0,0,632,0.0,350.83397871344727,6
2020-05-18-170228,170228,5,0,5,637,7.333333333333332,352.21488090954267,0
2020-05-19-170228,170228,5,0,3,642,5.166666666666667,362.85382352847597,1
2020-05-20-170228,170228,4,0,0,646,4.333333333333333,305.99541231982715,2
2020-05-21-170228,170228,2,0,3,648,3.8333333333333335,279.21486223486636,3
2020-05-22-170228,170228,6,0,3,654,4.0,260.78204291650684,4
2020-05-23-170228,170228,2,0,1,656,0.3333333333333333,301.94384360282186,5
2020-05-24-170228,170228,0,0,2,656,0.0,305.4764317983272,6
2020-05-25-170228,170228,12,0,2,668,4.833333333333333,231.36347702991333,0
2020-05-26-170228,170228,6,0,1,674,3.1666666666666665,232.91867229568658,1
2020-05-27-170228,170228,4,0,2,678,3.6666666666666665,269.59338494096244,2
2020-05-28-170228,170228,2,0,0,680,2.333333333333333,246.94727893976815,3
2020-05-29-170228,170228,6,0,1,686,1.6666666666666667,228.15266484251862,4
2020-05-30-170228,170228,0,0,0,686,0.0,218.5707718009983,5
2020-05-31-170228,170228,0,0,0,686,0.0,221.47215829421572,6
2020-06-01-170228,170228,5,0,2,691,1.6666666666666667,241.56148870689154,0
2020-06-02-170228,170228,3,0,3,694,2.0,68.70475273313126,1
2020-06-03-170228,170228,0,0,1,694,1.8333333333333333,52.71014626467209,2
2020-06-04-170228,170228,3,0,3,697,2.5,55.60849949728149,3
2020-06-05-170228,170228,3,0,0,700,2.333333333333333,69.50817401517337,4
2020-06-06-170228,170228,1,0,0,701,1.0,83.05200609087589,5
2020-06-07-170228,170228,2,1,0,703,0.0,86.89912214111521,6
2020-06-08-170228,170228,2,0,1,705,2.0,88.16954203030978,0
2020-06-09-170228,170228,1,0,1,706,1.5,109.99415617646989,1
2020-06-10-170228,170228,2,0,1,708,2.0,274.68853512814724,2
2020-06-11-170228,170228,0,2,3,708,1.3333333333333333,257.21593210520086,3
2020-06-12-170228,170228,1,0,0,709,1.3333333333333333,233.34134540874481,4
2020-06-13-170228,170228,0,0,0,709,0.0,186.2133876713614,5
2020-06-14-170228,170228,0,0,0,709,0.16666666666666666,148.32214157279054,6
2020-06-15-170228,170228,2,0,0,711,1.3333333333333333,86.87492329549994,0
2020-06-16-170228,170228,3,0,1,714,0.6666666666666666,109.09779736794992,1
2020-06-17-170228,170228,1,0,1,715,1.0,96.29882282678088,2
2020-06-18-170228,170228,3,0,0,718,0.8333333333333334,91.1241827317047,3
2020-06-19-170228,170228,0,0,2,718,0.3333333333333333,83.90806660717692,4
2020-06-20-170228,170228,0,0,0,718,0.3333333333333333,96.88012875876808,5
2020-06-21-170228,170228,0,0,0,718,0.16666666666666666,97.91975075717407,6
2020-06-22-170228,170228,1,0,0,719,0.8333333333333334,78.69236981047379,0
2020-06-23-170228,170228,1,0,1,720,0.6666666666666666,75.79802227283447,1
2020-06-24-170228,170228,1,0,0,721,1.1666666666666667,69.45672950638178,2
2020-06-25-170228,170228,3,0,0,724,0.5,71.71285324131848,3
2020-06-26-170228,170228,0,0,1,724,1.1666666666666667,78.27049581398614,4
2020-06-27-170228,170228,0,0,0,724,0.16666666666666666,71.80707217295657,5
2020-06-28-170228,170228,0,0,0,724,0.0,74.94992902357492,6
2020-06-29-170228,170228,0,0,0,724,0.16666666666666666,72.37669747267618,0
2020-06-30-170228,170228,1,0,0,725,0.3333333333333333,67.44323137927631,1
2020-07-01-170228,170228,1,0,1,726,0.6666666666666666,121.88342341222403,2
2020-07-02-170228,170228,0,0,0,726,0.0,90.95520599504874,3
2020-07-03-170228,170228,2,0,1,728,0.3333333333333333,100.31264559443676,4
2020-07-04-170228,170228,0,1,0,728,0.0,131.51882891258458,5
2020-07-05-170228,170228,0,0,1,728,0.3333333333333333,128.17367396470397,6
2020-07-06-170228,170228,0,0,0,728,0.0,107.04574546208833,0
2020-07-07-170228,170228,1,0,0,729,0.6666666666666666,99.83806161591176,1
2020-07-08-170228,170228,0,0,0,729,0.16666666666666666,85.43404137936622,2
2020-07-09-170228,170228,0,0,2,729,0.3333333333333333,80.24226853839349,3
2020-07-10-170228,170228,1,0,0,730,0.5,124.00041726321174,4
2020-07-11-170228,170228,0,0,0,730,0.16666666666666666,105.75970929635442,5
2020-07-12-170228,170228,0,0,0,730,0.5,76.80088125651781,6
2020-07-13-170228,170228,0,0,3,730,0.6666666666666666,72.05760993156849,0
2020-07-14-170228,170228,0,0,2,730,0.8333333333333334,84.72631796431499,1
2020-07-15-170228,170228,1,0,1,731,2.833333333333333,69.7663414219256,2
2020-07-16-170228,170228,0,0,2,731,0.5,63.785870131638696,3
2020-07-17-170228,170228,1,0,4,732,2.1666666666666665,59.39029720758586,4
2020-07-18-170228,170228,0,0,0,732,1.3333333333333333,76.37736686586162,5
2020-07-19-170228,170228,1,0,0,733,0.3333333333333333,89.81641262055336,6
2020-07-20-170228,170228,0,0,6,733,1.1666666666666667,76.35622092916822,0
2020-07-21-170228,170228,0,0,0,733,0.5,84.70244392944966,1
2020-07-22-170228,170228,0,0,4,733,0.8333333333333334,78.69763970468793,2
2020-07-23-170228,170228,2,0,2,735,0.6666666666666666,89.06545190426161,3
2020-07-24-170228,170228,0,0,0,735,1.3333333333333333,79.88576138646793,4
2020-07-25-170228,170228,0,0,5,735,0.3333333333333333,77.29935193811885,5
2020-07-26-170228,170228,0,0,3,735,0.5,77.84583490069197,6
2020-07-27-170228,170228,3,0,4,738,2.6666666666666665,81.31832420293537,0
2020-07-28-170228,170228,2,0,1,740,1.5,87.55499286114737,1
2020-07-29-170228,170228,1,0,5,741,2.0,89.37031671390122,2
2020-07-30-170228,170228,2,0,2,743,3.333333333333333,93.59446819406278,3
2020-07-31-170228,170228,4,0,1,747,3.333333333333333,117.68778221194914,4
2020-08-01-170228,170228,0,0,2,747,1.0,51.998879757573064,5
2020-08-02-170228,170228,0,0,0,747,0.3333333333333333,327.5576999165377,6
2020-08-03-170228,170228,6,0,3,753,2.5,324.60325145240586,0
2020-08-04-170228,170228,0,0,4,753,4.0,320.45375780100204,1
2020-08-05-170228,170228,4,1,5,757,3.6666666666666665,308.80943878631354,2
2020-08-06-170228,170228,2,0,0,759,3.333333333333333,318.5389486089301,3
2020-08-07-170228,170228,0,0,3,759,1.8333333333333333,298.7035669135447,4
2020-08-08-170228,170228,5,0,2,764,2.1666666666666665,305.8097046816347,5
2020-08-09-170228,170228,3,0,3,767,1.0,302.3756321534288,6
2020-08-10-170228,170228,4,0,9,771,2.333333333333333,39.14829431855433,0
2020-08-11-170228,170228,1,0,6,772,4.166666666666667,78.72328855475693,1
2020-08-12-170228,170228,5,0,3,777,4.833333333333333,125.65752595240164,2
2020-08-13-170228,170228,2,0,5,779,4.0,168.60566107651854,3
2020-08-14-170228,170228,1,0,3,780,3.1666666666666665,209.64628736221877,4
2020-08-15-170228,170228,2,0,1,782,2.5,243.72837693760204,5
2020-08-16-170228,170228,0,0,4,782,2.1666666666666665,250.1434476833149,6
2020-08-17-170228,170228,3,0,8,785,2.6666666666666665,271.86747342124795,0
2020-08-18-170228,170228,4,0,7,789,7.166666666666668,265.8953838032378,1
2020-08-19-170228,170228,5,0,10,794,2.833333333333333,289.8165659313504,2
2020-08-20-170228,170228,0,0,9,794,2.5,250.8811339661317,3
2020-08-21-170228,170228,3,0,7,797,4.5,254.72838414910765,4
2020-08-22-170228,170228,2,0,2,799,2.5,281.6826946156634,5
2020-08-23-170228,170228,3,0,1,802,0.8333333333333334,294.6613551714894,6
2020-08-24-170228,170228,9,0,7,811,8.333333333333334,280.03299532529843,0
2020-08-25-170228,170228,6,0,8,817,6.166666666666668,289.38903138408733,1
2020-08-26-170228,170228,3,0,7,820,5.0,295.7757498412664,2
2020-08-27-170228,170228,5,0,7,825,4.5,332.2105486815675,3
2020-08-28-170228,170228,3,0,3,828,4.333333333333333,326.86824257856483,4
2020-08-29-170228,170228,1,0,6,829,1.0,327.2337803287745,5
2020-08-30-170228,170228,4,0,0,833,2.1666666666666665,317.6818869209332,6
2020-08-31-170228,170228,8,0,11,841,5.5,276.2506215108931,0
2020-09-01-170228,170228,7,0,10,848,5.5,278.49836709156455,1
2020-09-02-170228,170228,10,0,6,858,5.666666666666668,533.2230827677856,2
2020-09-03-170228,170228,9,0,13,867,6.0,466.55264025220004,3
2020-09-04-170228,170228,7,0,14,874,6.333333333333332,467.9768040368836,4
2020-09-05-170228,170228,2,0,5,876,3.6666666666666665,440.7357504660763,5
2020-09-06-170228,170228,1,0,1,877,2.0,459.1834110772469,6
2020-09-07-170228,170228,7,1,13,884,4.333333333333333,464.8266935545871,0
2020-09-08-170228,170228,8,0,7,892,8.5,459.0285908226151,1
2020-09-09-170228,170228,7,0,13,899,5.833333333333332,472.119822608581,2
2020-09-10-170228,170228,7,0,8,906,10.0,344.1807422023487,3
2020-09-11-170228,170228,3,1,9,909,8.0,370.78302170218933,4
2020-09-12-170228,170228,6,0,0,915,2.1666666666666665,408.7193551827771,5
2020-09-13-170228,170228,0,0,2,915,3.8333333333333335,423.2675471193012,6
2020-09-14-170228,170228,11,0,4,926,6.666666666666668,466.7298829166789,0
2020-09-15-170228,170228,10,0,3,936,15.166666666666664,541.6089180015756,1
2020-09-16-170228,170228,6,0,9,942,9.0,630.1381602689738,2
2020-09-17-170228,170228,13,0,4,955,12.333333333333336,588.2589455216689,3
2020-09-18-170228,170228,14,0,8,969,11.166666666666664,621.7082787074115,4
2020-09-19-170228,170228,5,0,2,974,2.1666666666666665,648.7953811311386,5
2020-09-20-170228,170228,1,0,7,975,2.0,621.5101170556923,6
2020-09-21-170228,170228,13,0,5,988,13.0,531.2774737601403,0
2020-09-22-170228,170228,7,0,8,995,12.833333333333336,524.1851383400792,1
2020-09-23-170228,170228,13,2,12,1008,14.0,526.5878532965721,2
2020-09-24-170228,170228,8,0,18,1016,8.333333333333334,538.09527414228,3
2020-09-25-170228,170228,9,0,21,1025,11.333333333333336,494.5254818963249,4
2020-09-26-170228,170228,0,0,1,1025,0.16666666666666666,579.339175921017,5
2020-09-27-170228,170228,2,0,8,1027,1.3333333333333333,518.2856601767712,6
2020-09-28-170228,170228,4,0,5,1031,8.833333333333334,520.3209155247675,0
2020-09-29-170228,170228,3,0,16,1034,4.166666666666667,540.4427657237079,1
2020-09-30-170228,170228,9,0,11,1043,8.166666666666666,491.75405441534235,2
2020-10-01-170228,170228,4,0,17,1047,7.666666666666668,0.0,3
2020-10-02-170228,170228,8,0,19,1055,11.666666666666664,1291.191701019131,4
2020-10-03-170228,170228,2,0,2,1057,3.333333333333333,2038.3837654936092,5
2020-10-04-170228,170228,7,0,4,1064,4.666666666666667,2072.65051890381,6
2020-10-05-170228,170228,5,2,22,1069,6.666666666666668,1700.7162425259844,0
2020-10-06-170228,170228,8,0,15,1077,6.333333333333332,1444.7479463983764,1
2020-10-07-170228,170228,12,2,13,1089,9.5,1187.9544669777997,2
2020-10-08-170228,170228,18,0,11,1107,7.5,1009.8734176977764,3
2020-10-09-170228,170228,21,0,15,1128,17.833333333333332,1078.1875558808372,4
2020-10-10-170228,170228,1,0,2,1129,3.0,78.61861387278904,5
2020-10-11-170228,170228,8,0,9,1137,5.166666666666667,131.15968190810293,6
2020-10-12-170228,170228,5,0,27,1142,7.0,206.90816313402783,0
2020-10-13-170228,170228,16,0,15,1158,11.833333333333336,314.7832093298939,1
2020-10-14-170228,170228,11,0,17,1169,9.666666666666666,546.753282862635,2
2020-10-15-170228,170228,17,0,22,1186,16.5,673.4852068043961,3
2020-10-16-170228,170228,19,0,19,1205,14.5,948.4232477956684,4
2020-10-17-170228,170228,2,0,8,1207,3.6666666666666665,1098.8460669242286,5
2020-10-18-170228,170228,4,0,9,1211,3.1666666666666665,1114.4741049337424,6
2020-10-19-170228,170228,22,2,15,1233,18.33333333333333,1089.507517297765,0
2020-10-20-170228,170228,15,1,21,1248,14.5,1198.9521777232087,1
2020-10-21-170228,170228,13,0,33,1261,18.5,1313.443784139025,2
2020-10-22-170228,170228,11,0,28,1272,17.666666666666668,1328.4792705343957,3
2020-10-23-170228,170228,15,0,38,1287,17.166666666666668,1413.3518937491106,4
2020-10-24-170228,170228,2,1,9,1289,7.166666666666668,1621.985611641627,5
2020-10-25-170228,170228,9,2,17,1298,8.0,1678.7596664853982,6
2020-10-26-170228,170228,27,1,29,1325,29.33333333333333,1504.4797791120995,0
2020-10-27-170228,170228,15,0,19,1340,20.33333333333333,1825.0680801315166,1
2020-10-28-170228,170228,17,0,19,1357,21.166666666666668,1914.0952452976662,2
2020-10-29-170228,170228,22,1,30,1379,15.833333333333336,1972.3459414750696,3
2020-10-30-170228,170228,19,2,33,1398,22.0,1797.4152197515755,4
2020-10-31-170228,170228,8,0,0,1406,10.333333333333334,2037.0940949394208,5
2020-11-01-170228,170228,9,3,0,1415,22.5,783.9806060053033,6
2020-11-02-170228,170228,15,0,0,1430,11.166666666666664,1865.7801483166304,0
2020-11-03-170228,170228,21,0,0,1451,24.0,1636.656235355731,1
2020-11-04-170228,170228,33,1,0,1484,21.66666666666667,1970.1301569150949,2
2020-11-05-170228,170228,28,0,0,1512,22.0,2030.4510268356323,3
2020-11-06-170228,170228,38,1,0,1550,32.666666666666664,2167.825043406556,4
2020-11-07-170228,170228,9,2,0,1559,11.5,2246.0295453789518,5
2020-11-08-170228,170228,17,1,0,1576,17.666666666666668,2157.405593329728,6
2020-11-09-170228,170228,29,0,0,1605,26.83333333333333,2178.0534248202757,0
2020-11-10-170228,170228,19,0,0,1624,21.0,891.4467109898717,1
2020-11-11-170228,170228,19,2,0,1643,16.5,1116.206558394034,2
2020-11-12-170228,170228,30,0,0,1673,22.16666666666667,1277.9793216201426,3
2020-11-13-170228,170228,33,2,0,1706,25.0,1431.7176591274772,4
2020-03-01-170229,170229,0,0,0,0,0.0,0.0,6
2020-03-02-170229,170229,0,0,0,0,0.0,3.592681185292615,0
2020-03-03-170229,170229,0,0,0,0,0.0,21.44541149302148,1
2020-03-04-170229,170229,0,0,0,0,0.16666666666666666,20.477043152197947,2
2020-03-05-170229,170229,0,0,0,0,0.0,20.82418008466396,3
2020-03-06-170229,170229,0,1,0,0,0.16666666666666666,19.330813850164795,4
2020-03-07-170229,170229,0,0,0,0,0.0,19.976892551248426,5
2020-03-08-170229,170229,0,0,0,0,0.0,21.66237051287223,6
2020-03-09-170229,170229,0,0,0,0,0.5,21.700943622408353,0
2020-03-10-170229,170229,0,0,0,0,0.0,88.72491283666022,1
2020-03-11-170229,170229,0,0,0,0,0.16666666666666666,76.87763126832547,2
2020-03-12-170229,170229,0,0,0,0,0.16666666666666666,64.54009409821217,3
2020-03-13-170229,170229,0,0,0,0,0.5,51.849494869289096,4
2020-03-14-170229,170229,0,0,0,0,0.6666666666666666,35.80835322737013,5
2020-03-15-170229,170229,0,0,0,0,0.5,27.29816256815935,6
2020-03-16-170229,170229,0,0,0,0,0.16666666666666666,8.435208284344522,0
2020-03-17-170229,170229,0,0,0,0,1.6666666666666667,11.164946954537134,1
2020-03-18-170229,170229,0,0,0,0,1.6666666666666667,14.458985135902271,2
2020-03-19-170229,170229,0,0,0,0,3.0,19.49722108174653,3
2020-03-20-170229,170229,0,0,0,0,4.166666666666667,23.647413456402944,4
2020-03-21-170229,170229,0,0,0,0,1.8333333333333333,30.385529296444695,5
2020-03-22-170229,170229,0,0,0,0,0.3333333333333333,30.761217121693328,6
2020-03-23-170229,170229,0,1,0,0,5.0,30.455456010730735,0
2020-03-24-170229,170229,0,0,0,0,5.166666666666667,39.66344559073528,1
2020-03-25-170229,170229,0,0,0,0,3.5,47.56197312530876,2
2020-03-26-170229,170229,0,0,0,0,4.5,48.16859620028034,3
2020-03-27-170229,170229,0,0,0,0,3.1666666666666665,54.730622469749115,4
2020-03-28-170229,170229,0,0,0,0,1.5,51.16644472740428,5
2020-03-29-170229,170229,0,0,0,0,0.8333333333333334,50.51425572946546,6
2020-03-30-170229,170229,0,0,0,0,3.5,37.581745295797134,0
2020-03-31-170229,170229,0,0,0,0,2.1666666666666665,34.16708093702085,1
2020-04-01-170229,170229,0,0,0,0,3.0,6.0338422855134715,2
2020-04-02-170229,170229,0,0,0,0,3.0,16.350418072629235,3
2020-04-03-170229,170229,0,0,0,0,3.1666666666666665,10.12686106374221,4
2020-04-04-170229,170229,0,0,0,0,0.8333333333333334,16.65354690153961,5
2020-04-05-170229,170229,0,0,0,0,0.6666666666666666,16.53438949907687,6
2020-04-06-170229,170229,0,2,0,0,3.1666666666666665,16.43001108911251,0
2020-04-07-170229,170229,0,0,0,0,2.6666666666666665,19.339532608590538,1
2020-04-08-170229,170229,0,0,0,0,2.1666666666666665,22.096865033309854,2
2020-04-09-170229,170229,0,3,0,0,2.5,23.835246882437744,3
2020-04-10-170229,170229,0,0,0,0,1.3333333333333333,8.069892330222974,4
2020-04-11-170229,170229,0,0,0,0,1.3333333333333333,10.663293719514346,5
2020-04-12-170229,170229,0,0,0,0,0.16666666666666666,11.6843528688518,6
2020-04-13-170229,170229,0,0,0,0,2.1666666666666665,11.69870625815526,0
2020-04-14-170229,170229,0,1,0,0,1.0,15.840605937142955,1
2020-04-15-170229,170229,0,0,0,0,1.0,18.517869888390393,2
2020-04-16-170229,170229,0,0,0,0,1.0,22.255261811017434,3
2020-04-17-170229,170229,0,0,0,0,1.0,19.4581616190164,4
2020-04-18-170229,170229,0,0,0,0,0.5,18.5740163586761,5
2020-04-19-170229,170229,0,0,0,0,0.6666666666666666,18.240235875579163,6
2020-04-20-170229,170229,0,0,0,0,1.6666666666666667,21.0419946398694,0
2020-04-21-170229,170229,0,0,0,0,0.8333333333333334,21.46469672477557,1
2020-04-22-170229,170229,0,0,0,0,0.8333333333333334,19.505497017846807,2
2020-04-23-170229,170229,0,0,0,0,0.0,18.877526834596058,3
2020-04-24-170229,170229,0,0,0,0,0.6666666666666666,16.681537284325717,4
2020-04-25-170229,170229,0,0,0,0,0.6666666666666666,17.65192311995344,5
2020-04-26-170229,170229,0,0,0,0,0.6666666666666666,18.095711249339978,6
2020-04-27-170229,170229,0,0,0,0,1.0,12.906928530382714,0
2020-04-28-170229,170229,0,0,0,0,0.5,12.090823797410794,1
2020-04-29-170229,170229,0,0,0,0,0.5,12.149685371404942,2
2020-04-30-170229,170229,0,0,0,0,0.3333333333333333,18.883885697533678,3
2020-05-01-170229,170229,0,0,0,0,0.16666666666666666,26.66537719072977,4
2020-05-02-170229,170229,0,0,0,0,0.16666666666666666,12.603967302385783,5
2020-05-03-170229,170229,0,0,0,0,0.0,6.470443342498855,6
2020-05-04-170229,170229,0,0,0,0,1.3333333333333333,5.205012789814574,0
2020-05-05-170229,170229,0,0,0,0,1.1666666666666667,6.398003321346863,1
2020-05-06-170229,170229,0,0,0,0,1.1666666666666667,7.675304715109813,2
2020-05-07-170229,170229,0,0,0,0,0.3333333333333333,8.369149097952514,3
2020-05-08-170229,170229,0,0,0,0,1.1666666666666667,7.497993727676551,4
2020-05-09-170229,170229,0,0,0,0,0.3333333333333333,9.750536981545686,5
2020-05-10-170229,170229,0,0,0,0,0.3333333333333333,30.638993392915765,6
2020-05-11-170229,170229,0,0,0,0,1.1666666666666667,28.84828761036847,0
2020-05-12-170229,170229,0,0,0,0,0.6666666666666666,28.18958273477001,1
2020-05-13-170229,170229,0,0,0,0,1.8333333333333333,22.614719768389584,2
2020-05-14-170229,170229,0,0,0,0,1.5,20.473378112726813,3
2020-05-15-170229,170229,0,0,0,0,1.1666666666666667,19.558614910850057,4
2020-05-16-170229,170229,0,0,0,0,0.0,15.862615441158468,5
2020-05-17-170229,170229,0,0,0,0,0.16666666666666666,15.064548822271735,6
2020-05-18-170229,170229,0,0,0,0,0.6666666666666666,14.925134106805709,0
2020-05-19-170229,170229,0,1,0,0,0.8333333333333334,15.816434594152797,1
2020-05-20-170229,170229,0,0,0,0,0.6666666666666666,11.923760893724532,2
2020-05-21-170229,170229,0,0,0,0,0.5,10.841500403709922,3
2020-05-22-170229,170229,0,0,0,0,1.0,8.578192781196302,4
2020-05-23-170229,170229,0,0,0,0,0.0,12.003485302081474,5
2020-05-24-170229,170229,0,0,0,0,0.0,12.340171488280337,6
2020-05-25-170229,170229,0,0,0,0,0.8333333333333334,9.72570036039537,0
2020-05-26-170229,170229,0,0,0,0,0.8333333333333334,10.883101104214767,1
2020-05-27-170229,170229,0,0,0,0,0.5,12.060262996145042,2
2020-05-28-170229,170229,0,2,0,0,0.8333333333333334,11.0073684997178,3
2020-05-29-170229,170229,0,0,0,0,0.5,10.791324412000034,4
2020-05-30-170229,170229,0,0,0,0,0.16666666666666666,10.607199922752093,5
2020-05-31-170229,170229,0,0,0,0,0.5,11.715735479431716,6
2020-06-01-170229,170229,0,0,0,0,0.3333333333333333,15.812108880515853,0
2020-06-02-170229,170229,0,0,0,0,1.3333333333333333,7.092082836114295,1
2020-06-03-170229,170229,0,0,0,0,0.5,3.001491981319967,2
2020-06-04-170229,170229,0,0,0,0,0.8333333333333334,4.949902115270215,3
2020-06-05-170229,170229,0,0,0,0,0.6666666666666666,7.666944845768283,4
2020-06-06-170229,170229,0,0,0,0,0.16666666666666666,8.19443409107014,5
2020-06-07-170229,170229,0,0,0,0,0.0,8.050346887369646,6
2020-06-08-170229,170229,0,1,0,0,0.6666666666666666,7.987507741452793,0
2020-06-09-170229,170229,0,0,0,0,0.16666666666666666,9.457768612931915,1
2020-06-10-170229,170229,0,0,0,0,0.3333333333333333,15.718641666997765,2
2020-06-11-170229,170229,0,0,0,0,0.8333333333333334,16.02954669609504,3
2020-06-12-170229,170229,0,0,0,0,0.6666666666666666,14.823592010563955,4
2020-06-13-170229,170229,0,0,0,0,0.0,13.511928547253039,5
2020-06-14-170229,170229,0,0,0,0,0.16666666666666666,11.670496168728974,6
2020-06-15-170229,170229,0,0,0,0,1.8333333333333333,10.362606123312915,0
2020-06-16-170229,170229,0,0,0,0,0.5,11.863427147244913,1
2020-06-17-170229,170229,0,1,0,0,0.3333333333333333,11.815312365505843,2
2020-06-18-170229,170229,0,0,0,0,0.16666666666666666,9.17942770743786,3
2020-06-19-170229,170229,0,0,0,0,0.16666666666666666,8.022981354791057,4
2020-06-20-170229,170229,0,0,0,0,0.0,10.420229211560319,5
2020-06-21-170229,170229,0,0,0,0,0.3333333333333333,9.83388365924747,6
2020-06-22-170229,170229,0,0,0,0,0.0,8.532377797726818,0
2020-06-23-170229,170229,0,0,0,0,0.16666666666666666,6.760707720982133,1
2020-06-24-170229,170229,0,1,0,0,0.0,6.7983613166413175,2
2020-06-25-170229,170229,0,0,0,0,0.0,7.281697205383283,3
2020-06-26-170229,170229,0,0,0,0,0.3333333333333333,6.68378879600715,4
2020-06-27-170229,170229,0,0,0,0,0.16666666666666666,3.8322574255754165,5
2020-06-28-170229,170229,0,1,0,0,0.0,4.2894058632656344,6
2020-06-29-170229,170229,0,0,0,0,0.0,4.023972734891108,0
2020-06-30-170229,170229,0,0,0,0,0.3333333333333333,5.576036077279685,1
2020-07-01-170229,170229,0,0,0,0,0.3333333333333333,11.883037260765139,2
2020-07-02-170229,170229,0,0,0,0,0.0,15.294261419335992,3
2020-07-03-170229,170229,0,0,0,0,0.8333333333333334,7.946934276681466,4
2020-07-04-170229,170229,0,0,0,0,0.16666666666666666,12.263914405758177,5
2020-07-05-170229,170229,0,0,1,0,0.3333333333333333,12.183735646294975,6
2020-07-06-170229,170229,0,0,0,0,1.0,11.066680081493981,0
2020-07-07-170229,170229,0,0,1,0,0.3333333333333333,11.486978099251058,1
2020-07-08-170229,170229,0,0,0,0,0.6666666666666666,11.171521500004086,2
2020-07-09-170229,170229,0,0,0,0,0.6666666666666666,11.692637479750228,3
2020-07-10-170229,170229,0,0,0,0,0.3333333333333333,11.78436267592689,4
2020-07-11-170229,170229,0,1,0,0,0.0,9.36232288052963,5
2020-07-12-170229,170229,0,0,0,0,0.5,7.8485186638107916,6
2020-07-13-170229,170229,0,0,0,0,0.0,7.613756262319633,0
2020-07-14-170229,170229,0,0,0,0,0.3333333333333333,7.848023931385617,1
2020-07-15-170229,170229,0,0,0,0,0.8333333333333334,7.976863438661743,2
2020-07-16-170229,170229,0,0,0,0,0.0,10.058009253729772,3
2020-07-17-170229,170229,0,0,1,0,0.0,9.519005325811293,4
2020-07-18-170229,170229,0,0,0,0,0.3333333333333333,8.33715344914403,5
2020-07-19-170229,170229,1,0,1,1,0.0,9.748634287544036,6
2020-07-20-170229,170229,0,0,1,1,0.3333333333333333,17.384613124675372,0
2020-07-21-170229,170229,1,0,3,2,0.0,16.470382443747095,1
2020-07-22-170229,170229,0,0,1,2,0.16666666666666666,21.106499505164287,2
2020-07-23-170229,170229,0,0,0,2,0.16666666666666666,22.52447665462607,3
2020-07-24-170229,170229,0,0,1,2,0.3333333333333333,22.88941366190413,4
2020-07-25-170229,170229,0,0,0,2,0.6666666666666666,23.023987346746154,5
2020-07-26-170229,170229,0,0,0,2,0.16666666666666666,15.410886671300645,6
2020-07-27-170229,170229,0,0,0,2,0.3333333333333333,15.51292817512985,0
2020-07-28-170229,170229,0,0,0,2,1.0,15.748353813359515,1
2020-07-29-170229,170229,0,0,0,2,1.0,9.54851197397884,2
2020-07-30-170229,170229,0,0,0,2,1.1666666666666667,12.400831457939848,3
2020-07-31-170229,170229,1,0,0,3,0.5,14.282069251372246,4
2020-08-01-170229,170229,0,0,0,3,0.16666666666666666,14.21880094861363,5
2020-08-02-170229,170229,1,0,0,4,0.8333333333333334,76.87841886046604,6
2020-08-03-170229,170229,1,0,0,5,0.8333333333333334,73.20704976774788,0
2020-08-04-170229,170229,3,0,0,8,1.3333333333333333,89.71285020098962,1
2020-08-05-170229,170229,1,0,0,9,2.1666666666666665,117.12679761275075,2
2020-08-06-170229,170229,0,0,0,9,1.6666666666666667,128.30471123957267,3
2020-08-07-170229,170229,1,0,0,10,1.6666666666666667,122.94607123445105,4
2020-08-08-170229,170229,0,0,0,10,1.3333333333333333,147.64186806337202,5
2020-08-09-170229,170229,0,0,0,10,0.16666666666666666,137.33415842000534,6
2020-08-10-170229,170229,0,0,0,10,2.5,15.207419920287249,0
2020-08-11-170229,170229,0,0,0,10,2.833333333333333,25.817732329661965,1
2020-08-12-170229,170229,0,0,0,10,2.833333333333333,43.21067841312639,2
2020-08-13-170229,170229,0,0,0,10,2.1666666666666665,59.02335380147326,3
2020-08-14-170229,170229,0,0,0,10,1.5,83.88263045329278,4
2020-08-15-170229,170229,0,0,0,10,0.5,86.8150830681425,5
2020-08-16-170229,170229,0,0,0,10,1.0,87.48462328775612,6
2020-08-17-170229,170229,0,0,0,10,0.8333333333333334,89.00101875434474,0
2020-08-18-170229,170229,0,0,0,10,4.0,84.91121033451196,1
2020-08-19-170229,170229,0,0,0,10,2.333333333333333,80.11325128343852,2
2020-08-20-170229,170229,0,0,0,10,2.5,63.63175773471712,3
2020-08-21-170229,170229,0,0,0,10,2.1666666666666665,72.05725838404179,4
2020-08-22-170229,170229,0,0,0,10,0.8333333333333334,96.94739509501447,5
2020-08-23-170229,170229,0,0,0,10,1.5,103.23845333375345,6
2020-08-24-170229,170229,0,0,0,10,2.833333333333333,98.4923513421872,0
2020-08-25-170229,170229,0,0,0,10,1.6666666666666667,98.34107845492917,1
2020-08-26-170229,170229,0,0,0,10,2.1666666666666665,89.68959090134302,2
2020-08-27-170229,170229,0,0,0,10,3.0,85.81447357004119,3
2020-08-28-170229,170229,0,0,2,10,3.8333333333333335,87.4004088838183,4
2020-08-29-170229,170229,0,0,2,10,0.6666666666666666,75.41466599767273,5
2020-08-30-170229,170229,0,0,0,10,1.3333333333333333,76.98404251901971,6
2020-08-31-170229,170229,0,0,0,10,2.1666666666666665,69.26933537018019,0
2020-09-01-170229,170229,0,0,0,10,2.833333333333333,111.82658151897958,1
2020-09-02-170229,170229,0,0,0,10,2.833333333333333,76.27031407543866,2
2020-09-03-170229,170229,0,0,1,10,1.3333333333333333,47.742921351627515,3
2020-09-04-170229,170229,0,0,0,10,1.0,44.972325241885855,4
2020-09-05-170229,170229,0,0,0,10,1.8333333333333333,42.734945853988876,5
2020-09-06-170229,170229,0,0,0,10,0.3333333333333333,43.324573883055436,6
2020-09-07-170229,170229,0,0,0,10,0.16666666666666666,42.9252406262213,0
2020-09-08-170229,170229,0,0,0,10,1.5,38.068559162033196,1
2020-09-09-170229,170229,0,0,0,10,0.8333333333333334,45.873646237617514,2
2020-09-10-170229,170229,0,0,0,10,1.5,83.69617414218249,3
2020-09-11-170229,170229,2,0,0,12,1.0,62.79845598570289,4
2020-09-12-170229,170229,2,0,0,14,0.6666666666666666,64.53939322894482,5
2020-09-13-170229,170229,0,0,0,14,0.8333333333333334,76.20962321904796,6
2020-09-14-170229,170229,0,0,0,14,3.333333333333333,61.981320657089114,0
2020-09-15-170229,170229,0,0,0,14,4.166666666666667,66.5241775925766,1
2020-09-16-170229,170229,0,0,0,14,3.0,77.68482684419538,2
2020-09-17-170229,170229,1,0,0,15,3.5,77.1973819180713,3
2020-09-18-170229,170229,0,0,0,15,3.8333333333333335,87.14258214129734,4
2020-09-19-170229,170229,0,0,0,15,2.0,79.28470326719882,5
2020-09-20-170229,170229,0,0,0,15,1.3333333333333333,69.97877056496941,6
2020-09-21-170229,170229,0,0,0,15,2.833333333333333,60.34500705188141,0
2020-09-22-170229,170229,0,0,0,15,2.833333333333333,53.960277620074635,1
2020-09-23-170229,170229,0,0,0,15,2.1666666666666665,56.42791250172901,2
2020-09-24-170229,170229,0,0,0,15,1.8333333333333333,49.260009515131415,3
2020-09-25-170229,170229,0,0,0,15,2.0,44.01637610162504,4
2020-09-26-170229,170229,0,0,0,15,1.6666666666666667,44.73697987620662,5
2020-09-27-170229,170229,0,0,0,15,1.0,40.24545024747228,6
2020-09-28-170229,170229,0,0,0,15,0.8333333333333334,41.00290599738334,0
2020-09-29-170229,170229,0,0,0,15,1.6666666666666667,41.668518725348505,1
2020-09-30-170229,170229,0,0,0,15,2.1666666666666665,35.256117638129425,2
2020-10-01-170229,170229,0,0,0,15,1.6666666666666667,0.0,3
2020-10-02-170229,170229,0,0,0,15,1.8333333333333333,72.28437915619432,4
2020-10-03-170229,170229,0,0,0,15,1.1666666666666667,101.05851002497823,5
2020-10-04-170229,170229,0,0,0,15,0.6666666666666666,114.97810665452323,6
2020-10-05-170229,170229,0,0,0,15,2.5,94.92587551435176,0
2020-10-06-170229,170229,0,0,0,15,3.5,87.57443256259072,1
2020-10-07-170229,170229,0,0,0,15,2.333333333333333,74.43425832384216,2
2020-10-08-170229,170229,0,0,0,15,1.8333333333333333,69.41899860926848,3
2020-10-09-170229,170229,0,0,0,15,2.333333333333333,74.3680934851801,4
2020-10-10-170229,170229,0,0,0,15,1.1666666666666667,5.670900799170566,5
2020-10-11-170229,170229,0,0,0,15,1.5,8.658805409343898,6
2020-10-12-170229,170229,0,0,1,15,1.0,12.159621268339007,0
2020-10-13-170229,170229,0,0,0,15,2.5,16.603743147182353,1
2020-10-14-170229,170229,0,0,0,15,3.8333333333333335,27.91672887873101,2
2020-10-15-170229,170229,0,0,0,15,3.0,39.01044978080963,3
2020-10-16-170229,170229,0,0,1,15,5.166666666666667,54.74468397273081,4
2020-10-17-170229,170229,0,0,0,15,3.1666666666666665,65.35384598884652,5
2020-10-18-170229,170229,0,0,0,15,3.8333333333333335,65.47803739909592,6
2020-10-19-170229,170229,0,0,0,15,2.833333333333333,67.22329305359573,0
2020-10-20-170229,170229,0,0,0,15,4.833333333333333,70.50373713535066,1
2020-10-21-170229,170229,0,0,0,15,5.5,72.70749250325846,2
2020-10-22-170229,170229,0,0,0,15,9.833333333333334,76.48319217691605,3
2020-10-23-170229,170229,0,0,0,15,4.5,75.26327869463216,4
2020-10-24-170229,170229,0,0,2,15,4.0,79.92258703680054,5
2020-10-25-170229,170229,0,0,0,15,4.333333333333333,79.29965614723594,6
2020-10-26-170229,170229,1,0,0,16,4.833333333333333,69.27147418928796,0
2020-10-27-170229,170229,0,0,0,16,6.166666666666668,81.47017086361122,1
2020-10-28-170229,170229,0,0,0,16,5.666666666666668,83.91468014588087,2
2020-10-29-170229,170229,0,0,0,16,7.833333333333332,88.12415554102185,3
2020-10-30-170229,170229,1,0,0,17,4.5,79.53509135436809,4
2020-10-31-170229,170229,0,0,0,17,2.5,94.66218632231454,5
2020-11-01-170229,170229,0,0,0,17,2.833333333333333,50.74322261681563,6
2020-11-02-170229,170229,0,0,0,17,4.333333333333333,108.43543006153533,0
2020-11-03-170229,170229,0,0,0,17,3.8333333333333335,92.6719790171382,1
2020-11-04-170229,170229,0,0,0,17,4.5,98.2407263285497,2
2020-11-05-170229,170229,0,0,0,17,3.1666666666666665,99.65871209090524,3
2020-11-06-170229,170229,0,0,0,17,4.0,96.70118266673202,4
2020-11-07-170229,170229,2,0,0,19,4.0,98.63103555254514,5
2020-11-08-170229,170229,0,0,0,19,4.166666666666667,100.43282011548747,6
2020-11-09-170229,170229,0,0,0,19,5.833333333333332,99.28948573426538,0
2020-11-10-170229,170229,0,0,0,19,4.166666666666667,48.814436197889485,1
2020-11-11-170229,170229,0,0,0,19,3.333333333333333,61.319135360119404,2
2020-11-12-170229,170229,0,0,0,19,5.0,71.44927321503265,3
2020-11-13-170229,170229,0,0,0,19,6.166666666666668,74.50092034043016,4
2020-03-01-170230,170230,0,0,0,0,0.0,0.0,6
2020-03-02-170230,170230,0,0,0,0,0.0,3.0861767387414623,0
2020-03-03-170230,170230,0,0,0,0,0.0,20.7390436219678,1
2020-03-04-170230,170230,0,0,0,0,0.0,18.618558164198806,2
2020-03-05-170230,170230,0,0,0,0,0.0,15.337266905446418,3
2020-03-06-170230,170230,0,0,0,0,0.0,13.549870659653983,4
2020-03-07-170230,170230,0,0,0,0,0.0,14.947028587300753,5
2020-03-08-170230,170230,0,0,0,0,0.0,16.805742676381495,6
2020-03-09-170230,170230,0,0,0,0,0.25,16.93326550817978,0
2020-03-10-170230,170230,0,0,0,0,0.0,132.29378935110256,1
2020-03-11-170230,170230,0,0,0,0,0.0,112.91349761423055,2
2020-03-12-170230,170230,0,0,0,0,0.25,91.64271151735309,3
2020-03-13-170230,170230,0,0,0,0,0.25,75.76403672805364,4
2020-03-14-170230,170230,0,0,0,0,0.0,58.81897295359291,5
2020-03-15-170230,170230,0,0,0,0,0.5,43.302726575721486,6
2020-03-16-170230,170230,0,0,0,0,0.5,7.889566827852885,0
2020-03-17-170230,170230,0,0,0,0,0.5,9.724049588654658,1
2020-03-18-170230,170230,0,1,0,0,1.5,11.72808200912233,2
2020-03-19-170230,170230,0,0,0,0,1.5,15.927161227308135,3
2020-03-20-170230,170230,0,0,0,0,2.75,17.202335792250402,4
2020-03-21-170230,170230,0,0,0,0,0.25,26.57496519589907,5
2020-03-22-170230,170230,0,0,0,0,2.75,26.131888159309156,6
2020-03-23-170230,170230,0,0,1,0,1.5,31.58190088163291,0
2020-03-24-170230,170230,0,0,0,0,1.25,37.939548935786284,1
2020-03-25-170230,170230,0,0,0,0,2.25,41.425567061132526,2
2020-03-26-170230,170230,0,0,0,0,2.25,45.45606867500807,3
2020-03-27-170230,170230,0,0,0,0,1.75,54.422300859490846,4
2020-03-28-170230,170230,0,0,0,0,0.0,48.07205387914737,5
2020-03-29-170230,170230,0,0,0,0,0.25,46.41500675515885,6
2020-03-30-170230,170230,0,0,0,0,1.0,30.515837001316864,0
2020-03-31-170230,170230,0,0,0,0,1.25,26.863379558180007,1
2020-04-01-170230,170230,0,0,0,0,3.0,4.1806409039172685,2
2020-04-02-170230,170230,0,0,0,0,0.5,12.661683820562214,3
2020-04-03-170230,170230,0,0,0,0,1.75,7.47244746232431,4
2020-04-04-170230,170230,0,0,0,0,1.0,13.435227057171948,5
2020-04-05-170230,170230,0,0,0,0,0.25,16.284820492278072,6
2020-04-06-170230,170230,1,0,0,1,1.25,15.696713704026923,0
2020-04-07-170230,170230,0,0,0,1,0.5,24.292216946525485,1
2020-04-08-170230,170230,0,4,0,1,1.75,24.433263511953363,2
2020-04-09-170230,170230,0,0,0,1,0.5,26.78189667514878,3
2020-04-10-170230,170230,0,0,0,1,1.25,14.011149105479594,4
2020-04-11-170230,170230,0,0,0,1,0.0,16.542340428096068,5
2020-04-12-170230,170230,0,0,0,1,0.25,17.49965031737723,6
2020-04-13-170230,170230,0,0,0,1,1.25,18.122807119676768,0
2020-04-14-170230,170230,0,0,0,1,0.75,22.95872330649692,1
2020-04-15-170230,170230,0,0,0,1,0.5,26.481721768436543,2
2020-04-16-170230,170230,0,0,0,1,0.5,29.09843829333295,3
2020-04-17-170230,170230,0,0,0,1,0.0,17.689868618298142,4
2020-04-18-170230,170230,0,0,0,1,0.0,15.699441774201224,5
2020-04-19-170230,170230,0,0,0,1,0.0,14.785995323382993,6
2020-04-20-170230,170230,0,0,0,1,0.75,13.477535922703415,0
2020-04-21-170230,170230,0,0,0,1,0.5,15.145808774062566,1
2020-04-22-170230,170230,0,0,0,1,0.75,14.490997245583948,2
2020-04-23-170230,170230,0,0,0,1,0.25,15.518901531288337,3
2020-04-24-170230,170230,0,0,0,1,0.25,14.980560537109426,4
2020-04-25-170230,170230,0,0,0,1,0.25,15.661557631570302,5
2020-04-26-170230,170230,0,0,0,1,0.25,16.4175718837507,6
2020-04-27-170230,170230,0,0,0,1,0.0,13.775159570319474,0
2020-04-28-170230,170230,0,0,0,1,1.0,9.703892623670498,1
2020-04-29-170230,170230,0,0,0,1,0.25,10.352788445591848,2
2020-04-30-170230,170230,0,0,0,1,0.0,16.36850911789414,3
2020-05-01-170230,170230,0,0,0,1,0.5,24.94728276025463,4
2020-05-02-170230,170230,0,0,0,1,0.25,10.8926954814356,5
2020-05-03-170230,170230,0,0,0,1,0.0,7.004572322821939,6
2020-05-04-170230,170230,0,0,0,1,0.25,6.709058410759633,0
2020-05-05-170230,170230,0,0,0,1,0.0,5.850099382196598,1
2020-05-06-170230,170230,0,0,0,1,0.25,5.432443528945181,2
2020-05-07-170230,170230,0,0,0,1,0.25,5.0120278076791145,3
2020-05-08-170230,170230,0,0,0,1,0.5,4.900430314374629,4
2020-05-09-170230,170230,0,0,0,1,0.25,6.892074196600908,5
2020-05-10-170230,170230,0,0,0,1,0.0,30.508511377056873,6
2020-05-11-170230,170230,0,0,0,1,0.5,25.26209440672754,0
2020-05-12-170230,170230,0,0,0,1,0.5,26.319426472087013,1
2020-05-13-170230,170230,0,0,0,1,1.0,17.185436871877222,2
2020-05-14-170230,170230,0,0,0,1,1.25,18.114986617671043,3
2020-05-15-170230,170230,0,1,0,1,0.75,17.579905503519967,4
2020-05-16-170230,170230,0,0,0,1,0.0,16.017190231647792,5
2020-05-17-170230,170230,0,0,0,1,0.0,14.739251191442031,6
2020-05-18-170230,170230,0,0,0,1,0.5,14.70983971689955,0
2020-05-19-170230,170230,0,0,0,1,0.0,15.464291305600423,1
2020-05-20-170230,170230,0,0,0,1,0.5,10.370053392126447,2
2020-05-21-170230,170230,0,0,0,1,0.25,9.578508826732367,3
2020-05-22-170230,170230,0,0,0,1,0.25,8.91900258155852,4
2020-05-23-170230,170230,0,0,0,1,0.25,11.35322936827649,5
2020-05-24-170230,170230,0,0,0,1,0.0,12.0727511765389,6
2020-05-25-170230,170230,0,0,0,1,0.0,10.074530156712127,0
2020-05-26-170230,170230,0,0,0,1,1.25,9.486490756874678,1
2020-05-27-170230,170230,0,0,0,1,0.25,12.240409203453684,2
2020-05-28-170230,170230,0,0,0,1,0.75,10.641188152373802,3
2020-05-29-170230,170230,0,0,0,1,0.75,11.507212708214379,4
2020-05-30-170230,170230,0,0,0,1,0.0,11.38944120393625,5
2020-05-31-170230,170230,0,0,0,1,0.25,11.928606579763864,6
2020-06-01-170230,170230,0,0,0,1,0.75,11.230175521971965,0
2020-06-02-170230,170230,0,0,0,1,0.5,12.674117484381394,1
2020-06-03-170230,170230,0,0,0,1,0.5,2.1078398178357864,2
2020-06-04-170230,170230,0,0,0,1,0.75,5.0764893279264545,3
2020-06-05-170230,170230,0,0,0,1,0.25,11.870512001995975,4
2020-06-06-170230,170230,0,0,0,1,0.5,12.652949963689833,5
2020-06-07-170230,170230,0,0,0,1,0.25,14.065930580486286,6
2020-06-08-170230,170230,0,0,0,1,0.5,14.78261478854832,0
2020-06-09-170230,170230,0,1,0,1,0.0,16.68308378516019,1
2020-06-10-170230,170230,0,0,0,1,0.5,12.559078586531857,2
2020-06-11-170230,170230,0,0,0,1,0.0,13.076253077525262,3
2020-06-12-170230,170230,0,0,0,1,0.0,13.693444678573725,4
2020-06-13-170230,170230,0,0,0,1,0.0,12.65189791031493,5
2020-06-14-170230,170230,0,0,0,1,0.5,10.243625923792496,6
2020-06-15-170230,170230,0,0,0,1,0.25,9.969542039671168,0
2020-06-16-170230,170230,0,0,0,1,0.75,12.616426859887408,1
2020-06-17-170230,170230,0,0,0,1,0.25,12.360511619316238,2
2020-06-18-170230,170230,0,0,0,1,0.0,10.866946938502732,3
2020-06-19-170230,170230,0,1,0,1,0.5,9.45029463787668,4
2020-06-20-170230,170230,0,0,0,1,0.0,14.195268708423727,5
2020-06-21-170230,170230,0,0,0,1,0.25,12.650759134904854,6
2020-06-22-170230,170230,0,0,0,1,0.0,10.401760281786094,0
2020-06-23-170230,170230,0,0,0,1,0.25,7.767206473242699,1
2020-06-24-170230,170230,0,0,0,1,0.25,8.005344041629245,2
2020-06-25-170230,170230,0,0,0,1,0.0,9.217250574861776,3
2020-06-26-170230,170230,0,0,0,1,0.0,5.799321795196192,4
2020-06-27-170230,170230,0,0,0,1,0.0,3.544400840974964,5
2020-06-28-170230,170230,0,0,0,1,0.0,3.987510508042294,6
2020-06-29-170230,170230,0,0,0,1,0.0,3.0339196628498657,0
2020-06-30-170230,170230,0,0,0,1,0.25,4.667492281927812,1
2020-07-01-170230,170230,0,0,0,1,0.0,21.246486930299948,2
2020-07-02-170230,170230,0,0,0,1,0.25,7.746013102637833,3
2020-07-03-170230,170230,0,0,0,1,0.0,9.305927341595773,4
2020-07-04-170230,170230,0,0,0,1,0.25,10.58208248484828,5
2020-07-05-170230,170230,0,0,0,1,0.5,10.269665293686074,6
2020-07-06-170230,170230,0,0,0,1,0.5,11.288016836469929,0
2020-07-07-170230,170230,0,0,0,1,0.5,11.20141577142816,1
2020-07-08-170230,170230,0,1,0,1,0.25,14.111771829047996,2
2020-07-09-170230,170230,0,2,0,1,0.25,18.844137145534756,3
2020-07-10-170230,170230,0,0,0,1,0.25,19.37683422791979,4
2020-07-11-170230,170230,0,0,0,1,0.0,13.528279575480795,5
2020-07-12-170230,170230,0,0,0,1,0.0,11.771740081566385,6
2020-07-13-170230,170230,0,0,0,1,0.0,9.334045731234477,0
2020-07-14-170230,170230,0,1,0,1,0.25,8.040454593055964,1
2020-07-15-170230,170230,0,0,0,1,0.0,9.721449754245652,2
2020-07-16-170230,170230,0,0,0,1,0.25,9.398549438644752,3
2020-07-17-170230,170230,0,0,0,1,0.0,9.2090541718888,4
2020-07-18-170230,170230,0,0,0,1,0.0,5.936502955815288,5
2020-07-19-170230,170230,0,0,0,1,0.0,6.36968148712367,6
2020-07-20-170230,170230,0,0,0,1,0.25,9.718809699859142,0
2020-07-21-170230,170230,0,0,0,1,0.0,8.712134147960636,1
2020-07-22-170230,170230,0,0,0,1,0.25,10.024836561065255,2
2020-07-23-170230,170230,0,0,0,1,0.0,14.002228340315916,3
2020-07-24-170230,170230,0,0,0,1,0.0,14.014481896330764,4
2020-07-25-170230,170230,0,0,0,1,0.25,14.872665728424405,5
2020-07-26-170230,170230,0,0,0,1,0.0,14.52081941765558,6
2020-07-27-170230,170230,0,0,0,1,0.0,13.403501868474347,0
2020-07-28-170230,170230,0,0,0,1,0.5,11.017815077024675,1
2020-07-29-170230,170230,0,0,0,1,0.25,13.426759035840146,2
2020-07-30-170230,170230,0,0,0,1,0.0,12.462852087412202,3
2020-07-31-170230,170230,0,0,0,1,0.75,12.726977811389325,4
2020-08-01-170230,170230,0,0,0,1,0.5,23.258198783987904,5
2020-08-02-170230,170230,0,0,0,1,0.5,130.6617012658951,6
2020-08-03-170230,170230,0,0,0,1,1.25,92.19211774879841,0
2020-08-04-170230,170230,0,0,0,1,1.25,97.14590497792787,1
2020-08-05-170230,170230,0,0,2,1,2.75,105.19554180712248,2
2020-08-06-170230,170230,0,0,0,1,1.75,121.33867767769911,3
2020-08-07-170230,170230,0,0,0,1,2.75,118.35848630603645,4
2020-08-08-170230,170230,0,0,0,1,0.25,150.81831624041996,5
2020-08-09-170230,170230,0,0,0,1,1.75,143.74035902438683,6
2020-08-10-170230,170230,0,0,1,1,1.0,27.333405864090572,0
2020-08-11-170230,170230,0,0,0,1,4.25,39.96994829858384,1
2020-08-12-170230,170230,0,0,0,1,3.5,68.31145595944773,2
2020-08-13-170230,170230,0,0,0,1,3.0,118.35840383504504,3
2020-08-14-170230,170230,0,0,0,1,1.0,151.48056658147797,4
2020-08-15-170230,170230,0,0,0,1,0.75,153.23260063178682,5
2020-08-16-170230,170230,0,0,0,1,0.25,151.95072663808529,6
2020-08-17-170230,170230,0,0,0,1,1.0,149.9627560039888,0
2020-08-18-170230,170230,0,0,0,1,1.75,147.39294175029437,1
2020-08-19-170230,170230,2,0,0,3,3.25,130.6698180147511,2
2020-08-20-170230,170230,0,0,0,3,2.25,100.3272696616649,3
2020-08-21-170230,170230,0,0,0,3,5.0,122.02199097277753,4
2020-08-22-170230,170230,0,0,0,3,1.5,169.48787355242655,5
2020-08-23-170230,170230,0,0,0,3,1.25,186.8446790165513,6
2020-08-24-170230,170230,1,0,0,4,0.25,181.15008466010835,0
2020-08-25-170230,170230,0,0,0,4,0.75,188.37970769248744,1
2020-08-26-170230,170230,0,0,0,4,3.0,142.37722654923894,2
2020-08-27-170230,170230,0,0,0,4,1.75,146.13987822623457,3
2020-08-28-170230,170230,0,0,0,4,1.25,128.59850001832234,4
2020-08-29-170230,170230,0,0,0,4,0.75,97.22515003254695,5
2020-08-30-170230,170230,0,0,0,4,0.5,91.00279444901743,6
2020-08-31-170230,170230,0,0,0,4,1.5,79.38796363637022,0
2020-09-01-170230,170230,0,0,0,4,1.75,128.4207311923826,1
2020-09-02-170230,170230,0,0,0,4,1.25,119.09400218221577,2
2020-09-03-170230,170230,0,0,0,4,1.0,67.2687746538902,3
2020-09-04-170230,170230,0,0,0,4,0.75,59.58412850446595,4
2020-09-05-170230,170230,0,0,0,4,1.25,51.024205916991704,5
2020-09-06-170230,170230,0,0,0,4,0.25,59.93582311627672,6
2020-09-07-170230,170230,0,0,0,4,1.5,58.97441086221039,0
2020-09-08-170230,170230,0,0,0,4,0.5,55.724441146457735,1
2020-09-09-170230,170230,0,0,0,4,3.5,56.694065791858435,2
2020-09-10-170230,170230,0,0,0,4,1.25,106.53129045087385,3
2020-09-11-170230,170230,0,0,1,4,2.25,97.37795677480814,4
2020-09-12-170230,170230,0,0,0,4,1.0,87.03972000053416,5
2020-09-13-170230,170230,0,0,0,4,1.0,83.5340451902891,6
2020-09-14-170230,170230,0,0,0,4,2.0,58.95020715727597,0
2020-09-15-170230,170230,0,0,0,4,5.25,70.66074394837193,1
2020-09-16-170230,170230,0,0,0,4,1.75,89.46536451667231,2
2020-09-17-170230,170230,0,0,0,4,3.25,92.14515586316978,3
2020-09-18-170230,170230,0,0,0,4,1.75,104.39663844539598,4
2020-09-19-170230,170230,0,0,0,4,0.5,106.89016655988745,5
2020-09-20-170230,170230,0,0,0,4,1.75,110.9476087235989,6
2020-09-21-170230,170230,0,0,0,4,1.25,96.62794977693899,0
2020-09-22-170230,170230,0,0,0,4,1.75,74.28582834947557,1
2020-09-23-170230,170230,0,0,0,4,2.0,75.14697491365635,2
2020-09-24-170230,170230,0,0,0,4,3.0,65.46017584974646,3
2020-09-25-170230,170230,1,0,0,5,1.75,64.33642380568838,4
2020-09-26-170230,170230,0,0,0,5,0.0,68.32350783132864,5
2020-09-27-170230,170230,0,0,0,5,0.0,56.75310534273087,6
2020-09-28-170230,170230,0,0,0,5,1.0,55.85283160724066,0
2020-09-29-170230,170230,0,0,2,5,0.75,58.13622394457725,1
2020-09-30-170230,170230,0,0,0,5,1.0,50.82836477686354,2
2020-10-01-170230,170230,0,0,1,5,1.5,0.0,3
2020-10-02-170230,170230,0,0,0,5,1.0,72.7324232390732,4
2020-10-03-170230,170230,0,0,0,5,0.0,93.17003181401545,5
2020-10-04-170230,170230,0,0,0,5,0.25,107.52685116373374,6
2020-10-05-170230,170230,0,0,0,5,0.25,96.11518465412377,0
2020-10-06-170230,170230,0,0,0,5,2.5,91.56228569600255,1
2020-10-07-170230,170230,0,0,0,5,0.75,71.26261886408837,2
2020-10-08-170230,170230,0,0,0,5,0.5,64.94343577205109,3
2020-10-09-170230,170230,0,0,0,5,0.5,69.42246088418216,4
2020-10-10-170230,170230,0,0,0,5,0.25,7.309786180875232,5
2020-10-11-170230,170230,0,0,0,5,0.0,10.423152318150958,6
2020-10-12-170230,170230,0,0,0,5,0.25,12.122032243617241,0
2020-10-13-170230,170230,2,0,0,7,0.75,14.392608656773863,1
2020-10-14-170230,170230,0,0,0,7,0.5,43.22583427080615,2
2020-10-15-170230,170230,1,0,0,8,0.5,53.28712769166604,3
2020-10-16-170230,170230,0,0,0,8,1.5,61.90903685348354,4
2020-10-17-170230,170230,0,0,0,8,0.25,64.7623391235876,5
2020-10-18-170230,170230,0,0,3,8,1.5,62.33373197017259,6
2020-10-19-170230,170230,0,0,1,8,0.0,69.28022224236395,0
2020-10-20-170230,170230,0,0,0,8,1.75,55.09130510204118,1
2020-10-21-170230,170230,0,0,0,8,2.0,52.43975286758494,2
2020-10-22-170230,170230,0,0,1,8,3.5,60.96742717296171,3
2020-10-23-170230,170230,0,0,0,8,1.0,62.659144123726364,4
2020-10-24-170230,170230,0,0,0,8,1.0,69.51743969228104,5
2020-10-25-170230,170230,0,0,0,8,0.5,64.40573056664715,6
2020-10-26-170230,170230,0,0,0,8,1.25,61.2360130570561,0
2020-10-27-170230,170230,0,0,0,8,1.25,66.61203842577211,1
2020-10-28-170230,170230,0,0,0,8,4.25,66.63108910603577,2
2020-10-29-170230,170230,0,0,0,8,2.0,88.15176209904206,3
2020-10-30-170230,170230,0,0,0,8,2.25,77.04439283700792,4
2020-10-31-170230,170230,0,0,0,8,2.0,87.38307822721387,5
2020-11-01-170230,170230,3,0,0,11,2.25,56.257430734090676,6
2020-11-02-170230,170230,1,0,0,12,1.0,93.99893641616812,0
2020-11-03-170230,170230,0,0,0,12,3.0,77.4525742918261,1
2020-11-04-170230,170230,0,0,0,12,2.75,96.59955890669056,2
2020-11-05-170230,170230,1,0,0,13,2.75,111.95051023106132,3
2020-11-06-170230,170230,0,0,0,13,2.0,119.72130376710935,4
2020-11-07-170230,170230,0,0,0,13,0.75,129.01856072907017,5
2020-11-08-170230,170230,0,0,0,13,1.25,124.8665033374825,6
2020-11-09-170230,170230,0,0,0,13,4.0,120.78164157580605,0
2020-11-10-170230,170230,0,0,0,13,2.75,84.86677398990038,1
2020-11-11-170230,170230,0,0,0,13,3.0,101.71331649055986,2
2020-11-12-170230,170230,0,0,0,13,4.0,119.9448173411923,3
2020-11-13-170230,170230,0,0,0,13,4.0,112.30037763485389,4
2020-03-01-170231,170231,0,0,0,0,0.0,0.0,6
2020-03-02-170231,170231,0,0,0,0,0.0,6.499123605483114,0
2020-03-03-170231,170231,0,0,0,0,0.0,34.16825618997972,1
2020-03-04-170231,170231,0,0,0,0,0.0,34.2792249992501,2
2020-03-05-170231,170231,0,0,1,0,0.0,35.649311863791496,3
2020-03-06-170231,170231,0,1,0,0,0.25,33.426740644725626,4
2020-03-07-170231,170231,0,0,0,0,1.75,35.54621463618848,5
2020-03-08-170231,170231,0,0,0,0,0.25,41.545129719125896,6
2020-03-09-170231,170231,0,0,0,0,0.75,41.56141230609202,0
2020-03-10-170231,170231,0,0,0,0,3.5,61.75841507079895,1
2020-03-11-170231,170231,0,0,1,0,0.5,55.78697778601905,2
2020-03-12-170231,170231,0,0,0,0,0.75,49.437693148969544,3
2020-03-13-170231,170231,0,0,0,0,1.75,40.45227020978424,4
2020-03-14-170231,170231,0,0,0,0,1.0,34.47551525210464,5
2020-03-15-170231,170231,0,0,0,0,1.0,30.52904836711641,6
2020-03-16-170231,170231,0,0,2,0,4.0,17.969233286337648,0
2020-03-17-170231,170231,0,0,0,0,3.0,23.970128287785137,1
2020-03-18-170231,170231,0,0,0,0,4.25,24.6197533440226,2
2020-03-19-170231,170231,1,0,0,1,6.25,30.49769121148113,3
2020-03-20-170231,170231,0,0,1,1,6.75,38.95520490036493,4
2020-03-21-170231,170231,0,0,0,1,3.25,45.52566186086241,5
2020-03-22-170231,170231,0,0,0,1,4.5,46.482899356246236,6
2020-03-23-170231,170231,0,0,0,1,9.5,45.122928726671674,0
2020-03-24-170231,170231,0,0,0,1,10.25,58.760090558735214,1
2020-03-25-170231,170231,1,1,0,2,8.75,70.67341730154749,2
2020-03-26-170231,170231,0,0,0,2,6.25,76.96771469410824,3
2020-03-27-170231,170231,0,0,0,2,5.5,86.23458276097975,4
2020-03-28-170231,170231,0,0,0,2,2.0,85.73021421871292,5
2020-03-29-170231,170231,0,0,0,2,1.0,86.03557656023104,6
2020-03-30-170231,170231,2,0,0,4,7.75,63.989453533384136,0
2020-03-31-170231,170231,0,0,0,4,6.0,62.09381723236344,1
2020-04-01-170231,170231,0,0,0,4,4.5,14.207988392408538,2
2020-04-02-170231,170231,0,0,1,4,6.25,28.92452375476014,3
2020-04-03-170231,170231,1,0,0,5,6.5,14.588341033727069,4
2020-04-04-170231,170231,0,0,0,5,1.75,25.3778606281238,5
2020-04-05-170231,170231,0,0,0,5,0.5,26.164731415713,6
2020-04-06-170231,170231,0,1,0,5,5.75,26.238450981141042,0
2020-04-07-170231,170231,0,0,0,5,4.5,33.162442291279206,1
2020-04-08-170231,170231,0,0,0,5,2.75,35.39646319379483,2
2020-04-09-170231,170231,0,1,0,5,5.5,37.99775891758584,3
2020-04-10-170231,170231,0,0,0,5,2.5,10.506741119729956,4
2020-04-11-170231,170231,0,0,0,5,0.75,13.682183908355476,5
2020-04-12-170231,170231,0,0,0,5,0.25,14.720986769652455,6
2020-04-13-170231,170231,0,0,0,5,3.5,14.195666316528488,0
2020-04-14-170231,170231,0,0,1,5,2.25,17.53288915521742,1
2020-04-15-170231,170231,0,0,0,5,3.75,20.88376094938471,2
2020-04-16-170231,170231,1,0,0,6,4.25,25.149636200394497,3
2020-04-17-170231,170231,0,0,0,6,2.75,27.65445803903065,4
2020-04-18-170231,170231,0,0,0,6,0.75,28.31910412099436,5
2020-04-19-170231,170231,0,0,0,6,0.5,28.187284515767534,6
2020-04-20-170231,170231,0,0,0,6,2.75,34.53740714717384,0
2020-04-21-170231,170231,0,0,0,6,2.75,35.25169649985019,1
2020-04-22-170231,170231,0,0,0,6,2.0,33.12172467789251,2
2020-04-23-170231,170231,0,0,0,6,0.75,27.83736628065931,3
2020-04-24-170231,170231,0,1,0,6,1.0,24.485670294794016,4
2020-04-25-170231,170231,0,0,0,6,0.25,25.858675495368857,5
2020-04-26-170231,170231,0,0,0,6,1.0,25.343915398339632,6
2020-04-27-170231,170231,0,0,0,6,0.5,16.36338171742059,0
2020-04-28-170231,170231,1,0,1,7,3.25,13.87436047241803,1
2020-04-29-170231,170231,0,0,0,7,1.5,15.652220130898069,2
2020-04-30-170231,170231,0,0,1,7,1.0,26.696109266582205,3
2020-05-01-170231,170231,0,0,3,7,1.0,37.1767911025252,4
2020-05-02-170231,170231,0,0,0,7,1.0,20.78060880015319,5
2020-05-03-170231,170231,0,0,0,7,0.25,11.727621675122606,6
2020-05-04-170231,170231,0,0,0,7,2.0,9.674937429468065,0
2020-05-05-170231,170231,0,0,0,7,2.5,10.913002589812587,1
2020-05-06-170231,170231,0,0,0,7,2.5,13.45449916750324,2
2020-05-07-170231,170231,0,0,0,7,3.5,16.2289622544172,3
2020-05-08-170231,170231,0,0,0,7,1.0,16.39406672984647,4
2020-05-09-170231,170231,0,0,0,7,0.25,18.768576265512248,5
2020-05-10-170231,170231,0,1,0,7,0.5,43.84058881312971,6
2020-05-11-170231,170231,0,1,0,7,2.75,41.403977855576,0
2020-05-12-170231,170231,1,0,0,8,1.75,43.05632663694234,1
2020-05-13-170231,170231,0,0,0,8,3.5,36.215795868120985,2
2020-05-14-170231,170231,1,0,0,9,2.5,32.92471973142247,3
2020-05-15-170231,170231,3,1,2,12,1.5,32.78020395591155,4
2020-05-16-170231,170231,0,0,0,12,0.0,30.30070594603498,5
2020-05-17-170231,170231,0,1,0,12,0.0,28.984934888599906,6
2020-05-18-170231,170231,0,0,0,12,2.5,28.38826812502726,0
2020-05-19-170231,170231,0,0,0,12,0.5,29.4461762841837,1
2020-05-20-170231,170231,0,0,1,12,1.25,22.33374940875951,2
2020-05-21-170231,170231,0,0,0,12,1.5,18.580167938481402,3
2020-05-22-170231,170231,0,0,0,12,1.25,12.574559711258381,4
2020-05-23-170231,170231,0,0,0,12,0.25,15.587766373464845,5
2020-05-24-170231,170231,0,0,0,12,0.0,16.02219968940237,6
2020-05-25-170231,170231,0,0,0,12,1.5,11.39292679800953,0
2020-05-26-170231,170231,0,0,0,12,2.0,13.876762970063282,1
2020-05-27-170231,170231,0,0,2,12,1.5,15.464276751110233,2
2020-05-28-170231,170231,0,1,0,12,1.0,15.624172885161808,3
2020-05-29-170231,170231,2,0,0,14,0.75,14.14428363178698,4
2020-05-30-170231,170231,0,0,0,14,0.0,18.266690537969648,5
2020-05-31-170231,170231,0,0,1,14,0.25,19.585315858463993,6
2020-06-01-170231,170231,0,0,0,14,2.5,26.442354171713966,0
2020-06-02-170231,170231,0,0,1,14,1.0,8.719550318537445,1
2020-06-03-170231,170231,1,0,0,15,0.75,4.878629693573733,2
2020-06-04-170231,170231,0,0,0,15,1.75,7.4442811827846604,3
2020-06-05-170231,170231,0,0,0,15,0.75,11.005528478652053,4
2020-06-06-170231,170231,0,0,0,15,0.5,11.389792043389598,5
2020-06-07-170231,170231,0,0,0,15,0.25,11.429608237689564,6
2020-06-08-170231,170231,0,0,0,15,0.75,11.365634626746505,0
2020-06-09-170231,170231,0,0,0,15,0.0,12.534226943206836,1
2020-06-10-170231,170231,2,3,1,17,0.75,28.662516963683885,2
2020-06-11-170231,170231,0,0,0,17,0.5,31.413620806414535,3
2020-06-12-170231,170231,0,0,0,17,0.75,26.718931129564155,4
2020-06-13-170231,170231,0,0,0,17,0.0,23.996503859255647,5
2020-06-14-170231,170231,1,0,0,18,0.25,17.671163420502452,6
2020-06-15-170231,170231,0,0,0,18,0.0,18.47835334475282,0
2020-06-16-170231,170231,1,0,0,19,0.75,18.83920219572886,1
2020-06-17-170231,170231,0,0,0,19,0.25,17.408975756306198,2
2020-06-18-170231,170231,0,0,0,19,0.25,10.971979406902552,3
2020-06-19-170231,170231,0,0,0,19,0.25,10.21382396636372,4
2020-06-20-170231,170231,0,0,0,19,0.0,10.645406058938704,5
2020-06-21-170231,170231,0,0,0,19,0.25,8.222823730129615,6
2020-06-22-170231,170231,0,0,1,19,0.0,8.230522239404742,0
2020-06-23-170231,170231,0,0,0,19,0.25,4.695086458819062,1
2020-06-24-170231,170231,1,0,0,20,0.0,4.772258251762405,2
2020-06-25-170231,170231,0,0,0,20,0.25,6.792884796675408,3
2020-06-26-170231,170231,0,1,0,20,0.5,6.632828016634425,4
2020-06-27-170231,170231,0,0,0,20,0.0,5.5033524912554785,5
2020-06-28-170231,170231,0,0,0,20,0.0,6.050005895945139,6
2020-06-29-170231,170231,0,0,0,20,0.0,5.927381751248548,0
2020-06-30-170231,170231,0,0,0,20,0.5,11.534157381969806,1
2020-07-01-170231,170231,0,0,0,20,0.75,12.202050896729325,2
2020-07-02-170231,170231,0,0,0,20,0.25,7.610695511201188,3
2020-07-03-170231,170231,0,0,0,20,1.0,12.411047996153831,4
2020-07-04-170231,170231,0,0,0,20,0.25,14.785383100754673,5
2020-07-05-170231,170231,0,0,0,20,0.5,12.61034766168428,6
2020-07-06-170231,170231,1,0,0,21,0.25,12.841822131322331,0
2020-07-07-170231,170231,0,0,0,21,0.25,14.877293109595962,1
2020-07-08-170231,170231,0,0,0,21,0.75,12.391376183675778,2
2020-07-09-170231,170231,0,0,0,21,1.0,10.649059260225638,3
2020-07-10-170231,170231,0,0,0,21,0.25,13.340251187592811,4
2020-07-11-170231,170231,0,0,0,21,0.25,9.967919900427239,5
2020-07-12-170231,170231,0,0,0,21,0.0,8.322264869980565,6
2020-07-13-170231,170231,0,0,0,21,0.0,7.736277686419115,0
2020-07-14-170231,170231,0,0,0,21,0.25,7.720952607760465,1
2020-07-15-170231,170231,0,0,0,21,0.0,6.85383886526221,2
2020-07-16-170231,170231,0,0,0,21,0.5,7.474201871015894,3
2020-07-17-170231,170231,0,0,1,21,0.0,6.510440224726739,4
2020-07-18-170231,170231,0,0,0,21,0.25,5.460024773431926,5
2020-07-19-170231,170231,0,0,0,21,0.0,6.3561665156709335,6
2020-07-20-170231,170231,0,0,0,21,0.25,8.619170309378084,0
2020-07-21-170231,170231,0,0,0,21,0.0,8.103198518936527,1
2020-07-22-170231,170231,0,0,0,21,0.0,9.482131592845077,2
2020-07-23-170231,170231,0,0,0,21,0.75,8.181536582106741,3
2020-07-24-170231,170231,0,1,0,21,0.75,9.533344370121394,4
2020-07-25-170231,170231,0,0,0,21,0.75,9.630453221124668,5
2020-07-26-170231,170231,0,0,1,21,1.0,8.863026670537842,6
2020-07-27-170231,170231,0,0,0,21,0.0,10.91748878606403,0
2020-07-28-170231,170231,0,0,2,21,1.0,10.474555938927399,1
2020-07-29-170231,170231,0,0,1,21,1.0,10.787159126062912,2
2020-07-30-170231,170231,0,0,0,21,0.75,18.030777691018454,3
2020-07-31-170231,170231,1,0,0,22,1.25,18.102962185777574,4
2020-08-01-170231,170231,0,0,0,22,0.75,15.987142406283171,5
2020-08-02-170231,170231,0,0,0,22,0.75,80.24797364731529,6
2020-08-03-170231,170231,0,0,1,22,1.75,62.18463218065282,0
2020-08-04-170231,170231,0,0,0,22,1.25,56.48942613422486,1
2020-08-05-170231,170231,0,0,2,22,1.75,62.710121581798774,2
2020-08-06-170231,170231,0,1,0,22,2.75,65.4651964805509,3
2020-08-07-170231,170231,0,0,2,22,0.5,62.480763948897184,4
2020-08-08-170231,170231,0,0,0,22,1.25,67.5204649884017,5
2020-08-09-170231,170231,1,0,3,23,1.0,65.76916670499989,6
2020-08-10-170231,170231,0,0,0,23,2.25,16.438409665997995,0
2020-08-11-170231,170231,2,0,0,25,3.0,24.27138788098395,1
2020-08-12-170231,170231,1,0,0,26,2.5,33.68785874028387,2
2020-08-13-170231,170231,0,0,0,26,3.75,38.02826695176989,3
2020-08-14-170231,170231,0,0,0,26,1.75,49.12068957690771,4
2020-08-15-170231,170231,0,0,0,26,1.75,50.78616750005932,5
2020-08-16-170231,170231,0,0,0,26,1.0,52.48173097199983,6
2020-08-17-170231,170231,1,0,0,27,3.75,53.73657230496145,0
2020-08-18-170231,170231,0,0,0,27,3.25,62.635042397954386,1
2020-08-19-170231,170231,2,0,0,29,4.0,64.33286366476636,2
2020-08-20-170231,170231,0,0,0,29,4.25,72.17273943890932,3
2020-08-21-170231,170231,2,0,0,31,4.25,78.50401103002616,4
2020-08-22-170231,170231,0,0,0,31,0.5,96.42443520984403,5
2020-08-23-170231,170231,3,0,0,34,0.75,96.30977415922806,6
2020-08-24-170231,170231,0,0,0,34,3.75,81.9750832691046,0
2020-08-25-170231,170231,0,0,0,34,3.0,88.21007568726847,1
2020-08-26-170231,170231,0,0,0,34,4.0,72.38236876813136,2
2020-08-27-170231,170231,0,0,1,34,3.5,72.96131525168246,3
2020-08-28-170231,170231,0,0,1,34,4.0,72.0025737357079,4
2020-08-29-170231,170231,0,0,0,34,0.75,61.53453541863788,5
2020-08-30-170231,170231,0,0,0,34,3.25,64.78741927176603,6
2020-08-31-170231,170231,0,0,0,34,1.75,51.872838716198615,0
2020-09-01-170231,170231,0,0,2,34,2.75,60.03555460570162,1
2020-09-02-170231,170231,0,0,0,34,4.75,105.86159419511657,2
2020-09-03-170231,170231,0,0,0,34,2.25,135.05932360889236,3
2020-09-04-170231,170231,0,0,2,34,3.25,109.55349633677214,4
2020-09-05-170231,170231,0,0,0,34,3.0,92.4405783303641,5
2020-09-06-170231,170231,0,0,0,34,1.0,91.97786139241695,6
2020-09-07-170231,170231,0,0,1,34,6.5,89.24434401488249,0
2020-09-08-170231,170231,0,0,1,34,2.25,73.73325303803782,1
2020-09-09-170231,170231,0,0,2,34,4.5,69.08553601077821,2
2020-09-10-170231,170231,1,0,2,35,4.0,44.95190912625472,3
2020-09-11-170231,170231,1,0,3,36,6.0,46.83942001296847,4
2020-09-12-170231,170231,0,1,0,36,5.5,50.75152195146822,5
2020-09-13-170231,170231,0,0,0,36,3.75,59.62874653129259,6
2020-09-14-170231,170231,0,0,1,36,6.25,61.99866630271421,0
2020-09-15-170231,170231,2,0,0,38,12.25,67.35429235114545,1
2020-09-16-170231,170231,0,0,0,38,9.0,80.6686907381702,2
2020-09-17-170231,170231,0,0,0,38,10.5,88.09846772841009,3
2020-09-18-170231,170231,2,0,1,40,10.25,90.66622095416996,4
2020-09-19-170231,170231,0,0,0,40,3.0,106.03109454721206,5
2020-09-20-170231,170231,0,1,0,40,4.75,93.89791480350213,6
2020-09-21-170231,170231,1,0,0,41,16.0,91.73362110426193,0
2020-09-22-170231,170231,1,0,1,42,11.25,98.92201486485754,1
2020-09-23-170231,170231,2,0,0,44,10.25,107.05058120036833,2
2020-09-24-170231,170231,2,0,0,46,12.25,111.56346756866597,3
2020-09-25-170231,170231,3,0,0,49,22.0,107.85345653939656,4
2020-09-26-170231,170231,0,0,0,49,3.25,126.20346552697131,5
2020-09-27-170231,170231,0,0,0,49,2.25,127.89167198671547,6
2020-09-28-170231,170231,1,0,0,50,11.25,120.06020510570168,0
2020-09-29-170231,170231,0,0,0,50,7.0,117.98768140379315,1
2020-09-30-170231,170231,0,0,0,50,7.75,102.04115771789485,2
2020-10-01-170231,170231,0,0,0,50,15.5,0.0,3
2020-10-02-170231,170231,1,0,2,51,10.0,80.72026847601593,4
2020-10-03-170231,170231,0,0,0,51,2.5,87.2725578753001,5
2020-10-04-170231,170231,0,0,0,51,4.25,87.35042486185455,6
2020-10-05-170231,170231,0,0,0,51,5.5,80.65534613898943,0
2020-10-06-170231,170231,1,0,0,52,7.0,75.15306958608787,1
2020-10-07-170231,170231,0,0,0,52,6.5,71.2559077347802,2
2020-10-08-170231,170231,0,0,0,52,6.25,74.42912809049173,3
2020-10-09-170231,170231,0,0,0,52,3.0,80.97536689053133,4
2020-10-10-170231,170231,0,0,1,52,0.75,24.26947175468323,5
2020-10-11-170231,170231,0,0,0,52,0.5,27.156331625224738,6
2020-10-12-170231,170231,0,0,0,52,2.25,29.94661978289259,0
2020-10-13-170231,170231,0,0,1,52,8.5,33.96726780227685,1
2020-10-14-170231,170231,0,0,1,52,4.0,52.90494141662353,2
2020-10-15-170231,170231,0,0,0,52,3.0,62.88367189846688,3
2020-10-16-170231,170231,2,0,0,54,4.5,76.98882224663161,4
2020-10-17-170231,170231,0,0,0,54,1.0,66.66465760937447,5
2020-10-18-170231,170231,0,0,1,54,1.0,66.62293401422994,6
2020-10-19-170231,170231,0,0,0,54,4.25,66.51207907248862,0
2020-10-20-170231,170231,0,0,0,54,3.5,70.68290747689926,1
2020-10-21-170231,170231,0,0,0,54,5.5,67.28267056889293,2
2020-10-22-170231,170231,0,0,0,54,6.5,68.17041453240469,3
2020-10-23-170231,170231,0,0,0,54,6.25,67.90655802145562,4
2020-10-24-170231,170231,1,0,0,55,0.75,74.69778316121922,5
2020-10-25-170231,170231,0,0,1,55,4.75,74.66074435492627,6
2020-10-26-170231,170231,0,0,0,55,3.75,70.48205625998682,0
2020-10-27-170231,170231,1,0,0,56,4.75,67.6192689505682,1
2020-10-28-170231,170231,1,0,1,57,5.25,74.04122222485918,2
2020-10-29-170231,170231,0,0,0,57,4.75,80.11973396420989,3
2020-10-30-170231,170231,0,0,0,57,4.75,72.20675811543967,4
2020-10-31-170231,170231,0,0,0,57,2.75,83.51049213822587,5
2020-11-01-170231,170231,1,0,0,58,2.0,73.68768268256429,6
2020-11-02-170231,170231,0,0,0,58,2.5,69.72941642913355,0
2020-11-03-170231,170231,0,0,0,58,5.75,59.27813952740229,1
2020-11-04-170231,170231,0,0,0,58,3.75,69.04220329520182,2
2020-11-05-170231,170231,0,0,0,58,2.25,75.38553432356959,3
2020-11-06-170231,170231,0,0,0,58,3.75,68.41947982024205,4
2020-11-07-170231,170231,0,0,0,58,1.75,69.41412113626706,5
2020-11-08-170231,170231,1,0,0,59,0.5,67.25214182556388,6
2020-11-09-170231,170231,0,1,0,59,4.75,62.34719887978279,0
2020-11-10-170231,170231,0,0,0,59,5.5,75.02610144232435,1
2020-11-11-170231,170231,1,0,0,60,3.75,81.80191548786952,2
2020-11-12-170231,170231,0,0,0,60,3.5,83.1441096162304,3
2020-11-13-170231,170231,0,0,0,60,5.0,75.00558299296097,4
2020-03-01-170232,170232,0,0,0,0,0.0,0.0,6
2020-03-02-170232,170232,0,0,0,0,0.0,2.625586697421518,0
2020-03-03-170232,170232,0,0,0,0,0.0,15.674898133287767,1
2020-03-04-170232,170232,0,2,0,0,0.0,14.968591730456422,2
2020-03-05-170232,170232,0,0,0,0,0.0,15.220903093546577,3
2020-03-06-170232,170232,0,0,1,0,0.0,14.128157867457872,4
2020-03-07-170232,170232,0,0,0,0,0.0,14.600490540201083,5
2020-03-08-170232,170232,0,0,0,0,0.0,15.830710716920798,6
2020-03-09-170232,170232,0,0,1,0,0.0,15.85908666130355,0
2020-03-10-170232,170232,0,0,1,0,0.0,64.8965676022056,1
2020-03-11-170232,170232,0,0,0,0,0.0,56.227863669873074,2
2020-03-12-170232,170232,0,0,0,0,0.25,47.20086859817431,3
2020-03-13-170232,170232,0,0,0,0,0.25,37.92364367032905,4
2020-03-14-170232,170232,0,0,0,0,0.25,26.188709794076598,5
2020-03-15-170232,170232,0,0,0,0,0.25,19.959836012175302,6
2020-03-16-170232,170232,0,0,1,0,0.0,6.166017702611736,0
2020-03-17-170232,170232,0,0,0,0,0.75,8.160366454023823,1
2020-03-18-170232,170232,0,0,0,0,0.75,10.568252222025926,2
2020-03-19-170232,170232,0,0,0,0,0.5,14.249378432727177,3
2020-03-20-170232,170232,1,0,0,1,1.5,17.281051775764144,4
2020-03-21-170232,170232,0,0,0,1,0.75,22.20695686142928,5
2020-03-22-170232,170232,0,0,0,1,0.5,22.482763196238032,6
2020-03-23-170232,170232,1,0,0,2,1.5,22.25991898966791,0
2020-03-24-170232,170232,1,0,0,3,1.5,28.990625216611896,1
2020-03-25-170232,170232,0,0,0,3,0.75,34.76173774356205,2
2020-03-26-170232,170232,0,0,0,3,3.0,35.205088630206106,3
2020-03-27-170232,170232,0,1,1,3,0.75,40.003437269667366,4
2020-03-28-170232,170232,0,0,0,3,0.25,37.39849737248578,5
2020-03-29-170232,170232,0,0,0,3,0.25,36.920025006865075,6
2020-03-30-170232,170232,1,0,0,4,1.5,27.46806260048391,0
2020-03-31-170232,170232,0,0,0,4,0.75,24.974241477566082,1
2020-04-01-170232,170232,0,0,1,4,3.5,4.4088257754149005,2
2020-04-02-170232,170232,0,0,0,4,0.75,11.954026800332182,3
2020-04-03-170232,170232,0,0,0,4,1.75,7.402420220836767,4
2020-04-04-170232,170232,0,0,0,4,1.25,12.173757571741472,5
2020-04-05-170232,170232,0,0,0,4,0.25,12.08774769278152,6
2020-04-06-170232,170232,0,0,0,4,0.75,12.012326646117213,0
2020-04-07-170232,170232,0,0,0,4,1.25,14.139336982273807,1
2020-04-08-170232,170232,0,0,0,4,0.5,16.154484695443074,2
2020-04-09-170232,170232,0,0,0,4,0.5,17.42579614288544,3
2020-04-10-170232,170232,1,1,0,5,0.75,5.900768331735889,4
2020-04-11-170232,170232,0,0,1,5,0.75,7.79685264701329,5
2020-04-12-170232,170232,0,0,0,5,0.25,8.54335436612742,6
2020-04-13-170232,170232,0,1,1,5,1.0,8.55436224908092,0
2020-04-14-170232,170232,0,0,0,5,0.75,11.582339132110679,1
2020-04-15-170232,170232,1,0,0,6,0.25,13.540525292091653,2
2020-04-16-170232,170232,0,0,0,6,0.5,16.27157360232993,3
2020-04-17-170232,170232,0,0,0,6,0.5,14.223918949013733,4
2020-04-18-170232,170232,0,0,0,6,0.25,13.577793304830175,5
2020-04-19-170232,170232,0,0,0,6,0.0,13.334267561656548,6
2020-04-20-170232,170232,0,0,0,6,1.25,15.380627022096945,0
2020-04-21-170232,170232,0,0,0,6,1.0,15.691829574467619,1
2020-04-22-170232,170232,0,0,0,6,0.25,14.260981420312719,2
2020-04-23-170232,170232,0,0,0,6,0.0,13.80243359952539,3
2020-04-24-170232,170232,0,0,0,6,0.0,12.196827773056345,4
2020-04-25-170232,170232,1,0,0,7,0.25,12.905152454059552,5
2020-04-26-170232,170232,0,0,0,7,0.25,13.22956556097063,6
2020-04-27-170232,170232,1,0,0,8,0.25,9.43725119009493,0
2020-04-28-170232,170232,0,0,0,8,0.5,8.836737787853574,1
2020-04-29-170232,170232,0,0,0,8,0.5,8.879589242523576,2
2020-04-30-170232,170232,0,0,0,8,0.0,13.802847083795504,3
2020-05-01-170232,170232,0,0,0,8,0.0,19.49140926734844,4
2020-05-02-170232,170232,0,0,0,8,0.0,9.212252088773099,5
2020-05-03-170232,170232,0,0,0,8,0.0,4.731007633494745,6
2020-05-04-170232,170232,0,0,0,8,0.25,3.8080586272547063,0
2020-05-05-170232,170232,0,0,0,8,0.25,4.6806653110583145,1
2020-05-06-170232,170232,0,0,0,8,0.5,5.614035052995048,2
2020-05-07-170232,170232,0,0,0,8,0.25,6.120915914067588,3
2020-05-08-170232,170232,0,0,1,8,0.5,5.4843288961884795,4
2020-05-09-170232,170232,0,0,0,8,0.25,7.132140565952612,5
2020-05-10-170232,170232,0,1,0,8,0.0,22.395526659443625,6
2020-05-11-170232,170232,0,3,0,8,0.75,21.08592774768917,0
2020-05-12-170232,170232,0,0,0,8,0.75,20.605531196320236,1
2020-05-13-170232,170232,0,0,0,8,1.25,16.532820714653404,2
2020-05-14-170232,170232,0,0,0,8,0.5,14.967621277869403,3
2020-05-15-170232,170232,0,0,0,8,0.5,14.297450098389701,4
2020-05-16-170232,170232,0,0,0,8,0.0,11.59752426633711,5
2020-05-17-170232,170232,0,0,0,8,0.0,11.013036385518536,6
2020-05-18-170232,170232,0,0,0,8,0.25,10.911413811980022,0
2020-05-19-170232,170232,0,0,1,8,0.75,11.560521906964667,1
2020-05-20-170232,170232,0,0,0,8,0.5,8.714798938016692,2
2020-05-21-170232,170232,0,0,0,8,0.25,7.925013595198782,3
2020-05-22-170232,170232,1,0,0,9,1.0,6.271062735111242,4
2020-05-23-170232,170232,0,0,0,9,0.0,8.776792327281642,5
2020-05-24-170232,170232,0,0,0,9,0.0,9.022242705341412,6
2020-05-25-170232,170232,0,0,0,9,0.25,7.112062677488837,0
2020-05-26-170232,170232,0,0,0,9,0.75,7.957529854348095,1
2020-05-27-170232,170232,0,0,0,9,0.25,8.819292266617419,2
2020-05-28-170232,170232,0,1,0,9,0.5,8.04926700934984,3
2020-05-29-170232,170232,0,0,0,9,0.25,7.891472543648221,4
2020-05-30-170232,170232,0,0,0,9,0.25,7.753930730223468,5
2020-05-31-170232,170232,0,0,0,9,0.75,8.564673343866481,6
2020-06-01-170232,170232,0,1,0,9,0.0,11.564073164746866,0
2020-06-02-170232,170232,1,0,0,10,1.25,5.193892469598272,1
2020-06-03-170232,170232,0,0,0,10,0.0,2.197915546641828,2
2020-06-04-170232,170232,0,0,0,10,1.5,3.625357066901017,3
2020-06-05-170232,170232,0,0,0,10,0.75,5.612549079697644,4
2020-06-06-170232,170232,0,1,0,10,0.25,6.000656198315247,5
2020-06-07-170232,170232,0,0,0,10,0.0,5.895619582536461,6
2020-06-08-170232,170232,0,0,0,10,0.75,5.849787491114707,0
2020-06-09-170232,170232,0,0,0,10,0.25,6.925731745172796,1
2020-06-10-170232,170232,0,0,0,10,0.0,11.495454601355942,2
2020-06-11-170232,170232,0,0,0,10,0.5,11.720884519871142,3
2020-06-12-170232,170232,0,0,0,10,0.25,10.84070324704097,4
2020-06-13-170232,170232,0,0,0,10,0.0,9.881500074794802,5
2020-06-14-170232,170232,0,0,0,10,0.25,8.536318824128186,6
2020-06-15-170232,170232,0,0,0,10,2.75,7.579470722981206,0
2020-06-16-170232,170232,0,0,0,10,0.5,8.681369253759453,1
2020-06-17-170232,170232,0,0,0,10,0.25,8.646875183334185,2
2020-06-18-170232,170232,0,0,0,10,0.0,6.719000451759667,3
2020-06-19-170232,170232,0,0,0,10,0.5,5.872706099159321,4
2020-06-20-170232,170232,0,0,0,10,0.0,7.627576281619914,5
2020-06-21-170232,170232,0,0,0,10,0.25,7.2011992622165995,6
2020-06-22-170232,170232,0,0,0,10,0.0,6.245048057877657,0
2020-06-23-170232,170232,0,0,0,10,0.0,4.948729900944139,1
2020-06-24-170232,170232,0,1,0,10,0.0,4.977012455531041,2
2020-06-25-170232,170232,0,0,0,10,0.0,5.331521130527788,3
2020-06-26-170232,170232,0,0,0,10,0.25,4.892494244020348,4
2020-06-27-170232,170232,0,0,0,10,0.0,2.80614734543249,5
2020-06-28-170232,170232,0,0,0,10,0.0,3.139566082959018,6
2020-06-29-170232,170232,0,0,0,10,0.0,2.9446415251412716,0
2020-06-30-170232,170232,0,0,0,10,0.25,4.081563931497243,1
2020-07-01-170232,170232,0,0,1,10,0.0,8.697474427056939,2
2020-07-02-170232,170232,0,0,0,10,0.0,11.181740619212537,3
2020-07-03-170232,170232,0,0,0,10,0.0,5.8211015646973925,4
2020-07-04-170232,170232,0,0,0,10,0.25,8.972869519113225,5
2020-07-05-170232,170232,0,0,0,10,0.5,8.915609107168137,6
2020-07-06-170232,170232,0,0,0,10,1.75,8.098763497071946,0
2020-07-07-170232,170232,0,0,0,10,0.75,8.408969498848947,1
2020-07-08-170232,170232,0,0,0,10,0.75,8.174446959630792,2
2020-07-09-170232,170232,0,1,0,10,0.0,8.557871135518337,3
2020-07-10-170232,170232,0,0,0,10,0.5,8.623904161288806,4
2020-07-11-170232,170232,0,0,0,10,0.0,6.853948608656024,5
2020-07-12-170232,170232,0,0,0,10,0.25,5.744695098560323,6
2020-07-13-170232,170232,0,0,0,10,0.0,5.571622142689765,0
2020-07-14-170232,170232,0,0,0,10,0.5,5.743526934065551,1
2020-07-15-170232,170232,1,0,0,11,0.75,5.835724156007272,2
2020-07-16-170232,170232,0,0,0,11,0.0,7.354977912483395,3
2020-07-17-170232,170232,0,0,0,11,0.0,6.964628513107034,4
2020-07-18-170232,170232,0,0,0,11,0.0,6.100128546611145,5
2020-07-19-170232,170232,0,0,0,11,0.25,7.131295942028494,6
2020-07-20-170232,170232,0,0,0,11,0.5,12.712607633678605,0
2020-07-21-170232,170232,0,0,0,11,0.25,12.04402589215165,1
2020-07-22-170232,170232,0,0,0,11,0.5,15.433432563899277,2
2020-07-23-170232,170232,0,0,0,11,0.0,16.46552942219617,3
2020-07-24-170232,170232,0,0,0,11,0.25,16.730994939150026,4
2020-07-25-170232,170232,0,0,1,11,1.0,16.83002205245544,5
2020-07-26-170232,170232,0,0,0,11,0.25,11.270655329319364,6
2020-07-27-170232,170232,0,0,1,11,0.25,11.342447429741636,0
2020-07-28-170232,170232,0,0,4,11,1.25,11.51632093176888,1
2020-07-29-170232,170232,0,0,1,11,1.0,6.986712906178111,2
2020-07-30-170232,170232,0,0,2,11,0.75,9.078924370946687,3
2020-07-31-170232,170232,0,0,1,11,0.5,10.453090687700875,4
2020-08-01-170232,170232,0,0,0,11,0.5,10.405300039338684,5
2020-08-02-170232,170232,0,1,0,11,1.25,56.22776972978774,6
2020-08-03-170232,170232,0,0,0,11,1.0,53.57368598276517,0
2020-08-04-170232,170232,0,0,0,11,2.5,65.60972516718026,1
2020-08-05-170232,170232,0,0,0,11,3.5,85.61505293372821,2
2020-08-06-170232,170232,0,0,1,11,1.75,93.78374697416741,3
2020-08-07-170232,170232,0,0,0,11,4.25,89.86748945482142,4
2020-08-08-170232,170232,1,1,0,12,1.0,107.91881257795426,5
2020-08-09-170232,170232,0,0,0,12,0.75,100.38656131548805,6
2020-08-10-170232,170232,1,0,0,13,1.25,11.13068206618341,0
2020-08-11-170232,170232,4,0,0,17,3.25,18.888655188334837,1
2020-08-12-170232,170232,1,0,0,18,3.5,31.60489779025233,2
2020-08-13-170232,170232,2,0,4,20,1.75,43.1778063295759,3
2020-08-14-170232,170232,1,0,1,21,1.5,61.355410302516795,4
2020-08-15-170232,170232,0,0,0,21,0.25,63.503101514302585,5
2020-08-16-170232,170232,0,0,0,21,1.0,63.99522050291434,6
2020-08-17-170232,170232,0,0,3,21,1.0,65.10448645226963,0
2020-08-18-170232,170232,0,0,0,21,4.0,62.11473134844912,1
2020-08-19-170232,170232,0,0,1,21,2.0,58.61003747313156,2
2020-08-20-170232,170232,1,0,0,22,3.25,46.5368008175169,3
2020-08-21-170232,170232,0,0,0,22,4.0,52.69031618661376,4
2020-08-22-170232,170232,0,0,5,22,1.75,70.88927981854886,5
2020-08-23-170232,170232,0,0,0,22,1.5,75.48913539207345,6
2020-08-24-170232,170232,0,0,0,22,1.75,72.02391818353618,0
2020-08-25-170232,170232,0,0,0,22,0.75,71.91800976758675,1
2020-08-26-170232,170232,0,0,0,22,2.75,65.60771675633453,2
2020-08-27-170232,170232,4,0,1,26,1.25,62.80704911366898,3
2020-08-28-170232,170232,1,0,0,27,3.75,63.96616491566177,4
2020-08-29-170232,170232,0,0,0,27,0.75,55.19587041590641,5
2020-08-30-170232,170232,0,0,0,27,2.0,56.327570518464746,6
2020-08-31-170232,170232,3,0,0,30,2.0,50.67966738706086,0
2020-09-01-170232,170232,0,0,1,30,1.5,81.74306325020848,1
2020-09-02-170232,170232,1,0,0,31,3.5,55.77978688812584,2
2020-09-03-170232,170232,0,0,0,31,1.75,34.91925398080902,3
2020-09-04-170232,170232,0,0,1,31,0.5,32.89408543689129,4
2020-09-05-170232,170232,5,0,0,36,0.5,31.255196664214346,5
2020-09-06-170232,170232,0,0,0,36,0.0,31.686817714115893,6
2020-09-07-170232,170232,0,0,0,36,0.5,31.39071564774906,0
2020-09-08-170232,170232,0,0,1,36,0.75,27.840016538005237,1
2020-09-09-170232,170232,0,0,1,36,2.5,33.53858483403644,2
2020-09-10-170232,170232,1,0,3,37,0.75,61.18008393665247,3
2020-09-11-170232,170232,0,0,0,37,1.75,45.90892071952703,4
2020-09-12-170232,170232,0,0,0,37,0.75,47.17669386669745,5
2020-09-13-170232,170232,0,0,0,37,1.5,55.7041336711909,6
2020-09-14-170232,170232,0,0,0,37,5.0,45.30541877142579,0
2020-09-15-170232,170232,1,0,0,38,3.75,48.63293177703595,1
2020-09-16-170232,170232,0,0,0,38,1.75,56.795369011822096,2
2020-09-17-170232,170232,0,0,0,38,2.5,56.44145622729944,3
2020-09-18-170232,170232,1,0,0,39,3.5,63.71069128207492,4
2020-09-19-170232,170232,0,0,0,39,3.25,57.9733247209475,5
2020-09-20-170232,170232,0,0,1,39,1.5,51.17797933316422,6
2020-09-21-170232,170232,0,0,1,39,2.5,44.134414210419536,0
2020-09-22-170232,170232,1,0,0,40,2.0,39.46450780425185,1
2020-09-23-170232,170232,1,0,0,41,2.0,41.26788616703017,2
2020-09-24-170232,170232,3,0,0,44,1.25,36.030387937035044,3
2020-09-25-170232,170232,0,0,1,44,1.5,32.19677241716491,4
2020-09-26-170232,170232,0,0,0,44,0.5,32.719724998316096,5
2020-09-27-170232,170232,0,0,0,44,1.5,29.43590028597269,6
2020-09-28-170232,170232,0,0,0,44,1.0,29.98964725790111,0
2020-09-29-170232,170232,0,0,0,44,0.75,30.474264143089272,1
2020-09-30-170232,170232,0,0,0,44,2.0,25.790746272065682,2
2020-10-01-170232,170232,0,0,0,44,1.75,0.0,3
2020-10-02-170232,170232,0,0,0,44,0.75,52.91125051670775,4
2020-10-03-170232,170232,0,0,0,44,1.25,73.97121619707539,5
2020-10-04-170232,170232,1,0,0,45,0.0,84.10910631469233,6
2020-10-05-170232,170232,1,1,0,46,1.75,69.44848820848587,0
2020-10-06-170232,170232,0,0,1,46,3.5,64.0689786001178,1
2020-10-07-170232,170232,0,0,2,46,0.5,54.452832595501555,2
2020-10-08-170232,170232,0,0,0,46,1.75,50.760667228531396,3
2020-10-09-170232,170232,1,0,0,47,1.75,54.37586098582879,4
2020-10-10-170232,170232,0,0,1,47,1.5,4.148272127154129,5
2020-10-11-170232,170232,0,0,0,47,1.25,6.338641879230572,6
2020-10-12-170232,170232,0,0,1,47,0.75,8.902424003545669,0
2020-10-13-170232,170232,0,0,1,47,2.75,12.159667064534228,1
2020-10-14-170232,170232,0,0,0,47,4.0,20.433800593587588,2
2020-10-15-170232,170232,0,0,1,47,2.0,28.560033253819416,3
2020-10-16-170232,170232,0,0,2,47,5.0,40.061155900329176,4
2020-10-17-170232,170232,0,0,2,47,3.5,47.82087968270285,5
2020-10-18-170232,170232,0,0,1,47,6.0,47.923828432778045,6
2020-10-19-170232,170232,0,0,1,47,1.25,49.210577881776004,0
2020-10-20-170232,170232,1,0,0,48,4.5,51.6009813128665,1
2020-10-21-170232,170232,2,0,2,50,4.5,53.226406233694206,2
2020-10-22-170232,170232,0,0,1,50,10.25,55.989658123466434,3
2020-10-23-170232,170232,0,0,1,50,4.0,55.10475716609412,4
2020-10-24-170232,170232,1,0,0,51,5.25,58.50686575654203,5
2020-10-25-170232,170232,0,0,0,51,5.25,58.047553714282,6
2020-10-26-170232,170232,1,0,0,52,5.0,50.72418305993949,0
2020-10-27-170232,170232,1,0,0,53,5.25,59.639017311406995,1
2020-10-28-170232,170232,0,0,0,53,7.0,61.40413513484362,2
2020-10-29-170232,170232,1,0,1,54,9.25,64.49116114087475,3
2020-10-30-170232,170232,2,0,0,56,3.75,58.20976955299746,4
2020-10-31-170232,170232,2,0,0,58,2.25,69.25856352478749,5
2020-11-01-170232,170232,1,0,0,59,3.5,37.104672878149344,6
2020-11-02-170232,170232,1,0,0,60,4.25,79.26577100037098,0
2020-11-03-170232,170232,0,0,0,60,5.5,67.7481202017455,1
2020-11-04-170232,170232,2,1,0,62,5.5,71.82089412423514,2
2020-11-05-170232,170232,1,0,0,63,3.75,72.86520849498572,3
2020-11-06-170232,170232,1,0,0,64,4.0,70.70895042639002,4
2020-11-07-170232,170232,0,0,0,64,4.25,72.11927264610652,5
2020-11-08-170232,170232,0,0,0,64,5.25,73.44431565345127,6
2020-11-09-170232,170232,0,0,0,64,6.25,72.60575700054274,0
2020-11-10-170232,170232,0,0,0,64,3.5,35.69868175168651,1
2020-11-11-170232,170232,0,0,0,64,4.25,44.83714234926831,2
2020-11-12-170232,170232,1,0,0,65,5.0,52.23775800785674,3
2020-11-13-170232,170232,0,0,0,65,6.0,54.47025052963751,4
2020-03-01-170233,170233,0,0,1,0,0.0,0.0,6
2020-03-02-170233,170233,0,0,0,0,0.0,10.47730109103544,0
2020-03-03-170233,170233,0,0,2,0,0.0,42.98691128041939,1
2020-03-04-170233,170233,0,1,0,0,0.14285714285714285,54.568547971427066,2
2020-03-05-170233,170233,0,0,2,0,0.0,59.33105437449897,3
2020-03-06-170233,170233,0,1,2,0,0.14285714285714285,48.315049658318685,4
2020-03-07-170233,170233,0,0,1,0,0.0,52.39307372691817,5
2020-03-08-170233,170233,0,0,0,0,0.0,44.72922687213014,6
2020-03-09-170233,170233,0,0,1,0,0.42857142857142855,44.430054728396705,0
2020-03-10-170233,170233,0,0,1,0,0.14285714285714285,212.14363902304163,1
2020-03-11-170233,170233,0,0,0,0,0.14285714285714285,176.71423821064326,2
2020-03-12-170233,170233,1,0,1,1,0.2857142857142857,143.0115916450586,3
2020-03-13-170233,170233,0,0,3,1,1.0,120.25539571855879,4
2020-03-14-170233,170233,0,0,0,1,1.4285714285714286,96.5679853943347,5
2020-03-15-170233,170233,1,0,3,2,0.8571428571428571,68.0500745876875,6
2020-03-16-170233,170233,0,0,1,2,1.0,24.986728665323543,0
2020-03-17-170233,170233,2,0,1,4,2.0,34.62563262288179,1
2020-03-18-170233,170233,0,0,0,4,1.4285714285714286,45.5321789451675,2
2020-03-19-170233,170233,2,0,1,6,3.4285714285714284,51.87819369772291,3
2020-03-20-170233,170233,2,0,0,8,4.0,58.527163072218926,4
2020-03-21-170233,170233,1,0,1,9,1.2857142857142858,69.45309601874838,5
2020-03-22-170233,170233,0,0,1,9,1.2857142857142858,66.62021322963223,6
2020-03-23-170233,170233,1,0,1,10,4.428571428571429,62.124446573863445,0
2020-03-24-170233,170233,1,0,0,11,3.4285714285714284,68.83039139846761,1
2020-03-25-170233,170233,0,0,3,11,3.2857142857142856,76.97846089222281,2
2020-03-26-170233,170233,1,0,1,12,3.4285714285714284,70.5537535260793,3
2020-03-27-170233,170233,3,0,1,15,4.428571428571429,85.86593124212035,4
2020-03-28-170233,170233,0,0,3,15,1.0,91.03476163191432,5
2020-03-29-170233,170233,3,0,0,18,0.8571428571428571,87.98243023160863,6
2020-03-30-170233,170233,1,0,3,19,3.8571428571428568,77.70240396297098,0
2020-03-31-170233,170233,1,0,0,20,1.7142857142857142,81.16680728913785,1
2020-04-01-170233,170233,0,0,0,20,2.571428571428572,9.252597842296701,2
2020-04-02-170233,170233,1,0,0,21,2.2857142857142856,46.26813045136406,3
2020-04-03-170233,170233,0,0,1,21,2.142857142857143,13.375028644743004,4
2020-04-04-170233,170233,1,0,0,22,0.42857142857142855,17.689821111473645,5
2020-04-05-170233,170233,1,0,1,23,0.7142857142857143,20.971772962545014,6
2020-04-06-170233,170233,1,0,1,24,1.7142857142857142,23.84051153541279,0
2020-04-07-170233,170233,0,0,0,24,2.7142857142857144,28.201450135520396,1
2020-04-08-170233,170233,3,0,1,27,2.4285714285714284,33.11092149379131,2
2020-04-09-170233,170233,1,0,0,28,5.142857142857143,44.18673744472483,3
2020-04-10-170233,170233,1,1,0,29,2.142857142857143,6.95598997082516,4
2020-04-11-170233,170233,3,0,0,32,0.7142857142857143,16.257416124920752,5
2020-04-12-170233,170233,0,0,0,32,0.42857142857142855,23.60859144663449,6
2020-04-13-170233,170233,3,1,0,35,2.0,24.872152680368966,0
2020-04-14-170233,170233,0,0,0,35,2.0,36.46122827917343,1
2020-04-15-170233,170233,0,0,0,35,3.0,43.70010113727012,2
2020-04-16-170233,170233,0,0,0,35,1.7142857142857142,46.929860322777635,3
2020-04-17-170233,170233,1,0,0,36,1.2857142857142858,46.86925437186883,4
2020-04-18-170233,170233,0,0,1,36,0.2857142857142857,48.73313214873201,5
2020-04-19-170233,170233,1,0,0,37,1.4285714285714286,41.57164633238301,6
2020-04-20-170233,170233,1,2,2,38,2.0,40.59322534506023,0
2020-04-21-170233,170233,0,0,2,38,1.4285714285714286,43.50173568461993,1
2020-04-22-170233,170233,1,0,2,39,0.5714285714285714,42.07083878336937,2
2020-04-23-170233,170233,0,0,0,39,0.14285714285714285,44.610498856855116,3
2020-04-24-170233,170233,0,0,0,39,0.7142857142857143,35.24592540833296,4
2020-04-25-170233,170233,0,0,1,39,0.2857142857142857,37.533390047056145,5
2020-04-26-170233,170233,0,0,0,39,0.2857142857142857,34.853418128877784,6
2020-04-27-170233,170233,0,0,1,39,1.2857142857142858,27.445368059379952,0
2020-04-28-170233,170233,0,1,0,39,0.8571428571428571,20.471404324911973,1
2020-04-29-170233,170233,0,0,0,39,1.0,18.16393534268358,2
2020-04-30-170233,170233,0,0,0,39,0.7142857142857143,20.917540840704202,3
2020-05-01-170233,170233,0,0,1,39,0.5714285714285714,56.882496336899294,4
2020-05-02-170233,170233,1,0,0,40,0.0,25.398197965041582,5
2020-05-03-170233,170233,0,0,1,40,0.14285714285714285,17.53470068774194,6
2020-05-04-170233,170233,2,0,0,42,1.1428571428571428,17.282514474171947,0
2020-05-05-170233,170233,2,0,1,44,0.8571428571428571,20.104383959152806,1
2020-05-06-170233,170233,2,0,0,46,0.5714285714285714,25.33143265821036,2
2020-05-07-170233,170233,0,0,0,46,0.42857142857142855,29.939323475533296,3
2020-05-08-170233,170233,0,0,0,46,1.8571428571428568,28.164145297251373,4
2020-05-09-170233,170233,1,0,0,47,0.14285714285714285,35.09358536361785,5
2020-05-10-170233,170233,0,0,0,47,0.14285714285714285,62.98536308901322,6
2020-05-11-170233,170233,1,1,0,48,0.8571428571428571,56.15910605016792,0
2020-05-12-170233,170233,0,0,1,48,1.0,57.67189919255008,1
2020-05-13-170233,170233,0,0,0,48,1.7142857142857142,49.70282196819586,2
2020-05-14-170233,170233,0,0,0,48,1.7142857142857142,44.77320422553905,3
2020-05-15-170233,170233,1,0,1,49,1.1428571428571428,35.730723182357565,4
2020-05-16-170233,170233,0,0,0,49,0.0,28.35060555940567,5
2020-05-17-170233,170233,1,0,0,50,0.0,26.992616996892494,6
2020-05-18-170233,170233,0,0,0,50,1.2857142857142858,29.80036497158739,0
2020-05-19-170233,170233,1,0,2,51,0.8571428571428571,29.27048082924941,1
2020-05-20-170233,170233,0,0,1,51,1.1428571428571428,30.472230604759634,2
2020-05-21-170233,170233,0,0,0,51,0.5714285714285714,32.49693438008339,3
2020-05-22-170233,170233,0,0,0,51,1.5714285714285714,30.549328374375268,4
2020-05-23-170233,170233,0,0,0,51,0.0,38.560204287027055,5
2020-05-24-170233,170233,0,0,0,51,0.0,36.521348731396316,6
2020-05-25-170233,170233,0,0,0,51,0.8571428571428571,31.420215073355543,0
2020-05-26-170233,170233,1,0,0,52,1.0,29.02428071548,1
2020-05-27-170233,170233,0,0,0,52,0.5714285714285714,32.46771688947546,2
2020-05-28-170233,170233,0,2,1,52,1.1428571428571428,26.95483603781807,3
2020-05-29-170233,170233,1,0,0,53,0.5714285714285714,28.72757642785499,4
2020-05-30-170233,170233,0,0,0,53,0.14285714285714285,30.52793204636578,5
2020-05-31-170233,170233,0,0,0,53,0.42857142857142855,32.8122366990718,6
2020-06-01-170233,170233,0,0,1,53,0.0,56.02930302678584,0
2020-06-02-170233,170233,2,0,0,55,1.4285714285714286,21.16496560253899,1
2020-06-03-170233,170233,1,1,0,56,0.2857142857142857,8.73807930415692,2
2020-06-04-170233,170233,0,0,0,56,0.7142857142857143,13.406760082180034,3
2020-06-05-170233,170233,0,0,0,56,0.8571428571428571,14.44279147438069,4
2020-06-06-170233,170233,0,0,0,56,0.2857142857142857,16.53842942082483,5
2020-06-07-170233,170233,0,0,1,56,0.0,16.440013352986636,6
2020-06-08-170233,170233,0,0,0,56,0.2857142857142857,16.417357580214244,0
2020-06-09-170233,170233,0,0,0,56,0.14285714285714285,18.513593848858463,1
2020-06-10-170233,170233,0,0,0,56,0.2857142857142857,48.59077651414339,2
2020-06-11-170233,170233,1,0,0,57,0.5714285714285714,41.45655248789714,3
2020-06-12-170233,170233,0,0,0,57,0.42857142857142855,38.40929427830038,4
2020-06-13-170233,170233,0,0,0,57,0.14285714285714285,28.481212145674697,5
2020-06-14-170233,170233,0,0,0,57,0.2857142857142857,25.48015637853328,6
2020-06-15-170233,170233,1,0,0,58,1.4285714285714286,18.73597691609866,0
2020-06-16-170233,170233,0,0,0,58,0.8571428571428571,23.89891955263068,1
2020-06-17-170233,170233,0,0,0,58,0.42857142857142855,26.16569547900536,2
2020-06-18-170233,170233,0,0,0,58,0.42857142857142855,24.482363494197955,3
2020-06-19-170233,170233,0,0,0,58,0.14285714285714285,20.648916556332722,4
2020-06-20-170233,170233,0,1,0,58,0.0,30.838235595462475,5
2020-06-21-170233,170233,1,1,0,59,0.14285714285714285,31.888912545858968,6
2020-06-22-170233,170233,0,0,0,59,0.14285714285714285,27.56863485935984,0
2020-06-23-170233,170233,0,0,0,59,0.2857142857142857,23.9661264958127,1
2020-06-24-170233,170233,0,0,0,59,0.42857142857142855,24.228160049817493,2
2020-06-25-170233,170233,0,1,1,59,0.2857142857142857,24.191778545401014,3
2020-06-26-170233,170233,0,2,0,59,0.42857142857142855,24.611208437441142,4
2020-06-27-170233,170233,0,0,0,59,0.42857142857142855,13.835013438653515,5
2020-06-28-170233,170233,0,0,2,59,0.0,15.421649213439578,6
2020-06-29-170233,170233,0,0,0,59,0.0,10.766582500238881,0
2020-06-30-170233,170233,0,0,0,59,0.2857142857142857,16.555799432604243,1
2020-07-01-170233,170233,0,0,0,59,0.14285714285714285,18.55173376371758,2
2020-07-02-170233,170233,0,0,0,59,0.0,11.668972273086162,3
2020-07-03-170233,170233,0,0,0,59,0.14285714285714285,24.12139732483416,4
2020-07-04-170233,170233,0,0,0,59,0.14285714285714285,25.802132320035582,5
2020-07-05-170233,170233,0,0,0,59,0.42857142857142855,26.241834219985126,6
2020-07-06-170233,170233,0,0,0,59,0.5714285714285714,22.424784446120224,0
2020-07-07-170233,170233,0,0,0,59,0.7142857142857143,22.769574486637907,1
2020-07-08-170233,170233,0,0,0,59,0.0,20.194806745783335,2
2020-07-09-170233,170233,1,0,0,60,0.2857142857142857,20.29464832104322,3
2020-07-10-170233,170233,0,0,1,60,0.14285714285714285,17.69140860299165,4
2020-07-11-170233,170233,0,0,0,60,0.0,16.08423371340889,5
2020-07-12-170233,170233,2,0,0,62,0.2857142857142857,10.451033686509481,6
2020-07-13-170233,170233,0,0,0,62,0.0,17.32419321477075,0
2020-07-14-170233,170233,0,0,0,62,0.14285714285714285,18.31166158982972,1
2020-07-15-170233,170233,0,0,0,62,0.14285714285714285,16.62599943746419,2
2020-07-16-170233,170233,0,0,0,62,0.0,16.64121368223754,3
2020-07-17-170233,170233,0,0,1,62,0.14285714285714285,18.214888154743377,4
2020-07-18-170233,170233,0,0,0,62,0.14285714285714285,19.488831708142865,5
2020-07-19-170233,170233,0,0,0,62,0.14285714285714285,20.95068274545617,6
2020-07-20-170233,170233,0,0,0,62,0.0,12.545399775548873,0
2020-07-21-170233,170233,0,0,0,62,0.14285714285714285,12.1737182705903,1
2020-07-22-170233,170233,0,0,0,62,0.0,11.773492834844856,2
2020-07-23-170233,170233,0,0,0,62,0.2857142857142857,10.735192039412839,3
2020-07-24-170233,170233,1,0,0,63,0.0,11.782252440339413,4
2020-07-25-170233,170233,0,0,0,63,0.5714285714285714,16.52111327408911,5
2020-07-26-170233,170233,0,0,0,63,0.14285714285714285,17.335448414194833,6
2020-07-27-170233,170233,0,0,1,63,0.5714285714285714,16.925267614964056,0
2020-07-28-170233,170233,0,0,1,63,0.5714285714285714,20.81645630591673,1
2020-07-29-170233,170233,0,0,2,63,1.1428571428571428,21.89045022412074,2
2020-07-30-170233,170233,0,0,4,63,1.0,25.877550973942625,3
2020-07-31-170233,170233,1,0,2,64,1.1428571428571428,24.919209992245644,4
2020-08-01-170233,170233,0,0,1,64,0.42857142857142855,23.36027600090905,5
2020-08-02-170233,170233,0,0,0,64,1.0,103.2089939799682,6
2020-08-03-170233,170233,0,0,0,64,0.8571428571428571,128.36946280178722,0
2020-08-04-170233,170233,0,0,0,64,3.4285714285714284,89.35885224897996,1
2020-08-05-170233,170233,0,0,1,64,2.7142857142857144,91.88220903289616,2
2020-08-06-170233,170233,0,0,0,64,0.7142857142857143,83.27815178451787,3
2020-08-07-170233,170233,0,0,0,64,1.0,70.22598580655318,4
2020-08-08-170233,170233,0,0,1,64,1.5714285714285714,71.1449221921601,5
2020-08-09-170233,170233,0,0,2,64,0.0,77.86503911900985,6
2020-08-10-170233,170233,1,0,1,65,1.5714285714285714,18.48226485054407,0
2020-08-11-170233,170233,1,1,3,66,1.8571428571428568,31.2075021257234,1
2020-08-12-170233,170233,2,0,1,68,2.4285714285714284,41.11409405632527,2
2020-08-13-170233,170233,4,0,3,72,1.5714285714285714,61.00009947422954,3
2020-08-14-170233,170233,2,0,0,74,1.7142857142857142,78.66037336202999,4
2020-08-15-170233,170233,1,0,0,75,0.5714285714285714,96.12589141654503,5
2020-08-16-170233,170233,0,0,0,75,2.4285714285714284,100.33426089346796,6
2020-08-17-170233,170233,0,0,0,75,1.4285714285714286,114.79723702535037,0
2020-08-18-170233,170233,0,0,0,75,4.857142857142857,110.67883107869221,1
2020-08-19-170233,170233,1,0,0,76,1.4285714285714286,121.00160027785367,2
2020-08-20-170233,170233,0,0,0,76,1.4285714285714286,93.03548205565325,3
2020-08-21-170233,170233,0,0,2,76,2.4285714285714284,83.23055719999792,4
2020-08-22-170233,170233,1,0,0,77,1.2857142857142858,90.18866374689347,5
2020-08-23-170233,170233,2,0,0,79,0.7142857142857143,91.97421974986125,6
2020-08-24-170233,170233,1,0,0,80,3.7142857142857135,86.79707944690296,0
2020-08-25-170233,170233,3,0,1,83,1.4285714285714286,90.05841685767066,1
2020-08-26-170233,170233,1,0,1,84,2.0,114.51915256854896,2
2020-08-27-170233,170233,3,0,4,87,2.571428571428572,120.854973846077,3
2020-08-28-170233,170233,0,0,0,87,1.2857142857142858,137.3343162337723,4
2020-08-29-170233,170233,0,0,0,87,0.8571428571428571,137.85408793392648,5
2020-08-30-170233,170233,0,0,0,87,1.0,124.2119432782706,6
2020-08-31-170233,170233,0,0,0,87,1.0,105.41687534292761,0
2020-09-01-170233,170233,0,0,2,87,3.8571428571428568,63.24391967932634,1
2020-09-02-170233,170233,0,0,2,87,2.7142857142857144,115.60977026344169,2
2020-09-03-170233,170233,0,0,2,87,2.142857142857143,78.50353442002579,3
2020-09-04-170233,170233,2,0,0,89,1.2857142857142858,76.45227361384546,4
2020-09-05-170233,170233,0,0,0,89,0.7142857142857143,75.1215397879201,5
2020-09-06-170233,170233,0,0,0,89,0.2857142857142857,73.01079153939726,6
2020-09-07-170233,170233,0,0,1,89,1.1428571428571428,71.7722397307711,0
2020-09-08-170233,170233,1,0,0,90,2.8571428571428568,67.78363763599184,1
2020-09-09-170233,170233,1,0,1,91,1.2857142857142858,68.7563155311934,2
2020-09-10-170233,170233,4,0,2,95,2.571428571428572,68.58810055609055,3
2020-09-11-170233,170233,0,0,0,95,2.4285714285714284,75.82057621171944,4
2020-09-12-170233,170233,0,0,0,95,1.7142857142857142,77.18075198186355,5
2020-09-13-170233,170233,0,0,0,95,1.1428571428571428,83.77843425393522,6
2020-09-14-170233,170233,0,0,0,95,3.1428571428571432,85.36565662790491,0
2020-09-15-170233,170233,2,0,0,97,6.142857142857142,95.52375589533754,1
2020-09-16-170233,170233,2,0,0,99,3.7142857142857135,121.66416531720589,2
2020-09-17-170233,170233,2,0,0,101,3.7142857142857135,119.38580717344166,3
2020-09-18-170233,170233,0,0,1,101,3.2857142857142856,112.98621080968348,4
2020-09-19-170233,170233,0,0,0,101,1.7142857142857142,110.71467382376812,5
2020-09-20-170233,170233,0,0,0,101,1.8571428571428568,106.92016739481696,6
2020-09-21-170233,170233,1,1,0,102,2.8571428571428568,94.24718891841857,0
2020-09-22-170233,170233,0,0,1,102,2.8571428571428568,76.9895819216423,1
2020-09-23-170233,170233,1,0,0,103,4.285714285714286,67.50148801007055,2
2020-09-24-170233,170233,2,0,0,105,1.7142857142857142,68.29563718984093,3
2020-09-25-170233,170233,0,0,2,105,2.8571428571428568,63.34835325072574,4
2020-09-26-170233,170233,0,0,1,105,0.8571428571428571,68.79089717129955,5
2020-09-27-170233,170233,0,0,3,105,1.2857142857142858,63.90244807236749,6
2020-09-28-170233,170233,0,0,0,105,1.2857142857142858,63.087933000912784,0
2020-09-29-170233,170233,0,0,1,105,2.2857142857142856,66.64429215769165,1
2020-09-30-170233,170233,0,0,0,105,2.0,63.21480790390942,2
2020-10-01-170233,170233,0,0,0,105,2.142857142857143,0.0,3
2020-10-02-170233,170233,1,0,1,106,2.2857142857142856,209.04967556638445,4
2020-10-03-170233,170233,0,0,0,106,2.2857142857142856,270.1324517929741,5
2020-10-04-170233,170233,0,0,0,106,1.0,265.07212364099996,6
2020-10-05-170233,170233,0,0,1,106,2.8571428571428568,222.5842276805007,0
2020-10-06-170233,170233,1,1,0,107,3.8571428571428568,190.02945010013644,1
2020-10-07-170233,170233,0,0,1,107,3.571428571428572,169.4324613726187,2
2020-10-08-170233,170233,0,1,0,107,2.7142857142857144,136.82032788405348,3
2020-10-09-170233,170233,2,0,0,109,3.571428571428572,142.4478958073562,4
2020-10-10-170233,170233,1,0,1,110,1.2857142857142858,8.619225313630622,5
2020-10-11-170233,170233,3,0,0,113,1.1428571428571428,17.762926618809672,6
2020-10-12-170233,170233,0,0,0,113,2.0,36.95637882895194,0
2020-10-13-170233,170233,1,0,1,114,3.0,52.32425704277304,1
2020-10-14-170233,170233,0,0,2,114,4.285714285714286,83.38909810890081,2
2020-10-15-170233,170233,0,0,1,114,4.142857142857143,112.82702059717221,3
2020-10-16-170233,170233,1,0,2,115,6.0,139.83152740542488,4
2020-10-17-170233,170233,0,0,2,115,4.0,174.90940396537468,5
2020-10-18-170233,170233,0,0,4,115,3.571428571428572,191.05782309400706,6
2020-10-19-170233,170233,1,0,0,116,5.142857142857143,190.34873126765356,0
2020-10-20-170233,170233,0,0,0,116,6.7142857142857135,192.03619233113557,1
2020-10-21-170233,170233,1,0,1,117,5.7142857142857135,210.7066136433691,2
2020-10-22-170233,170233,0,0,0,117,11.428571428571427,217.45998356883092,3
2020-10-23-170233,170233,0,0,1,117,7.2857142857142865,220.03656417913342,4
2020-10-24-170233,170233,1,0,0,118,5.142857142857143,219.7835270741864,5
2020-10-25-170233,170233,0,1,2,118,5.7142857142857135,212.4102636358875,6
2020-10-26-170233,170233,0,0,4,118,8.428571428571429,200.0307249982951,0
2020-10-27-170233,170233,1,0,3,119,8.571428571428571,223.59212812241685,1
2020-10-28-170233,170233,2,0,0,121,6.571428571428571,217.26529701682472,2
2020-10-29-170233,170233,1,0,2,122,7.857142857142858,221.32780236262988,3
2020-10-30-170233,170233,2,0,0,124,7.2857142857142865,204.7336333249634,4
2020-10-31-170233,170233,2,0,0,126,2.8571428571428568,229.15640372756803,5
2020-11-01-170233,170233,4,0,0,130,3.7142857142857135,99.22403081487106,6
2020-11-02-170233,170233,0,0,0,130,5.142857142857143,269.9740281069926,0
2020-11-03-170233,170233,0,1,0,130,7.0,222.87918269352588,1
2020-11-04-170233,170233,1,0,0,131,4.857142857142857,238.7856654672941,2
2020-11-05-170233,170233,0,0,0,131,5.285714285714286,244.577415732715,3
2020-11-06-170233,170233,1,0,0,132,4.714285714285714,245.64140618891042,4
2020-11-07-170233,170233,0,0,0,132,4.857142857142857,224.0119589986453,5
2020-11-08-170233,170233,2,0,0,134,6.2857142857142865,208.50331721623132,6
2020-11-09-170233,170233,4,0,0,138,7.0,204.53419773953408,0
2020-11-10-170233,170233,3,0,0,141,4.571428571428571,100.66475779011503,1
2020-11-11-170233,170233,0,0,0,141,2.0,126.01703479269072,2
2020-11-12-170233,170233,2,1,0,143,8.285714285714286,130.051408599685,3
2020-11-13-170233,170233,0,0,0,143,10.857142857142858,149.08287852340044,4
2020-03-01-170234,170234,0,0,1,0,0.0,0.0,6
2020-03-02-170234,170234,0,0,0,0,0.0,7.38124870845536,0
2020-03-03-170234,170234,0,0,1,0,0.0,28.289848075964912,1
2020-03-04-170234,170234,0,0,3,0,0.0,38.964721825546945,2
2020-03-05-170234,170234,0,0,2,0,0.0,39.38584345651296,3
2020-03-06-170234,170234,0,1,3,0,0.0,21.752098253066205,4
2020-03-07-170234,170234,0,0,0,0,0.0,25.979580465703872,5
2020-03-08-170234,170234,0,0,1,0,0.0,23.015322943931153,6
2020-03-09-170234,170234,1,0,1,1,0.0,22.71949583687552,0
2020-03-10-170234,170234,0,0,1,1,0.0,60.808641934665545,1
2020-03-11-170234,170234,0,0,1,1,0.0,49.52588284030864,2
2020-03-12-170234,170234,0,0,2,1,0.5,26.387649292449176,3
2020-03-13-170234,170234,1,0,5,2,0.0,15.261315050536096,4
2020-03-14-170234,170234,0,0,0,2,0.0,18.715708979775115,5
2020-03-15-170234,170234,1,0,1,3,0.0,15.259127369165032,6
2020-03-16-170234,170234,0,0,0,3,0.0,14.230439015096014,0
2020-03-17-170234,170234,1,0,3,4,0.0,14.904067418758434,1
2020-03-18-170234,170234,3,0,0,7,0.0,21.27256717376359,2
2020-03-19-170234,170234,2,0,0,9,0.0,37.85201382955124,3
2020-03-20-170234,170234,3,2,0,12,1.5,37.76023770669479,4
2020-03-21-170234,170234,0,0,1,12,0.0,57.472978591689944,5
2020-03-22-170234,170234,1,0,1,13,0.5,50.466815920527075,6
2020-03-23-170234,170234,1,0,2,14,1.0,56.52331919145584,0
2020-03-24-170234,170234,1,0,1,15,1.0,54.81222397562173,1
2020-03-25-170234,170234,1,0,6,16,0.5,44.14235496202092,2
2020-03-26-170234,170234,2,0,1,18,1.5,44.15644582432281,3
2020-03-27-170234,170234,5,0,2,23,0.5,55.39057991869463,4
2020-03-28-170234,170234,0,0,0,23,0.0,63.51265610329935,5
2020-03-29-170234,170234,1,0,0,24,0.0,61.65992686997852,6
2020-03-30-170234,170234,0,0,1,24,0.0,53.94771798173436,0
2020-03-31-170234,170234,3,0,1,27,0.0,47.421725729081366,1
2020-04-01-170234,170234,0,0,0,27,3.5,19.175318418528754,2
2020-04-02-170234,170234,0,0,1,27,0.5,15.750361994579674,3
2020-04-03-170234,170234,0,0,0,27,1.0,10.09822794367884,4
2020-04-04-170234,170234,1,0,0,28,1.0,6.688247680529674,5
2020-04-05-170234,170234,1,0,0,29,0.0,7.551839791547331,6
2020-04-06-170234,170234,2,0,0,31,0.5,12.376123439588369,0
2020-04-07-170234,170234,1,0,0,32,0.0,24.139691187843155,1
2020-04-08-170234,170234,6,0,1,38,0.5,29.84379912920313,2
2020-04-09-170234,170234,1,4,0,39,0.0,61.36876623244422,3
2020-04-10-170234,170234,2,0,1,41,0.5,7.552187344243029,4
2020-04-11-170234,170234,0,0,1,41,0.0,17.70282370600527,5
2020-04-12-170234,170234,0,0,0,41,0.0,17.303417422547348,6
2020-04-13-170234,170234,1,0,0,42,1.0,18.01255866074099,0
2020-04-14-170234,170234,1,0,0,43,1.0,24.267400106972328,1
2020-04-15-170234,170234,0,0,0,43,0.5,30.557151552226095,2
2020-04-16-170234,170234,1,0,0,44,0.0,26.091784997735832,3
2020-04-17-170234,170234,0,0,0,44,0.0,29.300669694093205,4
2020-04-18-170234,170234,0,0,0,44,0.0,18.963497868162044,5
2020-04-19-170234,170234,0,0,0,44,0.0,18.666300411330706,6
2020-04-20-170234,170234,0,0,0,44,0.0,12.86866724130541,0
2020-04-21-170234,170234,0,0,0,44,0.5,7.701064764724035,1
2020-04-22-170234,170234,1,0,0,45,0.5,7.42307611802285,2
2020-04-23-170234,170234,0,0,0,45,0.0,7.614688063957819,3
2020-04-24-170234,170234,1,0,0,46,0.0,7.617250735835622,4
2020-04-25-170234,170234,1,0,0,47,0.0,12.930529361645489,5
2020-04-26-170234,170234,0,0,0,47,0.0,18.216045648629375,6
2020-04-27-170234,170234,0,1,1,47,0.0,17.61072003990451,0
2020-04-28-170234,170234,0,0,0,47,0.0,17.125741848547698,1
2020-04-29-170234,170234,0,0,1,47,0.0,17.21842229203493,2
2020-04-30-170234,170234,0,0,0,47,0.0,12.963464332978388,3
2020-05-01-170234,170234,0,0,0,47,0.0,69.09841632286307,4
2020-05-02-170234,170234,0,0,0,47,0.0,7.1284100162238655,5
2020-05-03-170234,170234,0,0,0,47,0.0,6.758719819449282,6
2020-05-04-170234,170234,0,0,0,47,0.0,6.831660460068438,0
2020-05-05-170234,170234,0,0,0,47,0.0,0.8914894555376388,1
2020-05-06-170234,170234,0,0,0,47,0.0,0.7836064672519557,2
2020-05-07-170234,170234,0,0,0,47,0.0,0.6178176882223425,3
2020-05-08-170234,170234,0,0,0,47,0.0,0.7032891501627461,4
2020-05-09-170234,170234,0,0,0,47,0.0,0.9878777770216427,5
2020-05-10-170234,170234,0,0,0,47,0.0,78.37644203607093,6
2020-05-11-170234,170234,1,2,0,48,0.0,70.94931986877036,0
2020-05-12-170234,170234,0,3,2,48,0.5,71.49764965494894,1
2020-05-13-170234,170234,1,0,0,49,0.0,59.279647036461434,2
2020-05-14-170234,170234,0,0,0,49,0.0,58.05624952570991,3
2020-05-15-170234,170234,0,1,0,49,0.0,21.2473026175724,4
2020-05-16-170234,170234,0,1,0,49,0.0,14.766247688141979,5
2020-05-17-170234,170234,0,0,0,49,0.0,14.588402206833344,6
2020-05-18-170234,170234,0,0,1,49,0.0,14.71230228183083,0
2020-05-19-170234,170234,0,0,0,49,0.0,8.641019966698119,1
2020-05-20-170234,170234,0,0,0,49,0.5,1.355177733255566,2
2020-05-21-170234,170234,0,0,0,49,0.0,1.2840316254989952,3
2020-05-22-170234,170234,0,0,0,49,0.0,1.502027862008206,4
2020-05-23-170234,170234,0,0,0,49,0.0,1.8107969271410955,5
2020-05-24-170234,170234,0,0,0,49,0.0,2.0233639634641434,6
2020-05-25-170234,170234,0,0,0,49,0.0,1.68181273850784,0
2020-05-26-170234,170234,2,0,0,51,0.0,1.5652009955666677,1
2020-05-27-170234,170234,0,0,0,51,0.0,7.833666364977854,2
2020-05-28-170234,170234,0,0,0,51,0.0,7.374167176265438,3
2020-05-29-170234,170234,0,0,0,51,0.0,7.717146546648982,4
2020-05-30-170234,170234,0,0,0,51,0.0,7.695071322292104,5
2020-05-31-170234,170234,0,0,0,51,0.0,8.19799333388086,6
2020-06-01-170234,170234,1,0,0,52,0.0,1.6210647273399896,0
2020-06-02-170234,170234,0,0,0,52,0.0,1.9289733566801415,1
2020-06-03-170234,170234,0,0,0,52,0.0,0.26493612402135513,2
2020-06-04-170234,170234,0,0,0,52,1.0,0.7974462517545293,3
2020-06-05-170234,170234,0,0,0,52,0.0,2.0387045087605786,4
2020-06-06-170234,170234,0,0,0,52,0.0,2.191420092551576,5
2020-06-07-170234,170234,0,0,0,52,0.0,2.5207284671719634,6
2020-06-08-170234,170234,0,0,0,52,0.5,2.6049510300468053,0
2020-06-09-170234,170234,0,0,0,52,0.0,3.0323898416621855,1
2020-06-10-170234,170234,0,0,0,52,0.0,9.160885996579196,2
2020-06-11-170234,170234,0,0,0,52,0.0,9.00557893520253,3
2020-06-12-170234,170234,0,0,0,52,0.0,9.550621385876138,4
2020-06-13-170234,170234,0,0,0,52,0.0,9.263678285363516,5
2020-06-14-170234,170234,0,0,0,52,0.0,8.82498611553897,6
2020-06-15-170234,170234,0,0,0,52,0.5,8.831562438318524,0
2020-06-16-170234,170234,0,0,0,52,0.0,9.246223109280374,1
2020-06-17-170234,170234,0,0,0,52,0.0,1.74634459471561,2
2020-06-18-170234,170234,0,0,0,52,0.0,1.8846146146352578,3
2020-06-19-170234,170234,0,0,0,52,0.5,1.52685908895144,4
2020-06-20-170234,170234,0,0,0,52,0.0,2.565385101695416,5
2020-06-21-170234,170234,0,0,0,52,0.0,2.444688911329126,6
2020-06-22-170234,170234,0,0,0,52,0.0,1.9867270693458075,0
2020-06-23-170234,170234,0,0,0,52,0.0,1.524398774589899,1
2020-06-24-170234,170234,0,0,0,52,0.0,1.4967105168614498,2
2020-06-25-170234,170234,0,1,0,52,0.0,1.544887253219787,3
2020-06-26-170234,170234,0,1,0,52,0.0,0.931608676314034,4
2020-06-27-170234,170234,0,0,0,52,0.0,0.5274779032150341,5
2020-06-28-170234,170234,0,0,0,52,0.0,0.5718882081564296,6
2020-06-29-170234,170234,0,0,0,52,0.0,0.43963453501734984,0
2020-06-30-170234,170234,0,0,0,52,0.5,0.5164691315914914,1
2020-07-01-170234,170234,0,0,0,52,0.0,4.05580874661507,2
2020-07-02-170234,170234,0,0,0,52,0.0,1.6373269661696517,3
2020-07-03-170234,170234,0,0,0,52,0.0,1.7822353351311773,4
2020-07-04-170234,170234,0,0,0,52,0.0,1.978453294300473,5
2020-07-05-170234,170234,0,0,0,52,0.0,1.998877071058017,6
2020-07-06-170234,170234,0,0,0,52,0.5,2.2042260752340415,0
2020-07-07-170234,170234,0,0,0,52,0.5,1.9648048713019648,1
2020-07-08-170234,170234,0,0,0,52,0.5,2.6776685318496027,2
2020-07-09-170234,170234,0,0,0,52,0.0,3.8993968424132426,3
2020-07-10-170234,170234,0,0,0,52,0.5,3.949742719401626,4
2020-07-11-170234,170234,0,0,0,52,0.0,2.6605472660974216,5
2020-07-12-170234,170234,0,0,0,52,0.0,2.2836562504720854,6
2020-07-13-170234,170234,0,0,0,52,0.0,1.7431499004729825,0
2020-07-14-170234,170234,0,0,0,52,0.5,1.6538546441524615,1
2020-07-15-170234,170234,0,0,0,52,0.0,2.1107689765464035,2
2020-07-16-170234,170234,0,0,0,52,0.0,2.1406795946347295,3
2020-07-17-170234,170234,0,0,0,52,0.0,2.03861139201205,4
2020-07-18-170234,170234,0,0,0,52,0.0,1.2948118108932056,5
2020-07-19-170234,170234,0,0,0,52,0.0,1.3779762563109235,6
2020-07-20-170234,170234,0,0,0,52,0.0,2.4336643919039274,0
2020-07-21-170234,170234,0,0,1,52,0.0,1.9382158346942768,1
2020-07-22-170234,170234,0,0,3,52,0.5,2.2923613298094203,2
2020-07-23-170234,170234,0,0,0,52,0.0,3.1803554245829133,3
2020-07-24-170234,170234,0,0,0,52,0.0,3.212312679010103,4
2020-07-25-170234,170234,0,0,1,52,0.0,3.4241587910118323,5
2020-07-26-170234,170234,0,0,0,52,0.0,3.010365904804118,6
2020-07-27-170234,170234,0,0,0,52,0.0,2.4967777992376434,0
2020-07-28-170234,170234,0,0,6,52,0.0,2.1449245571929003,1
2020-07-29-170234,170234,0,0,2,52,0.0,2.4566055313962445,2
2020-07-30-170234,170234,0,0,0,52,0.0,1.863596223019209,3
2020-07-31-170234,170234,0,0,1,52,0.0,1.8821866934996945,4
2020-08-01-170234,170234,0,0,0,52,0.5,4.054460674084493,5
2020-08-02-170234,170234,0,0,0,52,0.0,113.23222325409661,6
2020-08-03-170234,170234,0,0,1,52,0.0,45.55641041563081,0
2020-08-04-170234,170234,1,0,1,53,0.5,31.76570569640278,1
2020-08-05-170234,170234,3,0,6,56,2.0,40.19246330329089,2
2020-08-06-170234,170234,0,0,1,56,0.0,58.41277683878377,3
2020-08-07-170234,170234,0,0,0,56,4.5,58.35363569680182,4
2020-08-08-170234,170234,1,0,0,57,0.0,65.48525383285207,5
2020-08-09-170234,170234,0,0,1,57,1.0,75.25930685777772,6
2020-08-10-170234,170234,0,0,0,57,0.5,4.636381429173822,0
2020-08-11-170234,170234,6,0,1,63,1.5,15.710116788297803,1
2020-08-12-170234,170234,2,0,1,65,2.5,64.60955504712747,2
2020-08-13-170234,170234,0,0,2,65,1.0,89.99781112258434,3
2020-08-14-170234,170234,1,0,0,66,0.0,95.78951944397801,4
2020-08-15-170234,170234,0,0,0,66,0.0,114.57854849563779,5
2020-08-16-170234,170234,0,0,0,66,0.0,109.66952796083275,6
2020-08-17-170234,170234,1,0,1,67,0.5,106.42238921562247,0
2020-08-18-170234,170234,1,0,3,68,0.5,119.16747705092018,1
2020-08-19-170234,170234,6,0,0,74,2.0,76.37187242078144,2
2020-08-20-170234,170234,1,0,3,75,1.0,105.53181528449181,3
2020-08-21-170234,170234,0,0,1,75,5.5,101.9667239172239,4
2020-08-22-170234,170234,0,0,1,75,2.5,108.54496704172526,5
2020-08-23-170234,170234,1,0,1,76,0.0,112.96529488687122,6
2020-08-24-170234,170234,0,0,1,76,0.5,96.88530028757691,0
2020-08-25-170234,170234,1,0,1,77,0.5,103.19057296603118,1
2020-08-26-170234,170234,1,0,1,78,1.5,54.219467494718614,2
2020-08-27-170234,170234,2,0,1,80,0.5,56.52969043277619,3
2020-08-28-170234,170234,0,0,3,80,0.0,53.85494521143658,4
2020-08-29-170234,170234,0,0,1,80,0.5,47.50983100188036,5
2020-08-30-170234,170234,0,0,0,80,0.5,38.14279135838992,6
2020-08-31-170234,170234,1,0,1,81,1.0,29.719443510583545,0
2020-09-01-170234,170234,3,0,1,84,0.0,68.96274093712346,1
2020-09-02-170234,170234,0,0,0,84,1.0,44.39656064781256,2
2020-09-03-170234,170234,3,0,1,87,0.0,33.18733588020683,3
2020-09-04-170234,170234,1,0,0,88,0.0,39.611194677114774,4
2020-09-05-170234,170234,1,0,0,89,0.5,89.3776825196517,5
2020-09-06-170234,170234,1,0,0,90,0.0,109.21045733396,6
2020-09-07-170234,170234,1,0,0,91,0.5,115.98885884624184,0
2020-09-08-170234,170234,1,0,0,92,0.0,120.8475642510996,1
2020-09-09-170234,170234,1,0,1,93,4.5,128.0958164467374,2
2020-09-10-170234,170234,1,0,2,94,0.0,80.7322191271929,3
2020-09-11-170234,170234,3,0,0,97,0.5,85.53268245231729,4
2020-09-12-170234,170234,1,0,0,98,0.0,83.31318725886055,5
2020-09-13-170234,170234,0,0,0,98,0.5,90.72967773818502,6
2020-09-14-170234,170234,1,0,0,99,1.5,88.23612925023109,0
2020-09-15-170234,170234,1,0,0,100,3.5,89.83771168998251,1
2020-09-16-170234,170234,0,0,0,100,0.5,100.48894781243078,2
2020-09-17-170234,170234,1,0,0,101,1.5,78.62828031543641,3
2020-09-18-170234,170234,0,0,0,101,1.0,74.97470902338578,4
2020-09-19-170234,170234,0,0,0,101,1.0,51.62305591637856,5
2020-09-20-170234,170234,0,1,0,101,0.0,51.430251213761295,6
2020-09-21-170234,170234,0,0,0,101,0.5,39.42080338378151,0
2020-09-22-170234,170234,0,0,1,101,0.5,27.104953771188754,1
2020-09-23-170234,170234,1,0,0,102,1.0,27.26794338344809,2
2020-09-24-170234,170234,2,0,0,104,1.0,25.38450786855238,3
2020-09-25-170234,170234,0,0,0,104,1.0,39.432646956421,4
2020-09-26-170234,170234,0,0,0,104,0.0,39.56942817605142,5
2020-09-27-170234,170234,0,0,0,104,0.0,30.205543401392056,6
2020-09-28-170234,170234,0,0,0,104,1.0,29.641155223523267,0
2020-09-29-170234,170234,0,0,0,104,0.0,30.398141867944975,1
2020-09-30-170234,170234,0,0,0,104,1.5,50.06890043920776,2
2020-10-01-170234,170234,0,0,0,104,0.5,0.0,3
2020-10-02-170234,170234,0,0,1,104,0.0,34.533808175112306,4
2020-10-03-170234,170234,0,0,0,104,0.0,46.65566493576859,5
2020-10-04-170234,170234,0,0,1,104,0.0,51.18619027903272,6
2020-10-05-170234,170234,0,0,0,104,0.0,34.98980089183502,0
2020-10-06-170234,170234,1,0,2,105,1.5,27.226829596705386,1
2020-10-07-170234,170234,0,2,0,105,0.0,22.124236591091456,2
2020-10-08-170234,170234,0,0,3,105,0.5,20.395465136106825,3
2020-10-09-170234,170234,0,0,0,105,0.5,37.06138601272502,4
2020-10-10-170234,170234,0,0,1,105,0.5,1.0941770345179571,5
2020-10-11-170234,170234,0,0,0,105,0.0,1.7439940689591844,6
2020-10-12-170234,170234,0,0,2,105,0.0,2.0638570138616803,0
2020-10-13-170234,170234,0,0,1,105,1.0,2.4996496549848013,1
2020-10-14-170234,170234,0,0,0,105,1.0,6.261986860640453,2
2020-10-15-170234,170234,0,0,0,105,1.0,15.664407537888383,3
2020-10-16-170234,170234,1,0,1,106,0.5,17.42620572249155,4
2020-10-17-170234,170234,0,0,0,106,0.0,26.303556786321693,5
2020-10-18-170234,170234,1,0,1,107,1.5,26.869420700909178,6
2020-10-19-170234,170234,0,0,2,107,0.0,37.96407342235476,0
2020-10-20-170234,170234,2,0,0,109,0.0,34.78441646146005,1
2020-10-21-170234,170234,0,0,1,109,1.5,41.177605318218696,2
2020-10-22-170234,170234,3,0,3,112,0.5,43.68494865173755,3
2020-10-23-170234,170234,0,0,1,112,0.0,51.75740517488643,4
2020-10-24-170234,170234,1,2,0,113,1.0,52.83255884552831,5
2020-10-25-170234,170234,0,0,0,113,0.0,51.10087383706324,6
2020-10-26-170234,170234,2,0,0,115,0.5,49.613008704749504,0
2020-10-27-170234,170234,1,1,2,116,0.0,65.56907866408581,1
2020-10-28-170234,170234,0,0,0,116,6.0,58.40375914106365,2
2020-10-29-170234,170234,0,0,8,116,1.5,62.10791423480586,3
2020-10-30-170234,170234,1,0,2,117,1.5,44.085132910657464,4
2020-10-31-170234,170234,0,0,0,117,2.5,45.964544229301495,5
2020-11-01-170234,170234,1,1,0,118,3.5,24.455207410892136,6
2020-11-02-170234,170234,2,0,0,120,1.0,89.2888967484052,0
2020-11-03-170234,170234,0,0,0,120,4.0,91.30431879094658,1
2020-11-04-170234,170234,1,0,0,121,3.0,96.05667366575545,2
2020-11-05-170234,170234,3,1,0,124,3.5,103.07116549317607,3
2020-11-06-170234,170234,1,1,0,125,2.0,103.58979075659049,4
2020-11-07-170234,170234,0,0,0,125,1.5,88.38619332869307,5
2020-11-08-170234,170234,0,0,0,125,2.0,81.38299284257283,6
2020-11-09-170234,170234,0,0,0,125,6.0,66.4430085329049,0
2020-11-10-170234,170234,2,0,0,127,3.0,37.399696991509764,1
2020-11-11-170234,170234,0,0,0,127,3.5,70.37491742420275,2
2020-11-12-170234,170234,8,0,0,135,2.5,71.61720886323592,3
2020-11-13-170234,170234,2,0,0,137,2.5,129.78631082169684,4
2020-03-01-170235,170235,0,0,0,0,0.0,0.0,6
2020-03-02-170235,170235,0,0,0,0,0.0,3.8068684189064617,0
2020-03-03-170235,170235,0,1,2,0,0.0,29.51121785673598,1
2020-03-04-170235,170235,0,0,2,0,0.0,25.50997148516474,2
2020-03-05-170235,170235,0,0,1,0,0.0,19.72022618646728,3
2020-03-06-170235,170235,0,0,2,0,0.0,16.916074810369267,4
2020-03-07-170235,170235,0,0,2,0,0.0,18.397690828776526,5
2020-03-08-170235,170235,0,0,1,0,0.0,20.330423761425898,6
2020-03-09-170235,170235,0,0,2,0,0.4,20.336249187711378,0
2020-03-10-170235,170235,0,0,2,0,0.0,222.2156167903719,1
2020-03-11-170235,170235,0,0,2,0,0.2,190.14698677962662,2
2020-03-12-170235,170235,0,0,3,0,0.2,158.41524526715966,3
2020-03-13-170235,170235,1,0,0,1,0.4,129.8189238553117,4
2020-03-14-170235,170235,1,0,0,2,0.2,94.8384461333097,5
2020-03-15-170235,170235,0,0,0,2,0.4,68.62860746234733,6
2020-03-16-170235,170235,0,0,2,2,0.4,10.907582895689742,0
2020-03-17-170235,170235,2,0,2,4,0.6,13.062844603512882,1
2020-03-18-170235,170235,2,1,3,6,1.4,16.954146092527154,2
2020-03-19-170235,170235,1,0,1,7,2.2,22.481524618109475,3
2020-03-20-170235,170235,2,5,2,9,3.4,21.979020997383827,4
2020-03-21-170235,170235,2,0,1,11,1.4,37.18233184462723,5
2020-03-22-170235,170235,1,0,0,12,2.2,38.515355263789786,6
2020-03-23-170235,170235,2,0,1,14,4.8,43.894370407843155,0
2020-03-24-170235,170235,2,0,2,16,4.6,55.09930183364372,1
2020-03-25-170235,170235,2,0,1,18,3.8,64.36456524759124,2
2020-03-26-170235,170235,3,0,1,21,3.0,69.05173785535565,3
2020-03-27-170235,170235,0,0,0,21,2.2,84.3621579164887,4
2020-03-28-170235,170235,0,0,2,21,1.2,74.00043587876168,5
2020-03-29-170235,170235,0,0,0,21,0.2,71.49752103945599,6
2020-03-30-170235,170235,2,0,0,23,2.8,49.65823635264014,0
2020-03-31-170235,170235,2,0,0,25,2.0,41.75459299976063,1
2020-04-01-170235,170235,3,0,0,28,4.0,5.66053054017061,2
2020-04-02-170235,170235,1,0,1,29,3.0,23.679123168306297,3
2020-04-03-170235,170235,2,0,0,31,3.4,11.197731730960857,4
2020-04-04-170235,170235,1,0,0,32,0.8,22.16710350598057,5
2020-04-05-170235,170235,0,0,0,32,0.2,27.910976783164138,6
2020-04-06-170235,170235,1,1,3,33,2.2,27.167335036266024,0
2020-04-07-170235,170235,2,1,0,35,1.6,32.57845627629898,1
2020-04-08-170235,170235,1,0,0,36,0.8,34.7200077791084,2
2020-04-09-170235,170235,1,0,0,37,2.4,39.22166969317398,3
2020-04-10-170235,170235,0,0,0,37,1.4,27.602176486351976,4
2020-04-11-170235,170235,2,0,1,39,0.2,31.597877624267344,5
2020-04-12-170235,170235,0,0,1,39,0.2,33.72201150367495,6
2020-04-13-170235,170235,0,0,1,39,2.2,34.32781328900388,0
2020-04-14-170235,170235,0,0,1,39,1.0,42.66414842272033,1
2020-04-15-170235,170235,0,0,1,39,1.2,50.2770492026806,2
2020-04-16-170235,170235,1,0,0,40,0.8,55.514050288342474,3
2020-04-17-170235,170235,0,0,0,40,0.4,32.189259828958065,4
2020-04-18-170235,170235,0,0,0,40,0.2,28.883547946956025,5
2020-04-19-170235,170235,0,0,0,40,0.4,26.80475351413414,6
2020-04-20-170235,170235,3,1,0,43,1.2,25.67446524675052,0
2020-04-21-170235,170235,0,2,0,43,0.8,26.815042148661234,1
2020-04-22-170235,170235,0,0,0,43,1.2,25.56554563586597,2
2020-04-23-170235,170235,0,0,1,43,0.2,27.938237496018992,3
2020-04-24-170235,170235,0,0,0,43,0.4,27.131285136341933,4
2020-04-25-170235,170235,1,0,0,44,0.2,27.608557109945664,5
2020-04-26-170235,170235,1,0,0,45,0.6,28.877141092609026,6
2020-04-27-170235,170235,1,0,0,46,0.4,22.848616002847706,0
2020-04-28-170235,170235,1,0,0,47,0.8,16.97816697071258,1
2020-04-29-170235,170235,1,0,2,48,0.4,15.470962266931632,2
2020-04-30-170235,170235,0,0,0,48,0.0,25.275635468410655,3
2020-05-01-170235,170235,0,0,0,48,0.6,34.345440523218116,4
2020-05-02-170235,170235,0,0,0,48,0.2,13.201254655684652,5
2020-05-03-170235,170235,0,0,0,48,0.0,6.900650445801264,6
2020-05-04-170235,170235,0,0,0,48,0.6,6.254746555518223,0
2020-05-05-170235,170235,0,0,2,48,0.6,6.0230849573487735,1
2020-05-06-170235,170235,0,0,0,48,0.6,5.585888879736514,2
2020-05-07-170235,170235,1,0,1,49,0.2,5.4188436731121765,3
2020-05-08-170235,170235,0,0,1,49,0.6,5.926618085676679,4
2020-05-09-170235,170235,0,0,0,49,0.2,8.035621237913663,5
2020-05-10-170235,170235,0,1,0,49,0.4,39.1777726965909,6
2020-05-11-170235,170235,0,0,0,49,0.4,30.37732383578055,0
2020-05-12-170235,170235,0,0,0,49,0.4,31.141031862619883,1
2020-05-13-170235,170235,2,0,1,51,1.0,25.104147144298846,2
2020-05-14-170235,170235,0,0,0,51,1.2,25.995151556835854,3
2020-05-15-170235,170235,0,0,0,51,0.4,22.218367113983966,4
2020-05-16-170235,170235,0,0,0,51,0.0,18.58232585208866,5
2020-05-17-170235,170235,0,0,0,51,0.0,17.413705199741862,6
2020-05-18-170235,170235,0,0,0,51,0.8,17.414081585255317,0
2020-05-19-170235,170235,2,0,0,53,0.0,18.260561759299154,1
2020-05-20-170235,170235,0,0,0,53,0.6,11.191003113951243,2
2020-05-21-170235,170235,1,0,1,54,0.4,12.618620719703518,3
2020-05-22-170235,170235,1,0,0,55,0.6,12.955895104431413,4
2020-05-23-170235,170235,0,0,0,55,0.2,16.647003391110523,5
2020-05-24-170235,170235,0,0,0,55,0.0,17.218089989488636,6
2020-05-25-170235,170235,0,0,1,55,0.4,15.018781007929697,0
2020-05-26-170235,170235,0,0,1,55,0.6,13.433739600156507,1
2020-05-27-170235,170235,1,0,0,56,0.2,15.304521777538612,2
2020-05-28-170235,170235,0,0,2,56,0.6,12.719042385951862,3
2020-05-29-170235,170235,0,1,0,56,0.4,12.605887188823498,4
2020-05-30-170235,170235,0,0,0,56,0.0,10.721471467872366,5
2020-05-31-170235,170235,0,0,0,56,0.2,11.417750836136594,6
2020-06-01-170235,170235,0,0,1,56,0.8,13.069396870290127,0
2020-06-02-170235,170235,0,0,0,56,0.6,15.00045279076222,1
2020-06-03-170235,170235,0,0,0,56,0.4,2.1232949449271357,2
2020-06-04-170235,170235,1,0,0,57,0.8,6.924905458629477,3
2020-06-05-170235,170235,0,0,0,57,0.4,17.34769030955776,4
2020-06-06-170235,170235,0,1,0,57,0.4,17.945424038383667,5
2020-06-07-170235,170235,0,1,0,57,0.2,18.878901744518732,6
2020-06-08-170235,170235,1,1,0,58,0.6,19.388059489371766,0
2020-06-09-170235,170235,1,0,0,59,0.0,21.8368378148361,1
2020-06-10-170235,170235,0,0,0,59,0.4,13.932414047019359,2
2020-06-11-170235,170235,2,0,0,61,0.2,13.502489024323452,3
2020-06-12-170235,170235,0,0,0,61,0.6,15.166202554434637,4
2020-06-13-170235,170235,0,0,0,61,0.0,14.220068555204797,5
2020-06-14-170235,170235,0,1,0,61,0.2,11.565740842466393,6
2020-06-15-170235,170235,1,2,0,62,0.2,10.26922845371611,0
2020-06-16-170235,170235,0,0,0,62,0.6,15.622058001714024,1
2020-06-17-170235,170235,0,0,0,62,0.2,15.273166576125199,2
2020-06-18-170235,170235,0,0,0,62,0.2,14.160969980747115,3
2020-06-19-170235,170235,0,0,0,62,0.4,11.21175845245805,4
2020-06-20-170235,170235,0,0,0,62,0.0,18.048658649027477,5
2020-06-21-170235,170235,0,0,0,62,0.2,17.258546539601173,6
2020-06-22-170235,170235,0,0,2,62,0.0,12.251281066089025,0
2020-06-23-170235,170235,0,0,0,62,0.2,10.42090560684634,1
2020-06-24-170235,170235,0,0,2,62,0.0,10.625952598482577,2
2020-06-25-170235,170235,0,0,0,62,0.0,11.249040634101284,3
2020-06-26-170235,170235,0,1,0,62,0.0,6.1443294713370715,4
2020-06-27-170235,170235,0,0,0,62,0.0,3.2929994134198965,5
2020-06-28-170235,170235,0,0,0,62,0.0,3.590636670618645,6
2020-06-29-170235,170235,0,0,0,62,0.0,2.8621866374028113,0
2020-06-30-170235,170235,0,0,1,62,0.4,3.6823484498964403,1
2020-07-01-170235,170235,0,0,3,62,0.4,29.35934466621728,2
2020-07-02-170235,170235,0,0,0,62,0.2,16.083177393056804,3
2020-07-03-170235,170235,0,0,0,62,0.8,10.948900320248537,4
2020-07-04-170235,170235,0,0,0,62,0.2,13.229657245366905,5
2020-07-05-170235,170235,0,0,0,62,0.4,13.080953073300325,6
2020-07-06-170235,170235,2,0,2,64,0.2,12.412904350904988,0
2020-07-07-170235,170235,0,0,0,64,0.4,12.932024176056535,1
2020-07-08-170235,170235,2,0,1,66,0.6,17.557305457543276,2
2020-07-09-170235,170235,0,0,0,66,0.6,25.447236952128677,3
2020-07-10-170235,170235,0,0,1,66,0.4,24.140339655224743,4
2020-07-11-170235,170235,0,0,0,66,0.0,16.108884576774436,5
2020-07-12-170235,170235,0,0,0,66,0.0,14.465542170895214,6
2020-07-13-170235,170235,0,0,1,66,0.0,12.899450798737991,0
2020-07-14-170235,170235,1,0,2,67,0.4,12.300369721419182,1
2020-07-15-170235,170235,3,1,0,70,0.2,16.30658161806161,2
2020-07-16-170235,170235,0,0,2,70,0.2,16.1889004106642,3
2020-07-17-170235,170235,0,0,0,70,0.0,15.941385538247154,4
2020-07-18-170235,170235,0,0,1,70,0.2,10.750470639208553,5
2020-07-19-170235,170235,0,0,2,70,0.2,11.648860313874588,6
2020-07-20-170235,170235,2,0,1,72,0.2,17.643560635968367,0
2020-07-21-170235,170235,0,0,3,72,0.2,14.640404880857673,1
2020-07-22-170235,170235,1,0,5,73,0.2,17.89736589412323,2
2020-07-23-170235,170235,0,0,5,73,0.0,24.814203991677175,3
2020-07-24-170235,170235,1,0,6,74,0.0,24.98630061537648,4
2020-07-25-170235,170235,0,0,4,74,0.2,26.295162768610687,5
2020-07-26-170235,170235,0,0,1,74,0.0,21.74105457073181,6
2020-07-27-170235,170235,1,0,3,75,0.0,21.359675184247457,0
2020-07-28-170235,170235,2,0,8,77,0.6,19.45062318299464,1
2020-07-29-170235,170235,0,0,8,77,0.4,17.239527393383835,2
2020-07-30-170235,170235,2,0,2,79,0.2,13.624925931751708,3
2020-07-31-170235,170235,0,0,1,79,0.6,14.67387865178089,4
2020-08-01-170235,170235,1,0,1,80,0.4,28.001617154315607,5
2020-08-02-170235,170235,2,0,0,82,0.6,142.38875088210017,6
2020-08-03-170235,170235,1,0,0,83,1.6,121.19942245460133,0
2020-08-04-170235,170235,3,0,0,86,1.4,141.0581661465012,1
2020-08-05-170235,170235,5,0,2,91,2.2,156.3189611997346,2
2020-08-06-170235,170235,5,0,10,96,2.0,182.7824428543435,3
2020-08-07-170235,170235,6,0,4,102,2.4,167.21351205769207,4
2020-08-08-170235,170235,4,1,0,106,0.4,225.0342646553162,5
2020-08-09-170235,170235,1,0,4,107,1.2,220.88414307188754,6
2020-08-10-170235,170235,3,0,1,110,1.4,33.79908395691552,0
2020-08-11-170235,170235,8,0,2,118,2.8,52.367776761697456,1
2020-08-12-170235,170235,8,0,3,126,2.4,92.21600706815934,2
2020-08-13-170235,170235,2,0,2,128,2.8,147.69470084752004,3
2020-08-14-170235,170235,1,0,15,129,0.8,202.12498315272592,4
2020-08-15-170235,170235,1,0,1,130,0.8,198.2007364976346,5
2020-08-16-170235,170235,0,0,5,130,0.2,197.7199658826123,6
2020-08-17-170235,170235,0,0,2,130,0.6,193.1754318008466,0
2020-08-18-170235,170235,0,0,1,130,2.4,180.613794659559,1
2020-08-19-170235,170235,2,0,4,132,1.6,154.59947029213737,2
2020-08-20-170235,170235,10,0,2,142,1.8,90.31382964838039,3
2020-08-21-170235,170235,4,0,0,146,4.6,120.11429932243058,4
2020-08-22-170235,170235,0,0,0,146,1.2,189.6453394595987,5
2020-08-23-170235,170235,4,0,0,150,0.2,214.53855311069688,6
2020-08-24-170235,170235,1,0,0,151,0.8,210.94368097034481,0
2020-08-25-170235,170235,2,0,1,153,0.8,215.87557464585285,1
2020-08-26-170235,170235,3,0,0,156,2.2,188.5047878987579,2
2020-08-27-170235,170235,2,0,1,158,2.0,199.30292575259642,3
2020-08-28-170235,170235,15,0,2,173,1.6,179.65661272192443,4
2020-08-29-170235,170235,1,0,0,174,0.8,135.73817287194535,5
2020-08-30-170235,170235,5,0,2,179,0.4,119.44932969508594,6
2020-08-31-170235,170235,2,0,5,181,2.4,117.58872973943286,0
2020-09-01-170235,170235,1,0,2,182,0.8,192.76619987458417,1
2020-09-02-170235,170235,4,0,4,186,1.8,157.1245635750176,2
2020-09-03-170235,170235,2,0,0,188,0.4,69.28442667677079,3
2020-09-04-170235,170235,0,0,3,188,0.6,63.98294426361705,4
2020-09-05-170235,170235,0,0,3,188,2.6,61.711014078619314,5
2020-09-06-170235,170235,0,0,1,188,0.4,66.92750903221861,6
2020-09-07-170235,170235,0,0,3,188,1.0,65.13294926934688,0
2020-09-08-170235,170235,1,0,2,189,1.0,59.92685059773136,1
2020-09-09-170235,170235,0,0,2,189,3.0,64.88260425394557,2
2020-09-10-170235,170235,1,0,0,190,0.8,154.01383969031855,3
2020-09-11-170235,170235,2,0,0,192,1.6,131.20556607978244,4
2020-09-12-170235,170235,0,0,2,192,1.2,116.63418742830851,5
2020-09-13-170235,170235,2,0,1,194,0.8,119.0238271984037,6
2020-09-14-170235,170235,5,0,1,199,1.4,76.7123831835479,0
2020-09-15-170235,170235,2,0,0,201,4.6,92.29357651195724,1
2020-09-16-170235,170235,4,0,1,205,1.6,121.70276295807412,2
2020-09-17-170235,170235,0,0,0,205,2.8,127.12863379236305,3
2020-09-18-170235,170235,3,0,2,208,1.8,146.09562084891755,4
2020-09-19-170235,170235,3,0,0,211,0.4,145.31285280721968,5
2020-09-20-170235,170235,1,0,0,212,1.6,150.83763098895975,6
2020-09-21-170235,170235,3,1,3,215,1.2,129.24430057433048,0
2020-09-22-170235,170235,2,0,5,217,1.8,100.66827851212767,1
2020-09-23-170235,170235,2,0,1,219,1.2,102.02215032033429,2
2020-09-24-170235,170235,0,0,0,219,2.2,91.7513149750434,3
2020-09-25-170235,170235,0,0,0,219,1.2,88.12943118324974,4
2020-09-26-170235,170235,2,0,0,221,1.0,81.41197917362042,5
2020-09-27-170235,170235,1,0,1,222,0.0,65.18883172890948,6
2020-09-28-170235,170235,1,0,0,223,0.6,63.49875052711146,0
2020-09-29-170235,170235,0,0,2,223,0.6,65.21715641906658,1
2020-09-30-170235,170235,1,0,1,224,1.4,50.606087708663935,2
2020-10-01-170235,170235,0,0,2,224,1.4,0.0,3
2020-10-02-170235,170235,2,0,1,226,1.2,92.92362079350974,4
2020-10-03-170235,170235,0,0,1,226,0.0,137.5151608866404,5
2020-10-04-170235,170235,0,0,1,226,0.6,165.67550102128192,6
2020-10-05-170235,170235,3,0,0,229,0.8,148.52503539670172,0
2020-10-06-170235,170235,5,0,1,234,2.2,145.4750714488401,1
2020-10-07-170235,170235,1,1,2,235,1.2,108.26021797014211,2
2020-10-08-170235,170235,0,1,2,235,0.6,98.75162177434494,3
2020-10-09-170235,170235,0,0,3,235,0.6,105.46992438623082,4
2020-10-10-170235,170235,0,0,0,235,0.2,7.747910853336997,5
2020-10-11-170235,170235,1,0,0,236,0.0,13.112431933128992,6
2020-10-12-170235,170235,0,0,0,236,0.2,16.35937933719876,0
2020-10-13-170235,170235,2,0,1,238,0.8,19.327529180835597,1
2020-10-14-170235,170235,1,0,1,239,1.4,39.30147684792306,2
2020-10-15-170235,170235,2,0,3,241,0.6,54.834581586177,3
2020-10-16-170235,170235,1,0,0,242,1.0,69.99888823639182,4
2020-10-17-170235,170235,1,0,0,243,0.2,79.98747105273557,5
2020-10-18-170235,170235,1,0,0,244,1.2,77.18613857476365,6
2020-10-19-170235,170235,0,0,2,244,0.4,87.68133841831443,0
2020-10-20-170235,170235,1,0,1,245,1.6,82.72601232504591,1
2020-10-21-170235,170235,2,0,3,247,2.8,78.19802341216862,2
2020-10-22-170235,170235,2,0,0,249,3.2,89.39835787352953,3
2020-10-23-170235,170235,3,0,4,252,1.0,87.54121142822166,4
2020-10-24-170235,170235,0,0,1,252,0.6,97.79909636956776,5
2020-10-25-170235,170235,0,0,5,252,0.6,91.5319793103369,6
2020-10-26-170235,170235,0,0,4,252,1.0,84.11114178477871,0
2020-10-27-170235,170235,1,0,6,253,1.6,95.37467421081361,1
2020-10-28-170235,170235,1,0,8,254,4.2,97.12104981990628,2
2020-10-29-170235,170235,3,0,3,257,2.6,128.57622916607497,3
2020-10-30-170235,170235,0,0,6,257,3.0,117.30406921951584,4
2020-10-31-170235,170235,0,0,0,257,3.0,135.09668351111299,5
2020-11-01-170235,170235,0,0,0,257,1.6,81.35552729449545,6
2020-11-02-170235,170235,2,0,0,259,0.6,151.01152932423955,0
2020-11-03-170235,170235,1,1,0,260,3.0,124.51035059839913,1
2020-11-04-170235,170235,3,0,0,263,3.0,153.33661322734025,2
2020-11-05-170235,170235,0,0,0,263,2.0,177.75228619199729,3
2020-11-06-170235,170235,4,0,0,267,2.2,183.8588643680657,4
2020-11-07-170235,170235,1,0,0,268,1.4,189.41392968593595,5
2020-11-08-170235,170235,5,0,0,273,1.0,188.6350287510465,6
2020-11-09-170235,170235,4,0,0,277,3.2,194.25091858237008,0
2020-11-10-170235,170235,6,0,0,283,2.6,92.06945472585852,1
2020-11-11-170235,170235,8,0,0,291,3.0,116.5441464181302,2
2020-11-12-170235,170235,3,0,0,294,2.0,142.83344609120667,3
2020-11-13-170235,170235,6,0,0,300,3.6,142.17333327666458,4
2020-03-01-170236,170236,0,0,9,0,0.5,0.0,6
2020-03-02-170236,170236,3,0,16,3,0.0,232.05879658127847,0
2020-03-03-170236,170236,2,0,18,5,0.0,912.5057934288739,1
2020-03-04-170236,170236,1,0,28,6,0.5,975.752960472822,2
2020-03-05-170236,170236,0,0,41,6,0.75,1074.5579668840128,3
2020-03-06-170236,170236,0,0,28,6,0.25,915.4953223886903,4
2020-03-07-170236,170236,0,1,12,6,0.0,960.9243785735804,5
2020-03-08-170236,170236,1,0,15,7,0.25,905.5774623199554,6
2020-03-09-170236,170236,1,0,39,8,0.75,903.429367130939,0
2020-03-10-170236,170236,2,0,38,10,1.5,4895.408238278684,1
2020-03-11-170236,170236,1,0,26,11,1.75,4106.259662032288,2
2020-03-12-170236,170236,6,0,20,17,1.25,3270.3037640006673,3
2020-03-13-170236,170236,4,0,28,21,3.0,2288.062410399247,4
2020-03-14-170236,170236,5,0,10,26,2.75,1819.501849316338,5
2020-03-15-170236,170236,9,0,6,35,3.25,1339.1616436377467,6
2020-03-16-170236,170236,16,0,24,51,10.25,427.5115960300309,0
2020-03-17-170236,170236,18,0,14,69,10.5,675.7049341014367,1
2020-03-18-170236,170236,28,0,12,97,12.5,837.9045362168529,2
2020-03-19-170236,170236,41,0,12,138,15.25,1115.6001321801912,3
2020-03-20-170236,170236,28,3,16,166,17.5,1287.2036169306111,4
2020-03-21-170236,170236,12,0,5,178,6.25,1470.4999014596992,5
2020-03-22-170236,170236,15,0,6,193,8.0,1473.4498710020903,6
2020-03-23-170236,170236,39,0,19,232,18.75,1396.9773149226917,0
2020-03-24-170236,170236,38,0,6,270,15.5,1561.123137103782,1
2020-03-25-170236,170236,26,0,10,296,13.75,1566.493973154019,2
2020-03-26-170236,170236,20,0,9,316,14.25,1496.8870967151993,3
2020-03-27-170236,170236,28,0,19,344,13.5,1702.202386193324,4
2020-03-28-170236,170236,10,0,3,354,5.25,1678.8532633439313,5
2020-03-29-170236,170236,6,0,3,360,4.5,1644.5428966959512,6
2020-03-30-170236,170236,24,0,22,384,10.5,1256.1776701762017,0
2020-03-31-170236,170236,14,0,15,398,8.0,1136.7850003075023,1
2020-04-01-170236,170236,12,0,18,410,6.75,184.19314035117515,2
2020-04-02-170236,170236,12,0,16,422,7.75,762.1622589304112,3
2020-04-03-170236,170236,16,0,14,438,7.75,380.8792680262461,4
2020-04-04-170236,170236,5,0,1,443,1.25,506.8957843165122,5
2020-04-05-170236,170236,6,0,1,449,4.25,534.004931612227,6
2020-04-06-170236,170236,19,0,9,468,10.25,576.0326195919413,0
2020-04-07-170236,170236,6,0,11,474,5.5,647.9417379516484,1
2020-04-08-170236,170236,10,0,15,484,6.0,682.3402050579614,2
2020-04-09-170236,170236,9,0,2,493,3.25,738.6305694541534,3
2020-04-10-170236,170236,19,0,6,512,4.5,148.97549135802524,4
2020-04-11-170236,170236,3,0,4,515,2.75,258.9943569294438,5
2020-04-12-170236,170236,3,0,3,518,1.5,333.9774178275723,6
2020-04-13-170236,170236,22,0,13,540,5.5,360.9889358243901,0
2020-04-14-170236,170236,15,0,10,555,5.0,506.85332080648425,1
2020-04-15-170236,170236,18,0,7,573,15.5,624.392149314787,2
2020-04-16-170236,170236,16,0,12,589,5.5,800.2814405837937,3
2020-04-17-170236,170236,14,0,1,603,4.0,828.2452838610548,4
2020-04-18-170236,170236,1,0,2,604,2.25,883.6988637445747,5
2020-04-19-170236,170236,1,0,3,605,1.75,834.9886006124237,6
2020-04-20-170236,170236,9,0,5,614,4.75,847.5630486217553,0
2020-04-21-170236,170236,11,1,3,625,2.25,844.5102084526411,1
2020-04-22-170236,170236,15,0,6,640,2.75,746.4195887278591,2
2020-04-23-170236,170236,2,0,6,642,1.25,745.3832080911689,3
2020-04-24-170236,170236,6,0,10,648,2.5,587.7757960103809,4
2020-04-25-170236,170236,4,0,0,652,1.0,628.5354568881864,5
2020-04-26-170236,170236,3,0,0,655,0.75,607.7356820299372,6
2020-04-27-170236,170236,13,0,7,668,3.5,485.1413393114424,0
2020-04-28-170236,170236,10,0,6,678,3.25,483.50640986898236,1
2020-04-29-170236,170236,7,0,10,685,2.25,476.64137103686915,2
2020-04-30-170236,170236,12,1,14,697,2.5,582.1631700627694,3
2020-05-01-170236,170236,1,0,16,698,0.5,802.5016028323971,4
2020-05-02-170236,170236,2,0,1,700,0.0,625.6506304616571,5
2020-05-03-170236,170236,3,0,0,703,0.75,295.7068035808942,6
2020-05-04-170236,170236,5,0,19,708,3.0,230.52673120701715,0
2020-05-05-170236,170236,3,0,7,711,3.25,232.81002971428924,1
2020-05-06-170236,170236,6,0,8,717,3.0,260.4297450748898,2
2020-05-07-170236,170236,6,0,13,723,1.75,280.1506287991589,3
2020-05-08-170236,170236,10,0,8,733,2.25,300.09173383346626,4
2020-05-09-170236,170236,0,0,0,733,0.0,396.2427186590083,5
2020-05-10-170236,170236,0,0,1,733,0.25,848.3662708125007,6
2020-05-11-170236,170236,7,0,6,740,4.0,772.6792870073326,0
2020-05-12-170236,170236,6,1,3,746,3.25,790.9739608901647,1
2020-05-13-170236,170236,10,0,2,756,5.5,640.1277950651081,2
2020-05-14-170236,170236,14,0,3,770,6.75,672.8706041203322,3
2020-05-15-170236,170236,16,0,6,786,3.75,692.2771472711675,4
2020-05-16-170236,170236,1,0,0,787,1.0,702.0737492927537,5
2020-05-17-170236,170236,0,0,0,787,0.0,703.0961965776285,6
2020-05-18-170236,170236,19,0,0,806,4.5,703.2845239964543,0
2020-05-19-170236,170236,7,0,1,813,3.25,752.4133752405633,1
2020-05-20-170236,170236,8,0,3,821,3.25,632.1157203734632,2
2020-05-21-170236,170236,13,0,2,834,2.75,561.0299636124037,3
2020-05-22-170236,170236,8,0,6,842,4.5,527.5661373877131,4
2020-05-23-170236,170236,0,0,1,842,0.0,621.6866580219591,5
2020-05-24-170236,170236,1,0,0,843,0.0,633.6087571874473,6
2020-05-25-170236,170236,6,0,4,849,4.5,474.49146287967756,0
2020-05-26-170236,170236,3,0,3,852,3.0,481.50165293520604,1
2020-05-27-170236,170236,2,0,1,854,2.5,554.7580305318388,2
2020-05-28-170236,170236,3,0,5,857,3.0,519.5894564283419,3
2020-05-29-170236,170236,6,0,0,863,1.25,472.613084347098,4
2020-05-30-170236,170236,0,0,0,863,0.0,450.14107547975874,5
2020-05-31-170236,170236,0,0,2,863,0.0,454.00838374521805,6
2020-06-01-170236,170236,0,0,4,863,2.0,503.2143352601196,0
2020-06-02-170236,170236,1,0,1,864,0.5,141.3841222315043,1
2020-06-03-170236,170236,3,0,1,867,1.0,111.10163906029956,2
2020-06-04-170236,170236,2,0,3,869,0.5,113.9317289005173,3
2020-06-05-170236,170236,6,0,0,875,1.5,144.16813156079678,4
2020-06-06-170236,170236,1,0,0,876,0.5,167.1442606281488,5
2020-06-07-170236,170236,0,2,0,876,0.0,172.37421565896562,6
2020-06-08-170236,170236,4,0,1,880,1.25,174.35804245676056,0
2020-06-09-170236,170236,3,0,0,883,1.75,216.95107331670178,1
2020-06-10-170236,170236,1,0,2,884,1.25,558.8792290439785,2
2020-06-11-170236,170236,5,0,1,889,2.0,517.0515217621573,3
2020-06-12-170236,170236,0,0,0,889,0.25,470.4719891226536,4
2020-06-13-170236,170236,0,0,1,889,0.0,382.33735232296397,5
2020-06-14-170236,170236,2,0,0,891,0.0,298.536667652904,6
2020-06-15-170236,170236,4,0,0,895,0.75,172.98970541601363,0
2020-06-16-170236,170236,1,0,0,896,0.75,218.29509690121347,1
2020-06-17-170236,170236,1,0,0,897,0.75,200.86139625281368,2
2020-06-18-170236,170236,3,0,0,900,0.5,191.95569169091942,3
2020-06-19-170236,170236,0,0,0,900,0.5,170.66235934081192,4
2020-06-20-170236,170236,0,0,0,900,0.0,197.92346294637025,5
2020-06-21-170236,170236,0,0,0,900,0.0,197.70028828908707,6
2020-06-22-170236,170236,1,0,0,901,1.0,156.1928559473958,0
2020-06-23-170236,170236,0,0,0,901,0.25,151.9117843281606,1
2020-06-24-170236,170236,2,0,0,903,0.5,137.5968240122795,2
2020-06-25-170236,170236,1,1,3,904,0.5,142.59631531231588,3
2020-06-26-170236,170236,0,1,1,904,1.25,155.70755187787842,4
2020-06-27-170236,170236,1,0,0,905,0.25,143.42577058681704,5
2020-06-28-170236,170236,0,0,0,905,0.25,152.39731939351492,6
2020-06-29-170236,170236,0,0,1,905,0.0,148.21808840863247,0
2020-06-30-170236,170236,0,0,1,905,0.75,132.91466091161453,1
2020-07-01-170236,170236,0,0,2,905,0.5,235.59143846647626,2
2020-07-02-170236,170236,0,1,1,905,0.0,187.2482012601721,3
2020-07-03-170236,170236,0,0,0,905,0.75,205.12785188717166,4
2020-07-04-170236,170236,0,0,3,905,0.0,266.43322087141365,5
2020-07-05-170236,170236,0,0,0,905,0.0,257.33204341494456,6
2020-07-06-170236,170236,0,0,2,905,0.0,217.54480192166665,0
2020-07-07-170236,170236,0,1,4,905,0.75,205.17858159556357,1
2020-07-08-170236,170236,0,0,2,905,0.25,176.01881361583096,2
2020-07-09-170236,170236,3,0,0,908,0.5,163.3712692432859,3
2020-07-10-170236,170236,1,0,1,909,0.25,242.98410334503245,4
2020-07-11-170236,170236,0,0,2,909,0.0,203.55082792429235,5
2020-07-12-170236,170236,0,0,0,909,0.0,150.3649854670741,6
2020-07-13-170236,170236,1,0,0,910,1.75,141.17869947012153,0
2020-07-14-170236,170236,1,0,2,911,0.25,170.56514374356334,1
2020-07-15-170236,170236,2,0,1,913,4.0,140.8321065762371,2
2020-07-16-170236,170236,1,0,2,914,0.25,136.07015588679457,3
2020-07-17-170236,170236,0,0,0,914,1.25,125.64649627254613,4
2020-07-18-170236,170236,3,0,0,917,1.0,160.56186702499167,5
2020-07-19-170236,170236,0,0,1,917,0.5,188.88472046115953,6
2020-07-20-170236,170236,2,0,1,919,1.0,157.9177788265304,0
2020-07-21-170236,170236,4,0,0,923,0.75,176.87302698845735,1
2020-07-22-170236,170236,2,0,6,925,1.0,164.7124230228419,2
2020-07-23-170236,170236,0,0,4,925,1.5,186.59038410107883,3
2020-07-24-170236,170236,1,0,1,926,0.25,174.98523895821185,4
2020-07-25-170236,170236,2,0,4,928,0.25,167.33048628125545,5
2020-07-26-170236,170236,0,0,0,928,0.0,170.53638733880388,6
2020-07-27-170236,170236,0,0,2,928,1.5,179.73874380009613,0
2020-07-28-170236,170236,2,1,7,930,1.25,189.24844176930782,1
2020-07-29-170236,170236,1,0,9,931,2.25,188.12073051258767,2
2020-07-30-170236,170236,2,0,4,933,4.0,191.56842420871777,3
2020-07-31-170236,170236,0,0,4,933,3.0,244.6805802019801,4
2020-08-01-170236,170236,0,0,1,933,0.0,100.76511729632855,5
2020-08-02-170236,170236,1,0,4,934,0.25,629.329388173061,6
2020-08-03-170236,170236,1,0,7,935,1.0,663.2414133875477,0
2020-08-04-170236,170236,0,0,6,935,3.0,656.3667271117615,1
2020-08-05-170236,170236,6,0,5,941,2.5,630.9447072390554,2
2020-08-06-170236,170236,4,0,7,945,1.75,655.0074119857989,3
2020-08-07-170236,170236,1,0,3,946,2.25,620.2438350753273,4
2020-08-08-170236,170236,4,0,8,950,1.25,635.1156567398428,5
2020-08-09-170236,170236,0,0,2,950,1.25,637.743501562062,6
2020-08-10-170236,170236,2,0,9,952,4.75,72.06061389610898,0
2020-08-11-170236,170236,7,0,5,959,2.25,162.41512539385076,1
2020-08-12-170236,170236,9,0,6,968,4.75,258.7728367857219,2
2020-08-13-170236,170236,4,0,5,972,2.75,343.84038890263014,3
2020-08-14-170236,170236,4,0,2,976,0.75,416.277581494336,4
2020-08-15-170236,170236,1,0,3,977,1.0,478.79613074855166,5
2020-08-16-170236,170236,4,0,5,981,1.0,488.14261665071683,6
2020-08-17-170236,170236,7,0,12,988,2.5,534.2240929185036,0
2020-08-18-170236,170236,6,0,11,994,3.0,519.5824203665519,1
2020-08-19-170236,170236,5,0,18,999,2.75,563.0964960217304,2
2020-08-20-170236,170236,7,0,7,1006,1.75,492.6582910243472,3
2020-08-21-170236,170236,3,0,14,1009,3.25,503.317868534025,4
2020-08-22-170236,170236,8,1,4,1017,2.25,565.1058514166248,5
2020-08-23-170236,170236,2,0,2,1019,1.5,599.8176636148019,6
2020-08-24-170236,170236,9,0,11,1028,6.75,572.7494613483702,0
2020-08-25-170236,170236,5,0,8,1033,4.25,589.0513502682276,1
2020-08-26-170236,170236,6,0,12,1039,5.75,605.2592957867339,2
2020-08-27-170236,170236,5,0,6,1044,6.5,681.4393934673813,3
2020-08-28-170236,170236,2,0,13,1046,5.0,672.9154563852351,4
2020-08-29-170236,170236,3,0,3,1049,2.75,667.9750227850401,5
2020-08-30-170236,170236,5,0,6,1054,4.25,641.8858336614046,6
2020-08-31-170236,170236,12,0,9,1066,5.0,563.1029504333677,0
2020-09-01-170236,170236,11,0,9,1077,6.5,593.3655839345275,1
2020-09-02-170236,170236,18,0,9,1095,4.75,1152.325653396053,2
2020-09-03-170236,170236,7,0,15,1102,5.25,960.837387449198,3
2020-09-04-170236,170236,14,0,7,1116,5.5,962.4743729940653,4
2020-09-05-170236,170236,4,1,2,1120,2.0,927.3791263632467,5
2020-09-06-170236,170236,2,0,0,1122,1.5,947.602739320492,6
2020-09-07-170236,170236,11,0,4,1133,4.25,969.9045963210866,0
2020-09-08-170236,170236,8,0,11,1141,5.0,946.1116079426104,1
2020-09-09-170236,170236,12,0,11,1153,5.0,961.8960317510375,2
2020-09-10-170236,170236,6,1,7,1159,10.75,718.3156173282891,3
2020-09-11-170236,170236,13,0,7,1172,6.5,776.8444952995319,4
2020-09-12-170236,170236,3,0,1,1175,3.5,881.6428604214774,5
2020-09-13-170236,170236,6,0,2,1181,4.0,931.4163813417706,6
2020-09-14-170236,170236,9,0,7,1190,10.5,1016.2399355268966,0
2020-09-15-170236,170236,9,0,4,1199,18.0,1175.314806907441,1
2020-09-16-170236,170236,9,0,5,1208,12.5,1359.564806074935,2
2020-09-17-170236,170236,15,0,12,1223,16.25,1265.6127151251167,3
2020-09-18-170236,170236,7,0,9,1230,13.0,1333.3990434669763,4
2020-09-19-170236,170236,2,1,4,1232,2.0,1377.6670591469103,5
2020-09-20-170236,170236,0,0,2,1232,2.0,1321.6512745249404,6
2020-09-21-170236,170236,4,1,6,1236,18.25,1126.4284954708119,0
2020-09-22-170236,170236,11,1,3,1247,13.0,1116.5146780185464,1
2020-09-23-170236,170236,11,0,4,1258,10.0,1105.2565596481263,2
2020-09-24-170236,170236,7,0,15,1265,6.75,1105.5529076904027,3
2020-09-25-170236,170236,7,0,15,1272,10.25,994.08617644597,4
2020-09-26-170236,170236,1,0,3,1273,1.25,1148.307830964196,5
2020-09-27-170236,170236,2,0,3,1275,0.5,1014.8608335511778,6
2020-09-28-170236,170236,7,0,10,1282,7.0,1011.9596465879841,0
2020-09-29-170236,170236,4,0,22,1286,6.0,1054.928373955915,1
2020-09-30-170236,170236,5,0,3,1291,6.5,995.8686507301801,2
2020-10-01-170236,170236,12,0,17,1303,7.5,0.0,3
2020-10-02-170236,170236,9,1,14,1312,14.0,2698.087361278883,4
2020-10-03-170236,170236,4,0,2,1316,3.25,4006.002417817817,5
2020-10-04-170236,170236,2,1,3,1318,3.5,4081.9410608902426,6
2020-10-05-170236,170236,6,0,24,1324,6.75,3358.9743793401603,0
2020-10-06-170236,170236,3,1,27,1327,9.0,2885.222519607349,1
2020-10-07-170236,170236,4,2,41,1331,9.0,2391.713480696058,2
2020-10-08-170236,170236,15,1,41,1346,7.25,2072.793404190872,3
2020-10-09-170236,170236,15,0,20,1361,12.75,2231.475347291649,4
2020-10-10-170236,170236,3,0,9,1364,3.0,172.52314018811637,5
2020-10-11-170236,170236,3,0,12,1367,2.0,287.32196887804685,6
2020-10-12-170236,170236,10,0,30,1377,6.5,446.816450949552,0
2020-10-13-170236,170236,22,0,31,1399,13.5,669.842482553468,1
2020-10-14-170236,170236,3,0,37,1402,6.5,1172.780021177005,2
2020-10-15-170236,170236,17,0,35,1419,19.75,1424.9807234262807,3
2020-10-16-170236,170236,14,0,35,1433,13.5,1987.0929202816603,4
2020-10-17-170236,170236,2,0,22,1435,2.75,2296.313292628107,5
2020-10-18-170236,170236,3,0,34,1438,3.5,2317.0535792314295,6
2020-10-19-170236,170236,24,0,39,1462,17.5,2282.22327399587,0
2020-10-20-170236,170236,27,0,40,1489,10.75,2498.274844925555,1
2020-10-21-170236,170236,41,0,26,1530,19.75,2739.827025417359,2
2020-10-22-170236,170236,41,0,38,1571,17.5,2749.832038497873,3
2020-10-23-170236,170236,20,0,62,1591,13.5,2922.3511862057458,4
2020-10-24-170236,170236,9,1,26,1600,4.5,3357.3157659901085,5
2020-10-25-170236,170236,12,2,15,1612,9.5,3481.8705706346977,6
2020-10-26-170236,170236,30,1,47,1642,18.75,3098.6179620938324,0
2020-10-27-170236,170236,31,1,33,1673,16.25,3701.637998248021,1
2020-10-28-170236,170236,37,2,52,1710,19.75,3868.5953302114704,2
2020-10-29-170236,170236,35,3,45,1745,20.5,3981.4900244430505,3
2020-10-30-170236,170236,35,0,86,1780,20.0,3585.603592610093,4
2020-10-31-170236,170236,22,0,0,1802,6.5,4080.6539203590964,5
2020-11-01-170236,170236,34,0,0,1836,16.25,1678.120995033295,6
2020-11-02-170236,170236,39,1,0,1875,9.0,4000.5796953774297,0
2020-11-03-170236,170236,40,0,0,1915,19.0,3556.6110791828714,1
2020-11-04-170236,170236,26,0,0,1941,18.0,4195.88626586765,2
2020-11-05-170236,170236,38,0,0,1979,20.25,4286.549346346202,3
2020-11-06-170236,170236,62,1,0,2041,22.25,4544.204930420729,4
2020-11-07-170236,170236,26,3,0,2067,12.75,4683.043735264366,5
2020-11-08-170236,170236,15,0,0,2082,12.0,4492.57680058796,6
2020-11-09-170236,170236,47,0,0,2129,22.25,4496.122631274515,0
2020-11-10-170236,170236,33,1,0,2162,17.75,1892.2229508120597,1
2020-11-11-170236,170236,52,1,0,2214,16.25,2410.8076929288027,2
2020-11-12-170236,170236,45,0,0,2259,18.25,2866.357494778144,3
2020-11-13-170236,170236,86,2,0,2345,21.75,3311.71446032115,4
2020-03-01-170237,170237,0,0,4,0,0.0,0.0,6
2020-03-02-170237,170237,0,0,4,0,0.0,88.53502628473343,0
2020-03-03-170237,170237,0,0,8,0,0.3333333333333333,364.8212446014678,1
2020-03-04-170237,170237,0,0,10,0,0.3333333333333333,398.6847798126205,2
2020-03-05-170237,170237,0,0,6,0,0.0,428.76693764054266,3
2020-03-06-170237,170237,0,0,10,0,0.0,365.5903767507924,4
2020-03-07-170237,170237,0,0,4,0,0.3333333333333333,373.33175678535304,5
2020-03-08-170237,170237,0,0,7,0,0.0,355.44792591657176,6
2020-03-09-170237,170237,1,0,15,1,0.6666666666666666,352.8951414062277,0
2020-03-10-170237,170237,0,0,11,1,2.0,1814.6076513969892,1
2020-03-11-170237,170237,5,0,6,6,0.6666666666666666,1519.9403307302314,2
2020-03-12-170237,170237,3,0,14,9,1.0,1209.8910344834587,3
2020-03-13-170237,170237,0,0,19,9,5.0,837.0264984986009,4
2020-03-14-170237,170237,2,0,3,11,2.333333333333333,688.5433391594349,5
2020-03-15-170237,170237,4,0,7,15,3.333333333333333,490.82156199462656,6
2020-03-16-170237,170237,4,0,12,19,8.333333333333334,162.58395357752474,0
2020-03-17-170237,170237,8,3,12,27,9.666666666666666,251.05014413037566,1
2020-03-18-170237,170237,10,2,5,37,14.333333333333336,322.3025315296204,2
2020-03-19-170237,170237,6,0,9,43,17.666666666666668,423.98130461392793,3
2020-03-20-170237,170237,10,0,7,53,15.666666666666664,481.1556736846243,4
2020-03-21-170237,170237,4,0,6,57,7.0,563.4181016247135,5
2020-03-22-170237,170237,7,0,3,64,10.0,567.0897846399528,6
2020-03-23-170237,170237,15,2,5,79,25.33333333333333,555.8172881316427,0
2020-03-24-170237,170237,11,0,7,90,19.33333333333333,637.0023113800531,1
2020-03-25-170237,170237,6,0,4,96,16.0,640.9782068400847,2
2020-03-26-170237,170237,14,0,2,110,14.0,626.3028482453478,3
2020-03-27-170237,170237,19,0,9,129,14.333333333333336,727.4310506594991,4
2020-03-28-170237,170237,3,0,18,132,4.666666666666667,728.2764654434885,5
2020-03-29-170237,170237,7,0,1,139,4.333333333333333,719.7870494799627,6
2020-03-30-170237,170237,12,0,11,151,17.0,532.5562230610014,0
2020-03-31-170237,170237,12,0,8,163,9.0,503.6255769899283,1
2020-04-01-170237,170237,5,0,4,168,10.666666666666666,79.64799335555419,2
2020-04-02-170237,170237,9,0,5,177,12.333333333333336,333.35819733786116,3
2020-04-03-170237,170237,7,0,1,184,13.0,174.39181729156462,4
2020-04-04-170237,170237,6,0,0,190,4.666666666666667,230.97975854140705,5
2020-04-05-170237,170237,3,1,0,193,1.6666666666666667,251.36365130919881,6
2020-04-06-170237,170237,5,0,2,198,7.666666666666668,257.3196085618821,0
2020-04-07-170237,170237,7,3,10,205,7.666666666666668,275.44967777709905,1
2020-04-08-170237,170237,4,4,5,209,8.333333333333334,294.73325414487283,2
2020-04-09-170237,170237,2,0,1,211,14.333333333333336,304.5832522113948,3
2020-04-10-170237,170237,9,1,1,220,9.333333333333334,69.04772037574686,4
2020-04-11-170237,170237,18,0,1,238,2.6666666666666665,117.98686195528231,5
2020-04-12-170237,170237,1,0,1,239,2.0,168.7917960580012,6
2020-04-13-170237,170237,11,0,2,250,9.333333333333334,183.538128248312,0
2020-04-14-170237,170237,8,0,4,258,9.333333333333334,246.33945352654214,1
2020-04-15-170237,170237,4,0,7,262,10.666666666666666,308.08727912678023,2
2020-04-16-170237,170237,5,0,5,267,6.333333333333332,375.1243263741719,3
2020-04-17-170237,170237,1,0,0,268,6.0,373.72714371957716,4
2020-04-18-170237,170237,0,0,2,268,0.6666666666666666,400.775082284993,5
2020-04-19-170237,170237,0,0,0,268,3.6666666666666665,359.31783640567477,6
2020-04-20-170237,170237,2,0,5,270,9.333333333333334,362.0479663022451,0
2020-04-21-170237,170237,10,0,1,280,6.666666666666668,354.5806857097435,1
2020-04-22-170237,170237,5,1,9,285,5.666666666666668,326.80567127733724,2
2020-04-23-170237,170237,1,1,2,286,2.6666666666666665,333.46258475955653,3
2020-04-24-170237,170237,1,0,4,287,4.666666666666667,266.3379635230792,4
2020-04-25-170237,170237,1,0,0,288,2.0,283.5942858431208,5
2020-04-26-170237,170237,1,0,0,289,2.333333333333333,274.2690308995916,6
2020-04-27-170237,170237,2,0,14,291,5.333333333333333,227.24631841043856,0
2020-04-28-170237,170237,4,0,6,295,4.333333333333333,215.51601679157915,1
2020-04-29-170237,170237,7,0,6,302,5.666666666666668,200.63695130958456,2
2020-04-30-170237,170237,5,0,7,307,2.0,251.52839445191154,3
2020-05-01-170237,170237,0,0,6,307,1.0,310.57890286664065,4
2020-05-02-170237,170237,2,0,0,309,2.0,245.34410712705045,5
2020-05-03-170237,170237,0,0,1,309,0.6666666666666666,127.11055948274543,6
2020-05-04-170237,170237,5,0,5,314,2.6666666666666665,100.93192552620594,0
2020-05-05-170237,170237,1,0,4,315,3.6666666666666665,99.4093772921048,1
2020-05-06-170237,170237,9,0,10,324,3.0,105.28273834774673,2
2020-05-07-170237,170237,2,0,5,326,2.333333333333333,126.0574021629819,3
2020-05-08-170237,170237,4,0,4,330,5.666666666666668,126.72156912263999,4
2020-05-09-170237,170237,0,0,0,330,0.0,170.79687582632215,5
2020-05-10-170237,170237,0,0,0,330,0.6666666666666666,335.5221932229862,6
2020-05-11-170237,170237,14,0,3,344,4.333333333333333,290.66580229296346,0
2020-05-12-170237,170237,6,0,5,350,4.333333333333333,323.4365035592656,1
2020-05-13-170237,170237,6,2,2,356,8.0,283.6547332256065,2
2020-05-14-170237,170237,7,0,5,363,7.0,289.7772317237375,3
2020-05-15-170237,170237,6,0,3,369,4.666666666666667,300.831814631706,4
2020-05-16-170237,170237,0,0,0,369,1.3333333333333333,294.0162201732341,5
2020-05-17-170237,170237,1,0,0,370,0.0,296.5556354214314,6
2020-05-18-170237,170237,5,0,5,375,5.666666666666668,296.33958170882886,0
2020-05-19-170237,170237,4,0,1,379,5.666666666666668,290.85144528996454,1
2020-05-20-170237,170237,10,0,2,389,4.333333333333333,246.1865356535259,2
2020-05-21-170237,170237,5,0,0,394,4.333333333333333,232.6651362730929,3
2020-05-22-170237,170237,4,1,2,398,2.333333333333333,222.6185583176959,4
2020-05-23-170237,170237,0,0,0,398,0.3333333333333333,251.28344710015068,5
2020-05-24-170237,170237,0,0,0,398,0.0,253.7564999020428,6
2020-05-25-170237,170237,3,0,2,401,2.333333333333333,200.91909048235226,0
2020-05-26-170237,170237,5,0,3,406,3.333333333333333,197.02828192151065,1
2020-05-27-170237,170237,2,1,1,408,3.0,223.290150942349,2
2020-05-28-170237,170237,5,0,0,413,1.6666666666666667,198.17123357050673,3
2020-05-29-170237,170237,3,0,0,416,2.0,179.90294123831524,4
2020-05-30-170237,170237,0,0,1,416,0.0,175.46487949398363,5
2020-05-31-170237,170237,0,0,0,416,0.0,176.86799700635424,6
2020-06-01-170237,170237,5,0,1,421,2.333333333333333,198.75137598462518,0
2020-06-02-170237,170237,1,0,1,422,2.0,58.70905706229021,1
2020-06-03-170237,170237,2,1,1,424,2.333333333333333,41.986935518291844,2
2020-06-04-170237,170237,0,0,0,424,1.6666666666666667,45.1387972990139,3
2020-06-05-170237,170237,2,0,0,426,1.6666666666666667,56.178930116800785,4
2020-06-06-170237,170237,0,0,0,426,1.3333333333333333,68.36512074023008,5
2020-06-07-170237,170237,0,0,0,426,0.0,74.67959723715911,6
2020-06-08-170237,170237,2,0,1,428,1.0,75.7631337628876,0
2020-06-09-170237,170237,3,0,1,431,1.6666666666666667,92.14924855655654,1
2020-06-10-170237,170237,1,0,0,432,3.333333333333333,228.13651019129964,2
2020-06-11-170237,170237,0,0,0,432,1.0,217.64601743992665,3
2020-06-12-170237,170237,0,0,1,432,1.0,197.2237418537564,4
2020-06-13-170237,170237,1,0,0,433,0.0,155.59302479288542,5
2020-06-14-170237,170237,0,0,0,433,0.3333333333333333,129.98759495921402,6
2020-06-15-170237,170237,1,0,0,434,1.6666666666666667,77.49279387446532,0
2020-06-16-170237,170237,1,0,1,435,1.0,94.74953842579136,1
2020-06-17-170237,170237,1,0,1,436,1.6666666666666667,81.7081469897119,2
2020-06-18-170237,170237,0,0,0,436,0.6666666666666666,73.95118037340049,3
2020-06-19-170237,170237,0,0,1,436,0.3333333333333333,69.12829180820252,4
2020-06-20-170237,170237,0,0,1,436,0.3333333333333333,79.32228583259936,5
2020-06-21-170237,170237,0,0,0,436,0.3333333333333333,80.11776419438473,6
2020-06-22-170237,170237,1,0,1,437,1.0,65.04897746444388,0
2020-06-23-170237,170237,1,0,1,438,1.3333333333333333,64.92140474949582,1
2020-06-24-170237,170237,0,0,1,438,1.6666666666666667,58.58774473770181,2
2020-06-25-170237,170237,0,0,2,438,0.3333333333333333,60.12639050361281,3
2020-06-26-170237,170237,1,0,1,439,1.0,64.24500522544369,4
2020-06-27-170237,170237,0,0,0,439,0.3333333333333333,56.79913494339755,5
2020-06-28-170237,170237,0,0,0,439,0.0,58.544533743994066,6
2020-06-29-170237,170237,0,0,1,439,0.3333333333333333,56.237899127561796,0
2020-06-30-170237,170237,1,0,2,440,0.3333333333333333,51.03907506132171,1
2020-07-01-170237,170237,1,0,0,441,1.0,93.21797126983614,2
2020-07-02-170237,170237,0,0,3,441,0.0,66.66625687510631,3
2020-07-03-170237,170237,1,0,0,442,0.3333333333333333,76.42374936081107,4
2020-07-04-170237,170237,1,0,0,443,0.0,105.19128972957208,5
2020-07-05-170237,170237,0,0,1,443,0.0,103.27010437436587,6
2020-07-06-170237,170237,1,0,1,444,0.0,84.25724162266854,0
2020-07-07-170237,170237,1,0,0,445,0.6666666666666666,79.77916648252,1
2020-07-08-170237,170237,1,0,0,446,0.3333333333333333,67.19642777475862,2
2020-07-09-170237,170237,2,0,0,448,0.3333333333333333,63.532897097473,3
2020-07-10-170237,170237,1,0,1,449,0.0,97.55226347414518,4
2020-07-11-170237,170237,0,0,0,449,0.0,84.57860137194511,5
2020-07-12-170237,170237,0,0,0,449,0.6666666666666666,61.753105923640334,6
2020-07-13-170237,170237,1,0,0,450,0.6666666666666666,56.076843360963395,0
2020-07-14-170237,170237,2,0,0,452,1.0,63.4292766039823,1
2020-07-15-170237,170237,0,0,0,452,1.6666666666666667,52.510253208669994,2
2020-07-16-170237,170237,3,0,1,455,0.6666666666666666,47.68065698199186,3
2020-07-17-170237,170237,0,0,3,455,2.6666666666666665,42.769319956897746,4
2020-07-18-170237,170237,0,0,1,455,0.6666666666666666,54.90581336291862,5
2020-07-19-170237,170237,1,0,0,456,0.3333333333333333,63.984600004301086,6
2020-07-20-170237,170237,1,0,5,457,1.6666666666666667,57.1396844043207,0
2020-07-21-170237,170237,0,0,2,457,0.6666666666666666,62.6131283313653,1
2020-07-22-170237,170237,0,0,0,457,1.3333333333333333,57.03742399317244,2
2020-07-23-170237,170237,0,0,1,457,0.3333333333333333,64.55683585671237,3
2020-07-24-170237,170237,1,0,4,458,0.3333333333333333,55.64357465001856,4
2020-07-25-170237,170237,0,0,2,458,0.6666666666666666,53.96317533048544,5
2020-07-26-170237,170237,0,0,0,458,0.3333333333333333,54.41620822273911,6
2020-07-27-170237,170237,0,0,2,458,3.6666666666666665,56.80824960419797,0
2020-07-28-170237,170237,0,0,3,458,1.0,64.8196053041641,1
2020-07-29-170237,170237,0,0,5,458,3.0,66.67475763036865,2
2020-07-30-170237,170237,1,0,4,459,3.333333333333333,73.30968250473606,3
2020-07-31-170237,170237,3,0,3,462,3.6666666666666665,93.49401122628029,4
2020-08-01-170237,170237,1,0,0,463,2.0,41.9680634681194,5
2020-08-02-170237,170237,0,0,3,463,0.6666666666666666,258.5295175479828,6
2020-08-03-170237,170237,5,0,0,468,2.6666666666666665,249.44267321052425,0
2020-08-04-170237,170237,2,0,4,470,4.666666666666667,245.7172692506769,1
2020-08-05-170237,170237,0,1,3,470,5.666666666666668,234.7923408268384,2
2020-08-06-170237,170237,1,0,4,471,3.6666666666666665,242.99546971639995,3
2020-08-07-170237,170237,4,0,0,475,1.0,224.53632362155489,4
2020-08-08-170237,170237,2,0,1,477,2.333333333333333,230.2086396931037,5
2020-08-09-170237,170237,0,0,0,477,1.0,227.36795250328208,6
2020-08-10-170237,170237,2,1,3,479,2.333333333333333,32.711120951758225,0
2020-08-11-170237,170237,3,6,4,482,5.0,61.82019468860611,1
2020-08-12-170237,170237,5,0,3,487,6.0,97.45811816912311,2
2020-08-13-170237,170237,4,0,5,491,5.333333333333333,130.1812893104256,3
2020-08-14-170237,170237,3,0,2,494,5.0,165.96967919748909,4
2020-08-15-170237,170237,0,0,0,494,2.6666666666666665,193.086546416771,5
2020-08-16-170237,170237,3,0,6,497,3.0,197.66491413714374,6
2020-08-17-170237,170237,0,0,2,497,4.0,212.4989586015222,0
2020-08-18-170237,170237,4,0,3,501,10.666666666666666,207.42059616752715,1
2020-08-19-170237,170237,3,0,2,504,4.0,230.06095209686202,2
2020-08-20-170237,170237,4,0,19,508,3.6666666666666665,197.782802322927,3
2020-08-21-170237,170237,0,0,9,508,6.333333333333332,198.3316676440577,4
2020-08-22-170237,170237,1,0,5,509,5.0,218.2514058291681,5
2020-08-23-170237,170237,0,0,0,509,0.6666666666666666,228.2236834934955,6
2020-08-24-170237,170237,3,1,11,512,10.0,216.71626230656048,0
2020-08-25-170237,170237,4,0,2,516,6.333333333333332,217.56486004029165,1
2020-08-26-170237,170237,3,0,2,519,5.333333333333333,223.37486780714391,2
2020-08-27-170237,170237,5,0,0,524,5.333333333333333,250.3799757506146,3
2020-08-28-170237,170237,2,0,0,526,3.333333333333333,247.75867445744655,4
2020-08-29-170237,170237,0,0,0,526,1.0,251.33092485603058,5
2020-08-30-170237,170237,6,0,4,532,1.3333333333333333,247.18361194848367,6
2020-08-31-170237,170237,2,0,5,534,5.333333333333333,217.59118079983486,0
2020-09-01-170237,170237,3,0,1,537,6.666666666666668,212.67877350551626,1
2020-09-02-170237,170237,2,0,5,539,5.666666666666668,391.6178594278035,2
2020-09-03-170237,170237,19,0,5,558,4.666666666666667,365.1312354271199,3
2020-09-04-170237,170237,9,1,8,567,6.666666666666668,360.5772297747387,4
2020-09-05-170237,170237,5,1,1,572,4.0,333.0686495247269,5
2020-09-06-170237,170237,0,0,4,572,2.0,347.95419994635,6
2020-09-07-170237,170237,11,0,12,583,4.666666666666667,349.8629621363235,0
2020-09-08-170237,170237,2,0,9,585,10.0,344.3170972831029,1
2020-09-09-170237,170237,2,0,8,587,6.333333333333332,359.125105306757,2
2020-09-10-170237,170237,0,2,4,587,9.0,267.611918310085,3
2020-09-11-170237,170237,0,0,8,587,6.333333333333332,283.1631627667899,4
2020-09-12-170237,170237,0,0,1,587,3.0,299.47388005987955,5
2020-09-13-170237,170237,4,1,3,591,5.0,307.2722535926565,6
2020-09-14-170237,170237,5,0,3,596,7.333333333333332,336.35023154270647,0
2020-09-15-170237,170237,1,0,5,597,15.666666666666664,387.2719264347035,1
2020-09-16-170237,170237,5,1,4,602,8.333333333333334,453.01703867146955,2
2020-09-17-170237,170237,5,0,2,607,12.0,420.93414088194635,3
2020-09-18-170237,170237,8,0,6,615,10.666666666666666,447.1304164330369,4
2020-09-19-170237,170237,1,0,4,616,1.3333333333333333,475.7618208759489,5
2020-09-20-170237,170237,4,0,1,620,3.0,460.0716626628402,6
2020-09-21-170237,170237,12,1,3,632,10.333333333333334,402.0145818169959,0
2020-09-22-170237,170237,9,0,1,641,10.666666666666666,394.01807063528645,1
2020-09-23-170237,170237,8,1,9,649,15.666666666666664,404.89332529761816,2
2020-09-24-170237,170237,4,1,7,653,8.0,422.32530425780305,3
2020-09-25-170237,170237,8,1,3,661,13.0,398.9298905131493,4
2020-09-26-170237,170237,1,0,2,662,0.0,469.39452020169193,5
2020-09-27-170237,170237,3,0,3,665,1.6666666666666667,421.8612908514416,6
2020-09-28-170237,170237,3,1,5,668,8.666666666666666,421.56900475108375,0
2020-09-29-170237,170237,5,0,7,673,4.666666666666667,443.1863835776375,1
2020-09-30-170237,170237,4,0,3,677,10.0,387.1190424805834,2
2020-10-01-170237,170237,2,0,18,679,6.333333333333332,0.0,3
2020-10-02-170237,170237,6,0,8,685,7.0,995.8298712475896,4
2020-10-03-170237,170237,4,0,3,689,3.6666666666666665,1625.7428514502187,5
2020-10-04-170237,170237,1,0,1,690,5.333333333333333,1658.688250873554,6
2020-10-05-170237,170237,3,1,13,693,6.666666666666668,1348.7047354889874,0
2020-10-06-170237,170237,1,0,15,694,7.0,1137.635156136437,1
2020-10-07-170237,170237,9,0,12,703,8.0,923.190375052587,2
2020-10-08-170237,170237,7,0,10,710,6.666666666666668,770.4503655439655,3
2020-10-09-170237,170237,3,0,86,713,17.0,823.8503190977277,4
2020-10-10-170237,170237,2,0,5,715,2.333333333333333,53.291399808722325,5
2020-10-11-170237,170237,3,0,17,718,5.0,88.74416152292339,6
2020-10-12-170237,170237,5,0,25,723,7.333333333333332,148.09634145211044,0
2020-10-13-170237,170237,7,0,30,730,14.333333333333336,225.98079836682157,1
2020-10-14-170237,170237,3,0,27,733,9.0,390.37948234281527,2
2020-10-15-170237,170237,18,0,50,751,13.0,493.09078148223097,3
2020-10-16-170237,170237,8,0,21,759,16.666666666666668,700.1758782795245,4
2020-10-17-170237,170237,3,0,5,762,4.0,828.5342893348782,5
2020-10-18-170237,170237,1,0,5,763,4.0,842.7383120844647,6
2020-10-19-170237,170237,13,0,1,776,19.666666666666668,831.90004406105,0
2020-10-20-170237,170237,15,0,17,791,18.33333333333333,921.5177292136235,1
2020-10-21-170237,170237,12,0,14,803,17.0,1022.900872127848,2
2020-10-22-170237,170237,10,0,17,813,18.33333333333333,1052.7435359571696,3
2020-10-23-170237,170237,86,0,23,899,18.33333333333333,1110.7007531792328,4
2020-10-24-170237,170237,5,0,9,904,7.666666666666668,1278.5990071940075,5
2020-10-25-170237,170237,17,0,10,921,6.333333333333332,1319.4399448635306,6
2020-10-26-170237,170237,25,0,19,946,33.666666666666664,1181.7421508000539,0
2020-10-27-170237,170237,30,1,12,976,20.666666666666668,1458.8011877626532,1
2020-10-28-170237,170237,27,0,18,1003,20.666666666666668,1519.0255604543004,2
2020-10-29-170237,170237,50,1,21,1053,17.333333333333332,1560.293848046022,3
2020-10-30-170237,170237,21,0,19,1074,21.66666666666667,1446.5210983853272,4
2020-10-31-170237,170237,5,0,0,1079,9.333333333333334,1652.4943615694049,5
2020-11-01-170237,170237,5,0,0,1084,21.66666666666667,611.8512486096793,6
2020-11-02-170237,170237,1,0,0,1085,9.333333333333334,1412.5229290182729,0
2020-11-03-170237,170237,17,3,0,1102,24.66666666666667,1211.4915015137926,1
2020-11-04-170237,170237,14,0,0,1116,22.33333333333333,1468.5729736731616,2
2020-11-05-170237,170237,17,2,0,1133,17.333333333333332,1508.2761981388512,3
2020-11-06-170237,170237,23,1,0,1156,37.333333333333336,1623.2740125491985,4
2020-11-07-170237,170237,9,1,0,1165,10.333333333333334,1707.5736303836795,5
2020-11-08-170237,170237,10,2,0,1175,18.666666666666668,1651.6901511597694,6
2020-11-09-170237,170237,19,0,0,1194,26.33333333333333,1705.8967976253332,0
2020-11-10-170237,170237,12,0,0,1206,17.666666666666668,697.3267127287033,1
2020-11-11-170237,170237,18,1,0,1224,13.0,873.3211119427096,2
2020-11-12-170237,170237,21,0,0,1245,25.33333333333333,1015.5687154410869,3
2020-11-13-170237,170237,19,4,0,1264,22.33333333333333,1177.5318262621697,4
2020-03-01-170301,170301,0,0,0,0,0.14285714285714285,0.0,6
2020-03-02-170301,170301,0,0,10,0,0.0,119.88407463233506,0
2020-03-03-170301,170301,0,0,6,0,0.0,482.30212074576775,1
2020-03-04-170301,170301,0,0,14,0,0.0,539.8515258324982,2
2020-03-05-170301,170301,0,0,12,0,0.0,591.2043159911312,3
2020-03-06-170301,170301,0,0,15,0,0.0,510.2695400505552,4
2020-03-07-170301,170301,0,0,3,0,0.0,562.9368873341742,5
2020-03-08-170301,170301,0,0,0,0,0.0,564.1729118438211,6
2020-03-09-170301,170301,0,0,15,0,0.14285714285714285,563.1000292145776,0
2020-03-10-170301,170301,0,0,12,0,0.0,1591.7576586581833,1
2020-03-11-170301,170301,0,0,18,0,0.14285714285714285,1363.2837358692655,2
2020-03-12-170301,170301,1,0,6,1,0.14285714285714285,1070.443377761936,3
2020-03-13-170301,170301,0,0,20,1,0.0,690.3276256971246,4
2020-03-14-170301,170301,0,0,4,1,1.1428571428571428,626.970160471003,5
2020-03-15-170301,170301,0,0,10,1,1.1428571428571428,551.4312177131413,6
2020-03-16-170301,170301,10,0,7,11,9.571428571428571,58.109876280250994,0
2020-03-17-170301,170301,6,0,11,17,12.142857142857142,280.0962502345655,1
2020-03-18-170301,170301,14,0,6,31,12.428571428571427,479.6742202962232,2
2020-03-19-170301,170301,12,0,10,43,13.428571428571427,694.7495678362478,3
2020-03-20-170301,170301,15,0,7,58,12.142857142857142,879.9187937353365,4
2020-03-21-170301,170301,3,0,3,61,2.7142857142857144,1033.9065427000176,5
2020-03-22-170301,170301,0,0,2,61,4.0,1023.3125972975971,6
2020-03-23-170301,170301,15,0,5,76,18.714285714285715,876.9336796943848,0
2020-03-24-170301,170301,12,0,5,88,13.857142857142858,1000.8184449376356,1
2020-03-25-170301,170301,18,0,3,106,13.142857142857142,1004.44111037496,2
2020-03-26-170301,170301,6,0,3,112,12.571428571428573,1027.7302756052081,3
2020-03-27-170301,170301,20,0,35,132,13.714285714285715,1190.1742270839204,4
2020-03-28-170301,170301,4,0,5,136,3.571428571428572,1208.0501266128738,5
2020-03-29-170301,170301,10,0,6,146,0.8571428571428571,1210.9723666422979,6
2020-03-30-170301,170301,7,0,23,153,13.0,936.4647509745489,0
2020-03-31-170301,170301,11,0,15,164,11.714285714285715,910.1113786066757,1
2020-04-01-170301,170301,6,0,22,170,8.714285714285714,153.66100556107614,2
2020-04-02-170301,170301,10,0,14,180,6.0,928.6401824748257,3
2020-04-03-170301,170301,7,0,3,187,7.142857142857142,308.7317429009298,4
2020-04-04-170301,170301,3,0,0,190,1.7142857142857142,325.40139309860166,5
2020-04-05-170301,170301,2,0,1,192,1.1428571428571428,331.1379574696118,6
2020-04-06-170301,170301,5,0,3,197,11.571428571428573,342.4140565100429,0
2020-04-07-170301,170301,5,1,5,202,6.0,464.6855602975089,1
2020-04-08-170301,170301,3,0,2,205,10.571428571428571,515.2068561191206,2
2020-04-09-170301,170301,3,1,1,208,5.285714285714286,564.0450354328029,3
2020-04-10-170301,170301,35,0,6,243,5.571428571428571,109.40045648728685,4
2020-04-11-170301,170301,5,0,1,248,1.0,301.02674867358286,5
2020-04-12-170301,170301,6,0,1,254,1.2857142857142858,330.2546818054986,6
2020-04-13-170301,170301,23,0,0,277,5.428571428571429,377.4916981204223,0
2020-04-14-170301,170301,15,0,5,292,7.428571428571429,585.194862466753,1
2020-04-15-170301,170301,22,0,1,314,6.0,794.8366518868714,2
2020-04-16-170301,170301,14,0,6,328,6.2857142857142865,1012.0566926198844,3
2020-04-17-170301,170301,3,0,1,331,4.428571428571429,1126.4914528266459,4
2020-04-18-170301,170301,0,0,0,331,0.2857142857142857,1030.5415449059064,5
2020-04-19-170301,170301,1,0,0,332,0.7142857142857143,1014.6282764341813,6
2020-04-20-170301,170301,3,0,3,335,10.571428571428571,873.6419321846579,0
2020-04-21-170301,170301,5,0,1,340,8.285714285714286,785.7059727771307,1
2020-04-22-170301,170301,2,0,6,342,3.1428571428571432,636.3506162778752,2
2020-04-23-170301,170301,1,0,0,343,1.5714285714285714,504.1001870419022,3
2020-04-24-170301,170301,6,0,5,349,5.428571428571429,427.2447983908775,4
2020-04-25-170301,170301,1,0,1,350,1.4285714285714286,542.4248753621065,5
2020-04-26-170301,170301,1,0,0,351,0.42857142857142855,557.7296937895055,6
2020-04-27-170301,170301,0,0,2,351,3.4285714285714284,447.08552738975254,0
2020-04-28-170301,170301,5,0,1,356,2.571428571428572,363.2722892189913,1
2020-04-29-170301,170301,1,1,1,357,2.8571428571428568,343.67807769431545,2
2020-04-30-170301,170301,6,0,5,363,3.571428571428572,412.9964155113576,3
2020-05-01-170301,170301,1,0,3,364,0.2857142857142857,585.711808566066,4
2020-05-02-170301,170301,0,0,0,364,1.1428571428571428,224.99135357007972,5
2020-05-03-170301,170301,0,0,0,364,1.4285714285714286,175.55399544130734,6
2020-05-04-170301,170301,3,0,2,367,4.0,150.4093878674435,0
2020-05-05-170301,170301,1,0,1,368,3.0,178.56644792607887,1
2020-05-06-170301,170301,6,0,0,374,2.8571428571428568,188.938909932877,2
2020-05-07-170301,170301,0,0,5,374,2.4285714285714284,207.87470359562002,3
2020-05-08-170301,170301,5,0,0,379,3.1428571428571432,213.16418442345736,4
2020-05-09-170301,170301,1,0,0,380,1.0,276.6284817660053,5
2020-05-10-170301,170301,0,0,2,380,0.2857142857142857,575.0203701332847,6
2020-05-11-170301,170301,2,1,3,382,3.0,544.6617246470057,0
2020-05-12-170301,170301,1,0,1,383,1.7142857142857142,570.9500921882695,1
2020-05-13-170301,170301,1,0,1,384,3.8571428571428568,408.6407185143902,2
2020-05-14-170301,170301,5,1,2,389,3.571428571428572,324.1114027162057,3
2020-05-15-170301,170301,3,0,1,392,2.2857142857142856,288.1383454182202,4
2020-05-16-170301,170301,0,0,0,392,0.14285714285714285,247.89954820374953,5
2020-05-17-170301,170301,0,0,0,392,0.14285714285714285,252.31700884462356,6
2020-05-18-170301,170301,2,0,2,394,2.7142857142857144,253.26836300432313,0
2020-05-19-170301,170301,1,0,5,395,3.4285714285714284,245.5275688531421,1
2020-05-20-170301,170301,0,1,0,395,2.4285714285714284,238.18028103407482,2
2020-05-21-170301,170301,5,0,0,400,3.0,203.04071065357795,3
2020-05-22-170301,170301,0,0,2,400,3.0,223.85784911794624,4
2020-05-23-170301,170301,0,0,0,400,0.2857142857142857,278.8993985509859,5
2020-05-24-170301,170301,2,0,0,402,0.0,281.47676555018603,6
2020-05-25-170301,170301,3,0,1,405,1.7142857142857142,252.7480382304576,0
2020-05-26-170301,170301,1,0,0,406,2.0,247.75621668888638,1
2020-05-27-170301,170301,1,0,5,407,1.2857142857142858,272.0255443977415,2
2020-05-28-170301,170301,2,2,0,409,2.0,276.1896258016576,3
2020-05-29-170301,170301,1,0,0,410,1.4285714285714286,255.62927935105228,4
2020-05-30-170301,170301,0,1,0,410,1.0,242.81151755273328,5
2020-05-31-170301,170301,0,0,0,410,0.2857142857142857,246.57414666772132,6
2020-06-01-170301,170301,2,0,0,412,2.2857142857142856,345.54694695532663,0
2020-06-02-170301,170301,5,0,1,417,2.2857142857142856,129.02033120075126,1
2020-06-03-170301,170301,0,0,4,417,3.1428571428571432,71.1045902668232,2
2020-06-04-170301,170301,0,0,1,417,2.0,102.50813216136852,3
2020-06-05-170301,170301,2,1,0,419,1.8571428571428568,114.05883454904972,4
2020-06-06-170301,170301,0,0,0,419,0.2857142857142857,168.60242613161117,5
2020-06-07-170301,170301,0,0,0,419,0.42857142857142855,172.26591307829395,6
2020-06-08-170301,170301,1,0,0,420,2.142857142857143,174.4960000657913,0
2020-06-09-170301,170301,0,0,1,420,2.571428571428572,220.44414193683656,1
2020-06-10-170301,170301,5,0,0,425,2.7142857142857144,401.39410911208915,2
2020-06-11-170301,170301,0,1,1,425,2.7142857142857144,406.3887734722948,3
2020-06-12-170301,170301,0,0,0,425,1.7142857142857142,395.0964615910477,4
2020-06-13-170301,170301,0,0,0,425,0.42857142857142855,355.60739018848926,5
2020-06-14-170301,170301,0,0,0,425,0.0,309.7645427265477,6
2020-06-15-170301,170301,0,0,0,425,1.2857142857142858,238.11168502521156,0
2020-06-16-170301,170301,1,0,0,426,1.2857142857142858,240.3385796413072,1
2020-06-17-170301,170301,4,0,0,430,0.5714285714285714,212.84559968707785,2
2020-06-18-170301,170301,1,0,0,431,1.2857142857142858,169.96960577093165,3
2020-06-19-170301,170301,0,0,0,431,0.14285714285714285,149.80866707667448,4
2020-06-20-170301,170301,0,0,0,431,0.0,202.08439833559476,5
2020-06-21-170301,170301,0,0,0,431,0.0,200.38456669634382,6
2020-06-22-170301,170301,0,0,0,431,0.8571428571428571,182.05425292894742,0
2020-06-23-170301,170301,1,0,0,432,0.7142857142857143,163.319706500859,1
2020-06-24-170301,170301,0,3,0,432,0.7142857142857143,155.34820880632589,2
2020-06-25-170301,170301,1,0,0,433,1.8571428571428568,136.716954813878,3
2020-06-26-170301,170301,0,0,0,433,0.5714285714285714,145.7264583056157,4
2020-06-27-170301,170301,0,0,0,433,0.14285714285714285,79.71763892595835,5
2020-06-28-170301,170301,0,0,0,433,0.0,80.90854370922801,6
2020-06-29-170301,170301,0,0,0,433,0.0,80.82694116315534,0
2020-06-30-170301,170301,0,0,0,433,0.8571428571428571,105.041396614634,1
2020-07-01-170301,170301,0,0,0,433,0.14285714285714285,220.6257269153462,2
2020-07-02-170301,170301,0,0,1,433,0.2857142857142857,62.24800935426154,3
2020-07-03-170301,170301,0,0,1,433,0.5714285714285714,62.33324620215293,4
2020-07-04-170301,170301,0,0,0,433,0.0,78.18115447451923,5
2020-07-05-170301,170301,0,0,0,433,0.14285714285714285,74.30279861974131,6
2020-07-06-170301,170301,0,0,1,433,1.1428571428571428,66.96071925775796,0
2020-07-07-170301,170301,0,0,0,433,0.8571428571428571,64.86772939227444,1
2020-07-08-170301,170301,0,0,0,433,0.7142857142857143,70.92175888779288,2
2020-07-09-170301,170301,0,0,0,433,0.7142857142857143,71.34014545525885,3
2020-07-10-170301,170301,0,0,0,433,0.5714285714285714,229.92048339858144,4
2020-07-11-170301,170301,0,0,0,433,0.2857142857142857,203.25723684456352,5
2020-07-12-170301,170301,0,0,0,433,0.2857142857142857,138.90350333293222,6
2020-07-13-170301,170301,0,0,0,433,0.5714285714285714,137.17558062189352,0
2020-07-14-170301,170301,0,0,1,433,0.42857142857142855,145.86908072844676,1
2020-07-15-170301,170301,0,0,0,433,0.8571428571428571,95.14684508735823,2
2020-07-16-170301,170301,1,0,0,434,0.5714285714285714,50.844327127023746,3
2020-07-17-170301,170301,1,0,1,435,0.14285714285714285,55.22034207965136,4
2020-07-18-170301,170301,0,0,0,435,0.14285714285714285,61.997967652056964,5
2020-07-19-170301,170301,0,0,0,435,0.14285714285714285,62.86802442871045,6
2020-07-20-170301,170301,1,0,0,436,0.8571428571428571,55.63217701195891,0
2020-07-21-170301,170301,0,0,1,436,0.42857142857142855,70.25780973625027,1
2020-07-22-170301,170301,0,0,1,436,1.1428571428571428,72.90758719405865,2
2020-07-23-170301,170301,0,1,0,436,0.5714285714285714,84.12402532229073,3
2020-07-24-170301,170301,0,2,0,436,1.2857142857142858,75.90841543295222,4
2020-07-25-170301,170301,0,0,0,436,0.0,85.20870386509364,5
2020-07-26-170301,170301,0,0,0,436,0.2857142857142857,82.66559603542943,6
2020-07-27-170301,170301,0,0,1,436,0.42857142857142855,81.90508431202178,0
2020-07-28-170301,170301,1,0,1,437,0.5714285714285714,71.22177225839232,1
2020-07-29-170301,170301,0,0,1,437,0.7142857142857143,75.08946140265776,2
2020-07-30-170301,170301,0,0,0,437,0.7142857142857143,63.264377372382086,3
2020-07-31-170301,170301,1,0,0,438,0.8571428571428571,63.13481210092381,4
2020-08-01-170301,170301,0,0,0,438,0.14285714285714285,69.31473350953056,5
2020-08-02-170301,170301,0,0,0,438,0.14285714285714285,126.58030353171307,6
2020-08-03-170301,170301,0,0,0,438,0.42857142857142855,470.5971737798992,0
2020-08-04-170301,170301,1,0,0,439,1.0,440.8067716928447,1
2020-08-05-170301,170301,1,0,1,440,0.2857142857142857,402.0763838086925,2
2020-08-06-170301,170301,0,0,0,440,1.1428571428571428,332.4502412689607,3
2020-08-07-170301,170301,0,0,0,440,0.7142857142857143,271.6931902228099,4
2020-08-08-170301,170301,0,0,0,440,0.2857142857142857,225.54264598763095,5
2020-08-09-170301,170301,0,0,0,440,0.14285714285714285,213.60330576324185,6
2020-08-10-170301,170301,1,0,1,441,1.2857142857142858,56.16892391693443,0
2020-08-11-170301,170301,1,0,3,442,1.1428571428571428,79.02254983517757,1
2020-08-12-170301,170301,1,0,0,443,1.1428571428571428,102.7151097901854,2
2020-08-13-170301,170301,0,0,4,443,0.8571428571428571,112.88062746909013,3
2020-08-14-170301,170301,0,0,4,443,1.1428571428571428,117.22611420316494,4
2020-08-15-170301,170301,0,0,1,443,0.0,119.85066435113258,5
2020-08-16-170301,170301,0,1,0,443,0.42857142857142855,112.39377501413924,6
2020-08-17-170301,170301,0,0,5,443,0.2857142857142857,118.95260277628822,0
2020-08-18-170301,170301,0,0,3,443,0.8571428571428571,114.56928191538293,1
2020-08-19-170301,170301,1,0,1,444,1.5714285714285714,107.98777556525111,2
2020-08-20-170301,170301,0,0,2,444,2.2857142857142856,104.48105580447445,3
2020-08-21-170301,170301,0,1,4,444,2.7142857142857144,126.53180160812293,4
2020-08-22-170301,170301,0,0,0,444,0.14285714285714285,180.8005169606445,5
2020-08-23-170301,170301,0,0,7,444,0.8571428571428571,191.91338239514113,6
2020-08-24-170301,170301,1,0,6,445,1.2857142857142858,190.16766846008247,0
2020-08-25-170301,170301,3,0,4,448,5.285714285714286,231.591723819074,1
2020-08-26-170301,170301,0,0,10,448,1.8571428571428568,296.88287155762276,2
2020-08-27-170301,170301,4,0,11,452,3.4285714285714284,351.6326049776852,3
2020-08-28-170301,170301,4,0,7,456,2.142857142857143,399.57886290995896,4
2020-08-29-170301,170301,1,0,6,457,1.8571428571428568,409.4197166646919,5
2020-08-30-170301,170301,0,0,1,457,1.7142857142857142,446.3160261569642,6
2020-08-31-170301,170301,5,0,5,462,4.142857142857143,426.2959404617154,0
2020-09-01-170301,170301,3,0,4,465,2.2857142857142856,169.7405976585722,1
2020-09-02-170301,170301,1,0,3,466,2.571428571428572,805.91392843597,2
2020-09-03-170301,170301,2,0,5,468,3.0,936.5519755850096,3
2020-09-04-170301,170301,4,0,3,472,4.142857142857143,861.7102767441511,4
2020-09-05-170301,170301,0,0,6,472,1.8571428571428568,766.498528144522,5
2020-09-06-170301,170301,7,1,3,479,2.4285714285714284,766.5003952781742,6
2020-09-07-170301,170301,6,0,1,485,5.428571428571429,802.5016496653551,0
2020-09-08-170301,170301,4,0,5,489,4.285714285714286,728.11171448428,1
2020-09-09-170301,170301,10,0,6,499,7.0,706.8513770741198,2
2020-09-10-170301,170301,11,0,11,510,5.857142857142858,128.8973533695736,3
2020-09-11-170301,170301,7,0,10,517,4.857142857142857,302.0316913574825,4
2020-09-12-170301,170301,6,0,1,523,2.2857142857142856,464.5312681031168,5
2020-09-13-170301,170301,1,0,4,524,5.0,523.812824839486,6
2020-09-14-170301,170301,5,0,6,529,4.0,576.2543974686123,0
2020-09-15-170301,170301,4,0,4,533,5.142857142857143,716.0831132474789,1
2020-09-16-170301,170301,3,0,25,536,7.571428571428571,806.1520094783609,2
2020-09-17-170301,170301,5,0,34,541,8.0,921.8751712847333,3
2020-09-18-170301,170301,3,0,20,544,6.2857142857142865,895.8623145577774,4
2020-09-19-170301,170301,6,0,2,550,2.7142857142857144,827.8886805964103,5
2020-09-20-170301,170301,3,0,2,553,2.0,793.3559583607422,6
2020-09-21-170301,170301,1,0,2,554,10.428571428571429,690.2572866232485,0
2020-09-22-170301,170301,5,1,32,559,6.2857142857142865,743.5517946765364,1
2020-09-23-170301,170301,6,0,6,565,9.142857142857142,717.0496613192237,2
2020-09-24-170301,170301,11,0,20,576,15.857142857142858,704.0674074145671,3
2020-09-25-170301,170301,10,0,10,586,9.285714285714286,821.0836677949032,4
2020-09-26-170301,170301,1,0,6,587,2.8571428571428568,924.9063342367175,5
2020-09-27-170301,170301,4,1,5,591,1.1428571428571428,917.3025188421267,6
2020-09-28-170301,170301,6,0,6,597,8.857142857142858,908.8123639686726,0
2020-09-29-170301,170301,4,1,26,601,7.571428571428571,943.4356152034031,1
2020-09-30-170301,170301,25,0,15,626,7.571428571428571,859.7578928426533,2
2020-10-01-170301,170301,34,0,25,660,13.285714285714285,0.0,3
2020-10-02-170301,170301,20,1,21,680,12.571428571428573,1902.4762903750423,4
2020-10-03-170301,170301,2,1,4,682,5.285714285714286,1538.7180818880515,5
2020-10-04-170301,170301,2,0,1,684,2.2857142857142856,1588.5471032687014,6
2020-10-05-170301,170301,2,0,15,686,5.7142857142857135,1299.2514992450276,0
2020-10-06-170301,170301,32,2,9,718,6.428571428571429,1114.5670998540347,1
2020-10-07-170301,170301,6,2,20,724,9.142857142857142,1163.0113061602553,2
2020-10-08-170301,170301,20,2,6,744,10.142857142857142,1027.5296696453604,3
2020-10-09-170301,170301,10,5,10,754,21.0,1249.7876680234356,4
2020-10-10-170301,170301,6,0,3,760,2.571428571428572,347.9791869387686,5
2020-10-11-170301,170301,5,0,0,765,2.8571428571428568,412.80956170795497,6
2020-10-12-170301,170301,6,0,14,771,3.2857142857142856,475.86086015318233,0
2020-10-13-170301,170301,26,0,13,797,17.285714285714285,549.7673136950715,1
2020-10-14-170301,170301,15,0,7,812,14.0,949.9783624432943,2
2020-10-15-170301,170301,25,0,23,837,15.857142857142858,1193.7804055409867,3
2020-10-16-170301,170301,21,0,13,858,15.714285714285715,1495.1903259589096,4
2020-10-17-170301,170301,4,1,4,862,4.0,1480.2370265895622,5
2020-10-18-170301,170301,1,0,0,863,4.857142857142857,1473.8693753910072,6
2020-10-19-170301,170301,15,0,4,878,17.714285714285715,1479.7213449044905,0
2020-10-20-170301,170301,9,1,18,887,10.857142857142858,1672.8985218681962,1
2020-10-21-170301,170301,20,1,8,907,9.571428571428571,1635.670032831969,2
2020-10-22-170301,170301,6,0,10,913,12.142857142857142,1585.9280112580905,3
2020-10-23-170301,170301,10,0,19,923,14.428571428571427,1485.1758057758611,4
2020-10-24-170301,170301,3,1,2,926,5.0,1696.702472727194,5
2020-10-25-170301,170301,0,2,4,926,3.1428571428571432,1703.8772866903626,6
2020-10-26-170301,170301,14,0,20,940,15.571428571428573,1374.7796065481718,0
2020-10-27-170301,170301,13,0,6,953,7.2857142857142865,1464.9127159391078,1
2020-10-28-170301,170301,7,0,10,960,11.571428571428573,1437.8375920417102,2
2020-10-29-170301,170301,23,0,14,983,15.142857142857142,1434.9907780607177,3
2020-10-30-170301,170301,13,1,6,996,14.714285714285715,1288.6548014090788,4
2020-10-31-170301,170301,4,0,0,1000,3.571428571428572,1549.8150390767298,5
2020-11-01-170301,170301,0,2,0,1000,5.142857142857143,1385.3956526956908,6
2020-11-02-170301,170301,4,2,0,1004,1.8571428571428568,1288.2904395499727,0
2020-11-03-170301,170301,18,1,0,1022,14.857142857142858,1161.8196721381466,1
2020-11-04-170301,170301,8,1,0,1030,6.0,1541.3983895748374,2
2020-11-05-170301,170301,10,0,0,1040,13.428571428571427,1399.8435075919901,3
2020-11-06-170301,170301,19,5,0,1059,15.714285714285715,1496.7302738511946,4
2020-11-07-170301,170301,2,1,0,1061,4.142857142857143,1631.7812625795063,5
2020-11-08-170301,170301,4,0,0,1065,8.0,1490.4715703949946,6
2020-11-09-170301,170301,20,1,0,1085,24.57142857142857,1501.8222690385219,0
2020-11-10-170301,170301,6,0,0,1091,12.571428571428573,1343.2390445418018,1
2020-11-11-170301,170301,10,0,0,1101,9.142857142857142,1555.2907672462816,2
2020-11-12-170301,170301,14,1,0,1115,11.0,1749.0253571837998,3
2020-11-13-170301,170301,6,3,0,1121,13.142857142857142,1649.0139914221377,4
2020-03-01-170302,170302,0,0,2,0,0.0,0.0,6
2020-03-02-170302,170302,0,0,11,0,0.0,216.51719748438717,0
2020-03-03-170302,170302,0,0,25,0,0.0,710.6158458526982,1
2020-03-04-170302,170302,0,0,25,0,0.0,704.3691446982338,2
2020-03-05-170302,170302,0,0,25,0,0.0,720.5291075546118,3
2020-03-06-170302,170302,0,0,17,0,0.0,661.1331180723898,4
2020-03-07-170302,170302,0,0,16,0,0.0,682.7621484664411,5
2020-03-08-170302,170302,1,0,12,1,0.0,720.6695068198763,6
2020-03-09-170302,170302,1,0,28,2,0.0,708.3171490316655,0
2020-03-10-170302,170302,2,1,33,4,0.0,539.8793545789141,1
2020-03-11-170302,170302,0,0,25,4,0.0,424.412620545058,2
2020-03-12-170302,170302,1,0,20,5,0.0,349.5500777586311,3
2020-03-13-170302,170302,4,0,26,9,0.0,289.1997490471,4
2020-03-14-170302,170302,4,0,9,13,2.5,208.44492568518712,5
2020-03-15-170302,170302,2,0,0,15,1.5,239.7073012413028,6
2020-03-16-170302,170302,11,0,27,26,5.5,146.23744985431054,0
2020-03-17-170302,170302,25,0,20,51,10.0,270.1310722745988,1
2020-03-18-170302,170302,25,0,18,76,7.5,569.8530099696578,2
2020-03-19-170302,170302,25,1,11,101,8.0,786.777075360875,3
2020-03-20-170302,170302,17,0,24,118,8.5,985.5768422449332,4
2020-03-21-170302,170302,16,0,5,134,3.5,1072.8306891264704,5
2020-03-22-170302,170302,12,0,0,146,5.5,1097.176272055688,6
2020-03-23-170302,170302,28,0,18,174,18.0,1084.4297954613871,0
2020-03-24-170302,170302,33,0,9,207,12.5,1116.2638366940112,1
2020-03-25-170302,170302,25,0,8,232,13.5,1233.3290600741234,2
2020-03-26-170302,170302,20,0,9,252,9.0,1282.6571454702398,3
2020-03-27-170302,170302,26,0,17,278,15.0,1498.2790143528684,4
2020-03-28-170302,170302,9,0,4,287,5.5,1501.7487140997,5
2020-03-29-170302,170302,0,0,3,287,2.0,1488.5796047531605,6
2020-03-30-170302,170302,27,0,16,314,13.0,1141.1195920542623,0
2020-03-31-170302,170302,20,0,6,334,10.0,1025.9545658009924,1
2020-04-01-170302,170302,18,0,8,352,8.5,202.88645717089304,2
2020-04-02-170302,170302,11,0,11,363,7.0,505.1228364938298,3
2020-04-03-170302,170302,24,0,16,387,7.0,275.42381717472796,4
2020-04-04-170302,170302,5,0,4,392,3.5,271.6162959808341,5
2020-04-05-170302,170302,0,0,18,392,0.5,308.98261056491594,6
2020-04-06-170302,170302,18,0,11,410,5.5,307.9965063006356,0
2020-04-07-170302,170302,9,1,25,419,7.5,424.42602140803615,1
2020-04-08-170302,170302,8,2,3,427,23.5,506.0153183130441,2
2020-04-09-170302,170302,9,0,2,436,5.0,568.9631294419368,3
2020-04-10-170302,170302,17,1,26,453,5.0,144.0885230242756,4
2020-04-11-170302,170302,4,0,0,457,1.5,239.0386790197179,5
2020-04-12-170302,170302,3,0,1,460,2.5,276.42352955347627,6
2020-04-13-170302,170302,16,0,3,476,3.5,313.10010387636623,0
2020-04-14-170302,170302,6,0,1,482,3.5,448.19325819391474,1
2020-04-15-170302,170302,8,0,3,490,2.5,491.6894444807104,2
2020-04-16-170302,170302,11,0,4,501,5.0,524.5226280061529,3
2020-04-17-170302,170302,16,0,1,517,3.0,466.85171634245415,4
2020-04-18-170302,170302,4,0,1,521,0.0,485.6842769631939,5
2020-04-19-170302,170302,18,0,0,539,1.0,465.67318551359153,6
2020-04-20-170302,170302,11,1,4,550,10.0,491.930192247596,0
2020-04-21-170302,170302,25,0,3,575,19.0,498.8497737488989,1
2020-04-22-170302,170302,3,0,4,578,2.5,599.0811613621782,2
2020-04-23-170302,170302,2,0,7,580,0.0,594.3128191424222,3
2020-04-24-170302,170302,26,0,1,606,2.0,479.3614025361564,4
2020-04-25-170302,170302,0,0,0,606,0.5,632.3650647655691,5
2020-04-26-170302,170302,1,0,0,607,0.0,550.4467380861993,6
2020-04-27-170302,170302,3,0,4,610,2.0,447.48577500625765,0
2020-04-28-170302,170302,1,1,4,611,4.0,420.96630345986887,1
2020-04-29-170302,170302,3,0,4,614,0.5,330.08044513710496,2
2020-04-30-170302,170302,4,0,2,618,0.0,444.38380928290746,3
2020-05-01-170302,170302,1,0,5,619,0.0,544.7353405246614,4
2020-05-02-170302,170302,1,0,2,620,1.0,153.63464189713082,5
2020-05-03-170302,170302,0,0,2,620,0.0,213.56465830512312,6
2020-05-04-170302,170302,4,0,4,624,1.0,181.64686132247303,0
2020-05-05-170302,170302,3,0,2,627,1.5,177.96529700099398,1
2020-05-06-170302,170302,4,0,6,631,1.5,197.90541407623456,2
2020-05-07-170302,170302,7,0,2,638,0.0,178.35958759523183,3
2020-05-08-170302,170302,1,0,1,639,4.5,166.71769210326528,4
2020-05-09-170302,170302,0,0,2,639,0.5,198.77964885367373,5
2020-05-10-170302,170302,0,0,0,639,0.0,569.0548038163746,6
2020-05-11-170302,170302,4,0,3,643,0.5,520.0201473880383,0
2020-05-12-170302,170302,4,0,3,647,0.5,563.9080712984498,1
2020-05-13-170302,170302,4,0,3,651,0.5,449.90996710531215,2
2020-05-14-170302,170302,2,0,3,653,1.0,334.75491761512694,3
2020-05-15-170302,170302,5,0,7,658,1.5,259.65302953988964,4
2020-05-16-170302,170302,2,0,1,660,0.0,200.8328605045869,5
2020-05-17-170302,170302,2,0,0,662,0.0,207.18388825565157,6
2020-05-18-170302,170302,4,0,1,666,1.0,219.04319336662886,0
2020-05-19-170302,170302,2,0,3,668,3.5,206.71553713982354,1
2020-05-20-170302,170302,6,0,3,674,1.0,154.3263044730254,2
2020-05-21-170302,170302,2,0,4,676,0.5,172.8423721423317,3
2020-05-22-170302,170302,1,0,3,677,2.0,161.83499383229702,4
2020-05-23-170302,170302,2,0,1,679,0.0,162.81706281145202,5
2020-05-24-170302,170302,0,0,0,679,0.0,161.46138410785713,6
2020-05-25-170302,170302,3,0,1,682,0.5,128.62164221882966,0
2020-05-26-170302,170302,3,0,2,685,2.0,145.56557930778914,1
2020-05-27-170302,170302,3,0,1,688,0.5,176.79932301412458,2
2020-05-28-170302,170302,3,2,1,691,1.5,176.6884907445301,3
2020-05-29-170302,170302,7,0,3,698,1.0,216.45972244219678,4
2020-05-30-170302,170302,1,0,0,699,0.0,263.5868164371709,5
2020-05-31-170302,170302,0,0,0,699,0.0,274.9785053930989,6
2020-06-01-170302,170302,1,0,2,700,2.0,239.4882186614177,0
2020-06-02-170302,170302,3,0,2,703,0.0,69.12347302729427,1
2020-06-03-170302,170302,3,0,0,706,0.5,43.91780995858182,2
2020-06-04-170302,170302,4,0,1,710,0.0,67.39809709119069,3
2020-06-05-170302,170302,3,0,2,713,1.0,93.94046820581016,4
2020-06-06-170302,170302,1,1,0,714,0.0,129.70123140047852,5
2020-06-07-170302,170302,0,0,0,714,0.0,136.999986814258,6
2020-06-08-170302,170302,1,0,1,715,0.0,138.64668079217523,0
2020-06-09-170302,170302,2,0,1,717,2.0,147.73363148539892,1
2020-06-10-170302,170302,1,0,1,718,0.5,320.15093482285147,2
2020-06-11-170302,170302,1,0,1,719,1.5,318.18974612440525,3
2020-06-12-170302,170302,3,0,1,722,1.0,260.6699360657637,4
2020-06-13-170302,170302,0,0,0,722,0.5,256.39028538940863,5
2020-06-14-170302,170302,0,0,0,722,0.0,202.20894517842905,6
2020-06-15-170302,170302,2,0,0,724,0.0,169.2621483378864,0
2020-06-16-170302,170302,2,0,1,726,0.5,187.32369469055186,1
2020-06-17-170302,170302,0,0,0,726,0.0,127.1463957109963,2
2020-06-18-170302,170302,1,0,0,727,0.5,97.17621357001941,3
2020-06-19-170302,170302,2,0,1,729,0.0,94.49353479268358,4
2020-06-20-170302,170302,0,0,0,729,0.0,105.49586127718891,5
2020-06-21-170302,170302,0,0,0,729,0.0,107.10469736500612,6
2020-06-22-170302,170302,1,0,1,730,0.0,86.70089742268746,0
2020-06-23-170302,170302,1,0,0,731,0.0,79.84022007642102,1
2020-06-24-170302,170302,1,0,0,732,0.0,87.44416004036357,2
2020-06-25-170302,170302,1,0,0,733,1.5,84.59381525034051,3
2020-06-26-170302,170302,1,0,0,734,0.0,82.17281934609979,4
2020-06-27-170302,170302,0,0,0,734,0.5,57.7788375952462,5
2020-06-28-170302,170302,0,0,0,734,0.0,58.5678323075872,6
2020-06-29-170302,170302,0,0,0,734,0.0,57.867766561859,0
2020-06-30-170302,170302,1,0,1,735,1.0,69.21473012775444,1
2020-07-01-170302,170302,0,0,0,735,0.0,158.2597146372816,2
2020-07-02-170302,170302,0,0,0,735,0.5,24.391733581917308,3
2020-07-03-170302,170302,1,0,0,736,0.0,25.48869479288327,4
2020-07-04-170302,170302,0,0,0,736,0.0,33.96185607865901,5
2020-07-05-170302,170302,0,0,0,736,0.0,33.22196141808891,6
2020-07-06-170302,170302,1,0,0,737,0.0,31.116910780699307,0
2020-07-07-170302,170302,0,0,0,737,0.5,30.10588369555166,1
2020-07-08-170302,170302,0,0,1,737,0.5,29.52245098630184,2
2020-07-09-170302,170302,0,0,0,737,0.0,22.460884218389342,3
2020-07-10-170302,170302,0,0,0,737,0.0,148.95539324049432,4
2020-07-11-170302,170302,0,2,0,737,0.0,104.68818967071607,5
2020-07-12-170302,170302,0,0,0,737,0.5,56.85470475504191,6
2020-07-13-170302,170302,0,0,0,737,1.0,48.46010923618151,0
2020-07-14-170302,170302,1,0,1,738,0.0,52.551425979681,1
2020-07-15-170302,170302,0,0,0,738,1.0,46.45498654374231,2
2020-07-16-170302,170302,0,0,0,738,0.5,20.645517139031906,3
2020-07-17-170302,170302,0,0,0,738,0.0,22.347425367526277,4
2020-07-18-170302,170302,0,0,0,738,0.5,22.352222271041736,5
2020-07-19-170302,170302,0,0,0,738,0.5,25.348150452627188,6
2020-07-20-170302,170302,0,0,3,738,1.0,25.92434904075762,0
2020-07-21-170302,170302,0,0,2,738,0.5,21.503159727918923,1
2020-07-22-170302,170302,1,0,1,739,1.0,21.623222286141228,2
2020-07-23-170302,170302,0,0,0,739,1.0,29.38414981445198,3
2020-07-24-170302,170302,0,0,5,739,1.5,32.57240835910251,4
2020-07-25-170302,170302,0,0,1,739,0.0,33.39808601806021,5
2020-07-26-170302,170302,0,0,0,739,0.5,33.47251357602744,6
2020-07-27-170302,170302,0,0,0,739,0.5,28.286126684406668,0
2020-07-28-170302,170302,1,0,0,740,1.0,27.005553980188587,1
2020-07-29-170302,170302,0,1,0,740,0.5,36.00612760797785,2
2020-07-30-170302,170302,0,0,0,740,2.0,32.71479817218124,3
2020-07-31-170302,170302,0,0,1,740,0.5,34.42184628040657,4
2020-08-01-170302,170302,0,0,0,740,0.0,22.872391011946455,5
2020-08-02-170302,170302,0,0,0,740,0.0,83.89072060554017,6
2020-08-03-170302,170302,3,0,1,743,0.0,330.83677890016514,0
2020-08-04-170302,170302,2,0,0,745,1.5,382.4575103555407,1
2020-08-05-170302,170302,1,0,3,746,1.0,275.9228762326672,2
2020-08-06-170302,170302,0,0,0,746,1.0,261.3235371086056,3
2020-08-07-170302,170302,5,0,1,751,0.0,189.54459571057063,4
2020-08-08-170302,170302,1,0,1,752,0.0,218.42881173314512,5
2020-08-09-170302,170302,0,0,0,752,0.0,201.42069867525055,6
2020-08-10-170302,170302,0,0,0,752,0.5,24.047268873726974,0
2020-08-11-170302,170302,0,0,0,752,0.0,46.420331060232854,1
2020-08-12-170302,170302,0,1,1,752,0.5,49.2262667542103,2
2020-08-13-170302,170302,0,0,1,752,0.5,48.83502674943381,3
2020-08-14-170302,170302,1,1,5,753,0.5,57.81981234954556,4
2020-08-15-170302,170302,0,0,0,753,0.0,64.97997456207781,5
2020-08-16-170302,170302,0,0,0,753,1.0,72.39128826725639,6
2020-08-17-170302,170302,1,0,0,754,0.0,73.04140136987496,0
2020-08-18-170302,170302,0,0,2,754,1.0,59.85749321335459,1
2020-08-19-170302,170302,3,0,6,757,1.0,65.8389929262678,2
2020-08-20-170302,170302,0,0,2,757,3.0,77.33497412951851,3
2020-08-21-170302,170302,1,0,0,758,3.5,77.01526329114719,4
2020-08-22-170302,170302,1,0,0,759,0.0,86.84592245786706,5
2020-08-23-170302,170302,0,0,0,759,2.0,89.08535520467684,6
2020-08-24-170302,170302,0,0,0,759,1.5,82.94552170937676,0
2020-08-25-170302,170302,0,0,1,759,3.0,81.31455366913112,1
2020-08-26-170302,170302,1,0,25,760,4.0,66.52955911401551,2
2020-08-27-170302,170302,1,0,1,761,5.5,211.5526561229001,3
2020-08-28-170302,170302,5,1,2,766,3.0,247.85433073695634,4
2020-08-29-170302,170302,0,0,1,766,0.5,315.8549364975281,5
2020-08-30-170302,170302,0,0,1,766,2.0,356.9398058693182,6
2020-08-31-170302,170302,0,0,2,766,3.5,383.42416142531306,0
2020-09-01-170302,170302,2,0,4,768,2.0,166.87313726833887,1
2020-09-02-170302,170302,6,0,1,774,1.0,242.88811255245798,2
2020-09-03-170302,170302,2,0,2,776,6.0,225.47504979693542,3
2020-09-04-170302,170302,0,0,3,776,3.0,363.2711518577212,4
2020-09-05-170302,170302,0,0,0,776,1.5,361.1973491078766,5
2020-09-06-170302,170302,0,0,2,776,1.0,316.92396649008174,6
2020-09-07-170302,170302,0,0,6,776,3.5,316.17263753083694,0
2020-09-08-170302,170302,1,0,5,777,1.0,265.2166870249578,1
2020-09-09-170302,170302,25,0,0,802,4.5,247.48352605011843,2
2020-09-10-170302,170302,1,0,0,803,0.5,221.00533411788004,3
2020-09-11-170302,170302,2,0,2,805,1.5,202.17082238298084,4
2020-09-12-170302,170302,1,0,5,806,0.5,237.04489170958865,5
2020-09-13-170302,170302,1,0,0,807,3.0,232.04914154633525,6
2020-09-14-170302,170302,2,0,3,809,1.0,202.8446441942358,0
2020-09-15-170302,170302,4,0,2,813,6.0,230.05509164066223,1
2020-09-16-170302,170302,1,0,3,814,5.0,308.2819457923062,2
2020-09-17-170302,170302,2,0,1,816,7.5,253.0606074300692,3
2020-09-18-170302,170302,3,0,2,819,3.5,263.07983002328643,4
2020-09-19-170302,170302,0,0,2,819,1.5,238.2347792003988,5
2020-09-20-170302,170302,2,0,3,821,1.0,265.4789386995136,6
2020-09-21-170302,170302,6,1,0,827,6.0,262.58114000301305,0
2020-09-22-170302,170302,5,0,1,832,3.0,258.669191396082,1
2020-09-23-170302,170302,0,0,6,832,5.5,293.68372138706496,2
2020-09-24-170302,170302,0,0,11,832,1.5,284.45557284502576,3
2020-09-25-170302,170302,2,1,8,834,7.0,265.5812595226231,4
2020-09-26-170302,170302,5,0,1,839,1.0,288.0257906477275,5
2020-09-27-170302,170302,0,0,0,839,0.0,279.4344601123498,6
2020-09-28-170302,170302,3,0,0,842,4.5,249.1029638557004,0
2020-09-29-170302,170302,2,0,4,844,4.5,235.50867397154735,1
2020-09-30-170302,170302,3,0,8,847,2.0,283.7472097136087,2
2020-10-01-170302,170302,1,0,14,848,15.0,0.0,3
2020-10-02-170302,170302,2,0,5,850,8.0,590.6136475731948,4
2020-10-03-170302,170302,2,2,8,852,1.5,647.718568724242,5
2020-10-04-170302,170302,3,0,5,855,0.0,732.1560546976107,6
2020-10-05-170302,170302,0,1,3,855,3.5,659.434009849709,0
2020-10-06-170302,170302,1,1,3,856,2.5,617.2934274824977,1
2020-10-07-170302,170302,6,0,10,862,1.5,591.2237244689644,2
2020-10-08-170302,170302,11,2,9,873,4.5,450.7111621608029,3
2020-10-09-170302,170302,8,2,7,881,4.5,473.1062500766923,4
2020-10-10-170302,170302,1,0,5,882,0.5,51.88595165371471,5
2020-10-11-170302,170302,0,0,1,882,1.0,66.04335806365047,6
2020-10-12-170302,170302,0,0,3,882,0.0,95.45129758641296,0
2020-10-13-170302,170302,4,0,2,886,7.0,101.26697646454932,1
2020-10-14-170302,170302,8,0,1,894,10.5,181.97301903115465,2
2020-10-15-170302,170302,14,0,21,908,7.5,280.337622673237,3
2020-10-16-170302,170302,5,0,5,913,7.0,347.2614543186188,4
2020-10-17-170302,170302,8,0,8,921,1.0,385.7457531253233,5
2020-10-18-170302,170302,5,0,0,926,2.0,449.2584893550538,6
2020-10-19-170302,170302,3,0,6,929,11.0,490.9519381193241,0
2020-10-20-170302,170302,3,1,3,932,6.5,540.1428163140777,1
2020-10-21-170302,170302,10,0,8,942,6.5,510.5120485679704,2
2020-10-22-170302,170302,9,1,3,951,6.0,561.4418012554005,3
2020-10-23-170302,170302,7,0,3,958,5.5,576.9306403150404,4
2020-10-24-170302,170302,5,0,7,963,4.5,614.8370337925601,5
2020-10-25-170302,170302,1,0,0,964,2.5,605.619561548037,6
2020-10-26-170302,170302,3,1,10,967,5.0,539.3889444671972,0
2020-10-27-170302,170302,2,1,2,969,4.5,584.6737544275248,1
2020-10-28-170302,170302,1,2,5,970,5.5,581.44885807686,2
2020-10-29-170302,170302,21,1,6,991,17.0,522.603462480612,3
2020-10-30-170302,170302,5,0,4,996,6.5,573.5824600137037,4
2020-10-31-170302,170302,8,0,0,1004,4.0,612.3511865530083,5
2020-11-01-170302,170302,0,0,0,1004,1.5,511.20225622658836,6
2020-11-02-170302,170302,6,0,0,1010,3.0,352.49812250129935,0
2020-11-03-170302,170302,3,2,0,1013,10.0,365.493425759458,1
2020-11-04-170302,170302,8,0,0,1021,3.0,486.38495133873647,2
2020-11-05-170302,170302,3,2,0,1024,11.0,563.3457380283228,3
2020-11-06-170302,170302,3,2,0,1027,7.0,601.2908365125087,4
2020-11-07-170302,170302,7,0,0,1034,4.0,541.0039627101551,5
2020-11-08-170302,170302,0,0,0,1034,2.0,551.9468379866091,6
2020-11-09-170302,170302,10,2,0,1044,7.0,493.60907799101426,0
2020-11-10-170302,170302,2,0,0,1046,5.0,372.6542704230659,1
2020-11-11-170302,170302,5,0,0,1051,5.5,398.021344852716,2
2020-11-12-170302,170302,6,2,0,1057,6.5,466.7569848160435,3
2020-11-13-170302,170302,4,1,0,1061,14.5,508.2176295624045,4
2020-03-01-170303,170303,0,0,1,0,0.0,0.0,6
2020-03-02-170303,170303,0,0,1,0,0.0,173.02110752476563,0
2020-03-03-170303,170303,0,0,7,0,0.0,593.848525584877,1
2020-03-04-170303,170303,0,0,4,0,0.0,606.0732913307422,2
2020-03-05-170303,170303,0,0,9,0,0.0,627.433028472165,3
2020-03-06-170303,170303,0,1,5,0,0.14285714285714285,576.8134969938042,4
2020-03-07-170303,170303,0,0,0,0,0.0,593.9139359166629,5
2020-03-08-170303,170303,0,0,1,0,0.14285714285714285,608.0938622697004,6
2020-03-09-170303,170303,0,0,7,0,0.2857142857142857,605.3767302271863,0
2020-03-10-170303,170303,0,0,9,0,0.2857142857142857,706.5057258747809,1
2020-03-11-170303,170303,0,0,15,0,0.0,566.7701477726373,2
2020-03-12-170303,170303,0,0,8,0,0.42857142857142855,447.10961731738007,3
2020-03-13-170303,170303,0,0,3,0,0.7142857142857143,335.53214601320826,4
2020-03-14-170303,170303,1,0,2,1,1.2857142857142858,241.61427849111243,5
2020-03-15-170303,170303,1,0,2,2,1.0,235.560275727736,6
2020-03-16-170303,170303,1,0,4,3,5.142857142857143,120.05397159713877,0
2020-03-17-170303,170303,7,0,6,10,9.285714285714286,240.0491764070801,1
2020-03-18-170303,170303,4,0,3,14,11.142857142857142,491.17271400670234,2
2020-03-19-170303,170303,9,0,3,23,9.142857142857142,712.58274580298,3
2020-03-20-170303,170303,5,1,2,28,7.571428571428571,907.2942077257351,4
2020-03-21-170303,170303,0,0,1,28,5.428571428571429,1003.6933506045195,5
2020-03-22-170303,170303,1,0,0,29,6.571428571428571,1036.4007763726718,6
2020-03-23-170303,170303,7,0,2,36,15.428571428571427,1032.987749253796,0
2020-03-24-170303,170303,9,0,6,45,14.571428571428573,1090.398265161739,1
2020-03-25-170303,170303,15,0,2,60,12.857142857142858,1190.802809742388,2
2020-03-26-170303,170303,8,0,2,68,10.428571428571429,1231.2057551788089,3
2020-03-27-170303,170303,3,0,0,71,13.285714285714285,1431.4578225514706,4
2020-03-28-170303,170303,2,0,1,73,5.0,1471.5284364587678,5
2020-03-29-170303,170303,2,0,0,75,3.4285714285714284,1455.5576173869465,6
2020-03-30-170303,170303,4,0,4,79,12.0,1111.9724984054494,0
2020-03-31-170303,170303,6,0,1,85,9.428571428571429,1013.3124285626958,1
2020-04-01-170303,170303,3,0,0,88,8.428571428571429,190.7169564394046,2
2020-04-02-170303,170303,3,0,0,91,7.0,513.6532805818458,3
2020-04-03-170303,170303,2,0,2,93,7.857142857142858,290.8789706082126,4
2020-04-04-170303,170303,1,0,0,94,4.857142857142857,290.99889305156637,5
2020-04-05-170303,170303,0,0,0,94,1.4285714285714286,330.5219996908272,6
2020-04-06-170303,170303,2,0,0,96,9.571428571428571,334.13979347996315,0
2020-04-07-170303,170303,6,5,0,102,5.428571428571429,453.21039982968136,1
2020-04-08-170303,170303,2,0,3,104,11.0,527.7076660853891,2
2020-04-09-170303,170303,2,0,0,106,6.7142857142857135,600.8623896103995,3
2020-04-10-170303,170303,0,0,1,106,6.7142857142857135,139.86022047319153,4
2020-04-11-170303,170303,1,0,0,107,2.4285714285714284,256.9792366775341,5
2020-04-12-170303,170303,0,0,0,107,5.0,296.4337011802286,6
2020-04-13-170303,170303,4,0,0,111,5.428571428571429,338.64620595194646,0
2020-04-14-170303,170303,1,0,4,112,6.2857142857142865,466.19773197102893,1
2020-04-15-170303,170303,0,0,0,112,3.571428571428572,528.8802640788878,2
2020-04-16-170303,170303,0,0,0,112,5.285714285714286,568.1616012753766,3
2020-04-17-170303,170303,2,0,0,114,5.0,519.6281353677186,4
2020-04-18-170303,170303,0,0,0,114,1.0,508.34244848287005,5
2020-04-19-170303,170303,0,0,0,114,3.2857142857142856,486.7675191213292,6
2020-04-20-170303,170303,0,0,0,114,6.428571428571429,506.44013566431875,0
2020-04-21-170303,170303,0,0,2,114,11.285714285714285,511.59818123604555,1
2020-04-22-170303,170303,3,0,0,117,2.0,599.5773754534068,2
2020-04-23-170303,170303,0,0,0,117,1.0,581.3595221382469,3
2020-04-24-170303,170303,1,0,1,118,10.714285714285714,484.9428278433858,4
2020-04-25-170303,170303,0,0,0,118,1.0,630.3313301651092,5
2020-04-26-170303,170303,0,0,0,118,0.8571428571428571,566.3781418440244,6
2020-04-27-170303,170303,0,0,1,118,2.4285714285714284,459.266164786545,0
2020-04-28-170303,170303,4,6,1,122,1.8571428571428568,418.0404974095326,1
2020-04-29-170303,170303,0,0,0,122,2.4285714285714284,324.98582250414853,2
2020-04-30-170303,170303,0,0,0,122,2.0,440.7352674948288,3
2020-05-01-170303,170303,0,0,0,122,1.2857142857142858,572.5820576422573,4
2020-05-02-170303,170303,0,0,0,122,1.1428571428571428,185.13930721436736,5
2020-05-03-170303,170303,0,0,0,122,0.7142857142857143,213.62504449435892,6
2020-05-04-170303,170303,0,0,0,122,3.571428571428572,187.9062841385583,0
2020-05-05-170303,170303,2,0,0,124,2.571428571428572,197.58693108788918,1
2020-05-06-170303,170303,0,0,0,124,2.8571428571428568,208.3637830500154,2
2020-05-07-170303,170303,0,0,0,124,1.7142857142857142,199.35594006678502,3
2020-05-08-170303,170303,1,0,0,125,2.7142857142857144,192.79727562436472,4
2020-05-09-170303,170303,0,0,0,125,1.4285714285714286,225.02526142344382,5
2020-05-10-170303,170303,0,0,0,125,0.8571428571428571,619.9721827246677,6
2020-05-11-170303,170303,1,0,1,126,2.0,565.9943317797374,0
2020-05-12-170303,170303,1,1,1,127,2.142857142857143,595.3898932434602,1
2020-05-13-170303,170303,0,0,1,127,2.571428571428572,473.2373922842983,2
2020-05-14-170303,170303,0,0,2,127,1.8571428571428568,379.44119855634585,3
2020-05-15-170303,170303,0,0,1,127,3.2857142857142856,294.4080617416778,4
2020-05-16-170303,170303,0,0,0,127,0.42857142857142855,236.8981184737959,5
2020-05-17-170303,170303,0,0,0,127,0.5714285714285714,228.98815019399564,6
2020-05-18-170303,170303,0,0,4,127,2.4285714285714284,236.69591051952577,0
2020-05-19-170303,170303,0,0,0,127,2.571428571428572,236.94508989684266,1
2020-05-20-170303,170303,0,0,0,127,1.8571428571428568,190.77626946892826,2
2020-05-21-170303,170303,0,0,0,127,1.2857142857142858,206.78496452872542,3
2020-05-22-170303,170303,0,0,1,127,1.8571428571428568,191.50250522384079,4
2020-05-23-170303,170303,0,0,0,127,0.5714285714285714,212.94025699719606,5
2020-05-24-170303,170303,0,0,0,127,0.14285714285714285,210.3994915138763,6
2020-05-25-170303,170303,1,0,0,128,1.1428571428571428,167.89213945349644,0
2020-05-26-170303,170303,1,0,0,129,1.4285714285714286,175.67575718592906,1
2020-05-27-170303,170303,1,0,1,130,2.2857142857142856,200.38328875286012,2
2020-05-28-170303,170303,2,1,0,132,2.8571428571428568,213.36016248601248,3
2020-05-29-170303,170303,1,0,1,133,2.7142857142857144,247.3632691252493,4
2020-05-30-170303,170303,0,0,0,133,0.14285714285714285,282.73702761117744,5
2020-05-31-170303,170303,0,0,0,133,0.0,291.4039117362686,6
2020-06-01-170303,170303,4,0,0,137,1.1428571428571428,288.6815409764892,0
2020-06-02-170303,170303,0,0,0,137,2.142857142857143,100.96335718477926,1
2020-06-03-170303,170303,0,0,0,137,2.142857142857143,81.50731071604851,2
2020-06-04-170303,170303,0,0,0,137,2.0,104.54578428181881,3
2020-06-05-170303,170303,1,1,0,138,1.7142857142857142,127.96842039679196,4
2020-06-06-170303,170303,0,0,0,138,0.14285714285714285,160.3621899581055,5
2020-06-07-170303,170303,0,0,0,138,0.2857142857142857,166.6959471144947,6
2020-06-08-170303,170303,0,0,0,138,1.2857142857142858,172.6229543647141,0
2020-06-09-170303,170303,0,0,0,138,2.7142857142857144,185.0780036455373,1
2020-06-10-170303,170303,1,0,0,139,1.2857142857142858,351.59636576651985,2
2020-06-11-170303,170303,0,0,0,139,1.5714285714285714,335.8664702291156,3
2020-06-12-170303,170303,1,0,0,140,1.7142857142857142,289.76508155930634,4
2020-06-13-170303,170303,0,0,0,140,0.14285714285714285,271.1746617926058,5
2020-06-14-170303,170303,0,0,0,140,0.0,216.59035830447,6
2020-06-15-170303,170303,0,0,0,140,1.4285714285714286,176.78185052945454,0
2020-06-16-170303,170303,0,0,0,140,1.5714285714285714,190.31432039064202,1
2020-06-17-170303,170303,0,0,0,140,0.7142857142857143,154.11549615222452,2
2020-06-18-170303,170303,0,0,0,140,0.5714285714285714,129.444319891609,3
2020-06-19-170303,170303,0,0,0,140,0.7142857142857143,117.30107084892116,4
2020-06-20-170303,170303,0,0,0,140,0.14285714285714285,139.8714501997951,5
2020-06-21-170303,170303,0,0,0,140,0.0,144.35167749834616,6
2020-06-22-170303,170303,0,0,0,140,0.8571428571428571,116.45352607897475,0
2020-06-23-170303,170303,0,0,0,140,1.2857142857142858,107.02531123751865,1
2020-06-24-170303,170303,0,0,0,140,1.0,117.8785348829006,2
2020-06-25-170303,170303,0,0,0,140,1.4285714285714286,122.83350266390279,3
2020-06-26-170303,170303,0,0,0,140,0.5714285714285714,123.9975556140548,4
2020-06-27-170303,170303,0,0,0,140,0.14285714285714285,94.57213015408884,5
2020-06-28-170303,170303,0,0,0,140,0.14285714285714285,94.00424079328738,6
2020-06-29-170303,170303,0,0,0,140,0.8571428571428571,92.77201238056209,0
2020-06-30-170303,170303,0,0,0,140,1.1428571428571428,109.66194038015104,1
2020-07-01-170303,170303,0,0,0,140,0.14285714285714285,198.522702107388,2
2020-07-02-170303,170303,0,0,0,140,0.8571428571428571,66.16079864492876,3
2020-07-03-170303,170303,0,0,0,140,0.7142857142857143,65.1930701354106,4
2020-07-04-170303,170303,0,0,0,140,0.14285714285714285,79.37903525510579,5
2020-07-05-170303,170303,0,0,0,140,0.14285714285714285,79.76729861586352,6
2020-07-06-170303,170303,0,0,0,140,0.14285714285714285,76.14951627687708,0
2020-07-07-170303,170303,0,0,0,140,0.42857142857142855,68.53385346054331,1
2020-07-08-170303,170303,0,0,0,140,0.5714285714285714,60.13362563993516,2
2020-07-09-170303,170303,0,0,0,140,0.5714285714285714,53.9551702834979,3
2020-07-10-170303,170303,0,0,0,140,0.2857142857142857,187.76986971191837,4
2020-07-11-170303,170303,0,0,0,140,0.0,146.27902679077386,5
2020-07-12-170303,170303,0,0,0,140,0.14285714285714285,99.47692635693988,6
2020-07-13-170303,170303,0,0,0,140,0.8571428571428571,91.26050925594927,0
2020-07-14-170303,170303,0,0,0,140,0.2857142857142857,103.5887951922102,1
2020-07-15-170303,170303,0,0,0,140,0.8571428571428571,83.45079650219898,2
2020-07-16-170303,170303,0,0,0,140,0.7142857142857143,51.791385646837895,3
2020-07-17-170303,170303,0,1,0,140,0.2857142857142857,58.25390019271455,4
2020-07-18-170303,170303,0,0,0,140,0.42857142857142855,59.432210109130146,5
2020-07-19-170303,170303,0,0,0,140,0.2857142857142857,67.61034286534465,6
2020-07-20-170303,170303,0,0,0,140,0.8571428571428571,62.042397471268245,0
2020-07-21-170303,170303,0,0,1,140,0.2857142857142857,68.80089274271658,1
2020-07-22-170303,170303,0,0,1,140,1.0,67.33260197871978,2
2020-07-23-170303,170303,0,0,0,140,1.0,74.27820571671433,3
2020-07-24-170303,170303,0,0,0,140,0.8571428571428571,81.8874984933682,4
2020-07-25-170303,170303,0,0,0,140,0.42857142857142855,81.12665555733471,5
2020-07-26-170303,170303,0,0,0,140,0.14285714285714285,84.20874732209606,6
2020-07-27-170303,170303,0,0,0,140,0.2857142857142857,75.77339807195389,0
2020-07-28-170303,170303,0,0,0,140,1.0,64.26269371056681,1
2020-07-29-170303,170303,0,0,0,140,0.7142857142857143,75.03068974509824,2
2020-07-30-170303,170303,0,0,0,140,1.4285714285714286,69.12835980904794,3
2020-07-31-170303,170303,0,0,0,140,0.5714285714285714,83.25291834177757,4
2020-08-01-170303,170303,0,0,0,140,0.14285714285714285,44.05239250825889,5
2020-08-02-170303,170303,0,0,0,140,0.42857142857142855,141.79641568439007,6
2020-08-03-170303,170303,0,0,0,140,1.0,378.93523701442473,0
2020-08-04-170303,170303,1,0,0,141,1.4285714285714286,428.279129597291,1
2020-08-05-170303,170303,1,0,0,142,1.7142857142857142,346.6752546261061,2
2020-08-06-170303,170303,0,0,0,142,2.142857142857143,331.70320721743906,3
2020-08-07-170303,170303,0,0,0,142,2.2857142857142856,262.12371126230516,4
2020-08-08-170303,170303,0,0,0,142,0.42857142857142855,290.45637641564053,5
2020-08-09-170303,170303,0,0,0,142,0.0,272.744291551831,6
2020-08-10-170303,170303,0,0,0,142,1.0,46.86401018896941,0
2020-08-11-170303,170303,0,0,0,142,0.42857142857142855,76.44834815398674,1
2020-08-12-170303,170303,0,0,7,142,1.4285714285714286,82.4945098961777,2
2020-08-13-170303,170303,0,0,1,142,0.8571428571428571,93.01735794354926,3
2020-08-14-170303,170303,0,0,4,142,0.2857142857142857,106.19995330860077,4
2020-08-15-170303,170303,0,0,1,142,1.1428571428571428,115.54979285316821,5
2020-08-16-170303,170303,0,0,0,142,0.7142857142857143,121.36610302407134,6
2020-08-17-170303,170303,0,0,0,142,0.5714285714285714,124.47045671320927,0
2020-08-18-170303,170303,0,0,2,142,2.0,104.63009512034006,1
2020-08-19-170303,170303,0,0,0,142,1.5714285714285714,127.0280316415663,2
2020-08-20-170303,170303,0,0,4,142,2.2857142857142856,138.37064847290443,3
2020-08-21-170303,170303,0,0,2,142,1.4285714285714286,148.79598658504977,4
2020-08-22-170303,170303,0,0,0,142,1.0,156.25379306258003,5
2020-08-23-170303,170303,0,0,0,142,0.7142857142857143,159.07129772022802,6
2020-08-24-170303,170303,0,0,0,142,1.4285714285714286,152.9594012223246,0
2020-08-25-170303,170303,0,0,0,142,2.2857142857142856,148.4298631920763,1
2020-08-26-170303,170303,7,0,2,149,1.1428571428571428,144.56133074281166,2
2020-08-27-170303,170303,1,0,0,150,3.1428571428571432,261.0917435102376,3
2020-08-28-170303,170303,4,0,2,154,1.7142857142857142,297.556055595379,4
2020-08-29-170303,170303,1,0,0,155,1.0,367.55024952191775,5
2020-08-30-170303,170303,0,0,0,155,4.0,403.0275659006523,6
2020-08-31-170303,170303,0,0,0,155,2.571428571428572,415.2464871709476,0
2020-09-01-170303,170303,2,0,2,157,2.0,219.1465491930819,1
2020-09-02-170303,170303,0,0,0,157,1.7142857142857142,354.26243504272185,2
2020-09-03-170303,170303,4,0,0,161,2.571428571428572,374.4728183802272,3
2020-09-04-170303,170303,2,0,0,163,1.8571428571428568,458.8731375320277,4
2020-09-05-170303,170303,0,0,0,163,1.5714285714285714,439.75029598738035,5
2020-09-06-170303,170303,0,0,1,163,1.8571428571428568,407.69909052506125,6
2020-09-07-170303,170303,0,0,1,163,2.2857142857142856,405.55559682305,0
2020-09-08-170303,170303,0,0,0,163,1.2857142857142858,339.60842290127886,1
2020-09-09-170303,170303,2,0,0,165,5.0,306.3037880065019,2
2020-09-10-170303,170303,0,0,0,165,1.4285714285714286,249.19268934525692,3
2020-09-11-170303,170303,2,0,0,167,1.7142857142857142,238.74248403953828,4
2020-09-12-170303,170303,0,0,0,167,0.5714285714285714,264.1279846497091,5
2020-09-13-170303,170303,0,0,0,167,2.4285714285714284,257.1767124035922,6
2020-09-14-170303,170303,0,0,1,167,1.4285714285714286,239.87086841456696,0
2020-09-15-170303,170303,2,0,0,169,4.142857142857143,271.8398398506441,1
2020-09-16-170303,170303,0,0,2,169,3.1428571428571432,346.34627724331585,2
2020-09-17-170303,170303,0,0,1,169,5.142857142857143,305.52502660742954,3
2020-09-18-170303,170303,0,0,1,169,3.0,329.28504345226185,4
2020-09-19-170303,170303,0,0,2,169,1.8571428571428568,315.9835425065763,5
2020-09-20-170303,170303,1,0,0,170,1.4285714285714286,328.88106126651667,6
2020-09-21-170303,170303,1,0,1,171,4.142857142857143,314.52399876166726,0
2020-09-22-170303,170303,0,0,1,171,4.428571428571429,307.27818620666926,1
2020-09-23-170303,170303,0,1,0,171,4.285714285714286,354.26827049900345,2
2020-09-24-170303,170303,0,0,0,171,1.2857142857142858,348.62995079438673,3
2020-09-25-170303,170303,0,1,3,171,4.0,323.2611515370334,4
2020-09-26-170303,170303,0,0,0,171,1.5714285714285714,347.89524952464285,5
2020-09-27-170303,170303,0,0,1,171,1.5714285714285714,338.9664297427728,6
2020-09-28-170303,170303,1,0,0,172,3.8571428571428568,334.73790569944174,0
2020-09-29-170303,170303,0,0,1,172,4.285714285714286,348.56935524677135,1
2020-09-30-170303,170303,2,0,1,174,2.7142857142857144,359.10504135043817,2
2020-10-01-170303,170303,1,0,3,175,8.142857142857142,0.0,3
2020-10-02-170303,170303,1,0,2,176,6.7142857142857135,630.3892253504596,4
2020-10-03-170303,170303,2,0,1,178,2.142857142857143,812.8422262315706,5
2020-10-04-170303,170303,0,0,2,178,1.2857142857142858,888.6359776894676,6
2020-10-05-170303,170303,1,1,1,179,5.285714285714286,799.3291893332829,0
2020-10-06-170303,170303,1,0,5,180,3.2857142857142856,763.5274996187404,1
2020-10-07-170303,170303,0,0,2,180,4.571428571428571,696.2523893310963,2
2020-10-08-170303,170303,0,0,3,180,6.428571428571429,540.8854591056596,3
2020-10-09-170303,170303,3,1,2,183,5.0,586.7023721417345,4
2020-10-10-170303,170303,0,0,1,183,2.142857142857143,87.24886905022205,5
2020-10-11-170303,170303,1,0,1,184,2.571428571428572,129.45017548501343,6
2020-10-12-170303,170303,0,0,1,184,1.7142857142857142,178.55032166679823,0
2020-10-13-170303,170303,1,0,2,185,5.571428571428571,211.7783067107137,1
2020-10-14-170303,170303,1,0,1,186,6.7142857142857135,314.1136774943415,2
2020-10-15-170303,170303,3,0,8,189,5.857142857142858,428.7592088948722,3
2020-10-16-170303,170303,2,0,3,191,5.285714285714286,503.7909950815649,4
2020-10-17-170303,170303,1,0,3,192,3.571428571428572,517.1424549209016,5
2020-10-18-170303,170303,2,0,0,194,2.571428571428572,555.5855883828468,6
2020-10-19-170303,170303,1,0,0,195,5.142857142857143,574.1770330058696,0
2020-10-20-170303,170303,5,0,3,200,4.285714285714286,618.8252399978134,1
2020-10-21-170303,170303,2,0,1,202,6.7142857142857135,597.4587637534847,2
2020-10-22-170303,170303,3,0,0,205,6.857142857142858,651.6037103163005,3
2020-10-23-170303,170303,2,0,0,207,8.285714285714286,663.9502892790654,4
2020-10-24-170303,170303,1,0,2,208,4.714285714285714,717.3391727662031,5
2020-10-25-170303,170303,1,0,0,209,1.4285714285714286,717.1391766314906,6
2020-10-26-170303,170303,1,0,1,210,6.2857142857142865,649.515527834625,0
2020-10-27-170303,170303,2,1,1,212,6.428571428571429,675.9719954937317,1
2020-10-28-170303,170303,1,0,3,213,7.2857142857142865,680.1642040638712,2
2020-10-29-170303,170303,8,0,2,221,14.285714285714285,677.6395273799766,3
2020-10-30-170303,170303,3,0,1,224,8.857142857142858,724.7384505615532,4
2020-10-31-170303,170303,3,0,0,227,5.428571428571429,780.1807979722389,5
2020-11-01-170303,170303,0,0,0,227,4.142857142857143,569.9024538729033,6
2020-11-02-170303,170303,0,0,0,227,5.428571428571429,491.4313184656466,0
2020-11-03-170303,170303,3,1,0,230,7.428571428571429,487.4065265452761,1
2020-11-04-170303,170303,1,0,0,231,6.7142857142857135,619.5062781303991,2
2020-11-05-170303,170303,0,0,0,231,11.571428571428573,706.6017416346116,3
2020-11-06-170303,170303,0,0,0,231,9.285714285714286,762.8333388436961,4
2020-11-07-170303,170303,2,1,0,233,5.7142857142857135,756.9764952434944,5
2020-11-08-170303,170303,0,0,0,233,3.2857142857142856,765.769546565052,6
2020-11-09-170303,170303,1,0,0,234,6.571428571428571,713.8751125730864,0
2020-11-10-170303,170303,1,0,0,235,5.285714285714286,473.12889530869273,1
2020-11-11-170303,170303,3,1,0,238,8.142857142857142,525.4685776876881,2
2020-11-12-170303,170303,2,0,0,240,5.7142857142857135,617.6697367317006,3
2020-11-13-170303,170303,1,2,0,241,9.142857142857142,660.738404767495,4
2020-03-01-170304,170304,0,0,0,0,0.0,0.0,6
2020-03-02-170304,170304,0,0,0,0,0.0,10.188844003068365,0
2020-03-03-170304,170304,0,0,5,0,0.0,45.38091257286126,1
2020-03-04-170304,170304,0,0,1,0,0.0,55.731772111640254,2
2020-03-05-170304,170304,0,0,1,0,0.0,62.16888670320219,3
2020-03-06-170304,170304,0,1,0,0,0.0,59.89189950755973,4
2020-03-07-170304,170304,0,0,1,0,0.0,64.5516737509181,5
2020-03-08-170304,170304,0,0,2,0,0.0,48.23590073473306,6
2020-03-09-170304,170304,0,0,0,0,0.0,49.200094343242576,0
2020-03-10-170304,170304,0,0,3,0,0.0,117.25035537606638,1
2020-03-11-170304,170304,0,0,0,0,0.0,91.51758539547015,2
2020-03-12-170304,170304,0,0,0,0,0.0,68.1026096445804,3
2020-03-13-170304,170304,0,0,1,0,0.3333333333333333,44.63423135752089,4
2020-03-14-170304,170304,1,0,0,1,0.3333333333333333,26.092980713437896,5
2020-03-15-170304,170304,0,0,2,1,0.6666666666666666,25.100513894360553,6
2020-03-16-170304,170304,0,0,1,1,2.6666666666666665,8.789812611088834,0
2020-03-17-170304,170304,5,2,1,6,2.0,17.154929986961193,1
2020-03-18-170304,170304,1,0,1,7,1.0,40.93492855296597,2
2020-03-19-170304,170304,1,0,0,8,4.333333333333333,50.44486202313053,3
2020-03-20-170304,170304,0,0,2,8,3.0,62.0094391720452,4
2020-03-21-170304,170304,1,0,0,9,1.0,59.8716195047127,5
2020-03-22-170304,170304,2,0,0,11,1.6666666666666667,58.0577685590791,6
2020-03-23-170304,170304,0,0,3,11,4.0,60.563807760706126,0
2020-03-24-170304,170304,3,0,1,14,3.333333333333333,55.313944073755216,1
2020-03-25-170304,170304,0,0,1,14,3.6666666666666665,66.17264810979886,2
2020-03-26-170304,170304,0,0,0,14,4.0,67.68531846207638,3
2020-03-27-170304,170304,1,0,2,15,3.0,80.69922211324165,4
2020-03-28-170304,170304,0,0,1,15,2.0,88.31954577155594,5
2020-03-29-170304,170304,2,0,0,17,5.666666666666668,88.7512013267363,6
2020-03-30-170304,170304,1,0,1,18,4.333333333333333,80.45926638698377,0
2020-03-31-170304,170304,1,0,0,19,3.6666666666666665,73.91868456302448,1
2020-04-01-170304,170304,1,0,0,20,2.333333333333333,10.390392998742943,2
2020-04-02-170304,170304,0,0,0,20,3.6666666666666665,21.066901528499898,3
2020-04-03-170304,170304,2,0,1,22,1.0,14.563744160514025,4
2020-04-04-170304,170304,0,0,0,22,1.3333333333333333,16.77741133102774,5
2020-04-05-170304,170304,0,0,0,22,0.0,20.501071448642737,6
2020-04-06-170304,170304,3,5,1,25,1.0,20.90394884672447,0
2020-04-07-170304,170304,1,3,0,26,0.6666666666666666,29.7248390658922,1
2020-04-08-170304,170304,1,0,0,27,1.6666666666666667,34.874995162185954,2
2020-04-09-170304,170304,0,0,0,27,4.333333333333333,43.5522546776288,3
2020-04-10-170304,170304,2,0,0,29,1.0,8.109683937887848,4
2020-04-11-170304,170304,1,0,0,30,0.6666666666666666,12.654552566699948,5
2020-04-12-170304,170304,0,0,0,30,0.0,16.433593295297594,6
2020-04-13-170304,170304,1,0,0,31,0.6666666666666666,17.82658682045234,0
2020-04-14-170304,170304,0,0,0,31,0.6666666666666666,24.599171791319186,1
2020-04-15-170304,170304,0,0,0,31,0.6666666666666666,27.44349861527333,2
2020-04-16-170304,170304,0,0,0,31,0.6666666666666666,29.762039031938016,3
2020-04-17-170304,170304,1,0,1,32,1.3333333333333333,25.85106514636121,4
2020-04-18-170304,170304,0,0,0,32,0.0,27.224314181715542,5
2020-04-19-170304,170304,0,0,0,32,0.3333333333333333,23.691521474553262,6
2020-04-20-170304,170304,1,1,0,33,1.0,23.699194881898645,0
2020-04-21-170304,170304,0,0,1,33,1.0,27.234445177607697,1
2020-04-22-170304,170304,0,0,1,33,1.6666666666666667,30.07876582220169,2
2020-04-23-170304,170304,0,0,0,33,0.0,31.38395336087042,3
2020-04-24-170304,170304,0,0,0,33,2.6666666666666665,26.842467334190204,4
2020-04-25-170304,170304,0,0,0,33,0.0,33.05046464653154,5
2020-04-26-170304,170304,0,0,0,33,0.0,33.46766720605621,6
2020-04-27-170304,170304,0,0,0,33,1.6666666666666667,25.670714893999246,0
2020-04-28-170304,170304,0,0,2,33,1.3333333333333333,21.74421318109286,1
2020-04-29-170304,170304,0,0,1,33,0.3333333333333333,19.19938464896773,2
2020-04-30-170304,170304,0,0,0,33,0.3333333333333333,24.133576227850213,3
2020-05-01-170304,170304,1,0,0,34,0.3333333333333333,47.148965402278165,4
2020-05-02-170304,170304,0,1,0,34,0.0,14.96172866135588,5
2020-05-03-170304,170304,0,0,0,34,0.3333333333333333,16.107531204084356,6
2020-05-04-170304,170304,0,0,0,34,2.333333333333333,14.789576141213356,0
2020-05-05-170304,170304,1,0,0,35,0.6666666666666666,19.090594195056582,1
2020-05-06-170304,170304,1,0,0,36,0.3333333333333333,20.837616436857807,2
2020-05-07-170304,170304,0,0,0,36,0.6666666666666666,23.830949385146383,3
2020-05-08-170304,170304,0,0,1,36,1.3333333333333333,21.176175949328133,4
2020-05-09-170304,170304,0,0,0,36,0.6666666666666666,25.44371255416084,5
2020-05-10-170304,170304,0,1,0,36,0.3333333333333333,60.56048850703556,6
2020-05-11-170304,170304,0,0,1,36,0.6666666666666666,55.231271550354734,0
2020-05-12-170304,170304,2,0,0,38,0.6666666666666666,55.80350624472658,1
2020-05-13-170304,170304,1,0,1,39,0.3333333333333333,47.25965512379575,2
2020-05-14-170304,170304,0,16,0,39,1.6666666666666667,42.67999983117541,3
2020-05-15-170304,170304,0,0,1,39,0.6666666666666666,33.58375948166756,4
2020-05-16-170304,170304,0,0,0,39,0.3333333333333333,27.88782817567737,5
2020-05-17-170304,170304,0,0,0,39,0.0,23.809302441087404,6
2020-05-18-170304,170304,0,0,0,39,2.0,24.04803007797551,0
2020-05-19-170304,170304,0,0,0,39,0.3333333333333333,25.555777633627613,1
2020-05-20-170304,170304,0,0,0,39,0.6666666666666666,16.95882271031268,2
2020-05-21-170304,170304,0,0,0,39,1.0,15.527148130737569,3
2020-05-22-170304,170304,1,0,0,40,2.0,14.417560252510707,4
2020-05-23-170304,170304,0,1,0,40,0.0,21.851430767994398,5
2020-05-24-170304,170304,0,0,0,40,0.0,22.081183602862367,6
2020-05-25-170304,170304,1,0,0,41,0.6666666666666666,19.13348016288765,0
2020-05-26-170304,170304,0,0,0,41,0.3333333333333333,21.126875807983115,1
2020-05-27-170304,170304,1,0,0,42,0.3333333333333333,22.130320732791734,2
2020-05-28-170304,170304,0,1,0,42,0.3333333333333333,26.55808643973099,3
2020-05-29-170304,170304,1,1,0,43,1.0,27.24836348724792,4
2020-05-30-170304,170304,0,1,0,43,0.3333333333333333,28.76740990486045,5
2020-05-31-170304,170304,0,0,0,43,0.0,29.493586916317376,6
2020-06-01-170304,170304,0,0,1,43,0.6666666666666666,40.13579726252359,0
2020-06-02-170304,170304,0,0,0,43,1.0,16.109569713455713,1
2020-06-03-170304,170304,0,0,0,43,0.3333333333333333,8.96678043055644,2
2020-06-04-170304,170304,0,0,0,43,1.3333333333333333,11.134296072381645,3
2020-06-05-170304,170304,0,0,0,43,0.6666666666666666,15.204341854687296,4
2020-06-06-170304,170304,0,0,0,43,0.0,17.220182844340123,5
2020-06-07-170304,170304,0,0,0,43,0.0,17.342911510982123,6
2020-06-08-170304,170304,0,0,0,43,1.0,17.87600615381038,0
2020-06-09-170304,170304,0,0,0,43,0.6666666666666666,20.174944610954128,1
2020-06-10-170304,170304,0,0,0,43,0.0,44.327081633306264,2
2020-06-11-170304,170304,0,0,0,43,0.3333333333333333,38.73391019019559,3
2020-06-12-170304,170304,0,0,0,43,0.0,32.70282519440727,4
2020-06-13-170304,170304,0,0,0,43,0.0,26.386835588435837,5
2020-06-14-170304,170304,0,0,0,43,0.0,22.14981151431778,6
2020-06-15-170304,170304,1,0,0,44,0.0,16.19813508562615,0
2020-06-16-170304,170304,0,1,0,44,1.6666666666666667,17.53567425861599,1
2020-06-17-170304,170304,0,0,0,44,0.6666666666666666,19.00179033210705,2
2020-06-18-170304,170304,0,0,0,44,0.0,18.990528636751378,3
2020-06-19-170304,170304,0,0,0,44,0.3333333333333333,16.26129271560529,4
2020-06-20-170304,170304,0,1,0,44,0.0,20.911610532174077,5
2020-06-21-170304,170304,0,0,0,44,0.3333333333333333,22.27852543636324,6
2020-06-22-170304,170304,0,0,0,44,0.0,17.341091326117493,0
2020-06-23-170304,170304,0,0,0,44,0.0,12.580145159799915,1
2020-06-24-170304,170304,0,0,0,44,0.0,12.328165838611644,2
2020-06-25-170304,170304,0,0,0,44,0.0,13.187688904881963,3
2020-06-26-170304,170304,0,0,0,44,0.0,13.130075834691691,4
2020-06-27-170304,170304,0,0,0,44,0.0,8.948043299611992,5
2020-06-28-170304,170304,0,0,0,44,0.0,8.719274478050624,6
2020-06-29-170304,170304,0,0,2,44,0.6666666666666666,8.656580215647784,0
2020-06-30-170304,170304,0,0,0,44,0.0,13.250002158346808,1
2020-07-01-170304,170304,0,0,0,44,0.0,24.98658064574262,2
2020-07-02-170304,170304,0,0,0,44,0.0,26.266839330481634,3
2020-07-03-170304,170304,0,0,1,44,0.3333333333333333,12.575568675193525,4
2020-07-04-170304,170304,0,0,1,44,0.0,21.31372679373898,5
2020-07-05-170304,170304,0,0,0,44,0.0,21.769084336089215,6
2020-07-06-170304,170304,0,0,1,44,0.0,21.219403838199693,0
2020-07-07-170304,170304,0,0,0,44,0.0,19.99970742775481,1
2020-07-08-170304,170304,0,0,1,44,0.3333333333333333,15.95274103084699,2
2020-07-09-170304,170304,0,0,0,44,0.3333333333333333,15.436995340342088,3
2020-07-10-170304,170304,0,0,0,44,0.0,25.422425232929754,4
2020-07-11-170304,170304,0,0,0,44,0.0,18.64881782525946,5
2020-07-12-170304,170304,0,0,0,44,0.0,15.155027938774115,6
2020-07-13-170304,170304,2,0,0,46,0.3333333333333333,15.277808655918003,0
2020-07-14-170304,170304,0,0,0,46,0.6666666666666666,25.863603840993193,1
2020-07-15-170304,170304,0,0,1,46,0.3333333333333333,21.670805391586356,2
2020-07-16-170304,170304,0,0,2,46,0.0,17.65671796685006,3
2020-07-17-170304,170304,1,0,0,47,0.0,19.13625913806687,4
2020-07-18-170304,170304,1,0,2,48,0.3333333333333333,23.43259382112265,5
2020-07-19-170304,170304,0,0,1,48,0.0,30.43395419099833,6
2020-07-20-170304,170304,1,0,1,49,0.0,19.479991078721323,0
2020-07-21-170304,170304,0,0,0,49,0.0,23.72394832982628,1
2020-07-22-170304,170304,1,0,0,50,0.0,22.959247248664102,2
2020-07-23-170304,170304,0,0,0,50,0.3333333333333333,26.87896944722329,3
2020-07-24-170304,170304,0,0,0,50,0.6666666666666666,24.086455739180206,4
2020-07-25-170304,170304,0,0,1,50,0.0,19.041939707564183,5
2020-07-26-170304,170304,0,0,0,50,0.0,19.32921309529962,6
2020-07-27-170304,170304,0,0,0,50,0.0,18.692340077852798,0
2020-07-28-170304,170304,0,0,1,50,0.3333333333333333,12.890717659545494,1
2020-07-29-170304,170304,1,0,0,51,0.3333333333333333,14.241359197611532,2
2020-07-30-170304,170304,2,0,0,53,0.0,14.093622760696913,3
2020-07-31-170304,170304,0,0,1,53,0.0,23.510636394594712,4
2020-08-01-170304,170304,2,0,0,55,0.0,8.067824043437174,5
2020-08-02-170304,170304,1,0,2,56,0.3333333333333333,46.91694296874465,6
2020-08-03-170304,170304,1,0,0,57,0.0,77.99280789236694,0
2020-08-04-170304,170304,0,0,0,57,0.3333333333333333,76.43524364430287,1
2020-08-05-170304,170304,0,0,2,57,0.3333333333333333,69.96828331791946,2
2020-08-06-170304,170304,0,0,0,57,0.0,64.89364269254358,3
2020-08-07-170304,170304,0,0,0,57,0.3333333333333333,45.11858515371492,4
2020-08-08-170304,170304,1,0,0,58,0.3333333333333333,40.71693567807709,5
2020-08-09-170304,170304,0,0,0,58,0.0,41.69311029423024,6
2020-08-10-170304,170304,0,0,1,58,1.0,16.14545680656174,0
2020-08-11-170304,170304,1,0,0,59,0.6666666666666666,21.24051023813012,1
2020-08-12-170304,170304,0,0,0,59,1.0,23.56637464225787,2
2020-08-13-170304,170304,0,0,0,59,0.6666666666666666,27.696906622929752,3
2020-08-14-170304,170304,1,0,4,60,0.0,30.608112187369116,4
2020-08-15-170304,170304,0,0,0,60,0.3333333333333333,34.04451859989156,5
2020-08-16-170304,170304,2,0,0,62,0.6666666666666666,33.53523109355628,6
2020-08-17-170304,170304,0,0,0,62,0.3333333333333333,36.78480156491597,0
2020-08-18-170304,170304,0,0,1,62,1.3333333333333333,32.3459885774551,1
2020-08-19-170304,170304,2,0,0,64,0.0,41.49487766687264,2
2020-08-20-170304,170304,0,0,0,64,0.6666666666666666,52.87814159820461,3
2020-08-21-170304,170304,0,0,0,64,0.3333333333333333,53.25423034374269,4
2020-08-22-170304,170304,0,0,0,64,0.3333333333333333,52.991180866585026,5
2020-08-23-170304,170304,0,0,0,64,0.0,43.178511411391256,6
2020-08-24-170304,170304,1,0,0,65,0.3333333333333333,42.53259434666481,0
2020-08-25-170304,170304,0,0,1,65,1.3333333333333333,41.29124739604242,1
2020-08-26-170304,170304,0,0,0,65,2.6666666666666665,41.92084648337301,2
2020-08-27-170304,170304,0,0,0,65,3.333333333333333,47.94812923195449,3
2020-08-28-170304,170304,4,0,0,69,0.0,52.39239673150797,4
2020-08-29-170304,170304,0,0,0,69,0.6666666666666666,70.48555807075014,5
2020-08-30-170304,170304,0,0,1,69,1.6666666666666667,76.88052939413372,6
2020-08-31-170304,170304,0,0,2,69,0.6666666666666666,73.5200688363206,0
2020-09-01-170304,170304,1,0,1,70,0.6666666666666666,28.560082979293668,1
2020-09-02-170304,170304,0,0,0,70,1.3333333333333333,75.85589619308138,2
2020-09-03-170304,170304,0,0,0,70,0.3333333333333333,100.05350697909455,3
2020-09-04-170304,170304,0,0,1,70,1.0,95.86120546620964,4
2020-09-05-170304,170304,0,0,0,70,0.6666666666666666,80.59325534071948,5
2020-09-06-170304,170304,0,0,0,70,1.0,76.70240093568646,6
2020-09-07-170304,170304,0,0,0,70,1.0,68.57227344963741,0
2020-09-08-170304,170304,1,0,0,71,0.3333333333333333,56.47959929357175,1
2020-09-09-170304,170304,0,0,0,71,2.0,54.21808234042866,2
2020-09-10-170304,170304,0,0,0,71,0.6666666666666666,33.074371304329226,3
2020-09-11-170304,170304,0,0,2,71,0.6666666666666666,35.44253085930714,4
2020-09-12-170304,170304,0,0,0,71,0.0,40.675134701499985,5
2020-09-13-170304,170304,1,0,2,72,1.3333333333333333,39.79173872571019,6
2020-09-14-170304,170304,2,0,2,74,0.0,50.96866056091942,0
2020-09-15-170304,170304,1,0,0,75,2.0,55.460005468868964,1
2020-09-16-170304,170304,0,0,0,75,2.0,66.57125024932725,2
2020-09-17-170304,170304,0,0,0,75,1.3333333333333333,61.20513429696028,3
2020-09-18-170304,170304,1,0,1,76,0.3333333333333333,68.82844209635618,4
2020-09-19-170304,170304,0,0,1,76,0.0,68.37365327059291,5
2020-09-20-170304,170304,0,0,0,76,1.3333333333333333,60.555636611361976,6
2020-09-21-170304,170304,0,0,0,76,1.0,52.19682078712246,0
2020-09-22-170304,170304,0,0,0,76,2.6666666666666665,49.31321766394015,1
2020-09-23-170304,170304,0,0,0,76,1.3333333333333333,55.99907326302709,2
2020-09-24-170304,170304,0,0,1,76,4.666666666666667,52.336670676336006,3
2020-09-25-170304,170304,2,0,0,78,7.333333333333332,51.58889841820819,4
2020-09-26-170304,170304,0,0,0,78,1.3333333333333333,66.18633105785996,5
2020-09-27-170304,170304,2,0,0,80,3.333333333333333,66.95591760282888,6
2020-09-28-170304,170304,2,0,0,82,2.0,78.28089967219545,0
2020-09-29-170304,170304,0,0,0,82,1.0,89.74307973024472,1
2020-09-30-170304,170304,0,0,0,82,0.3333333333333333,82.02309760773413,2
2020-10-01-170304,170304,0,0,0,82,3.6666666666666665,0.0,3
2020-10-02-170304,170304,1,0,1,83,1.6666666666666667,89.8969218398154,4
2020-10-03-170304,170304,1,0,0,84,1.6666666666666667,127.87995185204886,5
2020-10-04-170304,170304,0,0,0,84,1.0,135.62568521533086,6
2020-10-05-170304,170304,0,0,0,84,0.3333333333333333,120.25586011882109,0
2020-10-06-170304,170304,0,0,0,84,1.3333333333333333,106.95442616655266,1
2020-10-07-170304,170304,0,0,0,84,0.6666666666666666,89.95514565677095,2
2020-10-08-170304,170304,1,0,0,85,1.6666666666666667,64.68545367363129,3
2020-10-09-170304,170304,0,0,1,85,3.333333333333333,65.50681159172551,4
2020-10-10-170304,170304,0,0,0,85,2.333333333333333,17.387130393377646,5
2020-10-11-170304,170304,0,0,0,85,1.0,23.47622393279083,6
2020-10-12-170304,170304,0,0,0,85,3.0,29.778690709828187,0
2020-10-13-170304,170304,0,0,1,85,2.0,43.36052270873995,1
2020-10-14-170304,170304,0,0,0,85,2.0,54.03817057005726,2
2020-10-15-170304,170304,0,0,0,85,0.3333333333333333,66.98890646930501,3
2020-10-16-170304,170304,1,0,0,86,6.0,74.24898608551212,4
2020-10-17-170304,170304,0,0,0,86,4.333333333333333,73.7816968400039,5
2020-10-18-170304,170304,0,0,1,86,1.0,80.22728303352453,6
2020-10-19-170304,170304,0,0,0,86,6.666666666666668,79.58327114888033,0
2020-10-20-170304,170304,0,0,1,86,5.0,90.75412886582399,1
2020-10-21-170304,170304,0,0,2,86,5.666666666666668,92.3731219751364,2
2020-10-22-170304,170304,0,0,1,86,6.333333333333332,99.53923599861133,3
2020-10-23-170304,170304,1,0,1,87,2.333333333333333,97.31743207214278,4
2020-10-24-170304,170304,0,0,0,87,4.0,103.25218738043282,5
2020-10-25-170304,170304,0,0,0,87,2.0,102.65590167323893,6
2020-10-26-170304,170304,0,0,0,87,6.0,87.38136158817255,0
2020-10-27-170304,170304,1,0,0,88,4.0,89.44817806272795,1
2020-10-28-170304,170304,0,0,2,88,4.0,92.99338856687291,2
2020-10-29-170304,170304,0,0,0,88,5.333333333333333,99.38187708809713,3
2020-10-30-170304,170304,0,0,0,88,8.666666666666666,108.531775852598,4
2020-10-31-170304,170304,0,0,0,88,1.3333333333333333,123.43155459598276,5
2020-11-01-170304,170304,1,0,0,89,2.6666666666666665,52.25945409723784,6
2020-11-02-170304,170304,0,0,0,89,0.3333333333333333,77.07503344521828,0
2020-11-03-170304,170304,1,0,0,90,7.333333333333332,64.50644141844005,1
2020-11-04-170304,170304,2,0,0,92,5.0,86.33749128359847,2
2020-11-05-170304,170304,1,0,0,93,7.666666666666668,98.28621309084815,3
2020-11-06-170304,170304,1,0,0,94,4.333333333333333,107.01116340482241,4
2020-11-07-170304,170304,0,0,0,94,3.333333333333333,113.2042009657075,5
2020-11-08-170304,170304,0,0,0,94,1.3333333333333333,117.45304133822275,6
2020-11-09-170304,170304,0,0,0,94,8.333333333333334,113.61076324180536,0
2020-11-10-170304,170304,0,0,0,94,4.333333333333333,51.53663511662131,1
2020-11-11-170304,170304,2,0,0,96,4.666666666666667,61.52517183354728,2
2020-11-12-170304,170304,0,0,0,96,4.666666666666667,77.05477769041751,3
2020-11-13-170304,170304,0,0,0,96,7.0,82.00783498944438,4
2020-03-01-170305,170305,0,0,1,0,0.0,0.0,6
2020-03-02-170305,170305,0,0,4,0,0.0,15.05309925329075,0
2020-03-03-170305,170305,0,0,1,0,0.0,46.52716209429019,1
2020-03-04-170305,170305,0,0,0,0,0.0,42.216658683520336,2
2020-03-05-170305,170305,0,0,1,0,0.0,43.51531799506581,3
2020-03-06-170305,170305,0,0,2,0,0.0,36.24320759302629,4
2020-03-07-170305,170305,0,0,1,0,0.0,37.751658934445544,5
2020-03-08-170305,170305,0,0,1,0,0.0,40.726100523237236,6
2020-03-09-170305,170305,0,0,3,0,0.0,41.677997992956875,0
2020-03-10-170305,170305,0,0,3,0,0.0,181.0102115722707,1
2020-03-11-170305,170305,0,0,3,0,0.0,168.20316203343316,2
2020-03-12-170305,170305,0,0,2,0,0.0,135.96707791442714,3
2020-03-13-170305,170305,0,0,1,0,0.0,112.22586576487194,4
2020-03-14-170305,170305,0,0,1,0,1.0,109.64257436495413,5
2020-03-15-170305,170305,1,0,1,1,1.3333333333333333,68.85830461017906,6
2020-03-16-170305,170305,4,0,2,5,7.166666666666668,10.117566765004725,0
2020-03-17-170305,170305,1,0,1,6,7.5,33.748431191713884,1
2020-03-18-170305,170305,0,0,0,6,8.833333333333334,50.02793967610473,2
2020-03-19-170305,170305,1,0,2,7,10.0,57.757327282491865,3
2020-03-20-170305,170305,2,0,1,9,9.166666666666666,74.76820554842276,4
2020-03-21-170305,170305,1,0,0,10,1.3333333333333333,83.60919383299766,5
2020-03-22-170305,170305,1,0,1,11,2.0,73.79423768474882,6
2020-03-23-170305,170305,3,0,1,14,14.333333333333336,65.29030318862614,0
2020-03-24-170305,170305,3,0,1,17,9.833333333333334,73.19269576931555,1
2020-03-25-170305,170305,3,0,0,20,11.833333333333336,77.61491307242636,2
2020-03-26-170305,170305,2,0,1,22,12.0,74.08313222156232,3
2020-03-27-170305,170305,1,0,0,23,11.333333333333336,81.92799566784171,4
2020-03-28-170305,170305,1,0,1,24,0.8333333333333334,80.33675483703382,5
2020-03-29-170305,170305,1,0,2,25,0.3333333333333333,80.17832856995493,6
2020-03-30-170305,170305,2,0,2,27,13.666666666666664,55.60577682468933,0
2020-03-31-170305,170305,1,0,0,28,6.333333333333332,49.91994152423187,1
2020-04-01-170305,170305,0,0,3,28,6.833333333333332,7.18320951922288,2
2020-04-02-170305,170305,2,0,1,30,4.666666666666667,25.84536419340772,3
2020-04-03-170305,170305,1,0,0,31,6.666666666666668,17.73003043215075,4
2020-04-04-170305,170305,0,0,1,31,1.0,17.06539607688255,5
2020-04-05-170305,170305,1,0,1,32,1.3333333333333333,17.17948308289821,6
2020-04-06-170305,170305,1,1,0,33,10.833333333333336,17.144910585336255,0
2020-04-07-170305,170305,1,0,3,34,5.833333333333332,19.339086927366896,1
2020-04-08-170305,170305,0,0,0,34,4.666666666666667,20.1645216864922,2
2020-04-09-170305,170305,1,0,0,35,5.333333333333333,25.400192664399157,3
2020-04-10-170305,170305,0,0,3,35,4.333333333333333,6.29958261109862,4
2020-04-11-170305,170305,1,0,0,36,0.6666666666666666,11.09816476130861,5
2020-04-12-170305,170305,2,0,0,38,0.6666666666666666,13.113193456648869,6
2020-04-13-170305,170305,2,0,0,40,5.333333333333333,15.530843441399014,0
2020-04-14-170305,170305,0,0,1,40,5.666666666666668,22.665604764322257,1
2020-04-15-170305,170305,3,1,0,43,3.6666666666666665,28.123013348304447,2
2020-04-16-170305,170305,1,0,2,44,4.666666666666667,34.16419866721114,3
2020-04-17-170305,170305,0,0,0,44,5.166666666666667,34.40610115693514,4
2020-04-18-170305,170305,1,0,0,45,0.16666666666666666,34.390490132550894,5
2020-04-19-170305,170305,1,0,0,46,1.0,32.948750311410194,6
2020-04-20-170305,170305,0,0,0,46,8.5,30.105000001357638,0
2020-04-21-170305,170305,3,0,1,49,2.333333333333333,29.24871003392833,1
2020-04-22-170305,170305,0,0,0,49,8.0,30.215058423203033,2
2020-04-23-170305,170305,0,0,0,49,1.6666666666666667,29.044064844093636,3
2020-04-24-170305,170305,3,0,2,52,13.333333333333336,24.711819185748478,4
2020-04-25-170305,170305,0,0,0,52,0.3333333333333333,31.718157220875113,5
2020-04-26-170305,170305,0,0,1,52,0.6666666666666666,30.906568641519986,6
2020-04-27-170305,170305,0,0,0,52,3.8333333333333335,25.808065037984086,0
2020-04-28-170305,170305,1,1,1,53,1.8333333333333333,23.80776272214124,1
2020-04-29-170305,170305,0,0,0,53,3.1666666666666665,22.16784434234001,2
2020-04-30-170305,170305,2,0,0,55,3.333333333333333,24.862408727750207,3
2020-05-01-170305,170305,0,0,0,55,0.3333333333333333,32.95957393560779,4
2020-05-02-170305,170305,0,0,0,55,0.5,16.63568796733607,5
2020-05-03-170305,170305,0,0,0,55,0.3333333333333333,19.30257358888516,6
2020-05-04-170305,170305,0,0,0,55,3.0,12.580540007443215,0
2020-05-05-170305,170305,1,0,0,56,3.0,12.444114615473532,1
2020-05-06-170305,170305,0,0,0,56,2.6666666666666665,18.597154743634533,2
2020-05-07-170305,170305,0,0,0,56,2.5,20.821036139564292,3
2020-05-08-170305,170305,2,0,0,58,3.1666666666666665,20.921987690909912,4
2020-05-09-170305,170305,0,0,0,58,0.6666666666666666,30.998334855638625,5
2020-05-10-170305,170305,1,0,1,59,0.3333333333333333,36.17610164989872,6
2020-05-11-170305,170305,0,0,2,59,1.6666666666666667,37.24015703311357,0
2020-05-12-170305,170305,1,0,1,60,1.6666666666666667,35.78541771421128,1
2020-05-13-170305,170305,0,0,0,60,3.333333333333333,31.178906159534385,2
2020-05-14-170305,170305,0,0,0,60,4.166666666666667,30.647461502571968,3
2020-05-15-170305,170305,0,0,1,60,1.8333333333333333,24.480012890267005,4
2020-05-16-170305,170305,0,0,0,60,1.1666666666666667,20.692946392754287,5
2020-05-17-170305,170305,0,0,0,60,0.0,20.997831283181185,6
2020-05-18-170305,170305,0,0,0,60,1.8333333333333333,19.40299586634185,0
2020-05-19-170305,170305,0,0,0,60,2.333333333333333,22.206522712903013,1
2020-05-20-170305,170305,0,0,0,60,2.0,16.569452538472625,2
2020-05-21-170305,170305,0,0,3,60,3.1666666666666665,12.059357117530148,3
2020-05-22-170305,170305,0,0,0,60,4.5,13.50877551794421,4
2020-05-23-170305,170305,0,0,0,60,0.6666666666666666,15.26207868319549,5
2020-05-24-170305,170305,1,0,0,61,0.16666666666666666,17.019531297093547,6
2020-05-25-170305,170305,2,0,0,63,2.333333333333333,13.683705194307414,0
2020-05-26-170305,170305,1,0,0,64,2.333333333333333,20.273588317032015,1
2020-05-27-170305,170305,0,0,0,64,1.3333333333333333,26.825659732993657,2
2020-05-28-170305,170305,0,0,1,64,2.833333333333333,28.34601003452638,3
2020-05-29-170305,170305,1,0,0,65,3.333333333333333,27.391297824779212,4
2020-05-30-170305,170305,0,0,0,65,0.5,28.538585888955453,5
2020-05-31-170305,170305,0,0,1,65,0.16666666666666666,30.840576764613694,6
2020-06-01-170305,170305,0,0,0,65,2.333333333333333,46.064639077194045,0
2020-06-02-170305,170305,0,0,0,65,1.8333333333333333,10.00293034761094,1
2020-06-03-170305,170305,0,0,0,65,3.5,6.469807347126183,2
2020-06-04-170305,170305,3,0,0,68,1.5,7.690100549645406,3
2020-06-05-170305,170305,0,0,0,68,3.5,14.511620460866189,4
2020-06-06-170305,170305,0,0,0,68,0.0,18.423062688386885,5
2020-06-07-170305,170305,0,0,0,68,0.0,18.31455325832733,6
2020-06-08-170305,170305,0,0,1,68,3.5,18.688826103610456,0
2020-06-09-170305,170305,0,0,0,68,3.1666666666666665,20.83493164130988,1
2020-06-10-170305,170305,0,0,0,68,2.0,50.59997178272592,2
2020-06-11-170305,170305,1,0,0,69,2.1666666666666665,46.486642261052985,3
2020-06-12-170305,170305,0,0,1,69,1.1666666666666667,40.63380847450078,4
2020-06-13-170305,170305,0,0,0,69,0.5,36.41641127298279,5
2020-06-14-170305,170305,1,0,0,70,0.16666666666666666,30.8920674715485,6
2020-06-15-170305,170305,0,0,0,70,1.1666666666666667,21.10432104325863,0
2020-06-16-170305,170305,0,0,0,70,0.8333333333333334,20.090088255930397,1
2020-06-17-170305,170305,0,1,0,70,0.5,17.15114326713372,2
2020-06-18-170305,170305,0,0,0,70,0.8333333333333334,14.797876375156093,3
2020-06-19-170305,170305,0,0,0,70,1.0,10.823763493008338,4
2020-06-20-170305,170305,0,0,0,70,0.0,13.836146868354469,5
2020-06-21-170305,170305,0,0,0,70,0.0,12.552742605413172,6
2020-06-22-170305,170305,1,0,0,71,0.3333333333333333,12.596689241373985,0
2020-06-23-170305,170305,0,0,0,71,0.6666666666666666,13.784445420925326,1
2020-06-24-170305,170305,0,1,0,71,0.0,15.2782536018497,2
2020-06-25-170305,170305,0,1,0,71,0.3333333333333333,14.665856799536193,3
2020-06-26-170305,170305,1,0,1,72,0.5,14.11078821879235,4
2020-06-27-170305,170305,0,0,0,72,0.0,11.746153432150958,5
2020-06-28-170305,170305,0,0,0,72,0.0,11.939803046772932,6
2020-06-29-170305,170305,0,0,1,72,0.3333333333333333,11.111961315092096,0
2020-06-30-170305,170305,0,0,1,72,0.3333333333333333,10.379434822499462,1
2020-07-01-170305,170305,0,0,1,72,0.16666666666666666,29.455405790962182,2
2020-07-02-170305,170305,0,0,1,72,0.16666666666666666,21.528044603435347,3
2020-07-03-170305,170305,0,0,0,72,0.5,21.361087365735415,4
2020-07-04-170305,170305,0,0,1,72,0.0,13.622112590060942,5
2020-07-05-170305,170305,0,0,1,72,0.16666666666666666,13.294593472969172,6
2020-07-06-170305,170305,0,0,0,72,0.5,12.680232008099766,0
2020-07-07-170305,170305,0,0,2,72,1.1666666666666667,10.810253673503354,1
2020-07-08-170305,170305,0,0,0,72,0.3333333333333333,10.690361450039966,2
2020-07-09-170305,170305,0,0,4,72,0.5,10.232107189639581,3
2020-07-10-170305,170305,1,0,0,73,0.3333333333333333,31.090173775618283,4
2020-07-11-170305,170305,0,0,0,73,0.0,22.144292946232866,5
2020-07-12-170305,170305,0,0,0,73,0.16666666666666666,14.068829746680473,6
2020-07-13-170305,170305,1,0,1,74,0.8333333333333334,14.028390754582519,0
2020-07-14-170305,170305,1,0,0,75,0.3333333333333333,17.78552462300548,1
2020-07-15-170305,170305,1,0,1,76,0.3333333333333333,15.015158578224028,2
2020-07-16-170305,170305,1,0,0,77,0.16666666666666666,12.276349941702756,3
2020-07-17-170305,170305,0,0,0,77,0.8333333333333334,16.436928276014324,4
2020-07-18-170305,170305,1,0,0,78,0.3333333333333333,18.15673599015746,5
2020-07-19-170305,170305,1,0,0,79,0.3333333333333333,21.41297356951558,6
2020-07-20-170305,170305,0,0,0,79,0.5,21.894559380742724,0
2020-07-21-170305,170305,2,0,0,81,0.5,19.941637932161143,1
2020-07-22-170305,170305,0,0,1,81,0.5,23.516483784858565,2
2020-07-23-170305,170305,4,0,0,85,0.16666666666666666,20.411932250919165,3
2020-07-24-170305,170305,0,0,0,85,1.1666666666666667,26.874654059997525,4
2020-07-25-170305,170305,0,1,0,85,0.0,27.769995646399856,5
2020-07-26-170305,170305,0,0,0,85,0.5,25.367239477960815,6
2020-07-27-170305,170305,1,0,1,86,0.6666666666666666,24.816823237429652,0
2020-07-28-170305,170305,0,0,1,86,0.3333333333333333,24.606802597249334,1
2020-07-29-170305,170305,1,0,0,87,0.0,21.20421320994025,2
2020-07-30-170305,170305,0,0,0,87,0.8333333333333334,15.92338944261932,3
2020-07-31-170305,170305,0,0,1,87,0.6666666666666666,15.040859888127665,4
2020-08-01-170305,170305,0,0,0,87,0.0,8.195700652654928,5
2020-08-02-170305,170305,0,0,0,87,0.0,52.76547730074692,6
2020-08-03-170305,170305,0,0,1,87,1.5,110.45778030738907,0
2020-08-04-170305,170305,0,0,0,87,1.1666666666666667,100.35711415934705,1
2020-08-05-170305,170305,1,0,1,88,1.1666666666666667,73.09128449054428,2
2020-08-06-170305,170305,0,0,0,88,0.6666666666666666,49.92959461338529,3
2020-08-07-170305,170305,0,0,0,88,0.8333333333333334,45.925651961105004,4
2020-08-08-170305,170305,0,0,0,88,0.16666666666666666,41.40579261191384,5
2020-08-09-170305,170305,0,0,0,88,0.0,37.779611601263284,6
2020-08-10-170305,170305,1,0,0,89,0.8333333333333334,7.8589708148146205,0
2020-08-11-170305,170305,1,0,1,90,1.0,15.199876003053337,1
2020-08-12-170305,170305,0,0,5,90,1.3333333333333333,18.03716381279201,2
2020-08-13-170305,170305,0,0,0,90,1.0,18.759519748652703,3
2020-08-14-170305,170305,1,0,0,91,1.0,18.91554704431031,4
2020-08-15-170305,170305,0,0,0,91,1.0,21.141207234787643,5
2020-08-16-170305,170305,0,0,0,91,0.3333333333333333,28.51302292424718,6
2020-08-17-170305,170305,1,0,3,92,1.8333333333333333,31.18906099839256,0
2020-08-18-170305,170305,0,0,0,92,0.8333333333333334,34.184057215043964,1
2020-08-19-170305,170305,1,0,0,93,4.0,34.85946582655154,2
2020-08-20-170305,170305,0,0,0,93,0.8333333333333334,49.36152610038643,3
2020-08-21-170305,170305,0,0,1,93,4.0,54.86237351903094,4
2020-08-22-170305,170305,0,0,1,93,1.1666666666666667,64.22257421781748,5
2020-08-23-170305,170305,0,0,0,93,1.5,65.90180003368687,6
2020-08-24-170305,170305,0,0,0,93,1.8333333333333333,60.530496591898746,0
2020-08-25-170305,170305,1,0,1,94,4.0,70.83915529922598,1
2020-08-26-170305,170305,5,0,2,99,1.3333333333333333,68.10984622477062,2
2020-08-27-170305,170305,0,0,0,99,3.0,97.54672622353742,3
2020-08-28-170305,170305,0,0,0,99,2.0,115.68320944369273,4
2020-08-29-170305,170305,0,0,0,99,2.833333333333333,102.38194693889253,5
2020-08-30-170305,170305,0,0,0,99,1.6666666666666667,98.73612731610876,6
2020-08-31-170305,170305,3,0,4,102,2.833333333333333,89.29863760603345,0
2020-09-01-170305,170305,0,0,3,102,2.1666666666666665,27.4721949983301,1
2020-09-02-170305,170305,0,0,0,102,1.5,146.96721761293531,2
2020-09-03-170305,170305,0,0,2,102,2.5,110.5216455098647,3
2020-09-04-170305,170305,1,0,2,103,3.8333333333333335,86.67982115720581,4
2020-09-05-170305,170305,1,0,0,104,3.0,76.68330248346922,5
2020-09-06-170305,170305,0,0,0,104,0.6666666666666666,86.51978552330597,6
2020-09-07-170305,170305,0,0,1,104,5.833333333333332,84.70001961180321,0
2020-09-08-170305,170305,1,0,0,105,5.666666666666668,75.17567895182148,1
2020-09-09-170305,170305,2,0,0,107,5.0,75.2967889684094,2
2020-09-10-170305,170305,0,0,0,107,5.666666666666668,16.56854470725599,3
2020-09-11-170305,170305,0,0,0,107,6.666666666666668,31.08585890322918,4
2020-09-12-170305,170305,0,0,0,107,2.333333333333333,46.63404422902667,5
2020-09-13-170305,170305,0,0,0,107,4.166666666666667,49.11170535754103,6
2020-09-14-170305,170305,4,0,0,111,8.666666666666666,51.89381298661109,0
2020-09-15-170305,170305,3,0,1,114,4.833333333333333,93.20769739625666,1
2020-09-16-170305,170305,0,0,0,114,8.833333333333334,118.38459275492707,2
2020-09-17-170305,170305,2,0,0,116,7.666666666666668,130.88007830832004,3
2020-09-18-170305,170305,2,0,1,118,8.0,132.46492264865515,4
2020-09-19-170305,170305,0,0,0,118,1.1666666666666667,127.07368338779688,5
2020-09-20-170305,170305,0,0,3,118,2.0,122.80349723199308,6
2020-09-21-170305,170305,1,0,0,119,11.666666666666664,89.33248291176062,0
2020-09-22-170305,170305,0,1,0,119,7.0,81.42289691810946,1
2020-09-23-170305,170305,0,0,3,119,7.333333333333332,76.68070203894548,2
2020-09-24-170305,170305,0,1,0,119,7.0,71.8796720057659,3
2020-09-25-170305,170305,0,0,4,119,6.0,78.72559194304219,4
2020-09-26-170305,170305,0,0,3,119,1.6666666666666667,93.89284694952124,5
2020-09-27-170305,170305,0,0,0,119,1.0,91.87164804526267,6
2020-09-28-170305,170305,0,0,0,119,9.666666666666666,90.55714495220104,0
2020-09-29-170305,170305,1,0,0,120,4.5,90.5822195785108,1
2020-09-30-170305,170305,0,0,2,120,7.0,83.61113535074281,2
2020-10-01-170305,170305,0,0,2,120,9.666666666666666,0.0,3
2020-10-02-170305,170305,1,0,3,121,12.333333333333336,157.94198357022202,4
2020-10-03-170305,170305,0,0,8,121,3.0,152.62156087744745,5
2020-10-04-170305,170305,3,1,0,124,2.6666666666666665,161.0084171634984,6
2020-10-05-170305,170305,0,1,1,124,3.0,137.204443387673,0
2020-10-06-170305,170305,0,0,3,124,9.666666666666666,134.52989013143002,1
2020-10-07-170305,170305,3,0,0,127,8.666666666666666,134.487306702416,2
2020-10-08-170305,170305,0,0,5,127,8.0,127.76528237753581,3
2020-10-09-170305,170305,4,0,2,131,17.5,146.90631086162674,4
2020-10-10-170305,170305,3,0,2,134,2.1666666666666665,21.138653112213227,5
2020-10-11-170305,170305,0,0,0,134,1.8333333333333333,36.51504380401054,6
2020-10-12-170305,170305,0,0,0,134,1.0,44.1727881047655,0
2020-10-13-170305,170305,0,0,1,134,14.666666666666664,49.601990945385324,1
2020-10-14-170305,170305,2,0,0,136,9.833333333333334,72.21801927968211,2
2020-10-15-170305,170305,2,0,2,138,11.166666666666664,93.98942768534168,3
2020-10-16-170305,170305,3,0,5,141,7.666666666666668,110.32427287800796,4
2020-10-17-170305,170305,8,0,0,149,1.3333333333333333,115.13768518054033,5
2020-10-18-170305,170305,0,0,1,149,2.333333333333333,119.49721959015729,6
2020-10-19-170305,170305,1,0,0,150,17.0,118.80376990015961,0
2020-10-20-170305,170305,3,0,0,153,9.0,132.14574114909698,1
2020-10-21-170305,170305,0,0,1,153,11.166666666666664,131.2772074699756,2
2020-10-22-170305,170305,5,0,0,158,18.83333333333333,129.93103333074055,3
2020-10-23-170305,170305,2,0,2,160,11.166666666666664,154.08461280265794,4
2020-10-24-170305,170305,2,0,0,162,2.6666666666666665,155.7079723389403,5
2020-10-25-170305,170305,0,0,15,162,2.333333333333333,162.5914064423677,6
2020-10-26-170305,170305,0,0,9,162,13.833333333333336,140.34441865574203,0
2020-10-27-170305,170305,1,0,4,163,4.833333333333333,156.178234445756,1
2020-10-28-170305,170305,0,1,3,163,17.166666666666668,149.89026378255153,2
2020-10-29-170305,170305,2,0,2,165,13.833333333333336,155.21976256958308,3
2020-10-30-170305,170305,5,0,18,170,14.333333333333336,119.67349751086562,4
2020-10-31-170305,170305,0,0,0,170,2.0,141.14425592263046,5
2020-11-01-170305,170305,1,0,0,171,3.0,120.85592856468381,6
2020-11-02-170305,170305,0,0,0,171,0.8333333333333334,165.84721799417605,0
2020-11-03-170305,170305,0,0,0,171,15.166666666666664,120.05032482961592,1
2020-11-04-170305,170305,1,0,0,172,6.0,150.8203593501691,2
2020-11-05-170305,170305,0,0,0,172,12.333333333333336,136.80017621903963,3
2020-11-06-170305,170305,2,0,0,174,9.666666666666666,136.26373272794888,4
2020-11-07-170305,170305,0,1,0,174,0.6666666666666666,138.13951886527929,5
2020-11-08-170305,170305,15,0,0,189,1.3333333333333333,123.06939862771358,6
2020-11-09-170305,170305,9,0,0,198,17.5,139.95711341524864,0
2020-11-10-170305,170305,4,1,0,202,18.166666666666668,121.61088397852605,1
2020-11-11-170305,170305,3,1,0,205,10.833333333333336,139.80620936708254,2
2020-11-12-170305,170305,2,0,0,207,10.833333333333336,149.4067713005962,3
2020-11-13-170305,170305,18,0,0,225,10.666666666666666,149.81692453054347,4
2020-03-01-170306,170306,0,0,4,0,0.0,0.0,6
2020-03-02-170306,170306,0,0,3,0,0.0,11.67854642641308,0
2020-03-03-170306,170306,0,0,2,0,0.0,46.08915774389953,1
2020-03-04-170306,170306,0,0,4,0,0.0,42.11864916472623,2
2020-03-05-170306,170306,0,0,8,0,0.0,45.3473303688788,3
2020-03-06-170306,170306,0,0,7,0,0.0,34.31195688410867,4
2020-03-07-170306,170306,0,0,2,0,0.0,35.278185335101064,5
2020-03-08-170306,170306,0,0,3,0,0.0,33.381855787236816,6
2020-03-09-170306,170306,0,0,10,0,0.2,33.747051375118,0
2020-03-10-170306,170306,0,0,3,0,0.0,151.03077182862796,1
2020-03-11-170306,170306,0,0,4,0,0.0,141.39369536192277,2
2020-03-12-170306,170306,0,0,4,0,0.2,120.57001213650331,3
2020-03-13-170306,170306,0,0,9,0,0.0,104.23112394256047,4
2020-03-14-170306,170306,0,0,1,0,0.2,100.57977973402082,5
2020-03-15-170306,170306,4,0,2,4,0.4,61.934512073465974,6
2020-03-16-170306,170306,3,0,1,7,1.6,13.773190044049684,0
2020-03-17-170306,170306,2,0,2,9,1.2,38.072763112618404,1
2020-03-18-170306,170306,4,0,5,13,1.2,53.737029233670654,2
2020-03-19-170306,170306,8,1,1,21,0.8,61.49529329784681,3
2020-03-20-170306,170306,7,0,0,28,1.6,75.76954521583302,4
2020-03-21-170306,170306,2,0,0,30,0.8,90.37025067166547,5
2020-03-22-170306,170306,3,0,1,33,0.4,83.00524129101115,6
2020-03-23-170306,170306,10,0,1,43,2.4,74.99230946590586,0
2020-03-24-170306,170306,3,0,1,46,1.6,83.44705836245927,1
2020-03-25-170306,170306,4,0,7,50,1.8,86.24549520311233,2
2020-03-26-170306,170306,4,0,0,54,1.0,84.34771241132638,3
2020-03-27-170306,170306,9,0,5,63,0.8,90.53683114933854,4
2020-03-28-170306,170306,1,0,2,64,0.2,90.94857855547673,5
2020-03-29-170306,170306,2,0,0,66,0.6,88.90485221657744,6
2020-03-30-170306,170306,1,0,3,67,0.8,62.73557723498412,0
2020-03-31-170306,170306,2,0,2,69,0.8,55.843432241913135,1
2020-04-01-170306,170306,5,0,2,74,0.6,7.0390296662566385,2
2020-04-02-170306,170306,1,0,0,75,0.8,30.963059265804986,3
2020-04-03-170306,170306,0,0,0,75,1.2,18.720963054708594,4
2020-04-04-170306,170306,0,0,0,75,0.2,19.952903744089504,5
2020-04-05-170306,170306,1,0,0,76,0.2,20.31135482026351,6
2020-04-06-170306,170306,1,0,2,77,0.8,19.842310752435317,0
2020-04-07-170306,170306,1,0,1,78,0.8,23.109596122355242,1
2020-04-08-170306,170306,7,0,0,85,0.8,24.627753690975698,2
2020-04-09-170306,170306,0,0,0,85,0.2,32.841063388002496,3
2020-04-10-170306,170306,5,1,2,90,0.6,8.838010063535787,4
2020-04-11-170306,170306,2,0,0,92,0.8,15.61421948894543,5
2020-04-12-170306,170306,0,1,2,92,0.8,18.26695860104988,6
2020-04-13-170306,170306,3,0,1,95,0.8,21.233927950730568,0
2020-04-14-170306,170306,2,0,2,97,0.8,29.853500857802942,1
2020-04-15-170306,170306,2,0,0,99,1.2,36.922308561872384,2
2020-04-16-170306,170306,0,0,1,99,1.0,43.896619737595145,3
2020-04-17-170306,170306,0,0,1,99,0.2,41.54047718290185,4
2020-04-18-170306,170306,0,0,0,99,0.4,41.10894558430532,5
2020-04-19-170306,170306,0,0,0,99,0.2,39.47562989677009,6
2020-04-20-170306,170306,2,0,0,101,0.4,33.06732200225124,0
2020-04-21-170306,170306,1,0,1,102,1.0,31.11968260171123,1
2020-04-22-170306,170306,0,0,0,102,0.4,32.09774594151346,2
2020-04-23-170306,170306,0,0,4,102,0.2,30.288944467717812,3
2020-04-24-170306,170306,2,0,0,104,1.4,25.07200896040183,4
2020-04-25-170306,170306,0,0,0,104,0.2,30.96320256965845,5
2020-04-26-170306,170306,2,0,1,106,0.2,30.73357807772713,6
2020-04-27-170306,170306,1,0,0,107,0.2,27.750154744813635,0
2020-04-28-170306,170306,2,0,0,109,1.6,23.804372752515754,1
2020-04-29-170306,170306,0,0,6,109,1.0,22.470205087631822,2
2020-04-30-170306,170306,1,0,5,110,0.8,27.336786914877557,3
2020-05-01-170306,170306,1,0,0,111,0.0,39.57231698816149,4
2020-05-02-170306,170306,0,0,1,111,0.2,22.73073130062652,5
2020-05-03-170306,170306,0,0,0,111,0.0,23.777559132075595,6
2020-05-04-170306,170306,0,0,1,111,0.6,15.137008570864047,0
2020-05-05-170306,170306,1,0,1,112,0.2,13.28602317824334,1
2020-05-06-170306,170306,0,0,0,112,0.8,17.828056978396262,2
2020-05-07-170306,170306,4,0,1,116,1.0,20.945596364958206,3
2020-05-08-170306,170306,0,0,1,116,0.8,24.91479081327049,4
2020-05-09-170306,170306,0,0,2,116,0.2,33.37285173483554,5
2020-05-10-170306,170306,1,2,0,117,0.4,45.75854815536555,6
2020-05-11-170306,170306,0,0,2,117,0.0,46.56342318525092,0
2020-05-12-170306,170306,0,0,3,117,0.6,41.81041268128295,1
2020-05-13-170306,170306,6,0,0,123,0.8,36.609861050212764,2
2020-05-14-170306,170306,5,0,0,128,0.2,39.76074940874243,3
2020-05-15-170306,170306,0,0,1,128,0.0,31.219795020490253,4
2020-05-16-170306,170306,1,0,0,129,0.2,28.137889447585998,5
2020-05-17-170306,170306,0,0,1,129,0.0,28.259015349150793,6
2020-05-18-170306,170306,1,0,0,130,0.4,25.750202367043272,0
2020-05-19-170306,170306,1,0,1,131,0.0,27.914639194147192,1
2020-05-20-170306,170306,0,0,0,131,0.6,18.827846801220062,2
2020-05-21-170306,170306,1,0,0,132,0.2,11.446490328812192,3
2020-05-22-170306,170306,1,0,0,133,0.2,13.409271703720178,4
2020-05-23-170306,170306,2,0,0,135,0.2,12.977712806955783,5
2020-05-24-170306,170306,0,0,0,135,0.2,16.501322009761836,6
2020-05-25-170306,170306,2,0,0,137,1.0,14.879756547065673,0
2020-05-26-170306,170306,3,0,1,140,0.6,21.597804261415803,1
2020-05-27-170306,170306,0,0,0,140,0.4,29.86072015621062,2
2020-05-28-170306,170306,0,0,1,140,0.2,32.061786138365804,3
2020-05-29-170306,170306,1,0,0,141,1.2,30.056083330458172,4
2020-05-30-170306,170306,0,0,1,141,0.0,30.17805991914315,5
2020-05-31-170306,170306,1,0,0,142,0.0,31.31841869773458,6
2020-06-01-170306,170306,0,0,0,142,0.4,43.45480851587438,0
2020-06-02-170306,170306,1,1,0,143,0.0,10.46862489496662,1
2020-06-03-170306,170306,0,0,0,143,0.2,7.002121171273566,2
2020-06-04-170306,170306,0,0,0,143,0.8,6.1617493690843075,3
2020-06-05-170306,170306,0,0,0,143,0.4,12.187026111007718,4
2020-06-06-170306,170306,0,0,0,143,0.0,15.337806503905124,5
2020-06-07-170306,170306,0,1,0,143,0.0,15.11870518695078,6
2020-06-08-170306,170306,0,0,1,143,0.2,15.121163114383219,0
2020-06-09-170306,170306,1,0,1,144,0.2,18.970156712456415,1
2020-06-10-170306,170306,0,0,0,144,0.8,46.19334254498647,2
2020-06-11-170306,170306,1,0,0,145,0.2,44.68461089068819,3
2020-06-12-170306,170306,0,0,0,145,0.4,40.35844856035143,4
2020-06-13-170306,170306,1,0,0,146,0.0,35.94714749672844,5
2020-06-14-170306,170306,0,0,0,146,0.2,27.273898444606054,6
2020-06-15-170306,170306,0,0,0,146,0.4,20.220320747582146,0
2020-06-16-170306,170306,0,2,0,146,0.2,20.10232236721766,1
2020-06-17-170306,170306,0,0,0,146,0.4,17.609458997116615,2
2020-06-18-170306,170306,0,0,1,146,0.8,14.57693560113275,3
2020-06-19-170306,170306,0,1,0,146,0.0,11.407748402849112,4
2020-06-20-170306,170306,0,0,0,146,0.0,13.260676933711848,5
2020-06-21-170306,170306,0,0,0,146,0.0,11.652291178142598,6
2020-06-22-170306,170306,1,0,0,147,0.4,10.761943014780995,0
2020-06-23-170306,170306,1,0,0,148,0.2,13.974535947049628,1
2020-06-24-170306,170306,0,0,0,148,0.0,15.94620685182434,2
2020-06-25-170306,170306,0,0,0,148,0.4,14.584653086017509,3
2020-06-26-170306,170306,0,0,0,148,0.2,14.617434695444096,4
2020-06-27-170306,170306,0,0,0,148,0.0,12.599949699082732,5
2020-06-28-170306,170306,0,0,0,148,0.0,12.819733407079926,6
2020-06-29-170306,170306,0,0,1,148,0.0,12.860689307366478,0
2020-06-30-170306,170306,0,0,0,148,0.4,7.57793826969469,1
2020-07-01-170306,170306,0,0,0,148,0.0,25.7769563913278,2
2020-07-02-170306,170306,1,0,0,149,0.2,20.57006960566313,3
2020-07-03-170306,170306,0,0,1,149,0.2,17.967333135150884,4
2020-07-04-170306,170306,0,0,0,149,0.0,11.250018894294524,5
2020-07-05-170306,170306,0,0,0,149,0.0,11.11754692222631,6
2020-07-06-170306,170306,0,0,0,149,0.2,10.389760471861434,0
2020-07-07-170306,170306,0,0,0,149,0.0,8.04314100430712,1
2020-07-08-170306,170306,0,0,0,149,0.0,10.40420966969937,2
2020-07-09-170306,170306,0,0,0,149,0.0,9.52487974416379,3
2020-07-10-170306,170306,0,0,1,149,0.4,26.123302699931944,4
2020-07-11-170306,170306,0,0,0,149,0.0,19.359976837007142,5
2020-07-12-170306,170306,0,0,0,149,0.0,13.480587025078632,6
2020-07-13-170306,170306,1,0,0,150,0.2,13.505899076465948,0
2020-07-14-170306,170306,0,0,1,150,0.2,16.486591508935927,1
2020-07-15-170306,170306,0,0,0,150,0.2,13.366162877026953,2
2020-07-16-170306,170306,0,0,1,150,0.2,10.86583308620844,3
2020-07-17-170306,170306,1,0,0,151,0.0,13.994251132030024,4
2020-07-18-170306,170306,0,0,0,151,0.6,16.227312149498033,5
2020-07-19-170306,170306,0,0,0,151,0.2,20.22549089784962,6
2020-07-20-170306,170306,0,0,1,151,0.0,22.852563341260364,0
2020-07-21-170306,170306,0,0,1,151,0.6,20.62036591095347,1
2020-07-22-170306,170306,0,0,1,151,0.0,25.26269909488675,2
2020-07-23-170306,170306,0,0,1,151,0.8,22.53844024453923,3
2020-07-24-170306,170306,1,0,2,152,0.0,26.390688279910194,4
2020-07-25-170306,170306,0,0,0,152,0.4,25.517819884990963,5
2020-07-26-170306,170306,0,0,0,152,0.0,23.148384982547707,6
2020-07-27-170306,170306,0,0,1,152,0.4,20.835682832621405,0
2020-07-28-170306,170306,1,0,1,153,0.4,21.152826209333053,1
2020-07-29-170306,170306,0,0,0,153,0.2,18.032735441255074,2
2020-07-30-170306,170306,1,0,2,154,0.0,14.111159681252545,3
2020-07-31-170306,170306,0,0,1,154,0.2,12.536788249606584,4
2020-08-01-170306,170306,0,0,6,154,0.0,9.178096638875267,5
2020-08-02-170306,170306,0,0,1,154,0.0,84.57427644555713,6
2020-08-03-170306,170306,1,0,3,155,0.2,112.35791329852893,0
2020-08-04-170306,170306,1,0,1,156,0.0,88.50743245821226,1
2020-08-05-170306,170306,1,1,12,157,0.2,66.06655027233197,2
2020-08-06-170306,170306,1,0,3,158,0.0,54.163300239853314,3
2020-08-07-170306,170306,2,0,3,160,0.0,51.36180742656679,4
2020-08-08-170306,170306,0,0,1,160,0.0,45.03616444275268,5
2020-08-09-170306,170306,0,0,2,160,0.0,40.33757154944107,6
2020-08-10-170306,170306,1,0,0,161,0.4,9.233876288973622,0
2020-08-11-170306,170306,1,0,3,162,0.2,16.502144159006157,1
2020-08-12-170306,170306,0,0,1,162,0.4,20.788281613628822,2
2020-08-13-170306,170306,2,0,1,164,0.0,22.00475775316627,3
2020-08-14-170306,170306,1,0,0,165,0.2,23.36847413863308,4
2020-08-15-170306,170306,6,0,0,171,0.0,26.685188721932093,5
2020-08-16-170306,170306,1,0,2,172,0.2,40.65395435664996,6
2020-08-17-170306,170306,3,0,0,175,0.6,45.061177747951376,0
2020-08-18-170306,170306,1,0,3,176,1.2,49.28564892450502,1
2020-08-19-170306,170306,12,0,0,188,1.4,50.046627695950846,2
2020-08-20-170306,170306,3,0,2,191,0.4,74.33990344009494,3
2020-08-21-170306,170306,3,0,1,194,5.0,82.4278437184382,4
2020-08-22-170306,170306,1,0,0,195,0.4,97.71611627679701,5
2020-08-23-170306,170306,2,0,1,197,1.0,97.32758955554124,6
2020-08-24-170306,170306,0,0,2,197,0.2,94.71741728452425,0
2020-08-25-170306,170306,3,0,0,200,1.6,111.2467575218746,1
2020-08-26-170306,170306,1,0,2,201,2.4,98.39889377842727,2
2020-08-27-170306,170306,1,0,3,202,1.8,125.25289605582162,3
2020-08-28-170306,170306,0,0,0,202,0.8,130.2115955181083,4
2020-08-29-170306,170306,0,0,1,202,1.4,104.59202730233821,5
2020-08-30-170306,170306,2,0,0,204,0.6,104.75934673264354,6
2020-08-31-170306,170306,0,0,19,204,1.4,90.05897533360806,0
2020-09-01-170306,170306,3,0,8,207,0.2,30.368028438713708,1
2020-09-02-170306,170306,0,0,2,207,0.6,162.4618600898441,2
2020-09-03-170306,170306,2,0,1,209,0.0,104.65055416048264,3
2020-09-04-170306,170306,1,0,0,210,1.2,87.32894829950492,4
2020-09-05-170306,170306,0,0,2,210,1.8,80.92130613007974,5
2020-09-06-170306,170306,1,0,5,211,0.8,93.52609777460985,6
2020-09-07-170306,170306,2,0,7,213,0.4,92.54492602785473,0
2020-09-08-170306,170306,0,0,0,213,1.2,80.19337393614292,1
2020-09-09-170306,170306,2,0,2,215,1.2,75.84320200052466,2
2020-09-10-170306,170306,3,0,3,218,2.2,18.905894816050175,3
2020-09-11-170306,170306,0,0,3,218,0.2,39.34321403954405,4
2020-09-12-170306,170306,1,0,0,219,0.6,52.98798975019643,5
2020-09-13-170306,170306,0,0,1,219,0.0,57.189754477289014,6
2020-09-14-170306,170306,19,0,3,238,2.2,56.66224090549274,0
2020-09-15-170306,170306,8,0,2,246,0.6,116.54996024239523,1
2020-09-16-170306,170306,2,0,4,248,1.6,145.65748272539366,2
2020-09-17-170306,170306,1,0,4,249,1.0,157.12207555291545,3
2020-09-18-170306,170306,0,0,4,249,1.2,146.4996036300557,4
2020-09-19-170306,170306,2,0,3,251,0.0,142.71710599514645,5
2020-09-20-170306,170306,5,1,1,256,0.4,139.5119563387329,6
2020-09-21-170306,170306,7,1,5,263,1.0,91.54245208764152,0
2020-09-22-170306,170306,0,2,3,263,1.4,85.6018408420548,1
2020-09-23-170306,170306,2,0,1,265,0.6,76.87922969069538,2
2020-09-24-170306,170306,3,0,5,268,0.0,72.9246929623215,3
2020-09-25-170306,170306,3,0,9,271,0.2,77.2208561028838,4
2020-09-26-170306,170306,0,0,4,271,1.8,89.68355707397924,5
2020-09-27-170306,170306,1,0,0,272,0.0,88.85924781039473,6
2020-09-28-170306,170306,3,0,2,275,1.6,84.35658225956504,0
2020-09-29-170306,170306,2,0,3,277,1.8,82.67253776702665,1
2020-09-30-170306,170306,4,0,1,281,1.6,78.453333639303,2
2020-10-01-170306,170306,4,0,1,285,1.8,0.0,3
2020-10-02-170306,170306,4,0,0,289,1.0,134.73142682308998,4
2020-10-03-170306,170306,3,0,1,292,0.8,135.95714062775022,5
2020-10-04-170306,170306,1,0,0,293,3.2,136.59083463126058,6
2020-10-05-170306,170306,5,0,0,298,1.6,125.59846314766116,0
2020-10-06-170306,170306,3,0,0,301,1.2,126.54473191656568,1
2020-10-07-170306,170306,1,1,0,302,1.6,129.1381270058513,2
2020-10-08-170306,170306,5,0,2,307,3.0,122.515144758357,3
2020-10-09-170306,170306,9,0,3,316,1.4,137.502379748625,4
2020-10-10-170306,170306,4,0,2,320,1.0,19.492410275512924,5
2020-10-11-170306,170306,0,0,0,320,0.4,35.39054224590616,6
2020-10-12-170306,170306,2,0,2,322,1.0,40.09101294486017,0
2020-10-13-170306,170306,3,0,1,325,1.2,47.307867776680936,1
2020-10-14-170306,170306,1,0,1,326,0.6,64.39648421546545,2
2020-10-15-170306,170306,1,0,2,327,1.8,85.1028249801121,3
2020-10-16-170306,170306,0,0,1,327,0.8,101.92385415331515,4
2020-10-17-170306,170306,1,0,1,328,2.2,102.49242941716862,5
2020-10-18-170306,170306,0,0,5,328,1.2,106.72295139196001,6
2020-10-19-170306,170306,0,0,0,328,2.8,108.88068839890386,0
2020-10-20-170306,170306,0,0,0,328,2.2,125.01991135266817,1
2020-10-21-170306,170306,0,0,1,328,0.6,121.09252669908722,2
2020-10-22-170306,170306,2,0,4,330,4.0,112.07187943302648,3
2020-10-23-170306,170306,3,0,0,333,1.4,126.2681707036794,4
2020-10-24-170306,170306,2,0,0,335,3.8,127.5016197899819,5
2020-10-25-170306,170306,0,0,0,335,0.6,134.06305454298337,6
2020-10-26-170306,170306,2,0,2,337,1.6,116.6483524791547,0
2020-10-27-170306,170306,1,0,5,338,1.4,124.23979073786016,1
2020-10-28-170306,170306,1,0,1,339,4.8,122.09918739712259,2
2020-10-29-170306,170306,2,0,3,341,2.8,129.2452300073077,3
2020-10-30-170306,170306,1,0,1,342,3.0,106.83855240953989,4
2020-10-31-170306,170306,1,1,0,343,0.6,123.63662471733045,5
2020-11-01-170306,170306,5,0,0,348,4.4,128.139997387893,6
2020-11-02-170306,170306,0,1,0,348,1.2,152.94357346246764,0
2020-11-03-170306,170306,0,0,0,348,3.8,109.87785695866134,1
2020-11-04-170306,170306,1,0,0,349,2.6,121.46958427208739,2
2020-11-05-170306,170306,4,0,0,353,1.2,119.4545358993662,3
2020-11-06-170306,170306,0,1,0,353,2.4,107.16221030773232,4
2020-11-07-170306,170306,0,1,0,353,1.6,103.96997002589458,5
2020-11-08-170306,170306,0,1,0,353,3.2,93.55605319142816,6
2020-11-09-170306,170306,2,0,0,355,3.4,110.76474852971413,0
2020-11-10-170306,170306,5,0,0,360,2.6,125.67800994825757,1
2020-11-11-170306,170306,1,0,0,361,3.0,142.98095483258845,2
2020-11-12-170306,170306,3,0,0,364,4.6,149.57816693272827,3
2020-11-13-170306,170306,1,0,0,365,3.8,154.69707000821631,4
2020-03-01-170307,170307,0,0,2,0,0.0,0.0,6
2020-03-02-170307,170307,0,0,5,0,0.0,34.05770060901622,0
2020-03-03-170307,170307,0,0,2,0,0.0,99.55687478616315,1
2020-03-04-170307,170307,0,1,3,0,0.0,108.76381431807016,2
2020-03-05-170307,170307,0,0,10,0,0.0,111.56504592344774,3
2020-03-06-170307,170307,0,0,8,0,0.0,107.49411552103405,4
2020-03-07-170307,170307,0,0,0,0,0.0,116.15320794609977,5
2020-03-08-170307,170307,0,0,2,0,0.0,127.71501390799783,6
2020-03-09-170307,170307,0,0,6,0,0.0,129.89054671918245,0
2020-03-10-170307,170307,0,0,3,0,0.0,550.7663105541474,1
2020-03-11-170307,170307,0,0,5,0,0.0,484.0116439895087,2
2020-03-12-170307,170307,0,0,3,0,0.0,354.10244189756435,3
2020-03-13-170307,170307,0,0,1,0,0.2,277.0621964971414,4
2020-03-14-170307,170307,0,0,2,0,1.0,260.68112048921694,5
2020-03-15-170307,170307,2,0,0,2,0.6,194.9367363340848,6
2020-03-16-170307,170307,5,0,4,7,4.6,19.768769203755266,0
2020-03-17-170307,170307,2,0,6,9,9.4,77.36028610113155,1
2020-03-18-170307,170307,3,1,3,12,8.4,113.92625053848676,2
2020-03-19-170307,170307,10,0,5,22,11.4,139.65215314100826,3
2020-03-20-170307,170307,8,0,1,30,7.6,192.61246145633072,4
2020-03-21-170307,170307,0,0,0,30,1.8,218.2941530070023,5
2020-03-22-170307,170307,2,0,0,32,2.4,196.63080874436832,6
2020-03-23-170307,170307,6,0,0,38,13.0,170.14988982568735,0
2020-03-24-170307,170307,3,0,1,41,10.2,187.5101872110862,1
2020-03-25-170307,170307,5,0,3,46,11.6,190.17715565951204,2
2020-03-26-170307,170307,3,0,2,49,13.2,170.99553794075933,3
2020-03-27-170307,170307,1,0,2,50,11.8,198.05000216547916,4
2020-03-28-170307,170307,2,0,1,52,0.8,177.23817147536994,5
2020-03-29-170307,170307,0,0,0,52,1.2,179.35943788423418,6
2020-03-30-170307,170307,4,0,1,56,13.8,124.29734444359924,0
2020-03-31-170307,170307,6,0,1,62,6.8,119.7185481630576,1
2020-04-01-170307,170307,3,0,1,65,7.6,26.531669411204415,2
2020-04-02-170307,170307,5,0,2,70,4.6,58.30809158766164,3
2020-04-03-170307,170307,1,0,1,71,6.4,53.60819405230501,4
2020-04-04-170307,170307,0,0,0,71,1.2,45.85921970232223,5
2020-04-05-170307,170307,0,0,1,71,1.4,46.73946640027015,6
2020-04-06-170307,170307,0,7,1,71,6.6,48.62433256849778,0
2020-04-07-170307,170307,1,3,3,72,6.8,46.276564961965924,1
2020-04-08-170307,170307,3,0,3,75,5.0,45.425803162642914,2
2020-04-09-170307,170307,2,0,0,77,7.0,57.444579486120105,3
2020-04-10-170307,170307,2,0,3,79,2.6,17.21247354399478,4
2020-04-11-170307,170307,1,0,0,80,0.8,27.079536968041026,5
2020-04-12-170307,170307,0,0,0,80,0.8,31.26946868313557,6
2020-04-13-170307,170307,1,0,3,81,8.2,33.609264671464736,0
2020-04-14-170307,170307,1,0,3,82,4.6,49.2944982463859,1
2020-04-15-170307,170307,1,0,1,83,3.8,61.99295250819457,2
2020-04-16-170307,170307,2,0,1,85,3.2,74.11956818269005,3
2020-04-17-170307,170307,1,0,0,86,5.0,69.86094672686025,4
2020-04-18-170307,170307,0,0,0,86,0.8,71.93533454402413,5
2020-04-19-170307,170307,1,0,0,87,0.8,68.56867428652974,6
2020-04-20-170307,170307,1,0,3,88,4.4,76.48465301825493,0
2020-04-21-170307,170307,3,0,1,91,2.6,75.72061430361711,1
2020-04-22-170307,170307,3,0,0,94,9.4,78.74397372226,2
2020-04-23-170307,170307,0,0,0,94,0.4,84.70836251039947,3
2020-04-24-170307,170307,3,0,2,97,13.0,70.56908942930527,4
2020-04-25-170307,170307,0,0,0,97,1.2,92.33763127740991,5
2020-04-26-170307,170307,0,0,0,97,0.6,89.38952627049956,6
2020-04-27-170307,170307,3,0,2,100,3.8,69.9275826884721,0
2020-04-28-170307,170307,3,0,0,103,2.0,74.13877845268176,1
2020-04-29-170307,170307,1,0,0,104,3.0,74.99249453462599,2
2020-04-30-170307,170307,1,0,2,105,3.0,78.03935417948463,3
2020-05-01-170307,170307,0,0,0,105,0.4,79.13172319059149,4
2020-05-02-170307,170307,0,0,0,105,0.8,46.75225244014218,5
2020-05-03-170307,170307,0,0,0,105,0.4,36.93212066228695,6
2020-05-04-170307,170307,3,0,5,108,3.4,26.956805692660886,0
2020-05-05-170307,170307,1,0,0,109,3.6,36.13159491556733,1
2020-05-06-170307,170307,0,0,1,109,2.8,42.53502318037755,2
2020-05-07-170307,170307,0,0,1,109,2.4,43.7637335571586,3
2020-05-08-170307,170307,2,0,1,111,3.2,42.244313351542765,4
2020-05-09-170307,170307,0,0,0,111,0.4,62.05189141971943,5
2020-05-10-170307,170307,0,0,0,111,0.2,75.82612399753714,6
2020-05-11-170307,170307,2,7,2,113,1.8,75.32509876422665,0
2020-05-12-170307,170307,0,0,1,113,3.0,83.8519526446299,1
2020-05-13-170307,170307,0,0,1,113,2.8,76.19957531016789,2
2020-05-14-170307,170307,2,0,0,115,4.0,65.64118461824893,3
2020-05-15-170307,170307,0,0,0,115,1.6,53.33421667637682,4
2020-05-16-170307,170307,0,0,1,115,1.0,43.00017282589636,5
2020-05-17-170307,170307,0,0,0,115,0.2,43.75895507880465,6
2020-05-18-170307,170307,5,0,2,120,1.6,44.135711072920785,0
2020-05-19-170307,170307,0,0,1,120,2.2,55.732664595886234,1
2020-05-20-170307,170307,1,1,0,121,2.0,50.54489758472757,2
2020-05-21-170307,170307,1,0,0,122,2.0,43.901808541337346,3
2020-05-22-170307,170307,1,0,2,123,4.8,45.06958562282113,4
2020-05-23-170307,170307,0,0,0,123,0.4,55.3021085585425,5
2020-05-24-170307,170307,0,0,0,123,0.2,56.34679672412683,6
2020-05-25-170307,170307,2,0,0,125,2.6,34.16157825749095,0
2020-05-26-170307,170307,1,0,0,126,1.2,49.077276876641896,1
2020-05-27-170307,170307,1,0,0,127,1.8,60.32886684375343,2
2020-05-28-170307,170307,0,0,0,127,2.8,63.24384559819038,3
2020-05-29-170307,170307,0,1,0,127,3.4,60.56629359546133,4
2020-05-30-170307,170307,1,0,0,128,0.0,58.94885852151818,5
2020-05-31-170307,170307,0,0,0,128,0.4,66.97566081819528,6
2020-06-01-170307,170307,2,0,0,130,3.2,98.20252296732403,0
2020-06-02-170307,170307,1,0,1,131,2.0,20.794264908988836,1
2020-06-03-170307,170307,0,0,0,131,3.2,14.967220439094845,2
2020-06-04-170307,170307,0,0,0,131,2.8,19.016420838137662,3
2020-06-05-170307,170307,2,0,0,133,2.8,29.878696071560324,4
2020-06-06-170307,170307,0,0,0,133,0.0,44.05985664086684,5
2020-06-07-170307,170307,0,0,1,133,0.0,43.78440406430313,6
2020-06-08-170307,170307,0,0,0,133,3.6,43.88680797191792,0
2020-06-09-170307,170307,0,0,0,133,3.2,45.23472759420712,1
2020-06-10-170307,170307,0,0,0,133,2.8,106.07012981461435,2
2020-06-11-170307,170307,0,0,0,133,2.8,91.27429287797094,3
2020-06-12-170307,170307,0,0,0,133,1.8,79.67230671941697,4
2020-06-13-170307,170307,0,0,0,133,0.4,75.37638919896807,5
2020-06-14-170307,170307,0,0,0,133,0.4,69.10406309957622,6
2020-06-15-170307,170307,0,0,1,133,1.4,46.22147725510599,0
2020-06-16-170307,170307,1,0,0,134,1.0,45.77232575252411,1
2020-06-17-170307,170307,0,0,0,134,0.4,36.06525279240455,2
2020-06-18-170307,170307,0,0,0,134,0.0,30.609436857436968,3
2020-06-19-170307,170307,0,0,0,134,1.8,22.803318961327662,4
2020-06-20-170307,170307,0,0,0,134,0.0,33.08743010271734,5
2020-06-21-170307,170307,1,0,0,135,0.0,31.15734830876168,6
2020-06-22-170307,170307,0,0,0,135,0.2,34.42374611021305,0
2020-06-23-170307,170307,0,0,0,135,1.6,28.683068616690534,1
2020-06-24-170307,170307,0,1,0,135,0.2,30.745252385459015,2
2020-06-25-170307,170307,0,0,0,135,0.4,29.887768329100894,3
2020-06-26-170307,170307,0,0,0,135,0.6,27.601300484334487,4
2020-06-27-170307,170307,0,0,0,135,0.0,18.687362500191405,5
2020-06-28-170307,170307,0,0,0,135,0.0,18.97372399092447,6
2020-06-29-170307,170307,1,0,0,136,0.8,13.609547469600974,0
2020-06-30-170307,170307,0,0,0,136,0.2,22.65496575717723,1
2020-07-01-170307,170307,0,0,0,136,0.4,55.40845592926666,2
2020-07-02-170307,170307,0,0,0,136,0.0,32.829027874777275,3
2020-07-03-170307,170307,0,0,0,136,0.8,48.40277819628899,4
2020-07-04-170307,170307,0,0,0,136,0.0,30.441421302799785,5
2020-07-05-170307,170307,0,0,0,136,0.4,29.046861348574588,6
2020-07-06-170307,170307,0,0,0,136,0.8,27.822109643626327,0
2020-07-07-170307,170307,0,0,0,136,1.2,22.495459775979143,1
2020-07-08-170307,170307,0,0,0,136,0.2,16.415377645805002,2
2020-07-09-170307,170307,0,0,1,136,0.8,15.422287539220005,3
2020-07-10-170307,170307,0,0,2,136,0.6,58.74965986670045,4
2020-07-11-170307,170307,0,0,0,136,0.0,45.88630419136459,5
2020-07-12-170307,170307,0,0,0,136,0.0,24.816711579988123,6
2020-07-13-170307,170307,0,0,0,136,1.6,24.607539065960648,0
2020-07-14-170307,170307,0,0,1,136,0.4,30.719775238019366,1
2020-07-15-170307,170307,0,0,1,136,0.6,24.512188050427977,2
2020-07-16-170307,170307,0,0,0,136,0.2,18.719724669034896,3
2020-07-17-170307,170307,0,0,0,136,1.4,26.7522319847481,4
2020-07-18-170307,170307,0,0,0,136,0.6,28.457651454833474,5
2020-07-19-170307,170307,0,0,0,136,0.4,32.49316899812919,6
2020-07-20-170307,170307,0,0,0,136,1.4,30.35908002734795,0
2020-07-21-170307,170307,0,0,0,136,0.6,30.51143273939827,1
2020-07-22-170307,170307,0,0,1,136,0.8,34.006720259255275,2
2020-07-23-170307,170307,1,0,0,137,0.2,26.797736556497103,3
2020-07-24-170307,170307,2,0,0,139,1.0,37.89277997880993,4
2020-07-25-170307,170307,0,0,0,139,0.0,47.407896603978735,5
2020-07-26-170307,170307,0,0,0,139,0.6,44.237041192281495,6
2020-07-27-170307,170307,0,0,1,139,0.8,45.06155692333314,0
2020-07-28-170307,170307,1,0,0,140,0.6,42.93725008144524,1
2020-07-29-170307,170307,1,0,0,141,0.4,43.47210898373018,2
2020-07-30-170307,170307,0,0,0,141,1.4,38.14547852961819,3
2020-07-31-170307,170307,0,0,0,141,0.8,31.190698871438443,4
2020-08-01-170307,170307,0,0,0,141,0.4,11.478772170332068,5
2020-08-02-170307,170307,0,0,0,141,0.4,44.33267111386681,6
2020-08-03-170307,170307,0,0,1,141,2.0,209.8006174727812,0
2020-08-04-170307,170307,0,0,0,141,1.4,205.55031359956797,1
2020-08-05-170307,170307,1,0,0,142,1.6,141.9114176535177,2
2020-08-06-170307,170307,0,0,1,142,0.4,82.99764428363302,3
2020-08-07-170307,170307,0,0,1,142,1.4,71.54930420159778,4
2020-08-08-170307,170307,0,0,0,142,0.6,62.39187257183056,5
2020-08-09-170307,170307,0,0,0,142,0.0,58.19455982830215,6
2020-08-10-170307,170307,1,1,0,143,0.6,11.313440013390958,0
2020-08-11-170307,170307,0,0,0,143,0.8,23.70124135101061,1
2020-08-12-170307,170307,0,0,7,143,1.0,25.701116369583424,2
2020-08-13-170307,170307,0,0,8,143,1.0,25.88013715370432,3
2020-08-14-170307,170307,0,0,0,143,1.0,26.54478916005943,4
2020-08-15-170307,170307,0,0,0,143,0.2,28.906784346591756,5
2020-08-16-170307,170307,0,0,0,143,0.6,29.690420746558097,6
2020-08-17-170307,170307,1,0,1,144,1.8,31.36544976415293,0
2020-08-18-170307,170307,0,0,0,144,2.2,33.20254853864694,1
2020-08-19-170307,170307,0,0,2,144,2.4,37.920482151981886,2
2020-08-20-170307,170307,1,0,1,145,1.0,44.819804300866394,3
2020-08-21-170307,170307,1,0,1,146,2.2,52.31606754430295,4
2020-08-22-170307,170307,0,0,0,146,1.4,71.50647418517529,5
2020-08-23-170307,170307,0,0,1,146,2.0,78.42557737337148,6
2020-08-24-170307,170307,0,0,1,146,2.2,68.94048666152693,0
2020-08-25-170307,170307,0,0,1,146,3.6,77.32343492817948,1
2020-08-26-170307,170307,7,0,5,153,3.6,93.4216027539706,2
2020-08-27-170307,170307,8,0,0,161,3.6,157.84380659667386,3
2020-08-28-170307,170307,0,0,2,161,3.4,216.4049960684516,4
2020-08-29-170307,170307,0,0,0,161,4.2,204.88621571805163,5
2020-08-30-170307,170307,0,0,0,161,3.6,200.2794902651231,6
2020-08-31-170307,170307,1,0,0,162,2.8,189.35448949182512,0
2020-09-01-170307,170307,0,0,5,162,2.4,44.97895468709075,1
2020-09-02-170307,170307,2,0,3,164,2.6,219.28824148873366,2
2020-09-03-170307,170307,1,0,2,165,3.2,274.4208872597093,3
2020-09-04-170307,170307,1,0,0,166,3.2,207.14953149127024,4
2020-09-05-170307,170307,0,0,0,166,2.8,153.74328576773306,5
2020-09-06-170307,170307,1,0,3,167,2.4,166.5669320143985,6
2020-09-07-170307,170307,1,0,1,168,6.0,160.2375069747782,0
2020-09-08-170307,170307,1,0,1,169,5.6,148.92440337388408,1
2020-09-09-170307,170307,5,0,1,174,6.4,145.48569021989846,2
2020-09-10-170307,170307,0,0,8,174,5.4,30.829096335475732,3
2020-09-11-170307,170307,2,0,9,176,9.0,50.917475285188,4
2020-09-12-170307,170307,0,0,0,176,1.8,91.35773886767569,5
2020-09-13-170307,170307,0,0,2,176,6.6,94.95280804778066,6
2020-09-14-170307,170307,0,0,1,176,8.0,109.28684372201592,0
2020-09-15-170307,170307,5,0,2,181,6.4,144.42135352723557,1
2020-09-16-170307,170307,3,0,0,184,8.4,193.5875578669544,2
2020-09-17-170307,170307,2,0,5,186,8.0,217.91905270816795,3
2020-09-18-170307,170307,0,0,1,186,8.6,236.0527492014426,4
2020-09-19-170307,170307,0,0,0,186,1.4,215.50887581447375,5
2020-09-20-170307,170307,3,1,0,189,1.8,211.83748679851294,6
2020-09-21-170307,170307,1,0,0,190,11.8,191.28245427893575,0
2020-09-22-170307,170307,1,0,4,191,8.2,168.37684962114972,1
2020-09-23-170307,170307,1,0,1,192,10.2,162.36620696062235,2
2020-09-24-170307,170307,8,0,5,200,9.6,157.88043828324535,3
2020-09-25-170307,170307,9,0,10,209,6.0,197.09326819865078,4
2020-09-26-170307,170307,0,0,5,209,2.6,260.82685675623105,5
2020-09-27-170307,170307,2,0,2,211,1.6,251.57083286964965,6
2020-09-28-170307,170307,1,0,1,212,12.0,250.13770213622516,0
2020-09-29-170307,170307,2,0,6,214,4.8,259.79033168862316,1
2020-09-30-170307,170307,0,0,4,214,8.2,243.17139551783436,2
2020-10-01-170307,170307,5,0,1,219,12.4,0.0,3
2020-10-02-170307,170307,1,0,9,220,12.8,407.01660369702563,4
2020-10-03-170307,170307,0,2,4,220,3.6,420.0540554508932,5
2020-10-04-170307,170307,0,0,2,220,4.8,450.1923784650573,6
2020-10-05-170307,170307,0,2,7,220,2.0,359.11897464056017,0
2020-10-06-170307,170307,4,0,7,224,11.8,335.7159046807423,1
2020-10-07-170307,170307,1,0,7,225,8.2,318.5245634324705,2
2020-10-08-170307,170307,5,1,15,230,7.4,286.00132728539535,3
2020-10-09-170307,170307,10,0,0,240,12.4,345.6413006143744,4
2020-10-10-170307,170307,5,0,12,245,2.2,47.62797099399995,5
2020-10-11-170307,170307,2,0,1,247,1.8,85.67783443071768,6
2020-10-12-170307,170307,1,0,11,248,2.4,106.40004281632376,0
2020-10-13-170307,170307,6,0,2,254,18.4,116.22031721416718,1
2020-10-14-170307,170307,4,0,7,258,11.2,184.35364732692108,2
2020-10-15-170307,170307,1,0,5,259,15.2,233.10990422819626,3
2020-10-16-170307,170307,9,0,12,268,9.8,270.33088209280663,4
2020-10-17-170307,170307,4,0,1,272,3.0,296.27733253274835,5
2020-10-18-170307,170307,2,0,8,274,2.6,297.8776392720584,6
2020-10-19-170307,170307,7,0,0,281,18.0,302.4430872646663,0
2020-10-20-170307,170307,7,0,16,288,11.2,341.37468465065024,1
2020-10-21-170307,170307,7,1,9,295,12.6,365.3693021847171,2
2020-10-22-170307,170307,15,0,19,310,21.2,381.9740510939186,3
2020-10-23-170307,170307,0,0,7,310,15.8,454.3507009532847,4
2020-10-24-170307,170307,12,0,1,322,2.4,461.98602098314007,5
2020-10-25-170307,170307,1,2,4,323,4.2,482.69941117882524,6
2020-10-26-170307,170307,11,0,21,334,12.8,406.34241227093,0
2020-10-27-170307,170307,2,0,5,336,6.6,462.7862134892134,1
2020-10-28-170307,170307,7,1,8,343,18.2,426.7575426531076,2
2020-10-29-170307,170307,5,0,8,348,14.6,440.8194469391357,3
2020-10-30-170307,170307,12,1,12,360,12.0,346.0204071901451,4
2020-10-31-170307,170307,1,1,0,361,3.2,403.83744660254024,5
2020-11-01-170307,170307,8,1,0,369,4.2,255.20504601968696,6
2020-11-02-170307,170307,0,0,0,369,1.8,455.90358459299546,0
2020-11-03-170307,170307,16,0,0,385,19.2,346.5536933094138,1
2020-11-04-170307,170307,9,1,0,394,8.0,474.0475365736442,2
2020-11-05-170307,170307,19,0,0,413,12.8,419.689109957363,3
2020-11-06-170307,170307,7,2,0,420,13.0,472.4798928238201,4
2020-11-07-170307,170307,1,0,0,421,2.8,490.6665501031071,5
2020-11-08-170307,170307,4,0,0,425,1.8,450.096372368821,6
2020-11-09-170307,170307,21,0,0,446,17.8,474.48088993027613,0
2020-11-10-170307,170307,5,0,0,451,20.0,274.7053296827693,1
2020-11-11-170307,170307,8,0,0,459,12.8,330.311863912417,2
2020-11-12-170307,170307,8,0,0,467,12.6,384.6412819852248,3
2020-11-13-170307,170307,12,0,0,479,13.4,398.56618202000254,4
2020-03-01-170308,170308,0,0,4,0,0.0,0.0,6
2020-03-02-170308,170308,0,0,27,0,0.0,144.89729145489218,0
2020-03-03-170308,170308,0,3,28,0,0.0,583.1383544886013,1
2020-03-04-170308,170308,0,0,29,0,0.0,614.4126410475989,2
2020-03-05-170308,170308,0,0,27,0,0.0,696.2398823880919,3
2020-03-06-170308,170308,0,0,33,0,0.0,690.9113614841835,4
2020-03-07-170308,170308,0,0,24,0,0.0,783.5468241889548,5
2020-03-08-170308,170308,0,0,17,0,0.0,771.6057343208395,6
2020-03-09-170308,170308,0,0,75,0,1.0,773.3715621733983,0
2020-03-10-170308,170308,0,0,53,0,0.0,522.9387873445912,1
2020-03-11-170308,170308,1,0,31,1,0.0,491.05386205924657,2
2020-03-12-170308,170308,1,0,29,2,1.0,273.0693189946785,3
2020-03-13-170308,170308,5,0,24,7,0.0,170.11949973255838,4
2020-03-14-170308,170308,3,0,6,10,0.0,153.8576437265174,5
2020-03-15-170308,170308,4,0,22,14,2.0,152.95770740062562,6
2020-03-16-170308,170308,27,0,62,41,8.0,100.00021506512539,0
2020-03-17-170308,170308,28,0,46,69,19.0,271.7726063172684,1
2020-03-18-170308,170308,29,5,11,98,23.0,494.11863119305286,2
2020-03-19-170308,170308,27,0,19,125,15.0,708.470007022934,3
2020-03-20-170308,170308,33,1,15,158,13.0,831.0023098601615,4
2020-03-21-170308,170308,24,0,2,182,7.0,954.7993541172885,5
2020-03-22-170308,170308,17,0,4,199,4.0,1009.5516285924783,6
2020-03-23-170308,170308,75,1,7,274,32.0,963.63319739895,0
2020-03-24-170308,170308,53,0,13,327,29.0,1181.3114597911817,1
2020-03-25-170308,170308,31,0,10,358,19.0,1273.1012815628872,2
2020-03-26-170308,170308,29,0,26,387,9.0,1300.817755496242,3
2020-03-27-170308,170308,24,0,74,411,11.0,1446.7309748505354,4
2020-03-28-170308,170308,6,0,4,417,3.0,1403.0432728176759,5
2020-03-29-170308,170308,22,0,4,439,5.0,1324.7445208967536,6
2020-03-30-170308,170308,62,0,22,501,11.0,922.2702725921949,0
2020-03-31-170308,170308,46,0,16,547,9.0,881.0426688091817,1
2020-04-01-170308,170308,11,0,10,558,8.0,193.24128912008203,2
2020-04-02-170308,170308,19,0,4,577,10.0,370.68214450965314,3
2020-04-03-170308,170308,15,0,20,592,5.0,275.9762073317627,4
2020-04-04-170308,170308,2,0,1,594,1.0,241.22291073150552,5
2020-04-05-170308,170308,4,0,5,598,2.0,242.09324057554173,6
2020-04-06-170308,170308,7,0,9,605,19.0,262.1039896314377,0
2020-04-07-170308,170308,13,1,15,618,7.0,327.27956082964636,1
2020-04-08-170308,170308,10,2,1,628,8.0,378.1772900149562,2
2020-04-09-170308,170308,26,0,2,654,2.0,472.4624701077947,3
2020-04-10-170308,170308,74,1,12,728,11.0,93.76199876874813,4
2020-04-11-170308,170308,4,0,4,732,4.0,369.82299888236116,5
2020-04-12-170308,170308,4,0,1,736,25.0,399.5666597353317,6
2020-04-13-170308,170308,22,0,4,758,6.0,486.45087846610056,0
2020-04-14-170308,170308,16,0,5,774,12.0,590.7077885190823,1
2020-04-15-170308,170308,10,0,8,784,1.0,686.8103721295972,2
2020-04-16-170308,170308,4,0,8,788,4.0,711.904756078338,3
2020-04-17-170308,170308,20,0,1,808,2.0,690.191548808662,4
2020-04-18-170308,170308,1,0,2,809,0.0,507.2533314661707,5
2020-04-19-170308,170308,5,0,2,814,0.0,478.22506458210614,6
2020-04-20-170308,170308,9,0,3,823,2.0,415.0033630309568,0
2020-04-21-170308,170308,15,0,4,838,4.0,380.57251895063814,1
2020-04-22-170308,170308,1,0,5,839,0.0,440.5325730860604,2
2020-04-23-170308,170308,2,0,11,841,0.0,413.3518803068946,3
2020-04-24-170308,170308,12,1,2,853,34.0,323.65764474798465,4
2020-04-25-170308,170308,4,0,0,857,1.0,481.41024659737076,5
2020-04-26-170308,170308,1,0,0,858,1.0,482.3696967295306,6
2020-04-27-170308,170308,4,0,11,862,4.0,371.3837747182096,0
2020-04-28-170308,170308,5,0,14,867,4.0,349.29220203759655,1
2020-04-29-170308,170308,8,0,14,875,0.0,288.33567372771387,2
2020-04-30-170308,170308,8,1,7,883,2.0,386.34421741784473,3
2020-05-01-170308,170308,1,0,2,884,0.0,488.5950340300696,4
2020-05-02-170308,170308,2,0,0,886,1.0,222.41440801383462,5
2020-05-03-170308,170308,2,0,4,888,0.0,176.69198911577317,6
2020-05-04-170308,170308,3,0,6,891,5.0,176.28471438786144,0
2020-05-05-170308,170308,4,0,7,895,9.0,161.32289070457068,1
2020-05-06-170308,170308,5,0,10,900,4.0,175.98116594438255,2
2020-05-07-170308,170308,11,0,22,911,1.0,165.1144519593761,3
2020-05-08-170308,170308,2,0,6,913,1.0,183.67220462407022,4
2020-05-09-170308,170308,0,0,0,913,0.0,212.3420865763648,5
2020-05-10-170308,170308,0,0,1,913,0.0,512.0570114475045,6
2020-05-11-170308,170308,11,1,2,924,2.0,494.9499547541502,0
2020-05-12-170308,170308,14,0,9,938,4.0,519.9289052592843,1
2020-05-13-170308,170308,14,1,10,952,6.0,481.0653517446757,2
2020-05-14-170308,170308,7,0,8,959,4.0,463.71840390996647,3
2020-05-15-170308,170308,2,0,4,961,2.0,379.4675677347599,4
2020-05-16-170308,170308,0,0,0,961,1.0,279.41827752659736,5
2020-05-17-170308,170308,4,0,0,965,0.0,278.7607633923715,6
2020-05-18-170308,170308,6,0,7,971,2.0,292.3255428714565,0
2020-05-19-170308,170308,7,0,3,978,4.0,281.1290432346487,1
2020-05-20-170308,170308,10,1,3,988,1.0,202.25083170110116,2
2020-05-21-170308,170308,22,0,11,1010,3.0,213.02675921649706,3
2020-05-22-170308,170308,6,0,7,1016,2.0,300.0702241438254,4
2020-05-23-170308,170308,0,0,3,1016,0.0,334.74383416369767,5
2020-05-24-170308,170308,1,0,1,1017,0.0,322.822818315442,6
2020-05-25-170308,170308,2,0,6,1019,2.0,284.20362704609744,0
2020-05-26-170308,170308,9,0,7,1028,0.0,245.362340023012,1
2020-05-27-170308,170308,10,0,5,1038,1.0,280.28532769260426,2
2020-05-28-170308,170308,8,0,3,1046,3.0,275.91057383687087,3
2020-05-29-170308,170308,4,0,1,1050,4.0,231.89558520792704,4
2020-05-30-170308,170308,0,0,1,1050,0.0,249.46296453354594,5
2020-05-31-170308,170308,0,1,0,1050,0.0,252.02086077112492,6
2020-06-01-170308,170308,7,0,0,1057,3.0,260.4990254605761,0
2020-06-02-170308,170308,3,0,3,1060,4.0,97.63661547339093,1
2020-06-03-170308,170308,3,0,4,1063,3.0,96.03406591580679,2
2020-06-04-170308,170308,11,0,0,1074,6.0,113.88951151879422,3
2020-06-05-170308,170308,7,0,4,1081,1.0,170.33798783815234,4
2020-06-06-170308,170308,3,0,0,1084,0.0,211.91247171608012,5
2020-06-07-170308,170308,1,0,1,1085,0.0,225.39549937241333,6
2020-06-08-170308,170308,6,0,4,1091,0.0,232.1551461211752,0
2020-06-09-170308,170308,7,0,2,1098,1.0,247.51524917933983,1
2020-06-10-170308,170308,5,0,2,1103,4.0,330.20155579969094,2
2020-06-11-170308,170308,3,0,2,1106,0.0,360.0888278725364,3
2020-06-12-170308,170308,1,0,0,1107,3.0,308.84694781229064,4
2020-06-13-170308,170308,1,0,1,1108,0.0,284.65300808732593,5
2020-06-14-170308,170308,0,1,0,1108,0.0,223.7191825413404,6
2020-06-15-170308,170308,0,0,2,1108,3.0,190.571188359874,0
2020-06-16-170308,170308,3,0,5,1111,0.0,207.77969772543932,1
2020-06-17-170308,170308,4,0,0,1115,1.0,169.04496264123406,2
2020-06-18-170308,170308,0,0,1,1115,1.0,129.746775790639,3
2020-06-19-170308,170308,4,0,0,1119,0.0,110.16595786592016,4
2020-06-20-170308,170308,0,0,0,1119,0.0,135.56717188624066,5
2020-06-21-170308,170308,1,0,0,1120,0.0,135.96212730649054,6
2020-06-22-170308,170308,4,0,1,1124,2.0,119.59616656555441,0
2020-06-23-170308,170308,2,0,0,1126,1.0,130.40051788596358,1
2020-06-24-170308,170308,2,1,0,1128,3.0,125.39707199765235,2
2020-06-25-170308,170308,2,0,1,1130,2.0,146.71359852799162,3
2020-06-26-170308,170308,0,0,1,1130,0.0,157.47069104156313,4
2020-06-27-170308,170308,1,0,0,1131,0.0,119.9647435867561,5
2020-06-28-170308,170308,0,0,0,1131,0.0,127.451001240183,6
2020-06-29-170308,170308,2,0,1,1133,2.0,122.85744046920018,0
2020-06-30-170308,170308,5,0,0,1138,1.0,124.15605324683082,1
2020-07-01-170308,170308,0,0,0,1138,0.0,288.9505939565824,2
2020-07-02-170308,170308,1,0,0,1139,3.0,32.11924568913272,3
2020-07-03-170308,170308,0,0,0,1139,1.0,38.723547306127685,4
2020-07-04-170308,170308,0,0,0,1139,0.0,33.278088898909964,5
2020-07-05-170308,170308,0,0,0,1139,0.0,32.3764515490543,6
2020-07-06-170308,170308,1,0,0,1140,0.0,25.459062902477577,0
2020-07-07-170308,170308,0,0,0,1140,0.0,34.45465252057758,1
2020-07-08-170308,170308,0,0,0,1140,1.0,35.62021390850927,2
2020-07-09-170308,170308,1,0,1,1141,2.0,38.110047273721776,3
2020-07-10-170308,170308,1,0,0,1142,0.0,257.40192242967856,4
2020-07-11-170308,170308,0,0,0,1142,0.0,170.97204038641237,5
2020-07-12-170308,170308,0,0,0,1142,0.0,123.69926270620351,6
2020-07-13-170308,170308,1,0,0,1143,1.0,108.84449725107501,0
2020-07-14-170308,170308,0,0,0,1143,0.0,118.13606888274707,1
2020-07-15-170308,170308,0,0,0,1143,0.0,82.98944242744042,2
2020-07-16-170308,170308,0,0,0,1143,0.0,26.504156844795936,3
2020-07-17-170308,170308,0,0,0,1143,0.0,32.02096004643943,4
2020-07-18-170308,170308,0,0,0,1143,1.0,26.684606826420517,5
2020-07-19-170308,170308,0,0,0,1143,0.0,33.792779642333976,6
2020-07-20-170308,170308,0,0,0,1143,0.0,42.736585786626,0
2020-07-21-170308,170308,0,0,0,1143,0.0,43.371306378673154,1
2020-07-22-170308,170308,0,0,1,1143,0.0,44.6839108192649,2
2020-07-23-170308,170308,1,0,0,1144,1.0,43.092881149978425,3
2020-07-24-170308,170308,0,1,0,1144,1.0,56.086006709942964,4
2020-07-25-170308,170308,0,0,0,1144,0.0,61.66087255538635,5
2020-07-26-170308,170308,0,0,1,1144,0.0,59.91879916252166,6
2020-07-27-170308,170308,0,0,3,1144,1.0,38.438325994680895,0
2020-07-28-170308,170308,0,1,1,1144,0.0,42.09493308338483,1
2020-07-29-170308,170308,0,0,0,1144,0.0,44.148983129462785,2
2020-07-30-170308,170308,0,0,0,1144,0.0,33.1699657231594,3
2020-07-31-170308,170308,0,0,2,1144,0.0,28.816139876159312,4
2020-08-01-170308,170308,0,0,1,1144,1.0,44.131910915388055,5
2020-08-02-170308,170308,0,0,0,1144,0.0,97.22367188280137,6
2020-08-03-170308,170308,0,0,0,1144,0.0,367.8871247876586,0
2020-08-04-170308,170308,0,0,1,1144,0.0,496.1821992972832,1
2020-08-05-170308,170308,1,0,1,1145,1.0,416.14017963848056,2
2020-08-06-170308,170308,0,0,2,1145,9.0,332.9469316989487,3
2020-08-07-170308,170308,0,0,0,1145,2.0,266.438637670437,4
2020-08-08-170308,170308,0,0,0,1145,0.0,277.58627626781305,5
2020-08-09-170308,170308,1,0,0,1146,0.0,277.3760604186883,6
2020-08-10-170308,170308,3,0,0,1149,0.0,46.838314087154934,0
2020-08-11-170308,170308,1,0,1,1150,0.0,64.04144944143331,1
2020-08-12-170308,170308,0,0,10,1150,4.0,74.02854621273696,2
2020-08-13-170308,170308,0,0,14,1150,0.0,84.17292934047167,3
2020-08-14-170308,170308,2,0,17,1152,0.0,84.51793800974224,4
2020-08-15-170308,170308,1,0,0,1153,7.0,89.31491697352308,5
2020-08-16-170308,170308,0,0,3,1153,0.0,127.16599017362866,6
2020-08-17-170308,170308,0,0,3,1153,0.0,124.69494097824324,0
2020-08-18-170308,170308,1,0,0,1154,1.0,106.52234452589255,1
2020-08-19-170308,170308,1,0,2,1155,0.0,114.41121165251437,2
2020-08-20-170308,170308,2,0,6,1157,1.0,96.52239686805878,3
2020-08-21-170308,170308,0,1,1,1157,0.0,108.49065435659384,4
2020-08-22-170308,170308,0,0,1,1157,0.0,67.74856838912613,5
2020-08-23-170308,170308,0,0,1,1157,0.0,75.0695168872684,6
2020-08-24-170308,170308,0,0,2,1157,0.0,78.53660656993662,0
2020-08-25-170308,170308,1,1,1,1158,2.0,79.20157175466154,1
2020-08-26-170308,170308,10,1,7,1168,3.0,98.89348674934624,2
2020-08-27-170308,170308,14,0,2,1182,4.0,187.37177266807865,3
2020-08-28-170308,170308,17,1,2,1199,1.0,264.1289482666231,4
2020-08-29-170308,170308,0,0,2,1199,1.0,374.0957548370903,5
2020-08-30-170308,170308,3,0,0,1202,19.0,363.2254059232745,6
2020-08-31-170308,170308,3,0,10,1205,2.0,471.60454408212837,0
2020-09-01-170308,170308,0,1,7,1205,3.0,132.04790730034986,1
2020-09-02-170308,170308,2,0,4,1207,0.0,368.5382559869063,2
2020-09-03-170308,170308,6,3,3,1213,1.0,305.4175804068409,3
2020-09-04-170308,170308,1,0,8,1214,2.0,317.8897838781908,4
2020-09-05-170308,170308,1,0,1,1215,0.0,289.08011371119557,5
2020-09-06-170308,170308,1,0,2,1216,0.0,258.7590455471773,6
2020-09-07-170308,170308,2,0,1,1218,0.0,263.66063707972097,0
2020-09-08-170308,170308,1,1,10,1219,2.0,234.94669244593695,1
2020-09-09-170308,170308,7,0,0,1226,2.0,210.2201493494465,2
2020-09-10-170308,170308,2,0,3,1228,0.0,133.82587037156296,3
2020-09-11-170308,170308,2,0,3,1230,3.0,147.6310296818073,4
2020-09-12-170308,170308,2,0,1,1232,0.0,178.39512754323272,5
2020-09-13-170308,170308,0,0,0,1232,0.0,143.7835203800907,6
2020-09-14-170308,170308,10,0,1,1242,2.0,146.48734316057033,0
2020-09-15-170308,170308,7,0,2,1249,9.0,219.64742059411842,1
2020-09-16-170308,170308,4,0,3,1253,1.0,315.6808328032452,2
2020-09-17-170308,170308,3,0,1,1256,3.0,327.1962084209765,3
2020-09-18-170308,170308,8,0,3,1264,1.0,339.48443107441267,4
2020-09-19-170308,170308,1,0,4,1265,0.0,359.56309468022124,5
2020-09-20-170308,170308,2,0,0,1267,3.0,366.3159768622452,6
2020-09-21-170308,170308,1,2,1,1268,2.0,322.0082257163186,0
2020-09-22-170308,170308,10,0,9,1278,3.0,254.31437222863002,1
2020-09-23-170308,170308,0,0,0,1278,1.0,292.74666284345045,2
2020-09-24-170308,170308,3,0,3,1281,2.0,293.02676716800136,3
2020-09-25-170308,170308,3,1,0,1284,1.0,279.7732296544342,4
2020-09-26-170308,170308,1,0,4,1285,1.0,326.24549467942865,5
2020-09-27-170308,170308,0,0,7,1285,1.0,327.55126940310936,6
2020-09-28-170308,170308,1,0,1,1286,4.0,301.75869905502884,0
2020-09-29-170308,170308,2,0,1,1288,6.0,321.0527032810132,1
2020-09-30-170308,170308,3,1,1,1291,2.0,301.3567790765443,2
2020-10-01-170308,170308,1,0,4,1292,2.0,0.0,3
2020-10-02-170308,170308,3,0,5,1295,1.0,443.1029442056156,4
2020-10-03-170308,170308,4,0,4,1299,2.0,472.34010640028555,5
2020-10-04-170308,170308,0,1,0,1299,0.0,543.939961911483,6
2020-10-05-170308,170308,1,0,4,1300,2.0,483.52852376467115,0
2020-10-06-170308,170308,9,1,0,1309,5.0,481.2746665248103,1
2020-10-07-170308,170308,0,2,1,1309,2.0,511.57063167516543,2
2020-10-08-170308,170308,3,0,5,1312,2.0,411.2694765967986,3
2020-10-09-170308,170308,0,3,2,1312,3.0,445.70598063586755,4
2020-10-10-170308,170308,4,0,2,1316,0.0,79.25426756064462,5
2020-10-11-170308,170308,7,0,4,1323,2.0,107.36782589443122,6
2020-10-12-170308,170308,1,0,3,1324,1.0,173.9103150859329,0
2020-10-13-170308,170308,1,0,1,1325,1.0,183.00980648107418,1
2020-10-14-170308,170308,1,0,3,1326,2.0,241.42266967450973,2
2020-10-15-170308,170308,4,0,12,1330,3.0,305.98434070321264,3
2020-10-16-170308,170308,5,0,10,1335,1.0,380.64334719466615,4
2020-10-17-170308,170308,4,0,1,1339,3.0,396.71295172896856,5
2020-10-18-170308,170308,0,0,0,1339,0.0,416.0336351550479,6
2020-10-19-170308,170308,4,1,1,1343,0.0,364.59956859402655,0
2020-10-20-170308,170308,0,1,1,1343,1.0,427.3249814111835,1
2020-10-21-170308,170308,1,1,1,1344,3.0,408.2666860710731,2
2020-10-22-170308,170308,5,0,6,1349,4.0,384.8169113259645,3
2020-10-23-170308,170308,2,0,4,1351,2.0,385.52173316215146,4
2020-10-24-170308,170308,2,1,2,1353,2.0,396.63367492812256,5
2020-10-25-170308,170308,4,0,0,1357,0.0,424.8491464095482,6
2020-10-26-170308,170308,3,0,1,1360,2.0,387.70120253603193,0
2020-10-27-170308,170308,1,0,1,1361,1.0,396.9330475579995,1
2020-10-28-170308,170308,3,0,5,1364,3.0,403.6580924786674,2
2020-10-29-170308,170308,12,1,1,1376,4.0,417.1990338874323,3
2020-10-30-170308,170308,10,0,5,1386,10.0,437.9853478075073,4
2020-10-31-170308,170308,1,0,0,1387,7.0,507.50629479865484,5
2020-11-01-170308,170308,0,0,0,1387,0.0,394.7857654699772,6
2020-11-02-170308,170308,1,0,0,1388,2.0,425.2950717033374,0
2020-11-03-170308,170308,1,1,0,1389,0.0,374.9569496135531,1
2020-11-04-170308,170308,1,0,0,1390,0.0,426.86859176084204,2
2020-11-05-170308,170308,6,0,0,1396,27.0,370.74927849260484,3
2020-11-06-170308,170308,4,1,0,1400,5.0,507.48745371905204,4
2020-11-07-170308,170308,2,0,0,1402,1.0,535.947959497372,5
2020-11-08-170308,170308,0,1,0,1402,1.0,479.64030237971804,6
2020-11-09-170308,170308,1,1,0,1403,5.0,452.7189317004157,0
2020-11-10-170308,170308,1,0,0,1404,3.0,317.1324200239052,1
2020-11-11-170308,170308,5,0,0,1409,2.0,363.9406740556566,2
2020-11-12-170308,170308,1,1,0,1410,5.0,385.6951971310118,3
2020-11-13-170308,170308,5,1,0,1415,2.0,353.4409219547408,4
2020-03-01-170309,170309,0,0,2,0,0.0,0.0,6
2020-03-02-170309,170309,0,0,8,0,0.0,152.92306435657758,0
2020-03-03-170309,170309,0,0,19,0,0.0,576.8503896907755,1
2020-03-04-170309,170309,0,0,23,0,0.0,581.4701542651534,2
2020-03-05-170309,170309,0,0,15,0,0.0,649.6958052347775,3
2020-03-06-170309,170309,0,0,13,0,0.0,634.6283371490159,4
2020-03-07-170309,170309,0,0,7,0,0.1,699.6037959647214,5
2020-03-08-170309,170309,0,1,4,0,0.0,689.539173938409,6
2020-03-09-170309,170309,1,0,32,1,0.1,688.6794586377066,0
2020-03-10-170309,170309,0,0,29,1,0.0,620.2706041933548,1
2020-03-11-170309,170309,0,0,19,1,0.1,570.8203090432423,2
2020-03-12-170309,170309,1,0,9,2,0.1,342.4580598255208,3
2020-03-13-170309,170309,0,0,11,2,0.6,214.35932285543817,4
2020-03-14-170309,170309,0,0,3,2,0.9,178.54890712720373,5
2020-03-15-170309,170309,2,0,5,4,0.9,173.36883923431458,6
2020-03-16-170309,170309,8,0,11,12,4.3,94.80348059141996,0
2020-03-17-170309,170309,19,0,9,31,5.8,254.78052162680044,1
2020-03-18-170309,170309,23,0,8,54,6.9,495.5309932372455,2
2020-03-19-170309,170309,15,0,10,69,6.3,744.9060092908232,3
2020-03-20-170309,170309,13,1,5,82,7.2,926.6183481029731,4
2020-03-21-170309,170309,7,0,1,89,4.1,1085.3506050530748,5
2020-03-22-170309,170309,4,0,2,93,3.9,1127.8455645637039,6
2020-03-23-170309,170309,32,0,19,125,13.6,1074.8091129469074,0
2020-03-24-170309,170309,29,0,7,154,9.8,1279.090872086452,1
2020-03-25-170309,170309,19,0,8,173,8.5,1369.8995319668163,2
2020-03-26-170309,170309,9,0,2,182,6.3,1419.8353300832719,3
2020-03-27-170309,170309,11,0,11,193,8.1,1584.517295542416,4
2020-03-28-170309,170309,3,0,4,196,2.3,1564.0817892473349,5
2020-03-29-170309,170309,5,1,25,201,3.1,1499.3201173733814,6
2020-03-30-170309,170309,11,0,6,212,10.2,1071.4140005313361,0
2020-03-31-170309,170309,9,0,12,221,8.2,995.4109689960354,1
2020-04-01-170309,170309,8,0,1,229,5.2,205.04468100932246,2
2020-04-02-170309,170309,10,0,4,239,4.9,433.85887952549905,3
2020-04-03-170309,170309,5,0,2,244,3.8,365.76191609054325,4
2020-04-04-170309,170309,1,0,0,245,1.1,283.738677282577,5
2020-04-05-170309,170309,2,0,0,247,0.9,282.02568994347195,6
2020-04-06-170309,170309,19,0,2,266,3.0,302.59296259650296,0
2020-04-07-170309,170309,7,0,4,273,4.1,390.515823341248,1
2020-04-08-170309,170309,8,0,0,281,7.0,440.2459467682269,2
2020-04-09-170309,170309,2,0,0,283,5.7,545.9789823348947,3
2020-04-10-170309,170309,11,0,34,294,10.5,119.89439119414294,4
2020-04-11-170309,170309,4,0,1,298,1.2,347.7189248479402,5
2020-04-12-170309,170309,25,0,1,323,0.9,387.39006153617646,6
2020-04-13-170309,170309,6,0,4,329,3.8,510.89838100216394,0
2020-04-14-170309,170309,12,0,4,341,3.8,625.9891529851009,1
2020-04-15-170309,170309,1,0,0,342,1.9,730.148849909896,2
2020-04-16-170309,170309,4,0,2,346,2.3,765.5537500777052,3
2020-04-17-170309,170309,2,0,0,348,3.4,717.1074803262414,4
2020-04-18-170309,170309,0,0,1,348,0.5,575.4490294744605,5
2020-04-19-170309,170309,0,0,0,348,0.9,542.9386383405849,6
2020-04-20-170309,170309,2,0,5,350,3.5,460.0469470018842,0
2020-04-21-170309,170309,4,0,9,354,6.5,413.35048156496987,1
2020-04-22-170309,170309,0,0,4,354,1.2,477.54455158430136,2
2020-04-23-170309,170309,0,0,1,354,0.4,448.532730731102,3
2020-04-24-170309,170309,34,0,1,388,2.7,364.94094722838685,4
2020-04-25-170309,170309,1,0,0,389,1.3,572.7818900407146,5
2020-04-26-170309,170309,1,0,0,390,0.3,574.5436658832097,6
2020-04-27-170309,170309,4,0,2,394,2.0,448.9477561863277,0
2020-04-28-170309,170309,4,0,4,398,2.6,436.1753589770604,1
2020-04-29-170309,170309,0,0,6,398,1.4,378.7604274371964,2
2020-04-30-170309,170309,2,0,4,400,1.6,477.412759594257,3
2020-05-01-170309,170309,0,0,2,400,0.3,562.8506954942358,4
2020-05-02-170309,170309,1,0,1,401,0.6,259.15025184205416,5
2020-05-03-170309,170309,0,0,0,401,0.8,196.18705476743486,6
2020-05-04-170309,170309,5,0,2,406,1.4,197.3103873934138,0
2020-05-05-170309,170309,9,0,4,415,2.2,195.3936889182702,1
2020-05-06-170309,170309,4,0,1,419,2.0,236.12604083178667,2
2020-05-07-170309,170309,1,0,3,420,4.3,222.80449838527994,3
2020-05-08-170309,170309,1,0,2,421,1.9,236.89053970613242,4
2020-05-09-170309,170309,0,0,0,421,0.5,270.5073947049931,5
2020-05-10-170309,170309,0,2,0,421,0.5,596.1245826595209,6
2020-05-11-170309,170309,2,0,2,423,2.3,572.6645180547582,0
2020-05-12-170309,170309,4,0,0,427,2.0,587.7104706436814,1
2020-05-13-170309,170309,6,0,1,433,3.2,505.880269212344,2
2020-05-14-170309,170309,4,0,3,437,1.9,468.26506899732635,3
2020-05-15-170309,170309,2,0,4,439,1.2,377.7240545564553,4
2020-05-16-170309,170309,1,0,0,440,0.1,289.8720065132733,5
2020-05-17-170309,170309,0,0,0,440,0.5,293.6012561083922,6
2020-05-18-170309,170309,2,0,3,442,2.0,303.0402997928659,0
2020-05-19-170309,170309,4,0,4,446,2.3,300.71548774311566,1
2020-05-20-170309,170309,1,0,3,447,2.1,235.7329962885113,2
2020-05-21-170309,170309,3,0,6,450,2.8,237.5989129807021,3
2020-05-22-170309,170309,2,0,1,452,1.8,297.42074741619894,4
2020-05-23-170309,170309,0,0,0,452,0.1,331.38983763106353,5
2020-05-24-170309,170309,0,0,0,452,0.1,324.7298291504233,6
2020-05-25-170309,170309,2,0,0,454,0.5,274.7175632951605,0
2020-05-26-170309,170309,0,0,1,454,2.1,231.23760512096612,1
2020-05-27-170309,170309,1,1,4,455,1.4,264.13515477180863,2
2020-05-28-170309,170309,3,0,0,458,2.0,257.4427732898064,3
2020-05-29-170309,170309,4,0,3,462,0.9,242.45984113025597,4
2020-05-30-170309,170309,0,0,0,462,0.2,271.42728099945396,5
2020-05-31-170309,170309,0,0,0,462,0.0,278.94317982014036,6
2020-06-01-170309,170309,3,0,3,465,1.8,321.4489156097268,0
2020-06-02-170309,170309,4,0,0,469,0.9,112.61255686985676,1
2020-06-03-170309,170309,3,1,1,472,0.6,114.09628546207396,2
2020-06-04-170309,170309,6,0,1,478,2.0,129.00131800067817,3
2020-06-05-170309,170309,1,0,0,479,1.4,180.93702044301307,4
2020-06-06-170309,170309,0,3,0,479,0.4,217.61076388201337,5
2020-06-07-170309,170309,0,1,0,479,0.3,228.38478395391255,6
2020-06-08-170309,170309,0,0,2,479,1.5,234.9277112458817,0
2020-06-09-170309,170309,1,0,1,480,1.5,248.81215427245135,1
2020-06-10-170309,170309,4,0,3,484,2.1,387.0829873539663,2
2020-06-11-170309,170309,0,0,2,484,1.7,420.7492663871546,3
2020-06-12-170309,170309,3,0,0,487,1.0,355.65657880417814,4
2020-06-13-170309,170309,0,0,0,487,0.2,334.5931492192859,5
2020-06-14-170309,170309,0,0,0,487,0.0,269.776959413669,6
2020-06-15-170309,170309,3,0,2,490,0.8,229.3189868212207,0
2020-06-16-170309,170309,0,0,1,490,0.7,251.71602499702584,1
2020-06-17-170309,170309,1,1,0,491,0.7,208.46938253815077,2
2020-06-18-170309,170309,1,0,3,492,0.2,155.0214720817939,3
2020-06-19-170309,170309,0,0,1,492,0.4,131.88975652087825,4
2020-06-20-170309,170309,0,0,0,492,0.0,157.4446780288222,5
2020-06-21-170309,170309,0,0,0,492,0.1,158.347032628236,6
2020-06-22-170309,170309,2,0,0,494,0.5,131.82707869562225,0
2020-06-23-170309,170309,1,0,0,495,0.9,139.77210475349753,1
2020-06-24-170309,170309,3,0,1,498,0.7,139.5519035038804,2
2020-06-25-170309,170309,2,0,2,500,1.1,161.29051217573252,3
2020-06-26-170309,170309,0,1,0,500,0.4,180.76007457379376,4
2020-06-27-170309,170309,0,0,0,500,0.2,133.47893447109644,5
2020-06-28-170309,170309,0,0,0,500,0.0,140.5073182083393,6
2020-06-29-170309,170309,2,0,1,502,0.4,137.76398355616752,0
2020-06-30-170309,170309,1,0,0,503,1.0,141.79665299746063,1
2020-07-01-170309,170309,0,0,0,503,0.1,293.03654956368496,2
2020-07-02-170309,170309,3,0,0,506,0.2,39.08922504946033,3
2020-07-03-170309,170309,1,0,0,507,0.0,47.00694369350387,4
2020-07-04-170309,170309,0,0,1,507,0.0,44.73455724871971,5
2020-07-05-170309,170309,0,0,0,507,0.0,43.413029498880476,6
2020-07-06-170309,170309,0,0,0,507,0.6,35.3931193576132,0
2020-07-07-170309,170309,0,0,0,507,0.1,48.7949358325664,1
2020-07-08-170309,170309,1,0,0,508,0.5,49.92354487431677,2
2020-07-09-170309,170309,2,0,1,510,0.3,54.819749278034585,3
2020-07-10-170309,170309,0,0,1,510,0.4,260.64526440531444,4
2020-07-11-170309,170309,0,0,0,510,0.1,170.84862770736257,5
2020-07-12-170309,170309,0,0,0,510,0.1,124.99912531154769,6
2020-07-13-170309,170309,1,0,1,511,0.3,111.05135232196847,0
2020-07-14-170309,170309,0,0,0,511,0.1,119.38471184085503,1
2020-07-15-170309,170309,0,0,0,511,0.4,87.21256191568058,2
2020-07-16-170309,170309,0,0,0,511,0.1,31.130996342559236,3
2020-07-17-170309,170309,0,5,0,511,0.1,36.861516205973714,4
2020-07-18-170309,170309,1,0,1,512,0.1,32.49953162776389,5
2020-07-19-170309,170309,0,0,0,512,0.2,40.81763231058049,6
2020-07-20-170309,170309,0,0,0,512,0.2,52.39519269808902,0
2020-07-21-170309,170309,0,0,0,512,0.1,52.190244330942946,1
2020-07-22-170309,170309,0,0,1,512,0.2,53.64463198506093,2
2020-07-23-170309,170309,1,0,9,513,0.4,51.927366717997806,3
2020-07-24-170309,170309,1,0,2,514,0.5,65.36580537031176,4
2020-07-25-170309,170309,0,0,0,514,0.0,74.50023386993402,5
2020-07-26-170309,170309,0,0,0,514,0.1,72.51887696353425,6
2020-07-27-170309,170309,1,0,0,515,0.1,48.50394385483543,0
2020-07-28-170309,170309,0,0,0,515,0.2,52.268491903886044,1
2020-07-29-170309,170309,0,0,4,515,0.2,55.065957676974534,2
2020-07-30-170309,170309,0,0,0,515,0.7,44.71670380288536,3
2020-07-31-170309,170309,0,1,0,515,0.7,38.55760040818575,4
2020-08-01-170309,170309,1,0,7,516,0.0,64.95024522233913,5
2020-08-02-170309,170309,0,0,0,516,0.2,124.50978992067306,6
2020-08-03-170309,170309,0,0,0,516,0.4,382.0603134173913,0
2020-08-04-170309,170309,0,0,1,516,0.4,523.3163873506168,1
2020-08-05-170309,170309,1,0,0,517,0.5,441.0846626512128,2
2020-08-06-170309,170309,9,0,1,526,0.4,365.05265446514824,3
2020-08-07-170309,170309,2,0,0,528,0.0,326.9070547079566,4
2020-08-08-170309,170309,0,0,0,528,0.1,338.03785509906066,5
2020-08-09-170309,170309,0,0,0,528,0.3,337.64815488050044,6
2020-08-10-170309,170309,0,0,0,528,0.7,66.4882609092204,0
2020-08-11-170309,170309,0,0,2,528,0.4,86.19629957043938,1
2020-08-12-170309,170309,4,0,3,532,0.3,99.5528545843671,2
2020-08-13-170309,170309,0,0,4,532,0.3,110.05814385015273,3
2020-08-14-170309,170309,0,0,1,532,0.4,112.21055497279437,4
2020-08-15-170309,170309,7,0,1,539,0.6,113.58899470811491,5
2020-08-16-170309,170309,0,0,19,539,0.5,155.2666157620436,6
2020-08-17-170309,170309,0,0,2,539,0.3,151.44642675844375,0
2020-08-18-170309,170309,1,0,3,540,0.8,134.27681879081155,1
2020-08-19-170309,170309,0,0,0,540,1.4,144.2952932685815,2
2020-08-20-170309,170309,1,0,1,541,1.7,125.2608996651878,3
2020-08-21-170309,170309,0,0,2,541,1.2,144.74766643840536,4
2020-08-22-170309,170309,0,0,0,541,0.5,102.46259524455893,5
2020-08-23-170309,170309,0,1,0,541,0.7,113.86114785687772,6
2020-08-24-170309,170309,0,1,0,541,0.8,116.38070525141742,0
2020-08-25-170309,170309,2,0,2,543,2.1,117.01328719734451,1
2020-08-26-170309,170309,3,0,2,546,2.5,141.3643448147067,2
2020-08-27-170309,170309,4,0,0,550,3.0,235.17384166497422,3
2020-08-28-170309,170309,1,0,3,551,3.0,299.2495697758131,4
2020-08-29-170309,170309,1,0,0,552,0.3,391.0062302108366,5
2020-08-30-170309,170309,19,0,0,571,0.8,381.6551606617679,6
2020-08-31-170309,170309,2,0,2,573,2.1,504.439952481827,0
2020-09-01-170309,170309,3,1,9,576,1.1,167.5995706467924,1
2020-09-02-170309,170309,0,0,1,576,2.4,428.15629007024336,2
2020-09-03-170309,170309,1,0,3,577,2.6,452.62592528500033,3
2020-09-04-170309,170309,2,0,1,579,2.2,430.6306867895043,4
2020-09-05-170309,170309,0,1,0,579,0.7,389.4026378675875,5
2020-09-06-170309,170309,0,0,3,579,0.6,339.2134741666638,6
2020-09-07-170309,170309,0,0,2,579,1.1,341.8672533624799,0
2020-09-08-170309,170309,2,0,3,581,1.6,296.38227975174095,1
2020-09-09-170309,170309,2,0,1,583,4.1,260.254135344796,2
2020-09-10-170309,170309,0,0,2,583,1.8,170.0301007115553,3
2020-09-11-170309,170309,3,0,1,586,1.6,189.2112586001882,4
2020-09-12-170309,170309,0,0,1,586,0.8,229.5231125946362,5
2020-09-13-170309,170309,0,1,1,586,1.3,190.5153167638824,6
2020-09-14-170309,170309,2,0,4,588,1.8,195.41609871638985,0
2020-09-15-170309,170309,9,0,6,597,2.7,264.71923033814005,1
2020-09-16-170309,170309,1,0,2,598,2.8,371.2179308617758,2
2020-09-17-170309,170309,3,0,2,601,3.9,371.61322043532755,3
2020-09-18-170309,170309,1,1,1,602,3.0,388.31116666112496,4
2020-09-19-170309,170309,0,0,2,602,1.2,393.48230263768596,5
2020-09-20-170309,170309,3,0,0,605,0.9,402.32031495297235,6
2020-09-21-170309,170309,2,1,2,607,3.2,365.63929816559494,0
2020-09-22-170309,170309,3,1,5,610,4.9,300.22449483883236,1
2020-09-23-170309,170309,1,0,2,611,3.3,340.3948485363275,2
2020-09-24-170309,170309,2,0,2,613,8.6,338.44486019355327,3
2020-09-25-170309,170309,1,0,3,614,4.0,362.5675869292045,4
2020-09-26-170309,170309,1,0,0,615,1.4,415.86249843995705,5
2020-09-27-170309,170309,1,0,2,616,0.3,418.38651847100857,6
2020-09-28-170309,170309,4,0,1,620,2.4,393.5564480308278,0
2020-09-29-170309,170309,6,0,1,626,3.5,415.93874031674716,1
2020-09-30-170309,170309,2,0,2,628,3.2,393.58854623032414,2
2020-10-01-170309,170309,2,0,3,630,6.0,0.0,3
2020-10-02-170309,170309,1,0,1,631,4.8,624.8561301381335,4
2020-10-03-170309,170309,2,0,3,633,2.5,626.9665824245411,5
2020-10-04-170309,170309,0,1,0,633,0.2,692.1450069710106,6
2020-10-05-170309,170309,2,0,0,635,3.3,608.1130983483484,0
2020-10-06-170309,170309,5,0,1,640,2.9,599.7471493622347,1
2020-10-07-170309,170309,2,0,3,642,2.4,613.9343290881711,2
2020-10-08-170309,170309,2,0,4,644,2.8,508.3437960060255,3
2020-10-09-170309,170309,3,3,2,647,8.7,560.2050732498916,4
2020-10-10-170309,170309,0,0,2,647,1.0,108.85912575679747,5
2020-10-11-170309,170309,2,0,0,649,1.8,137.62545781165363,6
2020-10-12-170309,170309,1,0,2,650,0.6,211.15791376913108,0
2020-10-13-170309,170309,1,0,1,651,4.3,224.8781644655175,1
2020-10-14-170309,170309,2,0,3,653,6.0,312.875662625504,2
2020-10-15-170309,170309,3,0,4,656,8.0,404.9951909694363,3
2020-10-16-170309,170309,1,0,10,657,6.6,518.9327717423026,4
2020-10-17-170309,170309,3,0,7,660,1.6,536.5572104264284,5
2020-10-18-170309,170309,0,0,0,660,1.6,568.3955296012869,6
2020-10-19-170309,170309,0,1,2,660,4.6,525.3932196036658,0
2020-10-20-170309,170309,1,0,0,661,4.7,590.7351560124894,1
2020-10-21-170309,170309,3,0,0,664,3.0,574.0436896433962,2
2020-10-22-170309,170309,4,0,27,668,4.7,532.0173770258701,3
2020-10-23-170309,170309,2,0,5,670,9.9,521.8901023315328,4
2020-10-24-170309,170309,2,0,1,672,2.0,558.4088191852896,5
2020-10-25-170309,170309,0,1,1,672,2.4,581.2641291224189,6
2020-10-26-170309,170309,2,0,5,674,4.3,530.5116980649782,0
2020-10-27-170309,170309,1,1,3,675,3.9,542.2576545864549,1
2020-10-28-170309,170309,3,1,2,678,5.3,541.6947936573723,2
2020-10-29-170309,170309,4,0,5,682,8.5,553.1353311308762,3
2020-10-30-170309,170309,10,1,2,692,7.6,529.3874598391772,4
2020-10-31-170309,170309,7,0,0,699,2.4,607.9765037949486,5
2020-11-01-170309,170309,0,1,0,699,2.9,524.1881425184066,6
2020-11-02-170309,170309,2,0,0,701,1.1,479.1553503135832,0
2020-11-03-170309,170309,0,0,0,701,5.3,415.6384261903979,1
2020-11-04-170309,170309,0,1,0,701,3.2,498.51411025301354,2
2020-11-05-170309,170309,27,0,0,728,6.6,458.58275178073325,3
2020-11-06-170309,170309,5,2,0,733,7.2,614.0485059314115,4
2020-11-07-170309,170309,1,1,0,734,3.8,657.9284464769701,5
2020-11-08-170309,170309,1,1,0,735,1.2,617.9308159285144,6
2020-11-09-170309,170309,5,2,0,740,5.0,585.7398315573123,0
2020-11-10-170309,170309,3,1,0,743,4.3,427.4946938624812,1
2020-11-11-170309,170309,2,5,0,745,7.7,488.648842175905,2
2020-11-12-170309,170309,5,2,0,750,6.8,506.6135510563775,3
2020-11-13-170309,170309,2,2,0,752,9.7,495.6765187198516,4
2020-03-01-170310,170310,0,0,0,0,0.0,0.0,6
2020-03-02-170310,170310,0,0,0,0,0.0,11.822047571726143,0
2020-03-03-170310,170310,0,0,0,0,0.0,57.13429242820858,1
2020-03-04-170310,170310,0,0,0,0,0.0,54.17135211532727,2
2020-03-05-170310,170310,0,0,0,0,0.0,56.65529159394008,3
2020-03-06-170310,170310,0,0,0,0,0.14285714285714285,52.308405765776435,4
2020-03-07-170310,170310,0,0,1,0,0.14285714285714285,51.58260693630938,5
2020-03-08-170310,170310,0,0,0,0,0.0,46.505878487196824,6
2020-03-09-170310,170310,0,0,0,0,0.2857142857142857,46.45203727813302,0
2020-03-10-170310,170310,0,0,0,0,0.14285714285714285,124.6235222763942,1
2020-03-11-170310,170310,0,0,3,0,0.0,100.74930326023046,2
2020-03-12-170310,170310,0,0,0,0,0.2857142857142857,77.19226678748748,3
2020-03-13-170310,170310,0,0,0,0,0.14285714285714285,52.896170728324556,4
2020-03-14-170310,170310,0,0,0,0,0.2857142857142857,41.30471318665302,5
2020-03-15-170310,170310,0,0,0,0,0.5714285714285714,31.54288387143367,6
2020-03-16-170310,170310,0,0,0,0,2.0,8.407580605852575,0
2020-03-17-170310,170310,0,0,0,0,5.285714285714286,20.33109914444227,1
2020-03-18-170310,170310,0,0,0,0,5.0,35.511446438525184,2
2020-03-19-170310,170310,0,0,1,0,4.571428571428571,55.83459058116684,3
2020-03-20-170310,170310,0,0,0,0,4.428571428571429,73.94647861910329,4
2020-03-21-170310,170310,1,0,0,1,1.8571428571428568,84.89066152098138,5
2020-03-22-170310,170310,0,0,0,1,1.2857142857142858,87.32112738857805,6
2020-03-23-170310,170310,0,0,0,1,8.428571428571429,83.00203987428725,0
2020-03-24-170310,170310,0,0,0,1,7.7142857142857135,92.67930218440844,1
2020-03-25-170310,170310,3,0,0,4,7.571428571428571,97.0783184086985,2
2020-03-26-170310,170310,0,0,0,4,5.285714285714286,103.34831812858516,3
2020-03-27-170310,170310,0,0,0,4,5.285714285714286,117.69827740218372,4
2020-03-28-170310,170310,0,0,0,4,2.0,119.16743432397034,5
2020-03-29-170310,170310,0,0,0,4,2.571428571428572,120.85533685821709,6
2020-03-30-170310,170310,0,0,2,4,4.0,103.4194770687154,0
2020-03-31-170310,170310,0,0,0,4,4.142857142857143,93.08375768722121,1
2020-04-01-170310,170310,0,0,0,4,4.0,12.816178015729918,2
2020-04-02-170310,170310,1,0,0,5,3.8571428571428568,40.51167053831145,3
2020-04-03-170310,170310,0,0,0,5,2.8571428571428568,30.69109063942182,4
2020-04-04-170310,170310,0,0,0,5,1.5714285714285714,34.34373306053257,5
2020-04-05-170310,170310,0,0,0,5,0.5714285714285714,37.228165064875824,6
2020-04-06-170310,170310,0,0,0,5,4.285714285714286,37.29882913275686,0
2020-04-07-170310,170310,0,0,0,5,3.4285714285714284,42.34341180894916,1
2020-04-08-170310,170310,0,0,0,5,2.8571428571428568,47.49471958448129,2
2020-04-09-170310,170310,0,1,0,5,2.8571428571428568,50.714383728152484,3
2020-04-10-170310,170310,0,0,0,5,2.0,9.984551784025873,4
2020-04-11-170310,170310,0,0,0,5,1.0,17.76712454578186,5
2020-04-12-170310,170310,0,0,0,5,3.7142857142857135,21.30467156456514,6
2020-04-13-170310,170310,2,0,0,7,1.8571428571428568,24.29805237681721,0
2020-04-14-170310,170310,0,0,0,7,3.7142857142857135,35.497975310792526,1
2020-04-15-170310,170310,0,0,0,7,1.2857142857142858,43.75600451954121,2
2020-04-16-170310,170310,0,0,0,7,1.4285714285714286,48.459705886030484,3
2020-04-17-170310,170310,0,0,0,7,2.0,46.33144188527591,4
2020-04-18-170310,170310,0,0,0,7,0.14285714285714285,44.01202745209265,5
2020-04-19-170310,170310,0,0,0,7,0.42857142857142855,41.700874954827356,6
2020-04-20-170310,170310,0,0,0,7,1.7142857142857142,43.40233050476142,0
2020-04-21-170310,170310,0,0,0,7,1.2857142857142858,40.58459808049535,1
2020-04-22-170310,170310,0,0,0,7,1.8571428571428568,41.35876130620619,2
2020-04-23-170310,170310,0,0,0,7,0.5714285714285714,42.11294048868355,3
2020-04-24-170310,170310,0,0,0,7,6.2857142857142865,37.38559096783079,4
2020-04-25-170310,170310,0,0,0,7,0.5714285714285714,45.03732296649841,5
2020-04-26-170310,170310,0,0,2,7,0.42857142857142855,44.38952198366197,6
2020-04-27-170310,170310,0,0,0,7,1.5714285714285714,33.101752368250246,0
2020-04-28-170310,170310,0,0,0,7,2.142857142857143,31.944819303565957,1
2020-04-29-170310,170310,0,0,0,7,2.0,30.95315207823115,2
2020-04-30-170310,170310,0,0,0,7,1.4285714285714286,40.05541649046081,3
2020-05-01-170310,170310,0,0,0,7,0.2857142857142857,50.93492275896347,4
2020-05-02-170310,170310,0,0,0,7,0.2857142857142857,16.81812967577055,5
2020-05-03-170310,170310,0,0,0,7,0.14285714285714285,17.327566731071457,6
2020-05-04-170310,170310,0,0,0,7,2.0,15.217912964696009,0
2020-05-05-170310,170310,0,0,0,7,1.8571428571428568,16.78154178802071,1
2020-05-06-170310,170310,0,0,0,7,1.4285714285714286,18.029377838044333,2
2020-05-07-170310,170310,0,0,0,7,0.2857142857142857,18.052803625472073,3
2020-05-08-170310,170310,0,0,0,7,1.2857142857142858,18.55292889605767,4
2020-05-09-170310,170310,0,0,0,7,0.5714285714285714,22.739464067408598,5
2020-05-10-170310,170310,2,0,0,9,0.2857142857142857,56.94831646374878,6
2020-05-11-170310,170310,0,0,1,9,1.5714285714285714,55.57089554152425,0
2020-05-12-170310,170310,0,0,0,9,1.7142857142857142,57.98934253661666,1
2020-05-13-170310,170310,0,0,0,9,1.2857142857142858,50.31565711506259,2
2020-05-14-170310,170310,0,1,0,9,1.2857142857142858,42.31837934276034,3
2020-05-15-170310,170310,0,0,0,9,2.0,34.7382148999232,4
2020-05-16-170310,170310,0,2,0,9,0.14285714285714285,28.897947115673873,5
2020-05-17-170310,170310,0,0,0,9,0.0,27.502923959272234,6
2020-05-18-170310,170310,0,0,0,9,0.8571428571428571,23.75927631041555,0
2020-05-19-170310,170310,0,0,0,9,1.1428571428571428,25.465015481582938,1
2020-05-20-170310,170310,0,0,0,9,0.42857142857142855,21.757709200214876,2
2020-05-21-170310,170310,0,0,0,9,0.8571428571428571,22.977036374210428,3
2020-05-22-170310,170310,0,0,0,9,0.2857142857142857,19.36750785579526,4
2020-05-23-170310,170310,0,0,0,9,0.2857142857142857,24.487162955076847,5
2020-05-24-170310,170310,0,0,0,9,0.0,24.270932922897313,6
2020-05-25-170310,170310,1,0,0,10,0.5714285714285714,17.974219954928046,0
2020-05-26-170310,170310,0,0,0,10,0.8571428571428571,20.196851686355505,1
2020-05-27-170310,170310,0,0,0,10,0.8571428571428571,23.942809062770714,2
2020-05-28-170310,170310,0,4,0,10,1.8571428571428568,25.181234883558894,3
2020-05-29-170310,170310,0,0,0,10,1.2857142857142858,27.33450752631365,4
2020-05-30-170310,170310,0,0,0,10,0.0,26.608510944135617,5
2020-05-31-170310,170310,0,0,0,10,0.14285714285714285,28.173094612951644,6
2020-06-01-170310,170310,0,0,0,10,1.5714285714285714,31.24847748907868,0
2020-06-02-170310,170310,0,0,1,10,1.2857142857142858,14.55353120733209,1
2020-06-03-170310,170310,0,0,0,10,0.5714285714285714,9.343260211513346,2
2020-06-04-170310,170310,0,0,0,10,1.0,9.338575568226668,3
2020-06-05-170310,170310,0,0,0,10,0.7142857142857143,11.573917166365941,4
2020-06-06-170310,170310,0,0,0,10,0.0,14.157714002771613,5
2020-06-07-170310,170310,0,2,0,10,0.14285714285714285,15.001190835538067,6
2020-06-08-170310,170310,0,0,0,10,0.14285714285714285,16.30304153538338,0
2020-06-09-170310,170310,0,0,0,10,1.1428571428571428,14.506509316991167,1
2020-06-10-170310,170310,0,0,0,10,1.1428571428571428,37.473743367202204,2
2020-06-11-170310,170310,0,0,0,10,0.42857142857142855,32.264889728847315,3
2020-06-12-170310,170310,0,0,0,10,0.7142857142857143,28.237683103144377,4
2020-06-13-170310,170310,0,0,0,10,0.0,25.457758501301882,5
2020-06-14-170310,170310,0,0,0,10,0.0,21.931437847674808,6
2020-06-15-170310,170310,0,0,0,10,0.5714285714285714,16.587991946728778,0
2020-06-16-170310,170310,1,0,0,11,0.42857142857142855,16.701821823229565,1
2020-06-17-170310,170310,0,0,0,11,0.5714285714285714,16.78152640038228,2
2020-06-18-170310,170310,0,0,0,11,0.2857142857142857,16.598811389380444,3
2020-06-19-170310,170310,0,1,0,11,0.0,16.17472464677102,4
2020-06-20-170310,170310,0,0,0,11,0.14285714285714285,17.07572312177026,5
2020-06-21-170310,170310,0,0,0,11,0.0,18.19110791356414,6
2020-06-22-170310,170310,0,0,0,11,0.42857142857142855,15.725587636862784,0
2020-06-23-170310,170310,0,0,0,11,0.14285714285714285,14.05691251703999,1
2020-06-24-170310,170310,0,0,0,11,0.5714285714285714,11.873777895450962,2
2020-06-25-170310,170310,0,0,0,11,0.2857142857142857,14.368991475273646,3
2020-06-26-170310,170310,0,0,0,11,0.14285714285714285,14.4130303972644,4
2020-06-27-170310,170310,0,0,0,11,0.0,11.747865934441482,5
2020-06-28-170310,170310,0,0,0,11,0.0,11.196234539778157,6
2020-06-29-170310,170310,0,0,0,11,0.2857142857142857,10.757525930488859,0
2020-06-30-170310,170310,0,0,0,11,0.2857142857142857,12.822238616073548,1
2020-07-01-170310,170310,0,0,0,11,0.5714285714285714,18.36302908776181,2
2020-07-02-170310,170310,0,0,0,11,0.5714285714285714,9.933251794198593,3
2020-07-03-170310,170310,0,0,0,11,0.14285714285714285,8.97922626959973,4
2020-07-04-170310,170310,0,0,0,11,0.0,9.341302547372795,5
2020-07-05-170310,170310,0,0,0,11,0.14285714285714285,9.498867006034141,6
2020-07-06-170310,170310,0,0,0,11,0.0,8.012265017376976,0
2020-07-07-170310,170310,0,0,0,11,0.14285714285714285,7.950301631073375,1
2020-07-08-170310,170310,0,0,0,11,0.5714285714285714,7.143865968342786,2
2020-07-09-170310,170310,0,0,0,11,0.42857142857142855,8.295233005733337,3
2020-07-10-170310,170310,0,0,0,11,0.0,21.6762847349587,4
2020-07-11-170310,170310,0,0,0,11,0.0,21.46655161316701,5
2020-07-12-170310,170310,0,0,0,11,0.0,17.573099842292045,6
2020-07-13-170310,170310,0,0,0,11,0.42857142857142855,16.172091773223144,0
2020-07-14-170310,170310,0,0,0,11,0.0,18.086084781944166,1
2020-07-15-170310,170310,0,0,0,11,0.0,17.84970013432489,2
2020-07-16-170310,170310,0,0,0,11,0.14285714285714285,14.19660904049896,3
2020-07-17-170310,170310,0,0,0,11,0.0,11.126905488762755,4
2020-07-18-170310,170310,0,0,0,11,0.14285714285714285,8.243301319249948,5
2020-07-19-170310,170310,0,0,0,11,0.0,9.14998493904616,6
2020-07-20-170310,170310,0,0,0,11,0.0,10.770758241590034,0
2020-07-21-170310,170310,0,0,0,11,0.0,11.655362462711807,1
2020-07-22-170310,170310,0,0,0,11,0.5714285714285714,14.452958463818938,2
2020-07-23-170310,170310,0,0,0,11,0.14285714285714285,14.49812743510456,3
2020-07-24-170310,170310,0,0,0,11,0.14285714285714285,16.55698609929782,4
2020-07-25-170310,170310,0,0,0,11,0.0,16.809578524337994,5
2020-07-26-170310,170310,0,0,0,11,0.0,14.487713172930324,6
2020-07-27-170310,170310,0,0,0,11,0.14285714285714285,13.027503544420327,0
2020-07-28-170310,170310,0,0,0,11,0.0,12.824405008268926,1
2020-07-29-170310,170310,0,0,0,11,0.0,10.42766911925982,2
2020-07-30-170310,170310,0,0,0,11,0.2857142857142857,8.653863021021973,3
2020-07-31-170310,170310,0,0,0,11,0.42857142857142855,9.860776763580226,4
2020-08-01-170310,170310,0,0,0,11,0.14285714285714285,8.177125033799278,5
2020-08-02-170310,170310,0,0,0,11,0.14285714285714285,21.79350613627941,6
2020-08-03-170310,170310,0,0,0,11,0.2857142857142857,41.0239319430911,0
2020-08-04-170310,170310,0,0,0,11,0.14285714285714285,45.50934867190256,1
2020-08-05-170310,170310,0,0,0,11,0.42857142857142855,38.06283347677694,2
2020-08-06-170310,170310,0,0,0,11,1.5714285714285714,32.368551058764574,3
2020-08-07-170310,170310,0,0,0,11,0.5714285714285714,28.230010370141862,4
2020-08-08-170310,170310,0,1,0,11,0.2857142857142857,31.164225856490006,5
2020-08-09-170310,170310,0,0,0,11,0.8571428571428571,28.296365005673493,6
2020-08-10-170310,170310,0,0,0,11,0.2857142857142857,7.8454540292418775,0
2020-08-11-170310,170310,0,0,0,11,0.5714285714285714,12.637910372267385,1
2020-08-12-170310,170310,0,0,0,11,0.8571428571428571,15.555804857025883,2
2020-08-13-170310,170310,0,0,1,11,0.2857142857142857,17.311687230069204,3
2020-08-14-170310,170310,0,0,0,11,0.14285714285714285,19.00533316034871,4
2020-08-15-170310,170310,0,0,0,11,1.0,21.84975192343674,5
2020-08-16-170310,170310,0,0,0,11,0.8571428571428571,23.40273908579556,6
2020-08-17-170310,170310,0,0,0,11,0.2857142857142857,24.560620128888587,0
2020-08-18-170310,170310,0,0,0,11,0.7142857142857143,21.965566994958948,1
2020-08-19-170310,170310,0,0,0,11,0.42857142857142855,23.25533777339344,2
2020-08-20-170310,170310,0,0,2,11,0.8571428571428571,20.262711258282124,3
2020-08-21-170310,170310,0,0,0,11,0.2857142857142857,20.255247568198804,4
2020-08-22-170310,170310,0,0,0,11,0.8571428571428571,21.953890383504955,5
2020-08-23-170310,170310,0,0,0,11,0.2857142857142857,24.066497099059276,6
2020-08-24-170310,170310,0,0,0,11,0.42857142857142855,21.811491913799273,0
2020-08-25-170310,170310,0,0,1,11,0.5714285714285714,20.780212562372682,1
2020-08-26-170310,170310,0,0,0,11,1.8571428571428568,22.452627013802214,2
2020-08-27-170310,170310,1,0,0,12,1.0,33.392512404227155,3
2020-08-28-170310,170310,0,0,0,12,1.2857142857142858,39.318058336251624,4
2020-08-29-170310,170310,0,0,0,12,0.5714285714285714,43.32261045714762,5
2020-08-30-170310,170310,0,0,0,12,3.0,45.39962103694517,6
2020-08-31-170310,170310,0,0,0,12,1.1428571428571428,46.21135895505742,0
2020-09-01-170310,170310,0,0,0,12,1.2857142857142858,26.516885215470644,1
2020-09-02-170310,170310,0,0,0,12,0.42857142857142855,53.94691953352532,2
2020-09-03-170310,170310,2,0,0,14,8.285714285714286,60.32390074153309,3
2020-09-04-170310,170310,0,0,0,14,2.8571428571428568,63.277246632978645,4
2020-09-05-170310,170310,0,0,0,14,0.7142857142857143,60.399437859937656,5
2020-09-06-170310,170310,0,0,0,14,2.571428571428572,59.93798446533281,6
2020-09-07-170310,170310,0,0,0,14,2.2857142857142856,58.894604519023616,0
2020-09-08-170310,170310,1,0,0,15,2.142857142857143,49.84950486558898,1
2020-09-09-170310,170310,0,0,0,15,1.4285714285714286,47.75629107072108,2
2020-09-10-170310,170310,0,0,0,15,3.4285714285714284,28.881315653092333,3
2020-09-11-170310,170310,0,0,0,15,1.8571428571428568,30.4972366372978,4
2020-09-12-170310,170310,0,0,0,15,0.7142857142857143,36.485560337429845,5
2020-09-13-170310,170310,0,0,0,15,0.2857142857142857,37.50545078917405,6
2020-09-14-170310,170310,0,0,0,15,1.0,34.05660929126813,0
2020-09-15-170310,170310,0,0,0,15,2.7142857142857144,38.13010413393559,1
2020-09-16-170310,170310,0,0,0,15,1.5714285714285714,43.17515050912077,2
2020-09-17-170310,170310,0,0,1,15,6.857142857142858,41.00670835120053,3
2020-09-18-170310,170310,0,0,0,15,2.2857142857142856,47.660772203732236,4
2020-09-19-170310,170310,0,0,0,15,0.7142857142857143,47.4494224482562,5
2020-09-20-170310,170310,0,0,0,15,1.1428571428571428,47.74687221498788,6
2020-09-21-170310,170310,0,1,0,15,3.1428571428571432,43.71832102604601,0
2020-09-22-170310,170310,0,0,0,15,3.1428571428571432,43.84206373465321,1
2020-09-23-170310,170310,0,0,0,15,1.8571428571428568,53.666668673898016,2
2020-09-24-170310,170310,0,0,0,15,1.8571428571428568,51.001843799747306,3
2020-09-25-170310,170310,0,0,0,15,1.7142857142857142,50.37302902704118,4
2020-09-26-170310,170310,0,0,0,15,0.2857142857142857,53.514380576266475,5
2020-09-27-170310,170310,0,0,0,15,0.5714285714285714,53.07062089178395,6
2020-09-28-170310,170310,0,0,0,15,1.1428571428571428,56.05298811695569,0
2020-09-29-170310,170310,0,0,1,15,2.142857142857143,57.69108381168981,1
2020-09-30-170310,170310,0,0,0,15,1.5714285714285714,54.19567950704359,2
2020-10-01-170310,170310,1,0,0,16,2.2857142857142856,0.0,3
2020-10-02-170310,170310,0,0,0,16,2.7142857142857144,97.0059486549027,4
2020-10-03-170310,170310,0,0,0,16,1.2857142857142858,135.2625496444702,5
2020-10-04-170310,170310,0,0,0,16,0.2857142857142857,150.60333749337065,6
2020-10-05-170310,170310,0,0,1,16,3.8571428571428568,133.91868106724212,0
2020-10-06-170310,170310,0,0,2,16,2.8571428571428568,125.26888686556651,1
2020-10-07-170310,170310,0,0,0,16,2.8571428571428568,118.65378551181843,2
2020-10-08-170310,170310,0,0,0,16,2.8571428571428568,106.91266705832334,3
2020-10-09-170310,170310,0,0,0,16,3.1428571428571432,117.25254567860995,4
2020-10-10-170310,170310,0,0,0,16,1.2857142857142858,14.957100576129093,5
2020-10-11-170310,170310,0,0,0,16,2.0,37.2970736758446,6
2020-10-12-170310,170310,0,0,0,16,0.8571428571428571,50.753433063329446,0
2020-10-13-170310,170310,1,0,0,17,2.142857142857143,61.96496944693403,1
2020-10-14-170310,170310,0,0,0,17,2.0,77.22558890857277,2
2020-10-15-170310,170310,0,0,0,17,1.7142857142857142,92.51557379193896,3
2020-10-16-170310,170310,0,0,0,17,2.7142857142857144,103.07477478683816,4
2020-10-17-170310,170310,0,0,0,17,1.7142857142857142,107.43724786719278,5
2020-10-18-170310,170310,0,0,0,17,1.8571428571428568,97.9957438652866,6
2020-10-19-170310,170310,1,0,0,18,2.142857142857143,95.07815648186386,0
2020-10-20-170310,170310,2,0,0,20,3.571428571428572,93.46982284861993,1
2020-10-21-170310,170310,0,0,0,20,3.8571428571428568,106.14885257532171,2
2020-10-22-170310,170310,0,0,0,20,4.428571428571429,114.8098402977077,3
2020-10-23-170310,170310,0,0,0,20,7.571428571428571,118.57348974304382,4
2020-10-24-170310,170310,0,0,0,20,3.0,128.5155920720924,5
2020-10-25-170310,170310,0,0,0,20,1.2857142857142858,129.19344228341384,6
2020-10-26-170310,170310,0,0,0,20,4.428571428571429,119.40290565235729,0
2020-10-27-170310,170310,0,0,0,20,7.428571428571429,125.79189924320531,1
2020-10-28-170310,170310,0,0,0,20,3.4285714285714284,121.92415649470298,2
2020-10-29-170310,170310,0,0,0,20,5.428571428571429,118.48759042664729,3
2020-10-30-170310,170310,0,0,0,20,9.428571428571429,102.40810965337572,4
2020-10-31-170310,170310,0,0,0,20,3.8571428571428568,116.350636380853,5
2020-11-01-170310,170310,0,0,0,20,3.1428571428571432,92.52300336135671,6
2020-11-02-170310,170310,0,0,0,20,3.571428571428572,92.73103691712008,0
2020-11-03-170310,170310,0,0,0,20,3.2857142857142856,89.10532116109778,1
2020-11-04-170310,170310,0,0,0,20,4.142857142857143,104.46756136899592,2
2020-11-05-170310,170310,0,0,0,20,7.428571428571429,116.7640370406684,3
2020-11-06-170310,170310,0,0,0,20,6.428571428571429,125.30471398075876,4
2020-11-07-170310,170310,0,0,0,20,1.8571428571428568,136.80451485323982,5
2020-11-08-170310,170310,0,0,0,20,1.4285714285714286,136.8932123514101,6
2020-11-09-170310,170310,0,0,0,20,3.8571428571428568,132.18015795912416,0
2020-11-10-170310,170310,0,0,0,20,2.4285714285714284,81.65190775145106,1
2020-11-11-170310,170310,0,0,0,20,4.0,91.02128115169222,2
2020-11-12-170310,170310,0,0,0,20,2.4285714285714284,107.94378860385686,3
2020-11-13-170310,170310,0,0,0,20,3.0,113.7328491052869,4
2020-03-01-170311,170311,0,0,0,0,0.0,0.0,6
2020-03-02-170311,170311,0,0,2,0,0.0,23.39791757908315,0
2020-03-03-170311,170311,0,0,2,0,0.0,85.44424618595812,1
2020-03-04-170311,170311,0,0,0,0,0.0,100.41137546733619,2
2020-03-05-170311,170311,0,0,3,0,0.0,107.47253673899752,3
2020-03-06-170311,170311,0,0,1,0,0.0,98.61387692727033,4
2020-03-07-170311,170311,0,0,1,0,0.0,105.01068447819411,5
2020-03-08-170311,170311,0,0,3,0,0.0,92.66116901160471,6
2020-03-09-170311,170311,0,0,0,0,0.0,94.38938617989919,0
2020-03-10-170311,170311,0,0,3,0,0.0,224.29254466453946,1
2020-03-11-170311,170311,0,0,0,0,0.0,190.79300898010524,2
2020-03-12-170311,170311,0,0,4,0,0.0,139.2453303250376,3
2020-03-13-170311,170311,1,0,1,1,0.0,96.32551670269825,4
2020-03-14-170311,170311,1,0,1,2,0.75,57.21113417617141,5
2020-03-15-170311,170311,0,0,2,2,1.125,57.71681494874341,6
2020-03-16-170311,170311,2,0,2,4,4.25,19.94417105771307,0
2020-03-17-170311,170311,2,0,1,6,6.125,42.16637579769521,1
2020-03-18-170311,170311,0,0,1,6,6.0,89.74831669950856,2
2020-03-19-170311,170311,3,0,1,9,7.875,109.16261124904314,3
2020-03-20-170311,170311,1,0,0,10,5.125,133.8668846733241,4
2020-03-21-170311,170311,1,0,2,11,2.0,135.40761286739325,5
2020-03-22-170311,170311,3,0,0,14,4.125,129.33670967410944,6
2020-03-23-170311,170311,0,0,0,14,10.625,130.38172590888826,0
2020-03-24-170311,170311,3,0,0,17,8.0,127.45602956107483,1
2020-03-25-170311,170311,0,0,1,17,8.75,146.4611492711304,2
2020-03-26-170311,170311,4,0,8,21,7.0,145.05904707512872,3
2020-03-27-170311,170311,1,0,0,22,8.625,173.97800574185297,4
2020-03-28-170311,170311,1,0,1,23,2.875,183.56237572346564,5
2020-03-29-170311,170311,2,0,0,25,3.625,185.05610491475855,6
2020-03-30-170311,170311,2,0,1,27,8.125,150.5595298979453,0
2020-03-31-170311,170311,1,0,1,28,6.25,137.6440584544762,1
2020-04-01-170311,170311,1,0,0,29,5.125,21.38921833746755,2
2020-04-02-170311,170311,1,0,0,30,5.0,45.31878258083695,3
2020-04-03-170311,170311,0,0,2,30,4.125,29.780262684439187,4
2020-04-04-170311,170311,2,0,0,32,2.75,31.239484662396308,5
2020-04-05-170311,170311,0,0,0,32,1.0,37.845014120446834,6
2020-04-06-170311,170311,0,0,1,32,5.0,38.5588799819002,0
2020-04-07-170311,170311,0,0,0,32,4.625,52.41654159785774,1
2020-04-08-170311,170311,1,1,2,33,8.25,61.55469922588365,2
2020-04-09-170311,170311,8,0,0,41,3.75,87.01799502923959,3
2020-04-10-170311,170311,0,0,3,41,2.75,17.00553433588918,4
2020-04-11-170311,170311,1,1,0,42,1.125,26.707697913613234,5
2020-04-12-170311,170311,0,0,0,42,1.125,34.08953349487243,6
2020-04-13-170311,170311,1,0,0,43,4.625,38.71538863303742,0
2020-04-14-170311,170311,1,0,0,44,3.75,53.378289547303424,1
2020-04-15-170311,170311,0,1,0,44,2.75,59.24842763918002,2
2020-04-16-170311,170311,0,0,0,44,3.25,63.44756540564356,3
2020-04-17-170311,170311,2,0,1,46,2.375,55.6809143346522,4
2020-04-18-170311,170311,0,0,0,46,0.625,57.147337411279075,5
2020-04-19-170311,170311,0,0,1,46,0.5,49.379531555814054,6
2020-04-20-170311,170311,1,0,3,47,4.0,47.282655508405256,0
2020-04-21-170311,170311,0,1,0,47,6.875,57.4153153187161,1
2020-04-22-170311,170311,2,0,1,49,1.75,70.40334214757614,2
2020-04-23-170311,170311,0,0,0,49,0.625,74.55086806742315,3
2020-04-24-170311,170311,3,0,1,52,2.125,65.11399435186743,4
2020-04-25-170311,170311,0,0,0,52,1.375,80.68337734148989,5
2020-04-26-170311,170311,0,0,1,52,0.375,81.69777663878315,6
2020-04-27-170311,170311,0,0,0,52,2.125,65.85908741320144,0
2020-04-28-170311,170311,0,0,0,52,2.375,54.63582554027518,1
2020-04-29-170311,170311,0,0,0,52,1.25,41.80478014588525,2
2020-04-30-170311,170311,0,0,1,52,0.875,48.235460321635024,3
2020-05-01-170311,170311,1,0,2,53,0.875,98.04882537121797,4
2020-05-02-170311,170311,0,0,0,53,1.0,28.583139717129427,5
2020-05-03-170311,170311,1,0,0,54,0.5,25.04473847463146,6
2020-05-04-170311,170311,3,0,0,57,1.625,24.192139962013457,0
2020-05-05-170311,170311,0,0,0,57,1.375,33.88933872305152,1
2020-05-06-170311,170311,1,0,0,58,1.625,38.42130383871516,2
2020-05-07-170311,170311,0,0,1,58,1.375,44.95212984872275,3
2020-05-08-170311,170311,1,0,0,59,2.125,41.3185129868582,4
2020-05-09-170311,170311,0,0,0,59,1.0,50.667964588952195,5
2020-05-10-170311,170311,1,0,0,60,0.25,120.32733680607213,6
2020-05-11-170311,170311,0,0,0,60,1.25,109.12706145378256,0
2020-05-12-170311,170311,0,0,0,60,1.25,109.35153402876264,1
2020-05-13-170311,170311,0,0,0,60,0.875,95.35502282877732,2
2020-05-14-170311,170311,1,2,0,61,1.375,83.2727195689063,3
2020-05-15-170311,170311,2,0,0,63,1.625,56.00583039888102,4
2020-05-16-170311,170311,0,0,0,63,0.125,44.6711614317308,5
2020-05-17-170311,170311,0,1,0,63,0.375,38.24093388311227,6
2020-05-18-170311,170311,0,0,0,63,2.125,38.806470752321246,0
2020-05-19-170311,170311,0,0,0,63,1.75,40.51706044367849,1
2020-05-20-170311,170311,0,0,0,63,1.25,32.36481238813986,2
2020-05-21-170311,170311,1,0,2,64,0.625,28.09574683324218,3
2020-05-22-170311,170311,0,0,0,64,3.0,24.777927911290725,4
2020-05-23-170311,170311,0,0,0,64,0.0,34.2585757900857,5
2020-05-24-170311,170311,0,0,0,64,0.125,34.47969745585682,6
2020-05-25-170311,170311,0,0,0,64,1.125,30.543137344801693,0
2020-05-26-170311,170311,0,0,0,64,0.75,32.51296061627862,1
2020-05-27-170311,170311,0,0,0,64,2.0,35.490146131818335,2
2020-05-28-170311,170311,0,0,1,64,1.5,41.63262460020269,3
2020-05-29-170311,170311,0,0,0,64,1.625,41.093961576191134,4
2020-05-30-170311,170311,0,0,0,64,0.125,45.330159374067236,5
2020-05-31-170311,170311,0,0,0,64,0.25,48.09264015038395,6
2020-06-01-170311,170311,0,0,0,64,1.75,77.50503288157302,0
2020-06-02-170311,170311,0,0,1,64,1.625,22.6434385050562,1
2020-06-03-170311,170311,0,0,0,64,1.75,14.991353323447825,2
2020-06-04-170311,170311,2,0,0,66,0.875,19.2953618232394,3
2020-06-05-170311,170311,0,0,0,66,1.25,28.212294510404334,4
2020-06-06-170311,170311,0,0,0,66,0.0,33.10242135514956,5
2020-06-07-170311,170311,0,0,0,66,0.25,33.02698604727067,6
2020-06-08-170311,170311,0,0,0,66,1.625,33.828154640165806,0
2020-06-09-170311,170311,0,0,0,66,1.75,33.51700885070936,1
2020-06-10-170311,170311,0,0,0,66,1.0,84.3713419002676,2
2020-06-11-170311,170311,1,0,0,67,1.375,70.51056507867784,3
2020-06-12-170311,170311,0,0,0,67,1.125,62.43415844262399,4
2020-06-13-170311,170311,0,0,0,67,0.125,51.78122438029766,5
2020-06-14-170311,170311,0,0,0,67,0.125,46.732712335203445,6
2020-06-15-170311,170311,0,0,1,67,0.75,32.31652907216446,0
2020-06-16-170311,170311,1,0,0,68,1.125,35.64522065787645,1
2020-06-17-170311,170311,0,1,0,68,0.625,35.686802349964466,2
2020-06-18-170311,170311,0,0,0,68,0.125,33.298326820138755,3
2020-06-19-170311,170311,0,0,0,68,1.0,25.936195040580937,4
2020-06-20-170311,170311,0,0,0,68,0.125,29.02180938145309,5
2020-06-21-170311,170311,0,0,0,68,0.125,30.248631244818576,6
2020-06-22-170311,170311,0,0,0,68,0.375,23.88887008213122,0
2020-06-23-170311,170311,0,0,0,68,1.5,15.74865647118895,1
2020-06-24-170311,170311,0,0,0,68,0.375,16.386324419323394,2
2020-06-25-170311,170311,0,1,1,68,1.0,16.344910789127862,3
2020-06-26-170311,170311,0,0,0,68,0.25,17.772373623641755,4
2020-06-27-170311,170311,0,0,0,68,0.125,12.61469885679092,5
2020-06-28-170311,170311,0,0,0,68,0.125,13.187340149986465,6
2020-06-29-170311,170311,1,0,1,69,0.625,13.208304819776604,0
2020-06-30-170311,170311,0,1,0,69,0.625,23.210208248318906,1
2020-07-01-170311,170311,0,0,1,69,0.125,45.18094434140065,2
2020-07-02-170311,170311,0,0,0,69,0.25,43.20351176129555,3
2020-07-03-170311,170311,0,0,0,69,0.625,21.16405588401876,4
2020-07-04-170311,170311,0,0,1,69,0.125,33.20026399375857,5
2020-07-05-170311,170311,0,0,0,69,0.125,32.67758168825846,6
2020-07-06-170311,170311,0,0,0,69,0.125,31.536057250387472,0
2020-07-07-170311,170311,0,0,0,69,0.5,29.346092063026564,1
2020-07-08-170311,170311,0,0,0,69,0.375,24.87081346416349,2
2020-07-09-170311,170311,1,0,0,70,0.25,24.906328389565886,3
2020-07-10-170311,170311,0,0,0,70,0.375,45.78468153407304,4
2020-07-11-170311,170311,0,0,0,70,0.0,30.363718970435272,5
2020-07-12-170311,170311,0,0,0,70,0.125,22.52669702752969,6
2020-07-13-170311,170311,1,0,0,71,0.75,22.96644451395461,0
2020-07-14-170311,170311,0,0,0,71,0.375,42.3986227731218,1
2020-07-15-170311,170311,1,0,0,72,0.875,36.91894184803386,2
2020-07-16-170311,170311,0,0,0,72,0.5,28.716917033908835,3
2020-07-17-170311,170311,0,1,0,72,0.625,29.8124441980486,4
2020-07-18-170311,170311,1,0,0,73,0.25,35.53313538975793,5
2020-07-19-170311,170311,0,0,1,73,0.25,48.191140122077954,6
2020-07-20-170311,170311,0,0,0,73,1.5,29.267099973250794,0
2020-07-21-170311,170311,0,0,1,73,0.375,36.925549799234496,1
2020-07-22-170311,170311,0,0,0,73,1.125,36.72574230386051,2
2020-07-23-170311,170311,0,0,0,73,1.0,43.21999325616589,3
2020-07-24-170311,170311,0,0,1,73,1.0,40.91707883886049,4
2020-07-25-170311,170311,0,0,1,73,0.375,32.84575374892877,5
2020-07-26-170311,170311,0,0,0,73,0.125,32.10488491561938,6
2020-07-27-170311,170311,0,0,0,73,0.25,31.74625862406419,0
2020-07-28-170311,170311,0,0,0,73,1.125,23.968313437459003,1
2020-07-29-170311,170311,0,0,0,73,1.0,26.22544000359713,2
2020-07-30-170311,170311,0,0,1,73,1.5,22.711923390625778,3
2020-07-31-170311,170311,0,0,0,73,0.5,35.777666162144364,4
2020-08-01-170311,170311,0,0,1,73,0.25,16.46322982470565,5
2020-08-02-170311,170311,1,0,0,74,0.375,87.74995729238555,6
2020-08-03-170311,170311,0,0,0,74,0.875,172.68832755277725,0
2020-08-04-170311,170311,1,0,4,75,1.125,171.70457020613463,1
2020-08-05-170311,170311,0,0,0,75,1.75,151.41110107956462,2
2020-08-06-170311,170311,0,0,1,75,0.75,130.6171671947862,3
2020-08-07-170311,170311,1,0,0,76,1.375,98.36699861781771,4
2020-08-08-170311,170311,1,0,0,77,0.125,83.58361954904441,5
2020-08-09-170311,170311,0,0,0,77,0.0,90.81981639528541,6
2020-08-10-170311,170311,0,0,1,77,1.125,27.545606720390893,0
2020-08-11-170311,170311,0,0,3,77,0.5,34.150625780625255,1
2020-08-12-170311,170311,0,0,1,77,1.125,37.09055888748751,2
2020-08-13-170311,170311,1,0,2,78,0.625,40.17459717546572,3
2020-08-14-170311,170311,0,0,0,78,0.25,46.866794921966665,4
2020-08-15-170311,170311,1,0,2,79,0.0,52.8944256121327,5
2020-08-16-170311,170311,0,0,5,79,0.875,50.925734450245244,6
2020-08-17-170311,170311,0,0,1,79,0.625,55.14004417182831,0
2020-08-18-170311,170311,4,0,2,83,1.25,51.02508166261386,1
2020-08-19-170311,170311,0,0,1,83,1.125,77.13105057458245,2
2020-08-20-170311,170311,1,0,0,84,1.875,95.47587810754966,3
2020-08-21-170311,170311,0,0,2,84,1.25,100.53694220295785,4
2020-08-22-170311,170311,0,0,2,84,0.75,101.53209045866518,5
2020-08-23-170311,170311,0,0,2,84,1.25,88.06459591842844,6
2020-08-24-170311,170311,1,0,2,85,1.375,88.93946205861349,0
2020-08-25-170311,170311,3,0,0,88,1.625,77.12765072120257,1
2020-08-26-170311,170311,1,0,1,89,3.25,89.78608944951853,2
2020-08-27-170311,170311,2,0,2,91,3.125,111.8849904494013,3
2020-08-28-170311,170311,0,0,0,91,2.125,127.02563512211836,4
2020-08-29-170311,170311,2,0,0,93,1.125,153.61334285259082,5
2020-08-30-170311,170311,5,0,4,98,1.25,166.56143556959393,6
2020-08-31-170311,170311,1,0,0,99,2.125,170.02344119673842,0
2020-09-01-170311,170311,2,0,1,101,1.5,56.06704460011237,1
2020-09-02-170311,170311,1,0,2,102,1.375,160.8507395282649,2
2020-09-03-170311,170311,0,0,1,102,3.0,179.55099080621636,3
2020-09-04-170311,170311,2,0,0,104,1.5,169.58031000532148,4
2020-09-05-170311,170311,2,0,0,106,1.25,153.3015381973884,5
2020-09-06-170311,170311,2,0,1,108,2.25,142.7087124912183,6
2020-09-07-170311,170311,2,0,1,110,1.625,140.18283705305296,0
2020-09-08-170311,170311,0,0,3,110,1.0,131.66516578651434,1
2020-09-09-170311,170311,1,0,2,111,3.5,127.62870648027382,2
2020-09-10-170311,170311,2,0,1,113,1.875,58.73824477497826,3
2020-09-11-170311,170311,0,0,0,113,3.0,68.60851836307387,4
2020-09-12-170311,170311,0,0,2,113,0.625,90.02571781433892,5
2020-09-13-170311,170311,4,0,1,117,2.375,89.21817366480778,6
2020-09-14-170311,170311,0,0,1,117,2.25,120.50855665273555,0
2020-09-15-170311,170311,1,0,0,118,4.25,129.53695987156954,1
2020-09-16-170311,170311,2,1,0,120,3.75,154.16163015144213,2
2020-09-17-170311,170311,1,0,1,121,3.5,142.83434425057987,3
2020-09-18-170311,170311,0,0,0,121,2.625,155.3257241655421,4
2020-09-19-170311,170311,0,0,0,121,1.75,146.28319415705192,5
2020-09-20-170311,170311,1,0,1,122,1.625,126.36922592642935,6
2020-09-21-170311,170311,1,0,0,123,3.875,109.80089056203933,0
2020-09-22-170311,170311,3,1,0,126,3.25,105.09613351390539,1
2020-09-23-170311,170311,2,0,0,128,4.875,121.06727576048016,2
2020-09-24-170311,170311,1,0,0,129,5.0,116.0864477904166,3
2020-09-25-170311,170311,0,0,0,129,6.75,116.8449386471755,4
2020-09-26-170311,170311,2,0,1,131,0.875,139.29667387331062,5
2020-09-27-170311,170311,1,0,1,132,2.625,139.36314612005836,6
2020-09-28-170311,170311,1,0,5,133,5.75,149.05533060600578,0
2020-09-29-170311,170311,0,0,0,133,3.625,162.67910153621958,1
2020-09-30-170311,170311,0,0,2,133,3.25,145.1227883448915,2
2020-10-01-170311,170311,1,0,0,134,9.875,0.0,3
2020-10-02-170311,170311,0,0,3,134,6.625,206.71564408457817,4
2020-10-03-170311,170311,0,1,1,134,2.75,250.5010477121388,5
2020-10-04-170311,170311,1,0,0,135,2.375,252.37663382685173,6
2020-10-05-170311,170311,0,0,3,135,2.375,220.3557805793925,0
2020-10-06-170311,170311,0,0,0,135,4.0,196.6185607249634,1
2020-10-07-170311,170311,0,0,0,135,2.375,169.9717001684993,2
2020-10-08-170311,170311,0,0,3,135,4.125,117.38575373310996,3
2020-10-09-170311,170311,0,0,1,135,6.875,125.6273553507015,4
2020-10-10-170311,170311,1,0,0,136,2.0,42.30358567345184,5
2020-10-11-170311,170311,1,0,0,137,1.125,53.33579036314765,6
2020-10-12-170311,170311,5,0,1,142,1.875,64.45788129023717,0
2020-10-13-170311,170311,0,0,3,142,9.125,91.60233711431138,1
2020-10-14-170311,170311,2,0,2,144,5.5,119.91749643566312,2
2020-10-15-170311,170311,0,0,5,144,5.875,152.12188551568562,3
2020-10-16-170311,170311,3,0,0,147,6.25,171.64257566479486,4
2020-10-17-170311,170311,1,0,0,148,3.5,163.59165442094795,5
2020-10-18-170311,170311,0,0,0,148,1.875,169.35812208380133,6
2020-10-19-170311,170311,3,0,0,151,8.375,165.49852597748975,0
2020-10-20-170311,170311,0,0,1,151,6.125,183.78485269214812,1
2020-10-21-170311,170311,0,1,0,151,7.25,173.42869219522947,2
2020-10-22-170311,170311,3,0,2,154,5.625,179.65107002090667,3
2020-10-23-170311,170311,1,0,0,155,7.25,181.4838330043312,4
2020-10-24-170311,170311,0,0,7,155,3.5,197.6987068995198,5
2020-10-25-170311,170311,0,0,0,155,2.875,199.8072341417897,6
2020-10-26-170311,170311,1,0,1,156,6.0,163.97134669182356,0
2020-10-27-170311,170311,3,0,2,159,5.0,175.0482024825599,1
2020-10-28-170311,170311,2,0,2,161,8.625,182.0676734383766,2
2020-10-29-170311,170311,5,0,1,166,11.0,196.38420121415737,3
2020-10-30-170311,170311,0,0,0,166,8.625,201.87115018218867,4
2020-10-31-170311,170311,0,0,0,166,2.875,221.46738046880571,5
2020-11-01-170311,170311,0,0,0,166,5.25,102.48100051218819,6
2020-11-02-170311,170311,0,0,0,166,2.125,157.6649906613089,0
2020-11-03-170311,170311,1,0,0,167,12.375,137.36026964585523,1
2020-11-04-170311,170311,0,0,0,167,7.75,185.74005553651415,2
2020-11-05-170311,170311,2,0,0,169,9.125,187.81266778810084,3
2020-11-06-170311,170311,0,0,0,169,8.375,212.93484372267125,4
2020-11-07-170311,170311,7,0,0,176,3.125,227.74377765412163,5
2020-11-08-170311,170311,0,0,0,176,2.75,236.60338004984087,6
2020-11-09-170311,170311,1,1,0,177,10.25,225.5886760385871,0
2020-11-10-170311,170311,2,0,0,179,7.375,98.28763423060262,1
2020-11-11-170311,170311,2,0,0,181,7.875,120.18528581279621,2
2020-11-12-170311,170311,1,0,0,182,5.875,145.53758457113466,3
2020-11-13-170311,170311,0,1,0,182,11.875,153.7097686029599,4
2020-03-01-170312,170312,0,0,0,0,0.1111111111111111,0.0,6
2020-03-02-170312,170312,0,0,5,0,0.0,356.0114244361185,0
2020-03-03-170312,170312,0,0,17,0,0.0,1418.967365911689,1
2020-03-04-170312,170312,0,0,26,0,0.3333333333333333,1604.4313626447936,2
2020-03-05-170312,170312,0,1,25,0,0.0,1626.6003828449134,3
2020-03-06-170312,170312,0,0,23,0,0.0,1425.4790705110645,4
2020-03-07-170312,170312,0,0,4,0,0.0,1623.9937700817127,5
2020-03-08-170312,170312,0,0,2,0,0.0,1770.4181150409183,6
2020-03-09-170312,170312,0,0,37,0,0.2222222222222222,1771.3609070098519,0
2020-03-10-170312,170312,0,0,30,0,0.0,4526.802788881696,1
2020-03-11-170312,170312,0,0,41,0,0.2222222222222222,3886.6067749588174,2
2020-03-12-170312,170312,0,0,48,0,0.4444444444444444,2944.0892374700197,3
2020-03-13-170312,170312,0,0,36,0,0.3333333333333333,1875.0496599401724,4
2020-03-14-170312,170312,3,0,2,3,0.5555555555555556,1709.5221998430115,5
2020-03-15-170312,170312,0,0,0,3,1.4444444444444444,1519.8428958312952,6
2020-03-16-170312,170312,5,0,51,8,13.777777777777779,144.6500905163522,0
2020-03-17-170312,170312,17,0,23,25,12.666666666666664,560.6918568788863,1
2020-03-18-170312,170312,26,0,24,51,15.444444444444445,1121.1534723675877,2
2020-03-19-170312,170312,25,0,16,76,15.111111111111109,1665.86851767835,3
2020-03-20-170312,170312,23,0,24,99,14.222222222222221,2081.205713418486,4
2020-03-21-170312,170312,4,0,4,103,1.2222222222222223,2371.5626334938574,5
2020-03-22-170312,170312,2,0,5,105,2.555555555555556,2314.1216949426694,6
2020-03-23-170312,170312,37,0,21,142,22.0,2080.7009267290623,0
2020-03-24-170312,170312,30,0,21,172,14.666666666666664,2353.7885025582405,1
2020-03-25-170312,170312,41,0,14,213,13.111111111111109,2348.9438266187035,2
2020-03-26-170312,170312,48,0,19,261,10.555555555555557,2410.4472940877235,3
2020-03-27-170312,170312,36,1,10,297,11.111111111111109,2985.585418345344,4
2020-03-28-170312,170312,2,0,2,299,1.5555555555555556,3011.5460034593507,5
2020-03-29-170312,170312,0,0,2,299,0.5555555555555556,2994.3812086516527,6
2020-03-30-170312,170312,51,0,19,350,15.222222222222221,2228.5981071223673,0
2020-03-31-170312,170312,23,0,11,373,9.0,2326.113408856203,1
2020-04-01-170312,170312,24,0,10,397,7.111111111111112,363.7266270217669,2
2020-04-02-170312,170312,16,0,9,413,7.4444444444444455,1341.2236091870986,3
2020-04-03-170312,170312,24,0,15,437,6.666666666666668,980.3435966236221,4
2020-04-04-170312,170312,4,0,1,441,0.4444444444444444,880.5293737710424,5
2020-04-05-170312,170312,5,0,4,446,0.5555555555555556,879.2476979917902,6
2020-04-06-170312,170312,21,0,15,467,12.111111111111109,905.6903059731609,0
2020-04-07-170312,170312,21,0,6,488,8.0,1089.6263237705048,1
2020-04-08-170312,170312,14,3,40,502,6.111111111111112,1328.140986389119,2
2020-04-09-170312,170312,19,0,0,521,5.222222222222221,1429.1022158567441,3
2020-04-10-170312,170312,10,0,56,531,5.888888888888888,322.06467537231686,4
2020-04-11-170312,170312,2,0,0,533,0.5555555555555556,503.89731185056314,5
2020-04-12-170312,170312,2,0,2,535,1.4444444444444444,536.9776251713455,6
2020-04-13-170312,170312,19,0,13,554,7.888888888888888,584.5936928916805,0
2020-04-14-170312,170312,11,0,6,565,7.222222222222222,940.4256524105923,1
2020-04-15-170312,170312,10,0,11,575,6.777777777777778,1191.0630856416437,2
2020-04-16-170312,170312,9,1,12,584,7.5555555555555545,1427.5934241254545,3
2020-04-17-170312,170312,15,0,0,599,5.111111111111111,1373.4343085176858,4
2020-04-18-170312,170312,1,0,1,600,1.0,1448.9217269332248,5
2020-04-19-170312,170312,4,0,0,604,0.5555555555555556,1442.4336221262538,6
2020-04-20-170312,170312,15,0,12,619,8.444444444444445,1324.1609542201209,0
2020-04-21-170312,170312,6,0,12,625,4.777777777777779,1316.0917341421052,1
2020-04-22-170312,170312,40,0,7,665,3.0,1205.4107659893878,2
2020-04-23-170312,170312,0,0,7,665,1.5555555555555556,1341.4668751087472,3
2020-04-24-170312,170312,56,0,11,721,5.222222222222221,1093.346574358829,4
2020-04-25-170312,170312,0,0,1,721,1.2222222222222223,1543.5610311759565,5
2020-04-26-170312,170312,2,0,0,723,0.1111111111111111,1552.5812538473897,6
2020-04-27-170312,170312,13,0,6,736,3.6666666666666665,1305.517060954392,0
2020-04-28-170312,170312,6,0,10,742,2.7777777777777777,1242.7951347715896,1
2020-04-29-170312,170312,11,0,13,753,4.0,1204.1477454721846,2
2020-04-30-170312,170312,12,0,15,765,2.2222222222222223,1268.4659542565141,3
2020-05-01-170312,170312,0,0,2,765,0.1111111111111111,1478.8114971378302,4
2020-05-02-170312,170312,1,0,5,766,0.8888888888888888,653.8140507057495,5
2020-05-03-170312,170312,0,0,0,766,0.7777777777777778,583.743008196841,6
2020-05-04-170312,170312,12,0,6,778,3.4444444444444446,464.7138581625924,0
2020-05-05-170312,170312,12,0,8,790,2.2222222222222223,548.8887448889105,1
2020-05-06-170312,170312,7,0,7,797,3.0,624.5871033730363,2
2020-05-07-170312,170312,7,0,8,804,3.4444444444444446,604.0716465845474,3
2020-05-08-170312,170312,11,0,16,815,2.555555555555556,599.3640886212374,4
2020-05-09-170312,170312,1,0,2,816,0.4444444444444444,758.9931138613453,5
2020-05-10-170312,170312,0,0,1,816,0.2222222222222222,1500.7161401331255,6
2020-05-11-170312,170312,6,2,9,822,4.222222222222221,1441.2622293599588,0
2020-05-12-170312,170312,10,0,6,832,2.333333333333333,1542.1090163527406,1
2020-05-13-170312,170312,13,0,5,845,1.8888888888888888,1260.3410264848558,2
2020-05-14-170312,170312,15,0,12,860,2.333333333333333,1056.8715847555109,3
2020-05-15-170312,170312,2,0,12,862,2.555555555555556,946.065992677421,4
2020-05-16-170312,170312,5,0,0,867,0.3333333333333333,730.8237334067591,5
2020-05-17-170312,170312,0,0,0,867,0.2222222222222222,783.6931335827555,6
2020-05-18-170312,170312,6,0,9,873,3.0,793.8059945730017,0
2020-05-19-170312,170312,8,0,6,881,3.111111111111111,761.6085405976199,1
2020-05-20-170312,170312,7,0,11,888,2.555555555555556,629.5854273110563,2
2020-05-21-170312,170312,8,0,8,896,3.0,565.5519271336773,3
2020-05-22-170312,170312,16,0,12,912,4.5555555555555545,640.7962782063807,4
2020-05-23-170312,170312,2,0,0,914,0.2222222222222222,839.1166943243645,5
2020-05-24-170312,170312,1,0,0,915,0.2222222222222222,858.1546937269734,6
2020-05-25-170312,170312,9,0,15,924,2.7777777777777777,753.4493996915159,0
2020-05-26-170312,170312,6,0,14,930,1.5555555555555556,768.2365100018418,1
2020-05-27-170312,170312,5,0,10,935,2.1111111111111107,830.5128068608442,2
2020-05-28-170312,170312,12,2,8,947,2.333333333333333,807.9188879695005,3
2020-05-29-170312,170312,12,0,6,959,1.8888888888888888,835.3304080368177,4
2020-05-30-170312,170312,0,0,2,959,0.7777777777777778,731.8157576595172,5
2020-05-31-170312,170312,0,0,1,959,0.3333333333333333,733.1818391598727,6
2020-06-01-170312,170312,9,0,6,968,3.111111111111111,896.1882565756657,0
2020-06-02-170312,170312,6,0,3,974,3.111111111111111,315.37998417163914,1
2020-06-03-170312,170312,11,1,2,985,3.4444444444444446,169.23309477750962,2
2020-06-04-170312,170312,8,0,0,993,1.7777777777777777,285.9228590802844,3
2020-06-05-170312,170312,12,0,5,1005,3.7777777777777777,388.9561460452694,4
2020-06-06-170312,170312,0,0,0,1005,0.3333333333333333,559.3391319828476,5
2020-06-07-170312,170312,0,0,0,1005,0.0,567.1235808985222,6
2020-06-08-170312,170312,15,0,0,1020,1.6666666666666667,577.8815535106452,0
2020-06-09-170312,170312,14,0,3,1034,2.333333333333333,727.5955711738342,1
2020-06-10-170312,170312,10,0,0,1044,2.7777777777777777,1061.745330063847,2
2020-06-11-170312,170312,8,0,1,1052,2.6666666666666665,1050.6262863328295,3
2020-06-12-170312,170312,6,0,3,1058,1.7777777777777777,1018.5063342938249,4
2020-06-13-170312,170312,2,0,0,1060,0.2222222222222222,969.3440655632102,5
2020-06-14-170312,170312,1,0,0,1061,0.2222222222222222,832.1616330311947,6
2020-06-15-170312,170312,6,0,2,1067,0.5555555555555556,673.9545807736845,0
2020-06-16-170312,170312,3,0,1,1070,1.5555555555555556,715.5344468540216,1
2020-06-17-170312,170312,2,0,1,1072,0.8888888888888888,619.2564405861751,2
2020-06-18-170312,170312,0,0,0,1072,0.8888888888888888,488.08600535338087,3
2020-06-19-170312,170312,5,0,3,1077,0.7777777777777778,374.51092939583606,4
2020-06-20-170312,170312,0,0,0,1077,0.0,477.1452712590159,5
2020-06-21-170312,170312,0,0,1,1077,0.1111111111111111,463.1517870489343,6
2020-06-22-170312,170312,0,0,3,1077,0.6666666666666666,404.0827726297436,0
2020-06-23-170312,170312,3,0,4,1080,1.1111111111111112,348.11017363705065,1
2020-06-24-170312,170312,0,2,1,1080,0.2222222222222222,365.741969277892,2
2020-06-25-170312,170312,1,1,2,1081,0.8888888888888888,328.1795597094811,3
2020-06-26-170312,170312,3,0,2,1084,0.6666666666666666,285.6565448023281,4
2020-06-27-170312,170312,0,0,0,1084,0.0,168.18254799850797,5
2020-06-28-170312,170312,0,0,0,1084,0.0,168.9441151690178,6
2020-06-29-170312,170312,2,0,4,1086,0.3333333333333333,166.11287201950358,0
2020-06-30-170312,170312,1,0,2,1087,0.2222222222222222,283.756570609608,1
2020-07-01-170312,170312,1,0,1,1088,0.3333333333333333,751.1447637646547,2
2020-07-02-170312,170312,0,0,0,1088,0.3333333333333333,232.7422762484955,3
2020-07-03-170312,170312,3,0,4,1091,0.5555555555555556,196.82595938581335,4
2020-07-04-170312,170312,0,0,1,1091,0.0,266.7409677939653,5
2020-07-05-170312,170312,1,0,2,1092,0.1111111111111111,234.54969886333652,6
2020-07-06-170312,170312,3,0,1,1095,0.3333333333333333,209.159404099472,0
2020-07-07-170312,170312,4,0,2,1099,0.8888888888888888,216.54797703287258,1
2020-07-08-170312,170312,1,0,0,1100,0.3333333333333333,245.25910870408248,2
2020-07-09-170312,170312,2,0,0,1102,0.4444444444444444,214.40215023682288,3
2020-07-10-170312,170312,2,0,4,1104,0.6666666666666666,780.804030386104,4
2020-07-11-170312,170312,0,0,0,1104,0.2222222222222222,686.9705426177403,5
2020-07-12-170312,170312,0,0,3,1104,0.1111111111111111,484.3067245615018,6
2020-07-13-170312,170312,4,0,2,1108,0.6666666666666666,477.5755311312923,0
2020-07-14-170312,170312,2,0,1,1110,0.3333333333333333,521.198645239108,1
2020-07-15-170312,170312,1,0,0,1111,1.0,362.84299567295244,2
2020-07-16-170312,170312,0,0,4,1111,0.2222222222222222,190.2211320309857,3
2020-07-17-170312,170312,4,0,3,1115,0.8888888888888888,195.09928480143537,4
2020-07-18-170312,170312,1,0,0,1116,0.1111111111111111,212.72650920683571,5
2020-07-19-170312,170312,2,0,0,1118,0.1111111111111111,215.30363115790396,6
2020-07-20-170312,170312,1,0,7,1119,1.2222222222222223,187.4318591173801,0
2020-07-21-170312,170312,2,0,4,1121,0.7777777777777778,213.49182318951776,1
2020-07-22-170312,170312,0,0,6,1121,1.3333333333333333,222.37906326625443,2
2020-07-23-170312,170312,0,0,1,1121,0.8888888888888888,243.73850746459857,3
2020-07-24-170312,170312,4,0,1,1125,0.7777777777777778,203.75645002892205,4
2020-07-25-170312,170312,0,0,1,1125,0.1111111111111111,237.27771826349075,5
2020-07-26-170312,170312,3,0,0,1128,0.2222222222222222,220.55135708647705,6
2020-07-27-170312,170312,2,0,2,1130,0.6666666666666666,241.2638475360091,0
2020-07-28-170312,170312,1,0,2,1131,0.4444444444444444,228.45215092606523,1
2020-07-29-170312,170312,0,0,4,1131,0.6666666666666666,220.104180500622,2
2020-07-30-170312,170312,4,0,3,1135,0.8888888888888888,220.2182207834441,3
2020-07-31-170312,170312,3,0,4,1138,0.3333333333333333,230.09492493366957,4
2020-08-01-170312,170312,0,0,0,1138,0.2222222222222222,186.35406584125514,5
2020-08-02-170312,170312,0,0,0,1138,0.0,413.1272205071885,6
2020-08-03-170312,170312,7,0,6,1145,0.5555555555555556,1355.3162763994014,0
2020-08-04-170312,170312,4,0,3,1149,0.4444444444444444,1290.2637359220257,1
2020-08-05-170312,170312,6,0,8,1155,0.6666666666666666,1142.7059164337918,2
2020-08-06-170312,170312,1,0,0,1156,0.6666666666666666,985.6265397741031,3
2020-08-07-170312,170312,1,0,10,1157,0.8888888888888888,789.2655585934701,4
2020-08-08-170312,170312,1,0,6,1158,0.1111111111111111,621.8418798182796,5
2020-08-09-170312,170312,0,0,5,1158,0.1111111111111111,553.193245618095,6
2020-08-10-170312,170312,2,0,6,1160,1.1111111111111112,160.30627139770903,0
2020-08-11-170312,170312,2,0,13,1162,1.0,210.7816166486893,1
2020-08-12-170312,170312,4,0,6,1166,1.2222222222222223,250.74504461808104,2
2020-08-13-170312,170312,3,0,12,1169,1.3333333333333333,260.7340349299012,3
2020-08-14-170312,170312,4,0,6,1173,0.6666666666666666,261.04241300820195,4
2020-08-15-170312,170312,0,0,13,1173,0.3333333333333333,285.4824572747044,5
2020-08-16-170312,170312,0,0,7,1173,0.3333333333333333,266.7710805132655,6
2020-08-17-170312,170312,6,0,10,1179,1.1111111111111112,279.5200702040511,0
2020-08-18-170312,170312,3,0,5,1182,1.1111111111111112,314.4686481710669,1
2020-08-19-170312,170312,8,0,7,1190,1.3333333333333333,331.0571833151041,2
2020-08-20-170312,170312,0,0,9,1190,2.7777777777777777,343.5129822989614,3
2020-08-21-170312,170312,10,0,12,1200,2.4444444444444446,383.57901578239296,4
2020-08-22-170312,170312,6,0,9,1206,0.6666666666666666,526.0713296124616,5
2020-08-23-170312,170312,5,0,1,1211,0.5555555555555556,585.7891766764044,6
2020-08-24-170312,170312,6,0,23,1217,1.5555555555555556,565.3022691584367,0
2020-08-25-170312,170312,13,0,21,1230,3.888888888888889,644.0210611227689,1
2020-08-26-170312,170312,6,0,16,1236,3.888888888888889,799.8948796926483,2
2020-08-27-170312,170312,12,0,14,1248,3.333333333333333,978.0738193804711,3
2020-08-28-170312,170312,6,2,29,1254,4.111111111111111,1112.5594223095654,4
2020-08-29-170312,170312,13,0,6,1267,3.2222222222222223,1167.1388866213088,5
2020-08-30-170312,170312,7,0,21,1274,2.0,1308.8724649112246,6
2020-08-31-170312,170312,10,0,24,1284,4.777777777777779,1273.5221851787658,0
2020-09-01-170312,170312,5,0,15,1289,2.1111111111111107,452.6950723853459,1
2020-09-02-170312,170312,7,1,29,1296,2.888888888888889,2502.4064314649404,2
2020-09-03-170312,170312,9,0,33,1305,3.888888888888889,2455.341171888141,3
2020-09-04-170312,170312,12,1,36,1317,4.0,2203.7676341190413,4
2020-09-05-170312,170312,9,0,2,1326,1.7777777777777777,2055.0707715322756,5
2020-09-06-170312,170312,1,2,3,1327,3.2222222222222223,2087.2336793269587,6
2020-09-07-170312,170312,23,0,45,1350,4.888888888888889,2160.945423815699,0
2020-09-08-170312,170312,21,0,28,1371,6.0,1875.7126593907983,1
2020-09-09-170312,170312,16,1,30,1387,8.444444444444445,1892.1404694868593,2
2020-09-10-170312,170312,14,0,26,1401,7.777777777777778,357.44436179239165,3
2020-09-11-170312,170312,29,0,18,1430,7.5555555555555545,773.7535287761511,4
2020-09-12-170312,170312,6,1,8,1436,2.333333333333333,1275.5758771549272,5
2020-09-13-170312,170312,21,0,1,1457,3.6666666666666665,1372.0102250553612,6
2020-09-14-170312,170312,24,1,40,1481,9.0,1630.4158070012036,0
2020-09-15-170312,170312,15,0,16,1496,4.888888888888889,2139.9176218672505,1
2020-09-16-170312,170312,29,0,29,1525,8.333333333333334,2434.1670123808535,2
2020-09-17-170312,170312,33,0,32,1558,7.666666666666668,2824.6735572157386,3
2020-09-18-170312,170312,36,0,49,1594,7.111111111111112,2865.0796590199866,4
2020-09-19-170312,170312,2,2,12,1596,1.3333333333333333,2767.707884491576,5
2020-09-20-170312,170312,3,3,9,1599,1.8888888888888888,2597.9464411129225,6
2020-09-21-170312,170312,45,0,4,1644,12.0,2174.6141208898403,0
2020-09-22-170312,170312,28,0,37,1672,6.777777777777778,2571.880235334977,1
2020-09-23-170312,170312,30,0,31,1702,7.111111111111112,2516.5546566396874,2
2020-09-24-170312,170312,26,1,25,1728,9.666666666666666,2501.017852578297,3
2020-09-25-170312,170312,18,1,34,1746,8.666666666666666,2580.1347822333673,4
2020-09-26-170312,170312,8,1,6,1754,1.1111111111111112,2874.0473147888238,5
2020-09-27-170312,170312,1,0,5,1755,1.6666666666666667,2832.240789563267,6
2020-09-28-170312,170312,40,0,1,1795,10.666666666666666,2795.169823331607,0
2020-09-29-170312,170312,16,0,49,1811,5.666666666666668,2805.5226112903874,1
2020-09-30-170312,170312,29,1,43,1840,6.333333333333332,2448.4435700786025,2
2020-10-01-170312,170312,32,0,52,1872,12.111111111111109,0.0,3
2020-10-02-170312,170312,49,0,30,1921,12.333333333333336,5079.575246520531,4
2020-10-03-170312,170312,12,2,5,1933,3.0,4641.366927779589,5
2020-10-04-170312,170312,9,1,7,1942,3.6666666666666665,4748.870403545421,6
2020-10-05-170312,170312,4,1,59,1946,1.6666666666666667,3920.553516071689,0
2020-10-06-170312,170312,37,0,40,1983,10.222222222222221,3411.067447901315,1
2020-10-07-170312,170312,31,0,44,2014,9.222222222222221,3029.967615942125,2
2020-10-08-170312,170312,25,1,83,2039,11.444444444444445,2861.077975772403,3
2020-10-09-170312,170312,34,2,48,2073,17.444444444444443,3233.850616265062,4
2020-10-10-170312,170312,6,0,8,2079,2.4444444444444446,705.1050669923873,5
2020-10-11-170312,170312,5,0,9,2084,2.2222222222222223,825.7664983344916,6
2020-10-12-170312,170312,1,0,49,2085,3.4444444444444446,927.1600676017111,0
2020-10-13-170312,170312,49,0,11,2134,20.11111111111111,1088.091686885983,1
2020-10-14-170312,170312,43,0,75,2177,10.444444444444443,2137.521280482555,2
2020-10-15-170312,170312,52,0,49,2229,13.444444444444445,2823.3771515600874,3
2020-10-16-170312,170312,30,0,41,2259,14.555555555555555,3598.621043917233,4
2020-10-17-170312,170312,5,0,10,2264,4.666666666666667,3756.185345827413,5
2020-10-18-170312,170312,7,0,3,2271,2.1111111111111107,3821.341650991335,6
2020-10-19-170312,170312,59,1,5,2330,20.88888888888889,3911.1169593386917,0
2020-10-20-170312,170312,40,0,56,2370,10.444444444444443,4718.009967719932,1
2020-10-21-170312,170312,44,2,20,2414,11.888888888888891,4705.223273933261,2
2020-10-22-170312,170312,83,0,43,2497,12.777777777777779,4693.790807571417,3
2020-10-23-170312,170312,48,1,38,2545,15.0,4775.6263861556035,4
2020-10-24-170312,170312,8,1,2,2553,4.5555555555555545,5458.941846756394,5
2020-10-25-170312,170312,9,1,5,2562,2.333333333333333,5482.048535144399,6
2020-10-26-170312,170312,49,2,52,2611,17.0,4450.700035549449,0
2020-10-27-170312,170312,11,1,76,2622,9.888888888888891,4773.823069404702,1
2020-10-28-170312,170312,75,3,45,2697,13.0,4505.764494823311,2
2020-10-29-170312,170312,49,1,47,2746,13.333333333333336,4806.6230142401055,3
2020-10-30-170312,170312,41,3,41,2787,16.444444444444443,3953.8051516331493,4
2020-10-31-170312,170312,10,0,0,2797,3.4444444444444446,4691.4992677019545,5
2020-11-01-170312,170312,3,2,0,2800,3.7777777777777777,3263.0835082758936,6
2020-11-02-170312,170312,5,4,0,2805,1.8888888888888888,4039.502136845973,0
2020-11-03-170312,170312,56,3,0,2861,22.11111111111111,3429.7921191940563,1
2020-11-04-170312,170312,20,4,0,2881,10.555555555555557,4564.358358332452,2
2020-11-05-170312,170312,43,1,0,2924,15.666666666666664,3928.661329654341,3
2020-11-06-170312,170312,38,4,0,2962,13.555555555555555,4322.0355285383675,4
2020-11-07-170312,170312,2,1,0,2964,2.4444444444444446,4610.914507980681,5
2020-11-08-170312,170312,5,1,0,2969,6.4444444444444455,4178.382441131038,6
2020-11-09-170312,170312,52,2,0,3021,25.33333333333333,4211.8451265135045,0
2020-11-10-170312,170312,76,2,0,3097,14.444444444444445,3185.506292965933,1
2020-11-11-170312,170312,45,5,0,3142,12.666666666666664,4119.669210878302,2
2020-11-12-170312,170312,47,5,0,3189,15.0,4809.15545621378,3
2020-11-13-170312,170312,41,3,0,3230,14.777777777777779,4798.442772735059,4
2020-03-01-170313,170313,0,0,2,0,0.0,0.0,6
2020-03-02-170313,170313,0,0,15,0,0.0,149.4463373230554,0
2020-03-03-170313,170313,0,0,32,0,0.0,629.4281841988842,1
2020-03-04-170313,170313,1,0,35,1,0.6666666666666666,723.8752642283616,2
2020-03-05-170313,170313,0,0,22,1,0.0,746.0600788100946,3
2020-03-06-170313,170313,0,0,36,1,0.0,671.5980248046567,4
2020-03-07-170313,170313,0,0,1,1,0.0,771.4435067200527,5
2020-03-08-170313,170313,0,0,4,1,0.0,843.6388369261061,6
2020-03-09-170313,170313,1,0,50,2,0.3333333333333333,848.527200177901,0
2020-03-10-170313,170313,0,0,29,2,0.0,2105.98790139262,1
2020-03-11-170313,170313,0,0,23,2,0.6666666666666666,1811.6850548602024,2
2020-03-12-170313,170313,0,0,23,2,1.0,1373.202488787017,3
2020-03-13-170313,170313,0,0,19,2,1.0,869.0222958991161,4
2020-03-14-170313,170313,1,0,3,3,1.3333333333333333,785.7065440526658,5
2020-03-15-170313,170313,2,0,0,5,0.6666666666666666,685.8419537759394,6
2020-03-16-170313,170313,15,0,20,20,13.0,67.82747982490434,0
2020-03-17-170313,170313,32,0,15,52,14.333333333333336,264.48109746065273,1
2020-03-18-170313,170313,35,0,10,87,23.0,475.9177822474162,2
2020-03-19-170313,170313,22,0,16,109,20.666666666666668,675.653399195828,3
2020-03-20-170313,170313,36,0,11,145,18.666666666666668,777.0155515604081,4
2020-03-21-170313,170313,1,0,0,146,2.0,842.7082329743765,5
2020-03-22-170313,170313,4,1,0,150,2.333333333333333,812.8742529723999,6
2020-03-23-170313,170313,50,0,23,200,31.0,717.4511059165112,0
2020-03-24-170313,170313,29,0,22,229,25.66666666666667,822.3279739596619,1
2020-03-25-170313,170313,23,0,19,252,25.33333333333333,813.4292952159716,2
2020-03-26-170313,170313,23,0,12,275,25.33333333333333,839.6386645351442,3
2020-03-27-170313,170313,19,0,16,294,18.33333333333333,1019.5547671575324,4
2020-03-28-170313,170313,3,0,1,297,2.0,1015.5311822665826,5
2020-03-29-170313,170313,0,0,2,297,0.6666666666666666,1011.7002911307366,6
2020-03-30-170313,170313,20,0,12,317,35.333333333333336,748.1554331489068,0
2020-03-31-170313,170313,15,0,11,332,16.0,782.2972459367857,1
2020-04-01-170313,170313,10,0,11,342,14.333333333333336,124.63436223857532,2
2020-04-02-170313,170313,16,0,17,358,12.333333333333336,454.1098119989871,3
2020-04-03-170313,170313,11,0,7,369,14.0,314.3020722413383,4
2020-04-04-170313,170313,0,0,1,369,2.0,287.6856998156206,5
2020-04-05-170313,170313,0,0,1,369,1.6666666666666667,292.76517903288027,6
2020-04-06-170313,170313,23,0,10,392,16.0,300.50794217716845,0
2020-04-07-170313,170313,22,0,8,414,13.666666666666664,378.019380364171,1
2020-04-08-170313,170313,19,1,4,433,9.333333333333334,460.23844580548445,2
2020-04-09-170313,170313,12,0,0,445,9.333333333333334,493.8859053070709,3
2020-04-10-170313,170313,16,0,4,461,9.333333333333334,109.16299610843356,4
2020-04-11-170313,170313,1,0,1,462,1.3333333333333333,181.42466643257904,5
2020-04-12-170313,170313,2,0,0,464,2.0,193.29677846429,6
2020-04-13-170313,170313,12,0,7,476,11.666666666666664,212.02893814889418,0
2020-04-14-170313,170313,11,0,2,487,10.0,320.6380917251652,1
2020-04-15-170313,170313,11,0,7,498,10.333333333333334,409.5887384075667,2
2020-04-16-170313,170313,17,0,1,515,9.0,493.58262431367825,3
2020-04-17-170313,170313,7,0,0,522,10.0,493.24484976633005,4
2020-04-18-170313,170313,1,0,2,523,1.6666666666666667,502.43230422270614,5
2020-04-19-170313,170313,1,0,0,524,1.3333333333333333,501.2403785001672,6
2020-04-20-170313,170313,10,0,5,534,12.0,473.9491381018763,0
2020-04-21-170313,170313,8,1,3,542,5.333333333333333,479.10706043806,1
2020-04-22-170313,170313,4,0,6,546,15.666666666666664,431.63635761235605,2
2020-04-23-170313,170313,0,0,6,546,0.3333333333333333,459.7627086302187,3
2020-04-24-170313,170313,4,0,4,550,21.33333333333333,378.08829180005375,4
2020-04-25-170313,170313,1,0,1,551,0.6666666666666666,526.7641580823416,5
2020-04-26-170313,170313,0,0,0,551,0.6666666666666666,523.2700044540492,6
2020-04-27-170313,170313,7,0,12,558,7.0,435.20426590062874,0
2020-04-28-170313,170313,2,1,4,560,6.0,396.36315135880653,1
2020-04-29-170313,170313,7,0,9,567,8.666666666666666,387.7885163178312,2
2020-04-30-170313,170313,1,0,2,568,5.333333333333333,423.0315762403076,3
2020-05-01-170313,170313,0,0,3,568,0.0,512.614722770952,4
2020-05-02-170313,170313,2,0,3,570,0.6666666666666666,217.50728386045938,5
2020-05-03-170313,170313,0,0,0,570,0.3333333333333333,195.00484672687685,6
2020-05-04-170313,170313,5,0,4,575,7.333333333333332,154.82782168872558,0
2020-05-05-170313,170313,3,0,7,578,6.666666666666668,183.55183289124423,1
2020-05-06-170313,170313,6,0,4,584,4.333333333333333,206.93418012674985,2
2020-05-07-170313,170313,6,0,8,590,6.666666666666668,202.45579562270441,3
2020-05-08-170313,170313,4,0,9,594,5.0,205.7439854648632,4
2020-05-09-170313,170313,1,0,0,595,0.3333333333333333,264.7890289739763,5
2020-05-10-170313,170313,0,0,0,595,0.3333333333333333,545.1959134715529,6
2020-05-11-170313,170313,12,0,4,607,6.0,524.7153261132639,0
2020-05-12-170313,170313,4,0,5,611,6.666666666666668,564.4898690680096,1
2020-05-13-170313,170313,9,0,2,620,6.666666666666668,451.4114035344012,2
2020-05-14-170313,170313,2,0,9,622,7.333333333333332,375.65834559871416,3
2020-05-15-170313,170313,3,0,3,625,2.6666666666666665,333.1812431267696,4
2020-05-16-170313,170313,3,0,0,628,1.6666666666666667,261.4320482687552,5
2020-05-17-170313,170313,0,0,0,628,0.3333333333333333,278.4285236674788,6
2020-05-18-170313,170313,4,1,2,632,5.333333333333333,281.6388128667019,0
2020-05-19-170313,170313,7,0,9,639,6.666666666666668,269.6221316668738,1
2020-05-20-170313,170313,4,0,2,643,5.333333333333333,225.21624003784854,2
2020-05-21-170313,170313,8,0,2,651,4.333333333333333,207.24503468811918,3
2020-05-22-170313,170313,9,0,9,660,9.333333333333334,236.43475285565484,4
2020-05-23-170313,170313,0,0,0,660,1.3333333333333333,309.3943666270528,5
2020-05-24-170313,170313,0,0,0,660,0.6666666666666666,316.43695285071044,6
2020-05-25-170313,170313,4,0,1,664,6.333333333333332,276.98931812217353,0
2020-05-26-170313,170313,5,0,7,669,2.6666666666666665,279.1442891445484,1
2020-05-27-170313,170313,2,0,6,671,4.333333333333333,305.48514791188944,2
2020-05-28-170313,170313,9,1,5,680,5.666666666666668,298.6256828487725,3
2020-05-29-170313,170313,3,0,3,683,5.0,308.2919194245925,4
2020-05-30-170313,170313,0,0,1,683,0.6666666666666666,268.7950125371136,5
2020-05-31-170313,170313,0,0,0,683,0.0,272.1523131975107,6
2020-06-01-170313,170313,2,2,1,685,5.666666666666668,330.87047765660844,0
2020-06-02-170313,170313,9,0,2,694,4.666666666666667,120.33981936891671,1
2020-06-03-170313,170313,2,0,3,696,6.666666666666668,59.46989557211105,2
2020-06-04-170313,170313,2,0,3,698,4.0,107.78433790160145,3
2020-06-05-170313,170313,9,0,0,707,8.0,138.19876137484977,4
2020-06-06-170313,170313,0,0,0,707,1.0,208.99135475109495,5
2020-06-07-170313,170313,0,0,0,707,0.0,213.5395911917495,6
2020-06-08-170313,170313,1,0,0,708,7.0,216.82174174954574,0
2020-06-09-170313,170313,7,0,1,715,7.0,275.55274281062407,1
2020-06-10-170313,170313,6,0,0,721,7.333333333333332,404.59661590822986,2
2020-06-11-170313,170313,5,0,2,726,5.0,405.7506591952601,3
2020-06-12-170313,170313,3,0,2,729,4.666666666666667,396.9701429832846,4
2020-06-13-170313,170313,1,0,0,730,1.0,375.16716435695866,5
2020-06-14-170313,170313,0,0,0,730,0.3333333333333333,321.74706116194875,6
2020-06-15-170313,170313,1,0,0,731,3.0,260.75932300881516,0
2020-06-16-170313,170313,2,0,0,733,3.6666666666666665,277.1927308210359,1
2020-06-17-170313,170313,3,0,0,736,2.0,245.814911754286,2
2020-06-18-170313,170313,3,0,0,739,0.0,194.23898291585297,3
2020-06-19-170313,170313,0,0,2,739,2.333333333333333,153.05936532834846,4
2020-06-20-170313,170313,0,0,0,739,0.0,191.94152197225236,5
2020-06-21-170313,170313,0,0,0,739,0.0,187.39684606266292,6
2020-06-22-170313,170313,0,0,0,739,0.6666666666666666,163.9532142227728,0
2020-06-23-170313,170313,1,0,0,740,2.333333333333333,139.64922481355308,1
2020-06-24-170313,170313,0,0,0,740,0.0,141.71952627941107,2
2020-06-25-170313,170313,2,0,0,742,1.0,123.92393324924757,3
2020-06-26-170313,170313,2,0,1,744,2.0,114.6240361997943,4
2020-06-27-170313,170313,0,0,0,744,0.0,66.29533199470006,5
2020-06-28-170313,170313,0,0,0,744,0.0,67.07446476420283,6
2020-06-29-170313,170313,0,0,0,744,1.0,66.63320145475203,0
2020-06-30-170313,170313,0,0,0,744,0.3333333333333333,115.99516148211663,1
2020-07-01-170313,170313,0,0,1,744,1.0,302.3990283327406,2
2020-07-02-170313,170313,0,0,0,744,0.6666666666666666,93.64166404598284,3
2020-07-03-170313,170313,2,0,0,746,1.6666666666666667,74.42762733699557,4
2020-07-04-170313,170313,0,0,0,746,0.0,102.60974893316214,5
2020-07-05-170313,170313,0,0,0,746,0.3333333333333333,90.54074298750577,6
2020-07-06-170313,170313,0,0,0,746,1.3333333333333333,79.98336869004497,0
2020-07-07-170313,170313,0,0,1,746,2.0,83.25666623490282,1
2020-07-08-170313,170313,0,0,2,746,1.0,92.83031534456568,2
2020-07-09-170313,170313,0,0,0,746,1.3333333333333333,82.18426940556328,3
2020-07-10-170313,170313,1,0,0,747,1.6666666666666667,307.07591096063425,4
2020-07-11-170313,170313,0,0,0,747,0.6666666666666666,274.65845966045276,5
2020-07-12-170313,170313,0,0,1,747,0.0,189.21058460301975,6
2020-07-13-170313,170313,0,0,1,747,2.6666666666666665,185.64674578561693,0
2020-07-14-170313,170313,0,1,0,747,1.3333333333333333,203.49514379043362,1
2020-07-15-170313,170313,1,0,0,748,1.6666666666666667,143.57545184571686,2
2020-07-16-170313,170313,0,0,0,748,0.0,77.32072833252602,3
2020-07-17-170313,170313,0,0,0,748,3.333333333333333,78.85859535941314,4
2020-07-18-170313,170313,0,0,1,748,0.3333333333333333,85.92554012581604,5
2020-07-19-170313,170313,0,0,0,748,0.6666666666666666,86.50573173424168,6
2020-07-20-170313,170313,0,0,0,748,1.0,74.5710138206646,0
2020-07-21-170313,170313,1,0,1,749,1.3333333333333333,81.23618948589933,1
2020-07-22-170313,170313,2,0,0,751,1.0,83.23395380864746,2
2020-07-23-170313,170313,0,0,1,751,0.3333333333333333,92.96760357404177,3
2020-07-24-170313,170313,0,0,0,751,1.3333333333333333,76.16808687448045,4
2020-07-25-170313,170313,0,0,0,751,0.3333333333333333,88.53998743691096,5
2020-07-26-170313,170313,1,0,0,752,1.0,83.59128979656744,6
2020-07-27-170313,170313,1,0,0,753,1.0,90.22148920241611,0
2020-07-28-170313,170313,0,0,1,753,0.6666666666666666,87.50766678552056,1
2020-07-29-170313,170313,0,0,0,753,1.0,82.23004342908501,2
2020-07-30-170313,170313,0,0,3,753,3.6666666666666665,83.01589132234977,3
2020-07-31-170313,170313,0,0,0,753,1.0,88.91333950466044,4
2020-08-01-170313,170313,1,0,2,754,0.0,71.53269425289884,5
2020-08-02-170313,170313,0,0,1,754,0.0,159.34907500186264,6
2020-08-03-170313,170313,0,0,1,754,2.6666666666666665,528.5678741840882,0
2020-08-04-170313,170313,1,0,2,755,1.3333333333333333,491.405089747047,1
2020-08-05-170313,170313,0,0,1,755,2.6666666666666665,447.9058990148957,2
2020-08-06-170313,170313,1,0,4,756,0.3333333333333333,385.0398617433028,3
2020-08-07-170313,170313,0,1,3,756,0.6666666666666666,303.67550349262376,4
2020-08-08-170313,170313,0,0,0,756,0.3333333333333333,232.2656172120832,5
2020-08-09-170313,170313,0,0,0,756,0.3333333333333333,209.3185652344043,6
2020-08-10-170313,170313,0,0,5,756,1.3333333333333333,61.2566844202623,0
2020-08-11-170313,170313,1,0,5,757,1.6666666666666667,81.74797243179106,1
2020-08-12-170313,170313,0,0,3,757,3.0,101.52907856959729,2
2020-08-13-170313,170313,3,0,8,760,3.6666666666666665,108.28242070996012,3
2020-08-14-170313,170313,0,0,6,760,2.333333333333333,114.72763557729252,4
2020-08-15-170313,170313,2,0,5,762,0.3333333333333333,123.78752063897744,5
2020-08-16-170313,170313,1,0,2,763,0.3333333333333333,116.18927189119651,6
2020-08-17-170313,170313,1,0,10,764,2.6666666666666665,120.6421732627648,0
2020-08-18-170313,170313,2,0,3,766,1.6666666666666667,130.19449377868682,1
2020-08-19-170313,170313,1,0,5,767,4.0,131.5243935223557,2
2020-08-20-170313,170313,4,0,8,771,4.0,129.46139772981374,3
2020-08-21-170313,170313,3,0,3,774,6.333333333333332,149.8248220140956,4
2020-08-22-170313,170313,0,0,0,774,3.6666666666666665,210.85054653113298,5
2020-08-23-170313,170313,0,0,0,774,1.6666666666666667,235.25560941363432,6
2020-08-24-170313,170313,5,0,10,779,2.6666666666666665,228.16906444356084,0
2020-08-25-170313,170313,5,0,7,784,9.0,267.3843978421396,1
2020-08-26-170313,170313,3,0,14,787,4.333333333333333,337.857864582216,2
2020-08-27-170313,170313,8,0,13,795,6.666666666666668,395.41116255861823,3
2020-08-28-170313,170313,6,0,11,801,7.666666666666668,442.37025673449284,4
2020-08-29-170313,170313,5,0,4,806,8.333333333333334,465.2378532141799,5
2020-08-30-170313,170313,2,0,2,808,3.333333333333333,527.8070835007131,6
2020-08-31-170313,170313,10,0,21,818,7.333333333333332,504.65734173048804,0
2020-09-01-170313,170313,3,0,4,821,3.0,178.51899135166798,1
2020-09-02-170313,170313,5,0,12,826,5.0,991.4820348860653,2
2020-09-03-170313,170313,8,0,12,834,7.333333333333332,992.2305740121478,3
2020-09-04-170313,170313,3,0,18,837,9.666666666666666,911.811837673318,4
2020-09-05-170313,170313,0,0,0,837,4.666666666666667,853.1725716992481,5
2020-09-06-170313,170313,0,0,1,837,3.333333333333333,870.8792933464183,6
2020-09-07-170313,170313,10,0,39,847,11.333333333333336,903.5962818000633,0
2020-09-08-170313,170313,7,0,10,854,13.333333333333336,785.793888137615,1
2020-09-09-170313,170313,14,0,12,868,13.666666666666664,789.7472866740443,2
2020-09-10-170313,170313,13,0,13,881,14.0,136.85586630130516,3
2020-09-11-170313,170313,11,0,17,892,18.33333333333333,317.59431474277426,4
2020-09-12-170313,170313,4,0,1,896,4.333333333333333,515.0444617294214,5
2020-09-13-170313,170313,2,0,1,898,10.0,560.1600132763023,6
2020-09-14-170313,170313,21,0,9,919,18.666666666666668,660.6498515397425,0
2020-09-15-170313,170313,4,0,8,923,7.666666666666668,878.6462271830551,1
2020-09-16-170313,170313,12,0,6,935,18.33333333333333,996.4547465334215,2
2020-09-17-170313,170313,12,0,13,947,20.666666666666668,1167.4151684673832,3
2020-09-18-170313,170313,18,0,23,965,19.0,1183.5960124072021,4
2020-09-19-170313,170313,0,0,1,965,1.3333333333333333,1155.8399008005003,5
2020-09-20-170313,170313,1,0,3,966,2.0,1083.0039106701274,6
2020-09-21-170313,170313,39,3,0,1005,25.33333333333333,902.0772742824867,0
2020-09-22-170313,170313,10,0,10,1015,16.333333333333332,1094.0522146746857,1
2020-09-23-170313,170313,12,0,16,1027,13.333333333333336,1072.239145667245,2
2020-09-24-170313,170313,13,1,21,1040,16.333333333333332,1055.6095654207952,3
2020-09-25-170313,170313,17,0,14,1057,13.0,1097.343717170173,4
2020-09-26-170313,170313,1,0,1,1058,4.333333333333333,1237.0609167094785,5
2020-09-27-170313,170313,1,0,1,1059,1.6666666666666667,1219.9091099461407,6
2020-09-28-170313,170313,9,0,8,1068,26.33333333333333,1208.1244822605152,0
2020-09-29-170313,170313,8,1,15,1076,11.333333333333336,1216.163652603877,1
2020-09-30-170313,170313,6,0,15,1082,16.333333333333332,1088.0893614409765,2
2020-10-01-170313,170313,13,0,26,1095,21.33333333333333,0.0,3
2020-10-02-170313,170313,23,0,35,1118,30.33333333333333,2223.174009001478,4
2020-10-03-170313,170313,1,0,9,1119,7.0,2042.7943606825509,5
2020-10-04-170313,170313,3,0,1,1122,4.666666666666667,2101.058541986256,6
2020-10-05-170313,170313,0,0,29,1122,2.0,1701.423363905529,0
2020-10-06-170313,170313,10,0,20,1132,25.0,1441.3691283719756,1
2020-10-07-170313,170313,16,1,18,1148,18.33333333333333,1283.6410271291877,2
2020-10-08-170313,170313,21,1,21,1169,20.33333333333333,1216.06360829903,3
2020-10-09-170313,170313,14,3,29,1183,22.0,1391.997873377582,4
2020-10-10-170313,170313,1,0,5,1184,3.333333333333333,300.50037797206346,5
2020-10-11-170313,170313,1,0,2,1185,4.0,348.2722457536362,6
2020-10-12-170313,170313,8,0,22,1193,3.333333333333333,400.38841887666155,0
2020-10-13-170313,170313,15,0,25,1208,36.0,467.40032847457655,1
2020-10-14-170313,170313,15,0,23,1223,25.66666666666667,915.8418432401894,2
2020-10-15-170313,170313,26,0,8,1249,30.33333333333333,1214.6547976298466,3
2020-10-16-170313,170313,35,0,27,1284,22.66666666666667,1531.4271252414599,4
2020-10-17-170313,170313,9,0,6,1293,3.333333333333333,1613.1934121407428,5
2020-10-18-170313,170313,1,0,1,1294,4.333333333333333,1626.973373292182,6
2020-10-19-170313,170313,29,1,5,1323,37.66666666666666,1643.1652475916007,0
2020-10-20-170313,170313,20,0,28,1343,23.0,2056.3549921004924,1
2020-10-21-170313,170313,18,0,13,1361,26.0,2037.381273949532,2
2020-10-22-170313,170313,21,0,18,1382,37.0,2035.8160046942974,3
2020-10-23-170313,170313,29,0,22,1411,34.0,2068.7224518823464,4
2020-10-24-170313,170313,5,1,5,1416,6.0,2371.7421248586493,5
2020-10-25-170313,170313,2,2,1,1418,4.333333333333333,2388.4340274726,6
2020-10-26-170313,170313,22,1,34,1440,38.0,1903.9386997172335,0
2020-10-27-170313,170313,25,1,25,1465,11.666666666666664,2050.4867588620227,1
2020-10-28-170313,170313,23,0,17,1488,37.333333333333336,1948.4180515841915,2
2020-10-29-170313,170313,8,0,17,1496,31.0,2070.8966504959426,3
2020-10-30-170313,170313,27,0,19,1523,24.0,1709.8021958160796,4
2020-10-31-170313,170313,6,0,0,1529,7.666666666666668,2026.41816242393,5
2020-11-01-170313,170313,1,0,0,1530,2.6666666666666665,1430.9904169878607,6
2020-11-02-170313,170313,5,3,0,1535,3.6666666666666665,1797.8852454647508,0
2020-11-03-170313,170313,28,1,0,1563,42.0,1519.2729830520493,1
2020-11-04-170313,170313,13,0,0,1576,18.666666666666668,1995.1731282638543,2
2020-11-05-170313,170313,18,0,0,1594,31.66666666666667,1705.7890181677385,3
2020-11-06-170313,170313,22,4,0,1616,26.66666666666667,1874.2884248122461,4
2020-11-07-170313,170313,5,0,0,1621,3.333333333333333,1988.7682384702825,5
2020-11-08-170313,170313,1,0,0,1622,3.333333333333333,1775.9293752127767,6
2020-11-09-170313,170313,34,0,0,1656,35.666666666666664,1775.7829620917387,0
2020-11-10-170313,170313,25,0,0,1681,39.333333333333336,1367.7833975690087,1
2020-11-11-170313,170313,17,0,0,1698,30.0,1758.9045425333634,2
2020-11-12-170313,170313,17,2,0,1715,36.0,2059.2853834334724,3
2020-11-13-170313,170313,19,1,0,1734,24.66666666666667,2062.9247498344853,4
2020-03-01-170314,170314,0,0,2,0,0.2,0.0,6
2020-03-02-170314,170314,0,0,9,0,0.0,112.64671009158648,0
2020-03-03-170314,170314,0,0,12,0,0.0,452.9403277406153,1
2020-03-04-170314,170314,0,0,22,0,0.6,514.9296742182285,2
2020-03-05-170314,170314,0,1,21,0,0.0,545.5630494133264,3
2020-03-06-170314,170314,0,0,20,0,0.0,483.60541865876377,4
2020-03-07-170314,170314,0,0,2,0,0.0,555.3750524726665,5
2020-03-08-170314,170314,0,0,0,0,0.0,598.3501163042589,6
2020-03-09-170314,170314,0,0,22,0,0.4,607.8606701164158,0
2020-03-10-170314,170314,0,0,27,0,0.0,1583.2207822135908,1
2020-03-11-170314,170314,0,0,17,0,0.4,1352.6943362424872,2
2020-03-12-170314,170314,2,0,20,2,0.4,1030.2151388845268,3
2020-03-13-170314,170314,1,0,10,3,0.4,650.722963519464,4
2020-03-14-170314,170314,1,0,2,4,1.4,575.5483234703185,5
2020-03-15-170314,170314,2,0,1,6,1.0,490.9345526341464,6
2020-03-16-170314,170314,9,0,27,15,19.0,49.2191206442133,0
2020-03-17-170314,170314,12,0,9,27,18.6,205.44195924179783,1
2020-03-18-170314,170314,22,0,2,49,25.0,351.51272855813136,2
2020-03-19-170314,170314,21,1,10,70,20.2,476.346201381344,3
2020-03-20-170314,170314,20,0,8,90,21.4,546.7347627150242,4
2020-03-21-170314,170314,2,0,0,92,1.8,584.3391098434489,5
2020-03-22-170314,170314,0,1,0,92,3.4,558.7625409551949,6
2020-03-23-170314,170314,22,0,10,114,35.2,485.6616240799708,0
2020-03-24-170314,170314,27,2,7,141,22.8,545.8771166198013,1
2020-03-25-170314,170314,17,0,5,158,23.4,542.1494897243858,2
2020-03-26-170314,170314,20,0,3,178,20.8,543.9088171682472,3
2020-03-27-170314,170314,10,0,7,188,20.6,641.8362566175498,4
2020-03-28-170314,170314,2,0,0,190,2.0,633.5633020817966,5
2020-03-29-170314,170314,1,0,2,191,0.2,630.5654390315086,6
2020-03-30-170314,170314,27,0,9,218,28.0,457.7895337574156,0
2020-03-31-170314,170314,9,0,10,227,15.8,469.2493090851881,1
2020-04-01-170314,170314,2,0,10,229,14.2,76.23025671496494,2
2020-04-02-170314,170314,10,0,9,239,12.0,342.05644235282864,3
2020-04-03-170314,170314,8,0,5,247,13.6,175.6707007223868,4
2020-04-04-170314,170314,0,0,1,247,1.6,172.84977955978704,5
2020-04-05-170314,170314,0,0,0,247,1.4,172.86429643306468,6
2020-04-06-170314,170314,10,0,10,257,22.0,179.07375060278073,0
2020-04-07-170314,170314,7,0,6,264,14.4,237.78765241777384,1
2020-04-08-170314,170314,5,0,2,269,10.4,284.1237321720784,2
2020-04-09-170314,170314,3,2,1,272,10.4,302.0797205535513,3
2020-04-10-170314,170314,7,0,4,279,10.6,60.63972004041357,4
2020-04-11-170314,170314,0,0,0,279,1.0,113.95063290499424,5
2020-04-12-170314,170314,2,0,0,281,1.8,121.47231277795996,6
2020-04-13-170314,170314,9,0,6,290,11.6,134.3645068754605,0
2020-04-14-170314,170314,10,0,5,300,10.8,211.41258481343735,1
2020-04-15-170314,170314,10,0,8,310,9.6,282.18881366358016,2
2020-04-16-170314,170314,9,0,2,319,11.6,351.4742870331433,3
2020-04-17-170314,170314,5,0,0,324,9.6,375.60629695430765,4
2020-04-18-170314,170314,1,0,0,325,1.0,378.30150893601115,5
2020-04-19-170314,170314,0,0,0,325,1.4,374.9110875029345,6
2020-04-20-170314,170314,10,0,7,335,15.0,341.35065030682966,0
2020-04-21-170314,170314,6,1,6,341,6.0,333.24470916483966,1
2020-04-22-170314,170314,2,0,3,343,11.4,291.29632964016935,2
2020-04-23-170314,170314,1,0,9,344,2.2,273.5149489514604,3
2020-04-24-170314,170314,4,0,2,348,17.4,224.44829902427378,4
2020-04-25-170314,170314,0,0,0,348,1.0,292.7643016256487,5
2020-04-26-170314,170314,0,0,1,348,0.4,298.8493451691128,6
2020-04-27-170314,170314,6,0,8,354,6.2,242.90163025516003,0
2020-04-28-170314,170314,5,0,3,359,3.6,211.72081509979822,1
2020-04-29-170314,170314,8,0,5,367,6.8,201.53385006434166,2
2020-04-30-170314,170314,2,0,5,369,4.8,230.56325995973717,3
2020-05-01-170314,170314,0,0,4,369,0.2,317.4633003701901,4
2020-05-02-170314,170314,0,0,0,369,1.2,122.91888352388654,5
2020-05-03-170314,170314,0,0,0,369,1.2,103.7833827987215,6
2020-05-04-170314,170314,7,0,6,376,6.2,87.50726471452163,0
2020-05-05-170314,170314,6,0,7,382,3.8,103.86013593739347,1
2020-05-06-170314,170314,3,0,2,385,5.2,115.11700222892165,2
2020-05-07-170314,170314,9,0,3,394,4.8,119.65142747296485,3
2020-05-08-170314,170314,2,0,4,396,4.8,126.1650260642021,4
2020-05-09-170314,170314,0,0,2,396,0.8,161.03823565180403,5
2020-05-10-170314,170314,1,0,0,397,0.0,350.4113818594096,6
2020-05-11-170314,170314,8,0,6,405,6.2,334.5128761718535,0
2020-05-12-170314,170314,3,1,1,408,4.8,362.0839487251038,1
2020-05-13-170314,170314,5,0,3,413,5.0,274.0957446123192,2
2020-05-14-170314,170314,5,0,3,418,5.0,221.625757250079,3
2020-05-15-170314,170314,4,0,2,422,3.4,191.6722401072127,4
2020-05-16-170314,170314,0,0,1,422,1.6,155.5621520598753,5
2020-05-17-170314,170314,0,0,0,422,0.2,163.587890791546,6
2020-05-18-170314,170314,6,0,6,428,4.0,167.2131257680025,0
2020-05-19-170314,170314,7,0,2,435,5.2,158.8628819892161,1
2020-05-20-170314,170314,2,0,6,437,4.8,142.538946897919,2
2020-05-21-170314,170314,3,0,4,440,6.0,134.37007739832157,3
2020-05-22-170314,170314,4,0,7,444,9.0,150.48526934403543,4
2020-05-23-170314,170314,2,0,3,446,0.4,198.08902286793793,5
2020-05-24-170314,170314,0,0,0,446,0.4,201.2783337564323,6
2020-05-25-170314,170314,6,0,0,452,4.2,176.87367749500675,0
2020-05-26-170314,170314,1,0,4,453,3.4,177.49674703803822,1
2020-05-27-170314,170314,3,1,8,456,3.4,194.93492360419714,2
2020-05-28-170314,170314,3,0,5,459,5.6,192.55832553588246,3
2020-05-29-170314,170314,2,1,8,461,4.4,191.3503990295677,4
2020-05-30-170314,170314,1,0,0,462,1.0,168.45499026760433,5
2020-05-31-170314,170314,0,0,0,462,0.2,172.05549513556483,6
2020-06-01-170314,170314,6,0,3,468,4.4,216.14954822745386,0
2020-06-02-170314,170314,2,0,4,470,5.4,80.34743811979989,1
2020-06-03-170314,170314,6,0,3,476,6.2,41.18155938988049,2
2020-06-04-170314,170314,4,0,0,480,2.6,70.9625729397566,3
2020-06-05-170314,170314,7,0,1,487,7.0,90.23283040720068,4
2020-06-06-170314,170314,3,0,0,490,0.0,134.2817464956956,5
2020-06-07-170314,170314,0,0,0,490,0.0,138.3544938671493,6
2020-06-08-170314,170314,0,0,2,490,5.4,140.9074327282805,0
2020-06-09-170314,170314,4,0,4,494,5.8,177.8877725866709,1
2020-06-10-170314,170314,8,0,0,502,4.6,272.522462793645,2
2020-06-11-170314,170314,5,0,1,507,4.2,273.88933179750603,3
2020-06-12-170314,170314,8,0,2,515,2.2,272.47880484336036,4
2020-06-13-170314,170314,0,0,0,515,0.8,256.16247825356044,5
2020-06-14-170314,170314,0,5,0,515,0.2,218.94689196592088,6
2020-06-15-170314,170314,3,0,1,518,1.6,177.80971519643631,0
2020-06-16-170314,170314,4,0,0,522,2.2,185.33848246922582,1
2020-06-17-170314,170314,3,0,1,525,1.4,164.0242053043417,2
2020-06-18-170314,170314,0,0,2,525,1.6,131.9114528565285,3
2020-06-19-170314,170314,1,0,1,526,1.4,107.04750086389775,4
2020-06-20-170314,170314,0,0,0,526,0.0,140.95089549102264,5
2020-06-21-170314,170314,0,0,0,526,0.0,138.7987954936259,6
2020-06-22-170314,170314,2,0,1,528,0.4,124.86873419978122,0
2020-06-23-170314,170314,4,0,0,532,0.8,108.40063733201708,1
2020-06-24-170314,170314,0,0,0,532,0.2,109.96728716174744,2
2020-06-25-170314,170314,1,0,2,533,1.4,93.26106138271385,3
2020-06-26-170314,170314,2,1,3,535,1.2,87.85968638823783,4
2020-06-27-170314,170314,0,0,2,535,0.0,48.948663866682466,5
2020-06-28-170314,170314,0,0,0,535,0.0,49.65314691555707,6
2020-06-29-170314,170314,1,0,4,536,0.4,49.41467614574688,0
2020-06-30-170314,170314,0,0,2,536,0.6,80.51605849127036,1
2020-07-01-170314,170314,1,0,3,537,0.4,196.68585311077194,2
2020-07-02-170314,170314,2,0,0,539,0.2,57.78723290423956,3
2020-07-03-170314,170314,1,0,5,540,1.2,51.46974332223495,4
2020-07-04-170314,170314,0,0,0,540,0.0,69.46542811455006,5
2020-07-05-170314,170314,0,0,0,540,0.2,62.79251545535616,6
2020-07-06-170314,170314,1,0,2,541,0.8,56.11062782125315,0
2020-07-07-170314,170314,0,0,1,541,2.0,56.48762822616574,1
2020-07-08-170314,170314,0,0,3,541,0.8,62.12981305487804,2
2020-07-09-170314,170314,2,3,1,543,0.6,55.84954542542959,3
2020-07-10-170314,170314,3,0,0,546,0.6,207.13569577232508,4
2020-07-11-170314,170314,2,0,0,548,0.0,182.68839872139006,5
2020-07-12-170314,170314,0,0,0,548,0.2,125.27396714323427,6
2020-07-13-170314,170314,4,0,0,552,0.8,122.60256643149931,0
2020-07-14-170314,170314,2,0,1,554,0.4,132.10308263605037,1
2020-07-15-170314,170314,3,0,1,557,1.0,91.52222251280412,2
2020-07-16-170314,170314,0,0,4,557,0.0,49.444050928410874,3
2020-07-17-170314,170314,5,0,0,562,1.0,49.32778820148453,4
2020-07-18-170314,170314,0,0,0,562,0.2,54.40437586843117,5
2020-07-19-170314,170314,0,0,0,562,0.4,54.20178368410157,6
2020-07-20-170314,170314,2,0,1,564,1.0,46.76425876267665,0
2020-07-21-170314,170314,1,0,0,565,1.0,56.17745759634858,1
2020-07-22-170314,170314,3,0,2,568,1.2,57.016021326294606,2
2020-07-23-170314,170314,1,0,0,569,0.2,68.11702926334189,3
2020-07-24-170314,170314,0,0,1,569,1.6,58.56112543269419,4
2020-07-25-170314,170314,0,0,0,569,0.2,66.18653799291215,5
2020-07-26-170314,170314,0,0,0,569,1.0,63.826849764840276,6
2020-07-27-170314,170314,0,0,1,569,1.0,66.79563283766578,0
2020-07-28-170314,170314,1,0,2,570,0.2,61.46921919155383,1
2020-07-29-170314,170314,1,0,5,571,0.4,59.9069581668999,2
2020-07-30-170314,170314,4,0,4,575,1.4,55.21910017414628,3
2020-07-31-170314,170314,0,0,2,575,1.0,58.847315765118765,4
2020-08-01-170314,170314,0,0,1,575,0.4,49.51649357257894,5
2020-08-02-170314,170314,0,0,1,575,0.0,112.13252442549174,6
2020-08-03-170314,170314,1,0,0,576,1.8,379.23912811699756,0
2020-08-04-170314,170314,0,0,1,576,1.2,358.39171086611225,1
2020-08-05-170314,170314,2,0,4,578,1.2,320.9355063790749,2
2020-08-06-170314,170314,0,0,6,578,1.2,274.856606683179,3
2020-08-07-170314,170314,1,0,6,579,0.6,213.60558917479278,4
2020-08-08-170314,170314,0,0,0,579,0.4,169.04425343120138,5
2020-08-09-170314,170314,0,0,0,579,0.2,153.35567263299924,6
2020-08-10-170314,170314,1,0,1,580,1.6,42.57719996799266,0
2020-08-11-170314,170314,2,0,7,582,1.4,57.82199630259023,1
2020-08-12-170314,170314,5,0,3,587,1.8,72.59769443390046,2
2020-08-13-170314,170314,4,0,3,591,2.0,79.06197086847284,3
2020-08-14-170314,170314,2,0,7,593,1.4,83.91443139825631,4
2020-08-15-170314,170314,1,0,6,594,0.4,88.01107537889544,5
2020-08-16-170314,170314,1,0,1,595,0.2,83.62257727740044,6
2020-08-17-170314,170314,0,0,6,595,2.2,88.82035390907997,0
2020-08-18-170314,170314,1,0,3,596,1.6,93.18132541563507,1
2020-08-19-170314,170314,4,0,4,600,2.6,94.44188576471858,2
2020-08-20-170314,170314,6,0,9,606,2.8,90.61303373669986,3
2020-08-21-170314,170314,6,0,12,612,4.8,108.63548487615166,4
2020-08-22-170314,170314,0,0,3,612,2.2,152.94812847910038,5
2020-08-23-170314,170314,0,0,9,612,1.0,167.0279828250239,6
2020-08-24-170314,170314,1,0,5,613,3.2,160.62443735481486,0
2020-08-25-170314,170314,7,0,8,620,7.6,184.50005278467933,1
2020-08-26-170314,170314,3,0,18,623,3.0,231.9070361365267,2
2020-08-27-170314,170314,3,0,22,626,5.4,275.9375662739403,3
2020-08-28-170314,170314,7,0,17,633,5.8,307.1587169399604,4
2020-08-29-170314,170314,6,0,3,639,6.0,323.4644392312122,5
2020-08-30-170314,170314,1,0,9,640,3.6,360.77718259696127,6
2020-08-31-170314,170314,6,0,17,646,8.0,348.16849597404615,0
2020-09-01-170314,170314,3,0,6,649,3.4,125.39073190967903,1
2020-09-02-170314,170314,4,0,18,653,4.4,672.8293439257478,2
2020-09-03-170314,170314,9,1,26,662,5.4,696.1850638654495,3
2020-09-04-170314,170314,12,0,16,674,6.4,646.2701017782541,4
2020-09-05-170314,170314,3,1,2,677,3.6,602.168750028186,5
2020-09-06-170314,170314,9,0,0,686,2.2,609.4792617933748,6
2020-09-07-170314,170314,5,0,18,691,11.2,632.4039128847817,0
2020-09-08-170314,170314,8,0,16,699,11.8,549.4935209852256,1
2020-09-09-170314,170314,18,0,7,717,10.4,552.4026851591331,2
2020-09-10-170314,170314,22,0,10,739,10.2,99.56368945649788,3
2020-09-11-170314,170314,17,0,8,756,12.4,228.2675795199309,4
2020-09-12-170314,170314,3,0,1,759,4.2,363.8119633529088,5
2020-09-13-170314,170314,9,0,0,768,7.6,399.747634432154,6
2020-09-14-170314,170314,17,0,26,785,14.0,456.5184882434398,0
2020-09-15-170314,170314,6,0,11,791,6.0,599.9067223474852,1
2020-09-16-170314,170314,18,0,17,809,14.4,674.365610959154,2
2020-09-17-170314,170314,26,0,15,835,13.2,789.3270071061506,3
2020-09-18-170314,170314,16,0,21,851,15.2,783.876915069962,4
2020-09-19-170314,170314,2,0,7,853,1.4,751.4434436838818,5
2020-09-20-170314,170314,0,0,3,853,2.4,711.0541362412959,6
2020-09-21-170314,170314,18,0,1,871,24.0,593.5442247324008,0
2020-09-22-170314,170314,16,2,17,887,12.4,703.577589798406,1
2020-09-23-170314,170314,7,1,9,894,13.4,680.3229583427012,2
2020-09-24-170314,170314,10,0,18,904,14.8,668.5544252156367,3
2020-09-25-170314,170314,8,0,13,912,13.8,711.6096242272295,4
2020-09-26-170314,170314,1,0,1,913,2.8,808.5019865621965,5
2020-09-27-170314,170314,0,0,0,913,2.0,800.8833065086142,6
2020-09-28-170314,170314,26,0,5,939,18.4,794.7597239646917,0
2020-09-29-170314,170314,11,0,31,950,9.0,798.2693821797067,1
2020-09-30-170314,170314,17,0,21,967,11.4,724.3143923808304,2
2020-10-01-170314,170314,15,0,21,982,18.4,0.0,3
2020-10-02-170314,170314,21,0,20,1003,24.6,1515.4938158930586,4
2020-10-03-170314,170314,7,0,4,1010,5.4,1331.6755662628725,5
2020-10-04-170314,170314,3,1,4,1013,4.4,1368.6461386701058,6
2020-10-05-170314,170314,1,0,22,1014,2.4,1113.2475153091118,0
2020-10-06-170314,170314,17,0,20,1031,17.2,931.9525659149748,1
2020-10-07-170314,170314,9,2,13,1040,18.2,863.8030613751046,2
2020-10-08-170314,170314,18,0,23,1058,18.8,811.5429892568334,3
2020-10-09-170314,170314,13,5,26,1071,27.2,944.0509859826363,4
2020-10-10-170314,170314,1,0,7,1072,3.0,216.7510767146027,5
2020-10-11-170314,170314,0,0,2,1072,4.0,251.84273707920377,6
2020-10-12-170314,170314,5,0,36,1077,4.0,287.9056868666793,0
2020-10-13-170314,170314,31,0,18,1108,30.0,343.8941649220568,1
2020-10-14-170314,170314,21,0,19,1129,19.8,658.8744582150997,2
2020-10-15-170314,170314,21,0,23,1150,25.0,846.4605571702357,3
2020-10-16-170314,170314,20,0,17,1170,22.8,1066.989562595923,4
2020-10-17-170314,170314,4,0,5,1174,4.4,1109.3034441882992,5
2020-10-18-170314,170314,4,0,0,1178,2.8,1114.40258340946,6
2020-10-19-170314,170314,22,1,1,1200,37.8,1123.6332841979238,0
2020-10-20-170314,170314,20,1,36,1220,17.6,1354.2689224204828,1
2020-10-21-170314,170314,13,0,17,1233,22.4,1331.8020268022829,2
2020-10-22-170314,170314,23,1,23,1256,27.0,1320.4646920988125,3
2020-10-23-170314,170314,26,1,19,1282,25.2,1291.177716764979,4
2020-10-24-170314,170314,7,0,0,1289,4.8,1490.397157805041,5
2020-10-25-170314,170314,2,0,2,1291,3.0,1486.3874940140029,6
2020-10-26-170314,170314,36,0,33,1327,28.2,1183.0923187777346,0
2020-10-27-170314,170314,18,1,17,1345,12.2,1277.7704084822983,1
2020-10-28-170314,170314,19,1,26,1364,30.4,1241.0861550084408,2
2020-10-29-170314,170314,23,2,27,1387,24.0,1297.7239281113602,3
2020-10-30-170314,170314,17,1,17,1404,27.2,1099.8651546362448,4
2020-10-31-170314,170314,5,0,0,1409,5.8,1317.6734671254096,5
2020-11-01-170314,170314,0,1,0,1409,2.2,1011.5683293090552,6
2020-11-02-170314,170314,1,2,0,1410,3.4,1174.1092403662724,0
2020-11-03-170314,170314,36,1,0,1446,33.0,1005.6353297558404,1
2020-11-04-170314,170314,17,2,0,1463,14.0,1330.8269765879604,2
2020-11-05-170314,170314,23,1,0,1486,24.8,1170.6044861186006,3
2020-11-06-170314,170314,19,5,0,1505,21.2,1273.4610243391235,4
2020-11-07-170314,170314,0,0,0,1505,3.6,1355.0388322707952,5
2020-11-08-170314,170314,2,0,0,1507,7.6,1202.9305052646723,6
2020-11-09-170314,170314,33,0,0,1540,36.2,1197.651806964875,0
2020-11-10-170314,170314,17,1,0,1557,31.6,970.5438614638081,1
2020-11-11-170314,170314,26,1,0,1583,21.4,1199.5234674265769,2
2020-11-12-170314,170314,27,2,0,1610,26.0,1376.5824643655874,3
2020-11-13-170314,170314,17,2,0,1627,20.2,1350.5011661313733,4
2020-03-01-170315,170315,1,0,0,1,0.0,0.0,6
2020-03-02-170315,170315,0,0,17,1,0.0,16.62651883249608,0
2020-03-03-170315,170315,0,2,11,1,0.0,66.67363849726901,1
2020-03-04-170315,170315,0,1,22,1,0.0,75.85554267580177,2
2020-03-05-170315,170315,0,0,15,1,0.0,80.02656262657293,3
2020-03-06-170315,170315,0,0,14,1,0.0,70.84889492200853,4
2020-03-07-170315,170315,0,0,2,1,0.0,81.21222557671456,5
2020-03-08-170315,170315,0,0,0,1,0.0,87.4805407928961,6
2020-03-09-170315,170315,0,0,18,1,0.0,88.66724225147203,0
2020-03-10-170315,170315,0,0,12,1,0.0,230.6710343826128,1
2020-03-11-170315,170315,0,0,13,1,0.16666666666666666,197.0237096507729,2
2020-03-12-170315,170315,1,0,5,2,0.5,150.02108252023464,3
2020-03-13-170315,170315,0,0,18,2,0.16666666666666666,94.84825643960528,4
2020-03-14-170315,170315,0,0,1,2,1.3333333333333333,84.31592816668774,5
2020-03-15-170315,170315,0,0,0,2,1.6666666666666667,72.43151029340046,6
2020-03-16-170315,170315,17,0,11,19,12.333333333333336,7.264343041935751,0
2020-03-17-170315,170315,11,0,13,30,17.666666666666668,30.12465539707099,1
2020-03-18-170315,170315,22,0,9,52,19.33333333333333,52.549457995287646,2
2020-03-19-170315,170315,15,0,6,67,22.0,72.205956682133,3
2020-03-20-170315,170315,14,1,10,81,18.5,84.1601423693184,4
2020-03-21-170315,170315,2,0,0,83,2.6666666666666665,91.05455684186653,5
2020-03-22-170315,170315,0,0,0,83,3.1666666666666665,87.42543871108894,6
2020-03-23-170315,170315,18,0,7,101,27.66666666666667,76.26780046472757,0
2020-03-24-170315,170315,12,0,4,113,23.0,85.81207050912785,1
2020-03-25-170315,170315,13,0,4,126,23.0,85.23455124364156,2
2020-03-26-170315,170315,5,0,2,131,25.0,85.76168584844002,3
2020-03-27-170315,170315,18,0,7,149,20.33333333333333,102.01743402962637,4
2020-03-28-170315,170315,1,0,0,150,2.833333333333333,101.24336729858918,5
2020-03-29-170315,170315,0,0,1,150,2.6666666666666665,100.70617927333123,6
2020-03-30-170315,170315,11,1,10,161,24.5,73.45999916190708,0
2020-03-31-170315,170315,13,0,2,174,15.833333333333336,75.47968912512346,1
2020-04-01-170315,170315,9,0,6,183,10.833333333333336,12.185812285677343,2
2020-04-02-170315,170315,6,0,4,189,10.0,53.337740663770035,3
2020-04-03-170315,170315,10,0,1,199,11.333333333333336,28.86358159249148,4
2020-04-04-170315,170315,0,0,0,199,1.8333333333333333,27.97815725879972,5
2020-04-05-170315,170315,0,0,0,199,2.0,27.94544304206388,6
2020-04-06-170315,170315,7,1,5,206,17.0,28.92759351131507,0
2020-04-07-170315,170315,4,0,5,210,10.666666666666666,37.81595835369128,1
2020-04-08-170315,170315,4,0,1,214,7.5,45.258126118264066,2
2020-04-09-170315,170315,2,0,1,216,9.5,48.2498223396859,3
2020-04-10-170315,170315,7,0,2,223,11.5,9.90739331203002,4
2020-04-11-170315,170315,0,1,0,223,1.5,18.024727788904073,5
2020-04-12-170315,170315,1,0,0,224,2.5,19.202841765959647,6
2020-04-13-170315,170315,10,0,1,234,14.833333333333336,21.194341989779065,0
2020-04-14-170315,170315,2,0,0,236,13.166666666666664,33.528861498643224,1
2020-04-15-170315,170315,6,0,3,242,12.666666666666664,44.4210934070294,2
2020-04-16-170315,170315,4,0,3,246,10.666666666666666,54.93976141937955,3
2020-04-17-170315,170315,1,0,0,247,9.0,57.824304304642304,4
2020-04-18-170315,170315,0,0,0,247,1.0,58.67695750231577,5
2020-04-19-170315,170315,0,0,3,247,1.1666666666666667,58.24029624051012,6
2020-04-20-170315,170315,5,0,6,252,12.833333333333336,52.99562753001747,0
2020-04-21-170315,170315,5,0,0,257,5.833333333333332,51.796248221475196,1
2020-04-22-170315,170315,1,1,3,258,10.5,45.55417341201816,2
2020-04-23-170315,170315,1,0,3,259,2.333333333333333,43.85115732460426,3
2020-04-24-170315,170315,2,0,2,261,16.833333333333332,35.97654841182084,4
2020-04-25-170315,170315,0,0,0,261,1.6666666666666667,47.44028669573551,5
2020-04-26-170315,170315,0,0,0,261,0.8333333333333334,48.28793014324137,6
2020-04-27-170315,170315,1,0,5,262,6.333333333333332,39.48541318796626,0
2020-04-28-170315,170315,0,0,3,262,4.666666666666667,34.94885620103623,1
2020-04-29-170315,170315,3,0,0,265,6.5,33.396908810354226,2
2020-04-30-170315,170315,3,0,2,268,7.333333333333332,37.68106419751971,3
2020-05-01-170315,170315,0,0,1,268,0.3333333333333333,50.38885623953514,4
2020-05-02-170315,170315,0,0,0,268,1.3333333333333333,19.95462428287179,5
2020-05-03-170315,170315,3,0,0,271,0.5,16.994766974589492,6
2020-05-04-170315,170315,6,0,2,277,6.666666666666668,14.196604949366407,0
2020-05-05-170315,170315,0,0,1,277,4.833333333333333,16.858418022396084,1
2020-05-06-170315,170315,3,0,1,280,4.833333333333333,18.730441329818095,2
2020-05-07-170315,170315,3,0,2,283,4.666666666666667,19.220051095347667,3
2020-05-08-170315,170315,2,0,2,285,4.666666666666667,20.04851553093338,4
2020-05-09-170315,170315,0,0,0,285,0.8333333333333334,25.509684511956138,5
2020-05-10-170315,170315,0,0,0,285,0.16666666666666666,54.62807331430294,6
2020-05-11-170315,170315,5,0,3,290,4.666666666666667,52.20818911260586,0
2020-05-12-170315,170315,3,0,0,293,4.0,56.39619152139629,1
2020-05-13-170315,170315,0,0,3,293,6.833333333333332,43.166671465658055,2
2020-05-14-170315,170315,2,1,0,295,6.333333333333332,35.104418489403855,3
2020-05-15-170315,170315,1,0,0,296,4.166666666666667,30.60971517414589,4
2020-05-16-170315,170315,0,1,1,296,0.8333333333333334,24.657466650894747,5
2020-05-17-170315,170315,0,0,1,296,0.16666666666666666,25.96736984556112,6
2020-05-18-170315,170315,2,0,4,298,4.166666666666667,26.48273557707326,0
2020-05-19-170315,170315,1,0,2,299,4.666666666666667,25.194983035877524,1
2020-05-20-170315,170315,1,0,5,300,3.333333333333333,22.339779105488923,2
2020-05-21-170315,170315,2,0,2,302,5.333333333333333,20.893908229820568,3
2020-05-22-170315,170315,2,0,2,304,6.666666666666668,23.366012919054665,4
2020-05-23-170315,170315,0,0,0,304,0.8333333333333334,30.74746754835096,5
2020-05-24-170315,170315,0,0,0,304,0.5,31.276021621807754,6
2020-05-25-170315,170315,3,0,0,307,4.833333333333333,27.512603524408807,0
2020-05-26-170315,170315,0,0,1,307,2.5,27.645751720969777,1
2020-05-27-170315,170315,3,0,2,310,2.833333333333333,30.183192928249095,2
2020-05-28-170315,170315,0,0,2,310,4.333333333333333,29.716871152260527,3
2020-05-29-170315,170315,0,0,1,310,4.333333333333333,29.665276588848894,4
2020-05-30-170315,170315,1,0,0,311,0.8333333333333334,26.070588822258216,5
2020-05-31-170315,170315,1,0,0,312,0.5,26.522503056389358,6
2020-06-01-170315,170315,4,0,0,316,5.5,33.211836355150716,0
2020-06-02-170315,170315,2,0,0,318,4.166666666666667,12.276800685756633,1
2020-06-03-170315,170315,5,0,1,323,6.0,6.360700996470147,2
2020-06-04-170315,170315,2,0,1,325,4.166666666666667,10.89130455246167,3
2020-06-05-170315,170315,2,0,0,327,5.333333333333333,13.979966938574385,4
2020-06-06-170315,170315,0,0,0,327,0.6666666666666666,20.677373297533155,5
2020-06-07-170315,170315,0,0,0,327,0.16666666666666666,21.237390297093135,6
2020-06-08-170315,170315,0,0,1,327,4.833333333333333,21.63160350080191,0
2020-06-09-170315,170315,1,0,0,328,4.5,27.276254123940266,1
2020-06-10-170315,170315,2,0,1,330,4.666666666666667,41.51378322066718,2
2020-06-11-170315,170315,2,0,2,332,4.166666666666667,41.639341418680004,3
2020-06-12-170315,170315,1,0,0,333,3.5,41.3272302169304,4
2020-06-13-170315,170315,0,0,0,333,0.6666666666666666,38.935704026217685,5
2020-06-14-170315,170315,0,0,0,333,0.3333333333333333,33.3027412800419,6
2020-06-15-170315,170315,0,1,0,333,2.0,27.050993699448327,0
2020-06-16-170315,170315,0,0,1,333,2.5,28.247155678953142,1
2020-06-17-170315,170315,1,0,0,334,1.6666666666666667,24.882264027861797,2
2020-06-18-170315,170315,1,1,1,335,1.3333333333333333,19.952242350213854,3
2020-06-19-170315,170315,0,0,0,335,1.8333333333333333,16.057172718566534,4
2020-06-20-170315,170315,0,0,0,335,0.0,21.020537786901368,5
2020-06-21-170315,170315,0,0,0,335,0.0,20.64999682119903,6
2020-06-22-170315,170315,1,0,1,336,1.0,18.505238585616418,0
2020-06-23-170315,170315,0,0,1,336,2.333333333333333,16.056108252584195,1
2020-06-24-170315,170315,1,0,0,337,0.3333333333333333,16.356026932625902,2
2020-06-25-170315,170315,2,0,0,339,1.1666666666666667,13.988512163316027,3
2020-06-26-170315,170315,0,2,0,339,1.3333333333333333,13.046339614209082,4
2020-06-27-170315,170315,0,0,0,339,0.0,7.335256617721658,5
2020-06-28-170315,170315,0,0,0,339,0.0,7.428030264874346,6
2020-06-29-170315,170315,0,0,0,339,0.6666666666666666,7.384510664306752,0
2020-06-30-170315,170315,1,0,0,340,0.3333333333333333,12.045805945340609,1
2020-07-01-170315,170315,0,0,1,340,0.6666666666666666,29.612015379879104,2
2020-07-02-170315,170315,1,0,0,341,0.3333333333333333,8.777881952706922,3
2020-07-03-170315,170315,0,0,0,341,1.5,7.743448988610843,4
2020-07-04-170315,170315,0,0,0,341,0.0,10.471863190874547,5
2020-07-05-170315,170315,0,0,0,341,0.5,9.443028530180596,6
2020-07-06-170315,170315,1,0,2,342,1.3333333333333333,8.441732617137507,0
2020-07-07-170315,170315,1,0,1,343,1.6666666666666667,8.52142895043238,1
2020-07-08-170315,170315,0,0,1,343,0.6666666666666666,9.40865253715925,2
2020-07-09-170315,170315,0,1,0,343,1.1666666666666667,8.424514855324572,3
2020-07-10-170315,170315,0,0,2,343,1.6666666666666667,31.10829526101744,4
2020-07-11-170315,170315,0,0,0,343,0.6666666666666666,27.430138337799,5
2020-07-12-170315,170315,0,0,1,343,0.16666666666666666,18.904156690970016,6
2020-07-13-170315,170315,0,0,0,343,1.8333333333333333,18.500544958065305,0
2020-07-14-170315,170315,0,0,0,343,1.0,19.98156662255957,1
2020-07-15-170315,170315,1,0,0,344,1.3333333333333333,13.858229819162197,2
2020-07-16-170315,170315,0,0,0,344,0.6666666666666666,7.4934504182310135,3
2020-07-17-170315,170315,0,0,1,344,2.0,7.486308316288328,4
2020-07-18-170315,170315,0,0,1,344,0.16666666666666666,8.242549508910653,5
2020-07-19-170315,170315,0,0,0,344,0.3333333333333333,8.204972063648945,6
2020-07-20-170315,170315,2,0,2,346,1.8333333333333333,7.082215564355027,0
2020-07-21-170315,170315,1,0,0,347,0.6666666666666666,8.48412582102741,1
2020-07-22-170315,170315,1,0,0,348,1.8333333333333333,8.6279524279265,2
2020-07-23-170315,170315,0,0,2,348,0.5,10.222319568158733,3
2020-07-24-170315,170315,2,0,0,350,1.1666666666666667,8.738132928932055,4
2020-07-25-170315,170315,0,0,1,350,0.0,9.896035568366106,5
2020-07-26-170315,170315,1,0,0,351,0.5,9.511382749489155,6
2020-07-27-170315,170315,0,0,3,351,0.8333333333333334,9.992157409751611,0
2020-07-28-170315,170315,0,0,0,351,1.1666666666666667,9.187016795792003,1
2020-07-29-170315,170315,0,0,1,351,1.0,8.966678237803816,2
2020-07-30-170315,170315,0,0,0,351,1.5,8.349087661553744,3
2020-07-31-170315,170315,1,0,1,352,1.1666666666666667,8.880298152045139,4
2020-08-01-170315,170315,1,0,0,353,0.0,7.455634904276803,5
2020-08-02-170315,170315,0,0,0,353,0.0,16.794466471923805,6
2020-08-03-170315,170315,2,0,0,355,1.6666666666666667,56.563360664628554,0
2020-08-04-170315,170315,0,0,2,355,1.5,53.54536863432827,1
2020-08-05-170315,170315,0,0,1,355,1.8333333333333333,47.843421385531805,2
2020-08-06-170315,170315,2,0,2,357,0.6666666666666666,41.05300664814521,3
2020-08-07-170315,170315,0,0,2,357,2.0,31.99815563011599,4
2020-08-08-170315,170315,1,0,0,358,0.16666666666666666,25.315451702658805,5
2020-08-09-170315,170315,0,0,0,358,0.0,22.923278945047336,6
2020-08-10-170315,170315,3,0,1,361,1.3333333333333333,6.4002920704807575,0
2020-08-11-170315,170315,0,0,5,361,1.8333333333333333,8.63694481118241,1
2020-08-12-170315,170315,1,0,2,362,2.833333333333333,10.78452486542795,2
2020-08-13-170315,170315,0,0,0,362,1.3333333333333333,11.700397925249288,3
2020-08-14-170315,170315,1,0,3,363,1.8333333333333333,12.330124195228366,4
2020-08-15-170315,170315,0,0,4,363,0.16666666666666666,12.996981257691491,5
2020-08-16-170315,170315,0,0,6,363,0.5,12.294395868050985,6
2020-08-17-170315,170315,0,0,7,363,1.8333333333333333,13.039443577713957,0
2020-08-18-170315,170315,2,0,3,365,1.5,13.813943617758326,1
2020-08-19-170315,170315,1,0,4,366,3.8333333333333335,14.053404332404776,2
2020-08-20-170315,170315,2,0,2,368,2.333333333333333,13.618264015800055,3
2020-08-21-170315,170315,2,0,6,370,4.333333333333333,16.21955506175001,4
2020-08-22-170315,170315,0,0,6,370,1.1666666666666667,22.750445490178645,5
2020-08-23-170315,170315,0,0,8,370,2.0,24.92142962811733,6
2020-08-24-170315,170315,1,0,7,371,2.333333333333333,23.996049851665187,0
2020-08-25-170315,170315,5,0,9,376,7.0,27.488264416539792,1
2020-08-26-170315,170315,2,0,4,378,4.833333333333333,34.494874854319704,2
2020-08-27-170315,170315,0,0,9,378,5.333333333333333,41.19769205631534,3
2020-08-28-170315,170315,3,0,3,381,5.333333333333333,45.856628492373595,4
2020-08-29-170315,170315,4,0,3,385,5.333333333333333,48.32446548410266,5
2020-08-30-170315,170315,6,0,11,391,2.6666666666666665,53.983025828945685,6
2020-08-31-170315,170315,7,0,7,398,5.833333333333332,52.22427612050285,0
2020-09-01-170315,170315,3,0,5,401,3.5,18.779815205365733,1
2020-09-02-170315,170315,4,0,7,405,3.1666666666666665,101.24003559816467,2
2020-09-03-170315,170315,2,0,9,407,5.666666666666668,104.07027329392693,3
2020-09-04-170315,170315,6,0,9,413,6.833333333333332,96.29054184416518,4
2020-09-05-170315,170315,6,0,2,419,3.1666666666666665,89.73726444650443,5
2020-09-06-170315,170315,8,0,3,427,5.166666666666667,90.86901652678804,6
2020-09-07-170315,170315,7,0,8,434,9.666666666666666,94.38275723525179,0
2020-09-08-170315,170315,9,0,7,443,9.333333333333334,81.99920904300092,1
2020-09-09-170315,170315,4,0,14,447,13.5,82.33273430470886,2
2020-09-10-170315,170315,9,0,10,456,13.666666666666664,14.958709042205147,3
2020-09-11-170315,170315,3,0,6,459,15.333333333333336,34.09250977625188,4
2020-09-12-170315,170315,3,0,1,462,4.5,54.613028801739965,5
2020-09-13-170315,170315,11,0,0,473,8.5,59.8373073623431,6
2020-09-14-170315,170315,7,0,18,480,12.666666666666664,68.65003368895722,0
2020-09-15-170315,170315,5,0,7,485,9.0,90.08247741997559,1
2020-09-16-170315,170315,7,0,11,492,14.166666666666664,101.45659667527559,2
2020-09-17-170315,170315,9,0,12,501,14.833333333333336,118.50376406018148,3
2020-09-18-170315,170315,9,0,11,510,13.333333333333336,118.0130165787918,4
2020-09-19-170315,170315,2,0,10,512,4.666666666666667,113.09769750846425,5
2020-09-20-170315,170315,3,0,7,515,3.333333333333333,107.00357362594931,6
2020-09-21-170315,170315,8,1,1,523,18.666666666666668,89.39925484348763,0
2020-09-22-170315,170315,7,1,6,530,12.833333333333336,105.69444549053914,1
2020-09-23-170315,170315,14,0,10,544,13.166666666666664,102.28146308821294,2
2020-09-24-170315,170315,10,1,15,554,14.166666666666664,100.68210020071683,3
2020-09-25-170315,170315,6,1,8,560,11.666666666666664,106.82159488889009,4
2020-09-26-170315,170315,1,0,2,561,3.333333333333333,120.89458511559143,5
2020-09-27-170315,170315,0,0,3,561,2.333333333333333,119.59188733530013,6
2020-09-28-170315,170315,18,1,5,579,19.0,118.59384539876085,0
2020-09-29-170315,170315,7,0,22,586,9.166666666666666,119.34141647523427,1
2020-09-30-170315,170315,11,0,13,597,16.666666666666668,107.83644173763712,2
2020-10-01-170315,170315,12,0,15,609,23.0,0.0,3
2020-10-02-170315,170315,11,0,15,620,23.0,225.50241387944376,4
2020-10-03-170315,170315,10,0,6,630,5.5,198.9548241183099,5
2020-10-04-170315,170315,7,0,0,637,5.666666666666668,204.25219743748696,6
2020-10-05-170315,170315,1,0,30,638,3.1666666666666665,166.5768190889462,0
2020-10-06-170315,170315,6,0,6,644,21.33333333333333,140.15983466300278,1
2020-10-07-170315,170315,10,0,6,654,15.333333333333336,129.5169558939615,2
2020-10-08-170315,170315,15,1,6,669,17.666666666666668,121.77527118922137,3
2020-10-09-170315,170315,8,0,5,677,26.83333333333333,141.10475180311647,4
2020-10-10-170315,170315,2,0,6,679,4.333333333333333,32.347304770485884,5
2020-10-11-170315,170315,3,0,1,682,3.0,37.61234466874442,6
2020-10-12-170315,170315,5,0,13,687,5.5,42.8579091091736,0
2020-10-13-170315,170315,22,0,7,709,35.666666666666664,51.09822165067608,1
2020-10-14-170315,170315,13,0,11,722,20.666666666666668,98.2925355840528,2
2020-10-15-170315,170315,15,0,16,737,25.33333333333333,126.52235967612134,3
2020-10-16-170315,170315,15,0,12,752,23.16666666666667,159.67656928701433,4
2020-10-17-170315,170315,6,0,5,758,4.333333333333333,166.1008647535091,5
2020-10-18-170315,170315,0,0,1,758,6.166666666666668,167.07309374418833,6
2020-10-19-170315,170315,30,0,2,788,28.33333333333333,168.88011615776367,0
2020-10-20-170315,170315,6,0,12,794,20.166666666666668,203.1067824922119,1
2020-10-21-170315,170315,6,0,6,800,22.83333333333333,200.29457628737268,2
2020-10-22-170315,170315,6,0,7,806,27.33333333333333,198.79978529992738,3
2020-10-23-170315,170315,5,0,6,811,25.33333333333333,195.14371412704082,4
2020-10-24-170315,170315,6,1,2,817,5.666666666666668,224.96314170961068,5
2020-10-25-170315,170315,1,1,26,818,4.5,224.7501227073762,6
2020-10-26-170315,170315,13,1,26,831,28.83333333333333,179.42837670025617,0
2020-10-27-170315,170315,7,0,10,838,13.5,193.45923154359895,1
2020-10-28-170315,170315,11,1,8,849,27.5,187.13270721049602,2
2020-10-29-170315,170315,16,0,20,865,25.16666666666667,195.85231179941917,3
2020-10-30-170315,170315,12,1,3,877,24.0,165.53356405287218,4
2020-10-31-170315,170315,5,0,0,882,4.833333333333333,198.01438744823096,5
2020-11-01-170315,170315,1,1,0,883,7.833333333333332,150.37690039859234,6
2020-11-02-170315,170315,2,0,0,885,2.6666666666666665,175.1369228927753,0
2020-11-03-170315,170315,12,0,0,897,33.666666666666664,150.0358503381505,1
2020-11-04-170315,170315,6,0,0,903,14.166666666666664,198.91275864790848,2
2020-11-05-170315,170315,7,1,0,910,22.5,174.7016140080186,3
2020-11-06-170315,170315,6,6,0,916,24.33333333333333,190.4395810348674,4
2020-11-07-170315,170315,2,1,0,918,2.833333333333333,202.8560086301152,5
2020-11-08-170315,170315,26,0,0,944,5.666666666666668,180.67973620392925,6
2020-11-09-170315,170315,26,0,0,970,37.5,180.39156099262607,0
2020-11-10-170315,170315,10,0,0,980,26.83333333333333,144.8875994825148,1
2020-11-11-170315,170315,8,1,0,988,20.666666666666668,179.73890382649208,2
2020-11-12-170315,170315,20,0,0,1008,20.83333333333333,206.68396299390415,3
2020-11-13-170315,170315,3,0,0,1011,21.0,203.17928061637866,4
2020-03-01-170316,170316,0,0,0,0,0.0,0.0,6
2020-03-02-170316,170316,0,0,25,0,0.0,151.84405580908418,0
2020-03-03-170316,170316,0,0,14,0,0.0,554.5985979470047,1
2020-03-04-170316,170316,2,0,21,2,0.25,604.8819147596594,2
2020-03-05-170316,170316,0,0,16,2,0.0,636.0673944051803,3
2020-03-06-170316,170316,0,0,13,2,0.0,565.8676186482395,4
2020-03-07-170316,170316,0,0,0,2,0.0,648.1684656162504,5
2020-03-08-170316,170316,0,0,5,2,0.0,712.6389409831277,6
2020-03-09-170316,170316,1,0,34,3,0.25,717.5623993108782,0
2020-03-10-170316,170316,0,0,20,3,0.0,1827.306220773035,1
2020-03-11-170316,170316,2,0,18,5,0.0,1570.6907050475252,2
2020-03-12-170316,170316,1,0,8,6,0.5,1199.77575108699,3
2020-03-13-170316,170316,2,0,9,8,0.25,770.9382136051142,4
2020-03-14-170316,170316,0,0,2,8,2.0,699.1211083035222,5
2020-03-15-170316,170316,0,0,1,8,1.75,603.3918955339855,6
2020-03-16-170316,170316,25,0,28,33,15.5,62.88886914931844,0
2020-03-17-170316,170316,14,0,16,47,20.0,278.6644036651666,1
2020-03-18-170316,170316,21,0,17,68,26.0,473.25207953523034,2
2020-03-19-170316,170316,16,0,11,84,22.75,662.9079837052702,3
2020-03-20-170316,170316,13,0,10,97,25.0,782.2991344905532,4
2020-03-21-170316,170316,0,0,2,97,2.25,863.5030001309877,5
2020-03-22-170316,170316,5,0,0,102,3.0,824.5268896406826,6
2020-03-23-170316,170316,34,0,17,136,36.5,706.3888407007753,0
2020-03-24-170316,170316,20,0,13,156,27.25,811.6225818537202,1
2020-03-25-170316,170316,18,0,9,174,25.75,805.6269992416459,2
2020-03-26-170316,170316,8,1,6,182,27.75,822.2175625616281,3
2020-03-27-170316,170316,9,0,11,191,21.5,967.851892733561,4
2020-03-28-170316,170316,2,0,2,193,2.25,954.5731901262542,5
2020-03-29-170316,170316,1,0,2,194,0.25,961.2619712499276,6
2020-03-30-170316,170316,28,0,7,222,32.0,694.2051777560578,0
2020-03-31-170316,170316,16,0,9,238,14.75,709.4459968251726,1
2020-04-01-170316,170316,17,0,11,255,11.75,115.83890352306223,2
2020-04-02-170316,170316,11,0,9,266,13.25,524.5119992576947,3
2020-04-03-170316,170316,10,0,10,276,14.0,262.95208640062697,4
2020-04-04-170316,170316,2,0,3,278,1.5,255.29993434478854,5
2020-04-05-170316,170316,0,0,0,278,1.75,255.70320665182481,6
2020-04-06-170316,170316,17,0,11,295,24.0,265.17545770075407,0
2020-04-07-170316,170316,13,0,4,308,15.5,367.3738944282384,1
2020-04-08-170316,170316,9,1,5,317,11.0,439.02942674314085,2
2020-04-09-170316,170316,6,0,0,323,11.75,469.1250004157769,3
2020-04-10-170316,170316,11,0,4,334,10.5,92.96135739709013,4
2020-04-11-170316,170316,2,0,2,336,0.75,185.48383129077183,5
2020-04-12-170316,170316,2,0,0,338,2.0,200.27685873552596,6
2020-04-13-170316,170316,7,0,2,345,12.5,223.1693542201791,0
2020-04-14-170316,170316,9,0,7,354,13.25,337.2000349204125,1
2020-04-15-170316,170316,11,0,7,365,10.25,451.0825386547994,2
2020-04-16-170316,170316,9,0,2,374,13.5,558.2554972319975,3
2020-04-17-170316,170316,10,0,0,384,10.5,600.7904194856408,4
2020-04-18-170316,170316,3,0,1,387,0.75,588.9384604228541,5
2020-04-19-170316,170316,0,0,1,387,1.75,580.6047629839275,6
2020-04-20-170316,170316,11,0,3,398,17.25,539.3330249586029,0
2020-04-21-170316,170316,4,0,2,402,6.75,533.3190239243905,1
2020-04-22-170316,170316,5,1,3,407,13.25,466.6538497799185,2
2020-04-23-170316,170316,0,0,4,407,2.75,427.43272668381377,3
2020-04-24-170316,170316,4,0,2,411,21.25,359.4325506111777,4
2020-04-25-170316,170316,2,0,0,413,0.75,472.097907493135,5
2020-04-26-170316,170316,0,0,0,413,0.5,475.21669202301837,6
2020-04-27-170316,170316,2,2,4,415,8.5,386.54476179341475,0
2020-04-28-170316,170316,7,0,7,422,4.0,323.47787337160423,1
2020-04-29-170316,170316,7,0,2,429,8.0,310.0874733494887,2
2020-04-30-170316,170316,2,1,2,431,5.25,360.201784069697,3
2020-05-01-170316,170316,0,0,2,431,0.25,500.2738800821927,4
2020-05-02-170316,170316,1,0,0,432,1.25,189.36287991008146,5
2020-05-03-170316,170316,1,0,1,433,0.5,163.45239540426604,6
2020-05-04-170316,170316,3,0,4,436,7.25,137.27749072509388,0
2020-05-05-170316,170316,2,0,5,438,5.75,160.98982073201577,1
2020-05-06-170316,170316,3,0,7,441,5.75,175.28466514165734,2
2020-05-07-170316,170316,4,0,2,445,6.5,180.12564236160077,3
2020-05-08-170316,170316,2,0,8,447,5.5,185.51690263043514,4
2020-05-09-170316,170316,0,0,0,447,1.0,235.8525706430866,5
2020-05-10-170316,170316,0,0,1,447,0.25,524.2812269023083,6
2020-05-11-170316,170316,4,0,4,451,7.5,500.8531262765602,0
2020-05-12-170316,170316,7,0,1,458,4.25,542.3932136054057,1
2020-05-13-170316,170316,2,0,5,460,7.0,395.59127623798213,2
2020-05-14-170316,170316,2,1,2,462,6.5,317.3011817701029,3
2020-05-15-170316,170316,2,1,1,464,4.5,274.73461711452774,4
2020-05-16-170316,170316,0,0,1,464,2.0,222.72941031556235,5
2020-05-17-170316,170316,1,0,0,465,0.0,232.93998810516902,6
2020-05-18-170316,170316,4,0,2,469,5.0,236.93279232888744,0
2020-05-19-170316,170316,5,0,6,474,6.75,223.56888929597625,1
2020-05-20-170316,170316,7,0,3,481,4.5,202.29525486642717,2
2020-05-21-170316,170316,2,0,0,483,7.25,191.89633526471493,3
2020-05-22-170316,170316,8,0,5,491,9.75,219.31921430013824,4
2020-05-23-170316,170316,0,0,0,491,1.0,286.9820025113437,5
2020-05-24-170316,170316,1,0,0,492,0.25,292.60859574523124,6
2020-05-25-170316,170316,4,0,6,496,5.0,258.251756677102,0
2020-05-26-170316,170316,1,0,3,497,4.25,256.03972764002344,1
2020-05-27-170316,170316,5,0,4,502,3.0,285.3354893511206,2
2020-05-28-170316,170316,2,5,2,504,7.25,278.9307624250713,3
2020-05-29-170316,170316,1,1,0,505,5.75,274.8067460205297,4
2020-05-30-170316,170316,1,0,1,506,1.0,242.5531921374394,5
2020-05-31-170316,170316,0,0,0,506,0.0,249.484371515179,6
2020-06-01-170316,170316,2,0,0,508,5.5,310.1244435247797,0
2020-06-02-170316,170316,6,0,4,514,5.25,115.34839997887931,1
2020-06-03-170316,170316,3,0,1,517,7.25,54.43788134083865,2
2020-06-04-170316,170316,0,0,0,517,3.75,100.80719939891432,3
2020-06-05-170316,170316,5,0,1,522,8.75,120.42136442592694,4
2020-06-06-170316,170316,0,0,0,522,0.75,185.28249116653132,5
2020-06-07-170316,170316,0,0,0,522,0.0,190.29733923771903,6
2020-06-08-170316,170316,6,0,0,528,5.25,193.3061708053507,0
2020-06-09-170316,170316,3,0,0,531,7.25,243.1404060628799,1
2020-06-10-170316,170316,4,0,0,535,6.25,374.5482182787207,2
2020-06-11-170316,170316,2,0,1,537,5.5,376.42029629680906,3
2020-06-12-170316,170316,0,0,1,537,4.5,370.4266479778067,4
2020-06-13-170316,170316,1,0,0,538,0.75,340.124353678774,5
2020-06-14-170316,170316,0,0,0,538,0.25,290.5135324496662,6
2020-06-15-170316,170316,0,0,0,538,2.75,231.75752092478172,0
2020-06-16-170316,170316,4,1,0,542,2.75,240.22923996909208,1
2020-06-17-170316,170316,1,0,1,543,2.0,214.30971260920847,2
2020-06-18-170316,170316,0,1,0,543,1.75,172.09425652865264,3
2020-06-19-170316,170316,1,0,1,544,1.75,143.85628813878446,4
2020-06-20-170316,170316,0,0,0,544,0.0,188.9135197031071,5
2020-06-21-170316,170316,0,0,0,544,0.0,187.8409552804065,6
2020-06-22-170316,170316,0,0,0,544,0.75,169.822315563973,0
2020-06-23-170316,170316,0,0,2,544,2.0,146.7477569386826,1
2020-06-24-170316,170316,0,0,2,544,0.0,144.1620584731179,2
2020-06-25-170316,170316,1,0,0,545,1.25,121.14756719866455,3
2020-06-26-170316,170316,1,0,0,546,1.75,118.5017155296462,4
2020-06-27-170316,170316,0,0,0,546,0.0,64.13557491632804,5
2020-06-28-170316,170316,0,0,0,546,0.0,65.1916437238962,6
2020-06-29-170316,170316,0,0,0,546,0.75,64.75612474801505,0
2020-06-30-170316,170316,0,0,0,546,0.5,108.21961089113104,1
2020-07-01-170316,170316,1,0,1,547,0.5,263.2101220961457,2
2020-07-02-170316,170316,0,0,0,547,0.5,75.46273616267892,3
2020-07-03-170316,170316,1,0,1,548,1.5,63.30750808993615,4
2020-07-04-170316,170316,0,0,0,548,0.0,84.16098024924982,5
2020-07-05-170316,170316,0,0,0,548,0.25,75.67916179974281,6
2020-07-06-170316,170316,0,0,0,548,1.0,66.75410928122268,0
2020-07-07-170316,170316,2,0,1,550,1.75,67.34558660613175,1
2020-07-08-170316,170316,2,0,0,552,0.5,75.01591617574644,2
2020-07-09-170316,170316,0,0,0,552,1.25,68.34617788704261,3
2020-07-10-170316,170316,0,0,0,552,1.5,265.2136195813947,4
2020-07-11-170316,170316,0,0,1,552,0.5,238.00773641893358,5
2020-07-12-170316,170316,0,0,0,552,0.25,157.62781823080476,6
2020-07-13-170316,170316,0,0,1,552,2.0,154.42218771086416,0
2020-07-14-170316,170316,0,0,0,552,1.0,167.87949067168555,1
2020-07-15-170316,170316,1,0,2,553,1.5,116.6380504026436,2
2020-07-16-170316,170316,0,0,3,553,0.0,62.192543706448575,3
2020-07-17-170316,170316,1,0,0,554,2.25,62.59638453374513,4
2020-07-18-170316,170316,0,0,0,554,0.25,69.50391611028306,5
2020-07-19-170316,170316,0,0,0,554,0.5,70.13217057307888,6
2020-07-20-170316,170316,0,0,0,554,1.25,60.30463178900753,0
2020-07-21-170316,170316,1,0,0,555,1.0,68.30686457514588,1
2020-07-22-170316,170316,0,0,0,555,2.0,68.8531074166095,2
2020-07-23-170316,170316,0,0,0,555,0.5,83.73735627222014,3
2020-07-24-170316,170316,0,0,0,555,1.5,71.43946392236657,4
2020-07-25-170316,170316,1,0,0,556,0.0,80.69868535349575,5
2020-07-26-170316,170316,0,0,1,556,1.0,77.90104795316357,6
2020-07-27-170316,170316,1,0,1,557,1.0,80.76470740754672,0
2020-07-28-170316,170316,0,1,1,557,0.5,76.21133000436303,1
2020-07-29-170316,170316,2,0,0,559,0.25,72.57705002616882,2
2020-07-30-170316,170316,3,0,4,562,2.0,65.34209952655537,3
2020-07-31-170316,170316,0,0,1,562,1.0,69.1699924391346,4
2020-08-01-170316,170316,0,0,0,562,0.25,59.9685733014293,5
2020-08-02-170316,170316,0,0,0,562,0.0,134.3272701250449,6
2020-08-03-170316,170316,0,1,2,562,2.0,467.36499273568495,0
2020-08-04-170316,170316,0,0,1,562,1.5,434.1266558605975,1
2020-08-05-170316,170316,0,0,0,562,2.0,396.46572243207027,2
2020-08-06-170316,170316,0,0,6,562,1.0,336.50107258491687,3
2020-08-07-170316,170316,0,0,3,562,1.0,261.4955154294207,4
2020-08-08-170316,170316,0,0,5,562,0.25,201.41583702592723,5
2020-08-09-170316,170316,1,0,0,563,0.0,184.68825060577004,6
2020-08-10-170316,170316,1,0,1,564,1.25,51.27264481529062,0
2020-08-11-170316,170316,1,0,7,565,2.0,70.67134942474107,1
2020-08-12-170316,170316,0,0,4,565,3.25,92.08167265876318,2
2020-08-13-170316,170316,4,0,5,569,2.5,102.63793135370496,3
2020-08-14-170316,170316,1,0,10,570,1.75,110.79927089774522,4
2020-08-15-170316,170316,0,0,6,570,0.75,116.58633807544672,5
2020-08-16-170316,170316,0,0,2,570,0.5,110.09982723605164,6
2020-08-17-170316,170316,2,0,6,572,2.25,116.10616044974853,0
2020-08-18-170316,170316,1,0,1,573,1.5,119.3655349232173,1
2020-08-19-170316,170316,0,0,4,573,4.0,115.46720780209546,2
2020-08-20-170316,170316,6,0,4,579,3.0,106.85368695921662,3
2020-08-21-170316,170316,3,0,5,582,6.25,131.05901300225113,4
2020-08-22-170316,170316,5,0,2,587,1.5,189.3287335405739,5
2020-08-23-170316,170316,0,0,0,587,1.25,206.46851580595876,6
2020-08-24-170316,170316,1,0,6,588,3.75,197.84150154224892,0
2020-08-25-170316,170316,7,0,11,595,8.25,234.2708491832189,1
2020-08-26-170316,170316,4,0,7,599,3.0,299.4460784926199,2
2020-08-27-170316,170316,5,0,6,604,6.25,347.20336898237684,3
2020-08-28-170316,170316,10,0,9,614,5.75,385.02619800637683,4
2020-08-29-170316,170316,6,0,4,620,6.5,401.150155779123,5
2020-08-30-170316,170316,2,0,0,622,2.75,454.22544280957914,6
2020-08-31-170316,170316,6,0,15,628,8.25,431.7389365152532,0
2020-09-01-170316,170316,1,0,2,629,4.0,156.55074319243033,1
2020-09-02-170316,170316,4,0,8,633,4.5,839.4923299299887,2
2020-09-03-170316,170316,4,0,3,637,7.5,860.4837867015935,3
2020-09-04-170316,170316,5,0,5,642,8.25,805.4497460101154,4
2020-09-05-170316,170316,2,0,0,644,3.25,746.3747550242631,5
2020-09-06-170316,170316,0,0,3,644,3.0,761.7229637213622,6
2020-09-07-170316,170316,6,0,13,650,12.0,790.398123817428,0
2020-09-08-170316,170316,11,0,5,661,11.75,694.6694904005234,1
2020-09-09-170316,170316,7,0,3,668,14.75,700.0007247946946,2
2020-09-10-170316,170316,6,0,13,674,14.5,115.32835128854578,3
2020-09-11-170316,170316,9,1,13,683,16.75,288.26850827997,4
2020-09-12-170316,170316,4,0,4,687,4.25,454.1515717187843,5
2020-09-13-170316,170316,0,0,4,687,9.0,500.14952243107416,6
2020-09-14-170316,170316,15,0,13,702,16.25,572.5818635914455,0
2020-09-15-170316,170316,2,0,7,704,7.25,754.7019126035725,1
2020-09-16-170316,170316,8,0,3,712,18.75,840.3959943530692,2
2020-09-17-170316,170316,3,0,17,715,20.0,980.8128749664688,3
2020-09-18-170316,170316,5,0,21,720,19.5,976.2729687205868,4
2020-09-19-170316,170316,0,1,2,720,1.75,942.8379655265932,5
2020-09-20-170316,170316,3,0,2,723,1.5,893.4967435868649,6
2020-09-21-170316,170316,13,1,1,736,29.25,741.5263009263385,0
2020-09-22-170316,170316,5,1,21,741,16.5,886.2322578688459,1
2020-09-23-170316,170316,3,0,15,744,14.25,850.1041330658766,2
2020-09-24-170316,170316,13,2,18,757,15.25,823.390327306468,3
2020-09-25-170316,170316,13,0,19,770,14.5,869.7009436729475,4
2020-09-26-170316,170316,4,0,3,774,2.5,986.8818038826233,5
2020-09-27-170316,170316,4,0,7,778,1.5,976.2464590179854,6
2020-09-28-170316,170316,13,0,4,791,21.75,968.2185566903432,0
2020-09-29-170316,170316,7,0,28,798,10.5,964.7790196431015,1
2020-09-30-170316,170316,3,0,13,801,15.0,881.9420931164835,2
2020-10-01-170316,170316,17,0,18,818,19.5,0.0,3
2020-10-02-170316,170316,21,0,18,839,28.0,1861.421011842749,4
2020-10-03-170316,170316,2,0,1,841,5.5,1653.023239072218,5
2020-10-04-170316,170316,2,0,2,843,4.0,1708.8488570520124,6
2020-10-05-170316,170316,1,1,32,844,2.75,1379.5557905310416,0
2020-10-06-170316,170316,21,0,9,865,19.0,1165.210506556126,1
2020-10-07-170316,170316,15,1,21,880,18.75,1088.8060886748067,2
2020-10-08-170316,170316,18,0,5,898,19.75,1020.3818779121797,3
2020-10-09-170316,170316,19,4,28,917,30.5,1192.4467944533449,4
2020-10-10-170316,170316,3,0,3,920,2.75,270.5003019785747,5
2020-10-11-170316,170316,7,0,2,927,2.5,313.6219046365174,6
2020-10-12-170316,170316,4,0,29,931,4.0,360.5891501796138,0
2020-10-13-170316,170316,28,0,6,959,32.75,427.0227279961082,1
2020-10-14-170316,170316,13,0,18,972,23.5,811.074741611817,2
2020-10-15-170316,170316,18,0,21,990,28.25,1048.8757160464615,3
2020-10-16-170316,170316,18,0,14,1008,25.25,1315.21226154708,4
2020-10-17-170316,170316,1,0,8,1009,4.75,1363.374650330309,5
2020-10-18-170316,170316,2,1,5,1011,4.0,1373.6225499525628,6
2020-10-19-170316,170316,32,1,5,1043,37.25,1380.6174186840751,0
2020-10-20-170316,170316,9,0,34,1052,23.25,1680.720954613812,1
2020-10-21-170316,170316,21,0,19,1073,24.5,1647.7788379476342,2
2020-10-22-170316,170316,5,1,29,1078,36.75,1645.3811741831762,3
2020-10-23-170316,170316,28,0,23,1106,29.75,1609.8193096043883,4
2020-10-24-170316,170316,3,0,8,1109,5.5,1852.4470008056135,5
2020-10-25-170316,170316,2,0,3,1111,3.5,1853.8231007383192,6
2020-10-26-170316,170316,29,0,22,1140,33.75,1454.198313653632,0
2020-10-27-170316,170316,6,1,25,1146,16.5,1565.2192003548003,1
2020-10-28-170316,170316,18,1,19,1164,35.5,1519.8085739215956,2
2020-10-29-170316,170316,21,0,34,1185,26.5,1587.0247696512674,3
2020-10-30-170316,170316,14,1,16,1199,31.75,1363.38629998883,4
2020-10-31-170316,170316,8,0,0,1207,5.25,1632.6570949639918,5
2020-11-01-170316,170316,5,1,0,1212,1.25,1261.566516365625,6
2020-11-02-170316,170316,5,0,0,1217,2.75,1480.6430909484916,0
2020-11-03-170316,170316,34,1,0,1251,38.75,1306.634861345132,1
2020-11-04-170316,170316,19,1,0,1270,15.5,1716.9584642067468,2
2020-11-05-170316,170316,29,0,0,1299,27.75,1498.4799691214473,3
2020-11-06-170316,170316,23,4,0,1322,24.0,1626.1159390152961,4
2020-11-07-170316,170316,8,2,0,1330,2.0,1721.9686609126247,5
2020-11-08-170316,170316,3,0,0,1333,2.75,1510.776203231506,6
2020-11-09-170316,170316,22,1,0,1355,41.5,1515.8472258567995,0
2020-11-10-170316,170316,25,2,0,1380,35.0,1222.3751993701117,1
2020-11-11-170316,170316,19,2,0,1399,26.5,1506.1117256898585,2
2020-11-12-170316,170316,34,2,0,1433,25.75,1727.7314277572007,3
2020-11-13-170316,170316,16,1,0,1449,24.75,1691.1170097278666,4
2020-03-01-170317,170317,0,0,3,0,0.125,0.0,6
2020-03-02-170317,170317,0,0,33,0,0.0,182.2999848642573,0
2020-03-03-170317,170317,0,0,19,0,0.0,679.7214853611003,1
2020-03-04-170317,170317,0,2,21,0,0.25,753.2332198425612,2
2020-03-05-170317,170317,0,0,23,0,0.0,812.8175216667199,3
2020-03-06-170317,170317,0,0,21,0,0.0,718.0204765465431,4
2020-03-07-170317,170317,0,0,2,0,0.0,811.0000072635318,5
2020-03-08-170317,170317,0,0,6,0,0.0,855.9142167263092,6
2020-03-09-170317,170317,0,0,37,0,0.125,857.1547244091557,0
2020-03-10-170317,170317,0,1,23,0,0.0,2332.2377180661742,1
2020-03-11-170317,170317,0,0,22,0,0.25,1987.641405565796,2
2020-03-12-170317,170317,0,0,20,0,0.625,1545.6310470601875,3
2020-03-13-170317,170317,0,0,21,0,0.375,1012.1029985399296,4
2020-03-14-170317,170317,3,0,2,3,0.5,925.4509445672568,5
2020-03-15-170317,170317,3,0,0,6,0.5,811.4384930783554,6
2020-03-16-170317,170317,33,0,30,39,9.0,88.55840675168416,0
2020-03-17-170317,170317,19,0,12,58,8.0,412.577078556418,1
2020-03-18-170317,170317,21,0,11,79,13.375,677.3408396656672,2
2020-03-19-170317,170317,23,0,11,102,12.375,941.6805168849821,3
2020-03-20-170317,170317,21,0,13,123,12.125,1148.1142533676705,4
2020-03-21-170317,170317,2,0,2,125,1.5,1308.8460624515653,5
2020-03-22-170317,170317,6,0,2,131,1.125,1251.5181487645054,6
2020-03-23-170317,170317,37,0,42,168,16.375,1049.3284678488076,0
2020-03-24-170317,170317,23,1,12,191,13.625,1199.991609820744,1
2020-03-25-170317,170317,22,0,6,213,14.5,1205.0493387944903,2
2020-03-26-170317,170317,20,1,13,233,11.25,1219.4323944182215,3
2020-03-27-170317,170317,21,0,9,254,12.125,1414.5325910335955,4
2020-03-28-170317,170317,2,0,0,256,1.75,1403.710712826893,5
2020-03-29-170317,170317,0,0,2,256,1.625,1404.9155906980773,6
2020-03-30-170317,170317,30,0,10,286,16.0,1047.1236671121299,0
2020-03-31-170317,170317,12,0,21,298,9.25,1052.056380664122,1
2020-04-01-170317,170317,11,0,10,309,7.625,168.22335739177615,2
2020-04-02-170317,170317,11,0,19,320,6.875,958.1639999810396,3
2020-04-03-170317,170317,13,0,15,333,8.0,390.6150589220598,4
2020-04-04-170317,170317,2,0,0,335,1.375,397.5859735762205,5
2020-04-05-170317,170317,2,0,2,337,1.0,403.78456710183093,6
2020-04-06-170317,170317,42,0,34,379,8.125,416.1985550055234,0
2020-04-07-170317,170317,12,0,7,391,7.0,587.4962658433992,1
2020-04-08-170317,170317,6,0,7,397,4.5,675.6796791427362,2
2020-04-09-170317,170317,13,2,10,410,4.625,702.5165401773595,3
2020-04-10-170317,170317,9,0,21,419,9.125,132.77247461924705,4
2020-04-11-170317,170317,0,0,2,419,1.25,310.99589709559285,5
2020-04-12-170317,170317,2,0,0,421,1.875,335.23508227902556,6
2020-04-13-170317,170317,10,0,8,431,9.125,377.8397243550409,0
2020-04-14-170317,170317,21,0,3,452,6.25,583.55243429158,1
2020-04-15-170317,170317,10,0,6,462,8.0,801.1546885309408,2
2020-04-16-170317,170317,19,0,6,481,5.875,1005.6002479383824,3
2020-04-17-170317,170317,15,0,1,496,4.25,1116.668122157006,4
2020-04-18-170317,170317,0,0,2,496,0.75,1070.0731284431256,5
2020-04-19-170317,170317,2,0,2,498,0.75,1056.697251651862,6
2020-04-20-170317,170317,34,0,5,532,5.5,942.7688893974439,0
2020-04-21-170317,170317,7,1,2,539,3.75,891.2134396938427,1
2020-04-22-170317,170317,7,0,7,546,6.75,750.4367845221453,2
2020-04-23-170317,170317,10,0,4,556,0.375,635.5193264107079,3
2020-04-24-170317,170317,21,0,5,577,9.5,543.305772419115,4
2020-04-25-170317,170317,2,0,2,579,0.375,694.6351880915856,5
2020-04-26-170317,170317,0,0,0,579,0.375,704.4652360887707,6
2020-04-27-170317,170317,8,0,4,587,2.875,577.1120472946574,0
2020-04-28-170317,170317,3,0,0,590,3.25,462.7792767669606,1
2020-04-29-170317,170317,6,0,1,596,4.0,443.9942775048598,2
2020-04-30-170317,170317,6,0,4,602,3.375,531.4710245708123,3
2020-05-01-170317,170317,1,0,9,603,0.125,743.0339443404697,4
2020-05-02-170317,170317,2,0,0,605,0.25,263.54769149486236,5
2020-05-03-170317,170317,2,0,0,607,0.5,230.72083547782603,6
2020-05-04-170317,170317,5,1,4,612,4.0,195.49022350853497,0
2020-05-05-170317,170317,2,0,5,614,3.0,232.0775572777805,1
2020-05-06-170317,170317,7,0,5,621,2.875,240.7241450416617,2
2020-05-07-170317,170317,4,0,10,625,3.0,266.5040533171871,3
2020-05-08-170317,170317,5,0,10,630,3.125,273.1045603089286,4
2020-05-09-170317,170317,2,0,0,632,0.25,353.66945724168716,5
2020-05-10-170317,170317,0,2,0,632,0.375,766.3440321573582,6
2020-05-11-170317,170317,4,2,1,636,3.25,732.1412978343012,0
2020-05-12-170317,170317,0,0,5,636,3.125,775.6129684115281,1
2020-05-13-170317,170317,1,0,2,637,2.625,533.469953707765,2
2020-05-14-170317,170317,4,0,5,641,4.0,409.8174508030237,3
2020-05-15-170317,170317,9,1,6,650,1.5,367.51907624629837,4
2020-05-16-170317,170317,0,1,3,650,0.75,305.90987547884714,5
2020-05-17-170317,170317,0,0,0,650,0.125,316.7040843803933,6
2020-05-18-170317,170317,4,0,5,654,2.5,316.7409366376556,0
2020-05-19-170317,170317,5,0,4,659,2.875,303.8124960262833,1
2020-05-20-170317,170317,5,0,10,664,2.25,296.84457293323493,2
2020-05-21-170317,170317,10,0,1,674,2.625,272.4931962574819,3
2020-05-22-170317,170317,10,0,7,684,3.75,302.7809518160457,4
2020-05-23-170317,170317,0,0,0,684,0.5,391.8560720395212,5
2020-05-24-170317,170317,0,0,0,684,0.625,397.3522366256951,6
2020-05-25-170317,170317,1,0,5,685,3.75,356.4878099772695,0
2020-05-26-170317,170317,5,0,4,690,1.25,361.2671024314235,1
2020-05-27-170317,170317,2,0,1,692,2.25,397.4060112932721,2
2020-05-28-170317,170317,5,0,4,697,2.375,397.7219214422761,3
2020-05-29-170317,170317,6,0,1,703,2.125,372.4599359238122,4
2020-05-30-170317,170317,3,0,0,706,0.375,338.56761644052614,5
2020-05-31-170317,170317,0,0,0,706,0.125,349.76579255147044,6
2020-06-01-170317,170317,5,0,1,711,2.875,453.5955470874672,0
2020-06-02-170317,170317,4,0,2,715,2.75,173.1950801886227,1
2020-06-03-170317,170317,10,0,0,725,3.125,77.70391834126812,2
2020-06-04-170317,170317,1,0,4,726,2.125,140.44853829345115,3
2020-06-05-170317,170317,7,0,1,733,3.75,161.1047899188689,4
2020-06-06-170317,170317,0,0,0,733,0.375,254.73770858269066,5
2020-06-07-170317,170317,0,0,0,733,0.0,259.8117323895607,6
2020-06-08-170317,170317,5,0,1,738,2.875,261.87531126258426,0
2020-06-09-170317,170317,4,0,0,742,3.0,340.04267138382414,1
2020-06-10-170317,170317,1,0,0,743,4.0,538.3133571116316,2
2020-06-11-170317,170317,4,0,1,747,2.25,539.5111832537643,3
2020-06-12-170317,170317,1,0,0,748,1.875,535.5901073006592,4
2020-06-13-170317,170317,0,0,0,748,0.375,479.436162672803,5
2020-06-14-170317,170317,0,0,0,748,0.25,412.2547743133704,6
2020-06-15-170317,170317,1,0,0,749,1.25,319.3355089023375,0
2020-06-16-170317,170317,2,0,1,751,1.5,322.7823952878853,1
2020-06-17-170317,170317,0,0,0,751,1.5,285.9648940109208,2
2020-06-18-170317,170317,4,0,0,755,0.375,231.26820809299727,3
2020-06-19-170317,170317,1,0,0,756,0.875,205.00253480549253,4
2020-06-20-170317,170317,0,0,0,756,0.0,275.999895573273,5
2020-06-21-170317,170317,0,0,0,756,0.0,273.85678621014273,6
2020-06-22-170317,170317,1,0,0,757,0.625,252.05329851532588,0
2020-06-23-170317,170317,0,0,3,757,1.0,223.64116704466417,1
2020-06-24-170317,170317,0,0,1,757,0.125,213.0999843443862,2
2020-06-25-170317,170317,1,1,1,758,0.75,174.83896111382288,3
2020-06-26-170317,170317,0,1,0,758,0.875,174.81126732505314,4
2020-06-27-170317,170317,0,0,0,758,0.0,93.14353668323014,5
2020-06-28-170317,170317,0,0,1,758,0.0,93.7833013739382,6
2020-06-29-170317,170317,0,0,0,758,0.375,93.21491187893147,0
2020-06-30-170317,170317,1,0,0,759,0.25,147.94038218622134,1
2020-07-01-170317,170317,0,0,1,759,0.375,351.2278838037545,2
2020-07-02-170317,170317,0,0,0,759,0.375,99.48743996913558,3
2020-07-03-170317,170317,0,0,0,759,0.625,88.88834333650891,4
2020-07-04-170317,170317,0,0,0,759,0.0,108.2715079032055,5
2020-07-05-170317,170317,0,0,0,759,0.125,101.30942836194204,6
2020-07-06-170317,170317,0,0,2,759,0.625,89.4837503926858,0
2020-07-07-170317,170317,3,0,0,762,0.875,85.68365484832039,1
2020-07-08-170317,170317,1,0,3,763,0.375,97.68275612584928,2
2020-07-09-170317,170317,1,1,1,764,0.625,94.58931488830379,3
2020-07-10-170317,170317,0,0,2,764,0.75,363.55198840552134,4
2020-07-11-170317,170317,0,0,0,764,0.25,327.9060522369799,5
2020-07-12-170317,170317,1,0,0,765,0.0,213.30940773099974,6
2020-07-13-170317,170317,0,0,1,765,1.125,212.34884329088658,0
2020-07-14-170317,170317,0,0,0,765,0.625,228.2796595400242,1
2020-07-15-170317,170317,1,0,0,766,0.875,144.2987203305815,2
2020-07-16-170317,170317,0,0,0,766,0.25,79.2075987472145,3
2020-07-17-170317,170317,0,0,1,766,1.5,82.28097026190747,4
2020-07-18-170317,170317,0,0,0,766,0.375,93.06501531475791,5
2020-07-19-170317,170317,0,0,0,766,0.375,99.6218314301635,6
2020-07-20-170317,170317,2,0,0,768,0.75,86.95643689544971,0
2020-07-21-170317,170317,0,0,1,768,1.125,103.76077004366688,1
2020-07-22-170317,170317,3,1,0,771,0.5,110.88080200474586,2
2020-07-23-170317,170317,1,0,2,772,0.625,133.4510192134938,3
2020-07-24-170317,170317,2,0,2,774,0.75,121.05052033168849,4
2020-07-25-170317,170317,0,0,0,774,0.125,129.13119254250944,5
2020-07-26-170317,170317,0,0,0,774,0.5,125.67552352625383,6
2020-07-27-170317,170317,1,0,2,775,0.5,126.98123260317203,0
2020-07-28-170317,170317,0,0,3,775,0.375,116.48750140587389,1
2020-07-29-170317,170317,0,0,4,775,0.5,108.99916596518491,2
2020-07-30-170317,170317,0,0,0,775,1.375,89.45492730084965,3
2020-07-31-170317,170317,1,0,1,776,0.625,90.89980570346665,4
2020-08-01-170317,170317,0,0,0,776,0.125,90.13637196200398,5
2020-08-02-170317,170317,0,0,0,776,0.0,197.63437042633217,6
2020-08-03-170317,170317,0,0,2,776,1.375,734.3864267368222,0
2020-08-04-170317,170317,1,0,0,777,0.75,645.5401133456778,1
2020-08-05-170317,170317,0,0,3,777,1.25,584.551345300036,2
2020-08-06-170317,170317,2,0,2,779,0.375,486.45712754515694,3
2020-08-07-170317,170317,2,0,6,781,0.25,385.17996457998044,4
2020-08-08-170317,170317,0,0,0,781,0.25,296.50696939851355,5
2020-08-09-170317,170317,0,0,0,781,0.125,272.07885820528986,6
2020-08-10-170317,170317,2,0,3,783,1.125,75.51093852792327,0
2020-08-11-170317,170317,3,0,8,786,1.0,106.10216756425127,1
2020-08-12-170317,170317,4,0,0,790,1.375,139.65768746836602,2
2020-08-13-170317,170317,0,0,2,790,1.625,159.3941033695201,3
2020-08-14-170317,170317,1,0,4,791,1.125,167.2776005545305,4
2020-08-15-170317,170317,0,0,2,791,0.125,173.35507568376622,5
2020-08-16-170317,170317,0,0,1,791,0.25,160.10407301376762,6
2020-08-17-170317,170317,2,0,7,793,1.125,174.2306183024744,0
2020-08-18-170317,170317,0,0,5,793,0.875,175.63392204419682,1
2020-08-19-170317,170317,3,0,2,796,2.0,165.79623329185873,2
2020-08-20-170317,170317,2,0,4,798,1.75,160.20588208518407,3
2020-08-21-170317,170317,6,0,6,804,3.125,194.252329807051,4
2020-08-22-170317,170317,0,0,1,804,1.375,318.40820322818746,5
2020-08-23-170317,170317,0,0,2,804,0.75,335.3350922419273,6
2020-08-24-170317,170317,3,0,10,807,1.375,326.82476785982817,0
2020-08-25-170317,170317,8,0,11,815,5.0,415.9900353081404,1
2020-08-26-170317,170317,0,0,11,815,2.625,512.0192473516306,2
2020-08-27-170317,170317,2,0,9,817,3.5,592.2019781474008,3
2020-08-28-170317,170317,4,0,10,821,3.875,655.1161224119373,4
2020-08-29-170317,170317,2,0,4,823,4.25,635.7283274874973,5
2020-08-30-170317,170317,1,0,4,824,2.0,714.1768231155677,6
2020-08-31-170317,170317,7,0,3,831,4.75,643.5133292864688,0
2020-09-01-170317,170317,5,0,4,836,1.875,226.73633707298748,1
2020-09-02-170317,170317,2,0,16,838,2.75,1195.3302391540722,2
2020-09-03-170317,170317,4,0,9,842,3.5,1260.0995277968566,3
2020-09-04-170317,170317,6,0,8,848,5.75,1166.5760134499535,4
2020-09-05-170317,170317,1,0,3,849,3.5,1074.3936597111501,5
2020-09-06-170317,170317,2,0,2,851,3.125,1120.021397604421,6
2020-09-07-170317,170317,10,0,15,861,6.25,1164.1465841098193,0
2020-09-08-170317,170317,11,0,12,872,6.75,1030.544494140576,1
2020-09-09-170317,170317,11,0,8,883,7.375,1020.4413364355021,2
2020-09-10-170317,170317,9,0,12,892,8.875,165.60073773785786,3
2020-09-11-170317,170317,10,0,15,902,8.375,426.8428975894438,4
2020-09-12-170317,170317,4,0,0,906,3.125,662.7945500959614,5
2020-09-13-170317,170317,4,0,4,910,5.25,746.3247574665653,6
2020-09-14-170317,170317,3,0,12,913,9.875,825.5439965104539,0
2020-09-15-170317,170317,4,0,7,917,4.625,1068.7681994497004,1
2020-09-16-170317,170317,16,0,8,933,9.25,1192.3865967936497,2
2020-09-17-170317,170317,9,0,18,942,10.375,1400.5214433938409,3
2020-09-18-170317,170317,8,0,19,950,9.625,1347.1276289062193,4
2020-09-19-170317,170317,3,1,2,953,1.5,1264.3504094833218,5
2020-09-20-170317,170317,2,0,1,955,1.75,1200.6655778395434,6
2020-09-21-170317,170317,15,1,6,970,11.375,1000.3834340848265,0
2020-09-22-170317,170317,12,0,12,982,8.0,1132.0391414100777,1
2020-09-23-170317,170317,8,0,19,990,8.375,1062.4440517056983,2
2020-09-24-170317,170317,12,1,15,1002,10.0,1025.771389565427,3
2020-09-25-170317,170317,15,0,61,1017,7.0,1134.3382692717732,4
2020-09-26-170317,170317,0,0,3,1017,2.125,1290.3305654558258,5
2020-09-27-170317,170317,4,0,4,1021,1.125,1272.8131245385318,6
2020-09-28-170317,170317,12,0,2,1033,13.375,1264.8929082369038,0
2020-09-29-170317,170317,7,0,36,1040,6.0,1309.328988945738,1
2020-09-30-170317,170317,8,0,15,1048,10.625,1209.285634923515,2
2020-10-01-170317,170317,18,0,14,1066,14.0,0.0,3
2020-10-02-170317,170317,19,0,16,1085,16.0,2619.8840629763818,4
2020-10-03-170317,170317,2,0,1,1087,4.5,2259.0331346644,5
2020-10-04-170317,170317,1,2,4,1088,3.5,2343.8739752106544,6
2020-10-05-170317,170317,6,0,39,1094,1.25,1896.8525193177625,0
2020-10-06-170317,170317,12,0,13,1106,14.375,1615.9319903153726,1
2020-10-07-170317,170317,19,2,23,1125,9.5,1598.4467631106181,2
2020-10-08-170317,170317,15,1,20,1140,12.75,1432.6348901028855,3
2020-10-09-170317,170317,61,5,16,1201,11.625,1702.354197770408,4
2020-10-10-170317,170317,3,0,2,1204,3.125,415.53736042279405,5
2020-10-11-170317,170317,4,0,1,1208,2.5,491.22886107251617,6
2020-10-12-170317,170317,2,0,28,1210,2.875,563.478958350645,0
2020-10-13-170317,170317,36,0,12,1246,20.25,658.1004561646828,1
2020-10-14-170317,170317,15,0,25,1261,14.125,1201.2865362857167,2
2020-10-15-170317,170317,14,0,26,1275,16.875,1519.020177631649,3
2020-10-16-170317,170317,16,0,42,1291,14.0,1878.7902261317715,4
2020-10-17-170317,170317,1,0,0,1292,4.375,1900.763997207233,5
2020-10-18-170317,170317,4,2,1,1296,2.375,1904.0034637947754,6
2020-10-19-170317,170317,39,1,0,1335,21.5,1913.4327686809268,0
2020-10-20-170317,170317,13,1,35,1348,11.25,2268.958149062922,1
2020-10-21-170317,170317,23,2,12,1371,13.5,2220.094117874502,2
2020-10-22-170317,170317,20,2,27,1391,17.125,2212.3114096542063,3
2020-10-23-170317,170317,16,0,17,1407,15.0,2150.9542675690973,4
2020-10-24-170317,170317,2,1,1,1409,4.125,2450.159737934072,5
2020-10-25-170317,170317,1,1,3,1410,2.25,2478.269449335541,6
2020-10-26-170317,170317,28,0,47,1438,19.0,1954.5327369031486,0
2020-10-27-170317,170317,12,1,22,1450,7.5,2122.199559238728,1
2020-10-28-170317,170317,25,1,18,1475,16.375,2083.1319242136187,2
2020-10-29-170317,170317,26,0,12,1501,17.75,2118.3629237611904,3
2020-10-30-170317,170317,42,1,22,1543,13.625,1890.8430455416287,4
2020-10-31-170317,170317,0,0,0,1543,4.25,2270.847212905144,5
2020-11-01-170317,170317,1,1,0,1544,1.625,1902.3291798919352,6
2020-11-02-170317,170317,0,2,0,1544,2.5,1971.3302328989473,0
2020-11-03-170317,170317,35,0,0,1579,20.375,1757.1248994635494,1
2020-11-04-170317,170317,12,1,0,1591,9.375,2329.399753124946,2
2020-11-05-170317,170317,27,1,0,1618,15.25,2112.927739994534,3
2020-11-06-170317,170317,17,1,0,1635,16.25,2255.9085703051774,4
2020-11-07-170317,170317,1,0,0,1636,1.875,2391.665064365527,5
2020-11-08-170317,170317,3,1,0,1639,7.0,2122.0316144008652,6
2020-11-09-170317,170317,47,0,0,1686,24.0,2143.268375606845,0
2020-11-10-170317,170317,22,0,0,1708,18.375,1866.8467628394417,1
2020-11-11-170317,170317,18,1,0,1726,14.0,2218.3110040445467,2
2020-11-12-170317,170317,12,1,0,1738,18.75,2506.1407483213966,3
2020-11-13-170317,170317,22,3,0,1760,13.0,2418.3141080764362,4
2020-03-01-170318,170318,0,0,0,0,0.0,0.0,6
2020-03-02-170318,170318,0,0,2,0,0.0,22.58165848015676,0
2020-03-03-170318,170318,0,1,2,0,0.0,74.08510738947027,1
2020-03-04-170318,170318,0,3,1,0,0.0,69.47598955449683,2
2020-03-05-170318,170318,0,0,8,0,0.0,76.5762977317468,3
2020-03-06-170318,170318,0,0,8,0,0.0,65.5735791815466,4
2020-03-07-170318,170318,0,0,0,0,0.0,67.72973788145245,5
2020-03-08-170318,170318,0,0,0,0,0.0,69.93023066942247,6
2020-03-09-170318,170318,0,0,1,0,0.16666666666666666,69.96495686792835,0
2020-03-10-170318,170318,0,0,4,0,0.0,327.984306930151,1
2020-03-11-170318,170318,0,0,4,0,0.0,276.906794453157,2
2020-03-12-170318,170318,0,0,1,0,0.16666666666666666,222.79441783887293,3
2020-03-13-170318,170318,0,0,2,0,0.0,161.60082494669996,4
2020-03-14-170318,170318,0,0,2,0,0.5,138.96822628728336,5
2020-03-15-170318,170318,0,0,0,0,0.6666666666666666,125.90556489894257,6
2020-03-16-170318,170318,2,0,2,2,8.5,10.54582267053139,0
2020-03-17-170318,170318,2,0,0,4,5.166666666666667,43.023263599925315,1
2020-03-18-170318,170318,1,0,3,5,7.333333333333332,71.05826435303157,2
2020-03-19-170318,170318,8,0,0,13,7.0,103.87449436136171,3
2020-03-20-170318,170318,8,0,1,21,7.0,145.53908149623663,4
2020-03-21-170318,170318,0,0,2,21,1.5,184.5033621068932,5
2020-03-22-170318,170318,0,3,0,21,1.5,177.29812285552697,6
2020-03-23-170318,170318,1,0,4,22,11.333333333333336,157.19285789430057,0
2020-03-24-170318,170318,4,0,4,26,7.666666666666668,175.0221989176493,1
2020-03-25-170318,170318,4,0,1,30,9.0,182.4139552268618,2
2020-03-26-170318,170318,1,0,3,31,5.0,183.75986416435217,3
2020-03-27-170318,170318,2,0,2,33,8.166666666666666,205.22585036987056,4
2020-03-28-170318,170318,2,0,0,35,1.3333333333333333,193.63147268487114,5
2020-03-29-170318,170318,0,0,0,35,1.8333333333333333,196.07637265431237,6
2020-03-30-170318,170318,2,0,3,37,6.666666666666668,149.2600898323468,0
2020-03-31-170318,170318,0,0,3,37,5.333333333333333,133.94297657102143,1
2020-04-01-170318,170318,3,0,2,40,4.333333333333333,23.740404685513305,2
2020-04-02-170318,170318,0,0,1,40,3.5,117.08674808887456,3
2020-04-03-170318,170318,1,0,0,41,4.833333333333333,58.61958002488687,4
2020-04-04-170318,170318,2,0,0,43,1.0,67.53660639434462,5
2020-04-05-170318,170318,0,0,0,43,0.8333333333333334,69.94400597445667,6
2020-04-06-170318,170318,4,0,0,47,8.666666666666666,68.85869274304261,0
2020-04-07-170318,170318,4,1,1,51,3.6666666666666665,84.94968352991958,1
2020-04-08-170318,170318,1,1,3,52,2.6666666666666665,96.95299691278338,2
2020-04-09-170318,170318,3,0,0,55,2.6666666666666665,101.9799470496865,3
2020-04-10-170318,170318,2,0,0,57,8.166666666666666,25.894597011282293,4
2020-04-11-170318,170318,0,0,0,57,1.1666666666666667,49.60127911067775,5
2020-04-12-170318,170318,0,0,0,57,1.6666666666666667,53.01390877215793,6
2020-04-13-170318,170318,3,1,0,60,6.5,58.02864152484794,0
2020-04-14-170318,170318,3,0,2,63,8.333333333333334,81.38249648534322,1
2020-04-15-170318,170318,2,0,0,65,6.0,115.2716054487285,2
2020-04-16-170318,170318,1,0,0,66,6.0,135.32527806705212,3
2020-04-17-170318,170318,0,0,0,66,3.5,132.45897567181885,4
2020-04-18-170318,170318,0,0,0,66,0.16666666666666666,121.36525347290022,5
2020-04-19-170318,170318,0,0,0,66,0.5,119.46866862521271,6
2020-04-20-170318,170318,0,2,0,66,6.833333333333332,102.70174128668071,0
2020-04-21-170318,170318,1,0,2,67,2.333333333333333,79.6578283687142,1
2020-04-22-170318,170318,3,0,0,70,1.8333333333333333,66.7934946165021,2
2020-04-23-170318,170318,0,0,1,70,1.8333333333333333,63.14397314328028,3
2020-04-24-170318,170318,0,0,0,70,5.333333333333333,55.25114343281645,4
2020-04-25-170318,170318,0,0,0,70,1.0,71.63915560145098,5
2020-04-26-170318,170318,0,0,0,70,0.5,77.61856387344946,6
2020-04-27-170318,170318,0,0,1,70,1.8333333333333333,69.58345797379462,0
2020-04-28-170318,170318,2,0,0,72,1.5,64.30709583997361,1
2020-04-29-170318,170318,0,0,0,72,1.8333333333333333,64.50485428416724,2
2020-04-30-170318,170318,0,0,3,72,2.1666666666666665,84.45610212925507,3
2020-05-01-170318,170318,0,0,0,72,0.3333333333333333,98.74995878096279,4
2020-05-02-170318,170318,0,0,0,72,0.5,42.54192731163635,5
2020-05-03-170318,170318,0,0,0,72,0.5,37.687825334888586,6
2020-05-04-170318,170318,0,0,0,72,1.6666666666666667,29.995269696603696,0
2020-05-05-170318,170318,2,0,1,74,1.1666666666666667,34.94886630067239,1
2020-05-06-170318,170318,0,0,1,74,3.1666666666666665,34.970830237533065,2
2020-05-07-170318,170318,1,0,1,75,1.5,43.61254304625829,3
2020-05-08-170318,170318,0,0,0,75,2.1666666666666665,52.3911359502063,4
2020-05-09-170318,170318,0,0,0,75,0.8333333333333334,63.242118351220824,5
2020-05-10-170318,170318,0,0,0,75,0.16666666666666666,102.76759533377538,6
2020-05-11-170318,170318,1,1,1,76,1.3333333333333333,98.07292830447918,0
2020-05-12-170318,170318,0,0,0,76,0.3333333333333333,102.50078372467422,1
2020-05-13-170318,170318,0,0,0,76,0.8333333333333334,75.60608523337068,2
2020-05-14-170318,170318,3,2,0,79,2.1666666666666665,56.95287058922625,3
2020-05-15-170318,170318,0,0,0,79,2.0,52.55543547466469,4
2020-05-16-170318,170318,0,0,0,79,0.3333333333333333,43.1871504816023,5
2020-05-17-170318,170318,0,0,0,79,0.16666666666666666,47.620835658059605,6
2020-05-18-170318,170318,0,0,0,79,1.0,44.95495184519812,0
2020-05-19-170318,170318,1,0,1,80,1.1666666666666667,43.549598745326804,1
2020-05-20-170318,170318,1,0,0,81,1.0,43.853251848313434,2
2020-05-21-170318,170318,1,0,0,82,2.6666666666666665,34.09005703677464,3
2020-05-22-170318,170318,0,0,0,82,2.1666666666666665,40.010988154650434,4
2020-05-23-170318,170318,0,0,0,82,0.16666666666666666,43.1323896499673,5
2020-05-24-170318,170318,0,0,0,82,0.3333333333333333,44.68623372921443,6
2020-05-25-170318,170318,1,0,0,83,1.0,40.16851785432956,0
2020-05-26-170318,170318,0,0,2,83,1.1666666666666667,44.88226819683334,1
2020-05-27-170318,170318,0,0,2,83,1.0,49.817139155097095,2
2020-05-28-170318,170318,0,1,0,83,1.3333333333333333,57.69611448969621,3
2020-05-29-170318,170318,0,0,0,83,1.3333333333333333,54.573732256182666,4
2020-05-30-170318,170318,0,0,0,83,0.6666666666666666,53.30465440081424,5
2020-05-31-170318,170318,0,0,0,83,0.16666666666666666,56.71471679966649,6
2020-06-01-170318,170318,0,0,1,83,1.5,84.45695372520296,0
2020-06-02-170318,170318,1,0,0,84,1.5,26.773591006970808,1
2020-06-03-170318,170318,0,1,0,84,1.6666666666666667,17.986905952219175,2
2020-06-04-170318,170318,0,0,0,84,0.16666666666666666,15.740655035246888,3
2020-06-05-170318,170318,0,0,0,84,2.0,14.052577745596967,4
2020-06-06-170318,170318,0,0,0,84,0.0,28.30321371528165,5
2020-06-07-170318,170318,0,0,0,84,0.0,29.03305044840414,6
2020-06-08-170318,170318,0,0,1,84,1.6666666666666667,29.235655230333187,0
2020-06-09-170318,170318,2,0,0,86,1.0,45.17705183109618,1
2020-06-10-170318,170318,2,0,0,88,1.3333333333333333,89.20206734341245,2
2020-06-11-170318,170318,0,0,0,88,0.8333333333333334,97.55734094725472,3
2020-06-12-170318,170318,0,0,0,88,0.5,90.88415468976726,4
2020-06-13-170318,170318,0,0,0,88,0.0,77.70255032844648,5
2020-06-14-170318,170318,0,0,0,88,0.0,61.864879205774855,6
2020-06-15-170318,170318,1,0,0,89,0.3333333333333333,48.148158173105465,0
2020-06-16-170318,170318,0,0,0,89,0.5,49.445118094138834,1
2020-06-17-170318,170318,0,0,0,89,0.8333333333333334,43.117183321772586,2
2020-06-18-170318,170318,0,0,0,89,1.0,30.371741219786703,3
2020-06-19-170318,170318,0,0,0,89,0.16666666666666666,29.9003786431454,4
2020-06-20-170318,170318,0,0,0,89,0.0,35.71221810143368,5
2020-06-21-170318,170318,0,0,0,89,0.0,35.786736140651485,6
2020-06-22-170318,170318,1,0,0,90,0.16666666666666666,29.453325715956385,0
2020-06-23-170318,170318,0,0,0,90,0.6666666666666666,30.4248130499722,1
2020-06-24-170318,170318,0,0,0,90,0.3333333333333333,29.58753253899376,2
2020-06-25-170318,170318,0,3,1,90,0.6666666666666666,27.102999467463178,3
2020-06-26-170318,170318,0,1,0,90,0.0,31.59702205955403,4
2020-06-27-170318,170318,0,0,0,90,0.0,22.15308655122076,5
2020-06-28-170318,170318,0,0,0,90,0.0,22.59338634926221,6
2020-06-29-170318,170318,0,0,0,90,0.0,22.87982313163093,0
2020-06-30-170318,170318,0,0,0,90,0.16666666666666666,19.49493964326541,1
2020-07-01-170318,170318,0,0,0,90,0.0,56.37832467319756,2
2020-07-02-170318,170318,0,0,0,90,0.0,15.964018005010434,3
2020-07-03-170318,170318,0,0,1,90,0.16666666666666666,12.135265058589326,4
2020-07-04-170318,170318,0,0,0,90,0.0,13.520162587805114,5
2020-07-05-170318,170318,0,0,0,90,0.0,13.135226703111684,6
2020-07-06-170318,170318,0,0,0,90,0.16666666666666666,12.256803837079993,0
2020-07-07-170318,170318,0,0,1,90,0.5,10.869966499746132,1
2020-07-08-170318,170318,0,0,0,90,0.16666666666666666,12.31759378778273,2
2020-07-09-170318,170318,1,0,0,91,0.16666666666666666,11.732108313605915,3
2020-07-10-170318,170318,0,0,0,91,0.16666666666666666,58.834428397655095,4
2020-07-11-170318,170318,0,0,0,91,0.16666666666666666,57.666115184666175,5
2020-07-12-170318,170318,0,0,0,91,0.16666666666666666,40.20531357816392,6
2020-07-13-170318,170318,0,0,0,91,0.0,40.515089829357045,0
2020-07-14-170318,170318,0,0,0,91,0.0,40.998832303626955,1
2020-07-15-170318,170318,0,0,0,91,0.16666666666666666,21.80449306892403,2
2020-07-16-170318,170318,0,0,0,91,0.3333333333333333,9.263869828584948,3
2020-07-17-170318,170318,1,0,0,92,0.16666666666666666,10.43759836929959,4
2020-07-18-170318,170318,0,0,0,92,0.16666666666666666,12.14425583615937,5
2020-07-19-170318,170318,0,0,0,92,0.16666666666666666,16.963489624862234,6
2020-07-20-170318,170318,0,0,0,92,0.5,17.946820311316493,0
2020-07-21-170318,170318,1,0,1,93,0.3333333333333333,18.72486275563583,1
2020-07-22-170318,170318,0,0,0,93,0.6666666666666666,27.369643902810516,2
2020-07-23-170318,170318,0,0,0,93,0.3333333333333333,27.561395416626766,3
2020-07-24-170318,170318,0,0,0,93,0.3333333333333333,25.467451657378554,4
2020-07-25-170318,170318,0,0,0,93,0.0,22.353705599371047,5
2020-07-26-170318,170318,0,0,0,93,0.0,20.67667259717545,6
2020-07-27-170318,170318,0,0,0,93,0.3333333333333333,20.322785146099044,0
2020-07-28-170318,170318,0,0,1,93,0.5,19.692377377823682,1
2020-07-29-170318,170318,0,0,0,93,0.0,14.786057610108967,2
2020-07-30-170318,170318,0,0,2,93,0.3333333333333333,13.573309500231389,3
2020-07-31-170318,170318,0,0,0,93,0.6666666666666666,12.806539192089573,4
2020-08-01-170318,170318,0,0,0,93,0.0,15.286632278153,5
2020-08-02-170318,170318,0,0,0,93,0.16666666666666666,48.65419663774941,6
2020-08-03-170318,170318,0,0,0,93,0.3333333333333333,211.71444554705,0
2020-08-04-170318,170318,1,0,0,94,0.5,157.8054994670752,1
2020-08-05-170318,170318,0,0,0,94,0.3333333333333333,136.41596322989506,2
2020-08-06-170318,170318,0,0,0,94,0.6666666666666666,113.02481338223933,3
2020-08-07-170318,170318,0,0,0,94,0.3333333333333333,98.51231139078098,4
2020-08-08-170318,170318,0,0,0,94,0.16666666666666666,61.74982290726804,5
2020-08-09-170318,170318,0,0,0,94,0.16666666666666666,56.434166265234495,6
2020-08-10-170318,170318,0,0,0,94,0.8333333333333334,13.391067636395311,0
2020-08-11-170318,170318,1,0,4,95,1.0,20.843081807321077,1
2020-08-12-170318,170318,0,0,0,95,1.0,29.336979813054082,2
2020-08-13-170318,170318,2,0,3,97,0.5,30.081796413933596,3
2020-08-14-170318,170318,0,0,0,97,0.3333333333333333,37.859837672233844,4
2020-08-15-170318,170318,0,0,2,97,0.0,39.23952491757653,5
2020-08-16-170318,170318,0,0,0,97,0.16666666666666666,37.37919068642162,6
2020-08-17-170318,170318,0,0,1,97,0.5,43.94974728064764,0
2020-08-18-170318,170318,0,0,0,97,0.0,42.068985282959204,1
2020-08-19-170318,170318,0,0,2,97,1.1666666666666667,36.36826625232683,2
2020-08-20-170318,170318,0,0,2,97,0.6666666666666666,41.600678909536484,3
2020-08-21-170318,170318,0,0,2,97,3.5,49.150572609427876,4
2020-08-22-170318,170318,0,0,0,97,0.5,107.75286166112113,5
2020-08-23-170318,170318,0,0,0,97,0.16666666666666666,106.37569730742031,6
2020-08-24-170318,170318,0,0,3,97,1.3333333333333333,110.09760289259393,0
2020-08-25-170318,170318,4,0,0,101,4.0,154.84755700942065,1
2020-08-26-170318,170318,0,0,2,101,1.5,178.95131341338697,2
2020-08-27-170318,170318,3,0,3,104,2.833333333333333,204.89984814322366,3
2020-08-28-170318,170318,0,0,1,104,2.5,219.10113088231708,4
2020-08-29-170318,170318,2,0,0,106,1.8333333333333333,178.4275908184477,5
2020-08-30-170318,170318,0,0,0,106,0.3333333333333333,205.68134801090065,6
2020-08-31-170318,170318,1,0,1,107,2.833333333333333,165.59803461985257,0
2020-09-01-170318,170318,0,0,2,107,1.5,50.20532593289258,1
2020-09-02-170318,170318,2,0,4,109,1.5,210.49565174618112,2
2020-09-03-170318,170318,2,0,4,111,1.6666666666666667,328.8281444300645,3
2020-09-04-170318,170318,2,0,3,113,3.6666666666666665,218.44911637510765,4
2020-09-05-170318,170318,0,0,0,113,1.3333333333333333,189.61336375741197,5
2020-09-06-170318,170318,0,0,0,113,1.8333333333333333,211.30831407966286,6
2020-09-07-170318,170318,3,0,4,116,3.8333333333333335,211.34849133919246,0
2020-09-08-170318,170318,0,0,3,116,2.833333333333333,189.87416294733686,1
2020-09-09-170318,170318,2,0,5,118,6.666666666666668,172.42738143071438,2
2020-09-10-170318,170318,3,0,10,121,5.333333333333333,30.476224515545216,3
2020-09-11-170318,170318,1,0,1,122,4.5,83.16519614319128,4
2020-09-12-170318,170318,0,0,1,122,2.5,130.56036197055346,5
2020-09-13-170318,170318,0,0,0,122,1.0,144.32963319331756,6
2020-09-14-170318,170318,1,0,1,123,2.5,149.51309536005172,0
2020-09-15-170318,170318,2,0,0,125,1.8333333333333333,188.01074432285608,1
2020-09-16-170318,170318,4,0,0,129,5.0,201.7990252814807,2
2020-09-17-170318,170318,4,0,1,133,3.5,239.65305082784755,3
2020-09-18-170318,170318,3,0,5,136,3.6666666666666665,227.7009013123737,4
2020-09-19-170318,170318,0,1,2,136,1.6666666666666667,199.87385821063558,5
2020-09-20-170318,170318,0,0,0,136,1.3333333333333333,194.3031418196703,6
2020-09-21-170318,170318,4,0,1,140,5.5,160.71429361581502,0
2020-09-22-170318,170318,3,1,2,143,5.0,172.65478675971957,1
2020-09-23-170318,170318,5,0,2,148,6.166666666666668,159.82397369712947,2
2020-09-24-170318,170318,10,0,4,158,14.666666666666664,151.20523148376907,3
2020-09-25-170318,170318,1,0,5,159,14.333333333333336,224.61341250506354,4
2020-09-26-170318,170318,1,0,4,160,1.0,273.1703222478813,5
2020-09-27-170318,170318,0,0,0,160,1.8333333333333333,265.6491807574273,6
2020-09-28-170318,170318,1,0,1,161,4.833333333333333,267.6578593443463,0
2020-09-29-170318,170318,0,0,6,161,5.166666666666667,275.3530809433453,1
2020-09-30-170318,170318,0,0,6,161,9.333333333333334,243.9979565713654,2
2020-10-01-170318,170318,1,0,2,162,11.833333333333336,0.0,3
2020-10-02-170318,170318,5,0,5,167,9.833333333333334,396.9780248596479,4
2020-10-03-170318,170318,2,0,7,169,3.6666666666666665,331.4993685567581,5
2020-10-04-170318,170318,0,0,5,169,1.6666666666666667,309.07467216348243,6
2020-10-05-170318,170318,1,0,10,170,3.333333333333333,251.67237696133384,0
2020-10-06-170318,170318,2,1,3,172,8.333333333333334,236.82153852693318,1
2020-10-07-170318,170318,2,0,4,174,7.0,239.85279617204918,2
2020-10-08-170318,170318,4,0,8,178,7.833333333333332,216.25375370611278,3
2020-10-09-170318,170318,5,2,1,183,14.333333333333336,239.16598794397578,4
2020-10-10-170318,170318,4,0,0,187,2.0,50.35362583928764,5
2020-10-11-170318,170318,0,0,3,187,1.5,68.59150550718485,6
2020-10-12-170318,170318,1,0,9,188,2.333333333333333,76.45786782645511,0
2020-10-13-170318,170318,6,0,2,194,11.833333333333336,95.13064309605221,1
2020-10-14-170318,170318,6,0,1,200,7.333333333333332,151.65247547305393,2
2020-10-15-170318,170318,2,0,3,202,13.5,202.0941775375335,3
2020-10-16-170318,170318,5,0,6,207,7.5,278.5557869235647,4
2020-10-17-170318,170318,7,0,1,214,1.5,290.46285330397876,5
2020-10-18-170318,170318,5,0,0,219,2.0,298.71766426240237,6
2020-10-19-170318,170318,10,1,3,229,11.833333333333336,314.5851310695809,0
2020-10-20-170318,170318,3,0,7,232,5.666666666666668,360.5106463463587,1
2020-10-21-170318,170318,4,0,2,236,7.666666666666668,344.03822647741134,2
2020-10-22-170318,170318,8,0,10,244,7.333333333333332,291.3083824478788,3
2020-10-23-170318,170318,1,0,23,245,11.833333333333336,297.05202816812806,4
2020-10-24-170318,170318,0,1,0,245,2.1666666666666665,328.11589391166956,5
2020-10-25-170318,170318,3,2,1,248,0.8333333333333334,328.3706047551326,6
2020-10-26-170318,170318,9,0,30,257,9.666666666666666,272.3462759570187,0
2020-10-27-170318,170318,2,2,5,259,5.166666666666667,298.2655095967077,1
2020-10-28-170318,170318,1,1,1,260,6.333333333333332,294.17234208905484,2
2020-10-29-170318,170318,3,0,5,263,13.5,296.9533497442183,3
2020-10-30-170318,170318,6,0,3,269,12.166666666666664,258.94302608892383,4
2020-10-31-170318,170318,1,0,0,270,1.1666666666666667,297.50691159871343,5
2020-11-01-170318,170318,0,0,0,270,1.3333333333333333,241.7499940262026,6
2020-11-02-170318,170318,3,1,0,273,0.8333333333333334,309.89006774153745,0
2020-11-03-170318,170318,7,0,0,280,9.666666666666666,273.62490593548597,1
2020-11-04-170318,170318,2,1,0,282,5.5,327.2672435271371,2
2020-11-05-170318,170318,10,0,0,292,8.5,337.7426738683614,3
2020-11-06-170318,170318,23,1,0,315,9.0,318.2240276268006,4
2020-11-07-170318,170318,0,0,0,315,2.333333333333333,305.73776277418887,5
2020-11-08-170318,170318,1,0,0,316,1.8333333333333333,285.2805592092609,6
2020-11-09-170318,170318,30,0,0,346,13.833333333333336,275.9312571245718,0
2020-11-10-170318,170318,5,1,0,351,8.833333333333334,234.6745471101298,1
2020-11-11-170318,170318,1,0,0,352,8.0,278.8832918584453,2
2020-11-12-170318,170318,5,1,0,357,7.666666666666668,305.76801153255025,3
2020-11-13-170318,170318,3,1,0,360,7.666666666666668,320.6781080063275,4
2020-03-01-170319,170319,0,0,0,0,0.0,0.0,6
2020-03-02-170319,170319,0,0,2,0,0.0,7.2843184938070795,0
2020-03-03-170319,170319,0,1,4,0,0.0,20.900636494975217,1
2020-03-04-170319,170319,0,1,0,0,0.0,18.9839205680869,2
2020-03-05-170319,170319,0,0,3,0,0.0,19.293206600419374,3
2020-03-06-170319,170319,0,0,1,0,0.0,16.743052743056534,4
2020-03-07-170319,170319,0,0,0,0,0.0,17.52513095038325,5
2020-03-08-170319,170319,0,0,0,0,0.0,19.77568627630477,6
2020-03-09-170319,170319,0,3,1,0,0.0,20.30622768703616,0
2020-03-10-170319,170319,0,0,1,0,0.0,87.50445719145655,1
2020-03-11-170319,170319,0,0,2,0,0.0,80.32546146839385,2
2020-03-12-170319,170319,0,0,0,0,0.0,63.44671883810054,3
2020-03-13-170319,170319,0,0,1,0,0.0,51.02976935005548,4
2020-03-14-170319,170319,0,0,0,0,1.0,49.710490075387945,5
2020-03-15-170319,170319,0,0,0,0,1.0,31.798602527263142,6
2020-03-16-170319,170319,2,0,0,2,4.666666666666667,3.7358085520592836,0
2020-03-17-170319,170319,4,1,0,6,6.666666666666668,13.840949159765998,1
2020-03-18-170319,170319,0,0,1,6,9.666666666666666,21.06884437836966,2
2020-03-19-170319,170319,3,0,0,9,12.0,24.627165477955174,3
2020-03-20-170319,170319,1,0,0,10,11.0,32.6918270534785,4
2020-03-21-170319,170319,0,0,0,10,1.6666666666666667,35.65820176324024,5
2020-03-22-170319,170319,0,0,0,10,1.6666666666666667,31.043274098352015,6
2020-03-23-170319,170319,1,0,0,11,15.333333333333336,27.150242518348477,0
2020-03-24-170319,170319,1,0,0,12,12.0,30.83929898487554,1
2020-03-25-170319,170319,2,0,1,14,16.333333333333332,33.150440224376766,2
2020-03-26-170319,170319,0,0,0,14,17.666666666666668,31.385611983665207,3
2020-03-27-170319,170319,1,0,1,15,12.666666666666664,35.47152411513258,4
2020-03-28-170319,170319,0,0,0,15,1.6666666666666667,34.099063657269326,5
2020-03-29-170319,170319,0,0,0,15,0.3333333333333333,34.34427619228714,6
2020-03-30-170319,170319,0,0,0,15,19.0,23.716591894979253,0
2020-03-31-170319,170319,0,0,0,15,10.0,21.393706584803382,1
2020-04-01-170319,170319,1,0,0,16,9.0,3.2850484977238663,2
2020-04-02-170319,170319,0,0,0,16,7.666666666666668,10.895083550351888,3
2020-04-03-170319,170319,0,0,0,16,8.666666666666666,7.866069080242065,4
2020-04-04-170319,170319,0,0,0,16,1.3333333333333333,7.339962575946944,5
2020-04-05-170319,170319,0,0,0,16,2.0,7.433286886413977,6
2020-04-06-170319,170319,0,0,0,16,7.333333333333332,7.5180231505689665,0
2020-04-07-170319,170319,0,0,0,16,7.666666666666668,8.393604415276288,1
2020-04-08-170319,170319,1,2,0,17,5.666666666666668,8.70187331050788,2
2020-04-09-170319,170319,0,0,0,17,7.333333333333332,10.497150589004903,3
2020-04-10-170319,170319,1,0,0,18,4.0,2.4802634070297893,4
2020-04-11-170319,170319,0,1,0,18,1.3333333333333333,4.3295662193424524,5
2020-04-12-170319,170319,0,0,0,18,1.3333333333333333,5.097632823382343,6
2020-04-13-170319,170319,0,0,0,18,7.333333333333332,6.024874762253673,0
2020-04-14-170319,170319,0,0,0,18,4.0,8.993724549489789,1
2020-04-15-170319,170319,0,0,0,18,4.666666666666667,11.257040589371535,2
2020-04-16-170319,170319,0,0,0,18,4.0,13.682575588043662,3
2020-04-17-170319,170319,0,0,0,18,5.333333333333333,14.239895810173024,4
2020-04-18-170319,170319,0,0,0,18,0.6666666666666666,14.239556668563408,5
2020-04-19-170319,170319,0,0,0,18,2.0,13.628047014627047,6
2020-04-20-170319,170319,0,1,0,18,5.333333333333333,13.046766474079604,0
2020-04-21-170319,170319,0,0,3,18,4.0,12.687004337808633,1
2020-04-22-170319,170319,0,0,1,18,14.333333333333336,13.016307533120324,2
2020-04-23-170319,170319,0,0,0,18,0.0,12.731329486653728,3
2020-04-24-170319,170319,0,0,2,18,20.666666666666668,10.90543362570807,4
2020-04-25-170319,170319,0,0,1,18,0.0,14.264633932609456,5
2020-04-26-170319,170319,0,0,0,18,0.6666666666666666,13.918742418036745,6
2020-04-27-170319,170319,0,1,0,18,5.333333333333333,11.257822975045245,0
2020-04-28-170319,170319,0,0,0,18,3.333333333333333,10.767613508427383,1
2020-04-29-170319,170319,0,0,0,18,4.0,10.134268027834803,2
2020-04-30-170319,170319,0,0,0,18,5.0,11.077099012339016,3
2020-05-01-170319,170319,0,0,0,18,0.0,13.98823946680081,4
2020-05-02-170319,170319,0,0,0,18,0.3333333333333333,6.344514768629759,5
2020-05-03-170319,170319,0,0,0,18,0.0,7.6653214171169015,6
2020-05-04-170319,170319,0,0,0,18,5.0,5.176041760870472,0
2020-05-05-170319,170319,3,0,0,21,4.666666666666667,5.463762526770198,1
2020-05-06-170319,170319,1,0,0,22,2.333333333333333,8.336769753050397,2
2020-05-07-170319,170319,0,0,0,22,2.333333333333333,9.122183752627514,3
2020-05-08-170319,170319,2,0,0,24,5.0,8.503769078494898,4
2020-05-09-170319,170319,1,0,0,25,0.3333333333333333,13.218201562771169,5
2020-05-10-170319,170319,0,1,0,25,0.3333333333333333,14.588295834539544,6
2020-05-11-170319,170319,0,1,0,25,2.6666666666666665,14.965820808384471,0
2020-05-12-170319,170319,0,0,0,25,3.6666666666666665,15.035578880401433,1
2020-05-13-170319,170319,0,0,0,25,4.333333333333333,12.93440361268184,2
2020-05-14-170319,170319,0,0,0,25,5.666666666666668,11.844424389037306,3
2020-05-15-170319,170319,0,0,1,25,0.6666666666666666,9.623600038647133,4
2020-05-16-170319,170319,0,0,0,25,1.6666666666666667,7.760437023524201,5
2020-05-17-170319,170319,0,0,0,25,0.0,7.942777323236537,6
2020-05-18-170319,170319,0,1,0,25,3.6666666666666665,7.424556994840206,0
2020-05-19-170319,170319,0,0,0,25,2.6666666666666665,8.80275614258222,1
2020-05-20-170319,170319,0,0,0,25,2.6666666666666665,7.068078739045241,2
2020-05-21-170319,170319,0,0,0,25,3.0,5.676270097245149,3
2020-05-22-170319,170319,0,0,0,25,5.666666666666668,6.2217145960327995,4
2020-05-23-170319,170319,0,0,0,25,0.6666666666666666,7.428236872963552,5
2020-05-24-170319,170319,0,0,0,25,0.6666666666666666,7.875721013337773,6
2020-05-25-170319,170319,0,0,0,25,4.333333333333333,6.05024005968763,0
2020-05-26-170319,170319,0,0,0,25,2.6666666666666665,8.827329192253996,1
2020-05-27-170319,170319,0,0,0,25,2.0,11.319151814512516,2
2020-05-28-170319,170319,0,0,0,25,4.0,11.900731234940562,3
2020-05-29-170319,170319,1,1,0,26,4.333333333333333,11.670994135933167,4
2020-05-30-170319,170319,0,0,0,26,0.3333333333333333,12.360051453672696,5
2020-05-31-170319,170319,0,0,0,26,0.0,13.58853938256744,6
2020-06-01-170319,170319,0,0,0,26,3.6666666666666665,21.028941861334197,0
2020-06-02-170319,170319,0,0,0,26,2.333333333333333,4.446316561788034,1
2020-06-03-170319,170319,0,0,0,26,3.6666666666666665,2.9351753257798836,2
2020-06-04-170319,170319,0,0,0,26,3.6666666666666665,3.8047522480256384,3
2020-06-05-170319,170319,0,0,0,26,4.666666666666667,6.84389962203172,4
2020-06-06-170319,170319,0,1,0,26,0.0,8.745056617380818,5
2020-06-07-170319,170319,0,0,0,26,0.0,8.720938328678931,6
2020-06-08-170319,170319,0,0,0,26,5.0,8.948124418729503,0
2020-06-09-170319,170319,0,0,0,26,4.666666666666667,9.659720008626527,1
2020-06-10-170319,170319,0,0,0,26,3.333333333333333,23.329249742389838,2
2020-06-11-170319,170319,0,0,0,26,3.0,21.19276370759267,3
2020-06-12-170319,170319,0,0,0,26,2.0,18.38143722277123,4
2020-06-13-170319,170319,0,0,0,26,0.6666666666666666,16.44552835035976,5
2020-06-14-170319,170319,0,0,0,26,0.6666666666666666,14.523689531356768,6
2020-06-15-170319,170319,0,1,0,26,2.0,9.711858520754863,0
2020-06-16-170319,170319,0,0,0,26,1.3333333333333333,9.144916386372861,1
2020-06-17-170319,170319,0,0,0,26,0.6666666666666666,7.711092796626101,2
2020-06-18-170319,170319,0,0,0,26,0.0,6.655309496409632,3
2020-06-19-170319,170319,0,0,0,26,1.6666666666666667,4.813228390595977,4
2020-06-20-170319,170319,0,0,0,26,0.0,6.405350997761145,5
2020-06-21-170319,170319,0,0,0,26,0.3333333333333333,5.931524696759362,6
2020-06-22-170319,170319,0,0,0,26,0.3333333333333333,6.065503173307731,0
2020-06-23-170319,170319,0,0,0,26,1.0,6.196231839601012,1
2020-06-24-170319,170319,0,2,0,26,0.0,6.774144707258488,2
2020-06-25-170319,170319,0,0,0,26,0.3333333333333333,6.628570557220863,3
2020-06-26-170319,170319,0,2,0,26,1.3333333333333333,6.304233817769378,4
2020-06-27-170319,170319,0,0,0,26,0.0,5.163437251271943,5
2020-06-28-170319,170319,0,0,0,26,0.0,5.248765531953255,6
2020-06-29-170319,170319,0,0,0,26,1.0,4.725623222827981,0
2020-06-30-170319,170319,0,0,0,26,0.3333333333333333,5.2690913896809715,1
2020-07-01-170319,170319,0,0,0,26,0.3333333333333333,13.843336040058437,2
2020-07-02-170319,170319,0,0,1,26,0.0,9.621158208698894,3
2020-07-03-170319,170319,0,0,0,26,1.0,9.981874812417969,4
2020-07-04-170319,170319,0,0,0,26,0.0,6.592911631029702,5
2020-07-05-170319,170319,0,0,0,26,0.3333333333333333,6.417796464238866,6
2020-07-06-170319,170319,0,0,0,26,1.0,6.128903725928357,0
2020-07-07-170319,170319,0,0,0,26,1.3333333333333333,5.407985802106005,1
2020-07-08-170319,170319,0,0,0,26,0.3333333333333333,4.873447192061114,2
2020-07-09-170319,170319,0,2,0,26,0.6666666666666666,4.691836131189772,3
2020-07-10-170319,170319,0,0,0,26,1.0,14.852343331275755,4
2020-07-11-170319,170319,0,0,0,26,0.0,10.667109074652647,5
2020-07-12-170319,170319,0,0,0,26,0.0,6.666581392272871,6
2020-07-13-170319,170319,0,0,1,26,1.6666666666666667,6.660312484947576,0
2020-07-14-170319,170319,0,0,0,26,1.0,8.417174698181416,1
2020-07-15-170319,170319,0,0,0,26,0.6666666666666666,7.114288203393181,2
2020-07-16-170319,170319,1,0,0,27,0.3333333333333333,5.7709625803506786,3
2020-07-17-170319,170319,0,0,0,27,1.3333333333333333,7.790072041203895,4
2020-07-18-170319,170319,0,0,0,27,0.6666666666666666,8.399870453720368,5
2020-07-19-170319,170319,0,0,0,27,1.0,9.64214083230118,6
2020-07-20-170319,170319,0,0,0,27,0.3333333333333333,9.498723730475204,0
2020-07-21-170319,170319,0,0,1,27,1.3333333333333333,8.738973650795968,1
2020-07-22-170319,170319,0,0,0,27,0.0,10.13292532951753,2
2020-07-23-170319,170319,0,0,0,27,1.6666666666666667,8.686912210796077,3
2020-07-24-170319,170319,0,0,0,27,2.0,11.864958459403963,4
2020-07-25-170319,170319,0,0,0,27,0.0,12.577621203816527,5
2020-07-26-170319,170319,0,0,0,27,1.0,11.504198738271924,6
2020-07-27-170319,170319,1,0,0,28,1.0,11.568972321590406,0
2020-07-28-170319,170319,0,0,0,28,0.6666666666666666,11.390986226372647,1
2020-07-29-170319,170319,0,0,0,28,0.6666666666666666,9.896244265448853,2
2020-07-30-170319,170319,0,0,1,28,1.3333333333333333,7.483522186839178,3
2020-07-31-170319,170319,0,0,0,28,1.0,7.234400137573186,4
2020-08-01-170319,170319,0,0,0,28,0.0,3.5250669387854314,5
2020-08-02-170319,170319,0,0,0,28,0.0,17.126459123700176,6
2020-08-03-170319,170319,0,0,0,28,2.333333333333333,49.854146312896574,0
2020-08-04-170319,170319,1,0,0,29,1.3333333333333333,47.34362146176605,1
2020-08-05-170319,170319,0,0,0,29,2.6666666666666665,34.445680894568355,2
2020-08-06-170319,170319,0,0,0,29,0.3333333333333333,21.954620561273032,3
2020-08-07-170319,170319,0,0,0,29,0.3333333333333333,19.822046746448795,4
2020-08-08-170319,170319,0,0,0,29,0.3333333333333333,17.78287334047483,5
2020-08-09-170319,170319,0,0,0,29,0.0,16.411630603718347,6
2020-08-10-170319,170319,0,0,1,29,1.3333333333333333,3.324666797007076,0
2020-08-11-170319,170319,0,1,0,29,1.0,6.5657845667967685,1
2020-08-12-170319,170319,0,0,0,29,1.3333333333333333,7.62634735966544,2
2020-08-13-170319,170319,1,0,2,30,1.0,7.874744938629558,3
2020-08-14-170319,170319,0,0,1,30,1.6666666666666667,7.871775688387267,4
2020-08-15-170319,170319,0,0,0,30,0.0,8.645813781238992,5
2020-08-16-170319,170319,0,0,0,30,0.0,10.520582147441846,6
2020-08-17-170319,170319,0,0,0,30,2.6666666666666665,11.433581023912588,0
2020-08-18-170319,170319,0,0,0,30,1.0,12.50297950660207,1
2020-08-19-170319,170319,0,0,0,30,3.0,12.721831245049682,2
2020-08-20-170319,170319,0,0,0,30,0.3333333333333333,16.989079044643134,3
2020-08-21-170319,170319,0,0,0,30,3.6666666666666665,18.937206322909546,4
2020-08-22-170319,170319,0,0,0,30,2.0,22.60044452209925,5
2020-08-23-170319,170319,0,0,0,30,1.6666666666666667,23.655505101050966,6
2020-08-24-170319,170319,1,0,0,31,2.0,20.805779692043632,0
2020-08-25-170319,170319,0,0,2,31,4.666666666666667,24.47054796152752,1
2020-08-26-170319,170319,0,0,1,31,6.0,25.73511324567233,2
2020-08-27-170319,170319,2,0,0,33,6.666666666666668,39.137426412507054,3
2020-08-28-170319,170319,1,0,0,34,2.0,49.71925306768396,4
2020-08-29-170319,170319,0,0,0,34,4.333333333333333,45.83773441850841,5
2020-08-30-170319,170319,0,0,0,34,2.333333333333333,43.81518060384363,6
2020-08-31-170319,170319,0,0,0,34,4.666666666666667,40.33240784648019,0
2020-09-01-170319,170319,0,0,2,34,1.6666666666666667,11.809795947254454,1
2020-09-02-170319,170319,0,0,0,34,3.0,62.085117099164734,2
2020-09-03-170319,170319,0,0,2,34,3.333333333333333,52.28523582689627,3
2020-09-04-170319,170319,0,0,0,34,4.666666666666667,39.87689793235292,4
2020-09-05-170319,170319,0,0,0,34,3.333333333333333,33.98971625120314,5
2020-09-06-170319,170319,0,0,0,34,0.6666666666666666,37.83439087460025,6
2020-09-07-170319,170319,0,0,1,34,8.0,36.975496358274754,0
2020-09-08-170319,170319,2,0,1,36,7.666666666666668,33.408130530687814,1
2020-09-09-170319,170319,1,0,2,37,7.666666666666668,34.176959543345745,2
2020-09-10-170319,170319,0,0,1,37,4.666666666666667,7.114686624494721,3
2020-09-11-170319,170319,0,0,0,37,10.333333333333334,12.632001573141592,4
2020-09-12-170319,170319,0,0,0,37,2.0,20.125958742847516,5
2020-09-13-170319,170319,0,0,0,37,7.0,20.930052933452288,6
2020-09-14-170319,170319,0,0,0,37,9.333333333333334,22.905043561746954,0
2020-09-15-170319,170319,2,0,0,39,7.666666666666668,37.19109762669819,1
2020-09-16-170319,170319,0,0,0,39,10.666666666666666,47.47069125562531,2
2020-09-17-170319,170319,2,0,2,41,12.333333333333336,53.286628899943786,3
2020-09-18-170319,170319,0,0,1,41,12.666666666666664,56.26076742881825,4
2020-09-19-170319,170319,0,0,0,41,0.6666666666666666,53.40112801278382,5
2020-09-20-170319,170319,0,1,1,41,2.0,51.312642917307286,6
2020-09-21-170319,170319,1,0,3,42,15.666666666666664,39.57505611807416,0
2020-09-22-170319,170319,1,0,3,43,9.666666666666666,35.866240455115246,1
2020-09-23-170319,170319,2,0,1,45,10.333333333333334,34.59759930525396,2
2020-09-24-170319,170319,1,0,1,46,11.333333333333336,32.36586608774111,3
2020-09-25-170319,170319,0,0,1,46,9.0,36.333406301105455,4
2020-09-26-170319,170319,0,0,0,46,2.6666666666666665,44.592995640204734,5
2020-09-27-170319,170319,0,0,2,46,1.0,43.46511719243614,6
2020-09-28-170319,170319,0,0,0,46,13.666666666666664,43.5939306319608,0
2020-09-29-170319,170319,0,0,0,46,6.333333333333332,43.9443070633572,1
2020-09-30-170319,170319,0,0,0,46,9.666666666666666,39.917794572945326,2
2020-10-01-170319,170319,2,0,0,48,12.333333333333336,0.0,3
2020-10-02-170319,170319,1,0,0,49,17.0,76.38739056657784,4
2020-10-03-170319,170319,0,0,1,49,4.0,72.41854315329442,5
2020-10-04-170319,170319,1,0,1,50,4.0,77.02502408840402,6
2020-10-05-170319,170319,3,0,1,53,1.3333333333333333,63.81991437192315,0
2020-10-06-170319,170319,3,0,1,56,13.666666666666664,61.755158264415385,1
2020-10-07-170319,170319,1,0,0,57,11.666666666666664,60.94917908922862,2
2020-10-08-170319,170319,1,0,7,58,10.0,57.88201374421663,3
2020-10-09-170319,170319,1,0,0,59,16.0,67.12515349197093,4
2020-10-10-170319,170319,0,0,0,59,4.666666666666667,9.812092089568901,5
2020-10-11-170319,170319,2,0,2,61,2.333333333333333,16.610923759781336,6
2020-10-12-170319,170319,0,0,1,61,0.6666666666666666,20.51130791599272,0
2020-10-13-170319,170319,0,0,1,61,18.33333333333333,22.76248928699686,1
2020-10-14-170319,170319,0,0,0,61,16.333333333333332,34.09489413196578,2
2020-10-15-170319,170319,0,0,0,61,18.33333333333333,44.13180055314727,3
2020-10-16-170319,170319,0,0,1,61,14.0,51.77232731097517,4
2020-10-17-170319,170319,1,0,0,62,5.666666666666668,54.83063957086967,5
2020-10-18-170319,170319,1,0,0,63,3.0,56.68574083781665,6
2020-10-19-170319,170319,1,0,0,64,22.33333333333333,56.15829820469938,0
2020-10-20-170319,170319,1,0,0,65,16.666666666666668,61.87746616844383,1
2020-10-21-170319,170319,0,0,0,65,17.0,61.95549435956589,2
2020-10-22-170319,170319,7,0,0,72,34.333333333333336,62.418387203074,3
2020-10-23-170319,170319,0,0,0,72,16.666666666666668,74.78785196557985,4
2020-10-24-170319,170319,0,0,0,72,7.333333333333332,75.68752291034482,5
2020-10-25-170319,170319,2,0,0,74,3.333333333333333,78.616018479914,6
2020-10-26-170319,170319,1,0,3,75,20.0,67.57200447038896,0
2020-10-27-170319,170319,1,0,1,76,4.666666666666667,76.27775066489542,1
2020-10-28-170319,170319,0,0,0,76,27.33333333333333,72.70936970328793,2
2020-10-29-170319,170319,0,0,1,76,18.666666666666668,74.77756927506101,3
2020-10-30-170319,170319,1,0,0,77,19.33333333333333,56.493691727620025,4
2020-10-31-170319,170319,0,0,0,77,3.6666666666666665,67.05980587510119,5
2020-11-01-170319,170319,0,0,0,77,4.0,52.70042567260029,6
2020-11-02-170319,170319,0,0,0,77,1.6666666666666667,77.89159452127981,0
2020-11-03-170319,170319,0,0,0,77,24.0,57.59278401730731,1
2020-11-04-170319,170319,0,0,0,77,10.0,74.71908262701061,2
2020-11-05-170319,170319,0,0,0,77,20.666666666666668,66.76573145096687,3
2020-11-06-170319,170319,0,0,0,77,15.666666666666664,68.44014044241115,4
2020-11-07-170319,170319,0,0,0,77,1.0,69.55881928546219,5
2020-11-08-170319,170319,0,0,0,77,8.0,61.89059740838559,6
2020-11-09-170319,170319,3,1,0,80,27.33333333333333,68.81098423572311,0
2020-11-10-170319,170319,1,0,0,81,28.33333333333333,53.384942452069794,1
2020-11-11-170319,170319,0,0,0,81,18.666666666666668,61.74443347410892,2
2020-11-12-170319,170319,1,0,0,82,19.0,66.7851702116152,3
2020-11-13-170319,170319,0,0,0,82,23.66666666666667,66.57987509430262,4
2020-03-01-170320,170320,0,0,0,0,0.0,0.0,6
2020-03-02-170320,170320,0,0,0,0,0.0,0.00012581185827795948,0
2020-03-03-170320,170320,0,0,2,0,0.0,0.0007568320358474446,1
2020-03-04-170320,170320,0,1,1,0,0.0,0.0008148401411044524,2
2020-03-05-170320,170320,0,0,0,0,0.0,0.0008464663163578376,3
2020-03-06-170320,170320,0,0,1,0,0.0,0.0007161680931034868,4
2020-03-07-170320,170320,0,0,0,0,0.0,0.0007603036468611288,5
2020-03-08-170320,170320,0,0,0,0,0.0,0.0006641949325328345,6
2020-03-09-170320,170320,0,0,0,0,0.25,0.0006865065330279845,0
2020-03-10-170320,170320,0,0,1,0,0.0,0.005091515098535792,1
2020-03-11-170320,170320,0,0,0,0,0.0,9.304693924689378,2
2020-03-12-170320,170320,0,0,0,0,0.25,14.75372519920981,3
2020-03-13-170320,170320,0,0,0,0,0.0,16.633331355541333,4
2020-03-14-170320,170320,0,0,0,0,0.25,15.622844211343843,5
2020-03-15-170320,170320,0,0,0,0,1.25,9.61456306992138,6
2020-03-16-170320,170320,0,0,0,0,1.75,2.3403239054637393,0
2020-03-17-170320,170320,2,0,0,2,1.5,7.413441851889964,1
2020-03-18-170320,170320,1,0,0,3,1.75,9.254391492565293,2
2020-03-19-170320,170320,0,1,0,3,3.25,7.360147877317323,3
2020-03-20-170320,170320,1,1,0,4,3.5,8.407042067336084,4
2020-03-21-170320,170320,0,0,0,4,2.0,10.962502279726323,5
2020-03-22-170320,170320,0,0,0,4,1.25,10.691802675483745,6
2020-03-23-170320,170320,0,0,1,4,5.25,9.963719612144931,0
2020-03-24-170320,170320,1,0,0,5,1.75,6.295473016395049,1
2020-03-25-170320,170320,0,0,0,5,2.0,6.571760328827224,2
2020-03-26-170320,170320,0,0,0,5,2.25,6.345919398041871,3
2020-03-27-170320,170320,0,0,0,5,3.0,0.0015697967204877281,4
2020-03-28-170320,170320,0,0,0,5,0.5,3.429023476511257,5
2020-03-29-170320,170320,0,0,0,5,1.25,3.35538392236517,6
2020-03-30-170320,170320,0,0,0,5,1.0,2.3703634600321033,0
2020-03-31-170320,170320,0,0,0,5,0.75,2.1511136922777068,1
2020-04-01-170320,170320,0,0,0,5,1.75,0.2632024219687141,2
2020-04-02-170320,170320,0,0,0,5,1.25,1.3609038021789814,3
2020-04-03-170320,170320,0,0,1,5,0.75,0.8203081257034389,4
2020-04-04-170320,170320,0,0,0,5,0.0,0.0008393228073060146,5
2020-04-05-170320,170320,0,2,0,5,1.0,0.0007437809530675795,6
2020-04-06-170320,170320,1,0,0,6,1.0,0.0008027159876031227,0
2020-04-07-170320,170320,0,0,0,6,1.25,0.0009432564155481253,1
2020-04-08-170320,170320,0,0,0,6,2.5,0.0008874263876913085,2
2020-04-09-170320,170320,0,0,0,6,0.25,0.0008839894218040956,3
2020-04-10-170320,170320,0,0,0,6,1.5,0.00028054208840490546,4
2020-04-11-170320,170320,0,0,0,6,1.25,0.0009037318541622616,5
2020-04-12-170320,170320,0,2,0,6,0.75,0.0009843853301157242,6
2020-04-13-170320,170320,0,0,0,6,1.75,0.564913108876884,0
2020-04-14-170320,170320,0,0,0,6,1.25,0.7603534761074994,1
2020-04-15-170320,170320,0,1,0,6,1.5,0.8768579170503201,2
2020-04-16-170320,170320,0,0,1,6,1.0,3.9061661764413627,3
2020-04-17-170320,170320,1,0,0,7,0.0,3.570811960168875,4
2020-04-18-170320,170320,0,0,0,7,0.5,4.683355651558633,5
2020-04-19-170320,170320,0,0,0,7,0.25,4.344212276581745,6
2020-04-20-170320,170320,0,0,0,7,0.5,3.1259022848347326,0
2020-04-21-170320,170320,0,0,0,7,1.25,4.538742312990361,1
2020-04-22-170320,170320,0,0,0,7,0.0,5.780673037238602,2
2020-04-23-170320,170320,0,0,0,7,0.25,3.866038608175538,3
2020-04-24-170320,170320,0,0,0,7,2.25,3.1945149370964234,4
2020-04-25-170320,170320,0,0,0,7,0.25,2.865991685152223,5
2020-04-26-170320,170320,0,0,0,7,0.5,2.764552663695335,6
2020-04-27-170320,170320,0,0,0,7,0.25,2.484529893007447,0
2020-04-28-170320,170320,0,0,0,7,2.5,0.9149280505054189,1
2020-04-29-170320,170320,0,0,0,7,0.75,0.0008208887692216832,2
2020-04-30-170320,170320,1,0,1,8,1.0,0.0009943731830624222,3
2020-05-01-170320,170320,0,0,0,8,0.25,2.874202826963857,4
2020-05-02-170320,170320,0,1,0,8,0.25,2.4471990814791273,5
2020-05-03-170320,170320,0,0,0,8,0.25,2.8248435476410103,6
2020-05-04-170320,170320,0,0,0,8,1.25,1.7121201338033631,0
2020-05-05-170320,170320,0,0,0,8,0.5,2.017795385898876,1
2020-05-06-170320,170320,0,0,0,8,0.5,2.732348074319087,2
2020-05-07-170320,170320,0,0,0,8,1.75,3.9039727205798753,3
2020-05-08-170320,170320,0,0,0,8,0.75,4.389212646564368,4
2020-05-09-170320,170320,0,0,0,8,0.0,5.025829923716171,5
2020-05-10-170320,170320,0,0,0,8,0.75,5.6405854993438895,6
2020-05-11-170320,170320,0,1,0,8,0.5,6.008494974642395,0
2020-05-12-170320,170320,0,0,0,8,0.75,3.612124063849423,1
2020-05-13-170320,170320,0,0,0,8,2.5,4.435998029952843,2
2020-05-14-170320,170320,1,0,0,9,1.5,5.270318104392167,3
2020-05-15-170320,170320,0,0,0,9,0.0,3.088433880414875,4
2020-05-16-170320,170320,0,0,0,9,0.25,2.8423060221561975,5
2020-05-17-170320,170320,0,0,0,9,0.25,2.919443047964835,6
2020-05-18-170320,170320,0,0,0,9,0.75,2.5640069503980154,0
2020-05-19-170320,170320,0,0,0,9,0.25,2.739552650959187,1
2020-05-20-170320,170320,0,0,0,9,0.75,2.1706863199274005,2
2020-05-21-170320,170320,0,0,0,9,0.75,0.6275980471496281,3
2020-05-22-170320,170320,0,0,0,9,0.5,0.7734405434272603,4
2020-05-23-170320,170320,0,0,0,9,0.5,0.7299404946144967,5
2020-05-24-170320,170320,0,0,0,9,0.25,0.9046262368553649,6
2020-05-25-170320,170320,0,0,0,9,1.25,0.799457899539481,0
2020-05-26-170320,170320,0,0,0,9,1.5,1.1327510528425546,1
2020-05-27-170320,170320,0,0,0,9,0.25,1.772264534076144,2
2020-05-28-170320,170320,0,0,0,9,0.25,1.7555079389802435,3
2020-05-29-170320,170320,0,0,0,9,1.75,1.625450538413114,4
2020-05-30-170320,170320,0,0,0,9,0.0,1.6521491807278887,5
2020-05-31-170320,170320,0,0,0,9,0.25,1.5894453739718162,6
2020-06-01-170320,170320,0,0,0,9,0.25,2.049679302774097,0
2020-06-02-170320,170320,0,0,0,9,0.25,0.5348119985547268,1
2020-06-03-170320,170320,0,0,0,9,0.75,0.3050568734395484,2
2020-06-04-170320,170320,0,0,0,9,1.0,0.3320962820236415,3
2020-06-05-170320,170320,0,0,0,9,0.0,0.5933345510112777,4
2020-06-06-170320,170320,0,0,0,9,0.25,0.6598043102846062,5
2020-06-07-170320,170320,0,0,0,9,0.0,0.6619665430551658,6
2020-06-08-170320,170320,0,0,0,9,0.5,0.6655022761054353,0
2020-06-09-170320,170320,0,0,0,9,1.0,0.7933999713025062,1
2020-06-10-170320,170320,0,0,0,9,0.75,2.169605419998994,2
2020-06-11-170320,170320,0,0,0,9,0.75,2.161061859336287,3
2020-06-12-170320,170320,0,0,0,9,0.75,2.068212078411296,4
2020-06-13-170320,170320,0,0,0,9,0.5,1.9359230023275846,5
2020-06-14-170320,170320,0,0,0,9,0.25,1.4507895051084065,6
2020-06-15-170320,170320,0,0,0,9,0.75,1.1211924257042143,0
2020-06-16-170320,170320,0,0,0,9,0.5,1.1372756013344656,1
2020-06-17-170320,170320,0,0,0,9,0.25,0.8329734229931959,2
2020-06-18-170320,170320,0,0,0,9,0.75,0.7072301475871303,3
2020-06-19-170320,170320,0,0,0,9,0.25,0.5195059024050084,4
2020-06-20-170320,170320,0,0,0,9,0.5,0.5484158656184275,5
2020-06-21-170320,170320,0,0,0,9,0.0,0.4664427805986009,6
2020-06-22-170320,170320,0,0,0,9,0.75,0.4008555021827641,0
2020-06-23-170320,170320,0,0,0,9,0.5,0.5801091520051683,1
2020-06-24-170320,170320,0,0,0,9,0.5,1.092388511681104,2
2020-06-25-170320,170320,0,1,0,9,0.5,0.9751364665622055,3
2020-06-26-170320,170320,0,1,0,9,0.25,0.9818870847196393,4
2020-06-27-170320,170320,0,0,0,9,0.0,0.8720349624420872,5
2020-06-28-170320,170320,0,0,0,9,0.0,0.8530294843000628,6
2020-06-29-170320,170320,0,1,0,9,0.25,0.8414979341238534,0
2020-06-30-170320,170320,0,0,0,9,1.5,0.47670080470351256,1
2020-07-01-170320,170320,0,0,0,9,0.25,1.3756457605863122,2
2020-07-02-170320,170320,0,0,0,9,1.25,1.0890935605141052,3
2020-07-03-170320,170320,0,0,0,9,0.0,1.0368794115689037,4
2020-07-04-170320,170320,0,0,0,9,0.25,0.5733948609013929,5
2020-07-05-170320,170320,0,0,0,9,0.0,0.5705091927247987,6
2020-07-06-170320,170320,0,0,0,9,0.75,0.5092815092033265,0
2020-07-07-170320,170320,0,0,0,9,0.25,0.46275570298269203,1
2020-07-08-170320,170320,0,0,0,9,0.5,0.668036467839962,2
2020-07-09-170320,170320,0,0,0,9,0.0,0.6627555536224263,3
2020-07-10-170320,170320,0,0,0,9,0.75,1.3966736071362726,4
2020-07-11-170320,170320,0,0,0,9,0.0,0.9897929442379068,5
2020-07-12-170320,170320,0,0,0,9,0.0,0.7296931945207636,6
2020-07-13-170320,170320,0,0,0,9,0.75,0.7049154543447904,0
2020-07-14-170320,170320,0,0,0,9,0.25,0.8576095536249293,1
2020-07-15-170320,170320,0,0,0,9,0.25,0.8608170128813788,2
2020-07-16-170320,170320,0,0,0,9,1.0,0.6985404566326701,3
2020-07-17-170320,170320,0,0,0,9,0.5,0.93381039161564,4
2020-07-18-170320,170320,0,0,0,9,0.5,1.0825870175359067,5
2020-07-19-170320,170320,0,0,0,9,0.25,1.312664782985784,6
2020-07-20-170320,170320,0,0,0,9,0.0,1.5763333188623645,0
2020-07-21-170320,170320,0,0,0,9,1.0,1.43240575719732,1
2020-07-22-170320,170320,0,0,0,9,0.0,1.4638199195548762,2
2020-07-23-170320,170320,0,0,0,9,1.0,1.2634731728526558,3
2020-07-24-170320,170320,0,0,0,9,0.25,1.4600511966112653,4
2020-07-25-170320,170320,0,0,0,9,0.75,1.4213779541681544,5
2020-07-26-170320,170320,0,0,0,9,0.0,1.3805863784353534,6
2020-07-27-170320,170320,0,0,0,9,1.0,1.1400491792006298,0
2020-07-28-170320,170320,0,0,0,9,0.75,1.2011198915037609,1
2020-07-29-170320,170320,0,0,0,9,1.5,1.2935244762666624,2
2020-07-30-170320,170320,0,0,0,9,0.25,1.0980695738282442,3
2020-07-31-170320,170320,0,0,0,9,0.0,1.0112408910080484,4
2020-08-01-170320,170320,0,0,0,9,0.25,0.7905861792316102,5
2020-08-02-170320,170320,0,0,0,9,0.0,6.47186859280243,6
2020-08-03-170320,170320,0,0,0,9,0.5,7.854466134917729,0
2020-08-04-170320,170320,0,0,1,9,0.75,5.604480467619895,1
2020-08-05-170320,170320,0,0,0,9,1.0,4.168509851220371,2
2020-08-06-170320,170320,0,0,0,9,0.25,3.263189238458012,3
2020-08-07-170320,170320,0,0,1,9,1.0,3.1696652188716845,4
2020-08-08-170320,170320,0,0,0,9,0.25,3.105808809960916,5
2020-08-09-170320,170320,0,0,1,9,0.0,2.827165705393718,6
2020-08-10-170320,170320,0,0,0,9,1.75,0.8094619720080359,0
2020-08-11-170320,170320,0,0,0,9,1.0,1.3084672841323086,1
2020-08-12-170320,170320,0,0,0,9,3.75,1.5069882098465481,2
2020-08-13-170320,170320,0,0,0,9,1.75,1.791479270434187,3
2020-08-14-170320,170320,0,0,0,9,1.75,2.000485215370978,4
2020-08-15-170320,170320,0,0,0,9,2.0,2.27236329339386,5
2020-08-16-170320,170320,0,0,0,9,0.25,3.2603943180530814,6
2020-08-17-170320,170320,0,0,0,9,2.0,3.4733167628517045,0
2020-08-18-170320,170320,1,0,0,10,1.5,3.816050312466736,1
2020-08-19-170320,170320,0,0,0,10,4.5,4.740769438417293,2
2020-08-20-170320,170320,0,0,0,10,1.75,6.159758393745422,3
2020-08-21-170320,170320,1,0,0,11,5.75,6.752390404378198,4
2020-08-22-170320,170320,0,0,1,11,1.0,7.917561197085699,5
2020-08-23-170320,170320,1,0,0,12,3.25,8.014794165758575,6
2020-08-24-170320,170320,0,0,0,12,2.0,8.446829784782542,0
2020-08-25-170320,170320,0,0,0,12,4.25,8.435673551661518,1
2020-08-26-170320,170320,0,0,0,12,3.75,7.623152555234356,2
2020-08-27-170320,170320,0,0,2,12,1.5,9.671097082090032,3
2020-08-28-170320,170320,0,0,0,12,0.5,9.748931767036751,4
2020-08-29-170320,170320,0,0,0,12,0.0,7.736868949869301,5
2020-08-30-170320,170320,0,0,0,12,1.0,6.76268190471541,6
2020-08-31-170320,170320,0,0,0,12,1.75,6.267998786032196,0
2020-09-01-170320,170320,0,0,0,12,1.0,2.347871702246756,1
2020-09-02-170320,170320,0,0,1,12,0.75,8.639433706266654,2
2020-09-03-170320,170320,0,0,0,12,1.5,5.672328412524497,3
2020-09-04-170320,170320,0,0,1,12,0.75,5.379849698718468,4
2020-09-05-170320,170320,1,0,0,13,0.5,5.20612954768769,5
2020-09-06-170320,170320,0,0,0,13,1.25,4.716717358571213,6
2020-09-07-170320,170320,0,0,1,13,1.0,4.816314440305861,0
2020-09-08-170320,170320,0,0,1,13,1.5,4.317427568163498,1
2020-09-09-170320,170320,0,0,0,13,1.5,4.898578766216206,2
2020-09-10-170320,170320,2,0,0,15,1.25,1.4083876855456359,3
2020-09-11-170320,170320,0,0,0,15,0.0,2.9026554609721633,4
2020-09-12-170320,170320,0,0,1,15,0.5,3.442496337870125,5
2020-09-13-170320,170320,0,0,0,15,0.25,3.5726603947011135,6
2020-09-14-170320,170320,0,0,0,15,6.25,3.38197547389355,0
2020-09-15-170320,170320,0,0,0,15,3.25,7.309724163103661,1
2020-09-16-170320,170320,1,0,1,16,1.0,8.043391620100845,2
2020-09-17-170320,170320,0,0,1,16,1.5,8.65031649166509,3
2020-09-18-170320,170320,1,0,1,17,1.5,8.00049412458286,4
2020-09-19-170320,170320,0,1,0,17,1.0,8.429346332435772,5
2020-09-20-170320,170320,0,0,2,17,1.75,8.526381615540407,6
2020-09-21-170320,170320,1,0,0,18,2.75,5.817410740055776,0
2020-09-22-170320,170320,1,0,3,19,0.75,5.70090817773285,1
2020-09-23-170320,170320,0,0,0,19,1.25,4.420807418528485,2
2020-09-24-170320,170320,0,0,0,19,1.25,4.2122816123597,3
2020-09-25-170320,170320,0,0,0,19,2.0,4.0706501113933236,4
2020-09-26-170320,170320,1,0,0,20,1.75,4.508808705810856,5
2020-09-27-170320,170320,0,0,0,20,1.0,5.079106494764859,6
2020-09-28-170320,170320,0,0,0,20,2.0,4.615081498095069,0
2020-09-29-170320,170320,0,0,0,20,3.25,4.203861782209471,1
2020-09-30-170320,170320,1,0,0,21,2.75,5.178108571576406,2
2020-10-01-170320,170320,1,0,0,22,3.0,0.0,3
2020-10-02-170320,170320,1,0,0,23,2.0,9.043600124321603,4
2020-10-03-170320,170320,0,0,0,23,1.5,10.72769063489989,5
2020-10-04-170320,170320,2,0,2,25,3.0,11.848701106794389,6
2020-10-05-170320,170320,0,0,0,25,3.75,11.82762606689164,0
2020-10-06-170320,170320,3,0,0,28,2.0,11.503700890337692,1
2020-10-07-170320,170320,0,0,0,28,1.75,11.195674305270678,2
2020-10-08-170320,170320,0,0,0,28,4.0,10.674552068586717,3
2020-10-09-170320,170320,0,0,0,28,4.75,11.879384256914065,4
2020-10-10-170320,170320,0,0,0,28,2.75,1.4527709494511885,5
2020-10-11-170320,170320,0,0,1,28,1.25,2.5697076410767528,6
2020-10-12-170320,170320,0,0,1,28,3.25,2.984572447733032,0
2020-10-13-170320,170320,0,0,2,28,3.0,3.5933787423478565,1
2020-10-14-170320,170320,0,0,2,28,4.5,3.6613356535432353,2
2020-10-15-170320,170320,0,0,1,28,2.75,4.773267546678744,3
2020-10-16-170320,170320,0,0,0,28,1.5,5.823682785524,4
2020-10-17-170320,170320,0,0,0,28,6.75,5.719868488244124,5
2020-10-18-170320,170320,2,0,6,30,3.0,6.114521619003794,6
2020-10-19-170320,170320,0,0,0,30,4.5,6.575315840376842,0
2020-10-20-170320,170320,0,0,0,30,11.25,7.276597914942824,1
2020-10-21-170320,170320,0,0,1,30,2.5,6.5363067603298015,2
2020-10-22-170320,170320,0,0,0,30,6.75,5.92476361897277,3
2020-10-23-170320,170320,0,0,3,30,5.25,6.936446259139805,4
2020-10-24-170320,170320,0,0,0,30,7.0,6.921394520735024,5
2020-10-25-170320,170320,1,0,0,31,2.0,7.023649765509054,6
2020-10-26-170320,170320,1,0,1,32,1.75,6.7102799235169694,0
2020-10-27-170320,170320,2,1,1,34,1.5,6.727755952521308,1
2020-10-28-170320,170320,2,0,1,36,8.5,6.981747931483266,2
2020-10-29-170320,170320,1,0,1,37,5.5,7.949713514256473,3
2020-10-30-170320,170320,0,0,0,37,5.5,6.771359333915849,4
2020-10-31-170320,170320,0,0,0,37,2.5,8.078613960658057,5
2020-11-01-170320,170320,6,0,0,43,6.0,8.074884030478405,6
2020-11-02-170320,170320,0,0,0,43,2.5,7.939158301781565,0
2020-11-03-170320,170320,0,1,0,43,5.75,5.657703982684495,1
2020-11-04-170320,170320,1,0,0,44,4.0,6.296992780191704,2
2020-11-05-170320,170320,0,0,0,44,3.5,6.090177745493669,3
2020-11-06-170320,170320,3,0,0,47,2.0,5.465292137423013,4
2020-11-07-170320,170320,0,0,0,47,3.5,5.730017358628629,5
2020-11-08-170320,170320,0,0,0,47,4.75,5.477564612868291,6
2020-11-09-170320,170320,1,1,0,48,5.25,6.971320230417097,0
2020-11-10-170320,170320,1,0,0,49,2.75,9.60669833834574,1
2020-11-11-170320,170320,1,0,0,50,2.25,10.128829727389363,2
2020-11-12-170320,170320,1,0,0,51,6.0,10.333191883258785,3
2020-11-13-170320,170320,0,0,0,51,5.75,10.2682004914694,4
2020-03-01-170321,170321,0,0,1,0,0.0,0.0,6
2020-03-02-170321,170321,0,0,0,0,0.0,25.824907189727643,0
2020-03-03-170321,170321,0,0,1,0,0.0,78.02190050706136,1
2020-03-04-170321,170321,0,1,1,0,0.0,74.83654901188335,2
2020-03-05-170321,170321,0,0,1,0,0.0,81.12225285042734,3
2020-03-06-170321,170321,0,0,2,0,0.0,68.3183507021323,4
2020-03-07-170321,170321,0,0,0,0,0.0,75.28159058139151,5
2020-03-08-170321,170321,0,0,1,0,0.0,80.35711298248535,6
2020-03-09-170321,170321,0,0,1,0,0.0,79.3596513532589,0
2020-03-10-170321,170321,0,0,1,0,0.0,291.3392182407299,1
2020-03-11-170321,170321,0,0,2,0,0.0,238.52769769710085,2
2020-03-12-170321,170321,0,0,0,0,0.0,189.08289732080445,3
2020-03-13-170321,170321,0,0,1,0,0.0,140.48519571453528,4
2020-03-14-170321,170321,0,0,0,0,0.6,122.75487821235683,5
2020-03-15-170321,170321,1,0,0,1,1.6,109.81382555938326,6
2020-03-16-170321,170321,0,0,0,1,9.2,16.709871754850717,0
2020-03-17-170321,170321,1,0,1,2,5.0,50.303803981232434,1
2020-03-18-170321,170321,1,1,0,3,5.6,82.05693946166224,2
2020-03-19-170321,170321,1,0,0,4,8.0,115.41573477389292,3
2020-03-20-170321,170321,2,1,3,6,7.8,151.87551658085798,4
2020-03-21-170321,170321,0,1,0,6,1.0,187.72964900286053,5
2020-03-22-170321,170321,1,0,0,7,2.0,169.36509292452237,6
2020-03-23-170321,170321,1,0,0,8,11.0,149.40287707232818,0
2020-03-24-170321,170321,1,0,1,9,7.0,162.12604947237025,1
2020-03-25-170321,170321,2,0,0,11,7.2,167.30285100662763,2
2020-03-26-170321,170321,0,0,0,11,5.6,168.0926478987534,3
2020-03-27-170321,170321,1,0,1,12,6.8,187.35872965252145,4
2020-03-28-170321,170321,0,0,0,12,1.2,176.27887508926847,5
2020-03-29-170321,170321,0,0,0,12,0.8,179.04687675817345,6
2020-03-30-170321,170321,0,0,0,12,7.2,130.5569426781877,0
2020-03-31-170321,170321,1,0,0,13,3.4,121.34097179988797,1
2020-04-01-170321,170321,0,0,0,13,4.0,20.37615732144709,2
2020-04-02-170321,170321,0,1,0,13,2.8,94.4359764139347,3
2020-04-03-170321,170321,3,0,0,16,3.4,64.15073491565504,4
2020-04-04-170321,170321,0,0,0,16,1.0,74.1964468919062,5
2020-04-05-170321,170321,0,0,0,16,0.8,76.5324043949976,6
2020-04-06-170321,170321,0,1,0,16,9.8,76.57917644656229,0
2020-04-07-170321,170321,1,4,0,17,3.6,89.41954297118393,1
2020-04-08-170321,170321,0,1,1,17,3.4,104.16797511138594,2
2020-04-09-170321,170321,0,0,0,17,3.4,96.11233952581279,3
2020-04-10-170321,170321,1,0,1,18,3.4,20.196157387925492,4
2020-04-11-170321,170321,0,0,0,18,0.8,40.68455613826228,5
2020-04-12-170321,170321,0,0,0,18,1.0,43.07181485428329,6
2020-04-13-170321,170321,0,0,1,18,3.8,46.67594162968919,0
2020-04-14-170321,170321,0,1,0,18,5.6,63.96740176207282,1
2020-04-15-170321,170321,0,0,2,18,3.8,92.5216230125031,2
2020-04-16-170321,170321,0,0,0,18,4.4,110.5584314606196,3
2020-04-17-170321,170321,0,1,0,18,3.0,109.66533809015985,4
2020-04-18-170321,170321,0,0,0,18,0.2,101.3556621246068,5
2020-04-19-170321,170321,0,0,0,18,0.6,99.10573500591124,6
2020-04-20-170321,170321,0,1,1,18,7.6,89.46121885992886,0
2020-04-21-170321,170321,0,0,0,18,2.6,76.98369571207166,1
2020-04-22-170321,170321,1,0,1,19,2.2,67.30039015490775,2
2020-04-23-170321,170321,0,0,0,19,2.0,66.57213289177349,3
2020-04-24-170321,170321,1,0,1,20,5.2,59.28595263012784,4
2020-04-25-170321,170321,0,0,0,20,0.6,80.22589558824664,5
2020-04-26-170321,170321,0,0,1,20,0.6,82.54134612474762,6
2020-04-27-170321,170321,1,2,0,21,1.8,74.17758599208963,0
2020-04-28-170321,170321,0,3,0,21,1.8,69.25771990798444,1
2020-04-29-170321,170321,2,0,0,23,1.4,68.34079740838496,2
2020-04-30-170321,170321,0,0,0,23,1.8,102.5100820488469,3
2020-05-01-170321,170321,0,0,0,23,0.4,90.25401291034171,4
2020-05-02-170321,170321,0,0,1,23,0.4,35.18661154250348,5
2020-05-03-170321,170321,0,0,0,23,0.4,45.07709901070972,6
2020-05-04-170321,170321,1,0,0,24,1.0,26.535875527920403,0
2020-05-05-170321,170321,0,0,0,24,1.2,35.064342612842594,1
2020-05-06-170321,170321,1,0,0,25,1.6,30.703490800176567,2
2020-05-07-170321,170321,0,0,0,25,2.2,41.197189644792736,3
2020-05-08-170321,170321,1,0,0,26,1.6,44.53107365097103,4
2020-05-09-170321,170321,0,0,0,26,0.6,59.98141899773516,5
2020-05-10-170321,170321,1,0,0,27,0.4,95.37269777022938,6
2020-05-11-170321,170321,0,0,2,27,1.0,97.7382366060673,0
2020-05-12-170321,170321,0,0,0,27,0.4,101.55976805627152,1
2020-05-13-170321,170321,0,0,1,27,1.4,70.94087845303245,2
2020-05-14-170321,170321,0,0,0,27,2.4,50.54318477779458,3
2020-05-15-170321,170321,0,0,0,27,1.8,47.814908762210905,4
2020-05-16-170321,170321,1,0,0,28,0.2,39.58207262299321,5
2020-05-17-170321,170321,0,0,0,28,0.0,48.61829107669389,6
2020-05-18-170321,170321,0,0,0,28,1.0,40.70869208457854,0
2020-05-19-170321,170321,0,0,0,28,1.4,39.42594500292507,1
2020-05-20-170321,170321,0,0,0,28,1.2,39.96579950323185,2
2020-05-21-170321,170321,0,0,0,28,2.4,33.74122755434781,3
2020-05-22-170321,170321,0,0,2,28,2.2,38.93535101863337,4
2020-05-23-170321,170321,0,0,0,28,0.6,37.680102021179955,5
2020-05-24-170321,170321,0,0,0,28,0.2,39.52508092698878,6
2020-05-25-170321,170321,2,0,1,30,1.2,36.3949773456384,0
2020-05-26-170321,170321,0,0,0,30,1.8,54.26619209856955,1
2020-05-27-170321,170321,1,0,1,31,0.6,60.87157197258978,2
2020-05-28-170321,170321,0,0,0,31,1.0,70.07256144583789,3
2020-05-29-170321,170321,0,0,0,31,1.6,66.35142445775239,4
2020-05-30-170321,170321,0,0,0,31,0.6,65.78437954828205,5
2020-05-31-170321,170321,0,0,0,31,0.2,68.62877085199366,6
2020-06-01-170321,170321,0,0,0,31,1.4,86.66226851679451,0
2020-06-02-170321,170321,0,0,0,31,1.2,38.18661570816777,1
2020-06-03-170321,170321,0,0,1,31,2.0,9.535718152736965,2
2020-06-04-170321,170321,0,0,1,31,0.8,14.94276212850935,3
2020-06-05-170321,170321,2,0,0,33,1.4,16.491418576086502,4
2020-06-06-170321,170321,0,0,0,33,0.0,44.85108903246345,5
2020-06-07-170321,170321,0,0,0,33,0.0,45.71808439927876,6
2020-06-08-170321,170321,1,0,0,34,1.0,45.06490010518307,0
2020-06-09-170321,170321,0,0,0,34,1.4,71.60552146228585,1
2020-06-10-170321,170321,1,0,0,35,0.8,91.44033733442623,2
2020-06-11-170321,170321,0,0,0,35,1.2,94.52539895617761,3
2020-06-12-170321,170321,0,0,0,35,0.2,91.71016170294862,4
2020-06-13-170321,170321,0,0,0,35,0.2,74.15207808904043,5
2020-06-14-170321,170321,0,0,0,35,0.2,62.58922771430592,6
2020-06-15-170321,170321,0,1,0,35,0.4,44.20170955885912,0
2020-06-16-170321,170321,0,0,0,35,0.4,44.874271094583506,1
2020-06-17-170321,170321,1,1,0,36,0.0,40.69992145500016,2
2020-06-18-170321,170321,1,0,0,37,0.8,32.16467120477585,3
2020-06-19-170321,170321,0,0,0,37,0.2,38.27835701180117,4
2020-06-20-170321,170321,0,0,0,37,0.0,46.31823891529383,5
2020-06-21-170321,170321,0,0,0,37,0.0,46.690254929702405,6
2020-06-22-170321,170321,0,0,0,37,0.8,42.996974610409524,0
2020-06-23-170321,170321,0,0,0,37,0.4,43.04743925671278,1
2020-06-24-170321,170321,0,0,0,37,0.0,34.707200224925074,2
2020-06-25-170321,170321,0,0,0,37,0.2,22.182552620962877,3
2020-06-26-170321,170321,0,0,0,37,0.2,23.042233113793625,4
2020-06-27-170321,170321,0,0,0,37,0.0,13.91364312555318,5
2020-06-28-170321,170321,0,0,0,37,0.0,14.198358825633623,6
2020-06-29-170321,170321,0,0,0,37,0.0,14.352491223986137,0
2020-06-30-170321,170321,0,0,0,37,0.2,16.68923112718801,1
2020-07-01-170321,170321,0,0,0,37,0.0,79.49451192100446,2
2020-07-02-170321,170321,0,0,0,37,0.2,22.028833852274094,3
2020-07-03-170321,170321,0,0,0,37,0.2,12.710436438682013,4
2020-07-04-170321,170321,0,0,1,37,0.0,12.654830963599222,5
2020-07-05-170321,170321,0,0,0,37,0.0,11.925271877961034,6
2020-07-06-170321,170321,0,0,0,37,0.0,10.685254982470099,0
2020-07-07-170321,170321,0,0,1,37,0.6,8.63824011569744,1
2020-07-08-170321,170321,0,0,0,37,0.2,11.256121061268303,2
2020-07-09-170321,170321,0,0,0,37,0.4,10.865314271197983,3
2020-07-10-170321,170321,0,0,0,37,0.4,84.67117318846759,4
2020-07-11-170321,170321,0,0,0,37,0.0,83.12014882485025,5
2020-07-12-170321,170321,0,0,0,37,0.2,49.1668909852813,6
2020-07-13-170321,170321,0,0,0,37,0.4,50.189924697439515,0
2020-07-14-170321,170321,0,0,0,37,0.2,51.61353126198051,1
2020-07-15-170321,170321,0,0,0,37,0.4,19.084457932024574,2
2020-07-16-170321,170321,0,0,0,37,0.2,8.520439439580754,3
2020-07-17-170321,170321,0,0,0,37,0.4,9.550170381555414,4
2020-07-18-170321,170321,1,0,0,38,0.2,11.91978963606432,5
2020-07-19-170321,170321,0,0,0,38,0.2,24.328703221872342,6
2020-07-20-170321,170321,0,0,1,38,0.4,23.761937252626815,0
2020-07-21-170321,170321,1,0,0,39,0.6,25.187509960266546,1
2020-07-22-170321,170321,0,0,0,39,0.6,39.44455110781864,2
2020-07-23-170321,170321,0,0,0,39,1.0,42.001938110665435,3
2020-07-24-170321,170321,0,0,0,39,0.6,40.47520183618053,4
2020-07-25-170321,170321,0,0,0,39,0.0,30.5967338946348,5
2020-07-26-170321,170321,0,0,0,39,0.0,29.294269335622804,6
2020-07-27-170321,170321,0,0,0,39,0.4,29.068876532241262,0
2020-07-28-170321,170321,0,0,0,39,0.2,28.68713688022168,1
2020-07-29-170321,170321,0,0,0,39,0.2,15.90556757249079,2
2020-07-30-170321,170321,0,0,0,39,0.2,12.827053560586865,3
2020-07-31-170321,170321,0,0,0,39,0.4,11.961329866606821,4
2020-08-01-170321,170321,0,0,0,39,0.0,13.343056683262589,5
2020-08-02-170321,170321,0,0,1,39,0.0,64.18074301899524,6
2020-08-03-170321,170321,1,0,0,40,0.2,263.2599155853171,0
2020-08-04-170321,170321,0,0,0,40,0.6,174.08745643011397,1
2020-08-05-170321,170321,0,0,1,40,0.4,152.60341228004333,2
2020-08-06-170321,170321,0,0,0,40,0.6,133.34138592542848,3
2020-08-07-170321,170321,0,0,4,40,0.8,110.86408224910195,4
2020-08-08-170321,170321,0,0,0,40,0.0,60.412778687479005,5
2020-08-09-170321,170321,0,0,1,40,0.0,46.310748265032544,6
2020-08-10-170321,170321,0,0,1,40,1.0,12.262696400442284,0
2020-08-11-170321,170321,0,0,0,40,1.2,17.982803708358254,1
2020-08-12-170321,170321,0,0,1,40,0.8,24.878191268283587,2
2020-08-13-170321,170321,0,0,1,40,0.8,27.39661318977799,3
2020-08-14-170321,170321,0,0,1,40,0.6,31.89853336082109,4
2020-08-15-170321,170321,0,0,2,40,1.2,33.47256236025946,5
2020-08-16-170321,170321,1,0,0,41,0.2,33.30476472596185,6
2020-08-17-170321,170321,0,0,0,41,1.4,47.468214149694376,0
2020-08-18-170321,170321,0,0,0,41,0.2,48.13649438202573,1
2020-08-19-170321,170321,1,0,0,42,3.6,44.26307080781181,2
2020-08-20-170321,170321,0,0,0,42,1.0,58.88409712293146,3
2020-08-21-170321,170321,4,0,4,46,3.2,64.4396179198309,4
2020-08-22-170321,170321,0,0,7,46,0.2,174.79653420788912,5
2020-08-23-170321,170321,1,0,0,47,0.4,159.19046791414783,6
2020-08-24-170321,170321,1,0,0,48,0.6,170.62511865948247,0
2020-08-25-170321,170321,0,0,0,48,4.0,254.22610539376643,1
2020-08-26-170321,170321,1,0,0,49,2.4,252.95959046694105,2
2020-08-27-170321,170321,1,0,6,50,2.0,278.6366587054149,3
2020-08-28-170321,170321,1,0,1,51,1.4,286.1260979425001,4
2020-08-29-170321,170321,2,0,3,53,1.8,201.77998646091407,5
2020-08-30-170321,170321,0,0,0,53,0.8,243.7241210626778,6
2020-08-31-170321,170321,0,0,6,53,2.8,168.10670867122025,0
2020-09-01-170321,170321,0,0,0,53,1.6,37.52120815788392,1
2020-09-02-170321,170321,0,0,5,53,1.0,248.15954314485083,2
2020-09-03-170321,170321,0,0,1,53,1.6,237.00924345781073,3
2020-09-04-170321,170321,4,0,3,57,2.2,190.29156278175287,4
2020-09-05-170321,170321,7,0,0,64,0.4,207.60429090504766,5
2020-09-06-170321,170321,0,0,2,64,0.6,282.3932446681872,6
2020-09-07-170321,170321,0,0,1,64,3.0,284.09847411449243,0
2020-09-08-170321,170321,0,0,0,64,2.4,243.1775654800473,1
2020-09-09-170321,170321,0,0,2,64,3.8,226.91851903851824,2
2020-09-10-170321,170321,6,0,0,70,3.4,21.812775722451967,3
2020-09-11-170321,170321,1,0,0,71,2.2,100.08796567141721,4
2020-09-12-170321,170321,3,0,1,74,1.0,146.47706748918918,5
2020-09-13-170321,170321,0,0,0,74,0.8,171.1869844780157,6
2020-09-14-170321,170321,6,0,3,80,5.4,174.91491101261585,0
2020-09-15-170321,170321,0,0,2,80,3.4,240.31424095725578,1
2020-09-16-170321,170321,5,0,0,85,4.6,256.855113679381,2
2020-09-17-170321,170321,1,0,1,86,3.2,311.5796174536695,3
2020-09-18-170321,170321,3,0,0,89,2.6,265.47236932683745,4
2020-09-19-170321,170321,0,0,1,89,1.0,241.29020440331198,5
2020-09-20-170321,170321,2,0,2,91,1.4,216.1036783605635,6
2020-09-21-170321,170321,1,0,0,92,5.4,155.49509131169685,0
2020-09-22-170321,170321,0,0,0,92,4.0,165.65330556707022,1
2020-09-23-170321,170321,2,0,0,94,3.0,125.5987852249456,2
2020-09-24-170321,170321,0,0,2,94,5.0,118.26247636840746,3
2020-09-25-170321,170321,0,0,0,94,4.0,146.02099316814665,4
2020-09-26-170321,170321,1,0,0,95,0.2,167.05280909035412,5
2020-09-27-170321,170321,0,0,0,95,1.0,167.8246324239605,6
2020-09-28-170321,170321,3,0,1,98,3.4,169.64178280023606,0
2020-09-29-170321,170321,2,0,0,100,2.0,194.51751289527414,1
2020-09-30-170321,170321,0,0,0,100,2.4,189.62259290297064,2
2020-10-01-170321,170321,1,0,0,101,4.6,0.0,3
2020-10-02-170321,170321,0,0,0,101,5.8,343.7988161456069,4
2020-10-03-170321,170321,1,0,0,102,1.4,364.1622702804634,5
2020-10-04-170321,170321,2,1,0,104,1.2,358.15369429659825,6
2020-10-05-170321,170321,0,0,3,104,2.4,301.73120309799583,0
2020-10-06-170321,170321,0,0,0,104,3.4,268.814594541997,1
2020-10-07-170321,170321,0,0,0,104,5.4,263.0302342558244,2
2020-10-08-170321,170321,2,0,1,106,5.2,212.9638521181932,3
2020-10-09-170321,170321,0,0,0,106,16.0,243.6753709420719,4
2020-10-10-170321,170321,0,0,4,106,2.8,38.80788641778147,5
2020-10-11-170321,170321,0,0,1,106,0.8,52.11702198767064,6
2020-10-12-170321,170321,1,0,2,107,1.6,57.39562678155212,0
2020-10-13-170321,170321,0,0,2,107,9.2,75.25502307525197,1
2020-10-14-170321,170321,0,0,0,107,5.0,128.17678163697906,2
2020-10-15-170321,170321,0,0,5,107,4.2,167.37810606927968,3
2020-10-16-170321,170321,0,0,1,107,4.8,206.35532485064314,4
2020-10-17-170321,170321,0,0,1,107,3.6,215.3757033454952,5
2020-10-18-170321,170321,0,0,3,107,1.8,220.91774170450793,6
2020-10-19-170321,170321,3,0,0,110,10.2,229.14113553296448,0
2020-10-20-170321,170321,0,0,0,110,3.8,284.13282973862596,1
2020-10-21-170321,170321,0,0,2,110,5.6,270.4726787009841,2
2020-10-22-170321,170321,1,0,0,111,7.4,256.19737160299593,3
2020-10-23-170321,170321,0,0,0,111,5.2,266.6273359725741,4
2020-10-24-170321,170321,4,1,1,115,1.2,284.2432734402619,5
2020-10-25-170321,170321,1,1,0,116,0.8,312.15845028240915,6
2020-10-26-170321,170321,2,0,0,118,8.0,245.89216646421136,0
2020-10-27-170321,170321,2,0,4,120,3.4,284.53442932800544,1
2020-10-28-170321,170321,0,1,0,120,5.4,294.25671215075596,2
2020-10-29-170321,170321,5,0,1,125,7.2,301.60946928137776,3
2020-10-30-170321,170321,1,0,0,126,11.4,308.7968698714907,4
2020-10-31-170321,170321,1,0,0,127,0.4,328.1988833897684,5
2020-11-01-170321,170321,3,0,0,130,1.8,246.64356219095924,6
2020-11-02-170321,170321,0,0,0,130,0.8,253.35079105474242,0
2020-11-03-170321,170321,0,1,0,130,8.4,225.82873103387146,1
2020-11-04-170321,170321,2,0,0,132,3.6,284.2631404671261,2
2020-11-05-170321,170321,0,0,0,132,8.4,287.48665921198767,3
2020-11-06-170321,170321,0,0,0,132,9.2,276.20974154211547,4
2020-11-07-170321,170321,1,0,0,133,0.2,267.3986191004616,5
2020-11-08-170321,170321,0,0,0,133,3.8,238.6190552095686,6
2020-11-09-170321,170321,0,0,0,133,18.2,236.9960085157891,0
2020-11-10-170321,170321,4,1,0,137,7.8,238.81814913806167,1
2020-11-11-170321,170321,0,0,0,137,6.0,286.5689236952388,2
2020-11-12-170321,170321,1,0,0,138,5.0,311.0350433906809,3
2020-11-13-170321,170321,0,1,0,138,9.0,320.6662519067522,4
2020-03-01-170322,170322,0,0,2,0,0.0,0.0,6
2020-03-02-170322,170322,0,0,10,0,0.0,131.35495331501443,0
2020-03-03-170322,170322,0,0,13,0,0.0,517.6373834053683,1
2020-03-04-170322,170322,0,1,11,0,0.0,567.146015446099,2
2020-03-05-170322,170322,0,0,7,0,0.0,616.7688571117368,3
2020-03-06-170322,170322,0,0,12,0,0.0,540.3517028478464,4
2020-03-07-170322,170322,0,0,7,0,0.0,565.4907351059401,5
2020-03-08-170322,170322,0,0,10,0,0.125,585.154611067721,6
2020-03-09-170322,170322,0,0,29,0,0.25,577.3324003704338,0
2020-03-10-170322,170322,0,0,16,0,0.25,897.3019776435301,1
2020-03-11-170322,170322,0,0,12,0,0.125,807.1186937825901,2
2020-03-12-170322,170322,0,0,10,0,0.375,557.9969736954797,3
2020-03-13-170322,170322,0,0,27,0,0.625,361.0892567541712,4
2020-03-14-170322,170322,4,0,9,4,0.875,278.82595753881003,5
2020-03-15-170322,170322,2,0,2,6,1.375,261.5035575716687,6
2020-03-16-170322,170322,10,0,22,16,6.125,86.69174130534603,0
2020-03-17-170322,170322,13,0,14,29,14.25,227.42580149770023,1
2020-03-18-170322,170322,11,0,14,40,13.375,437.2582751764968,2
2020-03-19-170322,170322,7,0,11,47,15.5,612.2258946202273,3
2020-03-20-170322,170322,12,0,12,59,11.375,749.8638368695074,4
2020-03-21-170322,170322,7,0,6,66,4.25,854.6099244375158,5
2020-03-22-170322,170322,10,1,1,76,4.375,873.6332414410858,6
2020-03-23-170322,170322,29,0,9,105,18.125,840.7110294191652,0
2020-03-24-170322,170322,16,0,9,121,17.0,988.7488030553276,1
2020-03-25-170322,170322,12,0,45,133,15.875,1065.1432232542297,2
2020-03-26-170322,170322,10,0,8,143,13.75,1102.15578587187,3
2020-03-27-170322,170322,27,0,10,170,13.0,1254.5415075894048,4
2020-03-28-170322,170322,9,0,2,179,3.625,1319.217457538922,5
2020-03-29-170322,170322,2,0,5,181,3.125,1303.322430387398,6
2020-03-30-170322,170322,22,0,3,203,11.25,925.469335041166,0
2020-03-31-170322,170322,14,0,6,217,11.625,908.9795424135402,1
2020-04-01-170322,170322,14,0,5,231,8.0,164.91520586917204,2
2020-04-02-170322,170322,11,0,10,242,6.875,391.75838481679546,3
2020-04-03-170322,170322,12,0,4,254,7.0,228.5915701767015,4
2020-04-04-170322,170322,6,0,0,260,1.75,252.48907532538428,5
2020-04-05-170322,170322,1,0,2,261,1.375,279.0345379239861,6
2020-04-06-170322,170322,9,0,20,270,8.75,291.6869780555745,0
2020-04-07-170322,170322,9,0,38,279,6.25,354.7109827262193,1
2020-04-08-170322,170322,45,0,2,324,5.5,405.4893633529297,2
2020-04-09-170322,170322,8,0,0,332,5.375,642.331513190229,3
2020-04-10-170322,170322,10,0,3,342,9.0,116.70792165887045,4
2020-04-11-170322,170322,2,0,1,344,2.375,256.8649397403482,5
2020-04-12-170322,170322,5,1,0,349,4.625,280.9634937294503,6
2020-04-13-170322,170322,3,0,4,352,10.0,342.62624724176874,0
2020-04-14-170322,170322,6,0,4,358,7.125,426.18473655807065,1
2020-04-15-170322,170322,5,0,1,363,7.125,501.67740048396485,2
2020-04-16-170322,170322,10,0,0,373,5.5,558.3862203970693,3
2020-04-17-170322,170322,4,0,0,377,5.125,548.8668635125061,4
2020-04-18-170322,170322,0,0,2,377,1.0,483.6682568338668,5
2020-04-19-170322,170322,2,0,0,379,2.5,455.4970046028561,6
2020-04-20-170322,170322,20,0,2,399,4.375,429.38812351527434,0
2020-04-21-170322,170322,38,1,1,437,5.875,483.33000714840983,1
2020-04-22-170322,170322,2,0,3,439,3.0,633.1013282486872,2
2020-04-23-170322,170322,0,0,0,439,0.625,585.4370635536518,3
2020-04-24-170322,170322,3,0,8,442,10.625,515.9545857215664,4
2020-04-25-170322,170322,1,0,1,443,1.625,616.6828007125257,5
2020-04-26-170322,170322,0,0,0,443,0.75,634.8205059615138,6
2020-04-27-170322,170322,4,0,0,447,2.75,526.3338437916792,0
2020-04-28-170322,170322,4,0,0,451,3.375,428.8685234348162,1
2020-04-29-170322,170322,1,0,1,452,2.125,256.53699158367715,2
2020-04-30-170322,170322,0,0,2,452,3.75,355.13802719030775,3
2020-05-01-170322,170322,0,0,3,452,0.5,685.9313730783913,4
2020-05-02-170322,170322,2,0,0,454,1.0,202.7532684909976,5
2020-05-03-170322,170322,0,0,0,454,0.75,134.07364546777046,6
2020-05-04-170322,170322,2,0,2,456,3.875,130.5036170203345,0
2020-05-05-170322,170322,1,0,7,457,3.625,137.17314100893958,1
2020-05-06-170322,170322,3,0,2,460,2.875,155.84365439290877,2
2020-05-07-170322,170322,0,0,1,460,2.375,164.56136395304355,3
2020-05-08-170322,170322,8,0,4,468,2.125,165.63151555109494,4
2020-05-09-170322,170322,1,1,0,469,0.5,232.2370998664567,5
2020-05-10-170322,170322,0,1,0,469,0.375,744.0186065478586,6
2020-05-11-170322,170322,0,0,0,469,2.625,694.4631632760024,0
2020-05-12-170322,170322,0,0,3,469,2.75,690.7584186648222,1
2020-05-13-170322,170322,1,0,0,470,4.25,595.4591481468436,2
2020-05-14-170322,170322,2,1,1,472,3.25,532.4688564456459,3
2020-05-15-170322,170322,3,0,1,475,2.375,267.91488868162475,4
2020-05-16-170322,170322,0,2,0,475,0.375,190.7304252036576,5
2020-05-17-170322,170322,0,0,0,475,0.375,188.5519174192504,6
2020-05-18-170322,170322,2,0,0,477,2.625,192.94334776608264,0
2020-05-19-170322,170322,7,0,0,484,2.375,200.05736662628746,1
2020-05-20-170322,170322,2,0,1,486,2.25,207.6757089107707,2
2020-05-21-170322,170322,1,0,0,487,2.25,202.90911565906237,3
2020-05-22-170322,170322,4,0,1,491,1.625,223.67781026335086,4
2020-05-23-170322,170322,0,0,0,491,0.5,266.50525770249624,5
2020-05-24-170322,170322,0,0,0,491,0.25,265.539611634723,6
2020-05-25-170322,170322,0,0,0,491,2.375,232.38086867491046,0
2020-05-26-170322,170322,3,0,4,494,1.25,184.93990035287266,1
2020-05-27-170322,170322,0,0,0,494,1.5,208.13850954376818,2
2020-05-28-170322,170322,1,0,3,495,2.5,204.7917258405214,3
2020-05-29-170322,170322,1,0,1,496,2.375,193.874305711388,4
2020-05-30-170322,170322,0,0,1,496,0.375,190.80203389599887,5
2020-05-31-170322,170322,0,0,0,496,0.375,197.28309193119298,6
2020-06-01-170322,170322,0,0,0,496,3.0,298.6615797283873,0
2020-06-02-170322,170322,0,0,1,496,3.125,88.21406874039317,1
2020-06-03-170322,170322,1,0,0,497,2.125,82.7800512742218,2
2020-06-04-170322,170322,0,0,1,497,3.375,112.24478742390932,3
2020-06-05-170322,170322,1,0,0,498,1.375,123.98602101513069,4
2020-06-06-170322,170322,0,0,0,498,0.375,149.96381019493347,5
2020-06-07-170322,170322,0,0,0,498,0.375,149.04466670206102,6
2020-06-08-170322,170322,0,0,0,498,1.625,151.71880000317844,0
2020-06-09-170322,170322,4,0,0,502,1.375,162.07230997521842,1
2020-06-10-170322,170322,0,0,0,502,3.625,333.2258074591698,2
2020-06-11-170322,170322,3,0,3,505,2.0,322.19564019566064,3
2020-06-12-170322,170322,1,0,0,506,2.125,305.17595351771905,4
2020-06-13-170322,170322,1,0,1,507,0.25,278.644662086032,5
2020-06-14-170322,170322,0,1,0,507,0.125,252.86145491497865,6
2020-06-15-170322,170322,0,1,0,507,1.375,175.66531956518924,0
2020-06-16-170322,170322,1,0,2,508,1.375,180.74744074744666,1
2020-06-17-170322,170322,0,0,0,508,1.0,165.173339695987,2
2020-06-18-170322,170322,1,1,1,509,0.75,137.2870725690472,3
2020-06-19-170322,170322,0,0,0,509,0.75,107.98219453006536,4
2020-06-20-170322,170322,0,1,0,509,0.0,111.0945566814068,5
2020-06-21-170322,170322,0,0,0,509,0.0,112.20821771977643,6
2020-06-22-170322,170322,0,0,0,509,0.875,96.4836837741308,0
2020-06-23-170322,170322,0,0,1,509,1.5,85.75580203334874,1
2020-06-24-170322,170322,0,0,1,509,0.875,86.77473589146832,2
2020-06-25-170322,170322,3,0,0,512,1.25,84.27152066341361,3
2020-06-26-170322,170322,0,0,0,512,0.625,112.58704851447011,4
2020-06-27-170322,170322,1,0,0,513,0.0,86.7147034014719,5
2020-06-28-170322,170322,0,0,1,513,0.0,96.89480651234533,6
2020-06-29-170322,170322,0,0,2,513,0.5,96.62275189415723,0
2020-06-30-170322,170322,2,0,0,515,0.5,112.99650938775159,1
2020-07-01-170322,170322,0,0,2,515,0.25,214.44816018333077,2
2020-07-02-170322,170322,1,0,1,516,0.375,75.13113724855161,3
2020-07-03-170322,170322,0,0,0,516,0.875,93.30861158877511,4
2020-07-04-170322,170322,0,0,1,516,0.0,109.80504125688618,5
2020-07-05-170322,170322,0,0,1,516,0.25,101.17438778932201,6
2020-07-06-170322,170322,0,0,2,516,1.125,90.4958358491584,0
2020-07-07-170322,170322,1,0,1,517,0.375,82.17598025402674,1
2020-07-08-170322,170322,1,0,2,518,0.5,86.34322787366733,2
2020-07-09-170322,170322,0,0,2,518,0.875,93.72938118300104,3
2020-07-10-170322,170322,0,0,3,518,0.625,189.55021566393302,4
2020-07-11-170322,170322,0,0,0,518,0.25,142.22547689769414,5
2020-07-12-170322,170322,1,0,1,519,0.0,107.83210145966382,6
2020-07-13-170322,170322,2,0,1,521,0.625,109.61514377420187,0
2020-07-14-170322,170322,0,0,2,521,0.5,137.89871556603077,1
2020-07-15-170322,170322,2,0,1,523,0.5,117.48035316088173,2
2020-07-16-170322,170322,1,0,4,524,0.5,57.281618346347344,3
2020-07-17-170322,170322,0,0,1,524,0.375,59.908660711352375,4
2020-07-18-170322,170322,1,0,0,525,0.25,60.61570425556522,5
2020-07-19-170322,170322,1,1,0,526,0.0,76.75264638039668,6
2020-07-20-170322,170322,2,0,0,528,0.75,61.70593077226318,0
2020-07-21-170322,170322,1,0,2,529,0.125,83.80095884514792,1
2020-07-22-170322,170322,2,1,1,531,0.75,92.42230845924558,2
2020-07-23-170322,170322,2,0,2,533,0.25,112.99269129401277,3
2020-07-24-170322,170322,3,1,0,536,0.5,130.44442250393973,4
2020-07-25-170322,170322,0,0,0,536,0.0,137.22205322476177,5
2020-07-26-170322,170322,1,0,0,537,0.0,127.7005309451356,6
2020-07-27-170322,170322,1,0,1,538,0.375,120.011477008477,0
2020-07-28-170322,170322,2,0,0,540,0.75,108.70715950556456,1
2020-07-29-170322,170322,1,0,1,541,0.625,119.39356374107885,2
2020-07-30-170322,170322,4,0,1,545,0.25,85.03757157353559,3
2020-07-31-170322,170322,1,0,1,546,0.625,104.65642316914496,4
2020-08-01-170322,170322,0,0,0,546,0.125,68.8213300555895,5
2020-08-02-170322,170322,0,0,2,546,0.125,167.6143291682535,6
2020-08-03-170322,170322,0,0,0,546,0.625,469.8899469039343,0
2020-08-04-170322,170322,2,0,2,548,1.0,530.9330956332019,1
2020-08-05-170322,170322,1,0,2,549,0.75,478.022802586667,2
2020-08-06-170322,170322,2,0,6,551,1.25,380.10738523720966,3
2020-08-07-170322,170322,0,0,7,551,2.0,318.0641476160598,4
2020-08-08-170322,170322,0,0,0,551,0.25,304.66307404930126,5
2020-08-09-170322,170322,0,0,4,551,0.0,308.6379480633333,6
2020-08-10-170322,170322,1,0,3,552,0.5,64.76496339463706,0
2020-08-11-170322,170322,0,0,6,552,0.625,78.84040989261922,1
2020-08-12-170322,170322,1,0,1,553,1.0,88.01363172906271,2
2020-08-13-170322,170322,1,0,10,554,0.25,89.97831058019553,3
2020-08-14-170322,170322,1,0,2,555,0.625,88.88257453355936,4
2020-08-15-170322,170322,0,0,0,555,1.0,92.89407973225727,5
2020-08-16-170322,170322,2,0,4,557,0.25,102.64881025695465,6
2020-08-17-170322,170322,0,0,7,557,0.5,119.52712385847728,0
2020-08-18-170322,170322,2,0,2,559,1.375,110.72363687293199,1
2020-08-19-170322,170322,2,0,2,561,1.375,147.99583403470217,2
2020-08-20-170322,170322,6,0,8,567,1.375,168.67338145417608,3
2020-08-21-170322,170322,7,0,4,574,0.625,194.6848270350759,4
2020-08-22-170322,170322,0,0,3,574,0.25,210.77213486022265,5
2020-08-23-170322,170322,4,0,2,578,0.875,193.83357774404433,6
2020-08-24-170322,170322,3,0,7,581,0.625,217.43648302521225,0
2020-08-25-170322,170322,6,0,2,587,2.375,201.78737927600625,1
2020-08-26-170322,170322,1,0,7,588,4.0,237.05853031840027,2
2020-08-27-170322,170322,10,0,1,598,2.875,316.8121731786041,3
2020-08-28-170322,170322,2,0,1,600,3.125,389.5758321606395,4
2020-08-29-170322,170322,0,0,1,600,1.875,449.2232720307453,5
2020-08-30-170322,170322,4,0,6,604,3.875,440.3805551145499,6
2020-08-31-170322,170322,7,0,2,611,2.0,500.31375302247,0
2020-09-01-170322,170322,2,1,10,613,2.625,195.08304548341047,1
2020-09-02-170322,170322,2,0,10,615,2.25,577.4351439367088,2
2020-09-03-170322,170322,8,0,15,623,2.375,673.6985700398767,3
2020-09-04-170322,170322,4,0,7,627,2.25,650.9312020738482,4
2020-09-05-170322,170322,3,0,3,630,1.0,558.609939086439,5
2020-09-06-170322,170322,2,0,1,632,2.625,510.5263745264029,6
2020-09-07-170322,170322,7,0,11,639,2.75,530.4748131116605,0
2020-09-08-170322,170322,2,0,6,641,2.375,493.19648551490684,1
2020-09-09-170322,170322,7,0,11,648,8.25,427.3263268439789,2
2020-09-10-170322,170322,1,0,3,649,5.0,151.53895252030009,3
2020-09-11-170322,170322,1,0,14,650,5.375,183.00002569621523,4
2020-09-12-170322,170322,1,0,2,651,2.0,245.19954373477717,5
2020-09-13-170322,170322,6,0,0,657,3.25,236.32131218843574,6
2020-09-14-170322,170322,2,0,8,659,4.625,300.00223309493526,0
2020-09-15-170322,170322,10,0,9,669,5.75,359.0767762129416,1
2020-09-16-170322,170322,10,0,2,679,3.75,467.47580271823017,2
2020-09-17-170322,170322,15,0,29,694,3.5,494.1952473737855,3
2020-09-18-170322,170322,7,0,15,701,3.0,531.8512435933281,4
2020-09-19-170322,170322,3,0,1,704,2.625,503.1609964099168,5
2020-09-20-170322,170322,1,1,0,705,2.875,464.015841205298,6
2020-09-21-170322,170322,11,1,6,716,5.625,422.6419072358075,0
2020-09-22-170322,170322,6,1,4,722,4.375,402.1633082872074,1
2020-09-23-170322,170322,11,2,3,733,5.0,429.1575636004035,2
2020-09-24-170322,170322,3,1,9,736,5.875,426.7207765372616,3
2020-09-25-170322,170322,14,1,6,750,4.5,455.3527984415259,4
2020-09-26-170322,170322,2,0,1,752,3.375,554.7349163626604,5
2020-09-27-170322,170322,0,0,1,752,1.375,573.9129659625439,6
2020-09-28-170322,170322,8,0,0,760,6.0,559.468172989273,0
2020-09-29-170322,170322,9,0,13,769,4.25,584.2510613546526,1
2020-09-30-170322,170322,2,0,20,771,7.625,560.8167922503386,2
2020-10-01-170322,170322,29,0,12,800,10.25,0.0,3
2020-10-02-170322,170322,15,0,12,815,6.875,993.4375529841326,4
2020-10-03-170322,170322,1,0,1,816,2.375,959.3368981223671,5
2020-10-04-170322,170322,0,1,2,816,3.25,921.37897586104,6
2020-10-05-170322,170322,6,1,21,822,3.0,791.3771415015385,0
2020-10-06-170322,170322,4,1,8,826,9.25,740.5752956401569,1
2020-10-07-170322,170322,3,1,11,829,5.5,693.4151069147326,2
2020-10-08-170322,170322,9,0,9,838,8.125,508.3912154491884,3
2020-10-09-170322,170322,6,0,9,844,13.125,579.3493290549588,4
2020-10-10-170322,170322,1,0,8,845,2.375,257.5306342832861,5
2020-10-11-170322,170322,1,0,4,846,2.75,286.9591198799541,6
2020-10-12-170322,170322,0,0,9,846,3.875,330.9833514779093,0
2020-10-13-170322,170322,13,0,7,859,14.0,359.54360424683296,1
2020-10-14-170322,170322,20,0,10,879,8.75,533.1380141946124,2
2020-10-15-170322,170322,12,0,26,891,12.25,703.168385051773,3
2020-10-16-170322,170322,12,0,10,903,12.875,832.0499653791214,4
2020-10-17-170322,170322,1,0,5,904,4.375,747.3893397872021,5
2020-10-18-170322,170322,2,1,3,906,4.0,775.3986320557315,6
2020-10-19-170322,170322,21,0,6,927,8.25,772.1174898153514,0
2020-10-20-170322,170322,8,0,17,935,8.375,923.4060241190397,1
2020-10-21-170322,170322,11,1,5,946,9.625,867.1500626997317,2
2020-10-22-170322,170322,9,0,22,955,8.75,865.1435498162704,3
2020-10-23-170322,170322,9,1,14,964,10.0,828.4127321097526,4
2020-10-24-170322,170322,8,1,6,972,3.75,917.2307167962531,5
2020-10-25-170322,170322,4,3,4,976,2.875,946.0285496840936,6
2020-10-26-170322,170322,9,1,13,985,8.875,788.7054150369922,0
2020-10-27-170322,170322,7,0,9,992,7.375,793.2634591077775,1
2020-10-28-170322,170322,10,1,8,1002,7.125,798.9655683220748,2
2020-10-29-170322,170322,26,0,11,1028,11.875,795.0689002426334,3
2020-10-30-170322,170322,10,1,28,1038,8.75,793.0542473396283,4
2020-10-31-170322,170322,5,0,0,1043,5.0,858.8001680669151,5
2020-11-01-170322,170322,3,0,0,1046,5.75,558.9266668968974,6
2020-11-02-170322,170322,6,2,0,1052,2.25,781.3161766366532,0
2020-11-03-170322,170322,17,0,0,1069,11.375,715.7579351249539,1
2020-11-04-170322,170322,5,1,0,1074,5.625,891.8394541830764,2
2020-11-05-170322,170322,22,2,0,1096,9.625,819.8930604117689,3
2020-11-06-170322,170322,14,1,0,1110,11.625,975.564160067428,4
2020-11-07-170322,170322,6,0,0,1116,4.25,1036.9340401078832,5
2020-11-08-170322,170322,4,0,0,1120,3.375,977.1054355058072,6
2020-11-09-170322,170322,13,0,0,1133,14.25,913.2959905095495,0
2020-11-10-170322,170322,9,0,0,1142,7.75,500.4801675194214,1
2020-11-11-170322,170322,8,1,0,1150,6.625,601.9632124153782,2
2020-11-12-170322,170322,11,0,0,1161,7.0,654.9782701536328,3
2020-11-13-170322,170322,28,0,0,1189,7.375,661.9409382291782,4
2020-03-01-170323,170323,0,0,0,0,0.0,0.0,6
2020-03-02-170323,170323,0,0,4,0,0.0,12.847482797882106,0
2020-03-03-170323,170323,0,0,1,0,0.0,50.184025321426134,1
2020-03-04-170323,170323,0,0,2,0,0.0,47.71940376565838,2
2020-03-05-170323,170323,0,0,0,0,0.0,53.23430223735491,3
2020-03-06-170323,170323,0,0,1,0,0.0,44.55232413774068,4
2020-03-07-170323,170323,0,0,0,0,0.0,45.631703586981814,5
2020-03-08-170323,170323,0,0,0,0,0.0,46.85650374887167,6
2020-03-09-170323,170323,0,0,4,0,0.125,47.32876863376909,0
2020-03-10-170323,170323,0,0,2,0,0.0,227.59263885109078,1
2020-03-11-170323,170323,0,0,3,0,0.125,192.3304670041096,2
2020-03-12-170323,170323,0,1,1,0,0.125,155.7144232046232,3
2020-03-13-170323,170323,0,0,1,0,0.125,116.04114647861692,4
2020-03-14-170323,170323,0,0,0,0,0.125,97.9390362292322,5
2020-03-15-170323,170323,0,0,1,0,0.875,80.58425727619343,6
2020-03-16-170323,170323,4,0,1,4,1.0,9.335764401060821,0
2020-03-17-170323,170323,1,1,2,5,1.0,29.720724548111114,1
2020-03-18-170323,170323,2,0,1,7,1.0,44.695243356275746,2
2020-03-19-170323,170323,0,2,0,7,2.75,59.23513449946818,3
2020-03-20-170323,170323,1,2,2,8,3.5,80.86475684967763,4
2020-03-21-170323,170323,0,0,1,8,1.5,103.2328409707064,5
2020-03-22-170323,170323,0,0,0,8,1.0,101.76014916074173,6
2020-03-23-170323,170323,4,1,1,12,3.5,90.16551958853483,0
2020-03-24-170323,170323,2,0,0,14,2.125,104.05566837857252,1
2020-03-25-170323,170323,3,0,3,17,2.0,109.90913385922936,2
2020-03-26-170323,170323,1,0,0,18,1.625,111.08280749447837,3
2020-03-27-170323,170323,1,0,1,19,2.5,123.11198126154046,4
2020-03-28-170323,170323,0,0,1,19,0.75,114.89355694082222,5
2020-03-29-170323,170323,1,0,1,20,0.5,114.02306816049699,6
2020-03-30-170323,170323,1,0,1,21,1.625,85.98225043278046,0
2020-03-31-170323,170323,2,0,2,23,1.0,76.78599212710775,1
2020-04-01-170323,170323,1,0,2,24,2.0,12.435617470789593,2
2020-04-02-170323,170323,0,0,1,24,0.75,59.968505845088345,3
2020-04-03-170323,170323,2,0,0,26,1.25,30.405800885385915,4
2020-04-04-170323,170323,1,0,0,27,0.625,35.56293713005887,5
2020-04-05-170323,170323,0,0,0,27,0.75,38.70971779266044,6
2020-04-06-170323,170323,1,0,2,28,1.375,38.54752983625743,0
2020-04-07-170323,170323,0,0,1,28,1.625,47.318212685038205,1
2020-04-08-170323,170323,3,1,1,31,1.25,52.768628386881105,2
2020-04-09-170323,170323,0,0,0,31,0.5,59.628402947637895,3
2020-04-10-170323,170323,1,0,0,32,4.125,15.614169036613086,4
2020-04-11-170323,170323,1,0,1,33,0.75,27.714606204962923,5
2020-04-12-170323,170323,1,0,1,34,0.25,29.832390874960552,6
2020-04-13-170323,170323,1,0,0,35,1.875,32.061838289570446,0
2020-04-14-170323,170323,2,0,1,37,1.375,45.52754920112865,1
2020-04-15-170323,170323,2,0,1,39,1.0,62.2802550503047,2
2020-04-16-170323,170323,1,0,0,40,0.75,71.98398272926238,3
2020-04-17-170323,170323,0,0,0,40,0.5,69.3298926960559,4
2020-04-18-170323,170323,0,0,0,40,0.25,65.0647327331647,5
2020-04-19-170323,170323,0,0,0,40,0.125,63.29231707406092,6
2020-04-20-170323,170323,2,0,0,42,0.375,54.862782878764314,0
2020-04-21-170323,170323,1,0,0,43,0.5,43.52165780588969,1
2020-04-22-170323,170323,1,0,1,44,0.625,38.891830044873146,2
2020-04-23-170323,170323,0,0,2,44,0.125,38.27776077538428,3
2020-04-24-170323,170323,0,0,1,44,1.25,31.197279220294888,4
2020-04-25-170323,170323,1,0,1,45,0.75,39.338115988989216,5
2020-04-26-170323,170323,1,0,0,46,0.5,43.90186981538528,6
2020-04-27-170323,170323,0,0,0,46,0.25,39.399395534450754,0
2020-04-28-170323,170323,1,0,1,47,1.5,35.76286119936137,1
2020-04-29-170323,170323,1,0,0,48,0.625,38.12351950209171,2
2020-04-30-170323,170323,0,0,0,48,0.25,48.149345697266696,3
2020-05-01-170323,170323,0,0,0,48,0.125,65.08870805175081,4
2020-05-02-170323,170323,0,0,0,48,0.125,27.419695213530858,5
2020-05-03-170323,170323,0,0,0,48,0.0,22.42745383091531,6
2020-05-04-170323,170323,0,0,0,48,0.875,19.102451111965046,0
2020-05-05-170323,170323,0,0,0,48,0.375,20.413571531958755,1
2020-05-06-170323,170323,1,0,0,49,0.625,20.498564460675915,2
2020-05-07-170323,170323,2,0,0,51,1.125,24.38636744867813,3
2020-05-08-170323,170323,1,0,0,52,0.5,30.27106060836289,4
2020-05-09-170323,170323,1,0,1,53,0.0,37.35243777071314,5
2020-05-10-170323,170323,0,3,0,53,0.5,64.17298001889814,6
2020-05-11-170323,170323,0,5,0,53,0.375,59.517458476262476,0
2020-05-12-170323,170323,1,1,0,54,0.25,59.47176613484346,1
2020-05-13-170323,170323,0,0,1,54,1.5,46.243728216177495,2
2020-05-14-170323,170323,0,0,0,54,1.0,38.65002142388496,3
2020-05-15-170323,170323,0,0,0,54,0.125,33.179013844933195,4
2020-05-16-170323,170323,0,1,0,54,0.25,27.05639987983761,5
2020-05-17-170323,170323,0,0,0,54,0.0,28.355883507869805,6
2020-05-18-170323,170323,0,0,2,54,0.75,27.0822290960444,0
2020-05-19-170323,170323,0,0,0,54,0.25,28.637159478197354,1
2020-05-20-170323,170323,0,0,0,54,0.625,26.964756129151976,2
2020-05-21-170323,170323,0,0,0,54,0.625,21.173120262084545,3
2020-05-22-170323,170323,0,0,0,54,0.375,23.861523870319957,4
2020-05-23-170323,170323,1,1,0,55,0.25,25.881122915810362,5
2020-05-24-170323,170323,0,0,0,55,0.0,27.92079102573254,6
2020-05-25-170323,170323,0,0,0,55,0.75,24.609028124631713,0
2020-05-26-170323,170323,0,0,0,55,1.0,26.067811994023746,1
2020-05-27-170323,170323,1,0,1,56,0.125,29.666211361757853,2
2020-05-28-170323,170323,0,0,0,56,0.375,33.65415408364125,3
2020-05-29-170323,170323,0,0,0,56,1.25,31.705629884740517,4
2020-05-30-170323,170323,0,0,0,56,0.0,31.280396293548105,5
2020-05-31-170323,170323,0,0,0,56,0.375,32.950260740014556,6
2020-06-01-170323,170323,2,0,0,58,0.125,52.43165457481579,0
2020-06-02-170323,170323,0,0,0,58,0.75,14.67359227355978,1
2020-06-03-170323,170323,0,0,0,58,0.25,13.474774321311035,2
2020-06-04-170323,170323,0,0,0,58,0.375,10.891786903690289,3
2020-06-05-170323,170323,0,0,0,58,0.5,10.74974395412376,4
2020-06-06-170323,170323,0,0,0,58,0.0,16.04059818946545,5
2020-06-07-170323,170323,0,0,0,58,0.0,16.17349440679626,6
2020-06-08-170323,170323,0,0,0,58,0.375,16.184819511790337,0
2020-06-09-170323,170323,0,0,1,58,0.875,23.24790413771887,1
2020-06-10-170323,170323,1,0,0,59,2.375,54.613713657016646,2
2020-06-11-170323,170323,0,0,0,59,0.5,59.83755789553733,3
2020-06-12-170323,170323,0,0,0,59,0.25,56.47308001550994,4
2020-06-13-170323,170323,0,0,0,59,0.25,48.08033766783055,5
2020-06-14-170323,170323,0,1,0,59,0.125,37.53158237525639,6
2020-06-15-170323,170323,0,0,0,59,0.5,30.107920628653304,0
2020-06-16-170323,170323,0,0,0,59,0.125,31.32320947251155,1
2020-06-17-170323,170323,0,0,0,59,0.25,26.444260509253777,2
2020-06-18-170323,170323,0,0,0,59,0.625,17.765423519757253,3
2020-06-19-170323,170323,0,1,1,59,0.0,16.730235254702876,4
2020-06-20-170323,170323,0,0,0,59,0.125,20.489066770912885,5
2020-06-21-170323,170323,0,0,0,59,0.0,20.414813122071017,6
2020-06-22-170323,170323,0,0,0,59,0.375,16.847327465549608,0
2020-06-23-170323,170323,1,0,0,60,0.5,18.22704880868937,1
2020-06-24-170323,170323,0,0,0,60,0.0,20.194060644292165,2
2020-06-25-170323,170323,0,0,0,60,0.375,19.323139666957612,3
2020-06-26-170323,170323,0,1,1,60,0.375,21.327077580335192,4
2020-06-27-170323,170323,0,0,0,60,0.0,16.9031425423309,5
2020-06-28-170323,170323,0,0,0,60,0.0,17.245336704454076,6
2020-06-29-170323,170323,0,0,0,60,0.125,17.233863832312288,0
2020-06-30-170323,170323,0,0,0,60,0.375,14.198842786769436,1
2020-07-01-170323,170323,0,0,0,60,0.125,32.124714759824705,2
2020-07-02-170323,170323,0,0,0,60,0.5,14.35916032024095,3
2020-07-03-170323,170323,1,0,0,61,0.125,12.37712588255306,4
2020-07-04-170323,170323,0,0,0,61,0.0,14.071194059968775,5
2020-07-05-170323,170323,0,0,0,61,0.0,14.029566036790897,6
2020-07-06-170323,170323,0,0,0,61,0.875,12.471682248771655,0
2020-07-07-170323,170323,0,1,0,61,0.0,11.21813026062353,1
2020-07-08-170323,170323,0,0,0,61,0.0,11.852240200678963,2
2020-07-09-170323,170323,0,2,0,61,0.125,9.788602471269812,3
2020-07-10-170323,170323,1,0,0,62,0.125,34.28169654895417,4
2020-07-11-170323,170323,0,0,0,62,0.25,33.98528979632532,5
2020-07-12-170323,170323,0,0,0,62,0.0,26.286233518988855,6
2020-07-13-170323,170323,0,0,0,62,0.125,26.923053079103983,0
2020-07-14-170323,170323,0,0,0,62,0.0,27.731004231044096,1
2020-07-15-170323,170323,0,0,0,62,0.375,18.64480567450018,2
2020-07-16-170323,170323,0,0,0,62,0.375,11.450655630397122,3
2020-07-17-170323,170323,0,0,1,62,0.375,13.66247987973319,4
2020-07-18-170323,170323,0,0,0,62,0.25,13.928870944866631,5
2020-07-19-170323,170323,0,0,0,62,0.125,15.284717575792591,6
2020-07-20-170323,170323,0,0,0,62,0.125,17.87049412372917,0
2020-07-21-170323,170323,0,0,0,62,0.375,18.014839173442184,1
2020-07-22-170323,170323,0,0,0,62,0.125,22.555091663307774,2
2020-07-23-170323,170323,0,0,0,62,0.0,20.547031896079517,3
2020-07-24-170323,170323,0,0,0,62,0.125,18.74329020256759,4
2020-07-25-170323,170323,0,0,0,62,0.25,18.02362516860112,5
2020-07-26-170323,170323,0,0,0,62,0.0,16.046824967394034,6
2020-07-27-170323,170323,0,0,1,62,0.375,14.467686036500009,0
2020-07-28-170323,170323,0,0,0,62,0.75,14.691478997465797,1
2020-07-29-170323,170323,0,0,0,62,0.0,13.837970759439902,2
2020-07-30-170323,170323,0,0,0,62,0.5,15.394624950941463,3
2020-07-31-170323,170323,1,0,0,63,0.125,14.786039713722964,4
2020-08-01-170323,170323,0,0,0,63,0.0,11.517414595364837,5
2020-08-02-170323,170323,0,0,0,63,0.125,48.64853289799996,6
2020-08-03-170323,170323,0,0,1,63,0.25,154.8100627848616,0
2020-08-04-170323,170323,0,0,0,63,0.25,116.58064570539275,1
2020-08-05-170323,170323,0,0,2,63,0.125,97.36279861223309,2
2020-08-06-170323,170323,0,0,0,63,0.375,76.58339011171958,3
2020-08-07-170323,170323,0,0,7,63,0.25,67.88515335348231,4
2020-08-08-170323,170323,0,0,0,63,0.0,46.495885239744375,5
2020-08-09-170323,170323,0,0,0,63,0.125,44.08429547938268,6
2020-08-10-170323,170323,1,0,0,64,0.5,11.465757085210768,0
2020-08-11-170323,170323,0,0,4,64,0.625,17.582629754400767,1
2020-08-12-170323,170323,0,0,6,64,0.875,24.04554906045319,2
2020-08-13-170323,170323,0,0,4,64,1.125,25.456312882896054,3
2020-08-14-170323,170323,0,0,3,64,0.125,32.29967103227459,4
2020-08-15-170323,170323,0,0,5,64,0.75,34.303300975878706,5
2020-08-16-170323,170323,0,0,1,64,0.5,36.57760026083809,6
2020-08-17-170323,170323,1,0,3,65,0.625,41.186906393319966,0
2020-08-18-170323,170323,0,0,0,65,0.875,42.19690034725097,1
2020-08-19-170323,170323,2,0,1,67,2.125,39.96873964314817,2
2020-08-20-170323,170323,0,0,0,67,0.875,44.76758617351078,3
2020-08-21-170323,170323,7,0,1,74,3.5,51.12887515279462,4
2020-08-22-170323,170323,0,0,0,74,0.625,86.15018415766656,5
2020-08-23-170323,170323,0,0,0,74,1.0,85.55931834929757,6
2020-08-24-170323,170323,0,0,0,74,1.5,84.97554673121115,0
2020-08-25-170323,170323,4,0,0,78,2.0,107.8454051070033,1
2020-08-26-170323,170323,6,0,2,84,0.5,126.01523545844356,2
2020-08-27-170323,170323,4,0,2,88,2.875,147.97425530830745,3
2020-08-28-170323,170323,3,0,0,91,0.375,161.4413561392284,4
2020-08-29-170323,170323,5,0,0,96,0.5,134.1200352261214,5
2020-08-30-170323,170323,1,0,0,97,0.625,146.22545737524797,6
2020-08-31-170323,170323,3,0,0,100,0.375,123.81854694960785,0
2020-09-01-170323,170323,0,0,0,100,0.875,37.37843197280299,1
2020-09-02-170323,170323,1,0,1,101,0.875,145.14191356433116,2
2020-09-03-170323,170323,0,0,0,101,1.25,216.38820891266283,3
2020-09-04-170323,170323,1,0,0,102,1.625,153.54488489322608,4
2020-09-05-170323,170323,0,0,0,102,1.0,117.18870622654627,5
2020-09-06-170323,170323,0,0,0,102,0.75,124.8906580197923,6
2020-09-07-170323,170323,0,0,0,102,1.75,126.6130993646814,0
2020-09-08-170323,170323,0,0,5,102,1.75,119.33475497098549,1
2020-09-09-170323,170323,2,0,0,104,2.0,111.14430552948734,2
2020-09-10-170323,170323,2,0,0,106,2.25,25.09252421391831,3
2020-09-11-170323,170323,0,0,1,106,0.75,52.985411708000555,4
2020-09-12-170323,170323,0,0,0,106,0.75,80.82095079955175,5
2020-09-13-170323,170323,0,0,0,106,0.125,86.35116632872843,6
2020-09-14-170323,170323,0,0,1,106,3.375,91.29690742779552,0
2020-09-15-170323,170323,0,0,0,106,1.875,117.8996220172966,1
2020-09-16-170323,170323,1,0,0,107,1.875,133.89767423852885,2
2020-09-17-170323,170323,0,0,0,107,1.0,152.28197750830054,3
2020-09-18-170323,170323,0,0,0,107,1.75,148.7371550646631,4
2020-09-19-170323,170323,0,0,0,107,0.25,134.35932548255715,5
2020-09-20-170323,170323,0,1,1,107,1.5,132.52554168661382,6
2020-09-21-170323,170323,0,0,0,107,2.5,109.75139720906799,0
2020-09-22-170323,170323,5,0,0,112,0.75,112.93092713442655,1
2020-09-23-170323,170323,0,1,2,112,2.5,109.13157734996479,2
2020-09-24-170323,170323,0,0,2,112,2.125,105.15358860572351,3
2020-09-25-170323,170323,1,0,1,113,6.0,142.85157280528134,4
2020-09-26-170323,170323,0,0,0,113,2.0,192.59146958940488,5
2020-09-27-170323,170323,0,0,0,113,0.125,189.27640166137402,6
2020-09-28-170323,170323,1,0,3,114,1.375,190.77155358691408,0
2020-09-29-170323,170323,0,0,1,114,2.125,190.93595444230988,1
2020-09-30-170323,170323,0,0,1,114,2.5,167.137150824995,2
2020-10-01-170323,170323,0,0,2,114,2.5,0.0,3
2020-10-02-170323,170323,0,0,0,114,1.75,252.08942513405117,4
2020-10-03-170323,170323,0,0,1,114,1.25,217.25410371737985,5
2020-10-04-170323,170323,1,0,0,115,1.875,199.3358876202742,6
2020-10-05-170323,170323,0,0,1,115,2.875,167.3779208227231,0
2020-10-06-170323,170323,0,0,0,115,1.25,159.0741844517301,1
2020-10-07-170323,170323,2,0,1,117,1.625,153.95896695445256,2
2020-10-08-170323,170323,2,0,2,119,3.5,144.26969027814835,3
2020-10-09-170323,170323,1,1,4,120,2.125,159.88958028599998,4
2020-10-10-170323,170323,0,0,0,120,2.0,30.060551977101476,5
2020-10-11-170323,170323,0,0,0,120,0.5,47.40229293254811,6
2020-10-12-170323,170323,3,0,1,123,1.25,52.242355743779,0
2020-10-13-170323,170323,1,0,1,124,2.125,66.04753751638522,1
2020-10-14-170323,170323,1,0,0,125,1.25,99.53601710772205,2
2020-10-15-170323,170323,2,0,3,127,1.875,131.6898549103393,3
2020-10-16-170323,170323,0,0,3,127,1.5,177.43348635706673,4
2020-10-17-170323,170323,1,0,0,128,2.5,185.95179662318463,5
2020-10-18-170323,170323,0,1,2,128,2.0,188.63800532188287,6
2020-10-19-170323,170323,1,0,1,129,4.75,202.38799931524733,0
2020-10-20-170323,170323,0,0,0,129,2.0,230.851044748284,1
2020-10-21-170323,170323,1,0,2,130,3.75,221.20639900448668,2
2020-10-22-170323,170323,2,1,1,132,4.375,191.24057302130757,3
2020-10-23-170323,170323,4,0,4,136,1.25,199.75329942592003,4
2020-10-24-170323,170323,0,2,0,136,2.625,212.05625679282127,5
2020-10-25-170323,170323,0,0,0,136,1.625,209.00211411571252,6
2020-10-26-170323,170323,1,0,3,137,2.875,176.32435234684945,0
2020-10-27-170323,170323,1,0,3,138,1.25,192.94649253044827,1
2020-10-28-170323,170323,0,0,7,138,4.0,188.42233316396965,2
2020-10-29-170323,170323,3,0,3,141,2.375,194.0825065489368,3
2020-10-30-170323,170323,3,0,1,144,2.125,160.69437627577315,4
2020-10-31-170323,170323,0,0,0,144,1.125,189.165049224675,5
2020-11-01-170323,170323,2,0,0,146,2.375,153.23146209685004,6
2020-11-02-170323,170323,1,0,0,147,1.625,235.62607291570504,0
2020-11-03-170323,170323,0,0,0,147,3.625,210.64884503306567,1
2020-11-04-170323,170323,2,1,0,149,3.0,234.6382448111833,2
2020-11-05-170323,170323,1,0,0,150,3.875,246.31602626614284,3
2020-11-06-170323,170323,4,1,0,154,4.0,228.05911337023792,4
2020-11-07-170323,170323,0,0,0,154,1.125,207.04126864841973,5
2020-11-08-170323,170323,0,0,0,154,1.125,191.65155859178606,6
2020-11-09-170323,170323,3,0,0,157,4.75,186.91189842132394,0
2020-11-10-170323,170323,3,0,0,160,3.375,146.20756067397787,1
2020-11-11-170323,170323,7,0,0,167,1.25,171.36823060796388,2
2020-11-12-170323,170323,3,0,0,170,4.75,189.3134749759015,3
2020-11-13-170323,170323,1,1,0,171,1.125,207.72597216664352,4
2020-03-01-170324,170324,0,0,3,0,0.16666666666666666,0.0,6
2020-03-02-170324,170324,0,0,14,0,0.0,197.1240437039831,0
2020-03-03-170324,170324,0,0,19,0,0.0,753.6685638085635,1
2020-03-04-170324,170324,0,1,15,0,0.0,859.9151123388685,2
2020-03-05-170324,170324,0,0,25,0,0.0,876.0336862071119,3
2020-03-06-170324,170324,0,0,13,0,0.0,758.0928228371814,4
2020-03-07-170324,170324,0,0,3,0,0.0,852.5244581183063,5
2020-03-08-170324,170324,0,0,5,0,0.0,911.1274686798494,6
2020-03-09-170324,170324,0,0,27,0,0.0,907.587406736499,0
2020-03-10-170324,170324,0,0,14,0,0.0,2495.7928640055566,1
2020-03-11-170324,170324,0,0,15,0,0.16666666666666666,2143.971593244778,2
2020-03-12-170324,170324,0,0,14,0,0.16666666666666666,1656.2268926032693,3
2020-03-13-170324,170324,0,0,20,0,0.16666666666666666,1060.7245913810702,4
2020-03-14-170324,170324,0,0,1,0,1.5,964.4905483525472,5
2020-03-15-170324,170324,3,0,2,3,1.0,837.4065993492135,6
2020-03-16-170324,170324,14,0,15,17,7.0,83.47363853776423,0
2020-03-17-170324,170324,19,0,9,36,13.0,330.4257624083559,1
2020-03-18-170324,170324,15,0,11,51,13.333333333333336,653.8588905453219,2
2020-03-19-170324,170324,25,0,6,76,14.333333333333336,943.9018347664363,3
2020-03-20-170324,170324,13,0,6,89,12.833333333333336,1224.9692355835566,4
2020-03-21-170324,170324,3,0,0,92,2.6666666666666665,1387.2521883133861,5
2020-03-22-170324,170324,5,0,2,97,3.8333333333333335,1359.4007735462756,6
2020-03-23-170324,170324,27,0,9,124,19.666666666666668,1221.3197753750323,0
2020-03-24-170324,170324,14,0,12,138,16.0,1348.7755746629891,1
2020-03-25-170324,170324,15,0,8,153,16.0,1361.2638722497525,2
2020-03-26-170324,170324,14,0,8,167,18.666666666666668,1345.31240665118,3
2020-03-27-170324,170324,20,1,0,187,16.333333333333332,1642.2048392611894,4
2020-03-28-170324,170324,1,0,0,188,3.5,1687.681414721425,5
2020-03-29-170324,170324,2,0,2,190,1.1666666666666667,1668.632712529255,6
2020-03-30-170324,170324,15,0,20,205,17.833333333333332,1254.9442247038196,0
2020-03-31-170324,170324,9,0,11,214,14.666666666666664,1282.8135232443412,1
2020-04-01-170324,170324,11,0,9,225,10.333333333333334,205.89583503608014,2
2020-04-02-170324,170324,6,0,7,231,7.666666666666668,867.7890586968734,3
2020-04-03-170324,170324,6,0,7,237,9.5,508.92540970226446,4
2020-04-04-170324,170324,0,0,3,237,2.333333333333333,490.18186231828844,5
2020-04-05-170324,170324,2,0,0,239,1.1666666666666667,477.1478059350032,6
2020-04-06-170324,170324,9,0,5,248,8.666666666666666,492.81207855112757,0
2020-04-07-170324,170324,12,0,7,260,7.0,593.8745499795617,1
2020-04-08-170324,170324,8,0,5,268,12.666666666666664,695.9435247415238,2
2020-04-09-170324,170324,8,0,2,276,8.333333333333334,756.17160542935,3
2020-04-10-170324,170324,0,0,6,276,6.166666666666668,163.31832966941425,4
2020-04-11-170324,170324,0,0,6,276,1.3333333333333333,270.86628641825376,5
2020-04-12-170324,170324,2,0,1,278,1.5,292.832282399651,6
2020-04-13-170324,170324,20,0,6,298,7.0,324.62277917197235,0
2020-04-14-170324,170324,11,0,4,309,5.333333333333333,552.6349017684817,1
2020-04-15-170324,170324,9,0,4,318,6.166666666666668,725.6911536303661,2
2020-04-16-170324,170324,7,0,3,325,5.166666666666667,892.3702293530208,3
2020-04-17-170324,170324,7,0,0,332,5.333333333333333,900.321365376712,4
2020-04-18-170324,170324,3,0,3,335,0.3333333333333333,943.9144016038919,5
2020-04-19-170324,170324,0,0,1,335,1.1666666666666667,935.5304921974598,6
2020-04-20-170324,170324,5,0,2,340,8.666666666666666,812.6389097151012,0
2020-04-21-170324,170324,7,0,2,347,9.333333333333334,786.0812416395815,1
2020-04-22-170324,170324,5,0,4,352,9.166666666666666,711.5586434742855,2
2020-04-23-170324,170324,2,0,5,354,0.16666666666666666,721.0642450716092,3
2020-04-24-170324,170324,6,0,2,360,12.5,590.034574439434,4
2020-04-25-170324,170324,6,0,0,366,0.3333333333333333,792.7310372714244,5
2020-04-26-170324,170324,1,0,0,367,0.5,814.6340559187659,6
2020-04-27-170324,170324,6,0,3,373,4.333333333333333,688.9704371328833,0
2020-04-28-170324,170324,4,2,3,377,3.0,633.5712659522692,1
2020-04-29-170324,170324,4,0,0,381,4.166666666666667,601.8076762105217,2
2020-04-30-170324,170324,3,0,4,384,5.166666666666667,658.1324163340716,3
2020-05-01-170324,170324,0,0,4,384,0.16666666666666666,804.1231836407885,4
2020-05-02-170324,170324,3,0,0,387,0.8333333333333334,344.7990978181017,5
2020-05-03-170324,170324,1,0,1,388,0.6666666666666666,280.9949407962677,6
2020-05-04-170324,170324,2,0,2,390,6.166666666666668,228.62567020332833,0
2020-05-05-170324,170324,2,0,3,392,3.333333333333333,282.30495648168665,1
2020-05-06-170324,170324,4,0,3,396,2.6666666666666665,310.61110987338606,2
2020-05-07-170324,170324,5,0,1,401,2.1666666666666665,313.33501985370714,3
2020-05-08-170324,170324,2,0,7,403,4.5,319.68635745087437,4
2020-05-09-170324,170324,0,1,0,403,0.5,399.02721137938494,5
2020-05-10-170324,170324,0,3,0,403,0.16666666666666666,794.6622501032814,6
2020-05-11-170324,170324,3,2,3,406,3.0,761.7633143568261,0
2020-05-12-170324,170324,3,0,0,409,3.333333333333333,804.8208109615081,1
2020-05-13-170324,170324,0,1,3,409,5.833333333333332,646.6987712472554,2
2020-05-14-170324,170324,4,0,2,413,4.5,543.9565062703416,3
2020-05-15-170324,170324,4,0,3,417,1.8333333333333333,480.2341643884822,4
2020-05-16-170324,170324,0,0,0,417,0.8333333333333334,384.04233116136123,5
2020-05-17-170324,170324,1,0,2,418,0.0,399.70239504579945,6
2020-05-18-170324,170324,2,0,7,420,3.333333333333333,408.7167024581465,0
2020-05-19-170324,170324,3,0,4,423,3.333333333333333,401.0378755506332,1
2020-05-20-170324,170324,3,0,5,426,2.333333333333333,347.26879774485496,2
2020-05-21-170324,170324,1,0,4,427,3.0,305.45769807625885,3
2020-05-22-170324,170324,7,0,2,434,4.333333333333333,326.5585382406233,4
2020-05-23-170324,170324,0,0,0,434,0.5,429.1662282680244,5
2020-05-24-170324,170324,0,0,0,434,0.16666666666666666,435.3468595463245,6
2020-05-25-170324,170324,3,0,3,437,3.5,381.63220218454916,0
2020-05-26-170324,170324,0,0,2,437,2.0,390.7889408772835,1
2020-05-27-170324,170324,3,0,4,440,2.0,408.8016191248292,2
2020-05-28-170324,170324,2,4,5,442,2.5,409.08779236427443,3
2020-05-29-170324,170324,3,1,3,445,2.5,408.31511504663985,4
2020-05-30-170324,170324,0,0,0,445,0.5,362.8001140648713,5
2020-05-31-170324,170324,2,0,1,447,0.3333333333333333,368.1440799628588,6
2020-06-01-170324,170324,7,0,0,454,3.1666666666666665,483.9985551721223,0
2020-06-02-170324,170324,4,0,1,458,2.1666666666666665,173.62135137709262,1
2020-06-03-170324,170324,5,0,0,463,3.5,104.95305563719023,2
2020-06-04-170324,170324,4,0,0,467,3.333333333333333,158.29394719270212,3
2020-06-05-170324,170324,2,0,4,469,3.1666666666666665,219.82306102075793,4
2020-06-06-170324,170324,0,0,0,469,0.16666666666666666,295.26178658725394,5
2020-06-07-170324,170324,0,0,0,469,0.16666666666666666,300.79288511859113,6
2020-06-08-170324,170324,3,0,1,472,3.333333333333333,306.17567297656024,0
2020-06-09-170324,170324,2,0,5,474,3.6666666666666665,380.66322485530566,1
2020-06-10-170324,170324,4,0,1,478,2.0,581.1642565918778,2
2020-06-11-170324,170324,5,0,1,483,2.833333333333333,567.1470384420434,3
2020-06-12-170324,170324,3,0,0,486,1.8333333333333333,556.8646978329303,4
2020-06-13-170324,170324,0,0,0,486,0.8333333333333334,534.0807471646851,5
2020-06-14-170324,170324,1,0,0,487,0.16666666666666666,460.7629855655957,6
2020-06-15-170324,170324,0,0,1,487,1.3333333333333333,377.527212083094,0
2020-06-16-170324,170324,1,0,0,488,1.6666666666666667,392.7638129926977,1
2020-06-17-170324,170324,0,0,1,488,0.6666666666666666,330.0494786138771,2
2020-06-18-170324,170324,0,0,0,488,0.8333333333333334,263.7247144317098,3
2020-06-19-170324,170324,4,0,1,492,0.8333333333333334,202.46726422919764,4
2020-06-20-170324,170324,0,0,0,492,0.0,258.7605333618569,5
2020-06-21-170324,170324,0,0,1,492,0.16666666666666666,249.57587014578834,6
2020-06-22-170324,170324,1,0,1,493,0.5,222.3240094382087,0
2020-06-23-170324,170324,5,0,2,498,0.6666666666666666,195.73600758514672,1
2020-06-24-170324,170324,1,0,0,499,0.3333333333333333,213.0935492182241,2
2020-06-25-170324,170324,1,0,1,500,1.3333333333333333,197.24410205611855,3
2020-06-26-170324,170324,0,1,1,500,1.0,176.4324870396035,4
2020-06-27-170324,170324,0,0,0,500,0.16666666666666666,110.88990802571243,5
2020-06-28-170324,170324,0,0,0,500,0.0,111.62172636172288,6
2020-06-29-170324,170324,1,0,1,501,0.6666666666666666,109.91924664585052,0
2020-06-30-170324,170324,0,0,0,501,0.6666666666666666,166.14055458713293,1
2020-07-01-170324,170324,1,0,1,502,0.3333333333333333,386.845558997776,2
2020-07-02-170324,170324,0,0,0,502,0.3333333333333333,121.27100432372406,3
2020-07-03-170324,170324,1,0,2,503,1.1666666666666667,115.42465940672349,4
2020-07-04-170324,170324,0,0,0,503,0.0,150.5773744623914,5
2020-07-05-170324,170324,1,0,0,504,0.3333333333333333,138.4452051954828,6
2020-07-06-170324,170324,1,0,5,505,1.1666666666666667,125.8674902606208,0
2020-07-07-170324,170324,2,0,1,507,1.1666666666666667,124.21858818907488,1
2020-07-08-170324,170324,0,0,3,507,0.6666666666666666,134.91462924209415,2
2020-07-09-170324,170324,1,1,1,508,0.6666666666666666,120.27986631152712,3
2020-07-10-170324,170324,1,0,1,509,1.0,398.60912283149725,4
2020-07-11-170324,170324,0,0,0,509,0.3333333333333333,341.2278667870012,5
2020-07-12-170324,170324,0,0,0,509,0.16666666666666666,252.24504731028128,6
2020-07-13-170324,170324,1,0,1,510,1.5,247.59262964952666,0
2020-07-14-170324,170324,0,0,2,510,0.6666666666666666,269.4081886988509,1
2020-07-15-170324,170324,1,0,1,511,1.1666666666666667,189.68300700901017,2
2020-07-16-170324,170324,0,0,1,511,0.6666666666666666,110.05059522111057,3
2020-07-17-170324,170324,2,0,1,513,0.6666666666666666,110.50083435779158,4
2020-07-18-170324,170324,0,0,0,513,0.5,117.37391829873445,5
2020-07-19-170324,170324,0,0,0,513,0.5,114.24121866632538,6
2020-07-20-170324,170324,5,0,2,518,0.8333333333333334,96.3857620111188,0
2020-07-21-170324,170324,1,0,1,519,0.6666666666666666,124.89904966525313,1
2020-07-22-170324,170324,3,0,2,522,0.8333333333333334,128.30946140347447,2
2020-07-23-170324,170324,1,0,1,523,0.5,147.82975043119282,3
2020-07-24-170324,170324,1,0,5,524,1.8333333333333333,128.75961907592045,4
2020-07-25-170324,170324,0,0,0,524,0.0,146.00465552856326,5
2020-07-26-170324,170324,0,0,0,524,0.8333333333333334,138.41053859294294,6
2020-07-27-170324,170324,1,0,1,525,0.6666666666666666,145.20510889415988,0
2020-07-28-170324,170324,2,0,1,527,1.0,125.49104685376598,1
2020-07-29-170324,170324,1,1,1,528,1.0,129.9139952993052,2
2020-07-30-170324,170324,1,0,0,529,1.3333333333333333,122.16126393827432,3
2020-07-31-170324,170324,1,0,0,530,1.0,125.0453634830529,4
2020-08-01-170324,170324,0,0,0,530,0.16666666666666666,107.02874066296735,5
2020-08-02-170324,170324,0,0,1,530,0.16666666666666666,223.14478110547788,6
2020-08-03-170324,170324,2,0,3,532,1.5,728.3845207152733,0
2020-08-04-170324,170324,1,0,4,533,1.5,706.0648223436996,1
2020-08-05-170324,170324,2,0,2,535,1.3333333333333333,610.2120491067813,2
2020-08-06-170324,170324,1,0,4,536,0.8333333333333334,527.5997363522789,3
2020-08-07-170324,170324,5,1,1,541,0.8333333333333334,413.99072878856475,4
2020-08-08-170324,170324,0,0,1,541,0.5,341.67939732662535,5
2020-08-09-170324,170324,0,0,5,541,0.0,308.50930681987825,6
2020-08-10-170324,170324,1,0,2,542,1.3333333333333333,89.39593694107246,0
2020-08-11-170324,170324,1,0,2,543,0.6666666666666666,115.85188218478135,1
2020-08-12-170324,170324,1,0,11,544,1.3333333333333333,137.18898602707137,2
2020-08-13-170324,170324,0,0,2,544,1.0,146.6463991344782,3
2020-08-14-170324,170324,0,0,6,544,1.6666666666666667,143.52324822215573,4
2020-08-15-170324,170324,0,0,6,544,0.16666666666666666,154.93448025169448,5
2020-08-16-170324,170324,1,0,6,545,0.5,140.1675212534059,6
2020-08-17-170324,170324,3,0,3,548,1.1666666666666667,150.79202188371377,0
2020-08-18-170324,170324,4,0,4,552,2.0,170.7839619331366,1
2020-08-19-170324,170324,2,0,5,554,2.6666666666666665,183.85035731923494,2
2020-08-20-170324,170324,4,0,7,558,2.0,193.20726572420566,3
2020-08-21-170324,170324,1,0,2,559,3.8333333333333335,217.4366245994187,4
2020-08-22-170324,170324,1,0,3,560,1.0,295.9265223140606,5
2020-08-23-170324,170324,5,0,9,565,1.8333333333333333,322.8774480259468,6
2020-08-24-170324,170324,2,0,5,567,2.0,314.4606602572276,0
2020-08-25-170324,170324,2,0,4,569,6.0,338.8380104014081,1
2020-08-26-170324,170324,11,0,14,580,4.333333333333333,408.44694086451517,2
2020-08-27-170324,170324,2,0,11,582,6.833333333333332,524.1763499989816,3
2020-08-28-170324,170324,6,0,16,588,2.6666666666666665,589.8944087731337,4
2020-08-29-170324,170324,6,0,3,594,3.8333333333333335,625.5873645179253,5
2020-08-30-170324,170324,6,0,7,600,3.8333333333333335,690.9668182877572,6
2020-08-31-170324,170324,3,0,14,603,5.0,692.180053036931,0
2020-09-01-170324,170324,4,0,13,607,2.1666666666666665,246.16755662573075,1
2020-09-02-170324,170324,5,0,11,612,2.6666666666666665,1339.8843662034994,2
2020-09-03-170324,170324,7,0,4,619,3.8333333333333335,1348.4517155738683,3
2020-09-04-170324,170324,2,0,6,621,5.0,1221.8740122965448,4
2020-09-05-170324,170324,3,0,5,624,3.8333333333333335,1128.337696139731,5
2020-09-06-170324,170324,9,0,5,633,2.833333333333333,1142.5198562828896,6
2020-09-07-170324,170324,5,0,12,638,8.166666666666666,1206.382165126604,0
2020-09-08-170324,170324,4,0,9,642,6.833333333333332,1040.9977859206301,1
2020-09-09-170324,170324,14,0,17,656,7.5,1027.1780080938804,2
2020-09-10-170324,170324,11,0,20,667,6.833333333333332,213.24047159214217,3
2020-09-11-170324,170324,16,0,10,683,8.0,446.07429558005816,4
2020-09-12-170324,170324,3,0,3,686,2.5,741.6591881543363,5
2020-09-13-170324,170324,7,0,4,693,8.5,798.9781910528461,6
2020-09-14-170324,170324,14,0,17,707,7.666666666666668,920.9562795354327,0
2020-09-15-170324,170324,13,0,8,720,8.0,1173.3306375394075,1
2020-09-16-170324,170324,11,0,12,731,9.833333333333334,1349.5832777553346,2
2020-09-17-170324,170324,4,0,27,735,12.0,1540.573370656868,3
2020-09-18-170324,170324,6,0,13,741,10.5,1538.785257050275,4
2020-09-19-170324,170324,5,0,5,746,2.833333333333333,1435.0599326540596,5
2020-09-20-170324,170324,5,0,13,751,3.0,1355.8817709936602,6
2020-09-21-170324,170324,12,1,3,763,14.5,1165.9332471457344,0
2020-09-22-170324,170324,9,2,19,772,8.666666666666666,1283.348203419661,1
2020-09-23-170324,170324,17,0,9,789,11.5,1239.6453322024465,2
2020-09-24-170324,170324,20,2,10,809,9.0,1246.1887683137015,3
2020-09-25-170324,170324,10,1,27,819,9.333333333333334,1327.7936342126502,4
2020-09-26-170324,170324,3,0,4,822,3.333333333333333,1463.7843079777474,5
2020-09-27-170324,170324,4,0,1,826,0.8333333333333334,1446.3886840372825,6
2020-09-28-170324,170324,17,1,6,843,13.5,1424.1396952406888,0
2020-09-29-170324,170324,8,0,43,851,7.166666666666668,1487.612970692272,1
2020-09-30-170324,170324,12,0,11,863,8.5,1315.5903507583357,2
2020-10-01-170324,170324,27,0,24,890,15.166666666666664,0.0,3
2020-10-02-170324,170324,13,0,15,903,15.333333333333336,2781.053420389095,4
2020-10-03-170324,170324,5,0,8,908,4.666666666666667,2418.896729293614,5
2020-10-04-170324,170324,13,3,5,921,3.8333333333333335,2450.8104385012866,6
2020-10-05-170324,170324,3,1,27,924,2.333333333333333,2054.8438676999717,0
2020-10-06-170324,170324,19,0,15,943,10.333333333333334,1785.4170826173122,1
2020-10-07-170324,170324,9,1,19,952,10.5,1656.4452206711924,2
2020-10-08-170324,170324,10,2,13,962,12.0,1533.702706286952,3
2020-10-09-170324,170324,27,7,29,989,12.333333333333336,1746.6846254438915,4
2020-10-10-170324,170324,4,0,4,993,3.5,423.8774667049775,5
2020-10-11-170324,170324,1,0,10,994,2.5,498.7986228780627,6
2020-10-12-170324,170324,6,0,13,1000,4.166666666666667,550.269011625836,0
2020-10-13-170324,170324,43,0,17,1043,19.83333333333333,652.6789958492823,1
2020-10-14-170324,170324,11,0,14,1054,16.833333333333332,1271.9303503165813,2
2020-10-15-170324,170324,24,0,19,1078,16.0,1620.9135442390302,3
2020-10-16-170324,170324,15,0,18,1093,17.666666666666668,2049.7340345546886,4
2020-10-17-170324,170324,8,0,6,1101,3.5,2110.883303712512,5
2020-10-18-170324,170324,5,0,17,1106,4.5,2132.520238988491,6
2020-10-19-170324,170324,27,0,4,1133,21.33333333333333,2191.5248518390213,0
2020-10-20-170324,170324,15,0,38,1148,14.166666666666664,2459.465835392601,1
2020-10-21-170324,170324,19,0,18,1167,14.333333333333336,2465.944970979362,2
2020-10-22-170324,170324,13,0,18,1180,22.5,2435.154470515891,3
2020-10-23-170324,170324,29,0,26,1209,14.333333333333336,2419.051275331301,4
2020-10-24-170324,170324,4,2,5,1213,7.333333333333332,2765.049157040632,5
2020-10-25-170324,170324,10,2,4,1223,3.333333333333333,2760.4107863365157,6
2020-10-26-170324,170324,13,0,33,1236,19.33333333333333,2274.683414643768,0
2020-10-27-170324,170324,17,1,21,1253,6.666666666666668,2450.179993900066,1
2020-10-28-170324,170324,14,0,15,1267,21.66666666666667,2332.8420989461492,2
2020-10-29-170324,170324,19,1,14,1286,18.666666666666668,2433.82806943086,3
2020-10-30-170324,170324,18,4,26,1304,14.666666666666664,2052.372925360194,4
2020-10-31-170324,170324,6,1,0,1310,4.166666666666667,2431.744230835249,5
2020-11-01-170324,170324,17,2,0,1327,6.833333333333332,1828.1756452712236,6
2020-11-02-170324,170324,4,0,0,1331,2.5,2003.5204341258193,0
2020-11-03-170324,170324,38,0,0,1369,20.166666666666668,1728.0432732659679,1
2020-11-04-170324,170324,18,0,0,1387,8.333333333333334,2366.336579959467,2
2020-11-05-170324,170324,18,2,0,1405,17.833333333333332,2121.027668401797,3
2020-11-06-170324,170324,26,4,0,1431,15.333333333333336,2345.3610216522434,4
2020-11-07-170324,170324,5,1,0,1436,4.166666666666667,2542.6112556319886,5
2020-11-08-170324,170324,4,0,0,1440,9.166666666666666,2327.946664034964,6
2020-11-09-170324,170324,33,2,0,1473,25.5,2360.7536502192343,0
2020-11-10-170324,170324,21,0,0,1494,20.166666666666668,1845.5541424516875,1
2020-11-11-170324,170324,15,5,0,1509,13.5,2245.3362548251084,2
2020-11-12-170324,170324,14,0,0,1523,16.333333333333332,2583.81387241045,3
2020-11-13-170324,170324,26,0,0,1549,16.333333333333332,2511.733968092117,4
2020-03-01-170325,170325,0,0,1,0,0.0,0.0,6
2020-03-02-170325,170325,0,0,0,0,0.0,71.83061937452081,0
2020-03-03-170325,170325,0,0,3,0,0.0,279.5592271771956,1
2020-03-04-170325,170325,0,1,8,0,0.0,279.7425043316358,2
2020-03-05-170325,170325,0,1,9,0,0.0,312.20447736708815,3
2020-03-06-170325,170325,0,0,8,0,0.0,290.9941136757111,4
2020-03-07-170325,170325,0,0,2,0,0.0,309.87761594006633,5
2020-03-08-170325,170325,0,1,4,0,0.0,306.37069577919357,6
2020-03-09-170325,170325,0,0,8,0,0.5,309.3915160779843,0
2020-03-10-170325,170325,0,0,4,0,0.0,530.4178903577329,1
2020-03-11-170325,170325,0,0,10,0,0.0,486.87617887990973,2
2020-03-12-170325,170325,0,0,7,0,0.5,331.1774385114454,3
2020-03-13-170325,170325,0,0,8,0,0.0,200.88655795364878,4
2020-03-14-170325,170325,0,0,3,0,1.0,158.4749635923376,5
2020-03-15-170325,170325,1,0,1,1,1.0,139.04218568613672,6
2020-03-16-170325,170325,0,0,7,1,7.5,36.824818984989015,0
2020-03-17-170325,170325,3,0,6,4,10.5,114.20627287028111,1
2020-03-18-170325,170325,8,0,6,12,13.5,227.35944339388186,2
2020-03-19-170325,170325,9,0,7,21,10.0,365.83075039917503,3
2020-03-20-170325,170325,8,0,2,29,10.75,474.76461365540865,4
2020-03-21-170325,170325,2,0,0,31,5.25,570.3138208922295,5
2020-03-22-170325,170325,4,0,4,35,4.0,585.6282864448006,6
2020-03-23-170325,170325,8,0,2,43,21.5,556.8202372918632,0
2020-03-24-170325,170325,4,0,4,47,15.75,657.5083693847687,1
2020-03-25-170325,170325,10,0,5,57,13.75,682.6882029750259,2
2020-03-26-170325,170325,7,0,0,64,7.0,708.5694604747188,3
2020-03-27-170325,170325,8,0,1,72,15.75,789.4422860041448,4
2020-03-28-170325,170325,3,0,2,75,4.5,793.0995818324546,5
2020-03-29-170325,170325,1,0,0,76,4.25,773.8169421384306,6
2020-03-30-170325,170325,7,0,2,83,10.5,560.3948310823442,0
2020-03-31-170325,170325,6,0,0,89,10.0,522.6496108215912,1
2020-04-01-170325,170325,6,0,2,95,8.75,101.56732762551073,2
2020-04-02-170325,170325,7,0,2,102,7.75,264.09557561203803,3
2020-04-03-170325,170325,2,0,0,104,6.5,205.82667634347874,4
2020-04-04-170325,170325,0,0,0,104,2.5,167.8533804575219,5
2020-04-05-170325,170325,4,0,1,108,1.25,160.60459490480898,6
2020-04-06-170325,170325,2,1,3,110,8.75,174.18530767538107,0
2020-04-07-170325,170325,4,0,2,114,5.75,216.8337049918444,1
2020-04-08-170325,170325,5,0,2,119,15.0,239.38677452318336,2
2020-04-09-170325,170325,0,0,0,119,3.25,309.57878662317063,3
2020-04-10-170325,170325,1,0,1,120,14.5,73.46347614559862,4
2020-04-11-170325,170325,2,0,4,122,3.0,172.02489945102278,5
2020-04-12-170325,170325,0,0,1,122,9.0,193.12760163365073,6
2020-04-13-170325,170325,2,0,4,124,8.5,253.61875748660435,0
2020-04-14-170325,170325,0,0,4,124,10.5,312.10990847395954,1
2020-04-15-170325,170325,2,0,0,126,7.5,375.3834566795592,2
2020-04-16-170325,170325,2,0,0,128,7.5,410.3628126234267,3
2020-04-17-170325,170325,0,0,1,128,2.75,393.6830328060416,4
2020-04-18-170325,170325,0,0,1,128,0.25,339.2480254047623,5
2020-04-19-170325,170325,1,0,4,129,0.75,322.0286078094439,6
2020-04-20-170325,170325,3,1,3,132,6.75,281.06051021171004,0
2020-04-21-170325,170325,2,0,6,134,12.0,248.04048676283148,1
2020-04-22-170325,170325,2,0,2,136,1.0,269.48921648970634,2
2020-04-23-170325,170325,0,0,3,136,0.25,240.96036338456685,3
2020-04-24-170325,170325,1,0,3,137,11.5,201.83482115597906,4
2020-04-25-170325,170325,4,0,2,141,1.25,302.48781103108905,5
2020-04-26-170325,170325,1,0,2,142,0.75,315.68508652176587,6
2020-04-27-170325,170325,4,0,4,146,2.5,245.60459092539952,0
2020-04-28-170325,170325,4,0,2,150,3.25,238.2245019950115,1
2020-04-29-170325,170325,0,0,2,150,0.75,213.30074526257718,2
2020-04-30-170325,170325,0,0,5,150,2.25,258.86484451583044,3
2020-05-01-170325,170325,1,0,0,151,0.25,305.919613469148,4
2020-05-02-170325,170325,1,0,0,152,1.0,157.5397544728883,5
2020-05-03-170325,170325,4,0,0,156,0.25,105.92166460157473,6
2020-05-04-170325,170325,3,0,6,159,2.75,115.14727163877032,0
2020-05-05-170325,170325,6,0,5,165,3.75,119.6992311469833,1
2020-05-06-170325,170325,2,0,5,167,4.0,150.37742257547407,2
2020-05-07-170325,170325,3,0,1,170,1.0,146.38981920759701,3
2020-05-08-170325,170325,3,0,0,173,3.75,157.93675999503512,4
2020-05-09-170325,170325,2,0,1,175,0.75,176.72528827067373,5
2020-05-10-170325,170325,2,0,0,177,0.0,331.4813816485113,6
2020-05-11-170325,170325,4,0,0,181,1.5,322.6652295298389,0
2020-05-12-170325,170325,2,0,3,183,1.25,330.18235735023615,1
2020-05-13-170325,170325,2,2,0,185,2.5,275.384188090174,2
2020-05-14-170325,170325,5,0,6,190,3.75,250.51063624419214,3
2020-05-15-170325,170325,0,0,1,190,2.0,198.33383209991396,4
2020-05-16-170325,170325,0,0,1,190,0.5,163.00618069030108,5
2020-05-17-170325,170325,0,1,0,190,0.25,163.92048303648505,6
2020-05-18-170325,170325,6,0,3,196,1.5,163.3057641135228,0
2020-05-19-170325,170325,5,0,5,201,3.25,166.57069733018383,1
2020-05-20-170325,170325,5,0,2,206,0.75,151.35198936586568,2
2020-05-21-170325,170325,1,0,3,207,2.5,140.82906199687125,3
2020-05-22-170325,170325,0,0,0,207,2.0,165.0549527944971,4
2020-05-23-170325,170325,1,0,1,208,0.0,183.24156607866433,5
2020-05-24-170325,170325,0,0,2,208,0.5,183.15947388015996,6
2020-05-25-170325,170325,0,0,3,208,1.25,150.34487773414284,0
2020-05-26-170325,170325,3,0,3,211,1.25,116.39806510609208,1
2020-05-27-170325,170325,0,0,14,211,0.75,134.29572914777435,2
2020-05-28-170325,170325,6,0,6,217,1.5,128.95988412618001,3
2020-05-29-170325,170325,1,0,4,218,1.5,133.87569020820177,4
2020-05-30-170325,170325,1,0,0,219,0.25,152.239125799224,5
2020-05-31-170325,170325,0,0,0,219,0.0,159.6342368751795,6
2020-06-01-170325,170325,3,1,4,222,1.25,210.77194290967282,0
2020-06-02-170325,170325,5,0,2,227,2.25,70.81850475864218,1
2020-06-03-170325,170325,2,0,2,229,1.0,77.16759736108261,2
2020-06-04-170325,170325,3,0,0,232,1.5,79.10795704602589,3
2020-06-05-170325,170325,0,0,0,232,1.25,93.92038878768142,4
2020-06-06-170325,170325,1,0,0,233,0.0,107.78590412554126,5
2020-06-07-170325,170325,2,0,0,235,0.0,112.78304339584093,6
2020-06-08-170325,170325,3,0,1,238,0.75,117.4162331140969,0
2020-06-09-170325,170325,3,0,3,241,1.5,130.5650429842662,1
2020-06-10-170325,170325,14,0,1,255,2.25,240.3221100815085,2
2020-06-11-170325,170325,6,0,3,261,1.0,271.19635227100474,3
2020-06-12-170325,170325,4,0,1,265,1.5,237.35822342080144,4
2020-06-13-170325,170325,0,2,0,265,0.25,227.4763126982515,5
2020-06-14-170325,170325,0,0,0,265,0.0,191.77923704293082,6
2020-06-15-170325,170325,4,1,0,269,1.0,162.45138764861454,0
2020-06-16-170325,170325,2,1,2,271,0.5,176.4911694827942,1
2020-06-17-170325,170325,2,0,0,273,1.25,156.6922928581414,2
2020-06-18-170325,170325,0,0,0,273,0.75,111.45733492725678,3
2020-06-19-170325,170325,0,0,0,273,0.0,90.08990285238346,4
2020-06-20-170325,170325,0,0,0,273,0.0,104.39902337486832,5
2020-06-21-170325,170325,0,0,0,273,0.0,104.88830507541313,6
2020-06-22-170325,170325,1,0,4,274,0.5,81.2725234751225,0
2020-06-23-170325,170325,3,0,0,277,0.75,82.4250128915262,1
2020-06-24-170325,170325,1,1,1,278,1.25,86.00100655685634,2
2020-06-25-170325,170325,3,0,2,281,2.0,100.06357535908381,3
2020-06-26-170325,170325,1,0,0,282,0.0,122.44454106981837,4
2020-06-27-170325,170325,0,0,0,282,0.25,88.13558329785192,5
2020-06-28-170325,170325,0,0,0,282,0.0,91.75512085193056,6
2020-06-29-170325,170325,0,1,0,282,0.5,91.75013097629989,0
2020-06-30-170325,170325,2,0,1,284,0.75,89.51006355571303,1
2020-07-01-170325,170325,0,0,0,284,0.0,157.0252568033931,2
2020-07-02-170325,170325,0,0,0,284,1.0,26.13670581885526,3
2020-07-03-170325,170325,0,0,0,284,0.25,33.25364994500615,4
2020-07-04-170325,170325,0,0,0,284,0.0,34.74923117979597,5
2020-07-05-170325,170325,0,0,0,284,0.0,33.599868574540835,6
2020-07-06-170325,170325,4,0,0,288,0.0,29.180876908738313,0
2020-07-07-170325,170325,0,0,0,288,0.25,42.52611370394033,1
2020-07-08-170325,170325,1,0,0,289,0.5,44.09324499451928,2
2020-07-09-170325,170325,2,0,0,291,0.5,50.35308268526809,3
2020-07-10-170325,170325,0,0,2,291,0.0,143.45572176912566,4
2020-07-11-170325,170325,0,0,0,291,0.0,101.153782990955,5
2020-07-12-170325,170325,0,0,0,291,0.25,79.48733072209241,6
2020-07-13-170325,170325,0,0,0,291,0.75,73.0028070005598,0
2020-07-14-170325,170325,1,0,0,292,0.0,75.59884129561527,1
2020-07-15-170325,170325,0,0,0,292,0.5,54.42219153756535,2
2020-07-16-170325,170325,0,0,1,292,0.5,20.41530578006794,3
2020-07-17-170325,170325,0,0,2,292,0.25,23.711759933481545,4
2020-07-18-170325,170325,0,0,0,292,0.5,23.104002381580955,5
2020-07-19-170325,170325,0,0,0,292,0.25,27.369818833538368,6
2020-07-20-170325,170325,0,0,0,292,0.75,32.86517240363747,0
2020-07-21-170325,170325,0,0,0,292,0.25,32.488916025896465,1
2020-07-22-170325,170325,0,0,0,292,0.5,34.05763664780759,2
2020-07-23-170325,170325,0,0,0,292,1.0,33.472434885165406,3
2020-07-24-170325,170325,2,0,0,294,1.0,39.83209543268957,4
2020-07-25-170325,170325,0,0,0,294,0.0,49.53194511008089,5
2020-07-26-170325,170325,0,0,0,294,0.25,48.08192980464327,6
2020-07-27-170325,170325,0,0,1,294,0.5,37.07544807259568,0
2020-07-28-170325,170325,0,0,1,294,0.75,37.833260521020314,1
2020-07-29-170325,170325,0,0,0,294,0.25,39.59650007419328,2
2020-07-30-170325,170325,1,0,0,295,1.0,32.14805153087017,3
2020-07-31-170325,170325,2,0,0,297,0.5,27.32104920379519,4
2020-08-01-170325,170325,0,0,0,297,0.25,56.30557016858294,5
2020-08-02-170325,170325,0,0,0,297,0.25,71.23268216790626,6
2020-08-03-170325,170325,0,0,0,297,0.25,216.94220402685224,0
2020-08-04-170325,170325,0,0,1,297,1.0,260.59813810505847,1
2020-08-05-170325,170325,0,0,0,297,1.0,227.60385192563012,2
2020-08-06-170325,170325,0,0,3,297,3.25,190.71607029356517,3
2020-08-07-170325,170325,0,0,0,297,0.5,186.6566237858205,4
2020-08-08-170325,170325,0,0,0,297,0.25,181.24585005803294,5
2020-08-09-170325,170325,0,0,0,297,0.25,182.23296783560744,6
2020-08-10-170325,170325,1,0,0,298,0.75,49.77069114623297,0
2020-08-11-170325,170325,1,0,0,299,0.5,63.403628778998176,1
2020-08-12-170325,170325,0,0,0,299,1.5,75.40187372092468,2
2020-08-13-170325,170325,0,0,0,299,0.75,72.19650530459656,3
2020-08-14-170325,170325,0,0,0,299,0.5,76.19697135020779,4
2020-08-15-170325,170325,0,0,0,299,1.75,73.38824270713799,5
2020-08-16-170325,170325,0,0,0,299,0.5,88.0881254423227,6
2020-08-17-170325,170325,0,0,1,299,0.0,87.3633013102826,0
2020-08-18-170325,170325,1,0,4,300,0.75,76.63205168309318,1
2020-08-19-170325,170325,0,0,5,300,0.75,78.87977579336354,2
2020-08-20-170325,170325,3,0,0,303,2.0,69.61096054153464,3
2020-08-21-170325,170325,0,0,1,303,2.0,88.05831936147865,4
2020-08-22-170325,170325,0,0,0,303,0.25,77.57171516992395,5
2020-08-23-170325,170325,0,0,0,303,1.0,87.94745000045799,6
2020-08-24-170325,170325,0,0,0,303,1.25,91.30207155315193,0
2020-08-25-170325,170325,0,0,0,303,4.0,101.12088778406095,1
2020-08-26-170325,170325,0,0,0,303,1.25,131.71943779599758,2
2020-08-27-170325,170325,0,1,0,303,4.5,170.33676173623445,3
2020-08-28-170325,170325,0,0,0,303,2.0,192.36237608439572,4
2020-08-29-170325,170325,0,0,1,303,0.75,215.87476911197035,5
2020-08-30-170325,170325,0,0,4,303,5.75,208.64673150910446,6
2020-08-31-170325,170325,1,0,1,304,4.0,255.93173251435783,0
2020-09-01-170325,170325,4,0,1,308,2.25,104.46348436976913,1
2020-09-02-170325,170325,5,0,4,313,1.5,310.50915454111055,2
2020-09-03-170325,170325,0,0,1,313,3.25,500.16176753186505,3
2020-09-04-170325,170325,1,0,0,314,3.75,387.12390465050834,4
2020-09-05-170325,170325,0,0,0,314,0.75,336.0883781356409,5
2020-09-06-170325,170325,0,0,1,314,2.75,292.0234854105588,6
2020-09-07-170325,170325,0,0,1,314,3.75,291.69442270000934,0
2020-09-08-170325,170325,0,0,3,314,2.0,253.19091542784335,1
2020-09-09-170325,170325,0,0,3,314,8.0,209.85109767605343,2
2020-09-10-170325,170325,0,0,7,314,4.0,99.20536889023953,3
2020-09-11-170325,170325,0,0,4,314,4.25,130.43880016903796,4
2020-09-12-170325,170325,1,0,8,315,2.25,173.29437927916646,5
2020-09-13-170325,170325,4,0,0,319,2.0,160.5158271763445,6
2020-09-14-170325,170325,1,0,3,320,2.5,176.67731476985307,0
2020-09-15-170325,170325,1,0,5,321,6.25,214.9610836334054,1
2020-09-16-170325,170325,4,0,8,325,4.5,269.71000444484116,2
2020-09-17-170325,170325,1,0,4,326,7.25,281.37460512105457,3
2020-09-18-170325,170325,0,0,2,326,4.25,295.6229204517148,4
2020-09-19-170325,170325,0,0,1,326,2.5,282.20146678584524,5
2020-09-20-170325,170325,1,0,1,327,1.75,287.30782449495706,6
2020-09-21-170325,170325,1,0,13,328,6.75,265.35486949084043,0
2020-09-22-170325,170325,3,0,5,331,5.0,252.7361561259725,1
2020-09-23-170325,170325,3,1,3,334,7.5,269.9874605812226,2
2020-09-24-170325,170325,7,0,4,341,19.75,272.03210085206456,3
2020-09-25-170325,170325,4,0,38,345,10.25,371.15433879114346,4
2020-09-26-170325,170325,8,0,1,353,1.25,424.52686784194634,5
2020-09-27-170325,170325,0,0,9,353,2.0,421.25063737946755,6
2020-09-28-170325,170325,3,0,0,356,6.25,411.84107991225835,0
2020-09-29-170325,170325,5,0,8,361,8.75,425.7938437077071,1
2020-09-30-170325,170325,8,0,12,369,11.0,389.52539851178153,2
2020-10-01-170325,170325,4,0,13,373,20.5,0.0,3
2020-10-02-170325,170325,2,0,19,375,14.0,639.5235055738458,4
2020-10-03-170325,170325,1,0,6,376,5.25,541.12032979438,5
2020-10-04-170325,170325,1,0,3,377,0.75,546.8916467833358,6
2020-10-05-170325,170325,13,1,9,390,5.0,470.2477299723319,0
2020-10-06-170325,170325,5,0,10,395,11.5,471.4455622303592,1
2020-10-07-170325,170325,3,1,5,398,5.0,482.3941204263509,2
2020-10-08-170325,170325,4,0,13,402,9.25,425.3266426944454,3
2020-10-09-170325,170325,38,3,6,440,8.0,475.9409700072981,4
2020-10-10-170325,170325,1,0,5,441,2.0,122.23308910608986,5
2020-10-11-170325,170325,9,0,6,450,2.0,143.50355436972876,6
2020-10-12-170325,170325,0,0,4,450,2.25,194.53823019202,0
2020-10-13-170325,170325,8,0,11,458,11.75,205.65944813467326,1
2020-10-14-170325,170325,12,0,4,470,12.5,298.75096493514116,2
2020-10-15-170325,170325,13,0,4,483,19.75,389.24678556089725,3
2020-10-16-170325,170325,19,0,8,502,10.0,529.5564351141973,4
2020-10-17-170325,170325,6,0,8,508,2.75,531.8503622408109,5
2020-10-18-170325,170325,3,0,3,511,1.75,556.9918841974787,6
2020-10-19-170325,170325,9,2,0,520,10.75,536.3832802052316,0
2020-10-20-170325,170325,10,0,9,530,7.5,597.1957407570014,1
2020-10-21-170325,170325,5,1,0,535,8.5,587.0673328170906,2
2020-10-22-170325,170325,13,0,3,548,7.25,504.90134720991387,3
2020-10-23-170325,170325,6,1,13,554,15.5,484.12603785410124,4
2020-10-24-170325,170325,5,0,3,559,4.25,548.6351639348038,5
2020-10-25-170325,170325,6,1,2,565,1.5,556.657080610254,6
2020-10-26-170325,170325,4,3,4,569,9.5,498.7057460048833,0
2020-10-27-170325,170325,11,2,8,580,5.75,502.7541773192062,1
2020-10-28-170325,170325,4,2,6,584,6.25,490.3505712808232,2
2020-10-29-170325,170325,4,3,3,588,18.25,493.9746245863052,3
2020-10-30-170325,170325,8,0,6,596,11.25,411.2298828031915,4
2020-10-31-170325,170325,8,1,0,604,4.5,474.45666920819843,5
2020-11-01-170325,170325,3,0,0,607,1.25,462.1832524084904,6
2020-11-02-170325,170325,0,0,0,607,3.0,396.3608995611655,0
2020-11-03-170325,170325,9,1,0,616,10.0,326.186825158079,1
2020-11-04-170325,170325,0,0,0,616,5.0,411.4539830643257,2
2020-11-05-170325,170325,3,0,0,619,17.5,381.5280402896109,3
2020-11-06-170325,170325,13,2,0,632,12.0,467.53763103016746,4
2020-11-07-170325,170325,3,1,0,635,4.75,521.8405275337196,5
2020-11-08-170325,170325,2,0,0,637,3.25,500.61153963515903,6
2020-11-09-170325,170325,4,0,0,641,12.5,488.679383505164,0
2020-11-10-170325,170325,8,1,0,649,8.25,408.8564794930944,1
2020-11-11-170325,170325,6,2,0,655,8.25,470.17187061301104,2
2020-11-12-170325,170325,3,1,0,658,11.25,477.37866064849135,3
2020-11-13-170325,170325,6,0,0,664,13.0,474.4565651340458,4
2020-03-01-170326,170326,0,0,0,0,0.0,0.0,6
2020-03-02-170326,170326,0,0,2,0,0.0,10.13631581488687,0
2020-03-03-170326,170326,0,2,0,0,0.0,41.32764750877561,1
2020-03-04-170326,170326,0,0,3,0,0.16666666666666666,38.58587248384886,2
2020-03-05-170326,170326,0,0,2,0,0.0,41.643030028790314,3
2020-03-06-170326,170326,0,0,4,0,0.0,33.79526630856719,4
2020-03-07-170326,170326,0,0,2,0,0.0,34.43847176554952,5
2020-03-08-170326,170326,0,0,1,0,0.0,35.255879769805155,6
2020-03-09-170326,170326,0,0,2,0,0.3333333333333333,35.419580678913164,0
2020-03-10-170326,170326,0,1,4,0,0.0,218.68807418986225,1
2020-03-11-170326,170326,0,0,0,0,0.0,185.69180997601035,2
2020-03-12-170326,170326,0,0,3,0,0.16666666666666666,137.80073574314636,3
2020-03-13-170326,170326,0,0,3,0,0.0,83.49284126452132,4
2020-03-14-170326,170326,0,0,0,0,0.0,53.29741808152091,5
2020-03-15-170326,170326,0,0,0,0,0.5,43.21273736608104,6
2020-03-16-170326,170326,2,0,0,2,2.333333333333333,4.490167147084533,0
2020-03-17-170326,170326,0,0,0,2,5.5,17.744160373581845,1
2020-03-18-170326,170326,3,0,0,5,7.166666666666668,30.74942357141172,2
2020-03-19-170326,170326,2,0,0,7,5.333333333333333,48.80012005023598,3
2020-03-20-170326,170326,4,0,0,11,5.0,64.99495397151463,4
2020-03-21-170326,170326,2,0,0,13,2.1666666666666665,78.20214627397309,5
2020-03-22-170326,170326,1,0,0,14,1.8333333333333333,82.40239058265865,6
2020-03-23-170326,170326,2,0,0,16,9.833333333333334,76.36785457602019,0
2020-03-24-170326,170326,4,0,0,20,7.833333333333332,89.1523643159017,1
2020-03-25-170326,170326,0,0,0,20,6.0,92.54853188817765,2
2020-03-26-170326,170326,3,0,1,23,3.333333333333333,91.68870736371628,3
2020-03-27-170326,170326,3,0,0,26,5.166666666666667,103.98618565116159,4
2020-03-28-170326,170326,0,0,0,26,1.1666666666666667,104.18226196976454,5
2020-03-29-170326,170326,0,0,0,26,1.6666666666666667,100.75550044279956,6
2020-03-30-170326,170326,0,0,0,26,3.333333333333333,73.19277416613976,0
2020-03-31-170326,170326,0,0,1,26,4.666666666666667,59.547739422923016,1
2020-04-01-170326,170326,0,0,0,26,4.166666666666667,12.234013170957207,2
2020-04-02-170326,170326,0,0,0,26,4.0,43.169189017792945,3
2020-04-03-170326,170326,0,0,0,26,2.833333333333333,27.9464742620546,4
2020-04-04-170326,170326,0,0,0,26,0.8333333333333334,27.5138068218443,5
2020-04-05-170326,170326,0,0,0,26,0.6666666666666666,24.347249390611857,6
2020-04-06-170326,170326,0,0,1,26,5.333333333333333,24.64052924815013,0
2020-04-07-170326,170326,0,1,1,26,3.0,28.530874854820034,1
2020-04-08-170326,170326,0,0,0,26,2.6666666666666665,31.155481238123325,2
2020-04-09-170326,170326,1,0,0,27,3.8333333333333335,34.23991797753668,3
2020-04-10-170326,170326,0,0,0,27,5.833333333333332,12.417397711423313,4
2020-04-11-170326,170326,0,0,2,27,1.5,18.396528232503204,5
2020-04-12-170326,170326,0,0,0,27,4.333333333333333,19.957328797639047,6
2020-04-13-170326,170326,0,0,0,27,2.833333333333333,22.6262875602054,0
2020-04-14-170326,170326,1,0,1,28,5.166666666666667,30.296532749735412,1
2020-04-15-170326,170326,0,0,1,28,0.8333333333333334,44.293576560057346,2
2020-04-16-170326,170326,0,0,0,28,2.5,49.167530594954115,3
2020-04-17-170326,170326,0,0,0,28,2.0,45.931013280829326,4
2020-04-18-170326,170326,0,0,0,28,0.6666666666666666,46.26926415988622,5
2020-04-19-170326,170326,0,0,0,28,0.16666666666666666,46.1799812854384,6
2020-04-20-170326,170326,1,1,1,29,0.8333333333333334,40.30394566959149,0
2020-04-21-170326,170326,1,0,0,30,2.5,29.751755035992016,1
2020-04-22-170326,170326,0,0,1,30,0.8333333333333334,32.876375241896255,2
2020-04-23-170326,170326,0,0,0,30,0.5,30.21451157424213,3
2020-04-24-170326,170326,0,0,0,30,7.833333333333332,24.612179110013425,4
2020-04-25-170326,170326,2,0,0,32,0.5,32.96590820303694,5
2020-04-26-170326,170326,0,0,0,32,0.5,38.49076449600558,6
2020-04-27-170326,170326,0,0,0,32,2.5,34.31181952037893,0
2020-04-28-170326,170326,1,0,0,33,2.5,33.95147753991875,1
2020-04-29-170326,170326,1,0,0,34,1.0,30.70566357833095,2
2020-04-30-170326,170326,0,0,0,34,2.1666666666666665,38.19573790033568,3
2020-05-01-170326,170326,0,0,1,34,0.16666666666666666,39.45312642675742,4
2020-05-02-170326,170326,0,0,0,34,0.5,26.925222398797544,5
2020-05-03-170326,170326,0,0,0,34,0.3333333333333333,14.237716056378472,6
2020-05-04-170326,170326,1,0,1,35,1.8333333333333333,18.654698243251886,0
2020-05-05-170326,170326,0,0,1,35,3.0,20.448140102111346,1
2020-05-06-170326,170326,1,0,0,36,2.6666666666666665,21.126781615567047,2
2020-05-07-170326,170326,0,0,0,36,5.666666666666668,25.656086052179518,3
2020-05-08-170326,170326,0,0,0,36,1.8333333333333333,34.254021111229996,4
2020-05-09-170326,170326,0,0,0,36,0.5,37.84064960731722,5
2020-05-10-170326,170326,0,0,0,36,0.3333333333333333,41.433788437757215,6
2020-05-11-170326,170326,0,1,1,36,1.3333333333333333,39.95664265100146,0
2020-05-12-170326,170326,0,0,0,36,1.5,43.77140034279374,1
2020-05-13-170326,170326,0,0,0,36,4.0,36.20990778386506,2
2020-05-14-170326,170326,0,0,0,36,2.6666666666666665,33.657858123508376,3
2020-05-15-170326,170326,1,1,0,37,1.0,32.961543857564955,4
2020-05-16-170326,170326,0,0,0,37,0.5,28.831555441477384,5
2020-05-17-170326,170326,0,0,0,37,0.16666666666666666,30.435849033396448,6
2020-05-18-170326,170326,1,0,0,38,1.5,30.079269874718754,0
2020-05-19-170326,170326,1,0,0,39,1.6666666666666667,30.308217682948708,1
2020-05-20-170326,170326,0,0,0,39,1.6666666666666667,27.055052946614254,2
2020-05-21-170326,170326,0,0,0,39,1.5,21.854383291456763,3
2020-05-22-170326,170326,0,0,1,39,1.8333333333333333,23.069736388785536,4
2020-05-23-170326,170326,0,0,0,39,0.0,27.339476763381164,5
2020-05-24-170326,170326,0,0,0,39,0.0,26.679450915090587,6
2020-05-25-170326,170326,1,0,1,40,0.3333333333333333,20.96344264150581,0
2020-05-26-170326,170326,0,0,0,40,0.8333333333333334,17.073465353406238,1
2020-05-27-170326,170326,0,0,1,40,0.5,18.723211184825175,2
2020-05-28-170326,170326,0,0,1,40,1.6666666666666667,22.228307507225765,3
2020-05-29-170326,170326,0,0,0,40,1.1666666666666667,23.61486437225245,4
2020-05-30-170326,170326,0,0,0,40,0.16666666666666666,24.769856252528193,5
2020-05-31-170326,170326,0,0,0,40,0.16666666666666666,27.174297850817,6
2020-06-01-170326,170326,0,0,1,40,1.1666666666666667,49.77211628979246,0
2020-06-02-170326,170326,0,0,0,40,1.5,10.012404666315554,1
2020-06-03-170326,170326,0,0,0,40,1.0,17.896798794354815,2
2020-06-04-170326,170326,0,0,0,40,2.6666666666666665,14.830915453185629,3
2020-06-05-170326,170326,1,0,0,41,0.8333333333333334,12.703849068874534,4
2020-06-06-170326,170326,0,0,0,41,0.16666666666666666,14.566189774293736,5
2020-06-07-170326,170326,0,0,0,41,0.0,14.774275929172786,6
2020-06-08-170326,170326,1,0,0,42,1.1666666666666667,15.081627664462236,0
2020-06-09-170326,170326,0,0,0,42,0.6666666666666666,19.910090343895664,1
2020-06-10-170326,170326,1,0,0,43,0.6666666666666666,49.07614875842063,2
2020-06-11-170326,170326,1,0,1,44,0.6666666666666666,50.16952551088326,3
2020-06-12-170326,170326,0,0,1,44,1.3333333333333333,46.65731436855104,4
2020-06-13-170326,170326,0,1,0,44,0.0,40.8860879768005,5
2020-06-14-170326,170326,0,2,0,44,0.0,27.81106750018037,6
2020-06-15-170326,170326,1,0,1,45,1.0,23.336163996466922,0
2020-06-16-170326,170326,0,0,1,45,0.16666666666666666,24.987521423596235,1
2020-06-17-170326,170326,0,0,1,45,0.5,22.18150428905296,2
2020-06-18-170326,170326,0,0,0,45,0.5,17.214426956617498,3
2020-06-19-170326,170326,0,0,0,45,0.0,13.530875379828956,4
2020-06-20-170326,170326,0,0,0,45,0.0,13.26986001187555,5
2020-06-21-170326,170326,0,0,0,45,0.0,12.843275649121,6
2020-06-22-170326,170326,0,0,0,45,0.5,8.460707952593907,0
2020-06-23-170326,170326,0,0,0,45,1.0,8.365215456893146,1
2020-06-24-170326,170326,0,0,2,45,1.3333333333333333,10.907311535821025,2
2020-06-25-170326,170326,1,0,0,46,0.8333333333333334,14.078668851275106,3
2020-06-26-170326,170326,1,1,1,47,0.5,18.74737279815875,4
2020-06-27-170326,170326,0,0,1,47,0.16666666666666666,17.48888455124205,5
2020-06-28-170326,170326,0,1,0,47,0.0,18.275686570277585,6
2020-06-29-170326,170326,1,0,0,48,0.5,18.469008917241965,0
2020-06-30-170326,170326,1,0,0,49,0.3333333333333333,17.93751895224186,1
2020-07-01-170326,170326,1,0,1,50,0.0,26.261094885402045,2
2020-07-02-170326,170326,0,0,0,50,0.6666666666666666,8.592419387191862,3
2020-07-03-170326,170326,0,0,0,50,0.3333333333333333,6.663773494053174,4
2020-07-04-170326,170326,0,0,0,50,0.0,6.153082078018273,5
2020-07-05-170326,170326,0,0,1,50,0.0,6.082129846686563,6
2020-07-06-170326,170326,0,0,0,50,0.3333333333333333,5.790019724721275,0
2020-07-07-170326,170326,0,0,0,50,0.0,6.534630814433154,1
2020-07-08-170326,170326,2,0,0,52,0.3333333333333333,6.105707621744931,2
2020-07-09-170326,170326,0,0,0,52,0.5,8.74626459731773,3
2020-07-10-170326,170326,1,0,0,53,0.6666666666666666,25.90754723686844,4
2020-07-11-170326,170326,1,0,0,54,0.16666666666666666,25.050019785837833,5
2020-07-12-170326,170326,0,0,0,54,0.0,20.48880082500567,6
2020-07-13-170326,170326,0,0,0,54,0.16666666666666666,20.07168947371489,0
2020-07-14-170326,170326,0,0,0,54,0.0,20.28705488989964,1
2020-07-15-170326,170326,1,0,0,55,0.0,12.589674317450818,2
2020-07-16-170326,170326,0,0,0,55,0.16666666666666666,8.73139828225614,3
2020-07-17-170326,170326,0,0,0,55,0.16666666666666666,8.570890344377231,4
2020-07-18-170326,170326,0,0,0,55,0.16666666666666666,7.277816172565862,5
2020-07-19-170326,170326,1,0,1,56,0.16666666666666666,6.589943699284269,6
2020-07-20-170326,170326,0,0,0,56,0.3333333333333333,9.435893359018149,0
2020-07-21-170326,170326,0,0,0,56,0.16666666666666666,10.020415532485064,1
2020-07-22-170326,170326,0,0,0,56,0.16666666666666666,10.413852704047208,2
2020-07-23-170326,170326,0,0,0,56,0.5,9.382479865890282,3
2020-07-24-170326,170326,0,0,0,56,0.16666666666666666,10.049902012622383,4
2020-07-25-170326,170326,0,0,0,56,0.0,10.757104476776329,5
2020-07-26-170326,170326,0,0,0,56,0.0,8.089007919044521,6
2020-07-27-170326,170326,0,0,1,56,0.3333333333333333,7.326997288681673,0
2020-07-28-170326,170326,0,0,0,56,0.5,6.876699751304762,1
2020-07-29-170326,170326,0,0,0,56,0.5,6.631159550954269,2
2020-07-30-170326,170326,0,0,0,56,0.5,5.301799694339531,3
2020-07-31-170326,170326,0,0,0,56,0.8333333333333334,5.30395033650419,4
2020-08-01-170326,170326,0,0,0,56,0.16666666666666666,9.479609227568083,5
2020-08-02-170326,170326,1,1,0,57,0.16666666666666666,25.43646797224193,6
2020-08-03-170326,170326,0,0,0,57,0.6666666666666666,73.97549922734497,0
2020-08-04-170326,170326,0,0,0,57,0.16666666666666666,56.538973074792644,1
2020-08-05-170326,170326,0,0,0,57,0.8333333333333334,47.5083651755409,2
2020-08-06-170326,170326,0,0,3,57,2.0,38.19185554506605,3
2020-08-07-170326,170326,0,0,0,57,0.5,36.52741436997655,4
2020-08-08-170326,170326,0,0,0,57,0.16666666666666666,30.2594512493938,5
2020-08-09-170326,170326,0,0,0,57,0.6666666666666666,29.456414866993015,6
2020-08-10-170326,170326,1,0,0,58,0.3333333333333333,8.97581406054311,0
2020-08-11-170326,170326,0,0,3,58,0.6666666666666666,13.397610222286154,1
2020-08-12-170326,170326,0,0,0,58,1.1666666666666667,18.516012548597494,2
2020-08-13-170326,170326,0,0,2,58,0.6666666666666666,18.899450201730915,3
2020-08-14-170326,170326,0,0,1,58,0.6666666666666666,22.097138303509013,4
2020-08-15-170326,170326,0,0,1,58,2.5,21.8147231273268,5
2020-08-16-170326,170326,0,0,0,58,0.3333333333333333,23.528010646127193,6
2020-08-17-170326,170326,0,0,0,58,1.0,25.128845299064047,0
2020-08-18-170326,170326,0,0,0,58,1.3333333333333333,25.588880066694482,1
2020-08-19-170326,170326,0,0,1,58,1.1666666666666667,24.171300130154012,2
2020-08-20-170326,170326,3,0,0,61,1.8333333333333333,25.325090006552703,3
2020-08-21-170326,170326,0,0,2,61,2.5,33.05966741454971,4
2020-08-22-170326,170326,0,0,0,61,0.6666666666666666,37.95332552596556,5
2020-08-23-170326,170326,0,0,0,61,0.16666666666666666,43.13385193673072,6
2020-08-24-170326,170326,0,0,0,61,0.6666666666666666,40.973519246678975,0
2020-08-25-170326,170326,3,0,0,64,2.1666666666666665,49.497503911367176,1
2020-08-26-170326,170326,0,0,3,64,2.6666666666666665,65.131114651924,2
2020-08-27-170326,170326,2,0,3,66,2.1666666666666665,73.0114552564661,3
2020-08-28-170326,170326,1,0,5,67,1.3333333333333333,73.61726586021975,4
2020-08-29-170326,170326,1,0,2,68,1.0,71.1209802375669,5
2020-08-30-170326,170326,0,0,0,68,3.5,71.03093353749773,6
2020-08-31-170326,170326,0,0,3,68,1.6666666666666667,63.11382742508334,0
2020-09-01-170326,170326,0,0,1,68,1.3333333333333333,26.659913476073136,1
2020-09-02-170326,170326,1,0,2,69,2.6666666666666665,117.25338568584624,2
2020-09-03-170326,170326,0,0,10,69,2.0,229.51847379398825,3
2020-09-04-170326,170326,2,1,3,71,3.0,153.5602091040276,4
2020-09-05-170326,170326,0,0,3,71,0.5,102.79607777893014,5
2020-09-06-170326,170326,0,0,1,71,0.3333333333333333,94.0397016506972,6
2020-09-07-170326,170326,0,0,1,71,1.1666666666666667,86.82637336372679,0
2020-09-08-170326,170326,0,0,2,71,2.1666666666666665,83.48675296187696,1
2020-09-09-170326,170326,3,0,4,74,3.6666666666666665,73.51343488841304,2
2020-09-10-170326,170326,3,0,0,77,1.5,22.817166664538778,3
2020-09-11-170326,170326,5,0,0,82,2.333333333333333,37.36990831261756,4
2020-09-12-170326,170326,2,0,0,84,0.5,59.13365697642642,5
2020-09-13-170326,170326,0,0,0,84,0.5,61.44285137597488,6
2020-09-14-170326,170326,3,0,0,87,0.8333333333333334,64.91400556098043,0
2020-09-15-170326,170326,1,0,0,88,2.1666666666666665,73.56176331728402,1
2020-09-16-170326,170326,2,0,1,90,1.5,80.00669622454065,2
2020-09-17-170326,170326,10,0,0,100,2.833333333333333,86.20772651612364,3
2020-09-18-170326,170326,3,0,3,103,4.0,109.85439818384833,4
2020-09-19-170326,170326,3,0,1,106,2.1666666666666665,98.5627526274009,5
2020-09-20-170326,170326,1,0,0,107,1.6666666666666667,106.4398787463198,6
2020-09-21-170326,170326,1,1,0,108,3.6666666666666665,97.54760348149887,0
2020-09-22-170326,170326,2,0,1,110,3.1666666666666665,112.16975555842916,1
2020-09-23-170326,170326,4,0,1,114,6.0,117.4842169700062,2
2020-09-24-170326,170326,0,0,1,114,12.333333333333336,108.63681184140891,3
2020-09-25-170326,170326,0,0,1,114,11.833333333333336,164.55409174548058,4
2020-09-26-170326,170326,0,0,3,114,1.6666666666666667,208.3073791346468,5
2020-09-27-170326,170326,0,0,0,114,1.1666666666666667,200.28071393179334,6
2020-09-28-170326,170326,0,0,0,114,1.8333333333333333,204.56412676085625,0
2020-09-29-170326,170326,0,0,7,114,5.666666666666668,196.66528064781306,1
2020-09-30-170326,170326,1,0,0,115,4.833333333333333,172.25977830086643,2
2020-10-01-170326,170326,0,0,1,115,4.666666666666667,0.0,3
2020-10-02-170326,170326,3,0,2,118,4.666666666666667,228.023700165178,4
2020-10-03-170326,170326,1,1,0,119,4.0,221.20026891155044,5
2020-10-04-170326,170326,0,0,2,119,0.8333333333333334,183.27035042227115,6
2020-10-05-170326,170326,0,0,0,119,2.833333333333333,152.2361506307185,0
2020-10-06-170326,170326,1,0,1,120,2.833333333333333,150.11551269715977,1
2020-10-07-170326,170326,1,0,2,121,5.0,136.9947885018661,2
2020-10-08-170326,170326,1,0,1,122,3.6666666666666665,128.17085744448042,3
2020-10-09-170326,170326,1,1,1,123,8.333333333333334,138.8192525200884,4
2020-10-10-170326,170326,3,0,0,126,1.6666666666666667,29.905458101143555,5
2020-10-11-170326,170326,0,0,2,126,0.5,40.990300309117856,6
2020-10-12-170326,170326,0,0,0,126,1.3333333333333333,49.16407819440077,0
2020-10-13-170326,170326,7,0,1,133,2.6666666666666665,57.394929948315536,1
2020-10-14-170326,170326,0,0,2,133,5.833333333333332,87.00692034178387,2
2020-10-15-170326,170326,1,0,0,134,12.666666666666664,114.46814958593265,3
2020-10-16-170326,170326,2,0,4,136,7.333333333333332,176.98666279086535,4
2020-10-17-170326,170326,0,0,1,136,3.0,177.2905863391045,5
2020-10-18-170326,170326,2,0,19,138,2.0,180.83631828341382,6
2020-10-19-170326,170326,0,0,1,138,3.333333333333333,191.51826396012433,0
2020-10-20-170326,170326,1,0,1,139,7.166666666666668,215.2303280050033,1
2020-10-21-170326,170326,2,0,2,141,7.166666666666668,221.51291463479546,2
2020-10-22-170326,170326,1,0,5,142,5.0,188.24573169905509,3
2020-10-23-170326,170326,1,0,12,143,16.666666666666668,196.0147010375203,4
2020-10-24-170326,170326,0,0,7,143,2.333333333333333,248.84304068889037,5
2020-10-25-170326,170326,2,1,0,145,4.0,244.2148599415367,6
2020-10-26-170326,170326,0,1,0,145,7.166666666666668,226.54650831015294,0
2020-10-27-170326,170326,1,0,3,146,3.333333333333333,228.75359071505312,1
2020-10-28-170326,170326,2,0,5,148,10.166666666666666,215.6590988175202,2
2020-10-29-170326,170326,0,0,19,148,9.666666666666666,213.09059701500064,3
2020-10-30-170326,170326,4,0,27,152,14.5,153.52698095270324,4
2020-10-31-170326,170326,1,0,0,153,2.333333333333333,184.0184339874089,5
2020-11-01-170326,170326,19,0,0,172,3.0,122.08763722805068,6
2020-11-02-170326,170326,1,0,0,173,1.0,202.96015386161883,0
2020-11-03-170326,170326,1,0,0,174,6.666666666666668,151.57232005137033,1
2020-11-04-170326,170326,2,0,0,176,8.166666666666666,171.0146507446124,2
2020-11-05-170326,170326,5,0,0,181,13.833333333333336,184.2221996895702,3
2020-11-06-170326,170326,12,1,0,193,8.833333333333334,191.94330767893024,4
2020-11-07-170326,170326,7,0,0,200,4.166666666666667,198.05691492954168,5
2020-11-08-170326,170326,0,0,0,200,1.3333333333333333,194.25515245377784,6
2020-11-09-170326,170326,0,0,0,200,7.666666666666668,187.88481274841308,0
2020-11-10-170326,170326,3,1,0,203,6.333333333333332,129.67061074790618,1
2020-11-11-170326,170326,5,1,0,208,12.166666666666664,152.9980506130043,2
2020-11-12-170326,170326,19,1,0,227,9.166666666666666,173.04457986488754,3
2020-11-13-170326,170326,27,1,0,254,6.666666666666668,194.17509930908307,4
2020-03-01-170327,170327,0,0,0,0,0.0,0.0,6
2020-03-02-170327,170327,0,0,2,0,0.0,49.34305583456717,0
2020-03-03-170327,170327,0,1,4,0,0.0,183.8986022333342,1
2020-03-04-170327,170327,0,1,6,0,0.0,176.38131251877695,2
2020-03-05-170327,170327,0,0,6,0,0.0,196.57552309504314,3
2020-03-06-170327,170327,0,1,3,0,0.0,165.1962055147395,4
2020-03-07-170327,170327,0,0,4,0,0.0,165.54717543338847,5
2020-03-08-170327,170327,0,0,2,0,0.0,170.4799300056944,6
2020-03-09-170327,170327,1,0,10,1,0.16666666666666666,170.30406249825649,0
2020-03-10-170327,170327,0,0,6,1,0.0,859.8176559925621,1
2020-03-11-170327,170327,0,0,6,1,0.0,749.0254600178621,2
2020-03-12-170327,170327,0,0,3,1,0.3333333333333333,573.1858190205241,3
2020-03-13-170327,170327,0,0,5,1,0.0,374.02312323826,4
2020-03-14-170327,170327,0,0,2,1,0.0,268.57140401594376,5
2020-03-15-170327,170327,0,0,0,1,0.5,227.62411196656612,6
2020-03-16-170327,170327,2,0,2,3,4.0,13.817440641350187,0
2020-03-17-170327,170327,4,0,6,7,5.0,73.45701340409633,1
2020-03-18-170327,170327,6,0,7,13,8.166666666666666,135.56975186602816,2
2020-03-19-170327,170327,6,0,0,19,7.666666666666668,224.43046313934485,3
2020-03-20-170327,170327,3,0,2,22,8.0,311.9211526818133,4
2020-03-21-170327,170327,4,0,0,26,2.333333333333333,381.1895577903348,5
2020-03-22-170327,170327,2,0,0,28,1.5,396.1105170424645,6
2020-03-23-170327,170327,10,1,2,38,9.833333333333334,365.77772637266867,0
2020-03-24-170327,170327,6,0,2,44,9.166666666666666,424.2179048358147,1
2020-03-25-170327,170327,6,0,4,50,9.0,431.71255246557894,2
2020-03-26-170327,170327,3,0,0,53,4.333333333333333,428.8691768210123,3
2020-03-27-170327,170327,5,0,2,58,7.5,481.0759316151599,4
2020-03-28-170327,170327,2,0,1,60,2.0,476.3315075915349,5
2020-03-29-170327,170327,0,0,0,60,2.6666666666666665,466.6642187984029,6
2020-03-30-170327,170327,2,0,2,62,4.5,343.4500222635331,0
2020-03-31-170327,170327,6,0,9,68,4.333333333333333,298.8375057277872,1
2020-04-01-170327,170327,7,0,2,75,4.0,64.14012318521137,2
2020-04-02-170327,170327,0,0,2,75,4.5,230.43230524947035,3
2020-04-03-170327,170327,2,0,2,77,2.833333333333333,127.5336394262938,4
2020-04-04-170327,170327,0,0,1,77,1.0,127.43283105769757,5
2020-04-05-170327,170327,0,0,0,77,1.5,115.00170632281583,6
2020-04-06-170327,170327,2,1,2,79,5.333333333333333,114.68697480355104,0
2020-04-07-170327,170327,2,0,1,81,3.6666666666666665,134.92659145923037,1
2020-04-08-170327,170327,4,0,0,85,2.833333333333333,150.47450830311863,2
2020-04-09-170327,170327,0,0,0,85,1.5,179.46213283938295,3
2020-04-10-170327,170327,2,1,3,87,8.333333333333334,64.45693381939111,4
2020-04-11-170327,170327,1,0,2,88,1.8333333333333333,103.9939567215839,5
2020-04-12-170327,170327,0,0,1,88,5.333333333333333,114.39523898414971,6
2020-04-13-170327,170327,2,0,2,90,6.166666666666668,128.0441252183099,0
2020-04-14-170327,170327,9,0,0,99,5.666666666666668,169.72740230250452,1
2020-04-15-170327,170327,2,0,1,101,4.5,243.95945891487287,2
2020-04-16-170327,170327,2,0,1,103,3.5,274.352671745026,3
2020-04-17-170327,170327,2,0,0,105,1.0,257.73367842247455,4
2020-04-18-170327,170327,1,0,1,106,0.0,248.0176820029488,5
2020-04-19-170327,170327,0,0,1,106,0.3333333333333333,243.70847005800653,6
2020-04-20-170327,170327,2,0,1,108,1.5,216.29062944961822,0
2020-04-21-170327,170327,1,0,4,109,2.1666666666666665,160.58702868479725,1
2020-04-22-170327,170327,0,0,3,109,1.1666666666666667,145.12126154135672,2
2020-04-23-170327,170327,0,0,3,109,0.16666666666666666,127.53627672998914,3
2020-04-24-170327,170327,3,0,1,112,7.0,105.7916140402672,4
2020-04-25-170327,170327,2,0,1,114,1.3333333333333333,143.17037315902402,5
2020-04-26-170327,170327,1,0,0,115,0.5,163.78993779525058,6
2020-04-27-170327,170327,2,0,2,117,1.3333333333333333,144.53315681115487,0
2020-04-28-170327,170327,0,0,0,117,2.6666666666666665,139.67388173499108,1
2020-04-29-170327,170327,1,0,2,118,0.3333333333333333,136.16034015323987,2
2020-04-30-170327,170327,1,0,4,119,1.3333333333333333,168.9181687982146,3
2020-05-01-170327,170327,0,0,0,119,0.3333333333333333,184.9238168995066,4
2020-05-02-170327,170327,1,0,1,120,0.3333333333333333,118.54115385874594,5
2020-05-03-170327,170327,1,0,1,121,0.6666666666666666,76.71180272687866,6
2020-05-04-170327,170327,1,0,0,122,2.0,89.54973727491296,0
2020-05-05-170327,170327,4,0,1,126,3.0,97.05913699566702,1
2020-05-06-170327,170327,3,0,0,129,2.333333333333333,100.760672676464,2
2020-05-07-170327,170327,3,0,1,132,0.8333333333333334,117.66092832578963,3
2020-05-08-170327,170327,1,0,2,133,1.5,143.22641073353867,4
2020-05-09-170327,170327,1,1,0,134,0.5,154.68020539157362,5
2020-05-10-170327,170327,0,0,0,134,0.3333333333333333,189.20243374374388,6
2020-05-11-170327,170327,2,2,0,136,1.5,182.99072464273286,0
2020-05-12-170327,170327,0,0,1,136,1.1666666666666667,196.57036350172442,1
2020-05-13-170327,170327,2,0,1,138,1.6666666666666667,155.85696197226542,2
2020-05-14-170327,170327,4,0,0,142,2.833333333333333,135.6133070881446,3
2020-05-15-170327,170327,0,0,0,142,1.0,128.65636544284376,4
2020-05-16-170327,170327,1,0,1,143,0.16666666666666666,115.42884284566023,5
2020-05-17-170327,170327,1,0,0,144,0.0,121.48128688861044,6
2020-05-18-170327,170327,0,0,0,144,1.8333333333333333,122.64711653291847,0
2020-05-19-170327,170327,1,0,0,145,2.0,118.69502636316298,1
2020-05-20-170327,170327,0,0,0,145,1.3333333333333333,120.64829908948765,2
2020-05-21-170327,170327,1,0,0,146,1.6666666666666667,91.27501034594667,3
2020-05-22-170327,170327,2,0,1,148,0.5,101.67521871914956,4
2020-05-23-170327,170327,0,0,0,148,0.16666666666666666,115.3156937225204,5
2020-05-24-170327,170327,0,0,0,148,0.3333333333333333,113.20345558973645,6
2020-05-25-170327,170327,0,0,2,148,1.1666666666666667,95.86693874560902,0
2020-05-26-170327,170327,1,0,1,149,0.6666666666666666,79.34582327449134,1
2020-05-27-170327,170327,1,0,0,150,0.3333333333333333,89.30014779674345,2
2020-05-28-170327,170327,0,0,1,150,2.0,112.97798327045707,3
2020-05-29-170327,170327,0,1,2,150,1.1666666666666667,113.93928907749856,4
2020-05-30-170327,170327,1,0,0,151,0.16666666666666666,117.94004940608583,5
2020-05-31-170327,170327,0,0,0,151,0.16666666666666666,128.49185036388252,6
2020-06-01-170327,170327,0,0,1,151,1.3333333333333333,196.45041289441204,0
2020-06-02-170327,170327,0,0,0,151,2.5,48.32486910405002,1
2020-06-03-170327,170327,0,0,0,151,0.8333333333333334,72.91773403060103,2
2020-06-04-170327,170327,0,0,0,151,1.5,57.929687790853066,3
2020-06-05-170327,170327,1,0,0,152,0.6666666666666666,45.872663969608716,4
2020-06-06-170327,170327,0,0,0,152,0.16666666666666666,59.15623516282281,5
2020-06-07-170327,170327,0,0,0,152,0.3333333333333333,61.57441712016722,6
2020-06-08-170327,170327,2,0,0,154,1.0,64.17440559416293,0
2020-06-09-170327,170327,1,0,1,155,1.1666666666666667,88.55473009853704,1
2020-06-10-170327,170327,0,1,2,155,4.333333333333333,210.33135131390725,2
2020-06-11-170327,170327,1,0,2,156,1.1666666666666667,226.03651481556443,3
2020-06-12-170327,170327,2,0,0,158,1.1666666666666667,203.38606643503027,4
2020-06-13-170327,170327,0,0,0,158,0.0,185.8563953151202,5
2020-06-14-170327,170327,0,0,0,158,0.0,144.02100267107562,6
2020-06-15-170327,170327,1,1,0,159,1.5,120.46105414243658,0
2020-06-16-170327,170327,0,0,0,159,0.5,128.87802785220725,1
2020-06-17-170327,170327,0,0,0,159,1.1666666666666667,119.64581171451574,2
2020-06-18-170327,170327,0,0,0,159,0.3333333333333333,88.14966239190329,3
2020-06-19-170327,170327,0,0,0,159,0.0,69.57726652312165,4
2020-06-20-170327,170327,0,0,0,159,0.0,69.97678534695194,5
2020-06-21-170327,170327,0,0,0,159,0.0,70.26888447512405,6
2020-06-22-170327,170327,0,0,0,159,0.6666666666666666,48.01440741735637,0
2020-06-23-170327,170327,1,0,0,160,1.0,47.865698438479285,1
2020-06-24-170327,170327,2,0,0,162,0.6666666666666666,55.608902352716456,2
2020-06-25-170327,170327,2,0,0,164,1.1666666666666667,69.57139329644168,3
2020-06-26-170327,170327,0,1,0,164,0.3333333333333333,94.44264079011487,4
2020-06-27-170327,170327,0,0,0,164,0.0,77.86493969906107,5
2020-06-28-170327,170327,0,0,0,164,0.0,79.2448715561102,6
2020-06-29-170327,170327,0,0,0,164,0.5,80.32281890648247,0
2020-06-30-170327,170327,0,0,0,164,0.6666666666666666,72.73134680535928,1
2020-07-01-170327,170327,0,0,0,164,0.16666666666666666,112.48322293217608,2
2020-07-02-170327,170327,0,0,0,164,0.5,26.176549298305424,3
2020-07-03-170327,170327,0,0,0,164,0.16666666666666666,25.45839861853719,4
2020-07-04-170327,170327,0,0,0,164,0.0,23.70895868161428,5
2020-07-05-170327,170327,0,0,0,164,0.0,23.249421998170476,6
2020-07-06-170327,170327,0,0,0,164,0.8333333333333334,21.856386856317094,0
2020-07-07-170327,170327,0,0,0,164,0.0,26.847329053130533,1
2020-07-08-170327,170327,0,0,0,164,0.6666666666666666,27.772398127573364,2
2020-07-09-170327,170327,0,0,1,164,0.8333333333333334,36.12291019846798,3
2020-07-10-170327,170327,0,0,0,164,0.16666666666666666,114.80517130046356,4
2020-07-11-170327,170327,0,0,0,164,0.3333333333333333,106.96641218251735,5
2020-07-12-170327,170327,0,0,0,164,0.0,83.94499307862992,6
2020-07-13-170327,170327,0,1,0,164,0.16666666666666666,81.9108774506382,0
2020-07-14-170327,170327,0,0,0,164,0.16666666666666666,81.93095528949542,1
2020-07-15-170327,170327,0,0,0,164,0.16666666666666666,49.26387830421148,2
2020-07-16-170327,170327,0,0,0,164,0.3333333333333333,25.257868417580397,3
2020-07-17-170327,170327,0,0,0,164,0.3333333333333333,24.01115276410018,4
2020-07-18-170327,170327,0,0,0,164,0.16666666666666666,22.10506693294511,5
2020-07-19-170327,170327,0,0,1,164,0.3333333333333333,23.681835190327305,6
2020-07-20-170327,170327,0,0,1,164,0.16666666666666666,29.407475269544797,0
2020-07-21-170327,170327,0,0,1,164,0.3333333333333333,29.440503147156782,1
2020-07-22-170327,170327,0,0,1,164,0.16666666666666666,31.490157339240263,2
2020-07-23-170327,170327,1,0,2,165,0.16666666666666666,30.71376101711543,3
2020-07-24-170327,170327,0,0,0,165,0.5,34.29848034928865,4
2020-07-25-170327,170327,0,0,1,165,0.0,38.745765698553726,5
2020-07-26-170327,170327,0,0,1,165,0.0,33.41826128911296,6
2020-07-27-170327,170327,0,0,1,165,0.3333333333333333,31.142965925650355,0
2020-07-28-170327,170327,0,1,1,165,0.5,30.004793914759514,1
2020-07-29-170327,170327,0,0,0,165,0.0,29.34260773602665,2
2020-07-30-170327,170327,0,0,2,165,0.5,22.13757571652495,3
2020-07-31-170327,170327,0,0,1,165,0.6666666666666666,19.70828295920451,4
2020-08-01-170327,170327,0,0,0,165,0.16666666666666666,41.86898546707765,5
2020-08-02-170327,170327,1,0,0,166,0.16666666666666666,69.58381386889667,6
2020-08-03-170327,170327,1,0,0,167,0.0,314.26468801725673,0
2020-08-04-170327,170327,1,0,0,168,0.3333333333333333,236.29675779040994,1
2020-08-05-170327,170327,1,0,0,169,0.3333333333333333,201.97335490876708,2
2020-08-06-170327,170327,2,0,1,171,1.5,170.70141690006724,3
2020-08-07-170327,170327,0,1,1,171,0.3333333333333333,167.45633891868903,4
2020-08-08-170327,170327,1,0,1,172,0.0,130.7734154000154,5
2020-08-09-170327,170327,1,0,0,173,0.0,131.53719742452842,6
2020-08-10-170327,170327,1,0,1,174,0.5,35.66554849327453,0
2020-08-11-170327,170327,1,0,5,175,0.6666666666666666,55.247862771654724,1
2020-08-12-170327,170327,0,0,1,175,1.0,74.10784987488995,2
2020-08-13-170327,170327,2,0,0,177,0.5,69.89151352715649,3
2020-08-14-170327,170327,1,0,1,178,0.0,85.05446941337715,4
2020-08-15-170327,170327,0,0,1,178,1.1666666666666667,84.37814558326451,5
2020-08-16-170327,170327,0,0,0,178,0.0,83.07084713661351,6
2020-08-17-170327,170327,0,0,2,178,0.0,86.19552297936198,0
2020-08-18-170327,170327,0,0,1,178,0.3333333333333333,73.26201954734627,1
2020-08-19-170327,170327,0,0,3,178,0.16666666666666666,62.51530642435804,2
2020-08-20-170327,170327,1,0,2,179,1.3333333333333333,62.83813598114178,3
2020-08-21-170327,170327,1,0,5,180,0.5,86.77865432886088,4
2020-08-22-170327,170327,1,0,0,181,0.3333333333333333,118.53405965247063,5
2020-08-23-170327,170327,0,0,2,181,0.0,138.55186593170927,6
2020-08-24-170327,170327,1,0,2,182,0.5,142.72059446219765,0
2020-08-25-170327,170327,5,0,0,187,2.6666666666666665,194.1986974256216,1
2020-08-26-170327,170327,1,0,13,188,0.6666666666666666,263.81442237318515,2
2020-08-27-170327,170327,0,0,4,188,3.1666666666666665,299.65407014965047,3
2020-08-28-170327,170327,1,0,6,189,1.3333333333333333,305.67332402991036,4
2020-08-29-170327,170327,1,0,2,190,0.8333333333333334,291.55633824845756,5
2020-08-30-170327,170327,0,0,1,190,3.1666666666666665,298.42849572776447,6
2020-08-31-170327,170327,2,0,1,192,1.5,259.52468280462426,0
2020-09-01-170327,170327,1,0,2,193,1.6666666666666667,120.61810366404366,1
2020-09-02-170327,170327,3,0,4,196,1.8333333333333333,444.8407605300025,2
2020-09-03-170327,170327,2,0,6,198,1.1666666666666667,943.4813528751782,3
2020-09-04-170327,170327,5,0,6,203,2.1666666666666665,566.0480910616947,4
2020-09-05-170327,170327,0,0,1,203,0.0,459.4773241826757,5
2020-09-06-170327,170327,2,0,0,205,1.1666666666666667,428.5444723784507,6
2020-09-07-170327,170327,2,0,13,207,2.333333333333333,419.0036090242907,0
2020-09-08-170327,170327,0,0,6,207,1.3333333333333333,368.9674989874482,1
2020-09-09-170327,170327,13,0,12,220,3.5,297.53486888717845,2
2020-09-10-170327,170327,4,0,63,224,2.833333333333333,98.29214460513266,3
2020-09-11-170327,170327,6,0,16,230,3.1666666666666665,173.71252554876074,4
2020-09-12-170327,170327,2,0,1,232,1.5,273.4343336744418,5
2020-09-13-170327,170327,1,0,3,233,0.8333333333333334,283.3470470304083,6
2020-09-14-170327,170327,1,0,7,234,2.0,299.7960485099293,0
2020-09-15-170327,170327,2,0,16,236,3.0,338.65024716194273,1
2020-09-16-170327,170327,4,0,15,240,2.5,364.2788170579363,2
2020-09-17-170327,170327,6,0,17,246,3.8333333333333335,409.57368469395396,3
2020-09-18-170327,170327,6,0,20,252,2.0,458.2152485692437,4
2020-09-19-170327,170327,1,0,16,253,1.5,403.0445101373736,5
2020-09-20-170327,170327,0,0,1,253,1.5,427.3211085083226,6
2020-09-21-170327,170327,13,1,10,266,2.0,386.2273526610028,0
2020-09-22-170327,170327,6,0,5,272,3.0,454.70484342954256,1
2020-09-23-170327,170327,12,1,9,284,4.666666666666667,466.43581024117566,2
2020-09-24-170327,170327,63,0,6,347,5.333333333333333,445.34608843668616,3
2020-09-25-170327,170327,16,1,13,363,10.0,762.9827208040692,4
2020-09-26-170327,170327,1,1,1,364,2.333333333333333,870.807672500744,5
2020-09-27-170327,170327,3,0,0,367,0.8333333333333334,850.9267522648536,6
2020-09-28-170327,170327,7,1,2,374,2.333333333333333,865.8793031464671,0
2020-09-29-170327,170327,16,1,7,390,2.833333333333333,845.9747814521035,1
2020-09-30-170327,170327,15,1,13,405,7.333333333333332,740.2890268556124,2
2020-10-01-170327,170327,17,1,39,422,7.0,0.0,3
2020-10-02-170327,170327,20,0,6,442,5.166666666666667,966.1543679294035,4
2020-10-03-170327,170327,16,1,3,458,1.5,825.0205577396541,5
2020-10-04-170327,170327,1,2,4,459,1.0,712.4270642167519,6
2020-10-05-170327,170327,10,2,7,469,3.333333333333333,578.1801983631299,0
2020-10-06-170327,170327,5,0,12,474,7.666666666666668,599.3475033738097,1
2020-10-07-170327,170327,9,2,0,483,3.333333333333333,597.5186322070235,2
2020-10-08-170327,170327,6,1,10,489,5.5,571.8982662663843,3
2020-10-09-170327,170327,13,4,41,502,9.666666666666666,599.407236635621,4
2020-10-10-170327,170327,1,0,4,503,2.6666666666666665,164.80257259510716,5
2020-10-11-170327,170327,0,0,2,503,2.6666666666666665,204.3757377021084,6
2020-10-12-170327,170327,2,0,13,505,1.3333333333333333,231.85110835388105,0
2020-10-13-170327,170327,7,0,2,512,8.166666666666666,257.3033136760479,1
2020-10-14-170327,170327,13,0,5,525,5.833333333333332,390.58937457308735,2
2020-10-15-170327,170327,39,0,20,564,7.5,514.2264136545339,3
2020-10-16-170327,170327,6,0,12,570,8.333333333333334,799.363555303853,4
2020-10-17-170327,170327,3,1,2,573,3.333333333333333,771.7329162631623,5
2020-10-18-170327,170327,4,3,2,577,2.333333333333333,781.7623373410675,6
2020-10-19-170327,170327,7,4,0,584,6.666666666666668,809.5230211788945,0
2020-10-20-170327,170327,12,2,5,596,4.0,917.9684487180737,1
2020-10-21-170327,170327,0,0,7,596,6.0,904.383569240667,2
2020-10-22-170327,170327,10,1,11,606,6.166666666666668,680.8316271316196,3
2020-10-23-170327,170327,41,1,10,647,3.333333333333333,692.5924592111608,4
2020-10-24-170327,170327,4,1,10,651,1.6666666666666667,899.0025032484417,5
2020-10-25-170327,170327,2,2,4,653,2.0,880.0123562304925,6
2020-10-26-170327,170327,13,1,12,666,4.833333333333333,801.9682822716877,0
2020-10-27-170327,170327,2,2,15,668,4.833333333333333,808.5850502644126,1
2020-10-28-170327,170327,5,2,13,673,3.0,758.4675223800027,2
2020-10-29-170327,170327,20,1,15,693,6.333333333333332,779.6022460965012,3
2020-10-30-170327,170327,12,0,16,705,7.166666666666668,577.3980633958176,4
2020-10-31-170327,170327,2,2,0,707,3.5,687.0198618722982,5
2020-11-01-170327,170327,2,1,0,709,3.6666666666666665,571.7879738221422,6
2020-11-02-170327,170327,0,2,0,709,1.6666666666666667,779.7109196175178,0
2020-11-03-170327,170327,5,0,0,714,5.833333333333332,587.778519029846,1
2020-11-04-170327,170327,7,1,0,721,2.333333333333333,696.1676993710918,2
2020-11-05-170327,170327,11,2,0,732,9.5,704.4058968424597,3
2020-11-06-170327,170327,10,4,0,742,12.666666666666664,720.7520914958604,4
2020-11-07-170327,170327,10,0,0,752,2.1666666666666665,736.619525654691,5
2020-11-08-170327,170327,4,1,0,756,1.3333333333333333,732.3431283252874,6
2020-11-09-170327,170327,12,0,0,768,10.0,728.7935802791412,0
2020-11-10-170327,170327,15,1,0,783,4.666666666666667,579.8747497628436,1
2020-11-11-170327,170327,13,2,0,796,4.0,692.9182284685425,2
2020-11-12-170327,170327,15,1,0,811,7.833333333333332,757.1549593069659,3
2020-11-13-170327,170327,16,1,0,827,7.5,813.0334151369846,4
2020-03-01-170328,170328,0,0,2,0,0.25,0.0,6
2020-03-02-170328,170328,0,0,3,0,0.0,80.21886048709257,0
2020-03-03-170328,170328,0,0,33,0,0.0,313.7347879397869,1
2020-03-04-170328,170328,0,0,18,0,0.0,358.73733680798904,2
2020-03-05-170328,170328,0,0,26,0,0.0,361.62254164347524,3
2020-03-06-170328,170328,0,0,19,0,0.0,318.12827959510065,4
2020-03-07-170328,170328,0,0,2,0,0.0,348.4210117318821,5
2020-03-08-170328,170328,0,0,6,0,0.0,366.0392650639052,6
2020-03-09-170328,170328,0,0,28,0,0.0,366.17466244446683,0
2020-03-10-170328,170328,0,0,32,0,0.0,980.5307977250535,1
2020-03-11-170328,170328,1,0,25,1,0.0,848.6571753008805,2
2020-03-12-170328,170328,0,0,42,1,0.5,681.0528272023977,3
2020-03-13-170328,170328,0,0,15,1,0.0,442.3961193237192,4
2020-03-14-170328,170328,1,0,6,2,1.0,394.80574059149353,5
2020-03-15-170328,170328,2,0,3,4,1.25,327.2927173792333,6
2020-03-16-170328,170328,3,0,17,7,12.75,36.04506450369103,0
2020-03-17-170328,170328,33,0,31,40,12.25,126.14707961126837,1
2020-03-18-170328,170328,18,0,11,58,15.5,277.9105435237029,2
2020-03-19-170328,170328,26,0,7,84,14.75,390.67735590435666,3
2020-03-20-170328,170328,19,0,10,103,13.5,498.0152432556759,4
2020-03-21-170328,170328,2,0,2,105,3.75,565.1380497362247,5
2020-03-22-170328,170328,6,0,1,111,3.75,556.7599051488648,6
2020-03-23-170328,170328,28,0,15,139,22.25,516.7596351937545,0
2020-03-24-170328,170328,32,0,7,171,13.5,554.7817172196973,1
2020-03-25-170328,170328,25,0,9,196,14.5,572.0299524301116,2
2020-03-26-170328,170328,42,0,11,238,8.75,558.3168507268889,3
2020-03-27-170328,170328,15,0,8,253,21.25,693.7054017968127,4
2020-03-28-170328,170328,6,0,2,259,3.75,705.1080422629191,5
2020-03-29-170328,170328,3,0,1,262,3.5,707.4378974442267,6
2020-03-30-170328,170328,17,0,8,279,13.75,536.7603897990755,0
2020-03-31-170328,170328,31,0,11,310,11.75,512.9928578496756,1
2020-04-01-170328,170328,11,0,15,321,10.0,100.06346546815018,2
2020-04-02-170328,170328,7,0,6,328,8.25,343.4389827521105,3
2020-04-03-170328,170328,10,0,9,338,8.75,168.12672793305794,4
2020-04-04-170328,170328,2,0,1,340,2.25,191.2051948309413,5
2020-04-05-170328,170328,1,0,0,341,1.25,189.99802667274503,6
2020-04-06-170328,170328,15,1,10,356,7.5,196.49515836377924,0
2020-04-07-170328,170328,7,3,4,363,7.5,241.91951464146814,1
2020-04-08-170328,170328,9,2,7,372,15.0,272.02731226781066,2
2020-04-09-170328,170328,11,0,0,383,5.25,306.03625118984405,3
2020-04-10-170328,170328,8,0,8,391,13.0,62.025687011325644,4
2020-04-11-170328,170328,2,0,1,393,1.75,116.0879943343334,5
2020-04-12-170328,170328,1,1,1,394,3.5,126.19611589299382,6
2020-04-13-170328,170328,8,0,5,402,14.0,139.65453805959214,0
2020-04-14-170328,170328,11,0,5,413,8.5,218.4282523103276,1
2020-04-15-170328,170328,15,0,9,428,10.5,289.7679660462241,2
2020-04-16-170328,170328,6,0,15,434,8.75,364.296055642654,3
2020-04-17-170328,170328,9,0,0,443,3.75,376.5145569707435,4
2020-04-18-170328,170328,1,0,2,444,0.75,381.03785612288914,5
2020-04-19-170328,170328,0,0,0,444,0.75,375.61358635161446,6
2020-04-20-170328,170328,10,2,11,454,8.25,335.18653199116727,0
2020-04-21-170328,170328,4,0,6,458,13.75,323.35952357230815,1
2020-04-22-170328,170328,7,0,2,465,2.5,293.33577892979855,2
2020-04-23-170328,170328,0,0,3,465,1.0,273.90947496439804,3
2020-04-24-170328,170328,8,1,3,473,4.25,221.21448118821866,4
2020-04-25-170328,170328,1,0,1,474,2.0,277.52625304831247,5
2020-04-26-170328,170328,1,0,0,475,0.5,286.6900318747333,6
2020-04-27-170328,170328,5,0,5,480,2.75,239.21551133167213,0
2020-04-28-170328,170328,5,0,7,485,3.25,209.00132455264333,1
2020-04-29-170328,170328,9,0,21,494,2.25,189.56927201695373,2
2020-04-30-170328,170328,15,0,5,509,3.0,229.74784586437963,3
2020-05-01-170328,170328,0,0,3,509,0.25,327.1462306133455,4
2020-05-02-170328,170328,2,0,0,511,1.25,139.54956843965314,5
2020-05-03-170328,170328,0,0,0,511,1.0,95.4374150721747,6
2020-05-04-170328,170328,11,0,5,522,3.25,75.89145039345192,0
2020-05-05-170328,170328,6,0,4,528,1.0,100.20050670890606,1
2020-05-06-170328,170328,2,0,3,530,4.0,108.70622409657776,2
2020-05-07-170328,170328,3,0,5,533,2.0,112.87447672324313,3
2020-05-08-170328,170328,3,0,3,536,4.25,116.76585709016538,4
2020-05-09-170328,170328,1,0,1,537,0.5,147.07758982790563,5
2020-05-10-170328,170328,0,3,0,537,0.0,312.9215593747022,6
2020-05-11-170328,170328,5,1,7,542,2.5,298.3770307232847,0
2020-05-12-170328,170328,7,0,2,549,1.75,313.4064822119451,1
2020-05-13-170328,170328,21,0,3,570,0.5,251.93039637725133,2
2020-05-14-170328,170328,5,3,2,575,3.25,233.5624124280628,3
2020-05-15-170328,170328,3,0,2,578,2.75,190.15111392895372,4
2020-05-16-170328,170328,0,0,1,578,0.0,154.6897015600656,5
2020-05-17-170328,170328,0,0,1,578,0.25,156.55424529329892,6
2020-05-18-170328,170328,5,0,4,583,2.0,159.60988938058873,0
2020-05-19-170328,170328,4,0,4,587,3.0,157.68626015450678,1
2020-05-20-170328,170328,3,0,4,590,1.5,123.92160569737452,2
2020-05-21-170328,170328,5,0,8,595,2.25,110.03918491809866,3
2020-05-22-170328,170328,3,0,2,598,3.25,118.51178288174184,4
2020-05-23-170328,170328,1,0,1,599,0.0,151.44022144893614,5
2020-05-24-170328,170328,0,0,1,599,0.5,154.1045710266234,6
2020-05-25-170328,170328,7,0,5,606,2.25,134.32264083058564,0
2020-05-26-170328,170328,2,0,3,608,1.0,137.07885019923953,1
2020-05-27-170328,170328,3,0,0,611,1.75,141.1556017197547,2
2020-05-28-170328,170328,2,0,3,613,1.25,144.43574318597183,3
2020-05-29-170328,170328,2,1,3,615,1.25,137.22809106083787,4
2020-05-30-170328,170328,1,0,2,616,0.25,122.57535524733572,5
2020-05-31-170328,170328,1,0,0,617,0.75,125.64336909312406,6
2020-06-01-170328,170328,4,0,2,621,3.25,178.1851945111356,0
2020-06-02-170328,170328,4,0,4,625,2.75,66.44454524180043,1
2020-06-03-170328,170328,4,0,1,629,2.75,41.739179937332125,2
2020-06-04-170328,170328,8,0,3,637,1.5,58.15906058470391,3
2020-06-05-170328,170328,2,0,0,639,1.75,81.04750042760878,4
2020-06-06-170328,170328,1,0,0,640,0.0,99.49220626503427,5
2020-06-07-170328,170328,1,0,0,641,0.0,101.40436204412816,6
2020-06-08-170328,170328,5,0,2,646,1.0,104.60581996954164,0
2020-06-09-170328,170328,3,0,1,649,1.75,127.327754469579,1
2020-06-10-170328,170328,0,0,1,649,2.75,208.18638478869488,2
2020-06-11-170328,170328,3,0,2,652,2.5,189.61324826726548,3
2020-06-12-170328,170328,3,0,3,655,1.25,183.11396381874917,4
2020-06-13-170328,170328,2,0,0,657,0.25,174.98403893192594,5
2020-06-14-170328,170328,0,0,0,657,0.25,154.1094934520529,6
2020-06-15-170328,170328,2,0,0,659,0.0,123.04685643354077,0
2020-06-16-170328,170328,4,0,0,663,0.75,126.86515444824414,1
2020-06-17-170328,170328,1,0,1,664,1.25,110.33457489358324,2
2020-06-18-170328,170328,3,0,0,667,0.75,93.34481556847904,3
2020-06-19-170328,170328,0,0,4,667,1.0,77.35065062831373,4
2020-06-20-170328,170328,0,0,0,667,0.0,90.78987245509106,5
2020-06-21-170328,170328,0,0,1,667,0.0,88.88657773159332,6
2020-06-22-170328,170328,2,0,3,669,0.5,79.31494150499786,0
2020-06-23-170328,170328,1,0,1,670,1.5,69.22219806470207,1
2020-06-24-170328,170328,1,0,2,671,0.5,72.08598494984204,2
2020-06-25-170328,170328,2,0,1,673,1.75,64.62869143112948,3
2020-06-26-170328,170328,3,0,4,676,0.0,63.919652753331825,4
2020-06-27-170328,170328,0,0,2,676,0.25,44.0856315114405,5
2020-06-28-170328,170328,0,0,0,676,0.0,44.56859816331271,6
2020-06-29-170328,170328,0,0,2,676,0.25,44.33606404567645,0
2020-06-30-170328,170328,0,0,2,676,0.75,58.41171211044645,1
2020-07-01-170328,170328,1,0,2,677,0.25,125.79026151619578,2
2020-07-02-170328,170328,0,0,3,677,0.5,36.843334862386314,3
2020-07-03-170328,170328,4,0,0,681,0.25,43.270386019154934,4
2020-07-04-170328,170328,0,0,0,681,0.0,59.27423526990535,5
2020-07-05-170328,170328,1,0,0,682,0.25,55.550815910906294,6
2020-07-06-170328,170328,3,0,0,685,0.5,50.41387375696039,0
2020-07-07-170328,170328,1,0,0,686,1.0,49.48702504938323,1
2020-07-08-170328,170328,2,0,2,688,0.25,47.08106107951731,2
2020-07-09-170328,170328,1,0,0,689,0.25,42.56384254045869,3
2020-07-10-170328,170328,4,1,0,693,0.25,123.99140716227518,4
2020-07-11-170328,170328,2,0,0,695,0.0,105.52405283502526,5
2020-07-12-170328,170328,0,0,0,695,0.25,83.71280535427806,6
2020-07-13-170328,170328,2,0,1,697,0.75,82.22216816336955,0
2020-07-14-170328,170328,2,0,2,699,0.0,90.42203557608175,1
2020-07-15-170328,170328,2,0,4,701,1.0,66.25237845670223,2
2020-07-16-170328,170328,3,0,0,704,0.5,41.02150605193406,3
2020-07-17-170328,170328,0,0,1,704,0.75,40.42113125148397,4
2020-07-18-170328,170328,0,0,0,704,0.25,37.87156734064534,5
2020-07-19-170328,170328,0,0,0,704,0.25,34.73054295193936,6
2020-07-20-170328,170328,0,0,0,704,2.5,27.50219654854915,0
2020-07-21-170328,170328,0,1,2,704,0.75,37.93462458594652,1
2020-07-22-170328,170328,2,1,0,706,1.5,38.538622026580704,2
2020-07-23-170328,170328,0,0,0,706,0.75,45.4522318912709,3
2020-07-24-170328,170328,0,0,3,706,1.5,41.46060355319436,4
2020-07-25-170328,170328,0,0,0,706,0.0,45.617914309773404,5
2020-07-26-170328,170328,0,0,0,706,0.5,43.64436737001527,6
2020-07-27-170328,170328,1,0,1,707,0.5,44.35291699067975,0
2020-07-28-170328,170328,2,0,2,709,1.25,38.17924690067957,1
2020-07-29-170328,170328,4,1,2,713,0.5,42.60354515853434,2
2020-07-30-170328,170328,0,0,1,713,1.25,44.54213714825676,3
2020-07-31-170328,170328,1,0,4,714,1.0,46.66219299088026,4
2020-08-01-170328,170328,0,0,0,714,0.25,37.4958691466114,5
2020-08-02-170328,170328,0,0,1,714,0.0,74.51002324625681,6
2020-08-03-170328,170328,0,0,0,714,1.0,247.22611284038305,0
2020-08-04-170328,170328,2,0,1,716,1.0,235.75579094378787,1
2020-08-05-170328,170328,0,0,5,716,1.0,201.44685846582468,2
2020-08-06-170328,170328,0,0,2,716,1.25,168.91053046865707,3
2020-08-07-170328,170328,3,0,3,719,1.25,128.71406384231685,4
2020-08-08-170328,170328,0,0,0,719,0.25,112.1740184925853,5
2020-08-09-170328,170328,0,0,2,719,0.0,103.81541293457303,6
2020-08-10-170328,170328,1,0,1,720,1.5,30.49425139796962,0
2020-08-11-170328,170328,2,0,9,722,0.5,38.84587349739602,1
2020-08-12-170328,170328,2,0,9,724,1.0,46.56151565192546,2
2020-08-13-170328,170328,1,0,9,725,0.25,49.037745794776114,3
2020-08-14-170328,170328,4,0,5,729,0.5,49.098573679279156,4
2020-08-15-170328,170328,0,0,4,729,0.0,51.30880795381856,5
2020-08-16-170328,170328,1,0,1,730,0.75,47.71215888012202,6
2020-08-17-170328,170328,0,0,4,730,0.75,53.54335427189882,0
2020-08-18-170328,170328,1,0,1,731,2.0,57.1392357570197,1
2020-08-19-170328,170328,5,0,0,736,1.5,61.65882265138647,2
2020-08-20-170328,170328,2,0,3,738,3.0,67.43538419951183,3
2020-08-21-170328,170328,3,0,5,741,2.5,72.4651880400332,4
2020-08-22-170328,170328,0,0,3,741,0.25,98.00760238625752,5
2020-08-23-170328,170328,2,0,3,743,2.25,102.54262697285284,6
2020-08-24-170328,170328,1,0,9,744,1.75,106.00970349367222,0
2020-08-25-170328,170328,9,0,8,753,4.0,111.1295378875345,1
2020-08-26-170328,170328,9,0,12,762,3.5,129.57266002193592,2
2020-08-27-170328,170328,9,0,15,771,4.0,171.23334363325705,3
2020-08-28-170328,170328,5,0,13,776,3.75,199.23351159468453,4
2020-08-29-170328,170328,4,0,5,780,2.75,216.66961075994703,5
2020-08-30-170328,170328,1,0,9,781,4.0,230.1659040620504,6
2020-08-31-170328,170328,4,0,13,785,5.5,230.70369259406152,0
2020-09-01-170328,170328,1,0,12,786,3.0,81.25070806422633,1
2020-09-02-170328,170328,0,0,8,786,3.0,428.55104435298995,2
2020-09-03-170328,170328,3,0,12,789,4.75,434.24481085063013,3
2020-09-04-170328,170328,5,1,11,794,4.0,395.8841570250406,4
2020-09-05-170328,170328,3,0,10,797,3.0,364.18756843414644,5
2020-09-06-170328,170328,3,0,7,800,6.5,365.4088803215343,6
2020-09-07-170328,170328,9,0,21,809,6.25,390.1399705911648,0
2020-09-08-170328,170328,8,0,7,817,4.75,344.2535051726926,1
2020-09-09-170328,170328,12,0,11,829,8.75,334.7396466540587,2
2020-09-10-170328,170328,15,0,6,844,8.0,69.99454154002004,3
2020-09-11-170328,170328,13,0,9,857,6.75,153.69030992036357,4
2020-09-12-170328,170328,5,0,7,862,3.25,251.4669255574787,5
2020-09-13-170328,170328,9,0,1,871,6.25,274.37710745709717,6
2020-09-14-170328,170328,13,0,13,884,7.0,311.9836484123418,0
2020-09-15-170328,170328,12,0,9,896,8.0,392.55372273859837,1
2020-09-16-170328,170328,8,0,9,904,7.75,449.15060908255066,2
2020-09-17-170328,170328,12,0,12,916,8.25,506.1175079824398,3
2020-09-18-170328,170328,11,0,16,927,6.25,500.41716692796206,4
2020-09-19-170328,170328,10,1,5,937,4.0,458.2915287894552,5
2020-09-20-170328,170328,7,0,6,944,3.0,429.0486507671986,6
2020-09-21-170328,170328,21,1,3,965,8.0,372.3049508661759,0
2020-09-22-170328,170328,7,3,11,972,6.75,402.8140193282414,1
2020-09-23-170328,170328,11,0,18,983,12.0,394.4808994398575,2
2020-09-24-170328,170328,6,2,18,989,11.0,391.9161208719478,3
2020-09-25-170328,170328,9,0,16,998,10.0,429.57291491543947,4
2020-09-26-170328,170328,7,1,6,1005,1.75,471.13525719417066,5
2020-09-27-170328,170328,1,0,3,1006,2.0,483.1430965054244,6
2020-09-28-170328,170328,13,0,13,1019,12.25,475.31559704443634,0
2020-09-29-170328,170328,9,0,29,1028,7.0,486.1359454007188,1
2020-09-30-170328,170328,9,0,19,1037,12.5,432.5534555694384,2
2020-10-01-170328,170328,12,0,16,1049,25.5,0.0,3
2020-10-02-170328,170328,16,0,37,1065,14.75,946.3024780086033,4
2020-10-03-170328,170328,5,0,4,1070,4.5,798.1711161752014,5
2020-10-04-170328,170328,6,2,16,1076,5.5,788.243831350072,6
2020-10-05-170328,170328,3,1,8,1079,3.0,650.3888018584494,0
2020-10-06-170328,170328,11,0,24,1090,15.25,569.1793617241858,1
2020-10-07-170328,170328,18,0,18,1108,7.0,543.6467244399483,2
2020-10-08-170328,170328,18,0,19,1126,13.5,499.27933998461305,3
2020-10-09-170328,170328,16,0,23,1142,12.75,570.6905125782212,4
2020-10-10-170328,170328,6,0,10,1148,3.25,145.23927111547974,5
2020-10-11-170328,170328,3,0,5,1151,2.5,172.0097246534255,6
2020-10-12-170328,170328,13,0,33,1164,4.25,189.6257231901677,0
2020-10-13-170328,170328,29,0,10,1193,26.0,227.06722994698106,1
2020-10-14-170328,170328,19,0,25,1212,14.75,416.3939562823751,2
2020-10-15-170328,170328,16,0,11,1228,19.0,526.2032591664595,3
2020-10-16-170328,170328,37,0,13,1265,15.75,665.9503265940485,4
2020-10-17-170328,170328,4,0,4,1269,4.75,697.8210936291873,5
2020-10-18-170328,170328,16,0,26,1285,2.0,701.7043929153284,6
2020-10-19-170328,170328,8,0,2,1293,23.25,740.921052689562,0
2020-10-20-170328,170328,24,0,19,1317,9.5,796.8117684622441,1
2020-10-21-170328,170328,18,1,10,1335,14.0,801.593386119787,2
2020-10-22-170328,170328,19,0,14,1354,8.5,804.6245503377133,3
2020-10-23-170328,170328,23,2,27,1377,13.25,755.4440688972157,4
2020-10-24-170328,170328,10,1,7,1387,5.25,874.1146336883276,5
2020-10-25-170328,170328,5,0,16,1392,3.75,869.2776372631702,6
2020-10-26-170328,170328,33,0,40,1425,12.25,729.5916196747492,0
2020-10-27-170328,170328,10,0,19,1435,11.0,797.1160022330503,1
2020-10-28-170328,170328,25,0,10,1460,10.5,754.7728455006259,2
2020-10-29-170328,170328,11,1,11,1471,21.0,764.8227545471142,3
2020-10-30-170328,170328,13,0,14,1484,13.25,658.0313876046356,4
2020-10-31-170328,170328,4,1,0,1488,5.0,769.3682972239417,5
2020-11-01-170328,170328,26,2,0,1514,5.25,606.9453930997969,6
2020-11-02-170328,170328,2,0,0,1516,4.0,618.7790166328497,0
2020-11-03-170328,170328,19,1,0,1535,21.25,540.1274022292527,1
2020-11-04-170328,170328,10,1,0,1545,9.25,736.9487398732866,2
2020-11-05-170328,170328,14,6,0,1559,14.25,682.5612562970559,3
2020-11-06-170328,170328,27,1,0,1586,16.25,738.3766636138133,4
2020-11-07-170328,170328,7,0,0,1593,3.75,805.0589772034389,5
2020-11-08-170328,170328,16,3,0,1609,9.5,741.9327827700934,6
2020-11-09-170328,170328,40,2,0,1649,23.0,769.5411376737995,0
2020-11-10-170328,170328,19,0,0,1668,11.5,624.8858465912137,1
2020-11-11-170328,170328,10,3,0,1678,10.25,720.7964611884515,2
2020-11-12-170328,170328,11,2,0,1689,14.75,806.907783583205,3
2020-11-13-170328,170328,14,0,0,1703,15.75,799.1364882054565,4
2020-03-01-170401,170401,0,0,1,0,0.0,0.0,6
2020-03-02-170401,170401,0,0,3,0,0.0,63.78497199431568,0
2020-03-03-170401,170401,0,0,1,0,0.0,291.4184318837516,1
2020-03-04-170401,170401,0,3,13,0,0.0,314.1875621367519,2
2020-03-05-170401,170401,0,0,10,0,0.0,323.05475145403904,3
2020-03-06-170401,170401,0,1,3,0,0.2,310.95189809863064,4
2020-03-07-170401,170401,0,0,2,0,0.0,316.65892968607955,5
2020-03-08-170401,170401,0,0,13,0,0.0,281.48545712096575,6
2020-03-09-170401,170401,0,0,9,0,0.0,287.12446486041136,0
2020-03-10-170401,170401,0,0,12,0,0.0,657.2509452720788,1
2020-03-11-170401,170401,0,0,15,0,0.0,506.63574253150585,2
2020-03-12-170401,170401,0,0,16,0,0.2,401.16112651913437,3
2020-03-13-170401,170401,0,0,10,0,0.2,272.33151175544606,4
2020-03-14-170401,170401,0,0,6,0,0.4,176.66615946924952,5
2020-03-15-170401,170401,1,0,6,1,0.2,119.45954260068287,6
2020-03-16-170401,170401,3,0,12,4,1.2,37.80236928341213,0
2020-03-17-170401,170401,1,0,10,5,3.2,77.07442018505674,1
2020-03-18-170401,170401,13,0,6,18,2.2,172.2559133542199,2
2020-03-19-170401,170401,10,0,9,28,3.4,265.76648437759593,3
2020-03-20-170401,170401,3,0,8,31,2.6,354.5035817432501,4
2020-03-21-170401,170401,2,0,12,33,1.6,376.0574940889611,5
2020-03-22-170401,170401,13,0,5,46,1.6,365.91204485370554,6
2020-03-23-170401,170401,9,0,14,55,4.8,397.6978880780039,0
2020-03-24-170401,170401,12,0,7,67,5.6,414.6225910288225,1
2020-03-25-170401,170401,15,0,6,82,7.8,455.9887163400796,2
2020-03-26-170401,170401,16,0,7,98,6.2,502.2803782909461,3
2020-03-27-170401,170401,10,0,7,108,5.8,607.2098203957947,4
2020-03-28-170401,170401,6,0,4,114,2.6,628.1844879505629,5
2020-03-29-170401,170401,6,0,1,120,5.6,651.782370829824,6
2020-03-30-170401,170401,12,0,8,132,4.6,541.0626989685784,0
2020-03-31-170401,170401,10,0,10,142,4.6,494.034645383544,1
2020-04-01-170401,170401,6,0,6,148,3.8,80.43265289572292,2
2020-04-02-170401,170401,9,0,7,157,3.2,203.92894683663351,3
2020-04-03-170401,170401,8,0,3,165,2.0,124.03625238547124,4
2020-04-04-170401,170401,12,0,2,177,2.8,148.7770388140363,5
2020-04-05-170401,170401,5,0,1,182,0.4,179.65758962160083,6
2020-04-06-170401,170401,14,5,4,196,2.4,187.41076213005817,0
2020-04-07-170401,170401,7,0,7,203,2.6,250.45566870654073,1
2020-04-08-170401,170401,6,0,0,209,2.6,289.90209337130875,2
2020-04-09-170401,170401,7,0,3,216,5.2,317.46098200902554,3
2020-04-10-170401,170401,7,0,2,223,0.6,52.65292252112896,4
2020-04-11-170401,170401,4,0,4,227,0.8,82.98546304819229,5
2020-04-12-170401,170401,1,0,2,228,0.4,106.65444396080122,6
2020-04-13-170401,170401,8,0,2,236,1.4,117.2176218208565,0
2020-04-14-170401,170401,10,0,3,246,2.4,175.59370593821765,1
2020-04-15-170401,170401,6,0,4,252,1.2,216.17666896766616,2
2020-04-16-170401,170401,7,0,3,259,1.0,244.90941038688266,3
2020-04-17-170401,170401,3,0,6,262,2.6,228.947211558525,4
2020-04-18-170401,170401,2,0,3,264,0.2,238.10875054231718,5
2020-04-19-170401,170401,1,0,3,265,0.4,222.00397906434915,6
2020-04-20-170401,170401,4,0,5,269,1.8,222.2949312189093,0
2020-04-21-170401,170401,7,0,3,276,1.0,208.64011235366578,1
2020-04-22-170401,170401,0,0,5,276,2.6,216.59699798734084,2
2020-04-23-170401,170401,3,0,4,279,0.4,211.45772084622786,3
2020-04-24-170401,170401,2,0,2,281,2.6,185.4809531336245,4
2020-04-25-170401,170401,4,0,5,285,0.2,207.3365747123746,5
2020-04-26-170401,170401,2,0,2,287,0.4,211.7270789345398,6
2020-04-27-170401,170401,2,1,4,289,1.2,156.667766932338,0
2020-04-28-170401,170401,3,0,2,292,1.2,143.1234433869953,1
2020-04-29-170401,170401,4,0,4,296,1.8,137.18878939491285,2
2020-04-30-170401,170401,3,0,1,299,1.0,175.14633457861186,3
2020-05-01-170401,170401,6,0,6,305,0.4,340.4422106545285,4
2020-05-02-170401,170401,3,0,0,308,0.2,106.48686431066342,5
2020-05-03-170401,170401,3,0,2,311,0.4,142.06736788037801,6
2020-05-04-170401,170401,5,0,7,316,2.0,133.18839521557783,0
2020-05-05-170401,170401,3,0,3,319,1.0,147.96436872334073,1
2020-05-06-170401,170401,5,0,2,324,0.8,136.73048280300435,2
2020-05-07-170401,170401,4,0,0,328,0.4,126.67572095348817,3
2020-05-08-170401,170401,2,0,6,330,2.0,118.7730718816892,4
2020-05-09-170401,170401,5,0,0,335,1.2,138.83907858440026,5
2020-05-10-170401,170401,2,1,1,337,0.4,403.7630423187777,6
2020-05-11-170401,170401,4,1,2,341,1.0,355.3532641576657,0
2020-05-12-170401,170401,2,1,1,343,1.6,360.3878633075112,1
2020-05-13-170401,170401,4,0,10,347,0.8,293.55826513102625,2
2020-05-14-170401,170401,1,0,6,348,1.2,238.73206351405437,3
2020-05-15-170401,170401,6,0,4,354,1.4,191.86638313460833,4
2020-05-16-170401,170401,0,0,0,354,0.2,164.99599442597733,5
2020-05-17-170401,170401,2,0,0,356,0.0,137.94634363291996,6
2020-05-18-170401,170401,7,0,1,363,0.6,138.37212949666036,0
2020-05-19-170401,170401,3,0,5,366,0.6,150.07589905627998,1
2020-05-20-170401,170401,2,0,7,368,0.8,128.50673519162552,2
2020-05-21-170401,170401,0,0,1,368,1.0,135.65052754219488,3
2020-05-22-170401,170401,6,0,4,374,1.0,108.96680764734481,4
2020-05-23-170401,170401,0,0,0,374,0.4,144.3388878441237,5
2020-05-24-170401,170401,1,0,2,375,0.0,138.4120380250185,6
2020-05-25-170401,170401,2,0,7,377,0.2,106.24308358690766,0
2020-05-26-170401,170401,1,0,6,378,0.8,110.7972357153779,1
2020-05-27-170401,170401,10,0,3,388,0.6,115.05796086992757,2
2020-05-28-170401,170401,6,0,3,394,2.0,158.38738834088468,3
2020-05-29-170401,170401,4,0,4,398,1.4,204.0964773103024,4
2020-05-30-170401,170401,0,0,0,398,0.0,216.6249722524878,5
2020-05-31-170401,170401,0,0,0,398,0.0,214.40334332693266,6
2020-06-01-170401,170401,1,0,5,399,1.4,212.7214122293554,0
2020-06-02-170401,170401,5,0,3,404,1.2,91.24059019951558,1
2020-06-03-170401,170401,7,0,3,411,0.4,95.99620634787293,2
2020-06-04-170401,170401,1,0,0,412,1.0,107.56222399790482,3
2020-06-05-170401,170401,4,0,3,416,0.8,100.48044265794425,4
2020-06-06-170401,170401,0,0,1,416,0.0,117.11815275215379,5
2020-06-07-170401,170401,2,0,0,418,0.0,119.16677162581126,6
2020-06-08-170401,170401,7,0,2,425,0.8,129.58301275707097,0
2020-06-09-170401,170401,6,1,7,431,1.6,149.8398870242461,1
2020-06-10-170401,170401,3,0,2,434,0.4,257.9369457942679,2
2020-06-11-170401,170401,3,0,4,437,0.8,246.75944072391286,3
2020-06-12-170401,170401,4,0,2,441,0.4,222.92291878198046,4
2020-06-13-170401,170401,0,1,0,441,0.0,206.354579934789,5
2020-06-14-170401,170401,0,0,1,441,0.0,178.67848628345797,6
2020-06-15-170401,170401,5,0,3,446,0.0,146.62114090940452,0
2020-06-16-170401,170401,3,1,3,449,1.4,146.9761549521681,1
2020-06-17-170401,170401,3,0,0,452,0.6,127.78839742135257,2
2020-06-18-170401,170401,0,0,1,452,0.2,115.05012346092559,3
2020-06-19-170401,170401,3,0,3,455,0.2,98.56729155586333,4
2020-06-20-170401,170401,1,0,1,456,0.0,124.19217090127697,5
2020-06-21-170401,170401,0,0,0,456,0.0,130.68424665090438,6
2020-06-22-170401,170401,2,0,0,458,0.2,100.17434996534374,0
2020-06-23-170401,170401,7,0,1,465,0.0,91.4261210680512,1
2020-06-24-170401,170401,2,0,1,467,0.2,107.99572169535458,2
2020-06-25-170401,170401,4,0,1,471,0.0,122.19420942680061,3
2020-06-26-170401,170401,2,0,2,473,0.2,127.49651968838435,4
2020-06-27-170401,170401,0,0,0,473,0.0,105.15254852580232,5
2020-06-28-170401,170401,1,0,0,474,0.0,101.33276643429073,6
2020-06-29-170401,170401,3,0,1,477,0.2,101.60499504236451,0
2020-06-30-170401,170401,3,0,1,480,0.2,119.34771322649902,1
2020-07-01-170401,170401,0,0,3,480,0.2,157.64877731638128,2
2020-07-02-170401,170401,1,0,3,481,0.2,95.26433862652706,3
2020-07-03-170401,170401,3,0,2,484,0.2,100.05400282529548,4
2020-07-04-170401,170401,1,0,0,485,0.0,118.43132571701425,5
2020-07-05-170401,170401,0,0,1,485,0.2,122.08862001476646,6
2020-07-06-170401,170401,0,0,4,485,0.0,118.99544901528458,0
2020-07-07-170401,170401,1,0,1,486,0.2,99.9356767179816,1
2020-07-08-170401,170401,1,1,3,487,0.4,79.7064415927965,2
2020-07-09-170401,170401,1,0,4,488,0.2,71.63249921731061,3
2020-07-10-170401,170401,2,0,2,490,0.0,138.87215414098776,4
2020-07-11-170401,170401,0,0,3,490,0.0,134.05869893455986,5
2020-07-12-170401,170401,0,0,0,490,0.0,104.84481911152548,6
2020-07-13-170401,170401,1,0,0,491,0.4,104.015278449153,0
2020-07-14-170401,170401,1,0,4,492,0.4,114.4724804490083,1
2020-07-15-170401,170401,3,0,4,495,0.4,79.74429619437083,2
2020-07-16-170401,170401,3,0,5,498,0.2,63.238055311334925,3
2020-07-17-170401,170401,2,0,2,500,0.0,81.80138731560086,4
2020-07-18-170401,170401,0,1,0,500,0.2,88.58401660429506,5
2020-07-19-170401,170401,1,0,2,501,0.0,96.0889654749495,6
2020-07-20-170401,170401,4,0,4,505,0.0,82.44519568351107,0
2020-07-21-170401,170401,1,0,5,506,0.0,103.58115167664437,1
2020-07-22-170401,170401,3,0,9,509,0.2,94.95443205049925,2
2020-07-23-170401,170401,4,0,3,513,0.0,96.87001420238576,3
2020-07-24-170401,170401,2,0,6,515,0.0,103.00630484645579,4
2020-07-25-170401,170401,3,0,0,518,0.0,102.02881880417881,5
2020-07-26-170401,170401,0,0,0,518,0.0,115.95136526117481,6
2020-07-27-170401,170401,0,0,4,518,0.0,108.87157273451633,0
2020-07-28-170401,170401,4,0,0,522,0.0,82.20920476447829,1
2020-07-29-170401,170401,4,0,4,526,0.0,95.37032752602036,2
2020-07-30-170401,170401,5,0,2,531,0.2,94.55420875997433,3
2020-07-31-170401,170401,2,0,0,533,0.2,122.35401293267381,4
2020-08-01-170401,170401,0,0,0,533,0.0,45.348576079862156,5
2020-08-02-170401,170401,2,0,0,535,0.2,123.47042798557897,6
2020-08-03-170401,170401,4,0,1,539,0.0,267.19522039938056,0
2020-08-04-170401,170401,5,0,3,544,0.4,269.86451591308054,1
2020-08-05-170401,170401,9,0,3,553,0.2,239.3525583596942,2
2020-08-06-170401,170401,3,0,4,556,0.2,262.2684058928721,3
2020-08-07-170401,170401,6,0,1,562,0.6,223.06233639701298,4
2020-08-08-170401,170401,0,0,4,562,0.4,237.98960664190832,5
2020-08-09-170401,170401,0,0,1,562,0.0,217.98713131933607,6
2020-08-10-170401,170401,4,0,4,566,0.8,46.657299496916,0
2020-08-11-170401,170401,0,0,4,566,1.0,80.76261188897776,1
2020-08-12-170401,170401,4,0,0,570,0.8,85.15093751787593,2
2020-08-13-170401,170401,2,0,3,572,1.0,110.27250404814467,3
2020-08-14-170401,170401,0,0,1,572,0.0,121.2925228414752,4
2020-08-15-170401,170401,0,0,2,572,0.2,123.7377268019319,5
2020-08-16-170401,170401,0,0,0,572,1.0,117.9069795983276,6
2020-08-17-170401,170401,1,0,6,573,0.4,123.33435644745589,0
2020-08-18-170401,170401,3,0,3,576,1.8,94.25760480332896,1
2020-08-19-170401,170401,3,0,1,579,0.6,117.87747496027856,2
2020-08-20-170401,170401,4,1,4,583,1.0,125.69448171779197,3
2020-08-21-170401,170401,1,0,3,584,0.2,146.26977478582555,4
2020-08-22-170401,170401,4,0,4,588,0.6,153.23971990898013,5
2020-08-23-170401,170401,1,0,6,589,0.0,157.68129228396774,6
2020-08-24-170401,170401,4,0,0,593,0.8,153.96055173731753,0
2020-08-25-170401,170401,4,0,0,597,1.0,162.03436972868445,1
2020-08-26-170401,170401,0,0,0,597,2.0,161.0131801539794,2
2020-08-27-170401,170401,3,0,2,600,1.0,214.08826470468827,3
2020-08-28-170401,170401,1,0,2,601,1.4,219.26416858357214,4
2020-08-29-170401,170401,2,0,1,603,1.0,265.29574323132823,5
2020-08-30-170401,170401,0,0,4,603,1.0,290.33087469949044,6
2020-08-31-170401,170401,6,0,0,609,0.6,258.87331415186895,0
2020-09-01-170401,170401,3,0,2,612,1.2,201.88143815679848,1
2020-09-02-170401,170401,1,1,2,613,0.8,282.27343156694593,2
2020-09-03-170401,170401,4,0,6,617,1.0,366.4700109757789,3
2020-09-04-170401,170401,3,0,4,620,1.2,407.97490477706685,4
2020-09-05-170401,170401,4,0,5,624,0.8,387.22538621077547,5
2020-09-06-170401,170401,6,0,1,630,1.0,396.4170692194748,6
2020-09-07-170401,170401,0,2,4,630,1.8,380.92313507549267,0
2020-09-08-170401,170401,0,0,3,630,0.6,304.5053898503786,1
2020-09-09-170401,170401,0,0,9,630,0.6,257.10224438473347,2
2020-09-10-170401,170401,2,0,2,632,1.4,217.1901768417556,3
2020-09-11-170401,170401,2,0,5,634,1.4,201.70540810132695,4
2020-09-12-170401,170401,1,0,0,635,0.2,184.9957716961593,5
2020-09-13-170401,170401,4,0,6,639,1.4,176.50518196351484,6
2020-09-14-170401,170401,0,0,10,639,0.8,175.66609175805684,0
2020-09-15-170401,170401,2,0,8,641,1.4,187.461550436683,1
2020-09-16-170401,170401,2,0,9,643,2.4,229.22977207047296,2
2020-09-17-170401,170401,6,0,11,649,2.2,203.3388593281942,3
2020-09-18-170401,170401,4,0,14,653,1.8,237.7245414091123,4
2020-09-19-170401,170401,5,0,6,658,1.2,246.27591902973253,5
2020-09-20-170401,170401,1,0,3,659,1.2,251.69116350405562,6
2020-09-21-170401,170401,4,0,7,663,1.8,249.64743167884274,0
2020-09-22-170401,170401,3,0,3,666,4.2,247.71278246926718,1
2020-09-23-170401,170401,9,0,4,675,2.0,270.27490425956717,2
2020-09-24-170401,170401,2,1,8,677,1.8,277.12136049366615,3
2020-09-25-170401,170401,5,1,6,682,4.0,252.67242482096316,4
2020-09-26-170401,170401,0,0,3,682,1.0,264.8867674278446,5
2020-09-27-170401,170401,6,0,3,688,2.2,259.42467107581376,6
2020-09-28-170401,170401,10,0,3,698,2.0,291.791398354705,0
2020-09-29-170401,170401,8,0,9,706,1.4,341.58924123516357,1
2020-09-30-170401,170401,9,0,8,715,1.2,342.61820627561076,2
2020-10-01-170401,170401,11,0,7,726,4.0,0.0,3
2020-10-02-170401,170401,14,0,5,740,4.8,450.0238093809888,4
2020-10-03-170401,170401,6,1,6,746,2.6,779.3553017417009,5
2020-10-04-170401,170401,3,0,3,749,1.2,860.8550140960576,6
2020-10-05-170401,170401,7,0,1,756,5.0,779.8378585348812,0
2020-10-06-170401,170401,3,1,2,759,2.4,757.6378929656107,1
2020-10-07-170401,170401,4,0,9,763,3.8,625.5604341615439,2
2020-10-08-170401,170401,8,2,3,771,3.0,480.60820953815676,3
2020-10-09-170401,170401,6,0,9,777,3.6,492.91453540742145,4
2020-10-10-170401,170401,3,0,3,780,2.6,90.18164660463724,5
2020-10-11-170401,170401,3,0,2,783,2.8,132.2674044282496,6
2020-10-12-170401,170401,3,0,7,786,2.6,181.44945799010856,0
2020-10-13-170401,170401,9,0,3,795,2.6,223.0296122190137,1
2020-10-14-170401,170401,8,0,31,803,2.0,299.2557831732396,2
2020-10-15-170401,170401,7,0,23,810,1.6,383.4818264528602,3
2020-10-16-170401,170401,5,0,11,815,4.4,445.4054474546986,4
2020-10-17-170401,170401,6,0,4,821,3.2,431.54314411909627,5
2020-10-18-170401,170401,3,0,10,824,2.2,449.9659153953097,6
2020-10-19-170401,170401,1,0,6,825,4.2,454.37415371859095,0
2020-10-20-170401,170401,2,0,13,827,6.2,490.67846680883696,1
2020-10-21-170401,170401,9,0,15,836,5.2,495.7060728096146,2
2020-10-22-170401,170401,3,2,9,839,5.6,527.777893381976,3
2020-10-23-170401,170401,9,1,12,848,8.2,520.2197618968296,4
2020-10-24-170401,170401,3,1,9,851,3.2,562.4227126838739,5
2020-10-25-170401,170401,2,0,10,853,1.8,555.9756061823621,6
2020-10-26-170401,170401,7,1,6,860,6.2,522.5622942182863,0
2020-10-27-170401,170401,3,1,16,863,8.4,524.7371520390451,1
2020-10-28-170401,170401,31,1,21,894,2.6,529.6759161594886,2
2020-10-29-170401,170401,23,0,7,917,8.2,621.8291391368463,3
2020-10-30-170401,170401,11,1,19,928,8.8,730.38121917497,4
2020-10-31-170401,170401,4,1,0,932,4.2,797.7416125809902,5
2020-11-01-170401,170401,10,2,0,942,3.8,436.31309881283204,6
2020-11-02-170401,170401,6,0,0,948,3.8,399.60044180945533,0
2020-11-03-170401,170401,13,1,0,961,6.6,352.39283299638896,1
2020-11-04-170401,170401,15,0,0,976,6.4,482.7100743769056,2
2020-11-05-170401,170401,9,1,0,985,4.8,586.0900472394642,3
2020-11-06-170401,170401,12,4,0,997,7.6,615.4494512085463,4
2020-11-07-170401,170401,9,1,0,1006,4.2,662.7406811703261,5
2020-11-08-170401,170401,10,3,0,1016,1.6,694.0254982900003,6
2020-11-09-170401,170401,6,1,0,1022,4.2,692.1064834499558,0
2020-11-10-170401,170401,16,1,0,1038,3.0,422.29402612797196,1
2020-11-11-170401,170401,21,4,0,1059,6.0,487.035353396845,2
2020-11-12-170401,170401,7,0,0,1066,3.6,583.1921271463458,3
2020-11-13-170401,170401,19,1,0,1085,4.2,610.7480404233784,4
2020-03-01-170402,170402,0,0,0,0,0.0,0.0,6
2020-03-02-170402,170402,0,0,0,0,0.0,29.947817517610837,0
2020-03-03-170402,170402,0,0,0,0,0.0,160.79395191268952,1
2020-03-04-170402,170402,0,0,4,0,0.0,165.68731466989215,2
2020-03-05-170402,170402,0,0,4,0,0.0,172.7971597990672,3
2020-03-06-170402,170402,0,0,3,0,0.0,157.54339177152798,4
2020-03-07-170402,170402,0,0,3,0,0.0,153.81744921345484,5
2020-03-08-170402,170402,0,0,0,0,0.0,130.39759372333938,6
2020-03-09-170402,170402,0,0,4,0,0.0,132.209426489007,0
2020-03-10-170402,170402,0,0,8,0,0.2857142857142857,612.1414188439292,1
2020-03-11-170402,170402,0,0,5,0,0.14285714285714285,492.7861216776159,2
2020-03-12-170402,170402,0,0,4,0,0.7142857142857143,377.7074140060443,3
2020-03-13-170402,170402,0,0,5,0,0.42857142857142855,251.40456929067327,4
2020-03-14-170402,170402,0,0,1,0,0.14285714285714285,192.71478112282531,5
2020-03-15-170402,170402,0,0,1,0,0.5714285714285714,134.01916195498606,6
2020-03-16-170402,170402,0,0,5,0,3.2857142857142856,19.440274944691758,0
2020-03-17-170402,170402,0,1,0,0,2.7142857142857144,46.703166513907554,1
2020-03-18-170402,170402,4,0,0,4,5.7142857142857135,78.79374703040926,2
2020-03-19-170402,170402,4,0,5,8,6.571428571428571,135.81757465437218,3
2020-03-20-170402,170402,3,0,5,11,5.428571428571429,185.43183430796267,4
2020-03-21-170402,170402,3,0,3,14,2.7142857142857144,218.71302731926465,5
2020-03-22-170402,170402,0,0,1,14,3.1428571428571432,232.6644413531665,6
2020-03-23-170402,170402,4,0,3,18,6.7142857142857135,231.1997386954264,0
2020-03-24-170402,170402,8,0,2,26,7.428571428571429,253.32462360524065,1
2020-03-25-170402,170402,5,0,1,31,7.2857142857142865,266.6393616094849,2
2020-03-26-170402,170402,4,0,3,35,6.7142857142857135,295.3898264632288,3
2020-03-27-170402,170402,5,0,4,40,6.0,343.2901841602411,4
2020-03-28-170402,170402,1,0,1,41,3.1428571428571432,349.0016042908734,5
2020-03-29-170402,170402,1,0,1,42,2.8571428571428568,344.0530579049321,6
2020-03-30-170402,170402,5,0,1,47,4.285714285714286,298.7099514599857,0
2020-03-31-170402,170402,0,0,5,47,4.285714285714286,271.5877089781967,1
2020-04-01-170402,170402,0,0,2,47,3.1428571428571432,33.741347451062516,2
2020-04-02-170402,170402,5,0,3,52,4.428571428571429,123.0308209620514,3
2020-04-03-170402,170402,5,0,1,57,4.285714285714286,98.84070436706321,4
2020-04-04-170402,170402,3,0,2,60,1.7142857142857142,123.25367990656375,5
2020-04-05-170402,170402,1,0,3,61,1.0,133.76007806650856,6
2020-04-06-170402,170402,3,3,4,64,3.4285714285714284,134.8478071615324,0
2020-04-07-170402,170402,2,15,5,66,2.4285714285714284,147.25929414226766,1
2020-04-08-170402,170402,1,1,4,67,2.8571428571428568,163.6825995436923,2
2020-04-09-170402,170402,3,0,0,70,3.571428571428572,165.99651710436675,3
2020-04-10-170402,170402,4,0,1,74,2.8571428571428568,25.22185122508973,4
2020-04-11-170402,170402,1,0,2,75,1.5714285714285714,43.80280633589673,5
2020-04-12-170402,170402,1,0,0,76,0.5714285714285714,55.21745094925825,6
2020-04-13-170402,170402,1,0,3,77,3.2857142857142856,60.50186184220267,0
2020-04-14-170402,170402,5,0,1,82,2.7142857142857144,87.57488823416348,1
2020-04-15-170402,170402,2,0,5,84,1.4285714285714286,121.81652617249912,2
2020-04-16-170402,170402,3,0,2,87,1.8571428571428568,137.9581970449097,3
2020-04-17-170402,170402,1,0,1,88,2.142857142857143,136.52518244005213,4
2020-04-18-170402,170402,2,0,0,90,0.5714285714285714,135.52811788394916,5
2020-04-19-170402,170402,3,0,0,93,0.7142857142857143,129.0321159286117,6
2020-04-20-170402,170402,4,0,5,97,2.4285714285714284,147.64034795366092,0
2020-04-21-170402,170402,5,0,0,102,1.0,139.24069062870478,1
2020-04-22-170402,170402,4,0,0,106,2.0,141.27825716682082,2
2020-04-23-170402,170402,0,0,1,106,2.571428571428572,148.7957370505419,3
2020-04-24-170402,170402,1,0,4,107,3.4285714285714284,139.81686733485947,4
2020-04-25-170402,170402,2,0,2,109,0.5714285714285714,159.28730673543197,5
2020-04-26-170402,170402,0,0,0,109,1.0,157.41761298573647,6
2020-04-27-170402,170402,3,0,0,112,3.0,121.20073533336885,0
2020-04-28-170402,170402,1,0,1,113,1.4285714285714286,118.498827612416,1
2020-04-29-170402,170402,5,0,0,118,1.8571428571428568,111.00021980493041,2
2020-04-30-170402,170402,2,0,0,120,1.7142857142857142,138.08285467504288,3
2020-05-01-170402,170402,1,0,1,121,0.8571428571428571,171.2289740581585,4
2020-05-02-170402,170402,0,0,0,121,1.0,45.71688731388901,5
2020-05-03-170402,170402,0,1,0,121,0.5714285714285714,54.509004940085084,6
2020-05-04-170402,170402,5,0,1,126,1.7142857142857142,47.48201796034235,0
2020-05-05-170402,170402,0,0,0,126,1.5714285714285714,55.96675996255667,1
2020-05-06-170402,170402,0,0,0,126,1.8571428571428568,57.00107765883255,2
2020-05-07-170402,170402,1,0,0,127,0.7142857142857143,59.527600984336615,3
2020-05-08-170402,170402,4,0,1,131,0.8571428571428571,60.9206969100925,4
2020-05-09-170402,170402,2,0,0,133,0.5714285714285714,79.01168900137233,5
2020-05-10-170402,170402,0,0,0,133,0.2857142857142857,182.1710644389218,6
2020-05-11-170402,170402,0,1,0,133,1.7142857142857142,168.22755932905483,0
2020-05-12-170402,170402,1,0,1,134,1.7142857142857142,172.9905655192968,1
2020-05-13-170402,170402,0,0,1,134,1.2857142857142858,145.20065738761457,2
2020-05-14-170402,170402,0,0,0,134,0.8571428571428571,122.70795197477138,3
2020-05-15-170402,170402,1,0,1,135,2.0,98.39009208414095,4
2020-05-16-170402,170402,0,0,0,135,0.14285714285714285,80.66165971757103,5
2020-05-17-170402,170402,0,0,0,135,0.5714285714285714,73.61150952531136,6
2020-05-18-170402,170402,1,0,0,136,1.1428571428571428,63.82135554264839,0
2020-05-19-170402,170402,0,0,0,136,0.7142857142857143,67.65804343875625,1
2020-05-20-170402,170402,0,1,0,136,0.7142857142857143,57.3508042370935,2
2020-05-21-170402,170402,0,0,0,136,1.0,62.858906844851155,3
2020-05-22-170402,170402,1,0,0,137,2.0,54.07284694428944,4
2020-05-23-170402,170402,0,0,0,137,0.0,77.93982774688331,5
2020-05-24-170402,170402,0,0,0,137,0.0,78.41889969853828,6
2020-05-25-170402,170402,0,0,0,137,0.8571428571428571,61.28845383150619,0
2020-05-26-170402,170402,1,0,0,138,1.4285714285714286,73.56272092913574,1
2020-05-27-170402,170402,1,0,0,139,1.0,87.19760080672175,2
2020-05-28-170402,170402,0,0,0,139,0.7142857142857143,90.28309154487894,3
2020-05-29-170402,170402,1,0,1,140,0.7142857142857143,93.90769269709924,4
2020-05-30-170402,170402,0,0,0,140,0.2857142857142857,83.45779101893314,5
2020-05-31-170402,170402,0,1,0,140,0.0,89.70697478563311,6
2020-06-01-170402,170402,0,0,0,140,0.2857142857142857,113.16060730213849,0
2020-06-02-170402,170402,0,0,0,140,0.7142857142857143,41.64420381522071,1
2020-06-03-170402,170402,0,0,1,140,0.5714285714285714,29.393623671676632,2
2020-06-04-170402,170402,0,0,0,140,0.5714285714285714,26.649620287979644,3
2020-06-05-170402,170402,0,2,0,140,0.42857142857142855,31.47306035906066,4
2020-06-06-170402,170402,0,0,0,140,0.42857142857142855,39.75956050855054,5
2020-06-07-170402,170402,0,0,0,140,0.2857142857142857,41.6651524964077,6
2020-06-08-170402,170402,0,1,0,140,0.14285714285714285,44.547132179569395,0
2020-06-09-170402,170402,0,0,0,140,1.4285714285714286,37.670793077589735,1
2020-06-10-170402,170402,0,0,1,140,1.1428571428571428,126.51401916986708,2
2020-06-11-170402,170402,0,0,0,140,0.42857142857142855,103.3437948897554,3
2020-06-12-170402,170402,1,0,0,141,0.42857142857142855,98.4046074740153,4
2020-06-13-170402,170402,0,0,0,141,0.14285714285714285,86.75522173764854,5
2020-06-14-170402,170402,0,0,0,141,0.14285714285714285,77.33925591083212,6
2020-06-15-170402,170402,0,3,0,141,1.2857142857142858,52.75019257563696,0
2020-06-16-170402,170402,0,0,0,141,0.5714285714285714,45.76561305352092,1
2020-06-17-170402,170402,1,0,0,142,0.8571428571428571,47.65394355427407,2
2020-06-18-170402,170402,0,0,0,142,0.7142857142857143,50.16756452398891,3
2020-06-19-170402,170402,0,0,0,142,0.2857142857142857,46.124627460718635,4
2020-06-20-170402,170402,0,0,0,142,0.2857142857142857,50.70450967714554,5
2020-06-21-170402,170402,0,0,0,142,0.14285714285714285,53.19727513610497,6
2020-06-22-170402,170402,0,0,0,142,1.1428571428571428,45.34147375948186,0
2020-06-23-170402,170402,0,0,0,142,0.2857142857142857,43.54667917182763,1
2020-06-24-170402,170402,1,0,0,143,1.2857142857142858,35.979345213741986,2
2020-06-25-170402,170402,0,0,0,143,0.0,44.26314950055107,3
2020-06-26-170402,170402,0,0,0,143,0.14285714285714285,42.87648214405733,4
2020-06-27-170402,170402,0,0,0,143,0.14285714285714285,33.97883854354636,5
2020-06-28-170402,170402,0,0,0,143,0.0,32.98871003033868,6
2020-06-29-170402,170402,0,0,1,143,1.2857142857142858,31.774705577590538,0
2020-06-30-170402,170402,0,0,0,143,0.5714285714285714,38.319747883133445,1
2020-07-01-170402,170402,0,0,0,143,1.7142857142857142,47.621171780994466,2
2020-07-02-170402,170402,0,0,1,143,0.2857142857142857,50.83028668629083,3
2020-07-03-170402,170402,0,0,0,143,0.0,37.532332386657586,4
2020-07-04-170402,170402,0,0,0,143,0.14285714285714285,35.846231187542045,5
2020-07-05-170402,170402,0,0,0,143,0.0,35.991611725652646,6
2020-07-06-170402,170402,0,0,0,143,0.7142857142857143,30.897990919585347,0
2020-07-07-170402,170402,0,0,4,143,0.42857142857142855,27.791621234867883,1
2020-07-08-170402,170402,0,0,0,143,0.42857142857142855,26.670639217020742,2
2020-07-09-170402,170402,0,0,0,143,0.42857142857142855,33.187432237052704,3
2020-07-10-170402,170402,0,0,0,143,0.8571428571428571,62.660071708727976,4
2020-07-11-170402,170402,0,0,0,143,0.0,69.37832856268265,5
2020-07-12-170402,170402,0,0,0,143,0.0,58.079726188697705,6
2020-07-13-170402,170402,1,0,0,144,0.8571428571428571,54.21784235650688,0
2020-07-14-170402,170402,0,0,1,144,0.2857142857142857,62.53143377403933,1
2020-07-15-170402,170402,0,0,0,144,0.7142857142857143,63.837415760734125,2
2020-07-16-170402,170402,1,0,0,145,0.42857142857142855,52.69415177750928,3
2020-07-17-170402,170402,0,0,0,145,0.0,45.47143497125577,4
2020-07-18-170402,170402,0,0,0,145,0.14285714285714285,34.36592071425265,5
2020-07-19-170402,170402,0,0,0,145,0.5714285714285714,38.971024323958275,6
2020-07-20-170402,170402,0,0,0,145,0.5714285714285714,49.1528521788455,0
2020-07-21-170402,170402,4,0,0,149,1.0,52.98389210463783,1
2020-07-22-170402,170402,0,0,0,149,0.7142857142857143,68.84480272990433,2
2020-07-23-170402,170402,0,0,0,149,0.7142857142857143,64.5300714194072,3
2020-07-24-170402,170402,0,0,0,149,0.2857142857142857,74.08708066165357,4
2020-07-25-170402,170402,0,0,0,149,0.14285714285714285,72.38082311919082,5
2020-07-26-170402,170402,0,0,0,149,0.14285714285714285,57.1236137001503,6
2020-07-27-170402,170402,0,0,0,149,0.7142857142857143,53.7089390107573,0
2020-07-28-170402,170402,1,0,1,150,0.42857142857142855,50.48490977824789,1
2020-07-29-170402,170402,0,0,0,150,1.0,37.77105797522694,2
2020-07-30-170402,170402,0,0,0,150,0.7142857142857143,30.111142762981608,3
2020-07-31-170402,170402,0,0,4,150,0.5714285714285714,35.09596957048329,4
2020-08-01-170402,170402,0,0,0,150,0.0,29.945543473088474,5
2020-08-02-170402,170402,0,0,0,150,0.0,85.18502193913477,6
2020-08-03-170402,170402,0,0,0,150,1.1428571428571428,110.68153346888761,0
2020-08-04-170402,170402,0,0,1,150,0.7142857142857143,103.76929921666701,1
2020-08-05-170402,170402,0,0,0,150,1.0,93.9092372326445,2
2020-08-06-170402,170402,0,0,0,150,0.8571428571428571,76.79056904042992,3
2020-08-07-170402,170402,0,0,0,150,1.4285714285714286,62.30209308892814,4
2020-08-08-170402,170402,0,0,2,150,0.14285714285714285,73.12813261657774,5
2020-08-09-170402,170402,0,0,0,150,0.5714285714285714,67.50606424148903,6
2020-08-10-170402,170402,0,0,0,150,1.7142857142857142,27.291511202897105,0
2020-08-11-170402,170402,1,0,1,151,1.0,44.80191063134662,1
2020-08-12-170402,170402,0,0,0,151,1.2857142857142858,57.126083226832165,2
2020-08-13-170402,170402,0,0,5,151,1.1428571428571428,64.8861045454092,3
2020-08-14-170402,170402,4,0,2,155,0.5714285714285714,68.17897240149782,4
2020-08-15-170402,170402,0,0,2,155,0.42857142857142855,83.25388157135994,5
2020-08-16-170402,170402,0,0,0,155,0.14285714285714285,87.3548379225174,6
2020-08-17-170402,170402,0,0,0,155,1.0,90.33866150974086,0
2020-08-18-170402,170402,1,0,2,156,1.2857142857142858,79.44771143048668,1
2020-08-19-170402,170402,0,0,1,156,1.1428571428571428,86.02693614416833,2
2020-08-20-170402,170402,0,0,0,156,0.5714285714285714,72.86429817572366,3
2020-08-21-170402,170402,0,0,0,156,1.0,65.19148391751779,4
2020-08-22-170402,170402,2,0,0,158,0.42857142857142855,66.47449585013416,5
2020-08-23-170402,170402,0,0,1,158,0.0,75.68350633840191,6
2020-08-24-170402,170402,0,0,0,158,1.7142857142857142,68.09959195143806,0
2020-08-25-170402,170402,1,0,0,159,1.0,59.64554709109971,1
2020-08-26-170402,170402,0,0,1,159,1.1428571428571428,66.43620787997534,2
2020-08-27-170402,170402,5,0,1,164,1.0,84.29989522251762,3
2020-08-28-170402,170402,2,1,1,166,1.4285714285714286,97.89441675298215,4
2020-08-29-170402,170402,2,0,1,168,0.42857142857142855,112.36407845143512,5
2020-08-30-170402,170402,0,0,0,168,0.14285714285714285,119.7766858579433,6
2020-08-31-170402,170402,0,0,0,168,0.2857142857142857,113.25313885362513,0
2020-09-01-170402,170402,2,0,3,170,1.2857142857142858,70.15322428132012,1
2020-09-02-170402,170402,1,0,4,171,0.5714285714285714,192.74602758377097,2
2020-09-03-170402,170402,0,0,3,171,0.5714285714285714,236.5808518216011,3
2020-09-04-170402,170402,0,0,4,171,1.0,215.70038481401815,4
2020-09-05-170402,170402,0,0,0,171,0.8571428571428571,202.0255496693788,5
2020-09-06-170402,170402,1,0,0,172,0.7142857142857143,206.60020927447079,6
2020-09-07-170402,170402,0,0,2,172,0.8571428571428571,203.443661494151,0
2020-09-08-170402,170402,0,0,2,172,0.8571428571428571,167.8743487174628,1
2020-09-09-170402,170402,1,0,3,173,0.7142857142857143,154.7751601348227,2
2020-09-10-170402,170402,1,0,3,174,1.4285714285714286,85.56585069400532,3
2020-09-11-170402,170402,1,0,4,175,2.0,94.74781381118483,4
2020-09-12-170402,170402,1,0,0,176,1.5714285714285714,112.77828976278496,5
2020-09-13-170402,170402,0,0,1,176,0.7142857142857143,121.11678690966048,6
2020-09-14-170402,170402,0,0,6,176,1.1428571428571428,105.84797188668762,0
2020-09-15-170402,170402,3,0,0,179,2.142857142857143,116.3633169245723,1
2020-09-16-170402,170402,4,0,3,183,3.0,142.68449193197108,2
2020-09-17-170402,170402,3,0,2,186,3.2857142857142856,142.96073128398638,3
2020-09-18-170402,170402,4,0,3,190,3.2857142857142856,175.36547120031264,4
2020-09-19-170402,170402,0,0,0,190,1.7142857142857142,186.97831980264755,5
2020-09-20-170402,170402,0,2,0,190,0.42857142857142855,186.73517065946214,6
2020-09-21-170402,170402,2,0,2,192,3.8571428571428568,175.69854734783303,0
2020-09-22-170402,170402,2,0,1,194,5.285714285714286,178.64147080516295,1
2020-09-23-170402,170402,3,2,3,197,3.2857142857142856,220.47415924569367,2
2020-09-24-170402,170402,3,0,0,200,3.8571428571428568,204.2553252365416,3
2020-09-25-170402,170402,4,0,4,204,2.4285714285714284,204.44140555018782,4
2020-09-26-170402,170402,0,0,37,204,0.8571428571428571,220.19280797934604,5
2020-09-27-170402,170402,1,0,3,205,0.8571428571428571,215.84909999778682,6
2020-09-28-170402,170402,6,0,6,211,3.8571428571428568,228.20023651416548,0
2020-09-29-170402,170402,0,0,2,211,3.4285714285714284,237.0752940235576,1
2020-09-30-170402,170402,3,0,1,214,2.142857142857143,197.04610362969697,2
2020-10-01-170402,170402,2,0,2,216,5.285714285714286,0.0,3
2020-10-02-170402,170402,3,0,1,219,3.2857142857142856,328.622179697231,4
2020-10-03-170402,170402,0,0,0,219,0.7142857142857143,501.839193599381,5
2020-10-04-170402,170402,0,0,3,219,2.4285714285714284,594.2395672205438,6
2020-10-05-170402,170402,2,0,2,221,3.7142857142857135,543.4496409491379,0
2020-10-06-170402,170402,1,1,5,222,2.8571428571428568,505.103271893653,1
2020-10-07-170402,170402,3,1,8,225,4.0,475.5146473432195,2
2020-10-08-170402,170402,0,3,5,225,4.571428571428571,444.58952167047346,3
2020-10-09-170402,170402,4,2,10,229,4.0,479.59333432571793,4
2020-10-10-170402,170402,37,0,2,266,3.0,53.23735713395587,5
2020-10-11-170402,170402,3,0,4,269,3.571428571428572,174.812568974889,6
2020-10-12-170402,170402,6,0,3,275,5.142857142857143,225.2072330584114,0
2020-10-13-170402,170402,2,0,3,277,3.4285714285714284,273.2189987009931,1
2020-10-14-170402,170402,1,0,2,278,4.285714285714286,319.15193362264813,2
2020-10-15-170402,170402,2,0,1,280,3.0,363.275966193663,3
2020-10-16-170402,170402,1,0,6,281,8.714285714285714,396.6571949423783,4
2020-10-17-170402,170402,0,0,40,281,6.142857142857142,412.39327165249426,5
2020-10-18-170402,170402,3,0,9,284,4.142857142857143,339.2053156876217,6
2020-10-19-170402,170402,2,0,2,286,3.0,329.03099026704524,0
2020-10-20-170402,170402,5,0,9,291,6.857142857142858,323.127340914126,1
2020-10-21-170402,170402,8,1,7,299,5.7142857142857135,372.3713888491941,2
2020-10-22-170402,170402,5,1,6,304,9.142857142857142,419.1197357775601,3
2020-10-23-170402,170402,10,0,15,314,9.428571428571429,442.2344946797264,4
2020-10-24-170402,170402,2,4,2,316,4.428571428571429,491.5026367390647,5
2020-10-25-170402,170402,4,3,8,320,2.571428571428572,491.2277090178643,6
2020-10-26-170402,170402,3,0,7,323,4.285714285714286,470.4323390925109,0
2020-10-27-170402,170402,3,0,8,326,5.857142857142858,493.8953735268336,1
2020-10-28-170402,170402,2,1,9,328,6.142857142857142,489.1490078323412,2
2020-10-29-170402,170402,1,1,4,329,8.0,472.21053139282543,3
2020-10-30-170402,170402,6,0,7,335,10.857142857142858,381.4546150855926,4
2020-10-31-170402,170402,40,0,0,375,4.571428571428571,451.26248708794867,5
2020-11-01-170402,170402,9,1,0,384,5.142857142857143,386.9421604861369,6
2020-11-02-170402,170402,2,1,0,386,3.7142857142857135,390.4151561045742,0
2020-11-03-170402,170402,9,0,0,395,5.857142857142858,363.43149618001115,1
2020-11-04-170402,170402,7,2,0,402,8.714285714285714,426.415897008764,2
2020-11-05-170402,170402,6,3,0,408,7.0,487.80006966248385,3
2020-11-06-170402,170402,15,2,0,423,10.857142857142858,523.3555031397126,4
2020-11-07-170402,170402,2,0,0,425,3.8571428571428568,574.0637480267383,5
2020-11-08-170402,170402,8,1,0,433,3.2857142857142856,582.0221346777353,6
2020-11-09-170402,170402,7,2,0,440,7.571428571428571,567.0027233954936,0
2020-11-10-170402,170402,8,2,0,448,5.571428571428571,305.05066376526923,1
2020-11-11-170402,170402,9,2,0,457,10.285714285714286,346.6026100419392,2
2020-11-12-170402,170402,4,2,0,461,6.142857142857142,428.95681214911315,3
2020-11-13-170402,170402,7,1,0,468,5.285714285714286,466.83981404373003,4
2020-03-01-170403,170403,0,0,0,0,0.0,0.0,6
2020-03-02-170403,170403,0,0,0,0,0.0,10.93227081942852,0
2020-03-03-170403,170403,0,0,0,0,0.0,48.840285673837286,1
2020-03-04-170403,170403,0,0,1,0,0.0,44.45615925220673,2
2020-03-05-170403,170403,0,0,1,0,0.0,45.463698415101874,3
2020-03-06-170403,170403,0,0,0,0,0.0,42.871626967854446,4
2020-03-07-170403,170403,0,0,0,0,0.0,42.50147687795099,5
2020-03-08-170403,170403,0,0,1,0,0.0,36.50737002363162,6
2020-03-09-170403,170403,0,0,0,0,0.0,36.068028002171516,0
2020-03-10-170403,170403,0,0,1,0,0.25,237.6983948922293,1
2020-03-11-170403,170403,0,0,0,0,0.25,173.66087860295372,2
2020-03-12-170403,170403,0,0,2,0,0.75,138.15667654676955,3
2020-03-13-170403,170403,0,0,0,0,0.25,99.62787553364107,4
2020-03-14-170403,170403,0,0,0,0,0.25,73.30751542869645,5
2020-03-15-170403,170403,0,0,0,0,0.75,56.783595615290096,6
2020-03-16-170403,170403,0,0,0,0,2.75,4.8947652062540445,0
2020-03-17-170403,170403,0,0,1,0,2.75,11.448951272398052,1
2020-03-18-170403,170403,1,0,0,1,5.5,21.652285676466157,2
2020-03-19-170403,170403,1,0,0,2,7.5,39.64449575871281,3
2020-03-20-170403,170403,0,0,0,2,5.75,54.785991345860694,4
2020-03-21-170403,170403,0,0,1,2,3.75,58.862732077054694,5
2020-03-22-170403,170403,1,2,0,3,2.5,60.962764527009334,6
2020-03-23-170403,170403,0,0,1,3,5.5,62.01354013082941,0
2020-03-24-170403,170403,1,0,1,4,9.75,66.15179229585654,1
2020-03-25-170403,170403,0,1,1,4,8.5,76.01463757025026,2
2020-03-26-170403,170403,2,0,2,6,3.75,82.08997916567515,3
2020-03-27-170403,170403,0,0,1,6,4.0,96.18983906027225,4
2020-03-28-170403,170403,0,0,2,6,2.0,97.97036209336197,5
2020-03-29-170403,170403,0,0,0,6,0.75,94.84261160568352,6
2020-03-30-170403,170403,0,0,2,6,4.5,82.82067983125725,0
2020-03-31-170403,170403,1,0,3,7,2.5,68.45464936943786,1
2020-04-01-170403,170403,0,0,0,7,2.5,9.307616956998883,2
2020-04-02-170403,170403,0,0,2,7,4.75,42.49316756209484,3
2020-04-03-170403,170403,0,0,0,7,5.5,67.52961512162078,4
2020-04-04-170403,170403,1,0,1,8,1.5,47.26666589243959,5
2020-04-05-170403,170403,0,0,0,8,1.25,54.13375099090488,6
2020-04-06-170403,170403,1,1,0,9,4.5,55.310880069994504,0
2020-04-07-170403,170403,1,0,2,10,2.5,49.57153334176391,1
2020-04-08-170403,170403,1,3,0,11,2.5,51.543260182102756,2
2020-04-09-170403,170403,2,0,14,13,2.75,52.81949621787461,3
2020-04-10-170403,170403,1,0,5,14,3.25,5.333957419858604,4
2020-04-11-170403,170403,2,0,0,16,1.25,11.060041647216096,5
2020-04-12-170403,170403,0,0,0,16,0.5,16.94574624875137,6
2020-04-13-170403,170403,2,0,6,18,2.0,20.44916184302193,0
2020-04-14-170403,170403,3,0,1,21,3.0,29.97360562854051,1
2020-04-15-170403,170403,0,0,1,21,1.0,43.760771906306545,2
2020-04-16-170403,170403,2,0,5,23,3.0,47.3178512773484,3
2020-04-17-170403,170403,0,0,0,23,2.0,50.99423950120968,4
2020-04-18-170403,170403,1,0,0,24,0.75,50.01414672514328,5
2020-04-19-170403,170403,0,0,0,24,1.0,47.24544459166819,6
2020-04-20-170403,170403,0,0,0,24,3.0,46.02605751159775,0
2020-04-21-170403,170403,2,0,1,26,2.0,36.73346095069202,1
2020-04-22-170403,170403,0,0,7,26,3.0,41.29654495233121,2
2020-04-23-170403,170403,14,0,1,40,0.25,40.489909304925376,3
2020-04-24-170403,170403,5,0,0,45,2.0,64.67889632624384,4
2020-04-25-170403,170403,0,0,0,45,1.25,78.01940469193082,5
2020-04-26-170403,170403,0,0,0,45,1.0,78.23539529751957,6
2020-04-27-170403,170403,6,0,2,51,2.25,67.938585852018,0
2020-04-28-170403,170403,1,0,2,52,0.75,79.60762712292275,1
2020-04-29-170403,170403,1,0,0,53,2.5,77.13722546718819,2
2020-04-30-170403,170403,5,1,0,58,1.5,60.56681451741072,3
2020-05-01-170403,170403,0,0,1,58,0.75,65.65326838157306,4
2020-05-02-170403,170403,0,0,0,58,0.5,16.31968927246728,5
2020-05-03-170403,170403,0,0,0,58,0.25,20.208572351836633,6
2020-05-04-170403,170403,0,0,1,58,2.25,16.55488595555202,0
2020-05-05-170403,170403,1,0,0,59,0.75,15.909089246271071,1
2020-05-06-170403,170403,7,0,0,66,1.0,18.471917163427996,2
2020-05-07-170403,170403,1,0,0,67,1.0,35.02914744992068,3
2020-05-08-170403,170403,0,0,1,67,1.75,33.691086050911046,4
2020-05-09-170403,170403,0,0,0,67,0.75,40.44733022543822,5
2020-05-10-170403,170403,0,1,0,67,0.25,55.26624775346437,6
2020-05-11-170403,170403,2,0,1,69,0.5,46.38071519241052,0
2020-05-12-170403,170403,2,0,1,71,1.5,51.68828838004003,1
2020-05-13-170403,170403,0,2,1,71,0.5,46.70726340101497,2
2020-05-14-170403,170403,0,0,0,71,0.0,41.82503286956644,3
2020-05-15-170403,170403,1,0,1,72,1.75,34.55983424184649,4
2020-05-16-170403,170403,0,0,0,72,0.0,28.675797171588066,5
2020-05-17-170403,170403,0,0,0,72,0.75,26.84461664223193,6
2020-05-18-170403,170403,1,0,0,73,0.5,25.6421679747083,0
2020-05-19-170403,170403,0,0,0,73,0.5,25.07265988333536,1
2020-05-20-170403,170403,0,0,0,73,1.0,17.81600969575404,2
2020-05-21-170403,170403,0,0,0,73,1.5,22.298569198564763,3
2020-05-22-170403,170403,1,0,0,74,1.25,21.00924280852358,4
2020-05-23-170403,170403,0,0,0,74,0.0,29.24232320476253,5
2020-05-24-170403,170403,0,0,0,74,0.0,29.762403286181332,6
2020-05-25-170403,170403,1,0,0,75,1.0,23.44840583087325,0
2020-05-26-170403,170403,1,0,0,76,0.75,27.821566525377552,1
2020-05-27-170403,170403,1,0,2,77,0.75,33.134150182843584,2
2020-05-28-170403,170403,0,0,0,77,0.75,31.36535571780183,3
2020-05-29-170403,170403,1,1,0,78,0.75,29.475921347112973,4
2020-05-30-170403,170403,0,0,0,78,0.5,27.805454638536,5
2020-05-31-170403,170403,0,0,0,78,0.0,28.848650701727948,6
2020-06-01-170403,170403,0,0,1,78,0.25,52.757199153396144,0
2020-06-02-170403,170403,0,0,0,78,0.75,13.434797228663044,1
2020-06-03-170403,170403,0,0,0,78,0.0,13.16139152664905,2
2020-06-04-170403,170403,0,0,0,78,0.25,13.100469376209453,3
2020-06-05-170403,170403,0,0,0,78,0.5,13.998518841244893,4
2020-06-06-170403,170403,0,0,0,78,0.0,15.74915355428423,5
2020-06-07-170403,170403,0,0,0,78,0.25,16.09926646619484,6
2020-06-08-170403,170403,0,0,1,78,0.0,16.95031985746502,0
2020-06-09-170403,170403,0,0,0,78,0.5,11.305636766520971,1
2020-06-10-170403,170403,2,0,0,80,0.0,54.94084189321348,2
2020-06-11-170403,170403,0,0,0,80,0.25,57.95985848682192,3
2020-06-12-170403,170403,0,0,0,80,0.5,53.522647262000746,4
2020-06-13-170403,170403,0,0,0,80,0.0,31.597136369458262,5
2020-06-14-170403,170403,0,0,0,80,0.25,26.63537190323244,6
2020-06-15-170403,170403,1,0,2,81,0.5,17.737884680234068,0
2020-06-16-170403,170403,0,0,0,81,0.0,19.486035661760766,1
2020-06-17-170403,170403,0,0,2,81,0.75,20.262219483817855,2
2020-06-18-170403,170403,0,0,0,81,0.5,15.43330331358523,3
2020-06-19-170403,170403,0,0,0,81,0.0,14.783250332545194,4
2020-06-20-170403,170403,0,0,1,81,0.0,19.936911270845567,5
2020-06-21-170403,170403,0,0,0,81,0.25,20.735020107109012,6
2020-06-22-170403,170403,1,0,1,82,0.75,15.7992070279396,0
2020-06-23-170403,170403,0,0,0,82,0.5,17.783896768648194,1
2020-06-24-170403,170403,0,0,0,82,0.75,16.469899213584007,2
2020-06-25-170403,170403,0,0,1,82,0.0,18.662475734753453,3
2020-06-26-170403,170403,0,0,0,82,0.0,18.217740162489036,4
2020-06-27-170403,170403,0,0,0,82,0.0,12.212130010126806,5
2020-06-28-170403,170403,0,0,0,82,0.0,11.798117708396992,6
2020-06-29-170403,170403,2,0,3,84,0.75,11.488040878565762,0
2020-06-30-170403,170403,0,0,0,84,1.0,16.068284170423812,1
2020-07-01-170403,170403,2,0,1,86,0.25,13.858226970539263,2
2020-07-02-170403,170403,0,0,0,86,0.25,23.35003932940004,3
2020-07-03-170403,170403,0,0,0,86,0.0,12.705507648534313,4
2020-07-04-170403,170403,1,0,0,87,0.0,13.697084059639922,5
2020-07-05-170403,170403,0,0,0,87,0.0,14.003410468212955,6
2020-07-06-170403,170403,1,0,0,88,0.5,12.761220271420594,0
2020-07-07-170403,170403,0,0,0,88,0.5,14.517726697965529,1
2020-07-08-170403,170403,0,0,0,88,0.5,13.257419509878183,2
2020-07-09-170403,170403,1,0,0,89,0.25,14.143876683287735,3
2020-07-10-170403,170403,0,0,0,89,0.75,21.409740455339175,4
2020-07-11-170403,170403,0,0,0,89,0.0,22.366811143009407,5
2020-07-12-170403,170403,0,0,1,89,0.0,19.690732391426256,6
2020-07-13-170403,170403,3,0,0,92,0.5,18.89500157817854,0
2020-07-14-170403,170403,0,0,0,92,0.5,29.77249170886798,1
2020-07-15-170403,170403,1,0,0,93,0.75,28.776044199250947,2
2020-07-16-170403,170403,0,0,0,93,0.75,28.629221391860984,3
2020-07-17-170403,170403,0,0,0,93,0.0,22.421115725715524,4
2020-07-18-170403,170403,0,0,0,93,0.25,21.059377938783207,5
2020-07-19-170403,170403,0,0,0,93,1.0,22.320940725578666,6
2020-07-20-170403,170403,0,0,1,93,1.0,13.904461184065347,0
2020-07-21-170403,170403,0,0,0,93,2.25,15.037950174656054,1
2020-07-22-170403,170403,0,0,1,93,0.0,15.16435740025587,2
2020-07-23-170403,170403,0,0,0,93,1.25,15.138772913947054,3
2020-07-24-170403,170403,0,0,0,93,0.5,16.1410020769446,4
2020-07-25-170403,170403,0,0,0,93,0.0,15.890361267985282,5
2020-07-26-170403,170403,1,0,0,94,0.0,13.782312412304446,6
2020-07-27-170403,170403,0,0,2,94,0.75,15.625537884529837,0
2020-07-28-170403,170403,0,0,1,94,0.5,14.732935389594111,1
2020-07-29-170403,170403,0,0,2,94,0.75,12.45616495842414,2
2020-07-30-170403,170403,0,0,0,94,0.25,11.531505637415439,3
2020-07-31-170403,170403,0,0,0,94,0.25,13.740444156470893,4
2020-08-01-170403,170403,0,0,0,94,0.0,15.06119620779978,5
2020-08-02-170403,170403,0,0,0,94,0.0,27.604172974884452,6
2020-08-03-170403,170403,1,0,1,95,0.25,44.96887768347784,0
2020-08-04-170403,170403,0,0,0,95,0.75,33.670204950743845,1
2020-08-05-170403,170403,1,0,1,96,0.75,31.52321929898215,2
2020-08-06-170403,170403,0,0,0,96,1.0,29.196314266736817,3
2020-08-07-170403,170403,0,1,0,96,1.75,21.37694113253867,4
2020-08-08-170403,170403,0,0,0,96,0.0,23.542693575972656,5
2020-08-09-170403,170403,0,0,0,96,0.5,21.961562128066124,6
2020-08-10-170403,170403,2,0,1,98,0.75,15.591802096402748,0
2020-08-11-170403,170403,1,0,1,99,0.5,22.944803033835253,1
2020-08-12-170403,170403,2,0,0,101,0.5,28.543787202157027,2
2020-08-13-170403,170403,0,0,1,101,0.75,33.791162181649476,3
2020-08-14-170403,170403,0,0,1,101,1.75,35.70850662820648,4
2020-08-15-170403,170403,0,0,0,101,0.5,39.65752517256672,5
2020-08-16-170403,170403,0,0,0,101,0.0,37.53358452463123,6
2020-08-17-170403,170403,1,0,0,102,0.25,38.535201942406275,0
2020-08-18-170403,170403,0,0,0,102,1.0,32.057498321327586,1
2020-08-19-170403,170403,1,0,1,103,0.0,30.780222593380312,2
2020-08-20-170403,170403,0,0,0,103,0.75,25.49919206616229,3
2020-08-21-170403,170403,0,0,0,103,0.5,24.384259682469228,4
2020-08-22-170403,170403,0,0,0,103,0.75,25.016423488904643,5
2020-08-23-170403,170403,0,0,0,103,0.0,26.12359129420588,6
2020-08-24-170403,170403,1,0,0,104,0.75,21.771253172448745,0
2020-08-25-170403,170403,1,0,0,105,0.75,27.190068505913608,1
2020-08-26-170403,170403,0,1,0,105,0.25,28.621315451226742,2
2020-08-27-170403,170403,1,0,0,106,1.5,32.48340976255794,3
2020-08-28-170403,170403,1,0,0,107,0.75,37.762528324439096,4
2020-08-29-170403,170403,0,0,0,107,0.75,44.98871260671677,5
2020-08-30-170403,170403,0,0,0,107,0.0,45.83145326594157,6
2020-08-31-170403,170403,0,0,0,107,0.0,37.4202066128294,0
2020-09-01-170403,170403,0,0,0,107,1.0,21.276078525554666,1
2020-09-02-170403,170403,1,0,1,108,1.0,82.10810588575205,2
2020-09-03-170403,170403,0,0,0,108,0.0,97.47378121482345,3
2020-09-04-170403,170403,0,0,1,108,1.75,88.37416100473999,4
2020-09-05-170403,170403,0,0,0,108,1.0,74.88819096883714,5
2020-09-06-170403,170403,0,1,0,108,1.0,71.61944943966309,6
2020-09-07-170403,170403,0,0,3,108,0.75,66.12211490042158,0
2020-09-08-170403,170403,0,0,3,108,1.5,45.5794587753272,1
2020-09-09-170403,170403,0,0,0,108,1.25,35.66279073429368,2
2020-09-10-170403,170403,0,0,0,108,2.0,24.730649022604204,3
2020-09-11-170403,170403,0,0,1,108,3.0,26.63357356085877,4
2020-09-12-170403,170403,0,0,2,108,1.5,27.58471193523137,5
2020-09-13-170403,170403,0,0,0,108,0.25,29.028522577734044,6
2020-09-14-170403,170403,0,0,0,108,1.75,30.47982962469934,0
2020-09-15-170403,170403,0,0,1,108,3.25,33.02988769383741,1
2020-09-16-170403,170403,1,0,0,109,2.75,41.938400052618434,2
2020-09-17-170403,170403,0,0,4,109,4.75,54.32302238232268,3
2020-09-18-170403,170403,1,0,4,110,4.0,60.93890393758774,4
2020-09-19-170403,170403,0,1,0,110,1.75,69.66264685887695,5
2020-09-20-170403,170403,0,0,0,110,0.5,75.80612384450637,6
2020-09-21-170403,170403,3,1,0,113,3.75,78.68315734807098,0
2020-09-22-170403,170403,3,1,0,116,5.0,86.8750642182124,1
2020-09-23-170403,170403,0,0,0,116,1.75,97.64280100739799,2
2020-09-24-170403,170403,0,0,0,116,4.75,93.52846990611648,3
2020-09-25-170403,170403,1,0,2,117,3.5,90.91901417940943,4
2020-09-26-170403,170403,2,0,2,119,0.25,96.40498632537714,5
2020-09-27-170403,170403,0,0,9,119,1.25,97.73108262939814,6
2020-09-28-170403,170403,0,0,17,119,5.0,99.87246092531768,0
2020-09-29-170403,170403,1,0,0,120,3.0,102.8617081835194,1
2020-09-30-170403,170403,0,0,2,120,2.0,84.36025908156307,2
2020-10-01-170403,170403,4,0,6,124,2.5,0.0,3
2020-10-02-170403,170403,4,0,1,128,3.25,131.71480725936394,4
2020-10-03-170403,170403,0,0,10,128,1.0,167.78645587015222,5
2020-10-04-170403,170403,0,0,0,128,2.0,203.22206472271938,6
2020-10-05-170403,170403,0,0,0,128,3.75,195.24269675764444,0
2020-10-06-170403,170403,0,0,0,128,3.5,188.2135864001732,1
2020-10-07-170403,170403,0,0,5,128,5.0,163.5011535566266,2
2020-10-08-170403,170403,0,2,22,128,4.5,145.70884864767714,3
2020-10-09-170403,170403,2,2,1,130,3.75,149.36480370644819,4
2020-10-10-170403,170403,2,0,0,132,12.0,20.69434879287217,5
2020-10-11-170403,170403,9,0,1,141,3.25,58.48844490677563,6
2020-10-12-170403,170403,17,0,0,158,4.75,96.6623460254221,0
2020-10-13-170403,170403,0,0,0,158,2.5,152.7636670234964,1
2020-10-14-170403,170403,2,0,3,160,3.75,168.7047782327818,2
2020-10-15-170403,170403,6,0,2,166,2.75,183.08963696176858,3
2020-10-16-170403,170403,1,0,5,167,7.75,200.86156838380873,4
2020-10-17-170403,170403,10,0,2,177,2.75,195.17856957348116,5
2020-10-18-170403,170403,0,0,3,177,3.25,187.84379155518184,6
2020-10-19-170403,170403,0,0,8,177,3.5,157.0296553528588,0
2020-10-20-170403,170403,0,0,2,177,8.25,130.21020675458067,1
2020-10-21-170403,170403,5,1,8,182,7.0,150.7359828075609,2
2020-10-22-170403,170403,22,1,2,204,7.25,159.94613467704735,3
2020-10-23-170403,170403,1,0,7,205,9.5,198.5935730622414,4
2020-10-24-170403,170403,0,0,6,205,4.75,202.27287873982735,5
2020-10-25-170403,170403,1,0,1,206,3.75,203.89743346313077,6
2020-10-26-170403,170403,0,2,5,206,4.0,200.8037719498046,0
2020-10-27-170403,170403,0,0,4,206,6.5,195.39234612049808,1
2020-10-28-170403,170403,3,2,5,209,5.5,180.46041992023663,2
2020-10-29-170403,170403,2,0,8,211,6.0,185.59839346936502,3
2020-10-30-170403,170403,5,1,1,216,11.5,131.31666096055903,4
2020-10-31-170403,170403,2,1,0,218,14.0,159.52440270310478,5
2020-11-01-170403,170403,3,1,0,221,6.5,115.01368748197571,6
2020-11-02-170403,170403,8,0,0,229,2.5,106.1909317510125,0
2020-11-03-170403,170403,2,1,0,231,7.5,117.51941912245557,1
2020-11-04-170403,170403,8,1,0,239,10.0,154.1033496436137,2
2020-11-05-170403,170403,2,0,0,241,7.75,203.41730458052075,3
2020-11-06-170403,170403,7,3,0,248,9.5,212.30711051435503,4
2020-11-07-170403,170403,6,0,0,254,3.5,228.01301800456488,5
2020-11-08-170403,170403,1,0,0,255,4.75,230.15488044335132,6
2020-11-09-170403,170403,5,0,0,260,10.25,205.53717851124952,0
2020-11-10-170403,170403,4,1,0,264,5.75,98.26640030952201,1
2020-11-11-170403,170403,5,2,0,269,10.75,108.68167176020442,2
2020-11-12-170403,170403,8,1,0,277,6.0,133.65315504627205,3
2020-11-13-170403,170403,1,0,0,278,4.25,156.44092615633252,4
2020-03-01-170404,170404,0,0,0,0,0.0,0.0,6
2020-03-02-170404,170404,0,0,2,0,0.0,117.27175639536767,0
2020-03-03-170404,170404,0,0,5,0,0.0,647.0406095614121,1
2020-03-04-170404,170404,0,0,6,0,0.0,730.8582949878872,2
2020-03-05-170404,170404,0,0,4,0,0.0,777.1946418808873,3
2020-03-06-170404,170404,1,0,7,1,0.0,728.3459152482635,4
2020-03-07-170404,170404,0,0,4,1,0.0,706.0310171634173,5
2020-03-08-170404,170404,0,0,4,1,0.0,590.9213148565425,6
2020-03-09-170404,170404,0,0,10,1,0.0,593.7843434113214,0
2020-03-10-170404,170404,0,0,9,1,0.2857142857142857,2036.9512405295447,1
2020-03-11-170404,170404,0,0,16,1,0.14285714285714285,1639.6113848122768,2
2020-03-12-170404,170404,1,0,14,2,0.5714285714285714,1292.728615811036,3
2020-03-13-170404,170404,0,0,18,2,0.42857142857142855,813.7161810316466,4
2020-03-14-170404,170404,0,0,7,2,0.2857142857142857,595.0143428616013,5
2020-03-15-170404,170404,0,0,9,2,0.5714285714285714,390.1631284562996,6
2020-03-16-170404,170404,2,0,10,4,2.8571428571428568,80.13683942997847,0
2020-03-17-170404,170404,5,0,12,9,3.1428571428571432,213.28168806722627,1
2020-03-18-170404,170404,6,5,12,15,6.142857142857142,315.3854944663992,2
2020-03-19-170404,170404,4,0,6,19,7.428571428571429,523.7617685098662,3
2020-03-20-170404,170404,7,0,6,26,5.285714285714286,668.6743016950101,4
2020-03-21-170404,170404,4,0,8,30,2.571428571428572,760.6829595850784,5
2020-03-22-170404,170404,4,0,2,34,4.285714285714286,790.1090930331766,6
2020-03-23-170404,170404,10,0,7,44,7.428571428571429,774.4919037756185,0
2020-03-24-170404,170404,9,0,6,53,9.571428571428571,868.1381076622852,1
2020-03-25-170404,170404,16,0,9,69,10.0,900.84021078363,2
2020-03-26-170404,170404,14,0,13,83,7.428571428571429,986.1509301089659,3
2020-03-27-170404,170404,18,0,2,101,5.857142857142858,1203.9997537504491,4
2020-03-28-170404,170404,7,0,2,108,2.7142857142857144,1255.469145314938,5
2020-03-29-170404,170404,9,0,1,117,1.7142857142857142,1297.1912124636788,6
2020-03-30-170404,170404,10,0,2,127,5.285714285714286,1147.6692703856947,0
2020-03-31-170404,170404,12,0,9,139,4.571428571428571,1082.2839042440442,1
2020-04-01-170404,170404,12,0,5,151,2.7142857142857144,153.4826257944975,2
2020-04-02-170404,170404,6,0,5,157,5.142857142857143,434.57076435528944,3
2020-04-03-170404,170404,6,0,8,163,4.0,318.09512478775906,4
2020-04-04-170404,170404,8,0,1,171,2.7142857142857144,368.9165276229535,5
2020-04-05-170404,170404,2,0,2,173,1.5714285714285714,420.89339190128584,6
2020-04-06-170404,170404,7,0,7,180,4.428571428571429,420.2576865213281,0
2020-04-07-170404,170404,6,1,5,186,3.0,483.68919296718514,1
2020-04-08-170404,170404,9,0,7,195,2.8571428571428568,549.4857297675923,2
2020-04-09-170404,170404,13,0,2,208,3.7142857142857135,579.3090450041955,3
2020-04-10-170404,170404,2,0,7,210,3.0,137.29976786175166,4
2020-04-11-170404,170404,2,0,1,212,1.5714285714285714,202.9758323279596,5
2020-04-12-170404,170404,1,0,2,213,0.42857142857142855,241.3579389851378,6
2020-04-13-170404,170404,2,0,4,215,4.0,257.0034841695441,0
2020-04-14-170404,170404,9,0,1,224,2.571428571428572,344.4888147707968,1
2020-04-15-170404,170404,5,0,9,229,1.7142857142857142,446.74558484207444,2
2020-04-16-170404,170404,5,0,5,234,2.571428571428572,503.236674218054,3
2020-04-17-170404,170404,8,0,1,242,2.7142857142857144,454.888797626028,4
2020-04-18-170404,170404,1,0,1,243,0.7142857142857143,484.84277867007,5
2020-04-19-170404,170404,2,0,1,245,0.5714285714285714,457.35328017455276,6
2020-04-20-170404,170404,7,0,6,252,2.7142857142857144,502.4680854490844,0
2020-04-21-170404,170404,5,0,2,257,1.4285714285714286,478.926467773783,1
2020-04-22-170404,170404,7,1,3,264,1.8571428571428568,476.6596340142914,2
2020-04-23-170404,170404,2,0,0,266,1.0,478.82282901880836,3
2020-04-24-170404,170404,7,0,6,273,2.2857142857142856,398.8118512227081,4
2020-04-25-170404,170404,1,0,4,274,1.0,481.41761453781857,5
2020-04-26-170404,170404,2,0,1,276,1.2857142857142858,476.94862891104435,6
2020-04-27-170404,170404,4,0,4,280,2.0,372.6286956076358,0
2020-04-28-170404,170404,1,0,5,281,2.0,347.9987541207181,1
2020-04-29-170404,170404,9,0,3,290,2.0,330.57163351371184,2
2020-04-30-170404,170404,5,0,3,295,1.0,441.40476249243375,3
2020-05-01-170404,170404,1,0,5,296,1.5714285714285714,653.3711977953038,4
2020-05-02-170404,170404,1,0,0,297,1.1428571428571428,218.8452218832502,5
2020-05-03-170404,170404,1,0,0,298,0.7142857142857143,185.7744549055181,6
2020-05-04-170404,170404,6,0,2,304,2.142857142857143,183.71219762473015,0
2020-05-05-170404,170404,2,0,2,306,2.0,196.58781622857157,1
2020-05-06-170404,170404,3,0,2,309,1.4285714285714286,213.32124974495238,2
2020-05-07-170404,170404,0,0,2,309,1.0,199.91988106571534,3
2020-05-08-170404,170404,6,0,0,315,1.1428571428571428,204.79702208818037,4
2020-05-09-170404,170404,4,0,2,319,1.0,255.98982081999512,5
2020-05-10-170404,170404,1,0,0,320,0.5714285714285714,713.8281153854971,6
2020-05-11-170404,170404,4,0,0,324,2.0,642.9416348364525,0
2020-05-12-170404,170404,5,2,3,329,1.4285714285714286,646.0573505442858,1
2020-05-13-170404,170404,3,3,2,332,1.7142857142857142,576.3351015685313,2
2020-05-14-170404,170404,3,0,7,335,1.0,504.50964127289114,3
2020-05-15-170404,170404,5,0,3,340,2.142857142857143,396.36801850575756,4
2020-05-16-170404,170404,0,0,0,340,0.14285714285714285,315.5544867341207,5
2020-05-17-170404,170404,0,0,0,340,0.8571428571428571,290.26459844221756,6
2020-05-18-170404,170404,2,1,3,342,1.2857142857142858,287.24876830470197,0
2020-05-19-170404,170404,2,0,3,344,0.8571428571428571,309.94683367977325,1
2020-05-20-170404,170404,2,0,1,346,0.7142857142857143,265.02506735166725,2
2020-05-21-170404,170404,2,0,1,348,0.8571428571428571,276.1135804180392,3
2020-05-22-170404,170404,0,0,3,348,1.7142857142857142,222.3460998141067,4
2020-05-23-170404,170404,2,0,0,350,0.0,281.4130871302692,5
2020-05-24-170404,170404,0,0,0,350,0.14285714285714285,283.830164175982,6
2020-05-25-170404,170404,0,0,1,350,0.8571428571428571,223.23685557924378,0
2020-05-26-170404,170404,3,0,6,353,0.7142857142857143,207.4093063212596,1
2020-05-27-170404,170404,2,0,1,355,2.4285714285714284,247.09235087456233,2
2020-05-28-170404,170404,7,0,3,362,1.7142857142857142,260.1777414194047,3
2020-05-29-170404,170404,3,0,1,365,1.2857142857142858,305.11088554214007,4
2020-05-30-170404,170404,0,0,0,365,0.14285714285714285,283.7490444897857,5
2020-05-31-170404,170404,0,0,0,365,0.0,291.0126079038862,6
2020-06-01-170404,170404,3,0,0,368,1.0,371.72058561594554,0
2020-06-02-170404,170404,3,0,3,371,1.2857142857142858,165.19326137147232,1
2020-06-03-170404,170404,1,1,1,372,1.0,133.17442385437025,2
2020-06-04-170404,170404,1,0,1,373,0.5714285714285714,135.78702158769582,3
2020-06-05-170404,170404,3,0,0,376,1.0,157.0306516393734,4
2020-06-06-170404,170404,0,0,0,376,0.14285714285714285,184.44857443102455,5
2020-06-07-170404,170404,0,0,0,376,0.5714285714285714,195.66178428566175,6
2020-06-08-170404,170404,1,0,1,377,1.0,206.24094052272034,0
2020-06-09-170404,170404,6,0,0,383,2.0,189.73412565095302,1
2020-06-10-170404,170404,1,0,1,384,1.2857142857142858,435.2479782204093,2
2020-06-11-170404,170404,3,0,0,387,0.5714285714285714,370.8552882061705,3
2020-06-12-170404,170404,1,0,1,388,1.1428571428571428,337.2292838029406,4
2020-06-13-170404,170404,0,0,0,388,0.0,300.65522335306815,5
2020-06-14-170404,170404,0,1,0,388,0.14285714285714285,271.8219109886644,6
2020-06-15-170404,170404,0,7,0,388,1.5714285714285714,203.40743884850255,0
2020-06-16-170404,170404,3,1,1,391,0.8571428571428571,190.8455993594663,1
2020-06-17-170404,170404,1,0,1,392,1.0,191.35901250502957,2
2020-06-18-170404,170404,1,0,1,393,0.7142857142857143,197.6352321947214,3
2020-06-19-170404,170404,0,1,0,393,0.5714285714285714,186.41176936783037,4
2020-06-20-170404,170404,0,0,0,393,0.2857142857142857,210.71010886417963,5
2020-06-21-170404,170404,0,0,1,393,0.14285714285714285,217.0029771962499,6
2020-06-22-170404,170404,1,0,0,394,1.0,182.91025336656622,0
2020-06-23-170404,170404,0,0,1,394,1.2857142857142858,183.4085985371157,1
2020-06-24-170404,170404,1,0,1,395,1.1428571428571428,164.6741186768767,2
2020-06-25-170404,170404,0,0,0,395,0.5714285714285714,192.5525276189059,3
2020-06-26-170404,170404,1,0,0,396,0.42857142857142855,185.85007641004933,4
2020-06-27-170404,170404,0,0,0,396,0.0,155.48888985505906,5
2020-06-28-170404,170404,0,0,0,396,0.14285714285714285,152.3951323869704,6
2020-06-29-170404,170404,0,0,1,396,1.0,146.66526524290464,0
2020-06-30-170404,170404,1,0,0,397,1.0,174.44535697499657,1
2020-07-01-170404,170404,1,0,0,398,0.8571428571428571,236.1474357353415,2
2020-07-02-170404,170404,1,0,1,399,0.2857142857142857,100.32518574781892,3
2020-07-03-170404,170404,0,0,0,399,0.42857142857142855,122.249604551073,4
2020-07-04-170404,170404,0,0,0,399,0.14285714285714285,150.6454739792599,5
2020-07-05-170404,170404,1,0,0,400,0.0,152.2006624234902,6
2020-07-06-170404,170404,0,0,0,400,0.42857142857142855,132.59275803602884,0
2020-07-07-170404,170404,1,0,0,401,0.42857142857142855,136.25073477648317,1
2020-07-08-170404,170404,1,0,1,402,0.42857142857142855,115.26476652192767,2
2020-07-09-170404,170404,0,1,0,402,0.42857142857142855,126.84304989040116,3
2020-07-10-170404,170404,0,0,0,402,0.5714285714285714,258.39416675138193,4
2020-07-11-170404,170404,0,0,0,402,0.0,268.4168896166595,5
2020-07-12-170404,170404,0,0,0,402,0.0,225.58338347763214,6
2020-07-13-170404,170404,1,0,0,403,0.42857142857142855,207.90711111163307,0
2020-07-14-170404,170404,0,0,0,403,0.2857142857142857,223.7760694116314,1
2020-07-15-170404,170404,0,0,0,403,0.8571428571428571,206.92797272129667,2
2020-07-16-170404,170404,1,0,1,404,0.7142857142857143,145.32091562135844,3
2020-07-17-170404,170404,0,0,1,404,0.2857142857142857,122.68523896960755,4
2020-07-18-170404,170404,0,0,0,404,0.0,89.99446478661383,5
2020-07-19-170404,170404,0,0,0,404,0.14285714285714285,94.09081605789669,6
2020-07-20-170404,170404,0,0,0,404,1.0,99.6550743419128,0
2020-07-21-170404,170404,0,0,0,404,1.0,115.84069235678422,1
2020-07-22-170404,170404,1,0,0,405,1.0,130.24750064335296,2
2020-07-23-170404,170404,0,0,1,405,1.0,129.71433050562788,3
2020-07-24-170404,170404,0,0,2,405,0.5714285714285714,141.49153753682964,4
2020-07-25-170404,170404,0,0,1,405,0.5714285714285714,150.15867037143948,5
2020-07-26-170404,170404,0,0,0,405,0.0,148.23931795211425,6
2020-07-27-170404,170404,0,0,2,405,0.5714285714285714,126.96731959101777,0
2020-07-28-170404,170404,0,0,3,405,0.7142857142857143,127.7619376784813,1
2020-07-29-170404,170404,0,0,1,405,1.1428571428571428,108.1296753722325,2
2020-07-30-170404,170404,1,0,2,406,1.0,110.91430702703968,3
2020-07-31-170404,170404,1,0,0,407,0.5714285714285714,137.77343753707135,4
2020-08-01-170404,170404,0,0,0,407,0.0,94.60653358604077,5
2020-08-02-170404,170404,0,0,3,407,0.2857142857142857,271.54531741467105,6
2020-08-03-170404,170404,0,0,2,407,1.2857142857142858,338.4093842648112,0
2020-08-04-170404,170404,0,0,4,407,1.4285714285714286,327.802850352546,1
2020-08-05-170404,170404,0,0,3,407,1.8571428571428568,289.3815953104913,2
2020-08-06-170404,170404,1,0,4,408,0.8571428571428571,273.465759050869,3
2020-08-07-170404,170404,2,0,1,410,1.8571428571428568,245.81447504475457,4
2020-08-08-170404,170404,1,0,2,411,0.0,275.4475631043678,5
2020-08-09-170404,170404,0,0,0,411,0.42857142857142855,255.16834829220142,6
2020-08-10-170404,170404,2,0,2,413,1.5714285714285714,79.95685056565588,0
2020-08-11-170404,170404,3,0,1,416,0.7142857142857143,144.67532386764128,1
2020-08-12-170404,170404,1,0,2,417,1.5714285714285714,165.27411435527426,2
2020-08-13-170404,170404,2,0,1,419,1.1428571428571428,188.23466120053706,3
2020-08-14-170404,170404,0,0,3,419,0.2857142857142857,221.4985141561174,4
2020-08-15-170404,170404,0,0,2,419,0.14285714285714285,240.7579535576578,5
2020-08-16-170404,170404,3,0,0,422,0.14285714285714285,235.5632930343627,6
2020-08-17-170404,170404,2,0,2,424,0.5714285714285714,260.5309095804829,0
2020-08-18-170404,170404,4,0,2,428,1.2857142857142858,232.3279936766371,1
2020-08-19-170404,170404,3,0,2,431,1.1428571428571428,263.89015146662007,2
2020-08-20-170404,170404,4,0,1,435,1.1428571428571428,222.73189219598757,3
2020-08-21-170404,170404,1,0,2,436,0.7142857142857143,261.597921746627,4
2020-08-22-170404,170404,2,0,2,438,0.7142857142857143,282.1178678147485,5
2020-08-23-170404,170404,0,0,3,438,0.14285714285714285,302.04302199763106,6
2020-08-24-170404,170404,2,0,7,440,1.4285714285714286,265.5294280285902,0
2020-08-25-170404,170404,1,0,3,441,1.1428571428571428,255.60957799622187,1
2020-08-26-170404,170404,2,0,0,443,1.2857142857142858,257.8379230226159,2
2020-08-27-170404,170404,1,0,4,444,1.2857142857142858,331.0696258870968,3
2020-08-28-170404,170404,3,0,4,447,1.2857142857142858,318.0559668856315,4
2020-08-29-170404,170404,2,0,1,449,0.8571428571428571,344.66925681299256,5
2020-08-30-170404,170404,0,0,2,449,0.0,369.9152050906712,6
2020-08-31-170404,170404,2,0,4,451,0.8571428571428571,340.137804259375,0
2020-09-01-170404,170404,2,0,3,453,1.2857142857142858,255.7295828999355,1
2020-09-02-170404,170404,2,0,6,455,0.5714285714285714,618.2765476792783,2
2020-09-03-170404,170404,1,0,9,456,1.7142857142857142,682.8203051440782,3
2020-09-04-170404,170404,2,0,6,458,1.4285714285714286,633.1430423532111,4
2020-09-05-170404,170404,2,0,5,460,1.1428571428571428,606.2018760370104,5
2020-09-06-170404,170404,3,1,2,463,1.2857142857142858,619.411492754504,6
2020-09-07-170404,170404,7,0,5,470,0.5714285714285714,601.3874341924758,0
2020-09-08-170404,170404,3,1,11,473,0.42857142857142855,546.3509749254126,1
2020-09-09-170404,170404,0,0,7,473,0.42857142857142855,454.2318603556124,2
2020-09-10-170404,170404,4,0,1,477,1.2857142857142858,293.07330407486756,3
2020-09-11-170404,170404,4,0,6,481,2.2857142857142856,318.8300074635056,4
2020-09-12-170404,170404,1,0,1,482,1.2857142857142858,394.15433175875086,5
2020-09-13-170404,170404,2,0,3,484,1.0,406.5631589739679,6
2020-09-14-170404,170404,4,0,1,488,1.1428571428571428,387.59098080527707,0
2020-09-15-170404,170404,3,0,5,491,1.7142857142857142,446.91614796974324,1
2020-09-16-170404,170404,6,0,3,497,1.8571428571428568,506.1348216902557,2
2020-09-17-170404,170404,9,0,12,506,2.7142857142857144,506.6912167170107,3
2020-09-18-170404,170404,6,0,15,512,2.4285714285714284,587.8722363600114,4
2020-09-19-170404,170404,5,0,4,517,2.142857142857143,579.6911813080131,5
2020-09-20-170404,170404,2,0,2,519,0.7142857142857143,623.8556635912646,6
2020-09-21-170404,170404,5,1,22,524,2.7142857142857144,569.9638809783933,0
2020-09-22-170404,170404,11,0,10,535,3.571428571428572,583.315602244646,1
2020-09-23-170404,170404,7,1,17,542,3.0,724.5257043808467,2
2020-09-24-170404,170404,1,0,15,543,3.0,713.5237132463022,3
2020-09-25-170404,170404,6,0,12,549,1.7142857142857142,685.3252736968938,4
2020-09-26-170404,170404,1,0,9,550,0.42857142857142855,680.4620985044054,5
2020-09-27-170404,170404,3,0,11,553,1.4285714285714286,667.6212517995847,6
2020-09-28-170404,170404,1,0,3,554,5.0,709.4863021953115,0
2020-09-29-170404,170404,5,0,11,559,3.2857142857142856,757.9855257397674,1
2020-09-30-170404,170404,3,0,7,562,3.2857142857142856,615.1017072160488,2
2020-10-01-170404,170404,12,0,5,574,4.714285714285714,0.0,3
2020-10-02-170404,170404,15,0,11,589,4.428571428571429,1425.5436175318341,4
2020-10-03-170404,170404,4,0,6,593,1.8571428571428568,2200.331706208741,5
2020-10-04-170404,170404,2,0,8,595,2.571428571428572,2175.689489154496,6
2020-10-05-170404,170404,22,0,7,617,4.714285714285714,1928.9775478447275,0
2020-10-06-170404,170404,10,0,14,627,2.8571428571428568,1807.9304441202585,1
2020-10-07-170404,170404,17,0,14,644,4.0,1752.5353216026383,2
2020-10-08-170404,170404,15,1,20,659,5.571428571428571,1618.5276588922898,3
2020-10-09-170404,170404,12,0,30,671,4.142857142857143,1826.4121377535223,4
2020-10-10-170404,170404,9,0,15,680,2.7142857142857144,224.49097536783242,5
2020-10-11-170404,170404,11,0,3,691,2.2857142857142856,459.15477758535025,6
2020-10-12-170404,170404,3,0,22,694,2.8571428571428568,632.0002653484153,0
2020-10-13-170404,170404,11,0,29,705,4.571428571428571,746.7202922688211,1
2020-10-14-170404,170404,7,0,4,712,4.428571428571429,948.2122125189123,2
2020-10-15-170404,170404,5,0,21,717,3.0,1147.039694643061,3
2020-10-16-170404,170404,11,0,26,728,7.2857142857142865,1280.6224264757677,4
2020-10-17-170404,170404,6,1,14,734,4.428571428571429,1365.0251841484815,5
2020-10-18-170404,170404,8,0,16,742,4.285714285714286,1334.297613257546,6
2020-10-19-170404,170404,7,0,18,749,2.8571428571428568,1358.6718363096038,0
2020-10-20-170404,170404,14,0,18,763,6.857142857142858,1407.9162413838287,1
2020-10-21-170404,170404,14,0,19,777,5.857142857142858,1560.4427578375144,2
2020-10-22-170404,170404,20,0,18,797,5.857142857142858,1716.5570131735012,3
2020-10-23-170404,170404,30,0,31,827,8.285714285714286,1728.8643264816396,4
2020-10-24-170404,170404,15,1,10,842,4.285714285714286,1944.3889031348626,5
2020-10-25-170404,170404,3,1,8,845,2.4285714285714284,1969.4652493472518,6
2020-10-26-170404,170404,22,0,11,867,4.714285714285714,1892.9799953548272,0
2020-10-27-170404,170404,29,0,5,896,5.0,2030.7444369423692,1
2020-10-28-170404,170404,4,1,19,900,8.428571428571429,2075.635774742264,2
2020-10-29-170404,170404,21,1,10,921,10.428571428571429,2020.958741998204,3
2020-10-30-170404,170404,26,2,11,947,9.571428571428571,1755.3739254507261,4
2020-10-31-170404,170404,14,0,0,961,4.285714285714286,1909.1308404235435,5
2020-11-01-170404,170404,16,0,0,977,5.571428571428571,1515.5943193560174,6
2020-11-02-170404,170404,18,0,0,995,2.7142857142857144,1141.1792045798977,0
2020-11-03-170404,170404,18,1,0,1013,6.857142857142858,1198.5144696602229,1
2020-11-04-170404,170404,19,2,0,1032,8.0,1429.3550987699077,2
2020-11-05-170404,170404,18,3,0,1050,5.142857142857143,1628.8527782428996,3
2020-11-06-170404,170404,31,2,0,1081,9.285714285714286,1743.6964988985928,4
2020-11-07-170404,170404,10,0,0,1091,3.1428571428571432,1988.7573792646385,5
2020-11-08-170404,170404,8,0,0,1099,3.4285714285714284,2025.9875847027197,6
2020-11-09-170404,170404,11,0,0,1110,5.7142857142857135,1948.4558326415074,0
2020-11-10-170404,170404,5,0,0,1115,5.7142857142857135,1457.6336040948,1
2020-11-11-170404,170404,19,0,0,1134,8.857142857142858,1544.2153646804736,2
2020-11-12-170404,170404,10,0,0,1144,4.428571428571429,1658.19988490528,3
2020-11-13-170404,170404,11,3,0,1155,5.285714285714286,1694.7053764895038,4
2020-03-01-170405,170405,0,0,1,0,0.0,0.0,6
2020-03-02-170405,170405,0,0,11,0,0.0,92.36908072358565,0
2020-03-03-170405,170405,0,0,7,0,0.0,542.168735247079,1
2020-03-04-170405,170405,0,0,15,0,0.0,615.6966712343017,2
2020-03-05-170405,170405,0,0,22,0,0.0,660.210386603251,3
2020-03-06-170405,170405,0,0,16,0,0.16666666666666666,615.2977478225998,4
2020-03-07-170405,170405,0,0,9,0,0.0,597.5742148815611,5
2020-03-08-170405,170405,0,0,8,0,0.0,498.79792837460474,6
2020-03-09-170405,170405,0,0,15,0,0.0,502.5266853833102,0
2020-03-10-170405,170405,1,0,28,1,0.16666666666666666,1808.6965170730036,1
2020-03-11-170405,170405,1,0,23,2,0.0,1451.6889712629327,2
2020-03-12-170405,170405,3,0,9,5,0.5,1136.8168971826553,3
2020-03-13-170405,170405,1,0,8,6,0.3333333333333333,713.1693126998762,4
2020-03-14-170405,170405,1,0,6,7,0.0,524.6757737902861,5
2020-03-15-170405,170405,1,0,1,8,0.0,343.9951085199378,6
2020-03-16-170405,170405,11,0,13,19,2.0,66.68920814278464,0
2020-03-17-170405,170405,7,0,7,26,2.1666666666666665,178.5935613421684,1
2020-03-18-170405,170405,15,0,8,41,5.5,259.99837501740967,2
2020-03-19-170405,170405,22,0,12,63,4.5,433.78528107288855,3
2020-03-20-170405,170405,16,0,13,79,4.166666666666667,557.9915292174411,4
2020-03-21-170405,170405,9,0,1,88,2.333333333333333,643.6736950484379,5
2020-03-22-170405,170405,8,0,4,96,2.6666666666666665,678.9664657455784,6
2020-03-23-170405,170405,15,0,11,111,6.166666666666668,660.866845566763,0
2020-03-24-170405,170405,28,0,6,139,6.0,752.8345738668381,1
2020-03-25-170405,170405,23,0,8,162,7.166666666666668,784.9854920368059,2
2020-03-26-170405,170405,9,0,8,171,8.5,866.742516777584,3
2020-03-27-170405,170405,8,0,8,179,8.5,1045.2124689465354,4
2020-03-28-170405,170405,6,0,3,185,3.8333333333333335,1083.1933601081507,5
2020-03-29-170405,170405,1,0,0,186,4.333333333333333,1113.756629547128,6
2020-03-30-170405,170405,13,0,7,199,4.833333333333333,989.4877107707716,0
2020-03-31-170405,170405,7,0,4,206,5.333333333333333,928.2405476207969,1
2020-04-01-170405,170405,8,0,2,214,4.0,127.23096244836972,2
2020-04-02-170405,170405,12,0,9,226,4.5,371.8459460412975,3
2020-04-03-170405,170405,13,0,7,239,3.8333333333333335,276.7678761828382,4
2020-04-04-170405,170405,1,0,1,240,3.5,322.22911902874705,5
2020-04-05-170405,170405,4,0,0,244,1.0,361.8738825239366,6
2020-04-06-170405,170405,11,0,7,255,3.1666666666666665,360.0332367221789,0
2020-04-07-170405,170405,6,0,2,261,2.6666666666666665,404.4012285493697,1
2020-04-08-170405,170405,8,0,4,269,3.5,456.80939332662933,2
2020-04-09-170405,170405,8,1,1,277,5.166666666666667,482.31887320924864,3
2020-04-10-170405,170405,8,0,6,285,2.6666666666666665,112.04523649458093,4
2020-04-11-170405,170405,3,0,2,288,1.6666666666666667,169.15024492412834,5
2020-04-12-170405,170405,0,0,4,288,1.0,200.63116616931296,6
2020-04-13-170405,170405,7,0,4,295,3.0,213.50320776062512,0
2020-04-14-170405,170405,4,0,2,299,4.166666666666667,295.72280598563145,1
2020-04-15-170405,170405,2,0,5,301,2.1666666666666665,381.3451078607544,2
2020-04-16-170405,170405,9,0,3,310,2.0,419.8923803443132,3
2020-04-17-170405,170405,7,0,2,317,2.833333333333333,377.429601821254,4
2020-04-18-170405,170405,1,0,2,318,1.0,392.601835038486,5
2020-04-19-170405,170405,0,0,0,318,1.3333333333333333,365.5325185054512,6
2020-04-20-170405,170405,7,0,4,325,2.833333333333333,395.2257403614353,0
2020-04-21-170405,170405,2,0,3,327,2.333333333333333,371.0836988202624,1
2020-04-22-170405,170405,4,0,4,331,3.0,359.47098213543495,2
2020-04-23-170405,170405,1,0,3,332,3.1666666666666665,363.3451331908258,3
2020-04-24-170405,170405,6,0,1,338,4.166666666666667,307.10616589279783,4
2020-04-25-170405,170405,2,0,0,340,0.5,368.98177394607376,5
2020-04-26-170405,170405,4,0,0,344,0.8333333333333334,367.49347277359993,6
2020-04-27-170405,170405,4,3,1,348,3.1666666666666665,281.2148237676554,0
2020-04-28-170405,170405,2,0,5,350,1.3333333333333333,265.90137444617665,1
2020-04-29-170405,170405,5,0,2,355,3.6666666666666665,256.8166269774736,2
2020-04-30-170405,170405,3,0,0,358,2.333333333333333,342.07240334031724,3
2020-05-01-170405,170405,2,0,6,360,1.0,485.981246048495,4
2020-05-02-170405,170405,2,0,0,362,1.0,165.55415541358764,5
2020-05-03-170405,170405,0,0,3,362,0.6666666666666666,138.77982807605974,6
2020-05-04-170405,170405,4,0,1,366,2.6666666666666665,134.6623823353704,0
2020-05-05-170405,170405,3,0,2,369,1.6666666666666667,145.70006096433107,1
2020-05-06-170405,170405,4,0,2,373,1.8333333333333333,159.9445547011877,2
2020-05-07-170405,170405,3,0,4,376,0.5,151.8522223980067,3
2020-05-08-170405,170405,1,0,2,377,2.333333333333333,156.4547085960536,4
2020-05-09-170405,170405,0,0,0,377,1.5,195.83838554972158,5
2020-05-10-170405,170405,0,1,0,377,0.3333333333333333,531.9744317727732,6
2020-05-11-170405,170405,1,9,1,378,1.6666666666666667,490.4255750833901,0
2020-05-12-170405,170405,5,1,2,383,2.1666666666666665,494.626755870282,1
2020-05-13-170405,170405,2,0,2,385,1.6666666666666667,442.16419460094914,2
2020-05-14-170405,170405,0,0,3,385,1.1666666666666667,388.4903686507728,3
2020-05-15-170405,170405,6,0,2,391,2.0,307.727225410459,4
2020-05-16-170405,170405,0,0,1,391,0.16666666666666666,248.47518679543657,5
2020-05-17-170405,170405,3,0,0,394,0.16666666666666666,229.7079347218362,6
2020-05-18-170405,170405,1,0,1,395,1.6666666666666667,218.7371599079293,0
2020-05-19-170405,170405,2,0,1,397,0.8333333333333334,238.32020709224554,1
2020-05-20-170405,170405,2,0,0,399,0.6666666666666666,205.37779190842252,2
2020-05-21-170405,170405,4,0,1,403,0.5,213.3575653197604,3
2020-05-22-170405,170405,2,0,1,405,1.8333333333333333,172.74124586660503,4
2020-05-23-170405,170405,0,0,0,405,0.3333333333333333,219.41192225370617,5
2020-05-24-170405,170405,0,0,1,405,0.0,221.69340962462186,6
2020-05-25-170405,170405,1,0,0,406,0.3333333333333333,171.9897849015971,0
2020-05-26-170405,170405,2,0,2,408,1.8333333333333333,165.67281780820122,1
2020-05-27-170405,170405,2,0,0,410,1.0,199.30604298719754,2
2020-05-28-170405,170405,3,1,0,413,1.3333333333333333,208.00998176159428,3
2020-05-29-170405,170405,2,0,1,415,1.1666666666666667,238.39019093062143,4
2020-05-30-170405,170405,1,0,0,416,0.0,220.06459612160248,5
2020-05-31-170405,170405,0,0,1,416,0.0,227.00142191338844,6
2020-06-01-170405,170405,1,0,2,417,0.5,292.6485636011302,0
2020-06-02-170405,170405,1,0,0,418,1.0,133.5571178023876,1
2020-06-03-170405,170405,0,0,2,418,0.8333333333333334,100.49572683040401,2
2020-06-04-170405,170405,1,0,2,419,0.6666666666666666,100.49525679745742,3
2020-06-05-170405,170405,1,0,0,420,0.6666666666666666,119.63852786755436,4
2020-06-06-170405,170405,0,0,0,420,0.5,140.82885853196927,5
2020-06-07-170405,170405,1,0,1,421,0.0,149.56469912532071,6
2020-06-08-170405,170405,0,0,3,421,0.3333333333333333,157.2610123852026,0
2020-06-09-170405,170405,2,0,2,423,2.1666666666666665,140.20017438667884,1
2020-06-10-170405,170405,0,0,2,423,1.3333333333333333,346.24268155509003,2
2020-06-11-170405,170405,0,0,0,423,0.8333333333333334,291.49109113520956,3
2020-06-12-170405,170405,1,0,0,424,0.6666666666666666,265.2299669451922,4
2020-06-13-170405,170405,0,0,0,424,0.16666666666666666,236.425997124486,5
2020-06-14-170405,170405,1,0,0,425,0.0,215.2496600215602,6
2020-06-15-170405,170405,2,0,3,427,1.0,158.32298282621935,0
2020-06-16-170405,170405,0,1,4,427,1.1666666666666667,146.93507046813244,1
2020-06-17-170405,170405,2,0,0,429,0.6666666666666666,152.0663198769068,2
2020-06-18-170405,170405,2,0,1,431,0.6666666666666666,158.25548629837505,3
2020-06-19-170405,170405,0,0,0,431,0.3333333333333333,150.17638740720858,4
2020-06-20-170405,170405,0,1,0,431,0.16666666666666666,166.5956968798859,5
2020-06-21-170405,170405,1,0,0,432,0.0,171.50830481946466,6
2020-06-22-170405,170405,3,0,2,435,1.0,145.76438755978046,0
2020-06-23-170405,170405,2,0,1,437,0.0,143.3696947070267,1
2020-06-24-170405,170405,2,0,1,439,1.5,124.11175370039366,2
2020-06-25-170405,170405,0,0,1,439,0.0,146.2849186322734,3
2020-06-26-170405,170405,0,0,2,439,0.3333333333333333,140.8775130644919,4
2020-06-27-170405,170405,0,0,0,439,0.16666666666666666,118.2744966980041,5
2020-06-28-170405,170405,0,0,0,439,0.0,116.18331074898194,6
2020-06-29-170405,170405,3,0,1,442,1.0,111.48266051433154,0
2020-06-30-170405,170405,4,0,1,446,0.16666666666666666,133.47404448913227,1
2020-07-01-170405,170405,0,0,2,446,1.5,180.7588667176579,2
2020-07-02-170405,170405,1,0,1,447,0.3333333333333333,83.55078316162523,3
2020-07-03-170405,170405,0,0,0,447,0.0,94.01041551448664,4
2020-07-04-170405,170405,0,1,0,447,0.16666666666666666,114.27093935396971,5
2020-07-05-170405,170405,0,0,0,447,0.16666666666666666,114.65503458504179,6
2020-07-06-170405,170405,2,0,3,449,0.5,98.7854947759412,0
2020-07-07-170405,170405,1,0,4,450,0.3333333333333333,102.175445085576,1
2020-07-08-170405,170405,1,0,0,451,0.16666666666666666,87.48301439274071,2
2020-07-09-170405,170405,1,0,3,452,0.16666666666666666,98.64376537594507,3
2020-07-10-170405,170405,2,0,2,454,0.5,202.02156439047573,4
2020-07-11-170405,170405,0,0,0,454,0.0,210.3734063212334,5
2020-07-12-170405,170405,0,0,0,454,0.0,178.98569535350478,6
2020-07-13-170405,170405,1,0,3,455,1.0,164.83253075919473,0
2020-07-14-170405,170405,1,0,0,456,0.0,179.51458560427153,1
2020-07-15-170405,170405,2,0,3,458,0.5,169.3206257538833,2
2020-07-16-170405,170405,1,0,1,459,0.5,121.30808924965714,3
2020-07-17-170405,170405,0,0,1,459,0.0,99.0818164013597,4
2020-07-18-170405,170405,0,0,0,459,0.0,71.87557001876864,5
2020-07-19-170405,170405,0,0,0,459,0.0,75.30094360439526,6
2020-07-20-170405,170405,3,0,1,462,0.0,80.31349111593808,0
2020-07-21-170405,170405,4,0,3,466,1.0,92.10247342028086,1
2020-07-22-170405,170405,0,0,2,466,0.5,108.28190196603192,2
2020-07-23-170405,170405,3,0,2,469,0.0,108.11882501087601,3
2020-07-24-170405,170405,2,0,4,471,0.0,117.65734518096482,4
2020-07-25-170405,170405,0,0,0,471,0.16666666666666666,123.32543262301806,5
2020-07-26-170405,170405,0,0,2,471,0.16666666666666666,117.38857292914486,6
2020-07-27-170405,170405,3,0,2,474,0.3333333333333333,101.98589176904767,0
2020-07-28-170405,170405,0,0,0,474,0.5,103.81483224943989,1
2020-07-29-170405,170405,3,0,2,477,0.6666666666666666,83.13384261656068,2
2020-07-30-170405,170405,1,0,2,478,0.8333333333333334,82.83749386882593,3
2020-07-31-170405,170405,1,0,2,479,0.6666666666666666,102.53521761444625,4
2020-08-01-170405,170405,0,0,0,479,0.0,75.75638056232653,5
2020-08-02-170405,170405,0,0,0,479,0.0,218.73938065238085,6
2020-08-03-170405,170405,1,0,1,480,0.8333333333333334,265.20955635867995,0
2020-08-04-170405,170405,3,0,0,483,0.3333333333333333,256.1327537033626,1
2020-08-05-170405,170405,2,0,0,485,0.6666666666666666,226.71972287285743,2
2020-08-06-170405,170405,2,0,3,487,0.3333333333333333,205.41405558248107,3
2020-08-07-170405,170405,4,0,1,491,0.8333333333333334,183.40464960131064,4
2020-08-08-170405,170405,0,0,1,491,0.3333333333333333,205.8893693173634,5
2020-08-09-170405,170405,2,0,0,493,0.3333333333333333,188.92031705770302,6
2020-08-10-170405,170405,2,0,2,495,1.8333333333333333,64.32371039599407,0
2020-08-11-170405,170405,0,0,2,495,1.5,114.43561851628903,1
2020-08-12-170405,170405,2,0,1,497,1.3333333333333333,133.89839278588673,2
2020-08-13-170405,170405,2,0,0,499,1.3333333333333333,152.2820287944848,3
2020-08-14-170405,170405,2,0,0,501,0.8333333333333334,177.56656796833227,4
2020-08-15-170405,170405,0,0,1,501,0.16666666666666666,196.3971317556185,5
2020-08-16-170405,170405,0,0,0,501,0.6666666666666666,190.63191104730987,6
2020-08-17-170405,170405,1,0,0,502,1.3333333333333333,209.32306249517268,0
2020-08-18-170405,170405,0,0,2,502,2.0,187.34976078066654,1
2020-08-19-170405,170405,0,0,3,502,1.8333333333333333,209.5535315755687,2
2020-08-20-170405,170405,3,0,0,505,0.8333333333333334,175.30558337808577,3
2020-08-21-170405,170405,1,0,5,506,0.8333333333333334,198.83204448201795,4
2020-08-22-170405,170405,1,0,3,507,1.0,213.75576479655103,5
2020-08-23-170405,170405,0,0,2,507,0.0,232.48351503092005,6
2020-08-24-170405,170405,2,0,2,509,2.0,203.5658166921021,0
2020-08-25-170405,170405,2,0,2,511,1.1666666666666667,193.29150634751738,1
2020-08-26-170405,170405,1,0,1,512,1.5,196.70781234807328,2
2020-08-27-170405,170405,0,0,5,512,2.1666666666666665,250.42089275227013,3
2020-08-28-170405,170405,0,0,10,512,2.333333333333333,248.92444048382052,4
2020-08-29-170405,170405,1,0,3,513,1.0,269.2470625943103,5
2020-08-30-170405,170405,0,0,0,513,0.16666666666666666,290.07697140937796,6
2020-08-31-170405,170405,0,0,7,513,0.6666666666666666,269.64177197253747,0
2020-09-01-170405,170405,2,0,5,515,1.8333333333333333,195.3592177836872,1
2020-09-02-170405,170405,3,0,4,518,0.6666666666666666,493.61227054983544,2
2020-09-03-170405,170405,0,0,11,518,0.8333333333333334,557.324609339651,3
2020-09-04-170405,170405,5,1,8,523,0.3333333333333333,514.5383715829639,4
2020-09-05-170405,170405,3,0,6,526,0.6666666666666666,493.4900954906693,5
2020-09-06-170405,170405,2,0,0,528,1.0,504.41429676404454,6
2020-09-07-170405,170405,2,0,5,530,1.6666666666666667,489.9552408271045,0
2020-09-08-170405,170405,2,0,10,532,0.5,439.602757712258,1
2020-09-09-170405,170405,1,0,3,533,0.3333333333333333,364.5841161593689,2
2020-09-10-170405,170405,5,0,9,538,1.5,223.41560646117645,3
2020-09-11-170405,170405,10,0,2,548,1.5,246.5147294130957,4
2020-09-12-170405,170405,3,0,1,551,1.1666666666666667,305.9249281551,5
2020-09-13-170405,170405,0,0,3,551,1.1666666666666667,317.87631300229236,6
2020-09-14-170405,170405,7,0,10,558,0.8333333333333334,299.7391047215971,0
2020-09-15-170405,170405,5,0,7,563,2.0,344.4230335743124,1
2020-09-16-170405,170405,4,0,3,567,4.5,394.42481031174003,2
2020-09-17-170405,170405,11,0,4,578,3.1666666666666665,402.5685010482573,3
2020-09-18-170405,170405,8,0,5,586,3.8333333333333335,466.93886276737675,4
2020-09-19-170405,170405,6,0,2,592,1.8333333333333333,465.844255220599,5
2020-09-20-170405,170405,0,0,6,592,0.8333333333333334,498.4983194041097,6
2020-09-21-170405,170405,5,0,12,597,3.5,457.37214860946966,0
2020-09-22-170405,170405,10,1,12,607,5.666666666666668,468.65408195797374,1
2020-09-23-170405,170405,3,1,14,610,4.666666666666667,580.1367489212621,2
2020-09-24-170405,170405,9,1,18,619,2.5,566.3430957159617,3
2020-09-25-170405,170405,2,1,8,621,2.833333333333333,547.9227130508482,4
2020-09-26-170405,170405,1,0,9,622,1.0,548.3811841370268,5
2020-09-27-170405,170405,3,0,7,625,1.0,537.1865944811052,6
2020-09-28-170405,170405,10,0,11,635,3.6666666666666665,570.6740480271558,0
2020-09-29-170405,170405,7,0,6,642,2.833333333333333,607.4872330568106,1
2020-09-30-170405,170405,3,0,14,645,2.333333333333333,495.30435764366393,2
2020-10-01-170405,170405,4,0,9,649,7.166666666666668,0.0,3
2020-10-02-170405,170405,5,0,28,654,5.833333333333332,1132.1578678275173,4
2020-10-03-170405,170405,2,1,10,656,1.1666666666666667,1743.0948233612692,5
2020-10-04-170405,170405,6,0,10,662,2.0,1755.1673020395106,6
2020-10-05-170405,170405,12,0,11,674,6.333333333333332,1556.831164972184,0
2020-10-06-170405,170405,12,1,23,686,3.1666666666666665,1453.672241062045,1
2020-10-07-170405,170405,14,0,18,700,5.333333333333333,1411.830023196501,2
2020-10-08-170405,170405,18,3,20,718,4.833333333333333,1304.8832553031575,3
2020-10-09-170405,170405,8,1,25,726,6.0,1461.9398892406487,4
2020-10-10-170405,170405,9,0,16,735,9.666666666666666,176.83134893229,5
2020-10-11-170405,170405,7,0,11,742,5.0,391.2083748780269,6
2020-10-12-170405,170405,11,0,11,753,5.666666666666668,531.3549179088859,0
2020-10-13-170405,170405,6,0,17,759,4.833333333333333,623.6044318089203,1
2020-10-14-170405,170405,14,0,13,773,3.8333333333333335,780.1838052908083,2
2020-10-15-170405,170405,9,0,18,782,3.1666666666666665,931.9526382341114,3
2020-10-16-170405,170405,28,0,27,810,7.0,1037.6912785187842,4
2020-10-17-170405,170405,10,0,11,820,6.333333333333332,1101.3337635556222,5
2020-10-18-170405,170405,10,0,14,830,5.0,1055.4524361226822,6
2020-10-19-170405,170405,11,0,5,841,2.833333333333333,1069.7061332167934,0
2020-10-20-170405,170405,23,0,12,864,6.833333333333332,1109.7610506374194,1
2020-10-21-170405,170405,18,0,20,882,6.833333333333332,1241.166405033064,2
2020-10-22-170405,170405,20,0,11,902,11.0,1366.2532938028223,3
2020-10-23-170405,170405,25,0,19,927,13.333333333333336,1386.6495878722135,4
2020-10-24-170405,170405,16,0,8,943,5.0,1557.6857032118728,5
2020-10-25-170405,170405,11,0,9,954,2.333333333333333,1566.4160864632217,6
2020-10-26-170405,170405,11,0,17,965,7.0,1507.8223613652974,0
2020-10-27-170405,170405,17,1,10,982,8.166666666666666,1615.9891003157372,1
2020-10-28-170405,170405,13,4,15,995,5.0,1639.101716054102,2
2020-10-29-170405,170405,18,1,11,1013,8.833333333333334,1591.0664690259914,3
2020-10-30-170405,170405,27,1,4,1040,10.833333333333336,1362.832492520838,4
2020-10-31-170405,170405,11,0,0,1051,11.833333333333336,1489.5367513745346,5
2020-11-01-170405,170405,14,2,0,1065,7.666666666666668,1209.4638901857388,6
2020-11-02-170405,170405,5,2,0,1070,6.333333333333332,941.5758976774084,0
2020-11-03-170405,170405,12,1,0,1082,8.666666666666666,973.3187530848518,1
2020-11-04-170405,170405,20,1,0,1102,9.833333333333334,1153.9359702526772,2
2020-11-05-170405,170405,11,1,0,1113,8.333333333333334,1311.276700697009,3
2020-11-06-170405,170405,19,2,0,1132,16.5,1400.6205768785985,4
2020-11-07-170405,170405,8,1,0,1140,4.5,1589.8250972723936,5
2020-11-08-170405,170405,9,1,0,1149,4.666666666666667,1604.6230006049427,6
2020-11-09-170405,170405,17,0,0,1166,6.333333333333332,1549.2476168866788,0
2020-11-10-170405,170405,10,1,0,1176,5.833333333333332,1130.7881744845088,1
2020-11-11-170405,170405,15,1,0,1191,11.166666666666664,1192.6616938191476,2
2020-11-12-170405,170405,11,1,0,1202,6.166666666666668,1284.3672932712516,3
2020-11-13-170405,170405,4,1,0,1206,7.5,1308.027813500871,4
2020-03-01-170406,170406,0,0,0,0,0.0,0.0,6
2020-03-02-170406,170406,0,0,3,0,0.0,23.25355215815794,0
2020-03-03-170406,170406,0,0,7,0,0.0,131.59896378096408,1
2020-03-04-170406,170406,0,0,10,0,0.0,148.65926066861607,2
2020-03-05-170406,170406,0,0,8,0,0.0,158.66590743478378,3
2020-03-06-170406,170406,0,0,10,0,0.2,148.34029520632998,4
2020-03-07-170406,170406,0,0,4,0,0.0,143.52495977661022,5
2020-03-08-170406,170406,0,0,8,0,0.0,118.99040430923947,6
2020-03-09-170406,170406,0,0,13,0,0.0,119.47833267507964,0
2020-03-10-170406,170406,1,0,10,1,0.2,425.17505100372665,1
2020-03-11-170406,170406,0,0,10,1,0.2,342.4060211150916,2
2020-03-12-170406,170406,1,0,16,2,1.0,269.1615418069664,3
2020-03-13-170406,170406,2,0,17,4,0.2,169.51045255413305,4
2020-03-14-170406,170406,0,0,5,4,0.2,124.90921141688831,5
2020-03-15-170406,170406,0,0,1,4,0.4,81.8053003346513,6
2020-03-16-170406,170406,3,0,5,7,4.4,16.303550943685877,0
2020-03-17-170406,170406,7,0,9,14,2.6,44.55869842515373,1
2020-03-18-170406,170406,10,0,2,24,7.2,63.811729705032455,2
2020-03-19-170406,170406,8,0,8,32,8.2,107.41303804828271,3
2020-03-20-170406,170406,10,1,4,42,6.8,139.0395629268004,4
2020-03-21-170406,170406,4,0,4,46,3.8,160.58287166406518,5
2020-03-22-170406,170406,8,0,2,54,3.0,168.9217377665434,6
2020-03-23-170406,170406,13,0,4,67,9.0,163.87965940540778,0
2020-03-24-170406,170406,10,0,1,77,11.0,186.80075419664792,1
2020-03-25-170406,170406,10,0,4,87,11.2,193.7838441124252,2
2020-03-26-170406,170406,16,0,7,103,9.0,210.36424001217046,3
2020-03-27-170406,170406,17,0,5,120,9.0,254.3830846733333,4
2020-03-28-170406,170406,5,0,3,125,4.8,261.9796777903793,5
2020-03-29-170406,170406,1,0,1,126,5.6,270.32597393972605,6
2020-03-30-170406,170406,5,0,6,131,8.0,240.06589783116488,0
2020-03-31-170406,170406,9,0,0,140,5.8,224.6422224289052,1
2020-04-01-170406,170406,2,0,2,142,6.0,30.816349582869343,2
2020-04-02-170406,170406,8,0,2,150,6.4,90.15891275476622,3
2020-04-03-170406,170406,4,0,7,154,6.6,66.37977625314672,4
2020-04-04-170406,170406,4,0,2,158,3.2,78.86973036615626,5
2020-04-05-170406,170406,2,0,2,160,1.6,88.91163562588135,6
2020-04-06-170406,170406,4,1,5,164,5.0,88.81247182185749,0
2020-04-07-170406,170406,1,1,1,165,4.2,101.38725245367829,1
2020-04-08-170406,170406,4,0,5,169,4.8,114.79734301582624,2
2020-04-09-170406,170406,7,0,3,176,6.4,120.84341599425153,3
2020-04-10-170406,170406,5,0,7,181,3.8,28.56789547278813,4
2020-04-11-170406,170406,3,0,0,184,1.6,43.43156549698227,5
2020-04-12-170406,170406,1,0,3,185,0.8,51.387795115551945,6
2020-04-13-170406,170406,6,0,5,191,3.6,54.51551626255561,0
2020-04-14-170406,170406,0,0,3,191,5.4,73.34591040496304,1
2020-04-15-170406,170406,2,0,5,193,3.0,94.53253257775704,2
2020-04-16-170406,170406,2,0,0,195,3.4,105.72830188343258,3
2020-04-17-170406,170406,7,0,3,202,3.4,95.36726361816358,4
2020-04-18-170406,170406,2,0,3,204,0.8,99.60493007390942,5
2020-04-19-170406,170406,2,0,2,206,1.4,93.65558688977636,6
2020-04-20-170406,170406,5,0,3,211,4.4,103.26494944928871,0
2020-04-21-170406,170406,1,0,6,212,2.6,97.86864454873637,1
2020-04-22-170406,170406,5,0,0,217,3.2,96.43062239052922,2
2020-04-23-170406,170406,3,1,0,220,0.6,97.02551351754326,3
2020-04-24-170406,170406,7,0,3,227,3.8,81.03853639920712,4
2020-04-25-170406,170406,0,0,2,227,1.2,97.97238922379188,5
2020-04-26-170406,170406,3,0,0,230,1.2,97.21422543046964,6
2020-04-27-170406,170406,5,0,4,235,3.0,75.3100811524346,0
2020-04-28-170406,170406,3,1,2,238,1.6,71.06812632193916,1
2020-04-29-170406,170406,5,0,6,243,4.2,68.18270327953441,2
2020-04-30-170406,170406,0,0,4,243,2.6,92.3497135358923,3
2020-05-01-170406,170406,3,0,1,246,1.0,132.23325690981542,4
2020-05-02-170406,170406,3,0,1,249,1.0,44.76851058378638,5
2020-05-03-170406,170406,2,0,1,251,0.4,36.45683005623296,6
2020-05-04-170406,170406,3,0,1,254,4.0,36.21310771312977,0
2020-05-05-170406,170406,6,0,1,260,1.2,38.64156790800601,1
2020-05-06-170406,170406,0,0,0,260,1.8,42.615409984836965,2
2020-05-07-170406,170406,0,0,0,260,1.0,40.494737024635995,3
2020-05-08-170406,170406,3,0,4,263,2.2,42.123539420966665,4
2020-05-09-170406,170406,2,0,0,265,1.4,52.55288926359808,5
2020-05-10-170406,170406,0,0,0,265,0.4,145.34333585917386,6
2020-05-11-170406,170406,4,2,1,269,1.8,132.18185793629561,0
2020-05-12-170406,170406,2,0,0,271,2.8,132.36272129064295,1
2020-05-13-170406,170406,6,0,2,277,1.2,118.49303757428166,2
2020-05-14-170406,170406,4,0,0,281,1.0,103.72146958320798,3
2020-05-15-170406,170406,1,0,2,282,3.6,81.28522192497385,4
2020-05-16-170406,170406,1,0,0,283,0.0,64.87878576269804,5
2020-05-17-170406,170406,1,0,0,284,0.6,59.85377969083642,6
2020-05-18-170406,170406,1,1,0,285,1.8,58.49643919717742,0
2020-05-19-170406,170406,1,0,2,286,1.2,63.86077645619126,1
2020-05-20-170406,170406,0,0,0,286,1.0,54.87749004583661,2
2020-05-21-170406,170406,0,0,2,286,1.4,57.38475612747433,3
2020-05-22-170406,170406,4,0,1,290,1.6,46.200940326412095,4
2020-05-23-170406,170406,0,0,1,290,0.4,58.76121276549385,5
2020-05-24-170406,170406,0,0,0,290,0.0,59.1433782323639,6
2020-05-25-170406,170406,1,0,0,291,0.2,46.387071637095566,0
2020-05-26-170406,170406,0,0,5,291,2.6,43.427827073727954,1
2020-05-27-170406,170406,2,0,4,293,1.4,52.299250438956065,2
2020-05-28-170406,170406,0,0,1,293,2.4,53.82498122313298,3
2020-05-29-170406,170406,2,0,2,295,1.2,61.967643792640516,4
2020-05-30-170406,170406,0,0,0,295,0.2,56.77170404600686,5
2020-05-31-170406,170406,0,0,0,295,0.0,58.61440086210701,6
2020-06-01-170406,170406,0,0,3,295,1.0,76.11205145411753,0
2020-06-02-170406,170406,2,0,2,297,0.8,34.47675122702627,1
2020-06-03-170406,170406,0,0,0,297,1.0,26.72899369790283,2
2020-06-04-170406,170406,2,0,3,299,0.6,26.784886884426832,3
2020-06-05-170406,170406,1,0,1,300,0.8,31.841575177023717,4
2020-06-06-170406,170406,1,0,0,301,0.4,37.26773427921103,5
2020-06-07-170406,170406,0,0,0,301,0.4,39.675627922068074,6
2020-06-08-170406,170406,0,0,2,301,0.4,41.71456170820878,0
2020-06-09-170406,170406,5,0,0,306,2.2,36.97007777981438,1
2020-06-10-170406,170406,4,0,4,310,0.6,88.50392888817153,2
2020-06-11-170406,170406,1,0,0,311,0.8,74.26885863303461,3
2020-06-12-170406,170406,2,0,1,313,0.6,67.59050490948593,4
2020-06-13-170406,170406,0,0,0,313,0.2,60.09168141741487,5
2020-06-14-170406,170406,0,1,0,313,0.2,54.45599859106358,6
2020-06-15-170406,170406,3,0,1,316,1.0,40.25638570984151,0
2020-06-16-170406,170406,2,0,0,318,1.0,37.58641313494211,1
2020-06-17-170406,170406,0,0,3,318,1.6,38.71915494072326,2
2020-06-18-170406,170406,3,0,0,321,0.6,40.72074680307469,3
2020-06-19-170406,170406,1,0,0,322,0.2,38.63998504007837,4
2020-06-20-170406,170406,0,0,0,322,0.4,42.850069876787224,5
2020-06-21-170406,170406,0,0,0,322,0.2,43.99858154054897,6
2020-06-22-170406,170406,2,0,1,324,1.2,37.429743531669686,0
2020-06-23-170406,170406,0,0,1,324,0.4,37.588851347559206,1
2020-06-24-170406,170406,4,0,0,328,1.4,32.60111046578716,2
2020-06-25-170406,170406,0,0,0,328,0.0,38.468890488682845,3
2020-06-26-170406,170406,1,0,0,329,0.2,36.949765700801876,4
2020-06-27-170406,170406,0,0,0,329,0.2,31.201128398500423,5
2020-06-28-170406,170406,0,0,0,329,0.0,30.650603774812144,6
2020-06-29-170406,170406,1,0,0,330,1.2,29.317112267047584,0
2020-06-30-170406,170406,0,0,0,330,1.0,35.14443558063684,1
2020-07-01-170406,170406,3,0,0,333,1.4,47.29459183015311,2
2020-07-02-170406,170406,0,0,1,333,0.6,20.963205356489297,3
2020-07-03-170406,170406,0,0,0,333,0.0,24.71538399576766,4
2020-07-04-170406,170406,0,0,0,333,0.0,29.931232600259605,5
2020-07-05-170406,170406,0,0,0,333,0.2,30.1437837985112,6
2020-07-06-170406,170406,1,0,0,334,0.6,25.826343770204875,0
2020-07-07-170406,170406,1,0,2,335,0.4,26.885966684066442,1
2020-07-08-170406,170406,0,0,1,335,0.6,22.89195483105818,2
2020-07-09-170406,170406,0,0,0,335,0.4,25.87172266463756,3
2020-07-10-170406,170406,0,1,0,335,1.0,52.55414419348301,4
2020-07-11-170406,170406,0,0,1,335,0.0,54.953017908435655,5
2020-07-12-170406,170406,0,0,0,335,0.0,46.63112359762055,6
2020-07-13-170406,170406,0,0,1,335,1.0,42.81299797381588,0
2020-07-14-170406,170406,0,0,1,335,0.2,46.18499005050177,1
2020-07-15-170406,170406,0,0,1,335,0.6,43.691015922445615,2
2020-07-16-170406,170406,1,0,1,336,0.6,31.077322778280863,3
2020-07-17-170406,170406,0,0,1,336,0.0,25.452590569205768,4
2020-07-18-170406,170406,0,0,0,336,0.0,17.967720317591507,5
2020-07-19-170406,170406,0,0,0,336,0.0,18.858252921412934,6
2020-07-20-170406,170406,0,0,2,336,0.6,20.697959928397893,0
2020-07-21-170406,170406,2,0,1,338,1.6,23.66759486809537,1
2020-07-22-170406,170406,1,0,1,339,1.0,27.722547085899002,2
2020-07-23-170406,170406,0,0,0,339,0.6,27.435728318456512,3
2020-07-24-170406,170406,0,0,3,339,0.4,30.04225326200997,4
2020-07-25-170406,170406,1,0,0,340,0.0,31.769575988827015,5
2020-07-26-170406,170406,0,0,1,340,0.0,30.248738719205782,6
2020-07-27-170406,170406,1,0,5,341,0.8,25.873164839642563,0
2020-07-28-170406,170406,1,0,4,342,0.4,26.545554608781163,1
2020-07-29-170406,170406,1,0,5,343,1.2,21.26175510916719,2
2020-07-30-170406,170406,1,0,3,344,1.0,21.626499273775657,3
2020-07-31-170406,170406,1,1,0,345,0.8,26.606512776156634,4
2020-08-01-170406,170406,0,0,1,345,0.0,19.57478618697452,5
2020-08-02-170406,170406,0,0,1,345,0.0,56.78524321394192,6
2020-08-03-170406,170406,2,0,2,347,1.0,66.99507117127763,0
2020-08-04-170406,170406,1,0,5,348,0.8,64.975127358047,1
2020-08-05-170406,170406,1,0,5,349,0.8,57.86347418425554,2
2020-08-06-170406,170406,0,0,1,349,1.0,52.90542665192603,3
2020-08-07-170406,170406,3,0,2,352,1.2,47.62626054293358,4
2020-08-08-170406,170406,0,0,0,352,0.4,53.91827329396317,5
2020-08-09-170406,170406,1,0,0,353,0.6,49.74160095608745,6
2020-08-10-170406,170406,5,0,3,358,1.2,16.586284457552043,0
2020-08-11-170406,170406,4,0,2,362,1.0,29.623197533590265,1
2020-08-12-170406,170406,5,0,1,367,0.6,34.3108518493082,2
2020-08-13-170406,170406,3,0,3,370,1.2,38.660687125192915,3
2020-08-14-170406,170406,0,0,4,370,1.4,45.42633082729181,4
2020-08-15-170406,170406,1,0,2,371,0.0,50.02173645607389,5
2020-08-16-170406,170406,1,0,0,372,0.6,49.06516303331837,6
2020-08-17-170406,170406,2,0,0,374,1.2,54.19389637070047,0
2020-08-18-170406,170406,5,0,2,379,1.2,48.76895097262043,1
2020-08-19-170406,170406,5,0,0,384,1.0,54.80961493633984,2
2020-08-20-170406,170406,1,0,2,385,1.4,45.636473348216214,3
2020-08-21-170406,170406,2,0,0,387,1.0,52.47197054046176,4
2020-08-22-170406,170406,0,0,1,387,1.4,56.634207940865565,5
2020-08-23-170406,170406,0,1,1,387,0.0,61.137697638380274,6
2020-08-24-170406,170406,3,0,2,390,1.8,53.38137784217896,0
2020-08-25-170406,170406,2,0,0,392,1.2,50.74231319948734,1
2020-08-26-170406,170406,1,0,0,393,1.8,51.68870685401365,2
2020-08-27-170406,170406,3,0,1,396,1.6,65.61266095755774,3
2020-08-28-170406,170406,4,0,1,400,1.8,63.65003099486532,4
2020-08-29-170406,170406,2,0,4,402,1.0,68.790028069295,5
2020-08-30-170406,170406,0,0,2,402,0.2,73.80425926614001,6
2020-08-31-170406,170406,0,0,1,402,0.8,68.80998394226157,0
2020-09-01-170406,170406,2,0,2,404,2.2,50.7492055592071,1
2020-09-02-170406,170406,0,0,4,404,1.2,128.2181324872463,2
2020-09-03-170406,170406,2,0,2,406,0.6,141.99020919268457,3
2020-09-04-170406,170406,0,0,3,406,1.4,129.7902508119849,4
2020-09-05-170406,170406,1,0,3,407,1.2,124.35078349867705,5
2020-09-06-170406,170406,1,0,1,408,1.4,127.57563506417179,6
2020-09-07-170406,170406,2,0,7,410,2.0,123.8826673009305,0
2020-09-08-170406,170406,0,0,8,410,1.0,112.68781960284264,1
2020-09-09-170406,170406,0,0,8,410,0.6,93.2495577331574,2
2020-09-10-170406,170406,1,0,6,411,2.4,58.12658838939302,3
2020-09-11-170406,170406,1,0,3,412,3.4,64.39837276384128,4
2020-09-12-170406,170406,4,0,2,416,1.4,80.9372678468314,5
2020-09-13-170406,170406,2,0,1,418,0.8,83.93662427355034,6
2020-09-14-170406,170406,1,0,10,419,2.2,79.07589263654066,0
2020-09-15-170406,170406,2,0,6,421,2.8,91.13327085957454,1
2020-09-16-170406,170406,4,0,7,425,4.6,103.74046775839143,2
2020-09-17-170406,170406,2,0,14,427,5.6,104.91712746551214,3
2020-09-18-170406,170406,3,0,7,430,5.0,121.98371707524554,4
2020-09-19-170406,170406,3,0,1,433,2.6,120.95835739500964,5
2020-09-20-170406,170406,1,0,8,434,0.4,129.83963321819348,6
2020-09-21-170406,170406,7,1,12,441,3.2,118.27102288502871,0
2020-09-22-170406,170406,8,0,3,449,6.2,121.56971206564982,1
2020-09-23-170406,170406,8,0,9,457,4.8,151.66389283579662,2
2020-09-24-170406,170406,6,0,13,463,3.6,148.39314936346443,3
2020-09-25-170406,170406,3,0,9,466,3.0,142.82534703810484,4
2020-09-26-170406,170406,2,0,5,468,0.6,142.12364098874303,5
2020-09-27-170406,170406,1,0,4,469,1.6,139.2551410743548,6
2020-09-28-170406,170406,10,0,4,479,4.0,148.04722869835757,0
2020-09-29-170406,170406,6,0,13,485,3.4,156.96239589867082,1
2020-09-30-170406,170406,7,0,7,492,2.4,126.46921339539463,2
2020-10-01-170406,170406,14,0,2,506,5.8,0.0,3
2020-10-02-170406,170406,7,0,15,513,5.0,298.0689496224116,4
2020-10-03-170406,170406,1,1,14,514,1.2,456.5689003030439,5
2020-10-04-170406,170406,8,1,15,522,1.8,452.222806620219,6
2020-10-05-170406,170406,12,1,5,534,7.4,400.649619132888,0
2020-10-06-170406,170406,3,0,10,537,5.4,374.33827908508096,1
2020-10-07-170406,170406,9,0,11,546,7.2,364.8132278076476,2
2020-10-08-170406,170406,13,3,14,559,6.8,339.7180243935471,3
2020-10-09-170406,170406,9,0,20,568,6.0,382.95521539414364,4
2020-10-10-170406,170406,5,0,9,573,11.6,45.861798251176594,5
2020-10-11-170406,170406,4,0,3,577,4.6,99.54223122025206,6
2020-10-12-170406,170406,4,0,12,581,4.4,135.99488896344351,0
2020-10-13-170406,170406,13,0,10,594,4.4,159.6611426713378,1
2020-10-14-170406,170406,7,0,9,601,5.8,201.22192340401133,2
2020-10-15-170406,170406,2,0,20,603,4.0,241.6193944797046,3
2020-10-16-170406,170406,15,0,21,618,11.0,269.3818559173906,4
2020-10-17-170406,170406,14,0,11,632,4.8,288.0803405333927,5
2020-10-18-170406,170406,15,0,11,647,5.0,278.71281485565385,6
2020-10-19-170406,170406,5,0,8,652,4.8,283.2559234026305,0
2020-10-20-170406,170406,10,0,13,662,10.4,292.92518080019784,1
2020-10-21-170406,170406,11,0,13,673,8.8,326.2105639223534,2
2020-10-22-170406,170406,14,0,14,687,9.8,359.90979790738766,3
2020-10-23-170406,170406,20,0,32,707,16.4,363.0478823584064,4
2020-10-24-170406,170406,9,0,3,716,7.6,407.897496217716,5
2020-10-25-170406,170406,3,0,5,719,4.2,411.8125199987635,6
2020-10-26-170406,170406,12,0,7,731,8.2,397.4563833408176,0
2020-10-27-170406,170406,10,0,9,741,11.4,427.6737489892707,1
2020-10-28-170406,170406,9,0,20,750,6.0,436.38595737174296,2
2020-10-29-170406,170406,20,0,11,770,10.2,421.2453796821,3
2020-10-30-170406,170406,21,2,13,791,13.8,359.8140229331863,4
2020-10-31-170406,170406,11,1,0,802,13.6,393.3717971922189,5
2020-11-01-170406,170406,11,0,0,813,8.8,319.59593073355575,6
2020-11-02-170406,170406,8,0,0,821,5.4,245.43144245538613,0
2020-11-03-170406,170406,13,0,0,834,8.8,255.52358859781845,1
2020-11-04-170406,170406,13,1,0,847,10.6,302.3612033768025,2
2020-11-05-170406,170406,14,0,0,861,8.6,343.21585061266154,3
2020-11-06-170406,170406,32,1,0,893,15.8,367.07770530534754,4
2020-11-07-170406,170406,3,0,0,896,5.2,418.339275585326,5
2020-11-08-170406,170406,5,1,0,901,6.2,423.48687718513173,6
2020-11-09-170406,170406,7,2,0,908,8.4,408.30362270680297,0
2020-11-10-170406,170406,9,0,0,917,6.8,302.93046130872654,1
2020-11-11-170406,170406,20,2,0,937,11.2,319.6128434339149,2
2020-11-12-170406,170406,11,0,0,948,5.8,343.9691629740925,3
2020-11-13-170406,170406,13,2,0,961,7.0,351.6400376810496,4
2020-03-01-170407,170407,0,0,1,0,0.0,0.0,6
2020-03-02-170407,170407,0,0,2,0,0.0,5.8840953895434716,0
2020-03-03-170407,170407,0,0,0,0,0.0,28.454816404222736,1
2020-03-04-170407,170407,0,0,0,0,0.0,27.000718400563564,2
2020-03-05-170407,170407,0,0,2,0,0.0,28.240417904390178,3
2020-03-06-170407,170407,0,3,3,0,0.2,26.07469529622953,4
2020-03-07-170407,170407,0,0,1,0,0.0,25.70970402146201,5
2020-03-08-170407,170407,0,0,0,0,0.0,23.167795887820674,6
2020-03-09-170407,170407,0,0,7,0,0.0,23.141565131648896,0
2020-03-10-170407,170407,0,0,5,0,0.2,62.23835089740975,1
2020-03-11-170407,170407,0,0,2,0,0.0,50.31625955154337,2
2020-03-12-170407,170407,0,0,3,0,0.4,38.556938224489066,3
2020-03-13-170407,170407,0,0,3,0,0.4,26.40854095543746,4
2020-03-14-170407,170407,0,0,0,0,0.0,20.61472985014381,5
2020-03-15-170407,170407,1,0,2,1,0.4,15.727982126103615,6
2020-03-16-170407,170407,2,0,3,3,1.0,4.183364823154285,0
2020-03-17-170407,170407,0,0,0,3,3.2,10.121301145039228,1
2020-03-18-170407,170407,0,1,0,3,4.4,17.66638233878946,2
2020-03-19-170407,170407,2,0,2,5,3.8,27.787933934353944,3
2020-03-20-170407,170407,3,0,1,8,4.8,36.803688217449626,4
2020-03-21-170407,170407,1,0,0,9,2.8,42.255699362543595,5
2020-03-22-170407,170407,0,0,0,9,2.8,43.47165237234698,6
2020-03-23-170407,170407,7,0,0,16,5.8,41.32753359947403,0
2020-03-24-170407,170407,5,0,1,21,5.4,46.14770438845075,1
2020-03-25-170407,170407,2,0,0,23,7.6,48.33642352915628,2
2020-03-26-170407,170407,3,0,2,26,7.2,51.46513134809933,3
2020-03-27-170407,170407,3,1,1,29,8.6,58.62630507871428,4
2020-03-28-170407,170407,0,0,0,29,2.8,59.36248504810593,5
2020-03-29-170407,170407,2,0,0,31,2.4,60.205021157898955,6
2020-03-30-170407,170407,3,0,1,34,4.0,51.52857241151939,0
2020-03-31-170407,170407,0,0,2,34,4.8,46.38780027522562,1
2020-04-01-170407,170407,0,0,2,34,3.2,6.385333299357722,2
2020-04-02-170407,170407,2,0,0,36,4.2,20.18239579000021,3
2020-04-03-170407,170407,1,0,0,37,3.8,15.286680036864364,4
2020-04-04-170407,170407,0,0,0,37,3.2,17.11621024643633,5
2020-04-05-170407,170407,0,0,1,37,1.0,18.556929241405,6
2020-04-06-170407,170407,0,1,3,37,3.6,18.592563876683126,0
2020-04-07-170407,170407,1,0,0,38,2.2,21.107567316180987,1
2020-04-08-170407,170407,0,0,0,38,3.0,23.67638059926895,2
2020-04-09-170407,170407,2,0,0,40,4.6,25.27754973651756,3
2020-04-10-170407,170407,1,0,0,41,2.4,4.977957815016214,4
2020-04-11-170407,170407,0,0,1,41,1.4,8.851888980148065,5
2020-04-12-170407,170407,0,0,0,41,0.6,10.614858127770924,6
2020-04-13-170407,170407,1,0,3,42,2.2,12.101472188682152,0
2020-04-14-170407,170407,2,0,2,44,3.2,17.67409322659189,1
2020-04-15-170407,170407,2,0,0,46,1.8,21.793117202847984,2
2020-04-16-170407,170407,0,0,1,46,2.0,24.138405934563494,3
2020-04-17-170407,170407,0,0,0,46,3.2,23.07413617923524,4
2020-04-18-170407,170407,0,0,0,46,1.0,21.928220516008846,5
2020-04-19-170407,170407,1,0,0,47,1.6,20.776293327558427,6
2020-04-20-170407,170407,3,0,3,50,3.4,21.63348979762324,0
2020-04-21-170407,170407,0,0,0,50,2.4,20.231196924859283,1
2020-04-22-170407,170407,0,0,1,50,3.8,20.61378238469673,2
2020-04-23-170407,170407,0,0,0,50,1.0,20.990439557093694,3
2020-04-24-170407,170407,0,0,0,50,3.2,18.62998367218423,4
2020-04-25-170407,170407,1,0,0,51,0.8,22.43993989070026,5
2020-04-26-170407,170407,0,0,0,51,1.0,22.11722814754605,6
2020-04-27-170407,170407,3,0,4,54,2.8,16.497079774038244,0
2020-04-28-170407,170407,2,0,0,56,1.0,15.918710055040606,1
2020-04-29-170407,170407,0,1,0,56,3.8,15.42262369078935,2
2020-04-30-170407,170407,1,0,2,57,1.6,19.96167192844166,3
2020-05-01-170407,170407,0,0,2,57,1.0,25.398396261414952,4
2020-05-02-170407,170407,0,0,0,57,0.8,8.382179649756281,5
2020-05-03-170407,170407,0,0,0,57,0.8,8.63170911612387,6
2020-05-04-170407,170407,3,0,0,60,2.8,7.584276068483265,0
2020-05-05-170407,170407,0,0,0,60,1.6,8.363651788174094,1
2020-05-06-170407,170407,1,0,0,61,0.6,8.985195042881585,2
2020-05-07-170407,170407,0,0,1,61,0.2,8.99480003361829,3
2020-05-08-170407,170407,0,0,0,61,2.8,9.24431671102304,4
2020-05-09-170407,170407,0,0,0,61,1.8,11.332023596382516,5
2020-05-10-170407,170407,0,0,0,61,0.8,28.39209225369468,6
2020-05-11-170407,170407,4,2,0,65,1.8,27.694067222019566,0
2020-05-12-170407,170407,0,0,1,65,1.6,28.89367591681716,1
2020-05-13-170407,170407,0,2,2,65,1.8,25.070805305626912,2
2020-05-14-170407,170407,2,0,1,67,1.4,21.088737439756322,3
2020-05-15-170407,170407,2,0,0,69,1.4,17.306781071624936,4
2020-05-16-170407,170407,0,0,0,69,0.2,14.393540797236902,5
2020-05-17-170407,170407,0,0,0,69,0.2,13.696231793769357,6
2020-05-18-170407,170407,0,0,1,69,0.8,11.837403110212943,0
2020-05-19-170407,170407,0,0,0,69,0.6,12.68744784903196,1
2020-05-20-170407,170407,0,0,0,69,0.6,10.840564764831509,2
2020-05-21-170407,170407,1,0,0,70,0.6,11.44866197428378,3
2020-05-22-170407,170407,0,0,0,70,1.4,9.648765119019341,4
2020-05-23-170407,170407,0,0,0,70,0.4,12.203205795255716,5
2020-05-24-170407,170407,0,0,1,70,0.0,12.096203314167386,6
2020-05-25-170407,170407,0,0,0,70,1.0,8.961729250474313,0
2020-05-26-170407,170407,1,0,1,71,0.8,10.064551099140038,1
2020-05-27-170407,170407,2,0,1,73,1.0,11.931190725875666,2
2020-05-28-170407,170407,1,1,0,74,1.4,12.546454364076142,3
2020-05-29-170407,170407,0,0,0,74,1.2,13.621177852746536,4
2020-05-30-170407,170407,0,0,0,74,0.2,13.253040668414926,5
2020-05-31-170407,170407,0,1,0,74,0.0,14.031624725608921,6
2020-06-01-170407,170407,1,0,1,75,0.6,15.573998868499405,0
2020-06-02-170407,170407,0,1,0,75,1.2,7.25057455792704,1
2020-06-03-170407,170407,0,0,2,75,0.2,4.658992716847789,2
2020-06-04-170407,170407,0,0,0,75,0.6,4.655992006383981,3
2020-06-05-170407,170407,0,0,0,75,1.0,5.7687063366783216,4
2020-06-06-170407,170407,0,3,1,75,0.2,7.055692490267369,5
2020-06-07-170407,170407,1,0,0,76,0.0,7.476136418426715,6
2020-06-08-170407,170407,0,0,0,76,0.2,8.12358010698538,0
2020-06-09-170407,170407,1,0,0,77,2.2,7.22764191727302,1
2020-06-10-170407,170407,1,0,0,78,1.0,18.670219930444276,2
2020-06-11-170407,170407,0,0,0,78,1.0,16.070856998068557,3
2020-06-12-170407,170407,0,0,0,78,0.8,14.069437908757838,4
2020-06-13-170407,170407,0,0,0,78,0.0,12.684269944276059,5
2020-06-14-170407,170407,0,0,0,78,0.0,10.93062985886051,6
2020-06-15-170407,170407,1,0,0,79,0.6,8.265271106962448,0
2020-06-16-170407,170407,0,0,0,79,1.2,8.317413496519732,1
2020-06-17-170407,170407,2,0,3,81,0.4,8.35859880128882,2
2020-06-18-170407,170407,0,0,0,81,0.8,8.271192793056752,3
2020-06-19-170407,170407,0,0,0,81,0.2,8.058101889893116,4
2020-06-20-170407,170407,1,0,0,82,0.0,8.509004411062007,5
2020-06-21-170407,170407,0,0,0,82,0.0,9.06325442414272,6
2020-06-22-170407,170407,0,0,0,82,0.6,7.834285473430792,0
2020-06-23-170407,170407,0,0,0,82,0.0,7.007082816633558,1
2020-06-24-170407,170407,0,1,1,82,1.2,5.91900177569547,2
2020-06-25-170407,170407,0,0,1,82,0.0,7.162322485107919,3
2020-06-26-170407,170407,0,0,0,82,0.4,7.182360175349669,4
2020-06-27-170407,170407,0,0,0,82,0.0,5.854953074949653,5
2020-06-28-170407,170407,0,0,0,82,0.0,5.580760717743335,6
2020-06-29-170407,170407,0,0,1,82,0.2,5.3618701271381415,0
2020-06-30-170407,170407,0,0,0,82,0.2,6.391374030653479,1
2020-07-01-170407,170407,3,0,0,85,1.0,9.148877748828856,2
2020-07-02-170407,170407,0,0,0,85,0.2,4.9538435346779135,3
2020-07-03-170407,170407,0,0,0,85,0.0,4.480151695651744,4
2020-07-04-170407,170407,0,0,0,85,0.0,4.662082341826793,5
2020-07-05-170407,170407,0,0,0,85,0.2,4.740396908048069,6
2020-07-06-170407,170407,0,0,0,85,0.2,3.9988645973308383,0
2020-07-07-170407,170407,0,0,0,85,0.6,3.9677880632342086,1
2020-07-08-170407,170407,1,0,3,86,0.4,3.564863793183104,2
2020-07-09-170407,170407,1,0,0,87,0.0,4.139760879558207,3
2020-07-10-170407,170407,0,1,0,87,0.2,10.799059250995043,4
2020-07-11-170407,170407,0,0,0,87,0.0,10.699797490039241,5
2020-07-12-170407,170407,0,0,0,87,0.0,8.760863513541796,6
2020-07-13-170407,170407,1,0,0,88,0.4,8.062615117695906,0
2020-07-14-170407,170407,0,0,0,88,0.2,9.015265435015143,1
2020-07-15-170407,170407,0,0,0,88,0.0,8.897020620087075,2
2020-07-16-170407,170407,0,0,0,88,0.8,7.073599670803581,3
2020-07-17-170407,170407,0,0,0,88,0.0,5.546188439715382,4
2020-07-18-170407,170407,0,0,0,88,0.2,4.10788110023662,5
2020-07-19-170407,170407,0,0,0,88,0.8,4.559309101243522,6
2020-07-20-170407,170407,0,0,2,88,0.2,5.368322073922938,0
2020-07-21-170407,170407,0,0,0,88,1.4,5.810077923549269,1
2020-07-22-170407,170407,3,0,0,91,0.4,7.2042933744801845,2
2020-07-23-170407,170407,0,0,1,91,0.4,7.225105682703088,3
2020-07-24-170407,170407,0,0,0,91,0.0,8.250667625859446,4
2020-07-25-170407,170407,0,0,0,91,0.2,8.376515773998324,5
2020-07-26-170407,170407,0,0,0,91,0.0,7.219476774287136,6
2020-07-27-170407,170407,0,0,0,91,0.2,6.4911882229269775,0
2020-07-28-170407,170407,0,0,1,91,0.6,6.390002585321278,1
2020-07-29-170407,170407,0,0,0,91,0.2,5.194759922000486,2
2020-07-30-170407,170407,0,0,0,91,0.4,4.313585799864399,3
2020-07-31-170407,170407,0,0,0,91,0.4,4.916605890302,4
2020-08-01-170407,170407,0,1,0,91,0.0,4.075016718514308,5
2020-08-02-170407,170407,0,0,0,91,0.0,10.864292839124127,6
2020-08-03-170407,170407,2,0,0,93,0.4,20.403306133788767,0
2020-08-04-170407,170407,0,0,0,93,0.2,22.623023438357265,1
2020-08-05-170407,170407,0,0,0,93,0.4,18.925874643156156,2
2020-08-06-170407,170407,1,0,0,94,0.6,16.096108677828603,3
2020-08-07-170407,170407,0,0,1,94,1.6,14.038622766360621,4
2020-08-08-170407,170407,0,0,0,94,0.2,15.500151950992606,5
2020-08-09-170407,170407,0,1,0,94,0.2,14.074215772429211,6
2020-08-10-170407,170407,0,0,0,94,1.6,3.90729512020084,0
2020-08-11-170407,170407,1,0,0,95,1.8,6.297283347180449,1
2020-08-12-170407,170407,0,0,0,95,1.2,7.7486048873538715,2
2020-08-13-170407,170407,0,0,0,95,1.0,8.623624387828805,3
2020-08-14-170407,170407,0,0,0,95,1.0,9.468807819402448,4
2020-08-15-170407,170407,0,0,0,95,0.6,10.88567005262968,5
2020-08-16-170407,170407,0,0,0,95,0.8,11.65584314146139,6
2020-08-17-170407,170407,0,0,0,95,0.8,12.233960588426621,0
2020-08-18-170407,170407,0,0,0,95,2.4,10.940833109491916,1
2020-08-19-170407,170407,0,0,0,95,1.6,11.58829936919053,2
2020-08-20-170407,170407,0,0,0,95,1.0,10.092570324880496,3
2020-08-21-170407,170407,1,0,0,96,0.8,10.090508745657937,4
2020-08-22-170407,170407,0,0,0,96,0.8,10.929307654651547,5
2020-08-23-170407,170407,0,0,0,96,0.0,11.980647398268879,6
2020-08-24-170407,170407,0,0,0,96,1.0,10.854941396128215,0
2020-08-25-170407,170407,0,0,0,96,0.8,10.336518807077223,1
2020-08-26-170407,170407,0,0,0,96,0.6,11.16860955493993,2
2020-08-27-170407,170407,0,0,0,96,2.0,16.604817623834435,3
2020-08-28-170407,170407,0,0,0,96,2.0,19.543882573266036,4
2020-08-29-170407,170407,0,0,1,96,1.2,21.54171401105394,5
2020-08-30-170407,170407,0,0,0,96,0.0,22.579800211379755,6
2020-08-31-170407,170407,0,0,0,96,0.4,22.97733749363929,0
2020-09-01-170407,170407,0,0,0,96,1.2,13.190074128961049,1
2020-09-02-170407,170407,0,0,0,96,0.6,26.865533863480152,2
2020-09-03-170407,170407,0,0,0,96,1.0,30.06007240845687,3
2020-09-04-170407,170407,0,0,0,96,0.8,31.498171415374145,4
2020-09-05-170407,170407,0,0,0,96,0.8,30.062451132502012,5
2020-09-06-170407,170407,0,0,0,96,1.2,29.839003503951467,6
2020-09-07-170407,170407,0,0,1,96,2.0,29.315692438968643,0
2020-09-08-170407,170407,0,0,1,96,1.6,24.815614516311072,1
2020-09-09-170407,170407,0,0,1,96,0.8,23.75719392006863,2
2020-09-10-170407,170407,0,0,2,96,1.4,14.375463188937488,3
2020-09-11-170407,170407,0,0,1,96,1.2,15.18167880014829,4
2020-09-12-170407,170407,1,0,0,97,1.6,18.166588889684455,5
2020-09-13-170407,170407,0,0,0,97,0.8,18.675907357510347,6
2020-09-14-170407,170407,0,0,1,97,1.0,16.958720820642995,0
2020-09-15-170407,170407,0,0,1,97,2.4,18.98948923508394,1
2020-09-16-170407,170407,0,0,2,97,2.8,21.50845459848039,2
2020-09-17-170407,170407,0,0,1,97,3.8,20.430946628781744,3
2020-09-18-170407,170407,0,0,0,97,3.0,23.748337295694057,4
2020-09-19-170407,170407,0,0,0,97,1.6,23.644725683770734,5
2020-09-20-170407,170407,0,0,0,97,0.6,23.79993045745026,6
2020-09-21-170407,170407,1,0,0,98,4.2,21.791505788991714,0
2020-09-22-170407,170407,1,0,0,99,5.2,21.855914812826327,1
2020-09-23-170407,170407,1,0,0,100,3.8,26.761173033493606,2
2020-09-24-170407,170407,2,1,0,102,3.0,25.43791051791781,3
2020-09-25-170407,170407,1,0,0,103,4.0,25.122539286746985,4
2020-09-26-170407,170407,0,1,0,103,0.6,26.682038249680343,5
2020-09-27-170407,170407,0,0,0,103,1.2,26.4582769173984,6
2020-09-28-170407,170407,1,0,0,104,3.6,27.94693074058741,0
2020-09-29-170407,170407,1,0,1,105,3.0,28.768665516126354,1
2020-09-30-170407,170407,2,0,1,107,3.0,26.995389491677656,2
2020-10-01-170407,170407,1,0,0,108,6.4,0.0,3
2020-10-02-170407,170407,0,0,1,108,5.2,48.38920681176178,4
2020-10-03-170407,170407,0,0,0,108,1.0,67.50973990248178,5
2020-10-04-170407,170407,0,0,0,108,2.2,75.12985208642905,6
2020-10-05-170407,170407,0,0,1,108,7.2,66.80999510425237,0
2020-10-06-170407,170407,0,0,2,108,2.8,62.49829704181618,1
2020-10-07-170407,170407,0,0,1,108,6.2,59.20705104109548,2
2020-10-08-170407,170407,0,1,0,108,5.6,53.361956895991646,3
2020-10-09-170407,170407,0,0,0,108,5.0,58.529611958732346,4
2020-10-10-170407,170407,0,0,1,108,10.2,7.462277692619896,5
2020-10-11-170407,170407,0,0,0,108,4.0,18.60675050546916,6
2020-10-12-170407,170407,0,0,1,108,2.6,25.31559830961868,0
2020-10-13-170407,170407,1,0,2,109,5.6,30.899223590519313,1
2020-10-14-170407,170407,1,0,2,110,3.0,38.506447616831196,2
2020-10-15-170407,170407,0,0,3,110,1.8,46.12574886085831,3
2020-10-16-170407,170407,1,0,4,111,5.8,51.38777220039826,4
2020-10-17-170407,170407,0,0,0,111,4.2,53.56892006141831,5
2020-10-18-170407,170407,0,0,1,111,5.2,48.86399719634787,6
2020-10-19-170407,170407,1,0,0,112,3.2,47.42118041137791,0
2020-10-20-170407,170407,2,0,1,114,6.4,46.630297796665744,1
2020-10-21-170407,170407,1,0,1,115,7.0,52.95396687816509,2
2020-10-22-170407,170407,0,0,0,115,8.4,57.28614699718391,3
2020-10-23-170407,170407,0,0,1,115,12.2,59.15617186180237,4
2020-10-24-170407,170407,1,0,0,116,5.4,64.13066040600411,5
2020-10-25-170407,170407,0,0,0,116,2.0,64.47063371550485,6
2020-10-26-170407,170407,1,0,4,117,7.6,59.603914344584034,0
2020-10-27-170407,170407,2,0,3,119,9.4,62.801907381274404,1
2020-10-28-170407,170407,2,0,1,121,3.8,60.886574418613634,2
2020-10-29-170407,170407,3,0,0,124,9.2,59.16500826245363,3
2020-10-30-170407,170407,4,1,0,128,13.0,51.126576851258015,4
2020-10-31-170407,170407,0,0,0,128,13.8,58.07881170509248,5
2020-11-01-170407,170407,1,0,0,129,7.2,46.206382028556305,6
2020-11-02-170407,170407,0,0,0,129,6.2,46.24994551402472,0
2020-11-03-170407,170407,1,0,0,130,8.6,44.453157638881436,1
2020-11-04-170407,170407,1,0,0,131,9.2,52.11789106284665,2
2020-11-05-170407,170407,0,0,0,131,10.0,58.257836912667024,3
2020-11-06-170407,170407,1,0,0,132,16.2,62.51886426482597,4
2020-11-07-170407,170407,0,0,0,132,3.8,68.2719274786424,5
2020-11-08-170407,170407,0,0,0,132,4.6,68.32641881665475,6
2020-11-09-170407,170407,4,0,0,136,7.4,65.97633131128853,0
2020-11-10-170407,170407,3,0,0,139,5.2,40.7842447287474,1
2020-11-11-170407,170407,1,0,0,140,13.0,45.45199653255898,2
2020-11-12-170407,170407,0,0,0,140,6.8,53.881861754815446,3
2020-11-13-170407,170407,0,0,0,140,7.4,56.76969792661718,4
2020-03-01-170408,170408,0,0,0,0,0.0,0.0,6
2020-03-02-170408,170408,0,0,0,0,0.0,16.114623146393832,0
2020-03-03-170408,170408,0,0,0,0,0.0,75.54333420709185,1
2020-03-04-170408,170408,0,0,1,0,0.0,76.00363162187999,2
2020-03-05-170408,170408,0,0,1,0,0.0,77.77067638726537,3
2020-03-06-170408,170408,0,1,0,0,0.14285714285714285,74.14326207176146,4
2020-03-07-170408,170408,0,1,1,0,0.0,74.3405685247406,5
2020-03-08-170408,170408,0,0,0,0,0.0,62.91301177502507,6
2020-03-09-170408,170408,0,1,1,0,0.0,63.01711610366893,0
2020-03-10-170408,170408,0,0,3,0,0.14285714285714285,295.4849605506006,1
2020-03-11-170408,170408,0,0,2,0,0.14285714285714285,216.51038360817097,2
2020-03-12-170408,170408,0,0,0,0,0.5714285714285714,173.1877744832468,3
2020-03-13-170408,170408,0,0,0,0,0.2857142857142857,122.79306417202588,4
2020-03-14-170408,170408,0,0,0,0,0.2857142857142857,87.19305500450004,5
2020-03-15-170408,170408,0,0,0,0,0.2857142857142857,66.9646983500885,6
2020-03-16-170408,170408,0,0,0,0,2.7142857142857144,8.3342312996017,0
2020-03-17-170408,170408,0,0,0,0,2.4285714285714284,18.68744483557124,1
2020-03-18-170408,170408,1,0,0,1,5.571428571428571,38.451748753748845,2
2020-03-19-170408,170408,1,0,1,2,6.2857142857142865,63.80428679337985,3
2020-03-20-170408,170408,0,0,0,2,4.285714285714286,84.04226343208154,4
2020-03-21-170408,170408,1,0,1,3,3.0,87.77346887309392,5
2020-03-22-170408,170408,0,0,0,3,4.142857142857143,87.32359009919632,6
2020-03-23-170408,170408,1,0,0,4,6.2857142857142865,92.71454386290304,0
2020-03-24-170408,170408,3,0,0,7,9.285714285714286,96.03562203615719,1
2020-03-25-170408,170408,2,0,0,9,9.285714285714286,107.86434183599872,2
2020-03-26-170408,170408,0,1,0,9,7.7142857142857135,116.2257342085413,3
2020-03-27-170408,170408,0,0,0,9,7.0,138.43010231073472,4
2020-03-28-170408,170408,0,1,0,9,3.4285714285714284,143.83069500650598,5
2020-03-29-170408,170408,0,0,1,9,4.857142857142857,145.29462585782673,6
2020-03-30-170408,170408,0,0,0,9,7.0,124.81969397150034,0
2020-03-31-170408,170408,0,0,1,9,5.0,106.37407049034489,1
2020-04-01-170408,170408,0,0,0,9,4.285714285714286,16.212862035718565,2
2020-04-02-170408,170408,1,0,0,10,5.428571428571429,54.22863273399412,3
2020-04-03-170408,170408,0,0,0,10,4.857142857142857,70.87908721661047,4
2020-04-04-170408,170408,1,0,0,11,4.142857142857143,53.12026025695972,5
2020-04-05-170408,170408,0,1,0,11,1.7142857142857142,62.639430650337474,6
2020-04-06-170408,170408,0,0,0,11,5.571428571428571,62.97300381322782,0
2020-04-07-170408,170408,0,0,0,11,3.2857142857142856,65.0381318217213,1
2020-04-08-170408,170408,0,0,1,11,3.8571428571428568,70.52964620202283,2
2020-04-09-170408,170408,0,0,0,11,6.2857142857142865,75.02878735706388,3
2020-04-10-170408,170408,0,0,0,11,3.2857142857142856,10.007959303905285,4
2020-04-11-170408,170408,0,0,0,11,1.8571428571428568,17.274829947521532,5
2020-04-12-170408,170408,1,0,0,12,0.42857142857142855,25.17408761275834,6
2020-04-13-170408,170408,0,0,0,12,3.0,29.48559843841818,0
2020-04-14-170408,170408,1,0,0,13,4.571428571428571,42.167149297315554,1
2020-04-15-170408,170408,0,1,0,13,2.2857142857142856,58.91293948201235,2
2020-04-16-170408,170408,0,0,0,13,3.7142857142857135,65.0260075738147,3
2020-04-17-170408,170408,0,0,0,13,3.1428571428571432,66.37662274067571,4
2020-04-18-170408,170408,0,0,0,13,1.0,66.83981551564939,5
2020-04-19-170408,170408,0,0,0,13,0.8571428571428571,61.38364450597013,6
2020-04-20-170408,170408,0,0,0,13,3.4285714285714284,60.592267103870185,0
2020-04-21-170408,170408,0,0,0,13,3.0,51.01629131746348,1
2020-04-22-170408,170408,1,0,0,14,2.4285714285714284,55.02785509059227,2
2020-04-23-170408,170408,0,0,0,14,2.8571428571428568,54.1276263947405,3
2020-04-24-170408,170408,0,0,1,14,3.7142857142857135,72.01954093061383,4
2020-04-25-170408,170408,0,0,0,14,1.2857142857142858,86.91145191359158,5
2020-04-26-170408,170408,0,0,0,14,1.1428571428571428,88.47506457449204,6
2020-04-27-170408,170408,0,0,0,14,3.0,74.21012516163452,0
2020-04-28-170408,170408,0,0,0,14,1.2857142857142858,81.41735225220494,1
2020-04-29-170408,170408,0,1,0,14,3.4285714285714284,79.30476500011123,2
2020-04-30-170408,170408,0,0,0,14,2.571428571428572,67.40261093423993,3
2020-05-01-170408,170408,0,0,0,14,1.5714285714285714,92.67369389618071,4
2020-05-02-170408,170408,0,0,0,14,0.8571428571428571,24.804401164459975,5
2020-05-03-170408,170408,0,0,0,14,0.7142857142857143,31.566738476330023,6
2020-05-04-170408,170408,0,0,0,14,3.4285714285714284,27.905567413994728,0
2020-05-05-170408,170408,0,0,0,14,1.4285714285714286,29.080346350287265,1
2020-05-06-170408,170408,0,0,1,14,2.8571428571428568,30.23570932508412,2
2020-05-07-170408,170408,0,0,1,14,1.5714285714285714,43.19798921008159,3
2020-05-08-170408,170408,1,0,0,15,2.142857142857143,41.07400848206585,4
2020-05-09-170408,170408,0,0,0,15,1.8571428571428568,50.25904614814446,5
2020-05-10-170408,170408,0,2,0,15,0.5714285714285714,91.93826053972617,6
2020-05-11-170408,170408,0,0,0,15,1.5714285714285714,77.22667039398198,0
2020-05-12-170408,170408,0,0,0,15,2.4285714285714284,81.7402946212692,1
2020-05-13-170408,170408,0,1,0,15,1.4285714285714286,71.92107822002322,2
2020-05-14-170408,170408,0,0,0,15,1.0,63.18576514725734,3
2020-05-15-170408,170408,0,0,0,15,3.0,51.497480464696466,4
2020-05-16-170408,170408,0,0,0,15,0.14285714285714285,43.29601060754487,5
2020-05-17-170408,170408,0,0,0,15,0.7142857142857143,38.358286965895786,6
2020-05-18-170408,170408,0,0,0,15,1.8571428571428568,38.12914358118659,0
2020-05-19-170408,170408,0,0,1,15,1.1428571428571428,39.37181801958961,1
2020-05-20-170408,170408,1,0,0,16,1.0,30.045057890277747,2
2020-05-21-170408,170408,1,0,0,17,1.1428571428571428,35.13407154051704,3
2020-05-22-170408,170408,0,0,0,17,2.142857142857143,31.98114381490633,4
2020-05-23-170408,170408,0,0,0,17,0.2857142857142857,43.3668523096845,5
2020-05-24-170408,170408,0,0,0,17,0.14285714285714285,43.97418215557874,6
2020-05-25-170408,170408,0,0,0,17,0.5714285714285714,35.510527225414194,0
2020-05-26-170408,170408,0,0,0,17,1.1428571428571428,38.662824067251236,1
2020-05-27-170408,170408,0,0,0,17,2.2857142857142856,43.93781192433044,2
2020-05-28-170408,170408,0,3,0,17,2.4285714285714284,47.07440839811446,3
2020-05-29-170408,170408,0,0,0,17,2.0,50.46643930269279,4
2020-05-30-170408,170408,0,0,0,17,0.14285714285714285,50.24046192833874,5
2020-05-31-170408,170408,0,1,0,17,0.0,50.76020765852758,6
2020-06-01-170408,170408,0,0,0,17,0.7142857142857143,73.74763328919053,0
2020-06-02-170408,170408,1,0,0,18,1.5714285714285714,22.94991138070175,1
2020-06-03-170408,170408,0,0,0,18,1.2857142857142858,23.427810383240875,2
2020-06-04-170408,170408,0,0,0,18,1.0,24.819309403163935,3
2020-06-05-170408,170408,0,4,0,18,1.1428571428571428,25.129322668304,4
2020-06-06-170408,170408,0,0,0,18,0.0,28.789306392274234,5
2020-06-07-170408,170408,0,1,0,18,0.42857142857142855,29.334831901702678,6
2020-06-08-170408,170408,0,0,0,18,1.5714285714285714,31.469938441876376,0
2020-06-09-170408,170408,0,0,0,18,2.2857142857142856,28.74052138038875,1
2020-06-10-170408,170408,0,0,0,18,0.8571428571428571,82.01186788806973,2
2020-06-11-170408,170408,0,0,0,18,1.0,83.76720048303319,3
2020-06-12-170408,170408,0,0,0,18,1.0,75.56973735871902,4
2020-06-13-170408,170408,0,0,0,18,0.0,53.2284923766143,5
2020-06-14-170408,170408,0,1,0,18,0.14285714285714285,45.44546197626482,6
2020-06-15-170408,170408,0,0,0,18,1.1428571428571428,32.90876498753305,0
2020-06-16-170408,170408,0,0,0,18,1.4285714285714286,34.45714266437888,1
2020-06-17-170408,170408,0,0,0,18,1.2857142857142858,32.952631543600035,2
2020-06-18-170408,170408,0,0,0,18,0.42857142857142855,27.31042408023271,3
2020-06-19-170408,170408,0,0,0,18,0.5714285714285714,24.641568846261627,4
2020-06-20-170408,170408,0,0,0,18,0.14285714285714285,33.639492986826916,5
2020-06-21-170408,170408,0,0,0,18,0.14285714285714285,35.59538033305065,6
2020-06-22-170408,170408,0,0,0,18,1.0,27.300770167459333,0
2020-06-23-170408,170408,0,0,0,18,1.2857142857142858,28.25777593078113,1
2020-06-24-170408,170408,0,0,0,18,0.8571428571428571,29.104771587852596,2
2020-06-25-170408,170408,0,0,0,18,0.5714285714285714,32.61068303897635,3
2020-06-26-170408,170408,0,0,0,18,0.42857142857142855,32.94294309077556,4
2020-06-27-170408,170408,0,0,0,18,0.0,24.147996330035102,5
2020-06-28-170408,170408,0,0,0,18,0.14285714285714285,23.091368570242082,6
2020-06-29-170408,170408,0,0,0,18,1.2857142857142858,22.72046068520654,0
2020-06-30-170408,170408,0,0,0,18,1.1428571428571428,29.09522462933398,1
2020-07-01-170408,170408,0,0,1,18,0.42857142857142855,32.06651531532066,2
2020-07-02-170408,170408,0,1,0,18,0.42857142857142855,32.56110548543259,3
2020-07-03-170408,170408,0,0,0,18,0.5714285714285714,23.407095752597115,4
2020-07-04-170408,170408,0,0,0,18,0.2857142857142857,27.91882269031867,5
2020-07-05-170408,170408,0,0,0,18,0.14285714285714285,29.046656736776082,6
2020-07-06-170408,170408,0,0,0,18,0.42857142857142855,27.757102052382795,0
2020-07-07-170408,170408,0,0,0,18,0.42857142857142855,27.365474206756353,1
2020-07-08-170408,170408,0,0,0,18,0.5714285714285714,23.20838628140348,2
2020-07-09-170408,170408,0,0,0,18,0.5714285714285714,22.963457242746117,3
2020-07-10-170408,170408,0,0,0,18,0.5714285714285714,37.31191071609722,4
2020-07-11-170408,170408,0,0,0,18,0.0,37.100669463575684,5
2020-07-12-170408,170408,0,0,0,18,0.0,31.127126745751504,6
2020-07-13-170408,170408,0,0,0,18,1.1428571428571428,30.082066065699692,0
2020-07-14-170408,170408,0,0,0,18,0.5714285714285714,42.07132389368262,1
2020-07-15-170408,170408,1,0,0,19,1.0,37.228581748439844,2
2020-07-16-170408,170408,0,0,0,19,0.8571428571428571,34.55067642490312,3
2020-07-17-170408,170408,0,0,0,19,0.2857142857142857,30.63005368629306,4
2020-07-18-170408,170408,0,0,0,19,0.14285714285714285,30.04543543476465,5
2020-07-19-170408,170408,0,0,0,19,0.14285714285714285,32.1139178963562,6
2020-07-20-170408,170408,0,0,0,19,1.0,22.069969615240772,0
2020-07-21-170408,170408,0,0,0,19,1.2857142857142858,25.769718650594825,1
2020-07-22-170408,170408,0,0,0,19,0.5714285714285714,24.21372315624007,2
2020-07-23-170408,170408,0,0,0,19,1.0,24.66927528747021,3
2020-07-24-170408,170408,0,0,0,19,0.5714285714285714,25.643945218263852,4
2020-07-25-170408,170408,0,0,0,19,0.42857142857142855,25.048766380457,5
2020-07-26-170408,170408,0,0,0,19,0.14285714285714285,25.806008799381637,6
2020-07-27-170408,170408,0,0,0,19,0.42857142857142855,26.231663387538994,0
2020-07-28-170408,170408,0,0,0,19,0.7142857142857143,22.50892102612427,1
2020-07-29-170408,170408,0,0,0,19,1.0,22.287269649636986,2
2020-07-30-170408,170408,0,0,1,19,1.0,21.975924482581277,3
2020-07-31-170408,170408,0,0,0,19,0.5714285714285714,28.205553032368886,4
2020-08-01-170408,170408,0,0,0,19,0.0,19.90355319745571,5
2020-08-02-170408,170408,0,0,0,19,0.42857142857142855,42.69811695081917,6
2020-08-03-170408,170408,0,0,0,19,0.8571428571428571,73.85224600427227,0
2020-08-04-170408,170408,0,0,1,19,1.2857142857142858,62.599012146053994,1
2020-08-05-170408,170408,0,0,0,19,1.7142857142857142,57.17998635343534,2
2020-08-06-170408,170408,0,0,0,19,0.8571428571428571,58.525744846272175,3
2020-08-07-170408,170408,0,0,0,19,1.8571428571428568,46.57011723304678,4
2020-08-08-170408,170408,0,0,0,19,0.2857142857142857,49.93206908711622,5
2020-08-09-170408,170408,0,1,0,19,0.2857142857142857,46.25504800459716,6
2020-08-10-170408,170408,0,0,1,19,1.7142857142857142,20.584468593539867,0
2020-08-11-170408,170408,0,0,0,19,1.0,31.51423151327023,1
2020-08-12-170408,170408,0,0,0,19,1.7142857142857142,36.82674945862935,2
2020-08-13-170408,170408,1,0,1,20,1.1428571428571428,44.311781102389816,3
2020-08-14-170408,170408,0,0,0,20,0.8571428571428571,47.44727226518861,4
2020-08-15-170408,170408,0,0,0,20,0.14285714285714285,50.32364054407314,5
2020-08-16-170408,170408,0,0,0,20,0.7142857142857143,47.19794091452243,6
2020-08-17-170408,170408,0,0,0,20,0.7142857142857143,48.95239236474961,0
2020-08-18-170408,170408,1,0,0,21,1.7142857142857142,40.04095536161968,1
2020-08-19-170408,170408,0,0,0,21,1.0,41.61518974909269,2
2020-08-20-170408,170408,0,0,0,21,1.7142857142857142,38.5179848058954,3
2020-08-21-170408,170408,0,0,0,21,0.42857142857142855,41.56806755248164,4
2020-08-22-170408,170408,0,0,0,21,1.4285714285714286,43.26916512875083,5
2020-08-23-170408,170408,0,0,0,21,0.14285714285714285,43.96814222399412,6
2020-08-24-170408,170408,1,0,0,22,1.4285714285714286,39.394356409228095,0
2020-08-25-170408,170408,0,0,0,22,1.8571428571428568,46.39482567400793,1
2020-08-26-170408,170408,0,0,0,22,0.5714285714285714,47.317843725278216,2
2020-08-27-170408,170408,1,0,1,23,1.7142857142857142,56.75616409244037,3
2020-08-28-170408,170408,0,0,1,23,1.0,59.971554397203136,4
2020-08-29-170408,170408,0,0,0,23,1.2857142857142858,71.94939476720012,5
2020-08-30-170408,170408,0,0,1,23,0.7142857142857143,76.20077866685448,6
2020-08-31-170408,170408,0,0,0,23,1.2857142857142858,63.67022617134057,0
2020-09-01-170408,170408,0,0,1,23,1.5714285714285714,42.90565038857008,1
2020-09-02-170408,170408,0,0,3,23,1.4285714285714286,115.26823638536474,2
2020-09-03-170408,170408,0,0,0,23,0.7142857142857143,137.79614092189684,3
2020-09-04-170408,170408,0,0,2,23,1.7142857142857142,130.81612486426542,4
2020-09-05-170408,170408,0,0,1,23,1.5714285714285714,114.89901324988656,5
2020-09-06-170408,170408,0,0,2,23,2.0,111.75541332304013,6
2020-09-07-170408,170408,0,0,1,23,1.5714285714285714,102.64248122333143,0
2020-09-08-170408,170408,0,0,3,23,0.7142857142857143,75.70589330267202,1
2020-09-09-170408,170408,0,0,0,23,0.42857142857142855,59.28619950016814,2
2020-09-10-170408,170408,1,0,2,24,2.0,45.15232270004715,3
2020-09-11-170408,170408,1,0,1,25,2.4285714285714284,45.541271381320456,4
2020-09-12-170408,170408,0,0,0,25,0.8571428571428571,45.29856799709384,5
2020-09-13-170408,170408,1,0,0,26,1.4285714285714286,45.09983481808626,6
2020-09-14-170408,170408,0,0,3,26,1.5714285714285714,48.51049555071136,0
2020-09-15-170408,170408,1,0,1,27,2.0,53.78539801592199,1
2020-09-16-170408,170408,3,0,0,30,2.8571428571428568,66.36058411618463,2
2020-09-17-170408,170408,0,0,1,30,4.428571428571429,76.08489799283521,3
2020-09-18-170408,170408,2,0,4,32,3.4285714285714284,87.16925351048576,4
2020-09-19-170408,170408,1,0,2,33,2.2857142857142856,95.32827907667365,5
2020-09-20-170408,170408,2,0,1,35,0.5714285714285714,103.05259479807154,6
2020-09-21-170408,170408,1,1,1,36,3.0,105.65919799115485,0
2020-09-22-170408,170408,3,0,1,39,5.142857142857143,111.31305618599205,1
2020-09-23-170408,170408,0,0,1,39,3.571428571428572,125.10133136418358,2
2020-09-24-170408,170408,2,0,0,41,3.0,122.9205890838127,3
2020-09-25-170408,170408,1,0,3,42,4.428571428571429,116.28691762870038,4
2020-09-26-170408,170408,0,0,2,42,1.1428571428571428,121.92357340671138,5
2020-09-27-170408,170408,0,0,1,42,3.0,123.60341779904901,6
2020-09-28-170408,170408,3,0,2,45,4.571428571428571,129.9296158706965,0
2020-09-29-170408,170408,1,0,1,46,3.1428571428571432,141.16546741583755,1
2020-09-30-170408,170408,0,0,0,46,2.7142857142857144,120.7144777734535,2
2020-10-01-170408,170408,1,0,0,47,5.571428571428571,0.0,3
2020-10-02-170408,170408,4,0,0,51,6.428571428571429,179.2971886053848,4
2020-10-03-170408,170408,2,0,0,53,2.4285714285714284,261.5967083556921,5
2020-10-04-170408,170408,1,0,0,54,2.0,295.8287003211075,6
2020-10-05-170408,170408,1,0,0,55,6.2857142857142865,274.68965448598374,0
2020-10-06-170408,170408,1,0,4,56,3.7142857142857135,263.74883531353925,1
2020-10-07-170408,170408,1,2,0,57,5.571428571428571,229.21877437157377,2
2020-10-08-170408,170408,0,1,1,57,5.857142857142858,194.60427595299797,3
2020-10-09-170408,170408,3,1,2,60,4.571428571428571,200.81429804638793,4
2020-10-10-170408,170408,2,0,0,62,8.857142857142858,30.440508213414823,5
2020-10-11-170408,170408,1,0,0,63,4.857142857142857,67.17237501732103,6
2020-10-12-170408,170408,2,0,1,65,6.857142857142858,108.69938011266733,0
2020-10-13-170408,170408,1,0,1,66,4.0,168.79246259580094,1
2020-10-14-170408,170408,0,0,3,66,4.857142857142857,192.44287689194232,2
2020-10-15-170408,170408,0,0,1,66,4.142857142857143,214.79520169337093,3
2020-10-16-170408,170408,0,0,1,66,7.857142857142858,240.01933289828622,4
2020-10-17-170408,170408,0,0,1,66,5.857142857142858,234.357130567709,5
2020-10-18-170408,170408,0,0,3,66,3.571428571428572,233.52155183255576,6
2020-10-19-170408,170408,0,0,0,66,4.857142857142857,207.12964721265223,0
2020-10-20-170408,170408,4,0,6,70,7.428571428571429,185.9952110951507,1
2020-10-21-170408,170408,0,0,6,70,9.142857142857142,206.606750063736,2
2020-10-22-170408,170408,1,0,2,71,10.571428571428571,218.67322553931933,3
2020-10-23-170408,170408,2,0,1,73,11.714285714285715,253.50818237343333,4
2020-10-24-170408,170408,0,0,0,73,5.142857142857143,263.90679656257265,5
2020-10-25-170408,170408,0,1,0,73,3.7142857142857135,266.0464880040457,6
2020-10-26-170408,170408,1,1,5,74,7.142857142857142,259.14202099745796,0
2020-10-27-170408,170408,1,0,1,75,8.857142857142858,255.44013891358975,1
2020-10-28-170408,170408,3,1,2,78,8.285714285714286,242.74155436044327,2
2020-10-29-170408,170408,1,0,0,79,10.857142857142858,256.62283043256093,3
2020-10-30-170408,170408,1,0,0,80,12.714285714285715,216.31037801451038,4
2020-10-31-170408,170408,1,1,0,81,10.571428571428571,250.00988110367484,5
2020-11-01-170408,170408,3,0,0,84,7.428571428571429,161.9673391947075,6
2020-11-02-170408,170408,0,0,0,84,5.7142857142857135,141.97700517388438,0
2020-11-03-170408,170408,6,0,0,90,8.571428571428571,150.9789456326276,1
2020-11-04-170408,170408,6,0,0,96,10.714285714285714,198.74580596303497,2
2020-11-05-170408,170408,2,0,0,98,7.142857142857142,261.3604681070842,3
2020-11-06-170408,170408,1,1,0,99,12.857142857142858,276.8155908835863,4
2020-11-07-170408,170408,0,0,0,99,6.2857142857142865,301.9572117019903,5
2020-11-08-170408,170408,0,0,0,99,5.142857142857143,313.0460748228254,6
2020-11-09-170408,170408,5,0,0,104,7.142857142857142,290.44472295747727,0
2020-11-10-170408,170408,1,0,0,105,7.2857142857142865,159.5305747875882,1
2020-11-11-170408,170408,2,0,0,107,10.714285714285714,176.77909222221197,2
2020-11-12-170408,170408,0,0,0,107,6.571428571428571,208.2293082621906,3
2020-11-13-170408,170408,0,0,0,107,7.2857142857142865,228.77024288938495,4
2020-03-01-170409,170409,0,0,0,0,0.0,0.0,6
2020-03-02-170409,170409,0,0,1,0,0.0,16.926954212250692,0
2020-03-03-170409,170409,0,1,2,0,0.0,202.4333853321037,1
2020-03-04-170409,170409,0,2,0,0,0.0,278.5729866178349,2
2020-03-05-170409,170409,0,1,0,0,0.0,324.2142282386387,3
2020-03-06-170409,170409,0,0,0,0,0.0,317.76324663969626,4
2020-03-07-170409,170409,0,0,2,0,0.0,343.1712346694679,5
2020-03-08-170409,170409,0,0,0,0,0.0,184.20153356606588,6
2020-03-09-170409,170409,0,0,6,0,0.0,182.35335809982777,0
2020-03-10-170409,170409,0,0,4,0,0.0,373.2060160696618,1
2020-03-11-170409,170409,0,0,6,0,0.0,239.19451076664728,2
2020-03-12-170409,170409,0,0,5,0,0.0,188.11829476831173,3
2020-03-13-170409,170409,0,0,7,0,0.25,102.7946130371128,4
2020-03-14-170409,170409,0,0,3,0,0.5,57.34749043830594,5
2020-03-15-170409,170409,0,0,15,0,0.25,57.68125475811435,6
2020-03-16-170409,170409,1,0,7,1,1.25,13.317080604817235,0
2020-03-17-170409,170409,2,0,4,3,2.0,28.815617268198068,1
2020-03-18-170409,170409,0,1,3,3,3.75,82.48473430267562,2
2020-03-19-170409,170409,0,0,5,3,3.75,91.82566486788363,3
2020-03-20-170409,170409,0,1,2,3,1.0,99.6423722620855,4
2020-03-21-170409,170409,2,0,2,5,1.25,88.09073141884298,5
2020-03-22-170409,170409,0,0,0,5,4.5,98.79447288406476,6
2020-03-23-170409,170409,6,0,3,11,2.5,99.7541106358514,0
2020-03-24-170409,170409,4,0,1,15,5.25,98.24683234445935,1
2020-03-25-170409,170409,6,0,1,21,4.25,143.11183051514604,2
2020-03-26-170409,170409,5,0,3,26,5.0,175.0287850097651,3
2020-03-27-170409,170409,7,0,1,33,3.0,216.96680779144606,4
2020-03-28-170409,170409,3,0,0,36,1.75,275.800874692885,5
2020-03-29-170409,170409,15,0,0,51,2.5,277.20107346730236,6
2020-03-30-170409,170409,7,0,0,58,3.75,328.12610456169733,0
2020-03-31-170409,170409,4,0,0,62,3.0,329.3740702132882,1
2020-04-01-170409,170409,3,0,1,65,2.0,33.225838021189446,2
2020-04-02-170409,170409,5,0,0,70,2.75,34.21112776502299,3
2020-04-03-170409,170409,2,0,1,72,2.5,41.14987309377075,4
2020-04-04-170409,170409,2,0,0,74,3.75,47.41755930894635,5
2020-04-05-170409,170409,0,0,0,74,1.25,61.6978642018026,6
2020-04-06-170409,170409,3,1,1,77,4.25,62.47988299602549,0
2020-04-07-170409,170409,1,0,0,78,2.0,81.84544873718461,1
2020-04-08-170409,170409,1,0,0,79,2.0,89.24412147647315,2
2020-04-09-170409,170409,3,0,0,82,3.75,102.63957154752774,3
2020-04-10-170409,170409,1,0,2,83,2.25,25.64838211090491,4
2020-04-11-170409,170409,0,0,0,83,1.5,35.919877989948326,5
2020-04-12-170409,170409,0,0,0,83,0.5,42.41657677161489,6
2020-04-13-170409,170409,0,0,2,83,2.5,42.89297402368362,0
2020-04-14-170409,170409,0,0,1,83,3.0,50.702950731955205,1
2020-04-15-170409,170409,1,0,0,84,1.5,52.88179605994244,2
2020-04-16-170409,170409,0,0,0,84,1.75,59.77651956802917,3
2020-04-17-170409,170409,1,1,0,85,1.5,38.40793155086751,4
2020-04-18-170409,170409,0,0,0,85,0.5,39.30269832417336,5
2020-04-19-170409,170409,0,0,0,85,0.25,34.134707904090895,6
2020-04-20-170409,170409,1,0,1,86,1.5,60.83241484111308,0
2020-04-21-170409,170409,0,0,1,86,1.75,73.01473425994388,1
2020-04-22-170409,170409,0,0,0,86,0.75,67.98527379360422,2
2020-04-23-170409,170409,0,0,2,86,0.75,69.54553255797043,3
2020-04-24-170409,170409,2,0,1,88,1.25,58.37178236697211,4
2020-04-25-170409,170409,0,0,2,88,1.0,77.30237481057164,5
2020-04-26-170409,170409,0,0,0,88,0.5,77.04933392445464,6
2020-04-27-170409,170409,2,0,0,90,0.5,40.67551065574754,0
2020-04-28-170409,170409,1,0,2,91,0.75,40.426628313785834,1
2020-04-29-170409,170409,0,0,1,91,1.0,45.165577752405014,2
2020-04-30-170409,170409,0,0,2,91,0.75,65.33302883459982,3
2020-05-01-170409,170409,0,0,0,91,2.0,109.418054706506,4
2020-05-02-170409,170409,0,0,1,91,0.75,50.13783826863403,5
2020-05-03-170409,170409,0,0,0,91,1.0,45.49387544927677,6
2020-05-04-170409,170409,1,0,1,92,2.0,42.99765318733083,0
2020-05-05-170409,170409,1,0,1,93,1.0,54.99789816709499,1
2020-05-06-170409,170409,0,0,1,93,1.75,63.67163158807503,2
2020-05-07-170409,170409,2,0,1,95,1.0,64.39055338991618,3
2020-05-08-170409,170409,1,0,5,96,1.0,54.26251760117887,4
2020-05-09-170409,170409,2,0,0,98,1.25,66.98523062236247,5
2020-05-10-170409,170409,0,2,0,98,0.75,143.72410466266277,6
2020-05-11-170409,170409,0,0,0,98,1.0,123.27764554438599,0
2020-05-12-170409,170409,2,0,0,100,1.0,123.90629718014335,1
2020-05-13-170409,170409,1,0,0,101,1.25,105.1213791641233,2
2020-05-14-170409,170409,2,0,1,103,0.5,105.03347870294043,3
2020-05-15-170409,170409,0,0,3,103,2.0,103.94128164238889,4
2020-05-16-170409,170409,1,2,0,104,0.0,76.48103241178043,5
2020-05-17-170409,170409,0,0,0,104,0.5,76.42752436212236,6
2020-05-18-170409,170409,1,0,0,105,1.75,77.36847330781163,0
2020-05-19-170409,170409,1,0,2,106,0.75,87.99240437348593,1
2020-05-20-170409,170409,1,0,1,107,0.75,55.65898420196077,2
2020-05-21-170409,170409,1,0,2,108,0.5,46.7815273240994,3
2020-05-22-170409,170409,5,0,0,113,1.75,61.44819279135496,4
2020-05-23-170409,170409,0,0,0,113,0.0,98.28201236995996,5
2020-05-24-170409,170409,0,0,0,113,0.25,100.35833249157753,6
2020-05-25-170409,170409,0,0,3,113,0.75,90.29170950623602,0
2020-05-26-170409,170409,0,0,2,113,0.25,88.76418851215782,1
2020-05-27-170409,170409,0,1,0,113,2.75,90.6032135335839,2
2020-05-28-170409,170409,1,0,0,114,1.5,93.55629123003285,3
2020-05-29-170409,170409,3,0,0,117,1.25,86.37051090951634,4
2020-05-30-170409,170409,0,0,0,117,0.0,79.05381848144572,5
2020-05-31-170409,170409,0,0,0,117,0.0,79.34025478051385,6
2020-06-01-170409,170409,0,0,0,117,0.25,116.0577772780513,0
2020-06-02-170409,170409,2,0,3,119,1.5,78.94506280512239,1
2020-06-03-170409,170409,1,0,2,120,1.75,11.226234898234587,2
2020-06-04-170409,170409,2,0,0,122,0.75,22.196875647077764,3
2020-06-05-170409,170409,0,0,1,122,1.0,43.98284185710874,4
2020-06-06-170409,170409,0,0,0,122,0.0,45.094423420509536,5
2020-06-07-170409,170409,0,0,0,122,0.5,45.13597924763056,6
2020-06-08-170409,170409,3,0,0,125,1.75,45.30155361173926,0
2020-06-09-170409,170409,2,0,0,127,1.5,73.1966830816108,1
2020-06-10-170409,170409,0,0,0,127,0.75,112.24943696917725,2
2020-06-11-170409,170409,0,0,0,127,1.0,96.86210207318857,3
2020-06-12-170409,170409,0,0,0,127,1.0,79.63042653341594,4
2020-06-13-170409,170409,0,0,0,127,0.0,68.56929155483824,5
2020-06-14-170409,170409,0,0,0,127,0.0,46.34658913904889,6
2020-06-15-170409,170409,0,0,0,127,1.5,32.65598102725713,0
2020-06-16-170409,170409,3,0,0,130,1.0,20.09737668670193,1
2020-06-17-170409,170409,2,0,0,132,0.75,52.14347190756203,2
2020-06-18-170409,170409,0,1,0,132,0.0,71.80106854664479,3
2020-06-19-170409,170409,1,0,1,133,0.75,69.01454324083483,4
2020-06-20-170409,170409,0,0,0,133,0.25,103.30839535355031,5
2020-06-21-170409,170409,0,0,0,133,0.0,105.10722035433037,6
2020-06-22-170409,170409,0,0,0,133,0.5,95.0442615305566,0
2020-06-23-170409,170409,0,0,0,133,1.75,61.90001947786944,1
2020-06-24-170409,170409,0,0,1,133,0.5,42.45886347794506,2
2020-06-25-170409,170409,0,0,0,133,1.0,44.49805237557269,3
2020-06-26-170409,170409,0,0,0,133,0.5,34.62908571895115,4
2020-06-27-170409,170409,0,0,0,133,0.0,11.170478959530948,5
2020-06-28-170409,170409,0,0,0,133,0.25,10.799958612248624,6
2020-06-29-170409,170409,0,0,0,133,1.0,10.74237515482502,0
2020-06-30-170409,170409,0,0,2,133,0.75,25.208053792900493,1
2020-07-01-170409,170409,0,0,0,133,0.0,92.90119844436296,2
2020-07-02-170409,170409,0,0,0,133,0.25,66.87641332959491,3
2020-07-03-170409,170409,1,0,0,134,0.75,19.03796337908624,4
2020-07-04-170409,170409,0,0,0,134,0.25,47.7923247679938,5
2020-07-05-170409,170409,0,0,0,134,0.0,47.72898685961213,6
2020-07-06-170409,170409,0,0,0,134,0.0,47.38562780312351,0
2020-07-07-170409,170409,0,0,0,134,0.25,46.22267163426439,1
2020-07-08-170409,170409,1,0,0,135,0.25,36.955314261530205,2
2020-07-09-170409,170409,0,0,0,135,0.5,36.03249702443258,3
2020-07-10-170409,170409,0,0,0,135,0.5,95.54969273497196,4
2020-07-11-170409,170409,0,0,0,135,0.0,70.54670596207552,5
2020-07-12-170409,170409,0,0,0,135,0.0,68.3567457718473,6
2020-07-13-170409,170409,0,0,0,135,1.0,68.98454581610287,0
2020-07-14-170409,170409,2,0,0,137,0.25,90.95241032159856,1
2020-07-15-170409,170409,0,0,0,137,1.25,74.12154510312637,2
2020-07-16-170409,170409,0,0,0,137,0.75,50.96656247005684,3
2020-07-17-170409,170409,0,0,0,137,0.75,53.15718041102391,4
2020-07-18-170409,170409,0,0,0,137,0.5,61.370594708729165,5
2020-07-19-170409,170409,0,0,0,137,0.25,74.10801393462344,6
2020-07-20-170409,170409,0,1,0,137,1.25,51.36813765439411,0
2020-07-21-170409,170409,0,0,0,137,0.25,41.122665522283995,1
2020-07-22-170409,170409,0,0,0,137,1.0,39.157983339419076,2
2020-07-23-170409,170409,0,0,0,137,1.0,46.60349373370684,3
2020-07-24-170409,170409,0,0,0,137,0.5,37.84950221624119,4
2020-07-25-170409,170409,0,0,0,137,0.75,27.60926461568173,5
2020-07-26-170409,170409,0,0,0,137,0.0,27.726074935404153,6
2020-07-27-170409,170409,0,0,2,137,0.0,26.7693135985822,0
2020-07-28-170409,170409,0,0,2,137,1.0,16.936882816477205,1
2020-07-29-170409,170409,0,0,3,137,1.25,18.02999420484283,2
2020-07-30-170409,170409,0,0,1,137,1.75,26.366141493669076,3
2020-07-31-170409,170409,0,0,0,137,0.5,44.611908000888675,4
2020-08-01-170409,170409,0,0,0,137,0.5,16.154535016637436,5
2020-08-02-170409,170409,0,0,2,137,1.0,91.83102431991603,6
2020-08-03-170409,170409,0,0,0,137,1.25,97.35682390116074,0
2020-08-04-170409,170409,0,0,0,137,1.5,86.95062575606022,1
2020-08-05-170409,170409,0,0,0,137,2.25,84.25616678972011,2
2020-08-06-170409,170409,0,0,0,137,0.75,82.16938858006318,3
2020-08-07-170409,170409,0,0,0,137,1.75,46.88345636583552,4
2020-08-08-170409,170409,0,0,1,137,0.5,44.06673312367606,5
2020-08-09-170409,170409,0,0,0,137,0.0,43.61173206136269,6
2020-08-10-170409,170409,2,0,0,139,1.0,32.2888091832237,0
2020-08-11-170409,170409,2,0,1,141,0.25,52.47910574643324,1
2020-08-12-170409,170409,3,0,0,144,1.0,69.12968449784968,2
2020-08-13-170409,170409,1,0,0,145,1.0,95.23420313026,3
2020-08-14-170409,170409,0,0,0,145,0.25,98.72956607631663,4
2020-08-15-170409,170409,0,0,0,145,0.25,99.76364261095051,5
2020-08-16-170409,170409,2,0,0,147,0.5,98.732214057924,6
2020-08-17-170409,170409,0,0,0,147,0.25,121.19362366172275,0
2020-08-18-170409,170409,0,0,0,147,2.0,98.64856083098208,1
2020-08-19-170409,170409,0,0,1,147,1.25,93.47046475834922,2
2020-08-20-170409,170409,0,0,0,147,1.25,94.30378405898722,3
2020-08-21-170409,170409,0,0,0,147,0.25,90.91619822171106,4
2020-08-22-170409,170409,1,0,0,148,1.0,90.06106583618053,5
2020-08-23-170409,170409,0,0,0,148,0.25,60.349516251611604,6
2020-08-24-170409,170409,0,0,0,148,1.75,60.50354985375941,0
2020-08-25-170409,170409,1,0,0,149,1.75,66.15160145578379,1
2020-08-26-170409,170409,0,0,0,149,0.25,65.95589217277352,2
2020-08-27-170409,170409,0,0,0,149,1.5,62.66626444588489,3
2020-08-28-170409,170409,0,0,0,149,1.25,64.56783749602539,4
2020-08-29-170409,170409,0,0,0,149,1.0,97.68594564120023,5
2020-08-30-170409,170409,0,1,0,149,1.25,100.8329400569925,6
2020-08-31-170409,170409,0,0,0,149,1.75,91.25102869897049,0
2020-09-01-170409,170409,0,0,0,149,1.5,32.870105491160025,1
2020-09-02-170409,170409,1,0,1,150,0.5,119.15429246991445,2
2020-09-03-170409,170409,0,0,1,150,1.0,345.4080118618785,3
2020-09-04-170409,170409,0,0,1,150,1.25,305.2348886340507,4
2020-09-05-170409,170409,0,0,0,150,1.5,200.3652539789894,5
2020-09-06-170409,170409,0,0,0,150,2.0,179.18875719400813,6
2020-09-07-170409,170409,0,0,1,150,0.5,116.25856795025011,0
2020-09-08-170409,170409,0,0,4,150,0.25,67.62607461632633,1
2020-09-09-170409,170409,0,0,1,150,0.25,61.77996252750184,2
2020-09-10-170409,170409,0,0,5,150,1.25,42.09171793203075,3
2020-09-11-170409,170409,0,0,13,150,0.75,44.300951956612295,4
2020-09-12-170409,170409,0,1,2,150,0.25,47.430554169323734,5
2020-09-13-170409,170409,0,0,7,150,2.5,46.32256905406051,6
2020-09-14-170409,170409,0,0,4,150,0.5,60.988911499966896,0
2020-09-15-170409,170409,0,0,1,150,1.25,69.05016959292195,1
2020-09-16-170409,170409,1,0,1,151,1.75,82.30825537386245,2
2020-09-17-170409,170409,1,0,5,152,1.75,88.06393926920296,3
2020-09-18-170409,170409,1,0,4,153,1.75,103.00696169751598,4
2020-09-19-170409,170409,0,0,5,153,1.5,115.33985847971775,5
2020-09-20-170409,170409,0,1,2,153,1.0,109.58656258910229,6
2020-09-21-170409,170409,1,0,1,154,1.5,93.56903195573528,0
2020-09-22-170409,170409,4,1,0,158,2.25,93.00911439757795,1
2020-09-23-170409,170409,1,1,1,159,2.75,113.4719773901075,2
2020-09-24-170409,170409,5,0,0,164,1.25,108.33045402358508,3
2020-09-25-170409,170409,13,1,0,177,2.0,127.11872277061715,4
2020-09-26-170409,170409,2,0,1,179,0.5,220.28151263588612,5
2020-09-27-170409,170409,7,0,0,186,2.25,229.79557023314305,6
2020-09-28-170409,170409,4,1,3,190,4.0,290.60744952047844,0
2020-09-29-170409,170409,1,0,0,191,2.25,327.1292527971399,1
2020-09-30-170409,170409,1,0,0,192,2.25,291.5411778382206,2
2020-10-01-170409,170409,5,0,0,197,3.25,0.0,3
2020-10-02-170409,170409,4,0,6,201,4.75,225.80798183056004,4
2020-10-03-170409,170409,5,0,8,206,2.25,337.50035001553107,5
2020-10-04-170409,170409,2,0,1,208,1.25,389.12092400601784,6
2020-10-05-170409,170409,1,0,10,209,2.0,347.9264342753512,0
2020-10-06-170409,170409,0,0,8,209,1.0,292.9517765418178,1
2020-10-07-170409,170409,1,1,10,210,1.25,254.7936937141083,2
2020-10-08-170409,170409,0,0,1,210,2.25,189.79736323222508,3
2020-10-09-170409,170409,0,0,6,210,2.25,164.14128805737587,4
2020-10-10-170409,170409,1,0,0,211,1.5,42.47126180206226,5
2020-10-11-170409,170409,0,0,5,211,1.25,56.051285448166304,6
2020-10-12-170409,170409,3,0,6,214,2.5,64.5224902316752,0
2020-10-13-170409,170409,0,0,7,214,2.5,98.55010940763098,1
2020-10-14-170409,170409,0,0,3,214,2.5,107.39253297267985,2
2020-10-15-170409,170409,0,0,6,214,1.75,120.96202036305618,3
2020-10-16-170409,170409,6,0,14,220,2.25,126.97766703193307,4
2020-10-17-170409,170409,8,0,3,228,1.75,139.98896960727,5
2020-10-18-170409,170409,1,0,0,229,0.75,188.0174174006917,6
2020-10-19-170409,170409,10,1,1,239,1.0,192.3426137809552,0
2020-10-20-170409,170409,8,0,5,247,1.5,277.30217411662255,1
2020-10-21-170409,170409,10,0,6,257,2.25,326.6194352846734,2
2020-10-22-170409,170409,1,0,2,258,1.75,382.27911680918123,3
2020-10-23-170409,170409,6,0,6,264,3.25,340.9183909605113,4
2020-10-24-170409,170409,0,0,2,264,0.75,334.4871129596948,5
2020-10-25-170409,170409,5,0,0,269,0.5,326.3650408860401,6
2020-10-26-170409,170409,6,1,3,275,2.25,282.3012001610234,0
2020-10-27-170409,170409,7,1,6,282,2.0,280.3946542978015,1
2020-10-28-170409,170409,3,1,4,285,9.0,286.72274116081746,2
2020-10-29-170409,170409,6,0,5,291,7.25,258.968843174501,3
2020-10-30-170409,170409,14,1,9,305,3.0,305.66968403337114,4
2020-10-31-170409,170409,3,0,0,308,1.25,379.53352390639907,5
2020-11-01-170409,170409,0,0,0,308,3.5,92.61569896175376,6
2020-11-02-170409,170409,1,1,0,309,1.5,219.44413025607804,0
2020-11-03-170409,170409,5,0,0,314,5.25,146.06548369059308,1
2020-11-04-170409,170409,6,0,0,320,5.75,177.26720851055325,2
2020-11-05-170409,170409,2,0,0,322,3.5,228.111431413884,3
2020-11-06-170409,170409,6,0,0,328,3.5,236.4536277209452,4
2020-11-07-170409,170409,2,2,0,330,4.0,231.92231175119193,5
2020-11-08-170409,170409,0,1,0,330,2.5,243.09048926079643,6
2020-11-09-170409,170409,3,0,0,333,3.0,234.5228392664552,0
2020-11-10-170409,170409,6,0,0,339,4.75,77.8936616307313,1
2020-11-11-170409,170409,4,4,0,343,6.75,104.88665076095846,2
2020-11-12-170409,170409,5,1,0,348,2.0,144.06606865853414,3
2020-11-13-170409,170409,9,0,0,357,4.75,179.3958623695388,4
2020-03-01-170410,170410,0,0,2,0,0.0,0.0,6
2020-03-02-170410,170410,0,0,0,0,0.0,26.579850595593037,0
2020-03-03-170410,170410,0,0,4,0,0.0,117.7513880668981,1
2020-03-04-170410,170410,0,2,2,0,0.0,118.28437514976673,2
2020-03-05-170410,170410,0,0,3,0,0.0,123.0276852575358,3
2020-03-06-170410,170410,0,0,4,0,0.0,109.34220144064764,4
2020-03-07-170410,170410,0,0,2,0,0.0,108.25564183229694,5
2020-03-08-170410,170410,0,0,2,0,0.0,94.66607486777443,6
2020-03-09-170410,170410,0,0,2,0,0.0,94.47536611665791,0
2020-03-10-170410,170410,0,0,0,0,0.0,543.7630766533947,1
2020-03-11-170410,170410,0,0,4,0,0.0,446.39066265877244,2
2020-03-12-170410,170410,0,0,2,0,0.0,324.46179061088446,3
2020-03-13-170410,170410,0,0,3,0,0.0,228.12450614479238,4
2020-03-14-170410,170410,0,0,1,0,0.0,176.28595765696502,5
2020-03-15-170410,170410,2,0,1,2,0.3333333333333333,132.78685112280388,6
2020-03-16-170410,170410,0,0,0,2,0.6666666666666666,16.360662191115672,0
2020-03-17-170410,170410,4,0,3,6,0.0,33.00160300316017,1
2020-03-18-170410,170410,2,0,2,8,1.6666666666666667,72.88604947586549,2
2020-03-19-170410,170410,3,0,1,11,2.333333333333333,120.22007335742487,3
2020-03-20-170410,170410,4,0,4,15,2.0,162.5460125027577,4
2020-03-21-170410,170410,2,0,1,17,1.3333333333333333,197.1393646388293,5
2020-03-22-170410,170410,2,1,0,19,0.3333333333333333,205.45230922179758,6
2020-03-23-170410,170410,2,0,4,21,3.6666666666666665,211.3544260026106,0
2020-03-24-170410,170410,0,0,2,21,4.666666666666667,220.4436772298748,1
2020-03-25-170410,170410,4,0,1,25,2.333333333333333,219.15524503785088,2
2020-03-26-170410,170410,2,0,0,27,3.0,242.71580258304658,3
2020-03-27-170410,170410,3,0,1,30,2.6666666666666665,277.46536474864325,4
2020-03-28-170410,170410,1,0,1,31,0.3333333333333333,278.29026504036193,5
2020-03-29-170410,170410,1,0,0,32,1.0,271.5031723272631,6
2020-03-30-170410,170410,0,0,0,32,2.6666666666666665,225.95259778674327,0
2020-03-31-170410,170410,3,0,2,35,0.3333333333333333,208.24749022997207,1
2020-04-01-170410,170410,2,0,0,37,0.0,31.924239071053044,2
2020-04-02-170410,170410,1,0,0,38,2.333333333333333,95.80892351334403,3
2020-04-03-170410,170410,4,0,0,42,2.0,77.15776022896495,4
2020-04-04-170410,170410,1,0,0,43,1.3333333333333333,103.64331855723,5
2020-04-05-170410,170410,0,0,1,43,0.3333333333333333,114.78678750470496,6
2020-04-06-170410,170410,4,0,1,47,1.3333333333333333,117.27920473339465,0
2020-04-07-170410,170410,2,0,1,49,1.3333333333333333,134.93998030862622,1
2020-04-08-170410,170410,1,0,3,50,0.6666666666666666,151.42980422115576,2
2020-04-09-170410,170410,0,0,0,50,2.333333333333333,155.67808040783277,3
2020-04-10-170410,170410,1,0,1,51,2.0,22.399897133679865,4
2020-04-11-170410,170410,1,0,1,52,1.0,38.54695389534401,5
2020-04-12-170410,170410,0,0,0,52,0.3333333333333333,49.10311460633695,6
2020-04-13-170410,170410,0,0,2,52,1.3333333333333333,52.77941634827746,0
2020-04-14-170410,170410,2,0,0,54,3.333333333333333,69.26288948603087,1
2020-04-15-170410,170410,0,1,0,54,1.3333333333333333,96.87324282147907,2
2020-04-16-170410,170410,0,0,1,54,1.6666666666666667,109.59612614134792,3
2020-04-17-170410,170410,0,0,0,54,0.3333333333333333,102.89479733071771,4
2020-04-18-170410,170410,0,0,0,54,1.0,99.77488323184687,5
2020-04-19-170410,170410,1,0,1,55,1.3333333333333333,92.9806785350861,6
2020-04-20-170410,170410,1,0,0,56,2.333333333333333,112.71225723008354,0
2020-04-21-170410,170410,1,0,0,57,2.333333333333333,104.60304102760435,1
2020-04-22-170410,170410,3,0,0,60,1.3333333333333333,108.09097367887094,2
2020-04-23-170410,170410,0,0,0,60,4.666666666666667,120.62898353086494,3
2020-04-24-170410,170410,1,0,1,61,2.0,114.57666226423427,4
2020-04-25-170410,170410,1,0,1,62,1.0,129.61618619880915,5
2020-04-26-170410,170410,0,0,1,62,0.0,127.49856560108597,6
2020-04-27-170410,170410,2,0,1,64,4.0,100.6637885761518,0
2020-04-28-170410,170410,0,0,0,64,1.3333333333333333,98.82080541856227,1
2020-04-29-170410,170410,0,0,0,64,2.0,89.87621850384251,2
2020-04-30-170410,170410,1,1,0,65,2.6666666666666665,114.09703714095647,3
2020-05-01-170410,170410,0,0,0,65,0.3333333333333333,145.0711851074239,4
2020-05-02-170410,170410,0,0,0,65,0.0,28.316346278239735,5
2020-05-03-170410,170410,1,0,0,66,0.0,46.56952955470617,6
2020-05-04-170410,170410,0,0,0,66,2.6666666666666665,38.11513098797983,0
2020-05-05-170410,170410,0,0,0,66,0.3333333333333333,44.70640214711664,1
2020-05-06-170410,170410,0,0,1,66,2.6666666666666665,45.27021474801083,2
2020-05-07-170410,170410,0,0,1,66,0.6666666666666666,47.430313177712364,3
2020-05-08-170410,170410,1,0,2,67,1.3333333333333333,47.92357576419102,4
2020-05-09-170410,170410,1,0,0,68,0.6666666666666666,61.030455414880294,5
2020-05-10-170410,170410,1,0,0,69,0.0,150.2321724141891,6
2020-05-11-170410,170410,1,1,3,70,2.0,136.69116315316774,0
2020-05-12-170410,170410,0,0,0,70,1.0,144.41847156889156,1
2020-05-13-170410,170410,0,0,0,70,0.0,110.40522251220051,2
2020-05-14-170410,170410,0,0,0,70,0.6666666666666666,88.0967475348848,3
2020-05-15-170410,170410,0,0,0,70,1.3333333333333333,70.09876838713787,4
2020-05-16-170410,170410,0,0,1,70,0.0,58.616020633737655,5
2020-05-17-170410,170410,0,0,0,70,0.0,54.80379479963907,6
2020-05-18-170410,170410,0,0,0,70,0.6666666666666666,43.84600202231174,0
2020-05-19-170410,170410,0,0,1,70,0.0,41.57472366420597,1
2020-05-20-170410,170410,1,0,0,71,0.0,34.124329602743316,2
2020-05-21-170410,170410,1,0,0,72,0.3333333333333333,41.498921183559936,3
2020-05-22-170410,170410,2,0,1,74,0.6666666666666666,41.11477118295101,4
2020-05-23-170410,170410,0,0,0,74,0.0,67.86318693165339,5
2020-05-24-170410,170410,0,0,0,74,0.0,68.30113310350822,6
2020-05-25-170410,170410,3,0,0,77,0.3333333333333333,58.52939211908945,0
2020-05-26-170410,170410,0,0,0,77,1.0,79.93301937257813,1
2020-05-27-170410,170410,0,0,0,77,1.3333333333333333,88.40928454393526,2
2020-05-28-170410,170410,0,2,1,77,0.3333333333333333,86.06711455233594,3
2020-05-29-170410,170410,0,2,0,77,0.6666666666666666,84.42278392612215,4
2020-05-30-170410,170410,1,0,0,78,0.0,70.29480611939529,5
2020-05-31-170410,170410,0,0,0,78,0.0,78.49879537387102,6
2020-06-01-170410,170410,0,0,0,78,0.3333333333333333,82.86735514472612,0
2020-06-02-170410,170410,1,0,0,79,0.0,23.92948779706571,1
2020-06-03-170410,170410,0,0,0,79,0.0,16.8297314268072,2
2020-06-04-170410,170410,0,0,0,79,0.0,15.009399571360014,3
2020-06-05-170410,170410,1,0,0,80,0.0,17.88125380165701,4
2020-06-06-170410,170410,0,0,0,80,0.0,27.492680861204697,5
2020-06-07-170410,170410,0,0,0,80,0.3333333333333333,28.670583689354775,6
2020-06-08-170410,170410,0,0,0,80,0.0,30.275712981211797,0
2020-06-09-170410,170410,0,0,0,80,0.3333333333333333,26.75510777351285,1
2020-06-10-170410,170410,0,0,0,80,1.0,90.40465586278324,2
2020-06-11-170410,170410,1,0,0,81,0.0,76.03866321541115,3
2020-06-12-170410,170410,0,0,0,81,0.3333333333333333,77.29787717081962,4
2020-06-13-170410,170410,0,0,0,81,0.0,71.26890554870583,5
2020-06-14-170410,170410,0,0,0,81,0.0,64.45396134381795,6
2020-06-15-170410,170410,0,0,0,81,0.6666666666666666,42.89401635131371,0
2020-06-16-170410,170410,0,0,0,81,0.0,34.01995821373835,1
2020-06-17-170410,170410,0,0,1,81,1.0,33.72427318721154,2
2020-06-18-170410,170410,0,0,0,81,0.0,34.44430053624183,3
2020-06-19-170410,170410,0,0,0,81,0.0,27.759884088649393,4
2020-06-20-170410,170410,0,0,0,81,0.3333333333333333,34.47881148185634,5
2020-06-21-170410,170410,0,0,0,81,0.0,36.31932981486519,6
2020-06-22-170410,170410,0,0,0,81,0.3333333333333333,32.114613941771836,0
2020-06-23-170410,170410,0,0,1,81,0.0,30.367493378979432,1
2020-06-24-170410,170410,0,0,1,81,0.3333333333333333,25.915191883759327,2
2020-06-25-170410,170410,0,0,0,81,0.0,31.114537564549416,3
2020-06-26-170410,170410,0,1,1,81,0.0,30.43418545475899,4
2020-06-27-170410,170410,0,0,0,81,0.0,19.941556709875982,5
2020-06-28-170410,170410,0,0,0,81,0.0,19.3188045596676,6
2020-06-29-170410,170410,0,0,0,81,0.6666666666666666,18.659513491500757,0
2020-06-30-170410,170410,0,0,1,81,0.0,21.974549283245842,1
2020-07-01-170410,170410,1,0,0,82,1.6666666666666667,34.26019667652825,2
2020-07-02-170410,170410,0,0,1,82,0.0,66.28673818148081,3
2020-07-03-170410,170410,0,0,0,82,0.0,37.19255316733567,4
2020-07-04-170410,170410,0,0,1,82,0.3333333333333333,25.809431295504854,5
2020-07-05-170410,170410,0,0,4,82,0.0,25.882102657058184,6
2020-07-06-170410,170410,0,0,1,82,0.3333333333333333,23.461482541290685,0
2020-07-07-170410,170410,1,0,1,83,0.0,16.16919825766501,1
2020-07-08-170410,170410,1,0,0,84,0.3333333333333333,21.27673472335895,2
2020-07-09-170410,170410,0,0,2,84,0.6666666666666666,30.516602112811647,3
2020-07-10-170410,170410,1,0,0,85,0.0,50.9326809434076,4
2020-07-11-170410,170410,0,0,0,85,0.0,59.312931920187864,5
2020-07-12-170410,170410,0,0,0,85,0.0,46.941002476731015,6
2020-07-13-170410,170410,0,0,0,85,1.6666666666666667,44.67291691375051,0
2020-07-14-170410,170410,1,0,1,86,0.0,51.06505093335298,1
2020-07-15-170410,170410,0,0,0,86,0.3333333333333333,56.93464840885764,2
2020-07-16-170410,170410,1,0,0,87,0.3333333333333333,49.53193798568973,3
2020-07-17-170410,170410,0,0,0,87,0.0,45.52840898213256,4
2020-07-18-170410,170410,1,0,0,88,0.0,33.94275640445926,5
2020-07-19-170410,170410,4,0,0,92,0.0,42.631020710372766,6
2020-07-20-170410,170410,1,0,0,93,0.0,71.44298845003937,0
2020-07-21-170410,170410,1,0,0,94,1.3333333333333333,73.52285895874978,1
2020-07-22-170410,170410,0,0,1,94,1.0,91.03397860743999,2
2020-07-23-170410,170410,2,0,2,96,0.0,82.36758575949956,3
2020-07-24-170410,170410,0,0,3,96,0.0,101.6650522829528,4
2020-07-25-170410,170410,0,0,0,96,0.0,93.7194977793589,5
2020-07-26-170410,170410,0,0,0,96,0.3333333333333333,60.5626694123019,6
2020-07-27-170410,170410,0,0,1,96,0.0,57.781741249529695,0
2020-07-28-170410,170410,1,0,1,97,0.3333333333333333,49.59111270310028,1
2020-07-29-170410,170410,0,0,0,97,0.0,40.14609118377057,2
2020-07-30-170410,170410,0,0,0,97,0.0,24.098232176722316,3
2020-07-31-170410,170410,0,0,1,97,0.0,26.3401367548065,4
2020-08-01-170410,170410,0,0,2,97,0.0,28.17441700065882,5
2020-08-02-170410,170410,0,0,0,97,0.0,79.70756319964522,6
2020-08-03-170410,170410,0,0,0,97,1.0,94.29874277092193,0
2020-08-04-170410,170410,0,0,2,97,0.0,91.04602275322168,1
2020-08-05-170410,170410,1,0,0,98,0.3333333333333333,80.59455312795238,2
2020-08-06-170410,170410,2,0,0,100,0.3333333333333333,66.5947094784813,3
2020-08-07-170410,170410,3,0,1,103,0.0,50.31929813881874,4
2020-08-08-170410,170410,0,0,0,103,0.0,69.9632520520663,5
2020-08-09-170410,170410,0,0,0,103,0.0,66.50628099651482,6
2020-08-10-170410,170410,1,0,0,104,0.6666666666666666,27.13124651783557,0
2020-08-11-170410,170410,1,0,0,105,1.0,43.296522999700635,1
2020-08-12-170410,170410,0,0,0,105,0.6666666666666666,56.88702512762096,2
2020-08-13-170410,170410,0,0,0,105,0.0,66.34097115450385,3
2020-08-14-170410,170410,1,0,1,106,1.3333333333333333,62.99091778188096,4
2020-08-15-170410,170410,2,0,0,108,0.0,73.80821181019809,5
2020-08-16-170410,170410,0,0,0,108,0.0,86.67053148262684,6
2020-08-17-170410,170410,0,0,0,108,0.3333333333333333,87.97016343351483,0
2020-08-18-170410,170410,2,0,0,110,0.3333333333333333,75.91015258918989,1
2020-08-19-170410,170410,0,0,0,110,0.3333333333333333,83.96400259336907,2
2020-08-20-170410,170410,0,0,0,110,0.0,71.94492168778596,3
2020-08-21-170410,170410,1,0,2,111,0.3333333333333333,61.10425450859985,4
2020-08-22-170410,170410,0,0,1,111,0.6666666666666666,58.060711956546236,5
2020-08-23-170410,170410,0,0,1,111,0.0,64.45338076582314,6
2020-08-24-170410,170410,0,0,1,111,0.3333333333333333,59.881747950651615,0
2020-08-25-170410,170410,0,0,4,111,0.6666666666666666,44.679795108584656,1
2020-08-26-170410,170410,0,0,3,111,0.0,50.03429858412684,2
2020-08-27-170410,170410,0,0,1,111,2.0,65.0850242914751,3
2020-08-28-170410,170410,1,0,0,112,1.0,77.69759849353315,4
2020-08-29-170410,170410,0,0,2,112,0.6666666666666666,91.84499536146666,5
2020-08-30-170410,170410,0,0,0,112,0.0,98.18673895462115,6
2020-08-31-170410,170410,0,0,0,112,0.0,95.75465463475301,0
2020-09-01-170410,170410,0,0,4,112,0.6666666666666666,62.50135493317667,1
2020-09-02-170410,170410,0,0,0,112,0.6666666666666666,167.89212061547659,2
2020-09-03-170410,170410,0,0,5,112,0.0,218.96303043668033,3
2020-09-04-170410,170410,2,0,2,114,0.0,190.51640791736918,4
2020-09-05-170410,170410,1,0,0,115,0.0,177.88669167796044,5
2020-09-06-170410,170410,1,0,0,116,0.3333333333333333,184.12779734620744,6
2020-09-07-170410,170410,1,0,7,117,0.0,182.20209705686696,0
2020-09-08-170410,170410,4,0,5,121,0.0,154.86544578971822,1
2020-09-09-170410,170410,3,0,1,124,0.3333333333333333,152.8449670720427,2
2020-09-10-170410,170410,1,0,5,125,0.3333333333333333,73.7584480148153,3
2020-09-11-170410,170410,0,0,7,125,0.3333333333333333,85.57981949088523,4
2020-09-12-170410,170410,2,0,0,127,0.6666666666666666,97.50775522112963,5
2020-09-13-170410,170410,0,0,1,127,0.0,105.5310258953807,6
2020-09-14-170410,170410,0,0,1,127,0.0,84.47042054530398,0
2020-09-15-170410,170410,4,0,4,131,1.0,91.7494234231273,1
2020-09-16-170410,170410,0,0,2,131,1.6666666666666667,124.09782989250809,2
2020-09-17-170410,170410,5,0,3,136,1.0,124.09865440385437,3
2020-09-18-170410,170410,2,0,1,138,1.6666666666666667,156.8977089953934,4
2020-09-19-170410,170410,0,0,0,138,0.0,171.34842973925777,5
2020-09-20-170410,170410,0,0,1,138,0.0,162.02251752702134,6
2020-09-21-170410,170410,7,0,0,145,2.0,152.7488579099064,0
2020-09-22-170410,170410,5,0,0,150,2.0,151.4812229116497,1
2020-09-23-170410,170410,1,2,2,151,1.3333333333333333,190.23065427846643,2
2020-09-24-170410,170410,5,0,0,156,1.6666666666666667,164.4824842821283,3
2020-09-25-170410,170410,7,1,0,163,2.0,172.19307570776837,4
2020-09-26-170410,170410,0,0,0,163,0.6666666666666666,198.40696599153642,5
2020-09-27-170410,170410,1,0,2,164,0.3333333333333333,193.80031312845568,6
2020-09-28-170410,170410,1,0,0,165,2.333333333333333,204.86871329073625,0
2020-09-29-170410,170410,4,0,1,169,0.6666666666666666,200.74169317878568,1
2020-09-30-170410,170410,2,0,0,171,1.6666666666666667,167.32538223633566,2
2020-10-01-170410,170410,3,0,0,174,2.333333333333333,0.0,3
2020-10-02-170410,170410,1,0,2,175,2.333333333333333,215.71113185568623,4
2020-10-03-170410,170410,0,0,1,175,0.0,338.7185642387728,5
2020-10-04-170410,170410,1,2,0,176,0.0,449.6861911039198,6
2020-10-05-170410,170410,0,0,1,176,0.6666666666666666,415.3407967231213,0
2020-10-06-170410,170410,0,0,1,176,0.3333333333333333,381.70627312652334,1
2020-10-07-170410,170410,2,1,2,178,1.0,350.34897532052753,2
2020-10-08-170410,170410,0,0,3,178,0.0,325.95941709256374,3
2020-10-09-170410,170410,0,0,1,178,2.0,348.1727797538917,4
2020-10-10-170410,170410,0,0,1,178,13.0,38.93506911244741,5
2020-10-11-170410,170410,2,0,0,180,4.0,124.94647514399853,6
2020-10-12-170410,170410,0,0,1,180,7.666666666666668,165.64306897015916,0
2020-10-13-170410,170410,1,0,5,181,1.0,201.71740848896215,1
2020-10-14-170410,170410,0,0,4,181,1.3333333333333333,237.00760230624462,2
2020-10-15-170410,170410,0,0,4,181,2.6666666666666665,264.51496661315383,3
2020-10-16-170410,170410,2,0,12,183,1.0,288.3321381698744,4
2020-10-17-170410,170410,1,0,4,184,3.333333333333333,295.3875982720242,5
2020-10-18-170410,170410,0,0,0,184,1.0,241.56547111264655,6
2020-10-19-170410,170410,1,0,3,185,1.0,223.95535465466713,0
2020-10-20-170410,170410,1,0,3,186,2.333333333333333,217.8217538991983,1
2020-10-21-170410,170410,2,0,7,188,4.666666666666667,256.607458917503,2
2020-10-22-170410,170410,3,0,12,191,9.0,292.8175676846834,3
2020-10-23-170410,170410,1,0,3,192,3.6666666666666665,313.44155654606186,4
2020-10-24-170410,170410,1,0,4,193,1.0,345.26593613338616,5
2020-10-25-170410,170410,0,0,2,193,1.6666666666666667,344.3503770988102,6
2020-10-26-170410,170410,1,1,12,194,1.3333333333333333,327.84693337975045,0
2020-10-27-170410,170410,5,0,4,199,1.6666666666666667,340.1176693040169,1
2020-10-28-170410,170410,4,0,17,203,2.333333333333333,338.85138396557477,2
2020-10-29-170410,170410,4,0,9,207,2.0,330.3202413216853,3
2020-10-30-170410,170410,12,2,6,219,5.0,268.3609711125058,4
2020-10-31-170410,170410,4,1,0,223,14.0,345.175493034977,5
2020-11-01-170410,170410,0,2,0,223,4.333333333333333,264.5840467152807,6
2020-11-02-170410,170410,3,0,0,226,3.333333333333333,349.46497214304355,0
2020-11-03-170410,170410,3,0,0,229,4.0,303.9535241851486,1
2020-11-04-170410,170410,7,1,0,236,5.333333333333333,345.78513556135715,2
2020-11-05-170410,170410,12,1,0,248,2.6666666666666665,393.1759931760723,3
2020-11-06-170410,170410,3,1,0,251,7.666666666666668,435.1799380778888,4
2020-11-07-170410,170410,4,0,0,255,2.6666666666666665,472.05732288099216,5
2020-11-08-170410,170410,2,0,0,257,3.0,474.0093141592506,6
2020-11-09-170410,170410,12,1,0,269,5.333333333333333,458.6967207446925,0
2020-11-10-170410,170410,4,0,0,273,5.0,184.35285414440804,1
2020-11-11-170410,170410,17,1,0,290,5.0,222.1533139252673,2
2020-11-12-170410,170410,9,0,0,299,4.0,318.1478616539206,3
2020-11-13-170410,170410,6,1,0,305,2.6666666666666665,364.42719213194425,4
2020-03-01-170411,170411,0,0,0,0,0.0,0.0,6
2020-03-02-170411,170411,0,0,7,0,0.0,64.11074156168364,0
2020-03-03-170411,170411,0,0,1,0,0.0,375.7764705697245,1
2020-03-04-170411,170411,0,0,11,0,0.0,428.7180264790365,2
2020-03-05-170411,170411,0,0,9,0,0.0,459.98764000166375,3
2020-03-06-170411,170411,0,1,5,0,0.0,428.2397731668013,4
2020-03-07-170411,170411,0,1,2,0,0.0,416.07583973745136,5
2020-03-08-170411,170411,0,0,3,0,0.0,346.93592481474786,6
2020-03-09-170411,170411,0,0,9,0,0.0,349.0310126438268,0
2020-03-10-170411,170411,0,0,5,0,0.6666666666666666,1252.794521674065,1
2020-03-11-170411,170411,0,0,10,0,0.3333333333333333,1004.642685795804,2
2020-03-12-170411,170411,1,0,15,1,1.3333333333333333,786.8963303415468,3
2020-03-13-170411,170411,0,0,11,1,1.0,492.20602527266163,4
2020-03-14-170411,170411,0,0,10,1,0.3333333333333333,361.0239698483982,5
2020-03-15-170411,170411,0,0,15,1,0.3333333333333333,236.01525846210802,6
2020-03-16-170411,170411,7,0,9,8,4.666666666666667,45.90910023246422,0
2020-03-17-170411,170411,1,0,10,9,4.666666666666667,123.2991094802262,1
2020-03-18-170411,170411,11,0,10,20,9.666666666666666,178.58438625238176,2
2020-03-19-170411,170411,9,1,7,29,11.333333333333336,297.8784781489247,3
2020-03-20-170411,170411,5,0,8,34,9.666666666666666,382.13397870482527,4
2020-03-21-170411,170411,2,0,4,36,5.333333333333333,440.50936767627115,5
2020-03-22-170411,170411,3,0,1,39,5.333333333333333,464.83606090043753,6
2020-03-23-170411,170411,9,0,4,48,10.666666666666666,452.6078657426252,0
2020-03-24-170411,170411,5,0,6,53,15.333333333333336,516.5266121726823,1
2020-03-25-170411,170411,10,0,6,63,12.666666666666664,538.1976015332378,2
2020-03-26-170411,170411,15,0,6,78,9.666666666666666,592.7587690562677,3
2020-03-27-170411,170411,11,0,4,89,10.0,716.6351201473204,4
2020-03-28-170411,170411,10,0,2,99,4.0,743.2599595828563,5
2020-03-29-170411,170411,15,0,2,114,1.0,766.2598791795052,6
2020-03-30-170411,170411,9,0,7,123,7.666666666666668,680.7521243866125,0
2020-03-31-170411,170411,10,0,7,133,5.333333333333333,639.6184229642867,1
2020-04-01-170411,170411,10,0,4,143,3.333333333333333,88.22004201336193,2
2020-04-02-170411,170411,7,0,0,150,8.333333333333334,255.20826599114764,3
2020-04-03-170411,170411,8,0,1,158,7.333333333333332,190.981424816514,4
2020-04-04-170411,170411,4,0,0,162,2.6666666666666665,221.59222765023316,5
2020-04-05-170411,170411,1,0,1,163,2.333333333333333,249.37232665796705,6
2020-04-06-170411,170411,4,0,1,167,6.0,248.17859417488538,0
2020-04-07-170411,170411,6,0,1,173,3.0,279.4430732334296,1
2020-04-08-170411,170411,6,0,1,179,4.333333333333333,316.13393571193706,2
2020-04-09-170411,170411,6,0,0,185,6.0,334.4166233009426,3
2020-04-10-170411,170411,4,0,5,189,5.666666666666668,78.7300392147649,4
2020-04-11-170411,170411,2,0,0,191,2.333333333333333,118.40685062945194,5
2020-04-12-170411,170411,2,0,0,193,0.6666666666666666,140.11600812145915,6
2020-04-13-170411,170411,7,0,1,200,4.666666666666667,148.90653202008616,0
2020-04-14-170411,170411,7,0,2,207,3.0,204.25006399389855,1
2020-04-15-170411,170411,4,0,2,211,2.0,262.8836993896243,2
2020-04-16-170411,170411,0,0,2,211,4.666666666666667,288.2126132960252,3
2020-04-17-170411,170411,1,0,1,212,5.0,257.1791650258309,4
2020-04-18-170411,170411,0,0,2,212,1.6666666666666667,267.19191434916934,5
2020-04-19-170411,170411,1,0,1,213,1.6666666666666667,248.1469061492714,6
2020-04-20-170411,170411,1,0,2,214,5.333333333333333,267.8217261275621,0
2020-04-21-170411,170411,1,0,1,215,2.6666666666666665,250.47614067395355,1
2020-04-22-170411,170411,1,0,1,216,4.333333333333333,241.84471791438247,2
2020-04-23-170411,170411,0,0,1,216,1.3333333333333333,243.68138572136425,3
2020-04-24-170411,170411,5,0,0,221,4.666666666666667,205.03911229897236,4
2020-04-25-170411,170411,0,0,1,221,1.3333333333333333,247.14376592873896,5
2020-04-26-170411,170411,0,0,1,221,2.333333333333333,246.13122517517175,6
2020-04-27-170411,170411,1,0,0,222,4.0,189.1940066239972,0
2020-04-28-170411,170411,2,0,3,224,2.0,179.06354013058382,1
2020-04-29-170411,170411,2,0,1,226,5.0,172.78926896279947,2
2020-04-30-170411,170411,2,0,0,228,1.6666666666666667,230.98224330092572,3
2020-05-01-170411,170411,1,0,4,229,2.0,330.26571903332444,4
2020-05-02-170411,170411,2,0,0,231,1.6666666666666667,113.0102490800025,5
2020-05-03-170411,170411,1,0,0,232,0.6666666666666666,93.25809966255686,6
2020-05-04-170411,170411,2,0,5,234,4.0,91.21444830683218,0
2020-05-05-170411,170411,1,0,2,235,3.0,98.20120348903671,1
2020-05-06-170411,170411,1,0,1,236,1.3333333333333333,108.39339004609309,2
2020-05-07-170411,170411,1,0,0,237,1.3333333333333333,102.8038364993009,3
2020-05-08-170411,170411,0,0,5,237,2.6666666666666665,105.95196347245255,4
2020-05-09-170411,170411,1,0,0,238,1.3333333333333333,132.50270386493168,5
2020-05-10-170411,170411,1,1,0,239,0.0,361.5568667853186,6
2020-05-11-170411,170411,0,3,0,239,1.6666666666666667,332.31356285872516,0
2020-05-12-170411,170411,3,0,6,242,2.6666666666666665,335.0989806347221,1
2020-05-13-170411,170411,1,1,0,243,2.6666666666666665,300.0264149977162,2
2020-05-14-170411,170411,0,0,1,243,1.3333333333333333,264.222086128763,3
2020-05-15-170411,170411,4,0,0,247,2.6666666666666665,209.05535953702108,4
2020-05-16-170411,170411,0,0,0,247,0.3333333333333333,168.39761936553413,5
2020-05-17-170411,170411,0,1,0,247,1.3333333333333333,155.62288128753409,6
2020-05-18-170411,170411,5,0,0,252,1.0,149.3144222916793,0
2020-05-19-170411,170411,2,0,0,254,1.0,162.62595536679606,1
2020-05-20-170411,170411,1,0,4,255,0.6666666666666666,139.93193117816116,2
2020-05-21-170411,170411,0,0,1,255,1.3333333333333333,145.21342982497566,3
2020-05-22-170411,170411,5,0,0,260,2.333333333333333,117.30480761583425,4
2020-05-23-170411,170411,0,0,2,260,0.0,148.68848640677504,5
2020-05-24-170411,170411,0,0,0,260,0.0,150.34067625802163,6
2020-05-25-170411,170411,0,0,1,260,0.6666666666666666,116.92406373437396,0
2020-05-26-170411,170411,6,0,2,266,1.0,111.23800509153308,1
2020-05-27-170411,170411,0,0,1,266,1.6666666666666667,133.8733968633677,2
2020-05-28-170411,170411,1,2,1,267,1.0,139.45928153551088,3
2020-05-29-170411,170411,0,2,0,267,1.6666666666666667,160.41884753124987,4
2020-05-30-170411,170411,0,2,1,267,0.3333333333333333,148.06120640441034,5
2020-05-31-170411,170411,0,0,0,267,0.0,152.51788416067882,6
2020-06-01-170411,170411,0,0,2,267,0.3333333333333333,198.27156274714224,0
2020-06-02-170411,170411,0,0,2,267,1.0,90.12132177150966,1
2020-06-03-170411,170411,4,0,2,271,0.0,68.51676554192665,2
2020-06-04-170411,170411,1,0,0,272,1.0,68.73929337276847,3
2020-06-05-170411,170411,0,1,1,272,0.6666666666666666,81.98271116327709,4
2020-06-06-170411,170411,2,0,1,274,0.3333333333333333,96.47998784442947,5
2020-06-07-170411,170411,0,0,0,274,0.3333333333333333,102.58378290656182,6
2020-06-08-170411,170411,1,0,2,275,0.0,107.68206233333805,0
2020-06-09-170411,170411,2,0,0,277,2.333333333333333,96.12169592169141,1
2020-06-10-170411,170411,1,0,3,278,1.3333333333333333,235.74268977624388,2
2020-06-11-170411,170411,1,0,0,279,0.3333333333333333,198.82801624693224,3
2020-06-12-170411,170411,0,0,0,279,1.3333333333333333,180.90773573290744,4
2020-06-13-170411,170411,1,0,1,280,0.0,161.1964126286794,5
2020-06-14-170411,170411,0,8,0,280,0.3333333333333333,146.940766522191,6
2020-06-15-170411,170411,2,0,3,282,1.6666666666666667,108.1186505338924,0
2020-06-16-170411,170411,2,0,0,284,0.6666666666666666,100.27224785116869,1
2020-06-17-170411,170411,2,0,3,286,1.0,103.53553301210616,2
2020-06-18-170411,170411,0,1,1,286,1.6666666666666667,107.67218504562729,3
2020-06-19-170411,170411,1,0,0,287,0.3333333333333333,102.05169430789662,4
2020-06-20-170411,170411,1,0,0,288,0.0,113.5049185300947,5
2020-06-21-170411,170411,0,0,0,288,0.3333333333333333,116.62580644524459,6
2020-06-22-170411,170411,2,0,1,290,1.6666666666666667,99.17700303200967,0
2020-06-23-170411,170411,0,0,0,290,0.6666666666666666,97.96993958728719,1
2020-06-24-170411,170411,3,1,0,293,2.333333333333333,84.95226356650824,2
2020-06-25-170411,170411,0,1,0,293,0.0,99.95722608330793,3
2020-06-26-170411,170411,0,0,3,293,0.3333333333333333,96.25525491352207,4
2020-06-27-170411,170411,1,0,0,294,0.0,80.86769247660628,5
2020-06-28-170411,170411,0,0,0,294,0.0,79.512008461975,6
2020-06-29-170411,170411,3,0,1,297,1.3333333333333333,76.31581122121284,0
2020-06-30-170411,170411,0,0,0,297,1.3333333333333333,91.41929182837262,1
2020-07-01-170411,170411,3,0,1,300,1.0,124.55283075504177,2
2020-07-02-170411,170411,1,0,0,301,0.3333333333333333,56.05584055100684,3
2020-07-03-170411,170411,0,0,0,301,0.0,63.85385718476862,4
2020-07-04-170411,170411,0,0,0,301,0.0,78.14580013710665,5
2020-07-05-170411,170411,0,0,0,301,0.0,78.45438066190249,6
2020-07-06-170411,170411,1,0,0,302,1.0,67.69042699806793,0
2020-07-07-170411,170411,0,0,0,302,0.6666666666666666,70.14786225572902,1
2020-07-08-170411,170411,0,0,1,302,0.3333333333333333,60.05848366608693,2
2020-07-09-170411,170411,0,0,0,302,0.3333333333333333,67.57829696869013,3
2020-07-10-170411,170411,3,0,0,305,0.6666666666666666,138.13980688979728,4
2020-07-11-170411,170411,0,0,0,305,0.0,143.52683952672402,5
2020-07-12-170411,170411,0,0,0,305,0.0,121.93569666535352,6
2020-07-13-170411,170411,1,0,1,306,0.6666666666666666,112.21041641365571,0
2020-07-14-170411,170411,0,0,1,306,0.3333333333333333,122.19592487595548,1
2020-07-15-170411,170411,1,0,3,307,0.6666666666666666,115.06117808658509,2
2020-07-16-170411,170411,0,0,3,307,1.0,81.83028750979004,3
2020-07-17-170411,170411,0,0,2,307,0.0,66.92304280504652,4
2020-07-18-170411,170411,0,0,0,307,0.0,48.503597484718256,5
2020-07-19-170411,170411,0,0,0,307,0.0,50.73280776395845,6
2020-07-20-170411,170411,0,1,2,307,1.0,53.770260348856866,0
2020-07-21-170411,170411,0,1,1,307,3.333333333333333,61.7209582613903,1
2020-07-22-170411,170411,1,0,2,308,0.3333333333333333,72.27314192836059,2
2020-07-23-170411,170411,0,0,1,308,1.0,72.14960474835146,3
2020-07-24-170411,170411,0,0,0,308,0.6666666666666666,78.43365878288456,4
2020-07-25-170411,170411,0,0,1,308,0.3333333333333333,82.4040037265078,5
2020-07-26-170411,170411,0,0,1,308,0.0,78.89568600582183,6
2020-07-27-170411,170411,1,0,2,309,1.3333333333333333,68.29020862544616,0
2020-07-28-170411,170411,1,0,0,310,0.6666666666666666,69.69909549011005,1
2020-07-29-170411,170411,3,0,0,313,1.3333333333333333,55.89648725230725,2
2020-07-30-170411,170411,3,0,2,316,0.6666666666666666,56.03216347112931,3
2020-07-31-170411,170411,2,0,1,318,0.6666666666666666,69.47189808226389,4
2020-08-01-170411,170411,0,0,0,318,0.0,51.43767656838108,5
2020-08-02-170411,170411,0,0,0,318,0.0,148.9323417821458,6
2020-08-03-170411,170411,2,0,3,320,1.0,178.6267524606182,0
2020-08-04-170411,170411,1,0,1,321,1.3333333333333333,172.25491008955493,1
2020-08-05-170411,170411,2,0,2,323,1.0,152.51690296181,2
2020-08-06-170411,170411,1,0,0,324,0.6666666666666666,138.8099048206209,3
2020-08-07-170411,170411,0,0,2,324,2.333333333333333,124.2665307772196,4
2020-08-08-170411,170411,1,0,2,325,0.0,139.6411158112159,5
2020-08-09-170411,170411,1,1,0,326,1.0,128.280934621845,6
2020-08-10-170411,170411,2,0,5,328,2.333333333333333,43.6143074055879,0
2020-08-11-170411,170411,0,0,2,328,1.6666666666666667,77.84263644181559,1
2020-08-12-170411,170411,0,0,6,328,2.333333333333333,90.90250445822714,2
2020-08-13-170411,170411,2,0,2,330,1.6666666666666667,103.61445106364468,3
2020-08-14-170411,170411,1,0,4,331,2.0,121.14411151260401,4
2020-08-15-170411,170411,0,0,0,331,0.3333333333333333,133.46878907609727,5
2020-08-16-170411,170411,0,0,1,331,0.3333333333333333,129.2467980704605,6
2020-08-17-170411,170411,3,0,2,334,1.0,142.37541169017476,0
2020-08-18-170411,170411,1,0,5,335,2.0,127.55857321581344,1
2020-08-19-170411,170411,2,0,0,337,1.6666666666666667,143.02568796013225,2
2020-08-20-170411,170411,0,0,2,337,1.3333333333333333,119.64278227864648,3
2020-08-21-170411,170411,2,0,0,339,1.0,136.79307925385416,4
2020-08-22-170411,170411,2,0,1,341,1.0,147.05705243749657,5
2020-08-23-170411,170411,0,0,1,341,0.0,159.5891564906616,6
2020-08-24-170411,170411,5,0,1,346,1.6666666666666667,139.55941020554656,0
2020-08-25-170411,170411,2,0,0,348,1.6666666666666667,132.55279295890193,1
2020-08-26-170411,170411,6,0,1,354,0.6666666666666666,134.2934658266119,2
2020-08-27-170411,170411,2,0,2,356,2.6666666666666665,170.24083723829952,3
2020-08-28-170411,170411,4,0,2,360,2.0,167.85056125732768,4
2020-08-29-170411,170411,0,0,1,360,1.6666666666666667,181.40124796039464,5
2020-08-30-170411,170411,1,0,2,361,0.0,195.60673745330368,6
2020-08-31-170411,170411,2,0,0,363,0.0,181.51682610065737,0
2020-09-01-170411,170411,5,0,3,368,2.0,132.5620504818836,1
2020-09-02-170411,170411,0,0,9,368,1.3333333333333333,336.1964806017969,2
2020-09-03-170411,170411,2,0,5,370,0.6666666666666666,378.77309378080565,3
2020-09-04-170411,170411,0,0,7,370,1.6666666666666667,348.7966064392912,4
2020-09-05-170411,170411,1,0,2,371,1.3333333333333333,334.70072240855114,5
2020-09-06-170411,170411,1,0,0,372,1.3333333333333333,342.2371962378578,6
2020-09-07-170411,170411,1,0,3,373,1.3333333333333333,332.0987330369891,0
2020-09-08-170411,170411,0,0,7,373,0.6666666666666666,299.44269397462904,1
2020-09-09-170411,170411,1,0,10,374,0.6666666666666666,246.80812323811307,2
2020-09-10-170411,170411,2,0,3,376,2.333333333333333,151.49980713688973,3
2020-09-11-170411,170411,2,0,2,378,4.0,167.64770148711966,4
2020-09-12-170411,170411,1,0,1,379,2.6666666666666665,208.43838885392302,5
2020-09-13-170411,170411,2,0,1,381,0.6666666666666666,216.12751845588986,6
2020-09-14-170411,170411,0,0,2,381,2.6666666666666665,204.16427553352145,0
2020-09-15-170411,170411,3,0,4,384,3.333333333333333,235.1663653777448,1
2020-09-16-170411,170411,9,0,1,393,4.0,269.42565582080044,2
2020-09-17-170411,170411,5,0,10,398,5.333333333333333,275.483149732455,3
2020-09-18-170411,170411,7,0,2,405,5.0,318.59486887219066,4
2020-09-19-170411,170411,2,0,0,407,3.0,317.4096091512064,5
2020-09-20-170411,170411,0,0,1,407,0.3333333333333333,340.95872743237464,6
2020-09-21-170411,170411,3,0,1,410,4.666666666666667,312.4510276650095,0
2020-09-22-170411,170411,7,0,4,417,6.666666666666668,320.0719679850062,1
2020-09-23-170411,170411,10,1,2,427,4.666666666666667,396.52429055264463,2
2020-09-24-170411,170411,3,0,1,430,6.0,387.9440074578052,3
2020-09-25-170411,170411,2,0,6,432,3.0,374.8005809368017,4
2020-09-26-170411,170411,1,0,3,433,1.0,374.18728224256324,5
2020-09-27-170411,170411,1,0,2,434,1.6666666666666667,366.48229356649813,6
2020-09-28-170411,170411,2,0,2,436,8.666666666666666,389.61718507581986,0
2020-09-29-170411,170411,4,0,2,440,4.333333333333333,414.83677606565413,1
2020-09-30-170411,170411,1,0,6,441,4.333333333333333,336.69817316345586,2
2020-10-01-170411,170411,10,0,4,451,6.666666666666668,0.0,3
2020-10-02-170411,170411,2,0,14,453,5.0,778.0734571162025,4
2020-10-03-170411,170411,0,0,8,453,1.0,1199.7828665436268,5
2020-10-04-170411,170411,1,0,4,454,4.666666666666667,1203.5100066904747,6
2020-10-05-170411,170411,1,0,3,455,8.666666666666666,1066.2231285629055,0
2020-10-06-170411,170411,4,0,8,459,5.333333333333333,995.7490828813097,1
2020-10-07-170411,170411,2,0,3,461,8.666666666666666,968.6999322005943,2
2020-10-08-170411,170411,1,1,4,462,10.333333333333334,895.3165324008291,3
2020-10-09-170411,170411,6,0,17,468,7.0,1004.2948020486172,4
2020-10-10-170411,170411,3,0,4,471,17.0,121.69019616157743,5
2020-10-11-170411,170411,2,0,3,473,4.666666666666667,265.3731069606577,6
2020-10-12-170411,170411,2,0,4,475,7.0,361.42802042513813,0
2020-10-13-170411,170411,2,0,6,477,7.0,423.68415438378486,1
2020-10-14-170411,170411,6,0,9,483,7.333333333333332,531.4724726344723,2
2020-10-15-170411,170411,4,0,8,487,4.333333333333333,635.7807968923355,3
2020-10-16-170411,170411,14,0,6,501,14.666666666666664,708.3128265131616,4
2020-10-17-170411,170411,8,0,3,509,8.0,751.851493472421,5
2020-10-18-170411,170411,4,0,4,513,9.333333333333334,724.0423275726607,6
2020-10-19-170411,170411,3,0,2,516,6.0,734.3758345643605,0
2020-10-20-170411,170411,8,0,4,524,12.666666666666664,763.0383669676162,1
2020-10-21-170411,170411,3,0,6,527,12.333333333333336,852.3568323567106,2
2020-10-22-170411,170411,4,0,8,531,13.0,937.7766842584945,3
2020-10-23-170411,170411,17,0,13,548,18.33333333333333,950.8712512745658,4
2020-10-24-170411,170411,4,0,6,552,9.0,1068.1658138366372,5
2020-10-25-170411,170411,3,1,6,555,6.0,1074.1379209749725,6
2020-10-26-170411,170411,4,0,3,559,8.666666666666666,1035.041428230067,0
2020-10-27-170411,170411,6,0,8,565,10.0,1110.3302934198095,1
2020-10-28-170411,170411,9,0,12,574,8.0,1129.1993319158896,2
2020-10-29-170411,170411,8,1,4,582,13.0,1095.2074181542853,3
2020-10-30-170411,170411,6,0,13,588,18.0,938.8114148478082,4
2020-10-31-170411,170411,3,0,0,591,20.666666666666668,1025.0152201613912,5
2020-11-01-170411,170411,4,0,0,595,11.333333333333336,832.4841701806224,6
2020-11-02-170411,170411,2,0,0,597,5.0,640.3238954109603,0
2020-11-03-170411,170411,4,1,0,601,11.333333333333336,665.7017387300134,1
2020-11-04-170411,170411,6,2,0,607,13.333333333333336,789.6897336152895,2
2020-11-05-170411,170411,8,0,0,615,10.333333333333334,898.4318069206042,3
2020-11-06-170411,170411,13,0,0,628,22.0,961.0849720232653,4
2020-11-07-170411,170411,6,0,0,634,4.333333333333333,1092.3709881331688,5
2020-11-08-170411,170411,6,0,0,640,7.333333333333332,1102.1793093905267,6
2020-11-09-170411,170411,3,0,0,643,10.333333333333334,1064.3446464366161,0
2020-11-10-170411,170411,8,1,0,651,9.0,781.6763793054736,1
2020-11-11-170411,170411,12,0,0,663,14.666666666666664,821.7848087014532,2
2020-11-12-170411,170411,4,1,0,667,8.666666666666666,880.7625326519952,3
2020-11-13-170411,170411,13,0,0,680,8.0,895.2982249287415,4
2020-03-01-170501,170501,0,0,1,0,0.0,0.0,6
2020-03-02-170501,170501,0,0,0,0,0.0,9.22175713142396,0
2020-03-03-170501,170501,0,0,1,0,0.0,47.41528371913549,1
2020-03-04-170501,170501,0,0,1,0,0.0,59.03318080885214,2
2020-03-05-170501,170501,0,0,1,0,0.0,60.37136458089212,3
2020-03-06-170501,170501,0,0,1,0,0.0,47.927552225937475,4
2020-03-07-170501,170501,0,1,1,0,0.0,50.79033970130925,5
2020-03-08-170501,170501,0,0,0,0,0.0,41.31414355153766,6
2020-03-09-170501,170501,0,0,2,0,0.0,41.906994513314096,0
2020-03-10-170501,170501,0,0,2,0,0.0,374.403896661309,1
2020-03-11-170501,170501,0,0,0,0,0.0,307.4296023211357,2
2020-03-12-170501,170501,0,0,6,0,0.6,237.6040170376693,3
2020-03-13-170501,170501,0,0,2,0,0.2,202.25499231672825,4
2020-03-14-170501,170501,0,0,1,0,0.6,135.43334904174907,5
2020-03-15-170501,170501,1,0,1,1,0.4,82.36740144647268,6
2020-03-16-170501,170501,0,0,4,1,0.2,25.2682617746788,0
2020-03-17-170501,170501,1,0,1,2,0.8,32.66930292371555,1
2020-03-18-170501,170501,1,0,4,3,0.2,44.15102794466832,2
2020-03-19-170501,170501,1,0,1,4,1.4,51.65525681529743,3
2020-03-20-170501,170501,1,0,3,5,2.0,58.29223987395092,4
2020-03-21-170501,170501,1,0,2,6,1.0,72.80307509041342,5
2020-03-22-170501,170501,0,0,1,6,0.4,76.30238528174408,6
2020-03-23-170501,170501,2,0,2,8,2.4,72.19151979159446,0
2020-03-24-170501,170501,2,0,3,10,0.8,88.1975317227882,1
2020-03-25-170501,170501,0,0,0,10,0.8,88.48773329684786,2
2020-03-26-170501,170501,6,0,1,16,0.8,81.83058270148874,3
2020-03-27-170501,170501,2,0,2,18,2.2,101.67837546986698,4
2020-03-28-170501,170501,1,0,1,19,0.2,101.8603704933632,5
2020-03-29-170501,170501,1,0,1,20,0.8,92.54732675469518,6
2020-03-30-170501,170501,4,0,2,24,0.6,75.71010201572321,0
2020-03-31-170501,170501,1,0,1,25,0.4,80.6687118365113,1
2020-04-01-170501,170501,4,0,0,29,0.4,6.873655232617542,2
2020-04-02-170501,170501,1,0,1,30,0.6,52.910741207365156,3
2020-04-03-170501,170501,3,0,2,33,0.4,24.20233508907817,4
2020-04-04-170501,170501,2,0,1,35,0.2,35.881457645796424,5
2020-04-05-170501,170501,1,0,0,36,0.6,37.48765342315142,6
2020-04-06-170501,170501,2,6,2,38,0.6,43.013844684550754,0
2020-04-07-170501,170501,3,0,3,41,0.6,48.751989464541566,1
2020-04-08-170501,170501,0,0,0,41,1.4,53.501993703740354,2
2020-04-09-170501,170501,1,0,0,42,0.2,60.78622282104353,3
2020-04-10-170501,170501,2,0,0,44,0.4,10.58837413445654,4
2020-04-11-170501,170501,1,0,0,45,0.6,18.43143658233423,5
2020-04-12-170501,170501,1,0,0,46,0.0,22.49208526427682,6
2020-04-13-170501,170501,2,0,0,48,0.8,24.981756372341906,0
2020-04-14-170501,170501,1,0,1,49,0.8,34.779368517319774,1
2020-04-15-170501,170501,0,0,1,49,0.4,44.873751388671245,2
2020-04-16-170501,170501,1,0,0,50,0.2,49.409946688349535,3
2020-04-17-170501,170501,2,0,0,52,0.2,47.65789348624027,4
2020-04-18-170501,170501,1,0,0,53,0.0,50.866685999385425,5
2020-04-19-170501,170501,0,0,0,53,0.4,51.79253338025534,6
2020-04-20-170501,170501,2,0,1,55,0.4,51.69533015406989,0
2020-04-21-170501,170501,3,0,1,58,0.0,62.65278516902131,1
2020-04-22-170501,170501,0,0,2,58,0.4,63.17449909453041,2
2020-04-23-170501,170501,0,0,0,58,0.0,62.751898174809796,3
2020-04-24-170501,170501,0,0,2,58,0.2,51.284265270123065,4
2020-04-25-170501,170501,0,0,1,58,0.4,49.81359434962587,5
2020-04-26-170501,170501,0,0,0,58,0.0,48.85619012174904,6
2020-04-27-170501,170501,0,0,3,58,0.2,40.63827877488112,0
2020-04-28-170501,170501,1,0,2,59,0.6,23.654313708713154,1
2020-04-29-170501,170501,1,0,3,60,0.2,23.17691974169829,2
2020-04-30-170501,170501,0,0,2,60,0.6,37.78187056984921,3
2020-05-01-170501,170501,0,0,2,60,0.8,63.96014636784147,4
2020-05-02-170501,170501,0,0,0,60,0.2,34.527749818423565,5
2020-05-03-170501,170501,0,0,0,60,0.2,25.109132425304068,6
2020-05-04-170501,170501,1,0,1,61,1.6,30.106611598114124,0
2020-05-05-170501,170501,1,0,1,62,0.6,36.81935904763111,1
2020-05-06-170501,170501,2,0,1,64,0.6,40.115629463531604,2
2020-05-07-170501,170501,0,0,0,64,0.2,41.99433305517623,3
2020-05-08-170501,170501,2,0,3,66,0.6,41.49315523222136,4
2020-05-09-170501,170501,1,0,0,67,0.2,55.682399401977236,5
2020-05-10-170501,170501,0,1,0,67,0.2,70.03098658283469,6
2020-05-11-170501,170501,3,1,1,70,0.8,66.04138931251347,0
2020-05-12-170501,170501,2,0,3,72,0.4,70.42938698433393,1
2020-05-13-170501,170501,3,2,0,75,0.0,67.37987963210112,2
2020-05-14-170501,170501,2,0,2,77,0.2,62.63570164611283,3
2020-05-15-170501,170501,2,0,1,79,0.4,54.74830657729326,4
2020-05-16-170501,170501,0,0,1,79,0.0,55.322237289039364,5
2020-05-17-170501,170501,0,0,3,79,0.4,49.55291940270757,6
2020-05-18-170501,170501,1,0,0,80,0.2,51.285519877671405,0
2020-05-19-170501,170501,1,0,5,81,0.2,42.39005563039217,1
2020-05-20-170501,170501,1,0,0,82,0.4,35.110695426212494,2
2020-05-21-170501,170501,0,0,3,82,0.4,35.64355077796308,3
2020-05-22-170501,170501,3,0,3,85,1.2,32.19454790258121,4
2020-05-23-170501,170501,0,0,1,85,0.0,48.88744735909068,5
2020-05-24-170501,170501,0,0,0,85,0.0,45.75302130921072,6
2020-05-25-170501,170501,1,0,1,86,0.2,41.31077001345811,0
2020-05-26-170501,170501,3,0,0,89,0.6,41.647488506076954,1
2020-05-27-170501,170501,0,0,0,89,0.4,51.31258941486674,2
2020-05-28-170501,170501,2,1,0,91,0.0,47.31132700765161,3
2020-05-29-170501,170501,1,5,1,92,0.2,46.86153442513134,4
2020-05-30-170501,170501,1,0,0,93,0.0,34.912313564589255,5
2020-05-31-170501,170501,3,1,1,96,0.0,39.54444016153447,6
2020-06-01-170501,170501,0,0,9,96,0.2,78.04761618115222,0
2020-06-02-170501,170501,5,0,2,101,0.8,56.60280908893374,1
2020-06-03-170501,170501,0,0,1,101,0.6,28.41112648392474,2
2020-06-04-170501,170501,3,0,0,104,0.0,44.96881551933812,3
2020-06-05-170501,170501,3,0,1,107,0.4,49.14658294974298,4
2020-06-06-170501,170501,1,0,0,108,0.4,61.386962667471195,5
2020-06-07-170501,170501,0,0,1,108,0.0,61.91182888665825,6
2020-06-08-170501,170501,1,0,0,109,0.4,62.095735621794866,0
2020-06-09-170501,170501,0,0,0,109,0.4,70.66106645970663,1
2020-06-10-170501,170501,0,0,0,109,0.4,75.44701943251519,2
2020-06-11-170501,170501,0,0,0,109,0.6,64.72234149488364,3
2020-06-12-170501,170501,1,0,1,110,0.2,65.65146553691264,4
2020-06-13-170501,170501,0,0,0,110,0.2,57.07588153430908,5
2020-06-14-170501,170501,1,0,0,111,0.0,56.0199244382462,6
2020-06-15-170501,170501,9,0,0,120,0.6,44.50947379385762,0
2020-06-16-170501,170501,2,0,0,122,0.2,67.85520822905423,1
2020-06-17-170501,170501,1,0,0,123,0.0,71.01616561761715,2
2020-06-18-170501,170501,0,0,0,123,0.0,60.77185868486552,3
2020-06-19-170501,170501,1,0,0,124,0.2,54.14109691868973,4
2020-06-20-170501,170501,0,0,1,124,0.4,68.77021002957484,5
2020-06-21-170501,170501,1,0,2,125,0.2,78.73335312796569,6
2020-06-22-170501,170501,0,0,4,125,0.0,55.928243044465425,0
2020-06-23-170501,170501,0,0,2,125,0.2,47.346771648165735,1
2020-06-24-170501,170501,0,0,0,125,0.4,50.48557010179,2
2020-06-25-170501,170501,0,0,0,125,0.2,57.3696343574152,3
2020-06-26-170501,170501,1,0,1,126,0.0,51.25372549665361,4
2020-06-27-170501,170501,0,0,0,126,0.2,36.24449609892778,5
2020-06-28-170501,170501,0,0,1,126,0.0,34.437633675981296,6
2020-06-29-170501,170501,0,0,0,126,0.2,29.441075705596788,0
2020-06-30-170501,170501,0,0,0,126,0.8,43.88686077367291,1
2020-07-01-170501,170501,0,0,0,126,0.2,67.54796907267014,2
2020-07-02-170501,170501,0,0,0,126,0.6,37.45997224246315,3
2020-07-03-170501,170501,0,0,0,126,0.0,76.4354534653196,4
2020-07-04-170501,170501,1,0,0,127,0.2,69.61940950083807,5
2020-07-05-170501,170501,2,0,0,129,0.2,75.66189787872995,6
2020-07-06-170501,170501,4,0,0,133,0.4,69.51274359802676,0
2020-07-07-170501,170501,2,0,0,135,0.4,83.98543518124927,1
2020-07-08-170501,170501,0,0,0,135,0.4,60.12850058525579,2
2020-07-09-170501,170501,0,0,0,135,0.2,67.03066541800591,3
2020-07-10-170501,170501,1,0,0,136,0.4,63.299603090357465,4
2020-07-11-170501,170501,0,0,4,136,0.0,64.89532955792644,5
2020-07-12-170501,170501,1,0,1,137,0.4,48.56846325733495,6
2020-07-13-170501,170501,0,0,0,137,0.2,43.3946420361482,0
2020-07-14-170501,170501,0,0,3,137,0.0,48.59965694511246,1
2020-07-15-170501,170501,0,0,4,137,0.2,35.2972881069407,2
2020-07-16-170501,170501,0,0,1,137,0.6,30.149317025117966,3
2020-07-17-170501,170501,0,0,1,137,0.2,46.31586176113616,4
2020-07-18-170501,170501,0,0,0,137,0.0,46.24702140511966,5
2020-07-19-170501,170501,0,0,2,137,0.2,47.0681308853373,6
2020-07-20-170501,170501,0,0,2,137,0.0,53.81224397486451,0
2020-07-21-170501,170501,0,0,3,137,0.6,53.1927979456152,1
2020-07-22-170501,170501,0,0,4,137,0.0,62.000849664433176,2
2020-07-23-170501,170501,0,0,2,137,0.0,39.69562460542399,3
2020-07-24-170501,170501,0,0,1,137,0.2,34.12728322686721,4
2020-07-25-170501,170501,4,0,0,141,0.2,37.05439345169158,5
2020-07-26-170501,170501,1,0,0,142,0.0,51.48754455389025,6
2020-07-27-170501,170501,0,0,1,142,0.4,38.66825154943122,0
2020-07-28-170501,170501,3,0,2,145,0.0,50.61739766886991,1
2020-07-29-170501,170501,4,0,1,149,1.0,50.15769245233163,2
2020-07-30-170501,170501,1,0,3,150,0.0,94.11546356669817,3
2020-07-31-170501,170501,1,0,5,151,0.4,95.29607019485707,4
2020-08-01-170501,170501,0,0,0,151,0.2,72.09817190449081,5
2020-08-02-170501,170501,2,0,4,153,0.2,246.08284420904337,6
2020-08-03-170501,170501,2,0,3,155,0.4,404.42909467075117,0
2020-08-04-170501,170501,3,0,15,158,1.0,272.04366488452047,1
2020-08-05-170501,170501,4,1,4,162,1.0,157.83716400727764,2
2020-08-06-170501,170501,2,0,1,164,0.0,151.0162899026823,3
2020-08-07-170501,170501,1,0,1,165,0.6,149.43326075941565,4
2020-08-08-170501,170501,0,0,2,165,0.4,157.01508136597727,5
2020-08-09-170501,170501,0,0,2,165,0.0,153.12628557227032,6
2020-08-10-170501,170501,1,0,6,166,1.4,80.77911588903444,0
2020-08-11-170501,170501,2,0,0,168,2.2,106.49916934292162,1
2020-08-12-170501,170501,1,0,5,169,3.2,130.2886555866155,2
2020-08-13-170501,170501,3,0,2,172,2.2,198.8462764473726,3
2020-08-14-170501,170501,5,0,0,177,1.6,246.7455411115826,4
2020-08-15-170501,170501,0,0,1,177,0.6,281.05709492574937,5
2020-08-16-170501,170501,4,0,2,181,0.2,298.0051973953489,6
2020-08-17-170501,170501,3,0,4,184,0.6,312.7526599127256,0
2020-08-18-170501,170501,15,0,5,199,0.0,309.2912761431261,1
2020-08-19-170501,170501,4,0,8,203,0.6,332.9928568987076,2
2020-08-20-170501,170501,1,0,5,204,0.6,212.86656499711353,3
2020-08-21-170501,170501,1,0,2,205,1.4,183.08714336860575,4
2020-08-22-170501,170501,2,0,1,207,0.4,212.47462438799982,5
2020-08-23-170501,170501,2,0,0,209,2.0,214.6007150844567,6
2020-08-24-170501,170501,6,0,1,215,1.8,224.83987713126015,0
2020-08-25-170501,170501,0,0,2,215,2.8,245.51577400593084,1
2020-08-26-170501,170501,5,0,1,220,2.0,318.78770704877894,2
2020-08-27-170501,170501,2,0,2,222,1.8,459.7762366633582,3
2020-08-28-170501,170501,0,0,2,222,0.6,476.6810571835606,4
2020-08-29-170501,170501,1,0,1,223,0.0,439.28027625359977,5
2020-08-30-170501,170501,2,0,3,225,0.6,376.9817725282086,6
2020-08-31-170501,170501,4,0,12,229,1.2,314.2952382753284,0
2020-09-01-170501,170501,5,0,6,234,0.0,124.63200488166406,1
2020-09-02-170501,170501,8,0,2,242,0.4,229.55057913310932,2
2020-09-03-170501,170501,5,0,6,247,0.8,188.60809185102374,3
2020-09-04-170501,170501,2,0,9,249,0.6,186.07471800405773,4
2020-09-05-170501,170501,1,0,8,250,1.2,165.56407920616041,5
2020-09-06-170501,170501,0,0,5,250,0.0,165.43074947897907,6
2020-09-07-170501,170501,1,0,6,251,0.0,147.41558806821172,0
2020-09-08-170501,170501,2,0,5,253,0.4,136.55748120537007,1
2020-09-09-170501,170501,1,0,4,254,0.2,117.03529576277737,2
2020-09-10-170501,170501,2,0,3,256,1.2,101.5255098580173,3
2020-09-11-170501,170501,2,0,5,258,0.6,99.22154874911982,4
2020-09-12-170501,170501,1,0,0,259,0.8,92.95610635217072,5
2020-09-13-170501,170501,3,0,5,262,0.6,102.45525734018256,6
2020-09-14-170501,170501,12,0,1,274,0.2,113.47355320242109,0
2020-09-15-170501,170501,6,0,3,280,1.2,147.60734131769368,1
2020-09-16-170501,170501,2,0,4,282,0.8,180.48253271008463,2
2020-09-17-170501,170501,6,0,6,288,0.8,180.1502276679813,3
2020-09-18-170501,170501,9,0,1,297,1.2,184.66217423157957,4
2020-09-19-170501,170501,8,0,5,305,0.4,201.26816885157848,5
2020-09-20-170501,170501,5,0,0,310,0.4,209.03517512297594,6
2020-09-21-170501,170501,6,1,4,316,0.4,190.04270869761,0
2020-09-22-170501,170501,5,1,6,321,0.6,179.02678726552972,1
2020-09-23-170501,170501,4,1,1,325,1.6,179.99437075374567,2
2020-09-24-170501,170501,3,0,6,328,1.8,182.61360314869344,3
2020-09-25-170501,170501,5,2,6,333,1.0,167.05617608117308,4
2020-09-26-170501,170501,0,0,5,333,0.6,161.8358550163192,5
2020-09-27-170501,170501,5,0,4,338,1.0,157.84649162912984,6
2020-09-28-170501,170501,1,1,3,339,0.4,160.5673792537448,0
2020-09-29-170501,170501,3,0,9,342,1.2,154.335414163106,1
2020-09-30-170501,170501,4,0,13,346,0.2,166.91406457496834,2
2020-10-01-170501,170501,6,0,5,352,0.2,0.0,3
2020-10-02-170501,170501,1,0,18,353,1.2,543.9666334034468,4
2020-10-03-170501,170501,5,0,13,358,1.0,735.5303427119559,5
2020-10-04-170501,170501,0,0,20,358,0.2,572.1512350254634,6
2020-10-05-170501,170501,4,0,5,362,0.8,499.54541149080035,0
2020-10-06-170501,170501,6,0,17,368,0.8,442.1678629011231,1
2020-10-07-170501,170501,1,0,13,369,0.2,373.5884491062542,2
2020-10-08-170501,170501,6,1,38,375,0.0,237.55568069862628,3
2020-10-09-170501,170501,6,0,13,381,1.4,236.54984832842007,4
2020-10-10-170501,170501,5,0,19,386,0.8,25.85919089774734,5
2020-10-11-170501,170501,4,0,21,390,1.2,61.76814731921703,6
2020-10-12-170501,170501,3,0,18,393,2.2,97.61198793779545,0
2020-10-13-170501,170501,9,0,20,402,1.0,154.75882842792856,1
2020-10-14-170501,170501,13,0,15,415,3.2,204.36607726312096,2
2020-10-15-170501,170501,5,0,31,420,0.6,308.07518345878725,3
2020-10-16-170501,170501,18,0,11,438,0.6,351.22585595956025,4
2020-10-17-170501,170501,13,0,4,451,3.4,406.13753856000403,5
2020-10-18-170501,170501,20,0,10,471,1.8,468.6636639297474,6
2020-10-19-170501,170501,5,0,14,476,2.0,511.59542195198367,0
2020-10-20-170501,170501,17,0,13,493,7.6,494.3553343940951,1
2020-10-21-170501,170501,13,0,13,506,2.2,581.2067470521034,2
2020-10-22-170501,170501,38,0,9,544,2.6,596.4071620193829,3
2020-10-23-170501,170501,13,0,8,557,4.6,628.4206676623792,4
2020-10-24-170501,170501,19,1,11,576,3.0,622.4154261439246,5
2020-10-25-170501,170501,21,1,12,597,2.4,609.6111140770181,6
2020-10-26-170501,170501,18,0,9,615,1.2,612.4881684404104,0
2020-10-27-170501,170501,20,0,2,635,2.4,642.5467010655007,1
2020-10-28-170501,170501,15,0,2,650,3.8,545.1701669775641,2
2020-10-29-170501,170501,31,0,12,681,4.6,582.3966682806716,3
2020-10-30-170501,170501,11,1,13,692,4.2,543.3822228612277,4
2020-10-31-170501,170501,4,0,0,696,2.6,542.202859505614,5
2020-11-01-170501,170501,10,0,0,706,2.8,172.92771527901817,6
2020-11-02-170501,170501,14,0,0,720,1.6,289.24188493793315,0
2020-11-03-170501,170501,13,1,0,733,2.2,277.2075442480815,1
2020-11-04-170501,170501,13,1,0,746,2.0,297.3849270087277,2
2020-11-05-170501,170501,9,1,0,755,2.4,323.04476840955795,3
2020-11-06-170501,170501,8,0,0,763,1.0,344.59820601725585,4
2020-11-07-170501,170501,11,0,0,774,2.2,339.24617242284694,5
2020-11-08-170501,170501,12,0,0,786,2.2,370.4761795861514,6
2020-11-09-170501,170501,9,2,0,795,2.0,348.9600334088111,0
2020-11-10-170501,170501,2,0,0,797,1.4,181.5864902333308,1
2020-11-11-170501,170501,2,1,0,799,0.4,199.7942351210918,2
2020-11-12-170501,170501,12,0,0,811,1.8,194.4229910057908,3
2020-11-13-170501,170501,13,0,0,824,1.2,227.8163424881539,4
2020-03-01-170502,170502,0,0,0,0,0.0,0.0,6
2020-03-02-170502,170502,0,0,0,0,0.0,9.155770853235783,0
2020-03-03-170502,170502,0,0,0,0,0.0,50.437443868042266,1
2020-03-04-170502,170502,0,0,0,0,0.0,55.19482675389524,2
2020-03-05-170502,170502,0,0,0,0,0.0,59.29497318439485,3
2020-03-06-170502,170502,0,0,1,0,0.0,50.257112703969554,4
2020-03-07-170502,170502,0,0,0,0,0.0,48.925716341223,5
2020-03-08-170502,170502,0,0,1,0,0.16666666666666666,42.916407640250384,6
2020-03-09-170502,170502,0,0,0,0,0.16666666666666666,43.98356150293475,0
2020-03-10-170502,170502,0,0,0,0,0.16666666666666666,231.94905448562378,1
2020-03-11-170502,170502,0,0,2,0,0.0,198.73826453218837,2
2020-03-12-170502,170502,0,0,2,0,0.3333333333333333,136.00431086442325,3
2020-03-13-170502,170502,0,0,4,0,0.5,104.07839346051992,4
2020-03-14-170502,170502,1,0,1,1,0.3333333333333333,48.07657349432212,5
2020-03-15-170502,170502,0,0,0,1,1.1666666666666667,42.46843750176708,6
2020-03-16-170502,170502,0,0,1,1,2.5,15.861216433798365,0
2020-03-17-170502,170502,0,0,0,1,3.333333333333333,26.716760847330182,1
2020-03-18-170502,170502,0,0,0,1,2.5,35.97891178907531,2
2020-03-19-170502,170502,0,0,0,1,4.166666666666667,45.991130221472275,3
2020-03-20-170502,170502,1,1,1,2,3.333333333333333,55.84908534386179,4
2020-03-21-170502,170502,0,0,0,2,3.333333333333333,61.686115963283505,5
2020-03-22-170502,170502,1,0,0,3,2.333333333333333,60.99479236331481,6
2020-03-23-170502,170502,0,1,0,3,6.666666666666668,57.82947998665691,0
2020-03-24-170502,170502,0,0,4,3,4.666666666666667,68.19052919802091,1
2020-03-25-170502,170502,2,0,1,5,4.166666666666667,73.88885611214488,2
2020-03-26-170502,170502,2,0,0,7,4.166666666666667,73.58612796053697,3
2020-03-27-170502,170502,4,0,1,11,4.0,87.1321785561772,4
2020-03-28-170502,170502,1,0,0,12,1.8333333333333333,89.6255778302344,5
2020-03-29-170502,170502,0,0,0,12,1.8333333333333333,90.0293762455063,6
2020-03-30-170502,170502,1,0,0,13,3.0,72.24466658868823,0
2020-03-31-170502,170502,0,0,0,13,2.6666666666666665,67.65857206684501,1
2020-04-01-170502,170502,0,0,0,13,3.6666666666666665,8.823692004481561,2
2020-04-02-170502,170502,0,0,0,13,3.0,27.143576267260176,3
2020-04-03-170502,170502,1,0,0,14,2.1666666666666665,16.10762692263798,4
2020-04-04-170502,170502,0,0,0,14,1.1666666666666667,19.959945985625552,5
2020-04-05-170502,170502,0,1,0,14,2.5,22.177356630059833,6
2020-04-06-170502,170502,0,2,0,14,2.333333333333333,27.567612243278987,0
2020-04-07-170502,170502,4,0,0,18,1.3333333333333333,31.83584537127874,1
2020-04-08-170502,170502,1,0,0,19,1.6666666666666667,37.00953517153343,2
2020-04-09-170502,170502,0,0,0,19,1.8333333333333333,42.3720110539724,3
2020-04-10-170502,170502,1,0,0,20,1.1666666666666667,8.609605191409297,4
2020-04-11-170502,170502,0,0,0,20,1.1666666666666667,13.293796681603848,5
2020-04-12-170502,170502,0,0,0,20,1.8333333333333333,15.94579376847167,6
2020-04-13-170502,170502,0,0,0,20,1.6666666666666667,17.342556628528328,0
2020-04-14-170502,170502,0,0,0,20,0.8333333333333334,22.767169642360727,1
2020-04-15-170502,170502,0,0,0,20,2.1666666666666665,26.31548338434307,2
2020-04-16-170502,170502,0,0,0,20,1.8333333333333333,30.81871300188044,3
2020-04-17-170502,170502,0,1,0,20,1.3333333333333333,31.988090956268568,4
2020-04-18-170502,170502,0,0,0,20,0.16666666666666666,33.25561862651764,5
2020-04-19-170502,170502,0,0,0,20,0.5,30.67102252854135,6
2020-04-20-170502,170502,0,0,1,20,1.1666666666666667,33.00174597209782,0
2020-04-21-170502,170502,0,0,1,20,1.0,34.73363590958408,1
2020-04-22-170502,170502,0,0,0,20,1.1666666666666667,33.05102966180506,2
2020-04-23-170502,170502,0,0,0,20,0.6666666666666666,31.112167850155664,3
2020-04-24-170502,170502,0,0,0,20,1.0,26.041698583650557,4
2020-04-25-170502,170502,0,0,0,20,0.16666666666666666,28.949533301131254,5
2020-04-26-170502,170502,0,0,0,20,0.6666666666666666,28.295153589412298,6
2020-04-27-170502,170502,0,1,2,20,0.3333333333333333,21.85493119106094,0
2020-04-28-170502,170502,0,0,2,20,1.3333333333333333,20.284203402469245,1
2020-04-29-170502,170502,0,0,0,20,0.8333333333333334,20.818588026075545,2
2020-04-30-170502,170502,0,0,0,20,1.0,25.504311184635288,3
2020-05-01-170502,170502,0,0,0,20,0.3333333333333333,54.08604896306397,4
2020-05-02-170502,170502,0,0,0,20,0.5,19.75343148765174,5
2020-05-03-170502,170502,0,0,0,20,0.5,11.5175671975646,6
2020-05-04-170502,170502,1,0,0,21,0.8333333333333334,10.888763833740125,0
2020-05-05-170502,170502,1,1,1,22,1.0,13.024982040997651,1
2020-05-06-170502,170502,0,0,0,22,1.3333333333333333,16.375955105870602,2
2020-05-07-170502,170502,0,0,0,22,2.0,19.36181694139693,3
2020-05-08-170502,170502,0,0,0,22,0.5,21.59971181812689,4
2020-05-09-170502,170502,0,0,0,22,0.16666666666666666,25.057238144883286,5
2020-05-10-170502,170502,0,1,0,22,0.3333333333333333,63.3603719913866,6
2020-05-11-170502,170502,2,0,0,24,1.8333333333333333,59.43272519626804,0
2020-05-12-170502,170502,2,1,0,26,0.5,56.450534742448795,1
2020-05-13-170502,170502,0,0,0,26,0.8333333333333334,49.95876626243275,2
2020-05-14-170502,170502,0,2,0,26,0.6666666666666666,42.02750532200896,3
2020-05-15-170502,170502,0,0,0,26,1.1666666666666667,34.37558991814604,4
2020-05-16-170502,170502,0,4,0,26,0.6666666666666666,29.12141553764956,5
2020-05-17-170502,170502,0,0,0,26,0.3333333333333333,29.499486619881765,6
2020-05-18-170502,170502,0,0,0,26,1.3333333333333333,29.973473346746616,0
2020-05-19-170502,170502,1,0,0,27,1.3333333333333333,25.58224818993212,1
2020-05-20-170502,170502,0,0,0,27,0.8333333333333334,22.05220024734639,2
2020-05-21-170502,170502,0,0,0,27,1.0,22.570014766828557,3
2020-05-22-170502,170502,0,0,0,27,1.1666666666666667,24.037457523658063,4
2020-05-23-170502,170502,0,0,0,27,0.0,30.82943347122452,5
2020-05-24-170502,170502,0,0,0,27,0.0,30.760967673178165,6
2020-05-25-170502,170502,0,0,0,27,1.0,26.82262117017911,0
2020-05-26-170502,170502,0,0,0,27,0.8333333333333334,23.96416833842921,1
2020-05-27-170502,170502,0,0,0,27,0.6666666666666666,26.502648110858466,2
2020-05-28-170502,170502,0,1,0,27,0.6666666666666666,26.222471078534085,3
2020-05-29-170502,170502,0,2,0,27,0.5,21.514657692596835,4
2020-05-30-170502,170502,0,1,0,27,0.16666666666666666,19.44825751375987,5
2020-05-31-170502,170502,0,0,0,27,0.16666666666666666,20.997089574065583,6
2020-06-01-170502,170502,0,0,0,27,0.3333333333333333,34.9598390598064,0
2020-06-02-170502,170502,0,0,0,27,0.3333333333333333,16.686543260539555,1
2020-06-03-170502,170502,0,0,0,27,0.3333333333333333,9.333662284778768,2
2020-06-04-170502,170502,0,0,0,27,0.3333333333333333,8.95958902470557,3
2020-06-05-170502,170502,0,1,0,27,0.5,8.901480113478517,4
2020-06-06-170502,170502,0,0,0,27,0.3333333333333333,9.721963931897907,5
2020-06-07-170502,170502,0,1,0,27,0.0,9.15680397621184,6
2020-06-08-170502,170502,0,0,0,27,0.5,9.090278752700058,0
2020-06-09-170502,170502,0,0,0,27,0.16666666666666666,9.662608900530111,1
2020-06-10-170502,170502,0,0,1,27,0.16666666666666666,35.73320001648096,2
2020-06-11-170502,170502,0,0,0,27,0.16666666666666666,32.17505594109039,3
2020-06-12-170502,170502,0,0,0,27,0.6666666666666666,26.688913358955517,4
2020-06-13-170502,170502,0,2,0,27,0.0,24.293285903260443,5
2020-06-14-170502,170502,0,0,0,27,0.0,17.592215019908547,6
2020-06-15-170502,170502,0,0,0,27,0.16666666666666666,13.831105941777487,0
2020-06-16-170502,170502,0,0,0,27,0.3333333333333333,13.4896253279448,1
2020-06-17-170502,170502,0,0,0,27,0.5,13.273834409454128,2
2020-06-18-170502,170502,0,0,0,27,1.0,13.160350543523329,3
2020-06-19-170502,170502,0,0,0,27,0.8333333333333334,19.938370665975032,4
2020-06-20-170502,170502,0,0,0,27,0.3333333333333333,19.219272484855374,5
2020-06-21-170502,170502,0,0,0,27,0.0,19.716529419790447,6
2020-06-22-170502,170502,0,0,1,27,0.16666666666666666,19.132581561012895,0
2020-06-23-170502,170502,0,0,0,27,0.0,18.004702177592186,1
2020-06-24-170502,170502,1,0,0,28,0.8333333333333334,17.065640728821993,2
2020-06-25-170502,170502,0,0,0,28,0.3333333333333333,10.499817343678439,3
2020-06-26-170502,170502,0,0,0,28,0.6666666666666666,9.903846688135229,4
2020-06-27-170502,170502,0,0,0,28,0.16666666666666666,10.108890651706174,5
2020-06-28-170502,170502,0,0,0,28,0.0,11.10733142798598,6
2020-06-29-170502,170502,0,0,0,28,0.16666666666666666,11.187590348262798,0
2020-06-30-170502,170502,0,0,1,28,0.3333333333333333,12.289522752740695,1
2020-07-01-170502,170502,0,1,0,28,0.0,12.193430261190569,2
2020-07-02-170502,170502,0,0,0,28,0.3333333333333333,4.911804695885184,3
2020-07-03-170502,170502,0,0,0,28,0.16666666666666666,13.360180495060256,4
2020-07-04-170502,170502,0,0,0,28,0.16666666666666666,14.601512308900208,5
2020-07-05-170502,170502,0,0,0,28,0.0,15.05319664346937,6
2020-07-06-170502,170502,1,0,0,29,0.3333333333333333,11.438286362243755,0
2020-07-07-170502,170502,0,0,0,29,0.5,11.644992036091093,1
2020-07-08-170502,170502,0,0,0,29,0.0,11.972103415301545,2
2020-07-09-170502,170502,0,0,0,29,0.3333333333333333,11.392813146149777,3
2020-07-10-170502,170502,0,0,0,29,0.5,12.484934704313263,4
2020-07-11-170502,170502,0,0,0,29,0.16666666666666666,12.059625168097291,5
2020-07-12-170502,170502,0,0,0,29,0.16666666666666666,7.802067917899366,6
2020-07-13-170502,170502,0,0,1,29,0.16666666666666666,7.4393699704538125,0
2020-07-14-170502,170502,1,0,0,30,0.8333333333333334,7.9463060951743,1
2020-07-15-170502,170502,0,0,0,30,1.0,6.706508136720111,2
2020-07-16-170502,170502,0,0,0,30,0.3333333333333333,6.960526558142388,3
2020-07-17-170502,170502,0,0,0,30,0.16666666666666666,6.843024346600535,4
2020-07-18-170502,170502,0,0,0,30,0.0,4.828539645330532,5
2020-07-19-170502,170502,0,0,0,30,0.16666666666666666,5.042004072284258,6
2020-07-20-170502,170502,0,0,0,30,0.0,7.867892024254369,0
2020-07-21-170502,170502,0,0,0,30,0.3333333333333333,7.265964800602458,1
2020-07-22-170502,170502,0,0,0,30,0.16666666666666666,8.705704008456127,2
2020-07-23-170502,170502,0,0,0,30,0.5,9.634922057077008,3
2020-07-24-170502,170502,0,0,0,30,0.16666666666666666,12.366180235678197,4
2020-07-25-170502,170502,0,0,0,30,0.0,13.658537362533204,5
2020-07-26-170502,170502,0,0,1,30,0.16666666666666666,13.484245459262908,6
2020-07-27-170502,170502,1,0,0,31,0.16666666666666666,9.9014116883133,0
2020-07-28-170502,170502,0,0,0,31,0.16666666666666666,13.636729120072449,1
2020-07-29-170502,170502,0,0,1,31,0.5,13.586451546989322,2
2020-07-30-170502,170502,0,0,3,31,0.8333333333333334,12.19213169718747,3
2020-07-31-170502,170502,0,0,1,31,0.5,14.037550382895024,4
2020-08-01-170502,170502,0,0,0,31,0.16666666666666666,10.055142523399532,5
2020-08-02-170502,170502,0,0,0,31,0.16666666666666666,58.58555532887974,6
2020-08-03-170502,170502,0,0,1,31,0.5,57.91396106887903,0
2020-08-04-170502,170502,0,0,1,31,0.8333333333333334,63.87082520348761,1
2020-08-05-170502,170502,0,0,1,31,0.8333333333333334,59.40561472275975,2
2020-08-06-170502,170502,0,0,1,31,1.3333333333333333,57.074975638731885,3
2020-08-07-170502,170502,0,0,1,31,1.0,45.479159148076896,4
2020-08-08-170502,170502,0,0,0,31,0.16666666666666666,42.31545090981628,5
2020-08-09-170502,170502,1,0,0,32,0.16666666666666666,42.23065273186177,6
2020-08-10-170502,170502,0,0,2,32,0.16666666666666666,7.850531697184056,0
2020-08-11-170502,170502,0,0,0,32,1.1666666666666667,9.794299862833793,1
2020-08-12-170502,170502,1,0,0,33,2.0,13.28325423655778,2
2020-08-13-170502,170502,3,0,0,36,2.0,18.304886483250836,3
2020-08-14-170502,170502,1,0,0,37,1.3333333333333333,20.92719278542038,4
2020-08-15-170502,170502,0,0,0,37,1.8333333333333333,29.82710499038939,5
2020-08-16-170502,170502,0,0,0,37,0.6666666666666666,32.19584895462489,6
2020-08-17-170502,170502,1,0,0,38,2.0,35.07493965767526,0
2020-08-18-170502,170502,1,0,1,39,1.8333333333333333,42.426028032238435,1
2020-08-19-170502,170502,1,0,0,40,1.3333333333333333,48.33165815029963,2
2020-08-20-170502,170502,1,0,4,41,2.0,50.395703005175484,3
2020-08-21-170502,170502,1,0,0,42,2.6666666666666665,49.26103859633472,4
2020-08-22-170502,170502,0,0,0,42,0.3333333333333333,60.380147771119226,5
2020-08-23-170502,170502,0,0,3,42,1.8333333333333333,62.95462442483422,6
2020-08-24-170502,170502,2,0,2,44,2.5,59.33671422064049,0
2020-08-25-170502,170502,0,0,2,44,1.8333333333333333,57.521394542651606,1
2020-08-26-170502,170502,0,0,3,44,1.6666666666666667,49.30973995447667,2
2020-08-27-170502,170502,0,0,0,44,1.8333333333333333,55.18099165498964,3
2020-08-28-170502,170502,0,0,1,44,2.5,53.036086233304374,4
2020-08-29-170502,170502,0,0,1,44,1.1666666666666667,52.35359088146267,5
2020-08-30-170502,170502,0,0,0,44,2.0,48.83050677533158,6
2020-08-31-170502,170502,0,0,1,44,0.6666666666666666,51.78945251856827,0
2020-09-01-170502,170502,1,0,7,45,1.3333333333333333,32.38590147455936,1
2020-09-02-170502,170502,0,0,1,45,0.8333333333333334,112.12069372976954,2
2020-09-03-170502,170502,4,0,1,49,3.0,71.11127654612534,3
2020-09-04-170502,170502,0,0,7,49,2.833333333333333,87.35854549270425,4
2020-09-05-170502,170502,0,0,0,49,0.3333333333333333,93.8621355362935,5
2020-09-06-170502,170502,3,0,1,52,3.1666666666666665,90.87990322700178,6
2020-09-07-170502,170502,2,0,1,54,1.6666666666666667,98.11981082211673,0
2020-09-08-170502,170502,2,0,0,56,3.1666666666666665,98.71628426067304,1
2020-09-09-170502,170502,3,0,3,59,2.0,120.24190404030935,2
2020-09-10-170502,170502,0,0,0,59,3.333333333333333,34.93768286167492,3
2020-09-11-170502,170502,1,0,1,60,2.6666666666666665,48.6944631257205,4
2020-09-12-170502,170502,1,0,1,61,3.1666666666666665,59.43235700723887,5
2020-09-13-170502,170502,0,0,1,61,1.3333333333333333,62.211506296149395,6
2020-09-14-170502,170502,1,0,2,62,3.8333333333333335,68.58972713191243,0
2020-09-15-170502,170502,7,0,0,69,3.1666666666666665,81.42757031924373,1
2020-09-16-170502,170502,1,0,0,70,3.5,105.523134481383,2
2020-09-17-170502,170502,1,0,0,71,4.833333333333333,106.68599468016811,3
2020-09-18-170502,170502,7,0,0,78,4.333333333333333,100.97626450307939,4
2020-09-19-170502,170502,0,0,2,78,1.3333333333333333,111.92989496835446,5
2020-09-20-170502,170502,1,0,0,79,2.6666666666666665,101.94176295251489,6
2020-09-21-170502,170502,1,0,0,80,3.0,100.30054118454518,0
2020-09-22-170502,170502,0,0,0,80,2.333333333333333,90.10405304468881,1
2020-09-23-170502,170502,3,0,0,83,3.333333333333333,84.14412452683383,2
2020-09-24-170502,170502,0,1,0,83,2.833333333333333,82.32698155284713,3
2020-09-25-170502,170502,1,0,0,84,3.8333333333333335,68.06608465029578,4
2020-09-26-170502,170502,1,0,0,85,2.0,69.27950320276793,5
2020-09-27-170502,170502,1,0,0,86,1.5,75.62675017512618,6
2020-09-28-170502,170502,2,0,0,88,2.1666666666666665,71.42806826280415,0
2020-09-29-170502,170502,0,0,1,88,3.6666666666666665,68.28972723441791,1
2020-09-30-170502,170502,0,0,0,88,3.1666666666666665,76.1132448659798,2
2020-10-01-170502,170502,0,0,2,88,3.333333333333333,0.0,3
2020-10-02-170502,170502,0,0,1,88,3.333333333333333,113.32565819085193,4
2020-10-03-170502,170502,2,0,0,90,1.3333333333333333,188.57344391247722,5
2020-10-04-170502,170502,0,1,0,90,1.1666666666666667,195.11095502308632,6
2020-10-05-170502,170502,0,0,1,90,1.5,176.31261736105662,0
2020-10-06-170502,170502,0,0,1,90,3.5,162.38006753993452,1
2020-10-07-170502,170502,0,0,1,90,2.0,144.29352457529194,2
2020-10-08-170502,170502,0,0,0,90,4.0,125.77530129593285,3
2020-10-09-170502,170502,0,1,2,90,3.5,131.65964822107406,4
2020-10-10-170502,170502,0,0,0,90,2.1666666666666665,9.332417172973642,5
2020-10-11-170502,170502,0,0,0,90,0.5,25.133823702124317,6
2020-10-12-170502,170502,0,0,5,90,0.8333333333333334,30.751433653196308,0
2020-10-13-170502,170502,1,0,2,91,0.5,34.81661989952886,1
2020-10-14-170502,170502,0,0,9,91,4.666666666666667,45.22140891618882,2
2020-10-15-170502,170502,2,0,5,93,2.5,63.78385850836842,3
2020-10-16-170502,170502,1,0,0,94,3.6666666666666665,79.09589977690322,4
2020-10-17-170502,170502,0,0,2,94,1.3333333333333333,89.62684158089816,5
2020-10-18-170502,170502,0,0,2,94,1.1666666666666667,84.88034731339643,6
2020-10-19-170502,170502,1,0,0,95,3.1666666666666665,85.77299483595417,0
2020-10-20-170502,170502,1,0,1,96,4.333333333333333,105.570164503178,1
2020-10-21-170502,170502,1,0,9,97,2.6666666666666665,106.93678035440999,2
2020-10-22-170502,170502,0,0,5,97,3.5,101.39385603166816,3
2020-10-23-170502,170502,2,0,20,99,7.333333333333332,100.78703502377962,4
2020-10-24-170502,170502,0,0,4,99,5.5,115.17246168325377,5
2020-10-25-170502,170502,0,0,0,99,1.8333333333333333,127.7631037747783,6
2020-10-26-170502,170502,5,0,3,104,3.5,118.91526089471523,0
2020-10-27-170502,170502,2,0,6,106,4.333333333333333,132.02165490624546,1
2020-10-28-170502,170502,9,0,0,115,6.5,138.59158107765518,2
2020-10-29-170502,170502,5,0,5,120,4.833333333333333,163.16758762978517,3
2020-10-30-170502,170502,0,0,1,120,8.5,165.6943192314985,4
2020-10-31-170502,170502,2,0,0,122,4.0,169.7092258315173,5
2020-11-01-170502,170502,2,0,0,124,3.0,118.40575353752806,6
2020-11-02-170502,170502,0,1,0,124,0.8333333333333334,192.44597270929074,0
2020-11-03-170502,170502,1,0,0,125,6.166666666666668,171.06211839390403,1
2020-11-04-170502,170502,9,0,0,134,5.666666666666668,180.03583731757502,2
2020-11-05-170502,170502,5,1,0,139,8.5,202.96702706524655,3
2020-11-06-170502,170502,20,0,0,159,7.333333333333332,240.09691530264905,4
2020-11-07-170502,170502,4,0,0,163,11.5,227.36238113411906,5
2020-11-08-170502,170502,0,0,0,163,2.1666666666666665,224.2605290983131,6
2020-11-09-170502,170502,3,0,0,166,3.1666666666666665,212.61641473810926,0
2020-11-10-170502,170502,6,0,0,172,3.8333333333333335,104.3859063694788,1
2020-11-11-170502,170502,0,0,0,172,3.5,113.33254114578084,2
2020-11-12-170502,170502,5,1,0,177,2.6666666666666665,109.34727253857844,3
2020-11-13-170502,170502,1,1,0,178,7.333333333333332,118.78144520805168,4
2020-03-01-170503,170503,0,0,0,0,0.0,0.0,6
2020-03-02-170503,170503,0,0,0,0,0.0,10.032451856692651,0
2020-03-03-170503,170503,0,1,0,0,0.0,72.61959676277836,1
2020-03-04-170503,170503,0,0,0,0,0.0,93.59749127151714,2
2020-03-05-170503,170503,0,0,1,0,0.0,104.14346897042168,3
2020-03-06-170503,170503,0,1,0,0,0.0,85.23477818064178,4
2020-03-07-170503,170503,0,0,1,0,0.0,85.56943018610463,5
2020-03-08-170503,170503,0,0,1,0,0.16666666666666666,77.96591575617464,6
2020-03-09-170503,170503,0,0,1,0,0.16666666666666666,80.9942359736979,0
2020-03-10-170503,170503,0,0,1,0,0.0,255.70026668963985,1
2020-03-11-170503,170503,0,0,0,0,0.0,218.0627275377327,2
2020-03-12-170503,170503,0,0,1,0,0.5,155.81903615262513,3
2020-03-13-170503,170503,0,0,5,0,0.3333333333333333,135.92006183282098,4
2020-03-14-170503,170503,0,0,2,0,0.5,79.13965330754158,5
2020-03-15-170503,170503,0,0,0,0,0.5,48.81056684364307,6
2020-03-16-170503,170503,0,0,5,0,1.0,22.043191059720996,0
2020-03-17-170503,170503,0,0,1,0,0.5,38.342369167908885,1
2020-03-18-170503,170503,0,0,5,0,0.8333333333333334,44.122900510715645,2
2020-03-19-170503,170503,1,0,1,1,1.1666666666666667,54.96136222925755,3
2020-03-20-170503,170503,0,0,2,1,2.833333333333333,59.86351878053669,4
2020-03-21-170503,170503,1,0,2,2,1.6666666666666667,75.16500838751664,5
2020-03-22-170503,170503,1,1,0,3,1.0,83.3137424429695,6
2020-03-23-170503,170503,1,0,2,4,2.6666666666666665,80.44808275268544,0
2020-03-24-170503,170503,1,0,0,5,1.6666666666666667,103.10769534780523,1
2020-03-25-170503,170503,0,0,3,5,1.5,112.38695072246189,2
2020-03-26-170503,170503,1,1,12,6,2.1666666666666665,111.30519494788082,3
2020-03-27-170503,170503,5,1,1,11,3.8333333333333335,133.07946271711342,4
2020-03-28-170503,170503,2,0,1,13,1.0,149.48261820201847,5
2020-03-29-170503,170503,0,0,3,13,1.1666666666666667,145.30950913555228,6
2020-03-30-170503,170503,5,0,5,18,2.5,119.46971045414762,0
2020-03-31-170503,170503,1,0,2,19,1.3333333333333333,131.30947414438663,1
2020-04-01-170503,170503,5,0,1,24,1.6666666666666667,17.348413491747372,2
2020-04-02-170503,170503,1,0,3,25,1.5,91.75846667995808,3
2020-04-03-170503,170503,2,0,16,27,0.8333333333333334,51.390143144424314,4
2020-04-04-170503,170503,2,0,0,29,0.8333333333333334,52.705269267250266,5
2020-04-05-170503,170503,0,0,2,29,0.8333333333333334,53.26964285088707,6
2020-04-06-170503,170503,2,0,14,31,1.6666666666666667,57.05601818855079,0
2020-04-07-170503,170503,0,0,0,31,1.0,65.04840052289177,1
2020-04-08-170503,170503,3,0,2,34,2.1666666666666665,70.7188055302891,2
2020-04-09-170503,170503,12,0,4,46,1.5,80.85715764312044,3
2020-04-10-170503,170503,1,0,1,47,5.5,23.272075207696595,4
2020-04-11-170503,170503,1,0,1,48,0.5,57.83877115591579,5
2020-04-12-170503,170503,3,0,1,51,0.16666666666666666,63.21875735347156,6
2020-04-13-170503,170503,5,0,0,56,1.1666666666666667,67.4918596307954,0
2020-04-14-170503,170503,2,0,0,58,0.8333333333333334,85.32923837734629,1
2020-04-15-170503,170503,1,0,3,59,1.3333333333333333,96.46333453759884,2
2020-04-16-170503,170503,3,0,1,62,0.3333333333333333,108.37520056255804,3
2020-04-17-170503,170503,16,0,0,78,0.5,104.49099751381276,4
2020-04-18-170503,170503,0,0,3,78,0.0,101.99212451528959,5
2020-04-19-170503,170503,2,0,0,80,0.3333333333333333,96.3504273332783,6
2020-04-20-170503,170503,14,0,2,94,0.6666666666666666,88.78399782073964,0
2020-04-21-170503,170503,0,0,0,94,0.6666666666666666,106.256055727065,1
2020-04-22-170503,170503,2,0,0,96,0.5,99.27620578342017,2
2020-04-23-170503,170503,4,0,2,100,0.0,98.5321048448395,3
2020-04-24-170503,170503,1,0,3,101,0.8333333333333334,69.05391871944954,4
2020-04-25-170503,170503,1,0,0,102,1.0,77.35577231444734,5
2020-04-26-170503,170503,1,0,0,103,0.3333333333333333,83.68147366969359,6
2020-04-27-170503,170503,0,0,0,103,0.8333333333333334,76.71498360272992,0
2020-04-28-170503,170503,0,0,1,103,0.6666666666666666,53.03531083358072,1
2020-04-29-170503,170503,3,0,1,106,0.3333333333333333,52.70129119402623,2
2020-04-30-170503,170503,1,0,0,107,0.6666666666666666,57.978595644689605,3
2020-05-01-170503,170503,0,0,2,107,0.6666666666666666,112.6607914616682,4
2020-05-02-170503,170503,3,0,0,110,0.16666666666666666,29.795193770205856,5
2020-05-03-170503,170503,0,0,0,110,0.0,29.249902013248068,6
2020-05-04-170503,170503,2,0,0,112,1.1666666666666667,32.968011626763314,0
2020-05-05-170503,170503,0,0,2,112,0.16666666666666666,41.85033712872902,1
2020-05-06-170503,170503,0,0,3,112,0.5,37.388601870619674,2
2020-05-07-170503,170503,2,0,2,114,0.3333333333333333,41.71136884192851,3
2020-05-08-170503,170503,3,0,0,117,1.0,39.83819447743667,4
2020-05-09-170503,170503,0,0,0,117,0.0,55.93910655952945,5
2020-05-10-170503,170503,0,0,0,117,0.3333333333333333,132.9706060331847,6
2020-05-11-170503,170503,0,2,0,117,0.5,121.23611223666015,0
2020-05-12-170503,170503,1,0,0,118,0.6666666666666666,111.67061715069853,1
2020-05-13-170503,170503,1,1,1,119,0.3333333333333333,100.83419937477672,2
2020-05-14-170503,170503,0,1,0,119,0.3333333333333333,94.92018571071422,3
2020-05-15-170503,170503,2,0,0,121,0.5,69.6031702594161,4
2020-05-16-170503,170503,0,0,0,121,0.0,44.97809855131642,5
2020-05-17-170503,170503,0,0,0,121,0.16666666666666666,40.240537770097134,6
2020-05-18-170503,170503,0,0,3,121,0.5,39.88359209804852,0
2020-05-19-170503,170503,2,0,0,123,0.16666666666666666,37.121562193701216,1
2020-05-20-170503,170503,3,0,1,126,0.3333333333333333,37.69732133914445,2
2020-05-21-170503,170503,2,0,1,128,0.8333333333333334,44.40605469096122,3
2020-05-22-170503,170503,0,0,5,128,1.0,46.68868546062375,4
2020-05-23-170503,170503,0,0,0,128,0.16666666666666666,58.5280435145663,5
2020-05-24-170503,170503,0,0,0,128,0.0,58.93840209640909,6
2020-05-25-170503,170503,0,0,2,128,0.16666666666666666,54.88219550892508,0
2020-05-26-170503,170503,0,0,0,128,0.6666666666666666,49.44285405540191,1
2020-05-27-170503,170503,1,0,2,129,0.3333333333333333,49.84461337357253,2
2020-05-28-170503,170503,0,0,3,129,0.5,47.31706958345082,3
2020-05-29-170503,170503,0,3,1,129,1.1666666666666667,39.86414998076637,4
2020-05-30-170503,170503,0,0,0,129,0.0,39.55324439957803,5
2020-05-31-170503,170503,0,0,0,129,0.5,42.34341617526583,6
2020-06-01-170503,170503,3,0,2,132,0.5,70.44895294345528,0
2020-06-02-170503,170503,0,0,0,132,0.8333333333333334,32.155371282126936,1
2020-06-03-170503,170503,1,0,1,133,0.3333333333333333,30.626528649159027,2
2020-06-04-170503,170503,1,0,2,134,0.6666666666666666,34.98070786189787,3
2020-06-05-170503,170503,5,0,1,139,0.6666666666666666,38.41025870808238,4
2020-06-06-170503,170503,0,0,1,139,0.3333333333333333,47.06885681344975,5
2020-06-07-170503,170503,0,0,0,139,0.0,45.099612155814945,6
2020-06-08-170503,170503,2,0,0,141,0.16666666666666666,44.565631884186296,0
2020-06-09-170503,170503,0,0,0,141,0.5,48.55890858033011,1
2020-06-10-170503,170503,2,0,1,143,2.5,72.6299943777575,2
2020-06-11-170503,170503,3,0,0,146,1.0,83.64052087200497,3
2020-06-12-170503,170503,1,0,1,147,0.3333333333333333,96.83999047486657,4
2020-06-13-170503,170503,0,0,1,147,0.3333333333333333,92.97404953747409,5
2020-06-14-170503,170503,0,0,0,147,0.0,84.46071897717347,6
2020-06-15-170503,170503,2,0,1,149,0.3333333333333333,70.33194199308119,0
2020-06-16-170503,170503,0,0,0,149,0.0,80.47512994957432,1
2020-06-17-170503,170503,1,0,1,150,0.0,69.43716976068714,2
2020-06-18-170503,170503,2,0,1,152,0.16666666666666666,45.20046698677625,3
2020-06-19-170503,170503,1,0,1,153,0.0,36.153998996428555,4
2020-06-20-170503,170503,1,0,0,154,0.16666666666666666,39.09985208274322,5
2020-06-21-170503,170503,0,0,1,154,0.16666666666666666,44.64560807042717,6
2020-06-22-170503,170503,0,0,1,154,0.0,37.20394341566989,0
2020-06-23-170503,170503,0,0,0,154,0.3333333333333333,36.16890909334626,1
2020-06-24-170503,170503,1,1,1,155,0.16666666666666666,37.44229802972234,2
2020-06-25-170503,170503,0,0,0,155,0.5,35.372582051884976,3
2020-06-26-170503,170503,1,0,1,156,0.5,36.809777463492196,4
2020-06-27-170503,170503,1,0,1,157,0.16666666666666666,35.344133187496645,5
2020-06-28-170503,170503,0,0,0,157,0.0,35.64024960093775,6
2020-06-29-170503,170503,1,0,0,158,0.16666666666666666,32.33436420646802,0
2020-06-30-170503,170503,0,0,2,158,0.16666666666666666,41.433839713358275,1
2020-07-01-170503,170503,1,0,4,159,0.16666666666666666,59.06671289808729,2
2020-07-02-170503,170503,1,0,4,160,0.3333333333333333,41.51426495234594,3
2020-07-03-170503,170503,1,0,0,161,0.16666666666666666,36.7990231709327,4
2020-07-04-170503,170503,0,0,0,161,0.0,34.33329701635756,5
2020-07-05-170503,170503,1,0,0,162,0.16666666666666666,35.085062690324506,6
2020-07-06-170503,170503,1,0,0,163,0.8333333333333334,29.410747965521534,0
2020-07-07-170503,170503,0,0,0,163,0.16666666666666666,36.738991992400564,1
2020-07-08-170503,170503,1,1,0,164,0.0,34.1247055165649,2
2020-07-09-170503,170503,0,0,0,164,0.0,29.582679279566108,3
2020-07-10-170503,170503,1,0,2,165,0.16666666666666666,62.17463331121212,4
2020-07-11-170503,170503,1,0,1,166,0.16666666666666666,58.532811310989864,5
2020-07-12-170503,170503,0,0,0,166,0.0,39.15704767085113,6
2020-07-13-170503,170503,0,0,2,166,0.0,35.87648761379607,0
2020-07-14-170503,170503,2,0,2,168,0.0,37.33884461059989,1
2020-07-15-170503,170503,4,0,0,172,0.5,37.35880170322058,2
2020-07-16-170503,170503,4,0,0,176,0.3333333333333333,39.291120703311314,3
2020-07-17-170503,170503,0,0,4,176,0.0,49.384153127497115,4
2020-07-18-170503,170503,0,0,1,176,0.0,43.73932693632811,5
2020-07-19-170503,170503,0,0,0,176,0.3333333333333333,41.83610189102109,6
2020-07-20-170503,170503,0,0,0,176,0.16666666666666666,53.345940919422944,0
2020-07-21-170503,170503,0,0,0,176,0.0,43.91814369488809,1
2020-07-22-170503,170503,0,0,1,176,0.16666666666666666,34.1058510162827,2
2020-07-23-170503,170503,0,0,0,176,0.3333333333333333,22.11022854346767,3
2020-07-24-170503,170503,2,0,0,178,0.16666666666666666,27.77019219698105,4
2020-07-25-170503,170503,1,0,0,179,0.0,37.51493692648464,5
2020-07-26-170503,170503,0,0,0,179,0.0,34.79504427423615,6
2020-07-27-170503,170503,2,0,0,181,0.3333333333333333,26.429434616293708,0
2020-07-28-170503,170503,2,0,0,183,0.16666666666666666,32.54854602576651,1
2020-07-29-170503,170503,0,0,5,183,0.0,38.660693585186316,2
2020-07-30-170503,170503,0,0,0,183,0.16666666666666666,41.51648767801861,3
2020-07-31-170503,170503,4,0,0,187,0.0,34.573420829103526,4
2020-08-01-170503,170503,1,0,0,188,0.0,29.439096324062838,5
2020-08-02-170503,170503,0,0,0,188,0.16666666666666666,97.51993598006352,6
2020-08-03-170503,170503,0,0,0,188,0.0,197.82357351066895,0
2020-08-04-170503,170503,0,0,4,188,0.0,150.19416813333734,1
2020-08-05-170503,170503,1,0,1,189,0.3333333333333333,126.41645437867321,2
2020-08-06-170503,170503,0,0,1,189,0.6666666666666666,71.48417607544009,3
2020-08-07-170503,170503,0,0,0,189,0.16666666666666666,70.36429192460952,4
2020-08-08-170503,170503,0,0,1,189,0.0,65.78722015418747,5
2020-08-09-170503,170503,0,0,3,189,0.16666666666666666,67.41157427013702,6
2020-08-10-170503,170503,0,0,1,189,0.6666666666666666,29.98816586445311,0
2020-08-11-170503,170503,0,0,7,189,1.0,39.25069116935589,1
2020-08-12-170503,170503,5,0,3,194,0.6666666666666666,49.04285224712076,2
2020-08-13-170503,170503,0,0,16,194,1.1666666666666667,56.72478350287496,3
2020-08-14-170503,170503,0,0,5,194,0.3333333333333333,68.31809196417713,4
2020-08-15-170503,170503,0,0,1,194,0.16666666666666666,73.78042621004346,5
2020-08-16-170503,170503,0,0,2,194,1.3333333333333333,79.15377419121305,6
2020-08-17-170503,170503,0,0,3,194,1.0,93.99634503354244,0
2020-08-18-170503,170503,4,0,1,198,0.3333333333333333,99.78557310177436,1
2020-08-19-170503,170503,1,0,0,199,0.3333333333333333,105.66647130295173,2
2020-08-20-170503,170503,1,0,0,200,1.0,91.71499850621073,3
2020-08-21-170503,170503,0,0,3,200,3.5,99.88756216749445,4
2020-08-22-170503,170503,1,0,0,201,1.3333333333333333,145.70839488574723,5
2020-08-23-170503,170503,3,0,0,204,0.8333333333333334,144.58626597481094,6
2020-08-24-170503,170503,1,0,1,205,1.5,143.7669335761757,0
2020-08-25-170503,170503,7,0,5,212,0.5,152.54651876364838,1
2020-08-26-170503,170503,3,0,3,215,1.0,162.19946767508083,2
2020-08-27-170503,170503,16,0,4,231,1.8333333333333333,188.2434861596936,3
2020-08-28-170503,170503,5,0,4,236,0.0,235.25842700638452,4
2020-08-29-170503,170503,1,0,0,237,0.0,198.5160371953185,5
2020-08-30-170503,170503,2,0,0,239,0.5,174.83475449375123,6
2020-08-31-170503,170503,3,0,1,242,0.16666666666666666,158.7061204652719,0
2020-09-01-170503,170503,1,0,0,243,0.8333333333333334,55.257389411054376,1
2020-09-02-170503,170503,0,0,2,243,0.16666666666666666,176.1115405553067,2
2020-09-03-170503,170503,0,0,3,243,1.0,148.88162596327348,3
2020-09-04-170503,170503,3,0,1,246,1.3333333333333333,138.69164526313938,4
2020-09-05-170503,170503,0,0,0,246,0.6666666666666666,150.37347412584216,5
2020-09-06-170503,170503,0,0,2,246,1.1666666666666667,129.9508612722856,6
2020-09-07-170503,170503,1,0,0,247,0.3333333333333333,131.26394831161628,0
2020-09-08-170503,170503,5,0,2,252,1.3333333333333333,128.59307098531602,1
2020-09-09-170503,170503,3,0,1,255,2.333333333333333,134.27760307586584,2
2020-09-10-170503,170503,4,0,2,259,1.3333333333333333,55.06500058607794,3
2020-09-11-170503,170503,4,0,2,263,1.5,78.1827847699899,4
2020-09-12-170503,170503,0,0,4,263,1.1666666666666667,101.44077012346705,5
2020-09-13-170503,170503,0,0,1,263,2.833333333333333,106.49030317621462,6
2020-09-14-170503,170503,1,0,0,264,1.6666666666666667,123.08204796771669,0
2020-09-15-170503,170503,0,0,0,264,3.0,149.97013312131207,1
2020-09-16-170503,170503,2,0,3,266,1.3333333333333333,173.00095379444627,2
2020-09-17-170503,170503,3,0,4,269,0.5,183.6318994734329,3
2020-09-18-170503,170503,1,0,5,270,1.6666666666666667,177.6650518545364,4
2020-09-19-170503,170503,0,0,0,270,0.6666666666666666,167.1050272183473,5
2020-09-20-170503,170503,2,2,6,272,1.0,143.59555745991267,6
2020-09-21-170503,170503,0,0,2,272,0.6666666666666666,136.84393911312566,0
2020-09-22-170503,170503,2,0,7,274,0.16666666666666666,123.49482730730992,1
2020-09-23-170503,170503,1,0,6,275,1.6666666666666667,103.52377104806789,2
2020-09-24-170503,170503,2,0,2,277,1.1666666666666667,105.11018230154363,3
2020-09-25-170503,170503,2,0,0,279,0.3333333333333333,97.62922911390888,4
2020-09-26-170503,170503,4,0,8,283,1.3333333333333333,103.63460029488448,5
2020-09-27-170503,170503,1,0,0,284,0.6666666666666666,127.05090496609225,6
2020-09-28-170503,170503,0,0,2,284,0.6666666666666666,117.21670632215024,0
2020-09-29-170503,170503,0,0,4,284,1.1666666666666667,121.67558764497278,1
2020-09-30-170503,170503,3,0,1,287,0.6666666666666666,125.86199002156329,2
2020-10-01-170503,170503,4,0,3,291,1.5,0.0,3
2020-10-02-170503,170503,5,0,4,296,3.333333333333333,215.81586327954176,4
2020-10-03-170503,170503,0,0,0,296,1.3333333333333333,276.8488980476463,5
2020-10-04-170503,170503,6,0,0,302,0.6666666666666666,255.86363441474785,6
2020-10-05-170503,170503,2,0,0,304,1.6666666666666667,243.75768574205767,0
2020-10-06-170503,170503,7,1,4,311,0.6666666666666666,235.50925516114148,1
2020-10-07-170503,170503,6,0,1,317,0.3333333333333333,205.43861871174636,2
2020-10-08-170503,170503,2,0,0,319,1.1666666666666667,187.09519110927533,3
2020-10-09-170503,170503,0,0,2,319,0.5,203.0267709063415,4
2020-10-10-170503,170503,8,0,0,327,1.8333333333333333,31.002162786951285,5
2020-10-11-170503,170503,0,0,3,327,0.5,72.87979330369564,6
2020-10-12-170503,170503,2,0,2,329,0.3333333333333333,85.05184460508175,0
2020-10-13-170503,170503,4,0,3,333,0.5,97.1535271594926,1
2020-10-14-170503,170503,1,0,4,334,1.0,117.6474776269164,2
2020-10-15-170503,170503,3,0,3,337,1.0,165.97663803652586,3
2020-10-16-170503,170503,4,0,1,341,0.8333333333333334,194.79681758911056,4
2020-10-17-170503,170503,0,0,1,341,0.8333333333333334,209.34639205363163,5
2020-10-18-170503,170503,0,0,1,341,0.6666666666666666,188.06631105762733,6
2020-10-19-170503,170503,0,0,2,341,2.0,191.37743506357538,0
2020-10-20-170503,170503,4,0,7,345,1.3333333333333333,225.64606387109288,1
2020-10-21-170503,170503,1,0,1,346,1.0,219.19929903067737,2
2020-10-22-170503,170503,0,0,3,346,2.6666666666666665,213.46531306348658,3
2020-10-23-170503,170503,2,1,1,348,2.6666666666666665,206.2009914325551,4
2020-10-24-170503,170503,0,0,1,348,1.1666666666666667,211.8255421619652,5
2020-10-25-170503,170503,3,1,0,351,1.8333333333333333,215.74222086035115,6
2020-10-26-170503,170503,2,0,2,353,1.6666666666666667,222.58200858599525,0
2020-10-27-170503,170503,3,0,2,356,2.0,214.23705298775747,1
2020-10-28-170503,170503,4,0,1,360,2.1666666666666665,206.04003006971436,2
2020-10-29-170503,170503,3,0,2,363,2.1666666666666665,234.23901284583766,3
2020-10-30-170503,170503,1,0,4,364,1.5,227.20483425669545,4
2020-10-31-170503,170503,1,0,0,365,1.1666666666666667,240.853453126357,5
2020-11-01-170503,170503,1,0,0,366,0.8333333333333334,169.85785709572582,6
2020-11-02-170503,170503,2,1,0,368,1.6666666666666667,290.3915123845285,0
2020-11-03-170503,170503,7,0,0,375,1.3333333333333333,286.0111711990531,1
2020-11-04-170503,170503,1,0,0,376,3.0,303.17450832866166,2
2020-11-05-170503,170503,3,0,0,379,3.1666666666666665,290.25001954838575,3
2020-11-06-170503,170503,1,0,0,380,1.0,295.12301655356373,4
2020-11-07-170503,170503,1,0,0,381,0.6666666666666666,263.5737911210465,5
2020-11-08-170503,170503,0,1,0,381,3.0,270.379734059249,6
2020-11-09-170503,170503,2,0,0,383,0.8333333333333334,263.2119016791237,0
2020-11-10-170503,170503,2,0,0,385,3.333333333333333,152.96985817294134,1
2020-11-11-170503,170503,1,1,0,386,0.8333333333333334,166.89747342271076,2
2020-11-12-170503,170503,2,0,0,388,3.1666666666666665,156.9651106092407,3
2020-11-13-170503,170503,4,0,0,392,1.3333333333333333,176.65642879537307,4
2020-03-01-170504,170504,0,0,0,0,0.0,0.0,6
2020-03-02-170504,170504,0,0,0,0,0.0,7.171777440973635,0
2020-03-03-170504,170504,0,0,2,0,0.0,32.283651965982486,1
2020-03-04-170504,170504,0,0,1,0,0.0,35.31311788951034,2
2020-03-05-170504,170504,0,0,2,0,0.0,34.26394441778116,3
2020-03-06-170504,170504,0,0,3,0,0.0,27.145929788814108,4
2020-03-07-170504,170504,0,0,2,0,0.0,29.31722773319511,5
2020-03-08-170504,170504,0,0,1,0,0.0,24.253423217369605,6
2020-03-09-170504,170504,0,0,4,0,0.2,24.86371774014885,0
2020-03-10-170504,170504,0,0,0,0,0.0,284.3804656864072,1
2020-03-11-170504,170504,0,0,0,0,0.0,230.86876114691677,2
2020-03-12-170504,170504,0,0,1,0,0.6,175.9525639820519,3
2020-03-13-170504,170504,0,0,1,0,0.2,151.13198747376904,4
2020-03-14-170504,170504,0,0,0,0,0.8,95.70461379265316,5
2020-03-15-170504,170504,0,0,1,0,0.4,58.31837760723022,6
2020-03-16-170504,170504,0,0,0,0,0.2,14.61636109941714,0
2020-03-17-170504,170504,2,0,0,2,0.8,17.79521513576986,1
2020-03-18-170504,170504,1,0,0,3,0.8,27.01304959343884,2
2020-03-19-170504,170504,2,0,0,5,1.4,33.334565678077084,3
2020-03-20-170504,170504,3,0,2,8,1.6,38.13983337224927,4
2020-03-21-170504,170504,2,0,0,10,2.0,49.41870904426234,5
2020-03-22-170504,170504,1,0,2,11,0.2,54.261772012235966,6
2020-03-23-170504,170504,4,0,1,15,3.0,52.15531113259218,0
2020-03-24-170504,170504,0,0,1,15,1.8,65.46379478775111,1
2020-03-25-170504,170504,0,0,2,15,1.0,63.941767025488105,2
2020-03-26-170504,170504,1,0,0,16,2.2,57.585751846540454,3
2020-03-27-170504,170504,1,0,0,17,2.4,69.77884459272265,4
2020-03-28-170504,170504,0,0,0,17,0.6,65.79732317939273,5
2020-03-29-170504,170504,1,0,0,18,0.6,55.845382206023984,6
2020-03-30-170504,170504,0,0,1,18,1.6,40.839811492519615,0
2020-03-31-170504,170504,0,0,1,18,1.0,43.07132013572968,1
2020-04-01-170504,170504,0,0,0,18,1.8,4.2800620334852715,2
2020-04-02-170504,170504,0,0,0,18,1.0,34.519257287064335,3
2020-04-03-170504,170504,2,0,0,20,1.2,20.413560329078486,4
2020-04-04-170504,170504,0,0,0,20,0.6,28.62955461612767,5
2020-04-05-170504,170504,2,0,0,22,1.0,27.4602481020625,6
2020-04-06-170504,170504,1,0,0,23,1.4,32.89296617175006,0
2020-04-07-170504,170504,1,0,0,24,1.6,38.18341786215066,1
2020-04-08-170504,170504,2,0,0,26,0.6,39.985689315071006,2
2020-04-09-170504,170504,0,0,0,26,0.4,43.84103808915258,3
2020-04-10-170504,170504,0,0,1,26,5.2,7.150103872609696,4
2020-04-11-170504,170504,0,0,1,26,0.6,15.073100392510256,5
2020-04-12-170504,170504,0,0,0,26,0.4,16.86796171361296,6
2020-04-13-170504,170504,1,0,0,27,1.0,18.6471492027885,0
2020-04-14-170504,170504,1,0,1,28,1.4,24.739352989265132,1
2020-04-15-170504,170504,0,0,1,28,0.8,32.7759883589414,2
2020-04-16-170504,170504,0,0,0,28,1.2,34.61483388845396,3
2020-04-17-170504,170504,0,1,0,28,0.6,33.53835006677305,4
2020-04-18-170504,170504,0,0,0,28,0.4,30.201096181482022,5
2020-04-19-170504,170504,0,0,1,28,0.4,34.308672302984455,6
2020-04-20-170504,170504,0,0,3,28,0.8,34.94965062868418,0
2020-04-21-170504,170504,0,0,0,28,1.0,44.095284495901026,1
2020-04-22-170504,170504,0,0,0,28,0.2,45.123437419435376,2
2020-04-23-170504,170504,0,0,0,28,0.2,43.63685365043674,3
2020-04-24-170504,170504,1,0,1,29,1.0,37.690163167588125,4
2020-04-25-170504,170504,1,0,0,30,0.8,36.089137546338605,5
2020-04-26-170504,170504,0,0,1,30,0.4,35.99939937774896,6
2020-04-27-170504,170504,0,0,2,30,0.0,31.497045508380083,0
2020-04-28-170504,170504,1,0,1,31,1.8,16.30657646936874,1
2020-04-29-170504,170504,1,0,0,32,0.8,17.95211281881246,2
2020-04-30-170504,170504,0,0,1,32,1.0,30.20330571539983,3
2020-05-01-170504,170504,0,0,0,32,0.8,37.12440153392215,4
2020-05-02-170504,170504,0,0,0,32,0.2,20.761644120888125,5
2020-05-03-170504,170504,1,0,1,33,0.0,15.416546491688692,6
2020-05-04-170504,170504,3,0,0,36,2.0,18.04624040157947,0
2020-05-05-170504,170504,0,0,0,36,0.4,26.242193249024663,1
2020-05-06-170504,170504,0,0,0,36,1.0,27.271139602913355,2
2020-05-07-170504,170504,0,0,1,36,0.8,29.16004454056968,3
2020-05-08-170504,170504,1,0,0,37,1.2,28.208060324257197,4
2020-05-09-170504,170504,0,0,0,37,0.2,37.42764685415638,5
2020-05-10-170504,170504,1,0,0,38,0.2,42.88160285740098,6
2020-05-11-170504,170504,2,1,0,40,1.0,42.10826391679111,0
2020-05-12-170504,170504,1,0,0,41,1.0,43.63955814849608,1
2020-05-13-170504,170504,0,0,1,41,1.4,42.63485381132084,2
2020-05-14-170504,170504,1,0,0,42,0.6,39.84606560642952,3
2020-05-15-170504,170504,0,0,0,42,0.6,35.32247889255845,4
2020-05-16-170504,170504,0,0,0,42,0.0,37.36241275496757,5
2020-05-17-170504,170504,1,0,0,43,0.0,34.46950578435482,6
2020-05-18-170504,170504,0,0,1,43,0.8,34.947844980368345,0
2020-05-19-170504,170504,0,0,0,43,0.2,28.974652337281924,1
2020-05-20-170504,170504,0,0,2,43,1.2,21.835091214150182,2
2020-05-21-170504,170504,1,0,0,44,0.8,22.487869711205697,3
2020-05-22-170504,170504,0,0,0,44,1.8,21.858444978825915,4
2020-05-23-170504,170504,0,0,1,44,0.0,32.91503817333965,5
2020-05-24-170504,170504,0,0,0,44,0.0,30.457866524783014,6
2020-05-25-170504,170504,0,0,2,44,0.6,27.63773399390547,0
2020-05-26-170504,170504,0,0,2,44,1.6,29.24500494314109,1
2020-05-27-170504,170504,1,0,1,45,0.2,36.915550605635815,2
2020-05-28-170504,170504,0,2,1,45,0.6,33.47770530084364,3
2020-05-29-170504,170504,0,0,1,45,1.6,30.897270785133657,4
2020-05-30-170504,170504,0,0,1,45,0.2,25.718129124229993,5
2020-05-31-170504,170504,0,0,0,45,0.6,29.533173802474998,6
2020-06-01-170504,170504,1,0,1,46,0.2,54.33710074204274,0
2020-06-02-170504,170504,0,0,1,46,1.6,44.16448806547265,1
2020-06-03-170504,170504,2,1,0,48,0.4,25.759835718491413,2
2020-06-04-170504,170504,0,0,0,48,1.2,43.01955574070122,3
2020-06-05-170504,170504,0,0,1,48,1.0,46.03375938823615,4
2020-06-06-170504,170504,1,1,2,49,0.4,52.82311137313718,5
2020-06-07-170504,170504,0,0,0,49,0.0,54.142072518712666,6
2020-06-08-170504,170504,2,0,0,51,0.2,54.94600071253329,0
2020-06-09-170504,170504,2,0,1,53,0.4,61.618109201170554,1
2020-06-10-170504,170504,1,1,2,54,3.2,55.67745291671652,2
2020-06-11-170504,170504,1,0,0,55,0.8,52.12762161607179,3
2020-06-12-170504,170504,1,0,0,56,0.6,56.1166653176777,4
2020-06-13-170504,170504,1,0,0,57,0.0,53.163212976593826,5
2020-06-14-170504,170504,0,0,0,57,0.2,52.0506814923984,6
2020-06-15-170504,170504,1,0,1,58,2.6,44.177089685799984,0
2020-06-16-170504,170504,1,0,4,59,0.6,62.559070165972194,1
2020-06-17-170504,170504,0,0,1,59,0.4,64.3382638515807,2
2020-06-18-170504,170504,0,0,3,59,0.8,49.54056348917587,3
2020-06-19-170504,170504,1,0,0,60,0.2,44.72777979007601,4
2020-06-20-170504,170504,2,0,1,62,0.2,53.20836928907549,5
2020-06-21-170504,170504,0,0,0,62,0.2,63.18935093488689,6
2020-06-22-170504,170504,0,0,2,62,0.2,44.27534851551614,0
2020-06-23-170504,170504,1,0,1,63,0.4,38.66265381283597,1
2020-06-24-170504,170504,2,0,2,65,0.0,42.161373717249575,2
2020-06-25-170504,170504,0,0,0,65,0.8,49.53392922488548,3
2020-06-26-170504,170504,0,0,2,65,0.4,45.74673808594292,4
2020-06-27-170504,170504,0,1,0,65,0.2,36.54961220424757,5
2020-06-28-170504,170504,0,0,0,65,0.0,33.76315307339634,6
2020-06-29-170504,170504,1,0,1,66,0.0,32.189480152634694,0
2020-06-30-170504,170504,4,0,0,70,0.6,46.68241164755003,1
2020-07-01-170504,170504,1,0,0,71,0.2,69.63155911323786,2
2020-07-02-170504,170504,3,0,3,74,0.6,39.00072056978956,3
2020-07-03-170504,170504,0,0,1,74,0.0,69.52748840175536,4
2020-07-04-170504,170504,1,0,0,75,0.2,63.101496608971104,5
2020-07-05-170504,170504,0,0,0,75,0.6,69.3039137342459,6
2020-07-06-170504,170504,2,0,0,77,2.0,60.68534548903895,0
2020-07-07-170504,170504,1,0,2,78,0.6,78.04871713979358,1
2020-07-08-170504,170504,2,0,0,80,0.0,54.9491512308974,2
2020-07-09-170504,170504,0,0,0,80,0.0,61.732730797885736,3
2020-07-10-170504,170504,2,0,0,82,0.2,59.052116589231865,4
2020-07-11-170504,170504,0,0,1,82,0.2,60.17567777369216,5
2020-07-12-170504,170504,0,0,0,82,0.2,49.860892739828365,6
2020-07-13-170504,170504,1,0,2,83,0.0,41.543971440911136,0
2020-07-14-170504,170504,0,0,0,83,0.0,47.22896298207628,1
2020-07-15-170504,170504,0,0,5,83,0.6,33.45945270370108,2
2020-07-16-170504,170504,3,0,0,86,0.4,26.60270760998978,3
2020-07-17-170504,170504,1,0,0,87,0.0,43.39126504540625,4
2020-07-18-170504,170504,0,0,1,87,0.2,42.949172474930855,5
2020-07-19-170504,170504,0,0,0,87,0.0,43.57666256660011,6
2020-07-20-170504,170504,0,0,1,87,0.0,56.4491138441985,0
2020-07-21-170504,170504,2,0,2,89,0.0,55.651227468746725,1
2020-07-22-170504,170504,0,0,2,89,0.0,65.46996199386828,2
2020-07-23-170504,170504,0,0,0,89,0.0,41.311688544924074,3
2020-07-24-170504,170504,0,0,2,89,0.0,35.36076751896795,4
2020-07-25-170504,170504,1,0,1,90,1.2,36.169153038799294,5
2020-07-26-170504,170504,0,0,0,90,0.2,50.74146970538965,6
2020-07-27-170504,170504,2,0,5,92,0.2,33.88341539985464,0
2020-07-28-170504,170504,0,0,2,92,1.0,47.166920480339115,1
2020-07-29-170504,170504,5,0,13,97,0.8,42.94868638165916,2
2020-07-30-170504,170504,0,0,5,97,0.4,87.5309457624673,3
2020-07-31-170504,170504,0,0,5,97,0.2,89.17357163832577,4
2020-08-01-170504,170504,1,0,2,98,0.0,66.04010961169709,5
2020-08-02-170504,170504,0,0,0,98,0.4,211.27255486897747,6
2020-08-03-170504,170504,1,0,3,99,0.4,411.92656380986,0
2020-08-04-170504,170504,2,1,0,101,0.6,261.6703805025159,1
2020-08-05-170504,170504,2,0,2,103,1.2,136.50623518773358,2
2020-08-06-170504,170504,0,0,2,103,0.6,124.24119886727624,3
2020-08-07-170504,170504,2,0,7,105,0.2,123.62105176089813,4
2020-08-08-170504,170504,1,0,1,106,0.0,131.6135869741987,5
2020-08-09-170504,170504,0,0,8,106,0.2,128.32524952359057,6
2020-08-10-170504,170504,5,0,8,111,0.6,78.87928642777568,0
2020-08-11-170504,170504,2,0,10,113,1.4,102.52137458553642,1
2020-08-12-170504,170504,13,0,9,126,1.4,123.7354839736488,2
2020-08-13-170504,170504,5,0,1,131,1.0,194.17174176765204,3
2020-08-14-170504,170504,5,0,2,136,1.0,244.17131443030314,4
2020-08-15-170504,170504,2,0,0,138,0.0,276.0698617494697,5
2020-08-16-170504,170504,0,0,0,138,1.2,297.31374890365726,6
2020-08-17-170504,170504,3,0,3,141,0.8,304.0084220148946,0
2020-08-18-170504,170504,0,0,0,141,4.4,300.3738222404186,1
2020-08-19-170504,170504,2,0,1,143,1.6,318.1165869323053,2
2020-08-20-170504,170504,2,0,4,145,0.6,185.96847307882302,3
2020-08-21-170504,170504,7,0,1,152,3.8,160.1598230471057,4
2020-08-22-170504,170504,1,0,1,153,0.8,206.3458402496995,5
2020-08-23-170504,170504,8,0,0,161,1.6,208.1307836044088,6
2020-08-24-170504,170504,8,0,0,169,2.2,228.21072530605812,0
2020-08-25-170504,170504,10,0,0,179,1.2,262.7750205950658,1
2020-08-26-170504,170504,9,0,0,188,1.2,336.6419752178356,2
2020-08-27-170504,170504,1,0,1,189,2.6,495.5976069881279,3
2020-08-28-170504,170504,2,0,0,191,0.0,505.63993552726,4
2020-08-29-170504,170504,0,0,1,191,0.2,442.95993238317726,5
2020-08-30-170504,170504,0,0,1,191,1.4,379.8048701841591,6
2020-08-31-170504,170504,3,0,1,194,1.2,312.95158101165634,0
2020-09-01-170504,170504,0,0,2,194,1.2,102.49029631691246,1
2020-09-02-170504,170504,1,0,1,195,2.2,176.79866297882847,2
2020-09-03-170504,170504,4,0,1,199,1.8,170.91559693860307,3
2020-09-04-170504,170504,1,0,4,200,0.8,168.98661936245009,4
2020-09-05-170504,170504,1,0,2,201,0.4,155.48733194528592,5
2020-09-06-170504,170504,0,1,2,201,1.0,151.61254375022833,6
2020-09-07-170504,170504,0,0,1,201,1.0,139.30241920809277,0
2020-09-08-170504,170504,0,0,2,201,3.0,131.3629587177951,1
2020-09-09-170504,170504,0,0,2,201,0.8,109.59499581008447,2
2020-09-10-170504,170504,1,0,2,202,1.8,74.1004269866412,3
2020-09-11-170504,170504,0,0,5,202,0.6,72.3494633365276,4
2020-09-12-170504,170504,1,0,0,203,0.6,64.44313410761265,5
2020-09-13-170504,170504,1,0,3,204,1.0,69.74178667114596,6
2020-09-14-170504,170504,1,0,1,205,2.6,78.4194534868272,0
2020-09-15-170504,170504,2,0,4,207,2.0,101.18520957781274,1
2020-09-16-170504,170504,1,0,0,208,1.4,125.51455432398511,2
2020-09-17-170504,170504,1,0,1,209,1.6,125.54063713002407,3
2020-09-18-170504,170504,4,0,0,213,3.0,129.39446903604158,4
2020-09-19-170504,170504,2,0,0,215,1.6,147.5213683627407,5
2020-09-20-170504,170504,2,0,0,217,1.8,159.1098182332272,6
2020-09-21-170504,170504,1,1,2,218,1.8,146.4119208117802,0
2020-09-22-170504,170504,2,0,2,220,1.4,139.17916811630212,1
2020-09-23-170504,170504,2,1,0,222,2.0,142.23810803587403,2
2020-09-24-170504,170504,2,0,0,224,1.4,144.1304479846138,3
2020-09-25-170504,170504,5,0,4,229,1.0,131.94438982043818,4
2020-09-26-170504,170504,0,0,2,229,3.0,129.04435634711487,5
2020-09-27-170504,170504,3,0,3,232,1.4,132.30208475960367,6
2020-09-28-170504,170504,1,0,10,233,1.2,134.6140159281437,0
2020-09-29-170504,170504,4,0,4,237,3.2,129.38140413883698,1
2020-09-30-170504,170504,0,0,15,237,2.8,149.74436367915303,2
2020-10-01-170504,170504,1,0,3,238,3.8,0.0,3
2020-10-02-170504,170504,0,0,2,238,2.4,459.33977650410895,4
2020-10-03-170504,170504,0,0,16,238,2.6,595.5340053930775,5
2020-10-04-170504,170504,0,0,8,238,2.2,448.7951772002408,6
2020-10-05-170504,170504,2,0,8,240,4.0,396.35231460070247,0
2020-10-06-170504,170504,2,0,34,242,2.8,365.49909151305917,1
2020-10-07-170504,170504,0,0,8,242,1.2,298.08752047055293,2
2020-10-08-170504,170504,0,0,8,242,4.0,195.2122007082677,3
2020-10-09-170504,170504,4,0,15,246,1.6,201.98791093069707,4
2020-10-10-170504,170504,2,0,11,248,2.2,26.510752656345936,5
2020-10-11-170504,170504,3,0,7,251,1.2,57.72295644856358,6
2020-10-12-170504,170504,10,0,1,261,1.0,87.16536857030337,0
2020-10-13-170504,170504,4,0,3,265,2.8,141.06918276177277,1
2020-10-14-170504,170504,15,0,11,280,2.8,185.26709321053013,2
2020-10-15-170504,170504,3,0,15,283,2.6,277.1671706132714,3
2020-10-16-170504,170504,2,0,10,285,4.2,313.03229313806963,4
2020-10-17-170504,170504,16,0,7,301,3.8,342.2008462390594,5
2020-10-18-170504,170504,8,0,8,309,5.6,390.77174483149577,6
2020-10-19-170504,170504,8,0,5,317,3.4,416.5134223776456,0
2020-10-20-170504,170504,34,1,4,351,6.2,398.72027568830964,1
2020-10-21-170504,170504,8,0,7,359,3.6,474.9315968532417,2
2020-10-22-170504,170504,8,1,5,367,11.6,487.3543448689106,3
2020-10-23-170504,170504,15,0,3,382,4.8,521.6307170617563,4
2020-10-24-170504,170504,11,0,7,393,6.8,510.474871875514,5
2020-10-25-170504,170504,7,4,3,400,5.6,510.29594630282145,6
2020-10-26-170504,170504,1,0,6,401,5.4,508.53007273041857,0
2020-10-27-170504,170504,3,1,1,404,6.2,529.2682396224371,1
2020-10-28-170504,170504,11,3,1,415,9.6,423.1642763100902,2
2020-10-29-170504,170504,15,0,3,430,8.2,462.60708070010867,3
2020-10-30-170504,170504,10,0,4,440,4.6,419.77647578218136,4
2020-10-31-170504,170504,7,0,0,447,1.6,412.3298667737822,5
2020-11-01-170504,170504,8,1,0,455,5.4,149.26279220442729,6
2020-11-02-170504,170504,5,0,0,460,4.2,224.10190764153344,0
2020-11-03-170504,170504,4,2,0,464,7.8,222.86363645270757,1
2020-11-04-170504,170504,7,1,0,471,4.8,240.53541434821682,2
2020-11-05-170504,170504,5,0,0,476,5.6,262.15715225612155,3
2020-11-06-170504,170504,3,0,0,479,3.0,287.4639669315699,4
2020-11-07-170504,170504,7,1,0,486,4.2,279.5820386275483,5
2020-11-08-170504,170504,3,0,0,489,4.2,306.87993166355125,6
2020-11-09-170504,170504,6,1,0,495,3.0,275.511072863879,0
2020-11-10-170504,170504,1,1,0,496,2.8,153.47928329476002,1
2020-11-11-170504,170504,1,3,0,497,2.0,162.36347153752257,2
2020-11-12-170504,170504,3,0,0,500,7.8,152.55595219122068,3
2020-11-13-170504,170504,4,5,0,504,3.4,182.64128278858047,4
2020-03-01-170505,170505,0,0,0,0,0.0,0.0,6
2020-03-02-170505,170505,0,0,0,0,0.0,10.878415819788959,0
2020-03-03-170505,170505,0,0,0,0,0.0,75.55228389478962,1
2020-03-04-170505,170505,0,1,0,0,0.0,94.54973174645241,2
2020-03-05-170505,170505,0,0,0,0,0.0,101.74277074833417,3
2020-03-06-170505,170505,0,0,2,0,0.0,84.0670400092884,4
2020-03-07-170505,170505,0,0,0,0,0.0,87.90310007222116,5
2020-03-08-170505,170505,1,0,0,1,0.0,79.87565285048997,6
2020-03-09-170505,170505,0,1,0,1,0.16666666666666666,84.27087249777819,0
2020-03-10-170505,170505,0,0,2,1,0.0,308.2834756654981,1
2020-03-11-170505,170505,0,0,1,1,0.0,273.36529041461836,2
2020-03-12-170505,170505,0,0,3,1,0.16666666666666666,218.11208260649454,3
2020-03-13-170505,170505,0,0,3,1,0.16666666666666666,193.35204024150477,4
2020-03-14-170505,170505,0,0,0,1,0.3333333333333333,78.02555831027365,5
2020-03-15-170505,170505,0,0,2,1,0.3333333333333333,55.462038863922466,6
2020-03-16-170505,170505,0,0,2,1,1.3333333333333333,14.696961258634866,0
2020-03-17-170505,170505,0,0,1,1,1.0,31.181035501300094,1
2020-03-18-170505,170505,0,0,2,1,1.5,40.79463951645309,2
2020-03-19-170505,170505,0,1,2,1,1.6666666666666667,54.54572486890666,3
2020-03-20-170505,170505,2,1,0,3,1.1666666666666667,65.106305443291,4
2020-03-21-170505,170505,0,1,1,3,0.8333333333333334,78.94861326394064,5
2020-03-22-170505,170505,0,0,1,3,1.0,81.02545430618258,6
2020-03-23-170505,170505,0,0,5,3,2.333333333333333,77.00468526747885,0
2020-03-24-170505,170505,2,0,1,5,1.6666666666666667,93.7579722501314,1
2020-03-25-170505,170505,1,0,8,6,1.3333333333333333,102.20764457520056,2
2020-03-26-170505,170505,3,0,8,9,2.333333333333333,104.00281432872468,3
2020-03-27-170505,170505,3,1,8,12,4.333333333333333,129.92669389823837,4
2020-03-28-170505,170505,0,0,0,12,1.1666666666666667,147.55870343391237,5
2020-03-29-170505,170505,2,0,0,14,0.8333333333333334,146.9613743841144,6
2020-03-30-170505,170505,2,0,2,16,2.5,127.24635469962081,0
2020-03-31-170505,170505,1,0,0,17,1.1666666666666667,130.8311003444452,1
2020-04-01-170505,170505,2,0,1,19,2.0,17.010893299967186,2
2020-04-02-170505,170505,2,0,0,21,1.6666666666666667,58.614716015431355,3
2020-04-03-170505,170505,0,0,0,21,0.8333333333333334,38.47300248276885,4
2020-04-04-170505,170505,1,0,0,22,0.6666666666666666,39.17601118646853,5
2020-04-05-170505,170505,1,0,0,23,1.3333333333333333,43.344263195438344,6
2020-04-06-170505,170505,5,0,1,28,1.3333333333333333,50.16777887202383,0
2020-04-07-170505,170505,1,1,3,29,1.0,63.935348539372264,1
2020-04-08-170505,170505,8,0,0,37,1.3333333333333333,70.10543597073288,2
2020-04-09-170505,170505,8,0,0,45,3.0,93.07966240245912,3
2020-04-10-170505,170505,8,0,1,53,1.3333333333333333,20.826287386439645,4
2020-04-11-170505,170505,0,0,0,53,0.6666666666666666,47.983845002431266,5
2020-04-12-170505,170505,0,0,0,53,0.6666666666666666,53.1884181774215,6
2020-04-13-170505,170505,2,0,1,55,1.3333333333333333,55.2838214419816,0
2020-04-14-170505,170505,0,0,1,55,1.1666666666666667,68.32447440213139,1
2020-04-15-170505,170505,1,0,0,56,1.3333333333333333,73.89893522098127,2
2020-04-16-170505,170505,0,1,0,56,0.8333333333333334,83.57281469664133,3
2020-04-17-170505,170505,0,0,0,56,3.333333333333333,79.9082790890753,4
2020-04-18-170505,170505,0,0,0,56,0.0,71.22461802344887,5
2020-04-19-170505,170505,0,0,0,56,0.3333333333333333,64.66519377266417,6
2020-04-20-170505,170505,1,0,0,57,2.833333333333333,63.392311805318,0
2020-04-21-170505,170505,3,0,0,60,0.16666666666666666,73.96750481752888,1
2020-04-22-170505,170505,0,0,0,60,1.0,74.20654919582549,2
2020-04-23-170505,170505,0,0,1,60,0.8333333333333334,73.0565474729648,3
2020-04-24-170505,170505,1,0,0,61,0.6666666666666666,55.79780909000539,4
2020-04-25-170505,170505,0,0,0,61,0.3333333333333333,63.79667277522539,5
2020-04-26-170505,170505,0,0,0,61,0.5,66.45819935916606,6
2020-04-27-170505,170505,1,0,0,62,0.8333333333333334,55.80595099408724,0
2020-04-28-170505,170505,1,0,2,63,0.3333333333333333,45.02821662319627,1
2020-04-29-170505,170505,0,0,1,63,1.0,41.880160875976365,2
2020-04-30-170505,170505,0,0,1,63,0.5,46.53907281526735,3
2020-05-01-170505,170505,0,0,1,63,0.16666666666666666,129.91916218257631,4
2020-05-02-170505,170505,0,0,0,63,0.6666666666666666,32.39861492589006,5
2020-05-03-170505,170505,0,0,0,63,0.0,29.0272513342133,6
2020-05-04-170505,170505,0,0,0,63,0.6666666666666666,32.01577609225579,0
2020-05-05-170505,170505,0,0,0,63,0.16666666666666666,38.30479120030237,1
2020-05-06-170505,170505,0,0,0,63,0.3333333333333333,36.854779619178686,2
2020-05-07-170505,170505,1,0,1,64,0.8333333333333334,36.53295286869135,3
2020-05-08-170505,170505,0,0,0,64,0.8333333333333334,33.85991864034283,4
2020-05-09-170505,170505,0,0,0,64,0.0,42.43692604789833,5
2020-05-10-170505,170505,0,1,0,64,0.16666666666666666,154.92003926084453,6
2020-05-11-170505,170505,0,1,0,64,0.3333333333333333,145.3357907189258,0
2020-05-12-170505,170505,2,0,0,66,0.3333333333333333,134.46384045299624,1
2020-05-13-170505,170505,1,0,1,67,0.3333333333333333,115.33213119581974,2
2020-05-14-170505,170505,1,0,2,68,0.16666666666666666,107.31304202026078,3
2020-05-15-170505,170505,1,0,3,69,0.6666666666666666,76.09483493349411,4
2020-05-16-170505,170505,0,3,0,69,0.0,45.708225410013746,5
2020-05-17-170505,170505,0,0,0,69,0.16666666666666666,42.348758698059726,6
2020-05-18-170505,170505,0,0,1,69,0.0,42.2365650546349,0
2020-05-19-170505,170505,0,0,0,69,1.5,39.16909774524578,1
2020-05-20-170505,170505,0,1,1,69,0.6666666666666666,36.58085978558818,2
2020-05-21-170505,170505,1,0,2,70,0.8333333333333334,37.98337778303382,3
2020-05-22-170505,170505,0,0,0,70,1.0,37.93788407286059,4
2020-05-23-170505,170505,0,0,1,70,0.16666666666666666,46.4844512581505,5
2020-05-24-170505,170505,0,0,0,70,0.0,47.688858734944915,6
2020-05-25-170505,170505,0,0,0,70,0.0,44.380778602146044,0
2020-05-26-170505,170505,0,0,1,70,0.16666666666666666,35.61235463443262,1
2020-05-27-170505,170505,1,0,0,71,0.16666666666666666,36.91036973407887,2
2020-05-28-170505,170505,2,0,2,73,0.3333333333333333,39.373710813298075,3
2020-05-29-170505,170505,3,0,1,76,0.5,39.194811931269356,4
2020-05-30-170505,170505,0,0,1,76,0.16666666666666666,44.169768035150426,5
2020-05-31-170505,170505,0,0,0,76,0.5,49.01834763583024,6
2020-06-01-170505,170505,1,0,0,77,0.8333333333333334,63.714783085875496,0
2020-06-02-170505,170505,0,0,0,77,0.0,28.415523615727405,1
2020-06-03-170505,170505,1,0,0,78,0.3333333333333333,20.980651619920142,2
2020-06-04-170505,170505,2,0,0,80,0.16666666666666666,22.889249240717266,3
2020-06-05-170505,170505,0,0,0,80,1.0,28.184861603644123,4
2020-06-06-170505,170505,1,1,0,81,0.0,32.71645277109039,5
2020-06-07-170505,170505,0,0,0,81,0.0,34.62998502248762,6
2020-06-08-170505,170505,0,0,0,81,0.3333333333333333,34.425951503881066,0
2020-06-09-170505,170505,1,0,0,82,0.16666666666666666,37.2050503397628,1
2020-06-10-170505,170505,0,0,1,82,0.3333333333333333,66.75308830575597,2
2020-06-11-170505,170505,2,0,0,84,0.5,63.64374598134563,3
2020-06-12-170505,170505,1,0,0,85,0.6666666666666666,70.1804863824317,4
2020-06-13-170505,170505,1,0,0,86,0.0,68.83951868368494,5
2020-06-14-170505,170505,0,0,0,86,0.0,58.28799743913798,6
2020-06-15-170505,170505,0,0,0,86,0.3333333333333333,49.02666733207376,0
2020-06-16-170505,170505,0,0,0,86,0.3333333333333333,52.58236852367193,1
2020-06-17-170505,170505,0,0,0,86,0.3333333333333333,45.730412663716265,2
2020-06-18-170505,170505,0,0,0,86,1.0,40.649740764950444,3
2020-06-19-170505,170505,0,0,0,86,0.5,32.98055759012281,4
2020-06-20-170505,170505,0,0,0,86,0.16666666666666666,28.793982135679116,5
2020-06-21-170505,170505,0,0,0,86,0.16666666666666666,31.67396373171455,6
2020-06-22-170505,170505,0,0,0,86,0.0,29.61591227876408,0
2020-06-23-170505,170505,0,0,0,86,0.0,27.065858685284077,1
2020-06-24-170505,170505,1,0,0,87,0.3333333333333333,26.192336683090637,2
2020-06-25-170505,170505,0,0,0,87,0.3333333333333333,27.041244095385746,3
2020-06-26-170505,170505,0,1,0,87,0.16666666666666666,25.606760711524423,4
2020-06-27-170505,170505,0,0,0,87,0.16666666666666666,25.735851392350654,5
2020-06-28-170505,170505,0,0,0,87,0.0,26.689277493290184,6
2020-06-29-170505,170505,0,0,0,87,0.16666666666666666,24.612953082527028,0
2020-06-30-170505,170505,0,0,0,87,0.0,32.98393507321844,1
2020-07-01-170505,170505,0,0,0,87,0.16666666666666666,46.99699091279321,2
2020-07-02-170505,170505,0,0,0,87,0.3333333333333333,23.778924300465604,3
2020-07-03-170505,170505,0,0,0,87,0.3333333333333333,33.90953646628559,4
2020-07-04-170505,170505,0,0,0,87,0.0,31.143328739309197,5
2020-07-05-170505,170505,0,0,0,87,0.16666666666666666,31.88854772533808,6
2020-07-06-170505,170505,0,0,0,87,0.16666666666666666,24.844700122602582,0
2020-07-07-170505,170505,0,1,0,87,0.0,25.399522797681172,1
2020-07-08-170505,170505,0,0,1,87,0.16666666666666666,24.13334161557747,2
2020-07-09-170505,170505,0,0,1,87,0.0,20.96718624661128,3
2020-07-10-170505,170505,0,0,0,87,0.5,49.79184015279349,4
2020-07-11-170505,170505,0,0,0,87,0.16666666666666666,43.8453989583128,5
2020-07-12-170505,170505,0,0,0,87,0.0,32.724741112177654,6
2020-07-13-170505,170505,0,0,1,87,0.0,27.40529635167084,0
2020-07-14-170505,170505,0,0,0,87,0.6666666666666666,28.28434499358577,1
2020-07-15-170505,170505,0,0,0,87,0.6666666666666666,26.985490838122786,2
2020-07-16-170505,170505,0,0,0,87,0.6666666666666666,25.241584455912573,3
2020-07-17-170505,170505,0,0,0,87,0.16666666666666666,30.00485229300487,4
2020-07-18-170505,170505,0,0,0,87,0.0,22.817083971632794,5
2020-07-19-170505,170505,0,0,0,87,0.3333333333333333,23.047363378389488,6
2020-07-20-170505,170505,0,0,0,87,0.0,28.74609591248926,0
2020-07-21-170505,170505,0,0,0,87,0.16666666666666666,23.532144306690945,1
2020-07-22-170505,170505,1,0,0,88,0.16666666666666666,17.80467855531857,2
2020-07-23-170505,170505,1,0,0,89,0.6666666666666666,18.48099130933047,3
2020-07-24-170505,170505,0,0,0,89,0.5,31.16377678388762,4
2020-07-25-170505,170505,0,0,0,89,0.16666666666666666,36.79959236716877,5
2020-07-26-170505,170505,0,0,0,89,0.0,34.73809798569677,6
2020-07-27-170505,170505,1,0,0,90,0.3333333333333333,30.919906214770407,0
2020-07-28-170505,170505,0,0,0,90,0.5,38.56370139035351,1
2020-07-29-170505,170505,0,0,0,90,0.0,41.3298716110629,2
2020-07-30-170505,170505,0,0,1,90,0.5,29.24600352150064,3
2020-07-31-170505,170505,0,0,1,90,0.6666666666666666,29.71399673873512,4
2020-08-01-170505,170505,0,0,1,90,0.16666666666666666,15.720508599675968,5
2020-08-02-170505,170505,0,0,3,90,0.0,121.69501505813797,6
2020-08-03-170505,170505,0,0,4,90,0.16666666666666666,120.38987688220325,0
2020-08-04-170505,170505,0,0,1,90,0.6666666666666666,107.08722150244921,1
2020-08-05-170505,170505,0,0,0,90,0.6666666666666666,95.48967684811926,2
2020-08-06-170505,170505,0,1,3,90,0.5,66.25805518815636,3
2020-08-07-170505,170505,0,0,10,90,1.0,63.07278766083775,4
2020-08-08-170505,170505,0,0,8,90,0.6666666666666666,62.53625151041814,5
2020-08-09-170505,170505,0,0,0,90,0.0,66.10169038218287,6
2020-08-10-170505,170505,0,0,0,90,0.3333333333333333,14.424865264543794,0
2020-08-11-170505,170505,0,0,0,90,0.16666666666666666,19.16571899436866,1
2020-08-12-170505,170505,0,0,1,90,1.3333333333333333,25.227760716039768,2
2020-08-13-170505,170505,1,0,2,91,0.8333333333333334,34.11734721107718,3
2020-08-14-170505,170505,1,1,0,92,1.1666666666666667,41.07097877725362,4
2020-08-15-170505,170505,1,0,0,93,0.16666666666666666,54.14704003274516,5
2020-08-16-170505,170505,3,0,0,96,0.8333333333333334,60.78049560605283,6
2020-08-17-170505,170505,4,0,0,100,0.5,79.96313493814529,0
2020-08-18-170505,170505,1,0,2,101,1.0,101.4743257163037,1
2020-08-19-170505,170505,0,0,0,101,0.8333333333333334,108.12807885694608,2
2020-08-20-170505,170505,3,0,1,104,0.8333333333333334,115.72089452840143,3
2020-08-21-170505,170505,10,0,4,114,1.5,124.45587235784738,4
2020-08-22-170505,170505,8,0,2,122,0.3333333333333333,182.76292375981694,5
2020-08-23-170505,170505,0,0,5,122,1.0,197.77363215409227,6
2020-08-24-170505,170505,0,0,0,122,1.1666666666666667,175.32419428866697,0
2020-08-25-170505,170505,0,0,0,122,1.6666666666666667,173.47050579441228,1
2020-08-26-170505,170505,1,0,6,123,1.3333333333333333,162.0009141269428,2
2020-08-27-170505,170505,2,0,3,125,3.1666666666666665,177.86250183882564,3
2020-08-28-170505,170505,0,0,3,125,1.3333333333333333,192.38190012003656,4
2020-08-29-170505,170505,0,0,1,125,0.5,140.76051960970779,5
2020-08-30-170505,170505,0,0,0,125,1.5,111.00018931393129,6
2020-08-31-170505,170505,0,0,0,125,0.8333333333333334,104.58667324927028,0
2020-09-01-170505,170505,2,0,1,127,1.5,55.02994517360865,1
2020-09-02-170505,170505,0,0,1,127,0.3333333333333333,146.52287686988322,2
2020-09-03-170505,170505,1,0,1,128,0.6666666666666666,132.98064081261015,3
2020-09-04-170505,170505,4,0,0,132,1.5,130.91039165269336,4
2020-09-05-170505,170505,2,0,0,134,0.5,142.91208709048544,5
2020-09-06-170505,170505,5,0,0,139,0.5,132.63421422830933,6
2020-09-07-170505,170505,0,0,0,139,0.3333333333333333,139.41348703946878,0
2020-09-08-170505,170505,0,0,0,139,3.1666666666666665,132.2450636147937,1
2020-09-09-170505,170505,6,0,0,145,1.6666666666666667,144.40347416421125,2
2020-09-10-170505,170505,3,0,1,148,2.5,66.29141504430987,3
2020-09-11-170505,170505,3,0,2,151,2.0,89.02097144132838,4
2020-09-12-170505,170505,1,0,0,152,0.8333333333333334,116.04434486359665,5
2020-09-13-170505,170505,0,0,0,152,2.833333333333333,124.19129011451392,6
2020-09-14-170505,170505,0,1,1,152,3.333333333333333,130.35271195075057,0
2020-09-15-170505,170505,1,0,0,153,2.833333333333333,147.68473140813467,1
2020-09-16-170505,170505,1,0,0,154,1.8333333333333333,166.35380160096986,2
2020-09-17-170505,170505,1,0,0,155,0.8333333333333334,162.36437679801298,3
2020-09-18-170505,170505,0,0,2,155,1.5,154.01582369225747,4
2020-09-19-170505,170505,0,0,2,155,0.8333333333333334,138.8484154783526,5
2020-09-20-170505,170505,0,1,1,155,1.1666666666666667,119.04800733671506,6
2020-09-21-170505,170505,0,0,0,155,0.8333333333333334,115.2241068727928,0
2020-09-22-170505,170505,0,0,2,155,1.1666666666666667,109.16479449318034,1
2020-09-23-170505,170505,0,0,0,155,2.1666666666666665,99.65644454485367,2
2020-09-24-170505,170505,1,1,3,156,1.3333333333333333,101.60366662234918,3
2020-09-25-170505,170505,2,0,3,158,1.0,96.61914237963347,4
2020-09-26-170505,170505,0,0,3,158,1.6666666666666667,104.96671120841594,5
2020-09-27-170505,170505,0,0,0,158,1.1666666666666667,122.75167013449584,6
2020-09-28-170505,170505,1,0,1,159,1.0,118.5546640237529,0
2020-09-29-170505,170505,0,0,1,159,0.16666666666666666,124.47869296013259,1
2020-09-30-170505,170505,0,0,5,159,2.5,121.07492669182676,2
2020-10-01-170505,170505,0,0,3,159,2.5,0.0,3
2020-10-02-170505,170505,2,0,2,161,3.0,223.6586057367752,4
2020-10-03-170505,170505,2,1,1,163,1.3333333333333333,227.7622808539449,5
2020-10-04-170505,170505,1,0,1,164,2.5,234.29949129745728,6
2020-10-05-170505,170505,0,0,1,164,1.3333333333333333,223.424657432253,0
2020-10-06-170505,170505,2,0,1,166,2.1666666666666665,214.00724585934236,1
2020-10-07-170505,170505,0,0,0,166,1.8333333333333333,199.91280047304411,2
2020-10-08-170505,170505,3,0,1,169,1.1666666666666667,187.57598202164783,3
2020-10-09-170505,170505,3,1,4,172,0.8333333333333334,204.6703331104424,4
2020-10-10-170505,170505,3,0,2,175,2.1666666666666665,18.585185503828157,5
2020-10-11-170505,170505,0,0,2,175,0.6666666666666666,54.96349724543484,6
2020-10-12-170505,170505,1,0,0,176,0.8333333333333334,62.81262259387333,0
2020-10-13-170505,170505,1,0,0,177,2.1666666666666665,73.62993929835434,1
2020-10-14-170505,170505,5,0,0,182,1.3333333333333333,95.59930657564124,2
2020-10-15-170505,170505,3,0,1,185,1.3333333333333333,146.48156495141762,3
2020-10-16-170505,170505,2,0,3,187,2.0,181.5454667345123,4
2020-10-17-170505,170505,1,0,0,188,1.3333333333333333,201.46896378121775,5
2020-10-18-170505,170505,1,0,1,189,0.16666666666666666,182.2017763124976,6
2020-10-19-170505,170505,1,0,2,190,2.5,187.29840930775163,0
2020-10-20-170505,170505,1,0,0,191,3.1666666666666665,211.63466661234736,1
2020-10-21-170505,170505,0,0,0,191,1.0,189.2176325872173,2
2020-10-22-170505,170505,1,0,1,192,2.6666666666666665,169.5943940319773,3
2020-10-23-170505,170505,4,0,0,196,1.8333333333333333,160.20739242360798,4
2020-10-24-170505,170505,2,0,0,198,1.0,164.42626231940744,5
2020-10-25-170505,170505,2,0,2,200,1.5,176.58397104104108,6
2020-10-26-170505,170505,0,0,3,200,1.6666666666666667,177.88203759641237,0
2020-10-27-170505,170505,0,0,1,200,1.6666666666666667,168.6307788764168,1
2020-10-28-170505,170505,0,0,0,200,1.3333333333333333,167.45447807932976,2
2020-10-29-170505,170505,1,1,2,201,1.8333333333333333,191.08481477724507,3
2020-10-30-170505,170505,3,0,1,204,2.333333333333333,189.87172965339425,4
2020-10-31-170505,170505,0,0,0,204,1.3333333333333333,212.82433596700037,5
2020-11-01-170505,170505,1,0,0,205,1.1666666666666667,167.30939940775403,6
2020-11-02-170505,170505,2,1,0,207,1.6666666666666667,298.93771498161425,0
2020-11-03-170505,170505,0,0,0,207,3.5,298.20876029356384,1
2020-11-04-170505,170505,0,0,0,207,3.6666666666666665,305.1930458459028,2
2020-11-05-170505,170505,1,1,0,208,3.0,290.9261444186045,3
2020-11-06-170505,170505,0,0,0,208,2.0,284.2934879996684,4
2020-11-07-170505,170505,0,1,0,208,9.0,252.54159509160402,5
2020-11-08-170505,170505,2,0,0,210,1.0,296.8684395624881,6
2020-11-09-170505,170505,3,2,0,213,1.8333333333333333,280.3056196102332,0
2020-11-10-170505,170505,1,1,0,214,2.6666666666666665,150.1469234029933,1
2020-11-11-170505,170505,0,0,0,214,0.6666666666666666,159.40427410292446,2
2020-11-12-170505,170505,2,0,0,216,2.333333333333333,156.28021793575834,3
2020-11-13-170505,170505,1,0,0,217,3.6666666666666665,168.51586327726807,4
2020-03-01-170506,170506,0,0,0,0,0.0,0.0,6
2020-03-02-170506,170506,0,0,0,0,0.0,9.431610381497746,0
2020-03-03-170506,170506,0,0,1,0,0.0,49.1925042828314,1
2020-03-04-170506,170506,0,0,2,0,0.0,48.26961630118164,2
2020-03-05-170506,170506,0,0,2,0,0.0,47.71708529888608,3
2020-03-06-170506,170506,0,0,2,0,0.0,40.74520447103015,4
2020-03-07-170506,170506,0,0,3,0,0.0,44.71623473250973,5
2020-03-08-170506,170506,0,0,0,0,0.0,36.7731362262639,6
2020-03-09-170506,170506,1,0,4,1,0.0,37.28647620644856,0
2020-03-10-170506,170506,0,0,1,1,0.0,358.32624174185173,1
2020-03-11-170506,170506,0,0,1,1,0.0,279.12767441096764,2
2020-03-12-170506,170506,1,0,2,2,0.0,204.35740544112664,3
2020-03-13-170506,170506,0,0,1,2,0.0,176.1109640358705,4
2020-03-14-170506,170506,1,0,0,3,0.0,93.1560286488953,5
2020-03-15-170506,170506,0,0,1,3,0.8,72.52833224883919,6
2020-03-16-170506,170506,0,0,1,3,1.4,19.37075287962812,0
2020-03-17-170506,170506,1,0,0,4,1.4,22.85801661155096,1
2020-03-18-170506,170506,2,1,2,6,1.6,33.95780317643571,2
2020-03-19-170506,170506,2,0,2,8,2.2,47.654647858318654,3
2020-03-20-170506,170506,2,0,0,10,2.4,54.74215649830933,4
2020-03-21-170506,170506,3,1,0,13,1.6,61.51520490103457,5
2020-03-22-170506,170506,0,0,0,13,0.8,79.09857436180675,6
2020-03-23-170506,170506,4,0,1,17,4.2,75.34911720367151,0
2020-03-24-170506,170506,1,0,2,18,1.8,96.16642770106426,1
2020-03-25-170506,170506,1,0,1,19,1.4,93.27923560665776,2
2020-03-26-170506,170506,2,0,0,21,1.4,87.35843041757443,3
2020-03-27-170506,170506,1,0,1,22,2.6,100.36460117572166,4
2020-03-28-170506,170506,0,0,2,22,0.4,97.47956951068167,5
2020-03-29-170506,170506,1,0,1,23,1.0,78.5002717311205,6
2020-03-30-170506,170506,1,0,1,24,0.8,54.10893605462313,0
2020-03-31-170506,170506,0,0,2,24,1.4,55.354061516285924,1
2020-04-01-170506,170506,2,0,1,26,1.4,11.515263550622025,2
2020-04-02-170506,170506,2,0,3,28,0.2,57.72870416467794,3
2020-04-03-170506,170506,0,0,0,28,1.4,65.22335566199895,4
2020-04-04-170506,170506,0,0,1,28,0.4,57.76498731957149,5
2020-04-05-170506,170506,0,0,0,28,1.4,55.25227414845126,6
2020-04-06-170506,170506,1,0,0,29,1.2,59.95752775630836,0
2020-04-07-170506,170506,2,0,1,31,0.6,70.44695078480031,1
2020-04-08-170506,170506,1,0,0,32,2.4,61.1187954983902,2
2020-04-09-170506,170506,0,0,1,32,0.2,59.137494234798396,3
2020-04-10-170506,170506,1,1,3,33,5.8,21.18777830911356,4
2020-04-11-170506,170506,2,0,0,35,0.6,53.30092882277765,5
2020-04-12-170506,170506,1,0,0,36,0.2,62.84361077908551,6
2020-04-13-170506,170506,1,0,0,37,1.4,69.53781022112598,0
2020-04-14-170506,170506,2,0,6,39,1.2,81.2641859590852,1
2020-04-15-170506,170506,1,0,2,40,1.2,96.35187151501025,2
2020-04-16-170506,170506,3,0,1,43,0.4,95.98305837512646,3
2020-04-17-170506,170506,0,0,0,43,0.2,100.41588643031974,4
2020-04-18-170506,170506,1,0,1,44,0.0,75.24081659761443,5
2020-04-19-170506,170506,0,0,0,44,0.2,71.90926786262963,6
2020-04-20-170506,170506,0,0,2,44,1.0,68.17837635328858,0
2020-04-21-170506,170506,1,0,0,45,0.6,64.02605734291816,1
2020-04-22-170506,170506,0,0,2,45,0.2,61.970023132758215,2
2020-04-23-170506,170506,1,0,3,46,0.0,46.96845495525018,3
2020-04-24-170506,170506,3,0,0,49,1.0,44.149898139798914,4
2020-04-25-170506,170506,0,0,0,49,1.2,55.79060737407981,5
2020-04-26-170506,170506,0,0,0,49,1.0,59.68653418052409,6
2020-04-27-170506,170506,0,0,0,49,0.2,51.79335556848838,0
2020-04-28-170506,170506,6,0,1,55,0.8,41.952970242779415,1
2020-04-29-170506,170506,2,0,4,57,0.6,62.99298073821957,2
2020-04-30-170506,170506,1,0,0,58,0.4,76.68077790072184,3
2020-05-01-170506,170506,0,0,0,58,0.2,57.77725924949185,4
2020-05-02-170506,170506,1,0,0,59,0.0,35.29403545908885,5
2020-05-03-170506,170506,0,0,0,59,0.2,51.874581587732884,6
2020-05-04-170506,170506,2,0,2,61,1.4,53.164924196082126,0
2020-05-05-170506,170506,0,0,0,61,0.2,57.793637476628525,1
2020-05-06-170506,170506,2,0,3,63,0.2,57.51671623844282,2
2020-05-07-170506,170506,3,0,1,66,1.2,63.69087285134495,3
2020-05-08-170506,170506,0,0,1,66,0.8,52.87926843005549,4
2020-05-09-170506,170506,0,0,0,66,0.2,61.958300385386764,5
2020-05-10-170506,170506,0,0,0,66,0.6,62.05500565411272,6
2020-05-11-170506,170506,0,0,1,66,0.6,61.69170124111047,0
2020-05-12-170506,170506,1,0,2,67,0.6,58.643702413223345,1
2020-05-13-170506,170506,4,0,0,71,1.2,55.56465666341718,2
2020-05-14-170506,170506,0,0,1,71,1.4,59.13233580787447,3
2020-05-15-170506,170506,0,0,5,71,0.0,49.74803396958032,4
2020-05-16-170506,170506,0,0,0,71,0.2,46.58739365379147,5
2020-05-17-170506,170506,0,0,0,71,0.2,45.63314012629199,6
2020-05-18-170506,170506,2,0,0,73,0.2,44.19234863364652,0
2020-05-19-170506,170506,0,0,0,73,0.2,51.284885638124756,1
2020-05-20-170506,170506,3,0,1,76,0.0,28.415723438190998,2
2020-05-21-170506,170506,1,0,1,77,0.8,45.66351741945098,3
2020-05-22-170506,170506,1,0,0,78,0.2,55.77076569512002,4
2020-05-23-170506,170506,0,0,0,78,0.6,66.40859656850398,5
2020-05-24-170506,170506,0,0,0,78,0.0,66.16560159068776,6
2020-05-25-170506,170506,1,0,0,79,0.4,54.06518855473742,0
2020-05-26-170506,170506,2,0,1,81,0.8,60.55114861451639,1
2020-05-27-170506,170506,0,0,2,81,0.4,69.9181423069789,2
2020-05-28-170506,170506,1,2,0,82,0.0,52.711295085443616,3
2020-05-29-170506,170506,5,0,2,87,0.6,47.00959476173958,4
2020-05-30-170506,170506,0,1,0,87,0.0,77.75219427562187,5
2020-05-31-170506,170506,0,1,0,87,0.2,86.61958935303288,6
2020-06-01-170506,170506,0,0,2,87,0.8,79.99137353229648,0
2020-06-02-170506,170506,0,0,1,87,0.6,61.82898931088428,1
2020-06-03-170506,170506,1,0,1,88,0.6,29.333196620119473,2
2020-06-04-170506,170506,1,0,3,89,0.4,57.994553909653746,3
2020-06-05-170506,170506,0,8,0,89,0.0,61.04519276470003,4
2020-06-06-170506,170506,0,0,0,89,0.2,61.09696951477187,5
2020-06-07-170506,170506,0,1,0,89,0.0,60.22340120931462,6
2020-06-08-170506,170506,0,0,1,89,0.4,59.56376405583735,0
2020-06-09-170506,170506,1,0,0,90,0.8,62.36991895447449,1
2020-06-10-170506,170506,2,0,0,92,3.0,82.97573768280697,2
2020-06-11-170506,170506,0,0,2,92,1.0,101.94744995121353,3
2020-06-12-170506,170506,2,0,0,94,0.2,111.88364145633196,4
2020-06-13-170506,170506,0,0,0,94,0.4,105.97293895956571,5
2020-06-14-170506,170506,0,5,0,94,0.0,85.76907294534462,6
2020-06-15-170506,170506,2,1,0,96,0.4,78.88949337309255,0
2020-06-16-170506,170506,1,0,2,97,0.2,100.12308682377552,1
2020-06-17-170506,170506,1,0,0,98,0.0,102.62839270090328,2
2020-06-18-170506,170506,3,0,1,101,0.2,63.10232047133488,3
2020-06-19-170506,170506,0,0,0,101,0.2,69.98378797754529,4
2020-06-20-170506,170506,0,0,0,101,0.6,68.61496515813377,5
2020-06-21-170506,170506,0,0,0,101,0.0,75.80663681450805,6
2020-06-22-170506,170506,1,0,1,102,0.2,54.61207010434982,0
2020-06-23-170506,170506,0,0,0,102,1.0,59.798660574696825,1
2020-06-24-170506,170506,0,0,0,102,0.4,60.2693502129742,2
2020-06-25-170506,170506,2,0,0,104,0.2,47.81407560737069,3
2020-06-26-170506,170506,0,0,0,104,0.2,55.15238297367875,4
2020-06-27-170506,170506,0,0,0,104,0.0,52.11557025469832,5
2020-06-28-170506,170506,0,0,0,104,0.0,48.54850976249301,6
2020-06-29-170506,170506,0,0,0,104,0.2,48.0959071965905,0
2020-06-30-170506,170506,2,0,0,106,1.0,45.00399568038165,1
2020-07-01-170506,170506,0,0,0,106,0.4,71.20367796762295,2
2020-07-02-170506,170506,1,0,0,107,1.2,31.585929085662563,3
2020-07-03-170506,170506,0,0,0,107,0.2,49.32840970695594,4
2020-07-04-170506,170506,0,0,1,107,0.2,33.03793880274425,5
2020-07-05-170506,170506,0,0,0,107,0.0,35.57434421513565,6
2020-07-06-170506,170506,1,0,0,108,1.4,23.378818545616955,0
2020-07-07-170506,170506,0,0,0,108,0.2,50.24244929466188,1
2020-07-08-170506,170506,0,0,0,108,0.4,41.02062295418226,2
2020-07-09-170506,170506,0,0,0,108,0.0,42.83944654360235,3
2020-07-10-170506,170506,0,0,0,108,0.6,50.58109883582364,4
2020-07-11-170506,170506,0,0,2,108,0.2,39.48946229433423,5
2020-07-12-170506,170506,0,0,0,108,0.0,37.21051940251139,6
2020-07-13-170506,170506,0,0,1,108,0.4,33.98326716126601,0
2020-07-14-170506,170506,0,0,2,108,0.0,36.085642528869876,1
2020-07-15-170506,170506,0,0,0,108,0.6,30.67109292045571,2
2020-07-16-170506,170506,0,0,0,108,1.0,18.924559723211846,3
2020-07-17-170506,170506,0,0,0,108,0.4,27.397884984130407,4
2020-07-18-170506,170506,1,0,0,109,0.0,27.192344781823923,5
2020-07-19-170506,170506,0,0,0,109,0.0,32.76317158207352,6
2020-07-20-170506,170506,0,0,0,109,0.0,51.35008871109137,0
2020-07-21-170506,170506,0,0,0,109,0.4,50.152028597677884,1
2020-07-22-170506,170506,0,0,0,109,0.0,53.86481122067675,2
2020-07-23-170506,170506,0,0,0,109,0.0,38.63935389377606,3
2020-07-24-170506,170506,0,0,0,109,0.2,37.69011070502343,4
2020-07-25-170506,170506,2,0,0,111,0.2,31.081517044748658,5
2020-07-26-170506,170506,0,0,0,111,0.0,48.79958083936175,6
2020-07-27-170506,170506,1,0,0,112,0.4,28.146026469874766,0
2020-07-28-170506,170506,2,0,0,114,0.2,41.42463909929171,1
2020-07-29-170506,170506,0,0,2,114,1.0,38.49134013763796,2
2020-07-30-170506,170506,0,0,0,114,0.4,55.10855717240756,3
2020-07-31-170506,170506,0,0,0,114,0.2,54.55499415797106,4
2020-08-01-170506,170506,0,0,0,114,0.2,44.803689107633645,5
2020-08-02-170506,170506,0,0,0,114,0.0,162.9309194713778,6
2020-08-03-170506,170506,0,0,1,114,0.4,376.7115838619568,0
2020-08-04-170506,170506,0,0,5,114,0.6,217.61880549947762,1
2020-08-05-170506,170506,0,0,3,114,0.6,138.35270795272083,2
2020-08-06-170506,170506,0,0,2,114,0.4,70.21738916551085,3
2020-08-07-170506,170506,0,0,13,114,0.8,69.52728621551472,4
2020-08-08-170506,170506,0,0,2,114,0.2,69.90472768285512,5
2020-08-09-170506,170506,0,0,3,114,0.2,70.1441970018868,6
2020-08-10-170506,170506,0,0,0,114,1.8,52.28606333354416,0
2020-08-11-170506,170506,0,0,3,114,0.8,66.34131606257027,1
2020-08-12-170506,170506,2,0,0,116,3.4,75.97432516715412,2
2020-08-13-170506,170506,0,0,4,116,1.8,105.1234705478791,3
2020-08-14-170506,170506,0,0,0,116,1.2,130.71899965212162,4
2020-08-15-170506,170506,0,0,0,116,1.6,142.3067461138312,5
2020-08-16-170506,170506,0,0,2,116,0.4,147.36499445780652,6
2020-08-17-170506,170506,1,0,1,117,1.4,148.2275595502902,0
2020-08-18-170506,170506,5,0,1,122,0.6,149.62037458959975,1
2020-08-19-170506,170506,3,0,2,125,3.4,193.25319023641575,2
2020-08-20-170506,170506,2,0,0,127,1.0,143.16440699319776,3
2020-08-21-170506,170506,13,0,0,140,4.4,149.6001339374813,4
2020-08-22-170506,170506,2,0,0,142,0.4,280.9162319585426,5
2020-08-23-170506,170506,3,0,4,145,2.6,294.64601492397344,6
2020-08-24-170506,170506,0,0,2,145,2.6,332.21419682203503,0
2020-08-25-170506,170506,3,0,5,148,3.8,348.68249427682525,1
2020-08-26-170506,170506,0,0,2,148,3.4,386.17610542263793,2
2020-08-27-170506,170506,4,0,1,152,2.4,462.70044815139806,3
2020-08-28-170506,170506,0,0,0,152,1.0,510.983692613246,4
2020-08-29-170506,170506,0,0,0,152,1.0,372.71904949971673,5
2020-08-30-170506,170506,2,0,0,154,0.6,297.02471261015546,6
2020-08-31-170506,170506,1,0,1,155,1.4,241.76663276385256,0
2020-09-01-170506,170506,1,0,0,156,0.6,50.85769801285994,1
2020-09-02-170506,170506,2,0,1,158,0.6,118.35855889439294,2
2020-09-03-170506,170506,0,0,2,158,2.0,213.8608627218164,3
2020-09-04-170506,170506,0,0,0,158,1.0,255.85593446163904,4
2020-09-05-170506,170506,0,0,0,158,0.4,302.76208586374645,5
2020-09-06-170506,170506,4,0,0,162,0.4,269.5949318205255,6
2020-09-07-170506,170506,2,0,2,164,0.8,295.0138096134244,0
2020-09-08-170506,170506,5,0,1,169,1.4,280.16584912632413,1
2020-09-09-170506,170506,2,0,1,171,1.0,257.84291554228196,2
2020-09-10-170506,170506,1,0,0,172,2.4,39.428735360034956,3
2020-09-11-170506,170506,0,0,0,172,0.0,51.116176980387465,4
2020-09-12-170506,170506,0,0,7,172,0.6,49.72176908518423,5
2020-09-13-170506,170506,0,0,0,172,0.2,50.657153339201,6
2020-09-14-170506,170506,1,0,4,173,4.0,53.48496535877234,0
2020-09-15-170506,170506,0,0,6,173,2.6,67.30760696463523,1
2020-09-16-170506,170506,1,0,7,174,1.4,82.19649874873718,2
2020-09-17-170506,170506,2,1,7,176,0.4,90.01936668005935,3
2020-09-18-170506,170506,0,0,3,176,1.8,95.28273694552833,4
2020-09-19-170506,170506,0,0,3,176,0.8,111.64636836161885,5
2020-09-20-170506,170506,0,0,8,176,2.2,127.57828100506784,6
2020-09-21-170506,170506,2,0,8,178,1.8,130.57393629434708,0
2020-09-22-170506,170506,1,2,3,179,1.6,145.030756830104,1
2020-09-23-170506,170506,1,0,3,180,1.0,133.03057732990635,2
2020-09-24-170506,170506,0,1,11,180,1.4,123.867861223792,3
2020-09-25-170506,170506,0,1,2,180,1.8,117.03916743486253,4
2020-09-26-170506,170506,7,0,2,187,1.0,120.62333037165644,5
2020-09-27-170506,170506,0,0,2,187,0.8,159.77849922287146,6
2020-09-28-170506,170506,4,1,1,191,1.0,144.8545265179207,0
2020-09-29-170506,170506,6,0,5,197,2.2,149.80027177938777,1
2020-09-30-170506,170506,7,0,0,204,1.2,209.85801342242556,2
2020-10-01-170506,170506,7,0,5,211,2.2,0.0,3
2020-10-02-170506,170506,3,0,1,214,1.4,407.11181205628776,4
2020-10-03-170506,170506,3,1,2,217,0.6,528.3680847390659,5
2020-10-04-170506,170506,8,0,4,225,1.0,473.38102302822546,6
2020-10-05-170506,170506,8,0,9,233,2.8,482.3078393323527,0
2020-10-06-170506,170506,3,1,8,236,1.8,524.9723258650765,1
2020-10-07-170506,170506,3,0,2,239,0.8,367.6132777161543,2
2020-10-08-170506,170506,11,0,12,250,2.0,347.2330482580743,3
2020-10-09-170506,170506,2,0,1,252,2.8,424.23588058133305,4
2020-10-10-170506,170506,2,0,13,254,1.8,73.93596011074959,5
2020-10-11-170506,170506,2,0,1,256,0.6,107.35517996361277,6
2020-10-12-170506,170506,1,0,4,257,3.0,133.6733142967702,0
2020-10-13-170506,170506,5,0,1,262,1.6,165.296378264466,1
2020-10-14-170506,170506,0,0,22,262,3.4,220.1987352148932,2
2020-10-15-170506,170506,5,0,3,267,1.8,261.29960359469703,3
2020-10-16-170506,170506,1,0,6,268,0.8,317.89168900485356,4
2020-10-17-170506,170506,2,0,2,270,4.2,285.1796010576935,5
2020-10-18-170506,170506,4,0,10,274,2.2,309.9643806843103,6
2020-10-19-170506,170506,9,1,5,283,2.2,337.0732521005425,0
2020-10-20-170506,170506,8,0,19,291,7.4,372.70622369568065,1
2020-10-21-170506,170506,2,1,7,293,2.4,475.5950896431601,2
2020-10-22-170506,170506,12,0,5,305,3.0,461.57593793282246,3
2020-10-23-170506,170506,1,0,3,306,4.8,535.2701609402288,4
2020-10-24-170506,170506,13,0,7,319,2.6,515.7493922729514,5
2020-10-25-170506,170506,1,0,1,320,1.6,567.5819482098502,6
2020-10-26-170506,170506,4,1,4,324,1.2,494.2279662309555,0
2020-10-27-170506,170506,1,0,1,325,1.6,504.3940119229327,1
2020-10-28-170506,170506,22,1,4,347,3.4,395.0148839946813,2
2020-10-29-170506,170506,3,0,16,350,4.2,540.8092554353976,3
2020-10-30-170506,170506,6,1,0,356,2.8,471.4232212404013,4
2020-10-31-170506,170506,2,0,0,358,1.6,444.8815229390374,5
2020-11-01-170506,170506,10,0,0,368,4.2,361.8124520028688,6
2020-11-02-170506,170506,5,1,0,373,1.2,505.09408304852354,0
2020-11-03-170506,170506,19,1,0,392,0.8,455.3623580335655,1
2020-11-04-170506,170506,7,0,0,399,2.8,531.1869713141893,2
2020-11-05-170506,170506,5,0,0,404,3.6,513.5139333624118,3
2020-11-06-170506,170506,3,1,0,407,2.2,520.5429133434354,4
2020-11-07-170506,170506,7,0,0,414,1.6,470.65831332091864,5
2020-11-08-170506,170506,1,1,0,415,1.0,491.87378646656555,6
2020-11-09-170506,170506,4,0,0,419,2.6,447.85500282441376,0
2020-11-10-170506,170506,1,2,0,420,3.4,398.00766238075073,1
2020-11-11-170506,170506,4,1,0,424,2.4,375.4416586877457,2
2020-11-12-170506,170506,16,2,0,440,3.4,334.2661900825744,3
2020-11-13-170506,170506,0,1,0,440,1.6,439.97187058450675,4
2020-03-01-170507,170507,0,0,1,0,0.0,0.0,6
2020-03-02-170507,170507,0,0,1,0,0.0,8.842576578785609,0
2020-03-03-170507,170507,0,0,0,0,0.0,46.91740189303463,1
2020-03-04-170507,170507,0,0,0,0,0.0,60.00643857383403,2
2020-03-05-170507,170507,0,0,3,0,0.0,65.95631962940121,3
2020-03-06-170507,170507,0,1,4,0,0.0,52.36537025220075,4
2020-03-07-170507,170507,0,0,2,0,0.0,53.366845109060485,5
2020-03-08-170507,170507,0,0,1,0,0.0,43.68519235835033,6
2020-03-09-170507,170507,0,0,6,0,0.0,44.86170196624278,0
2020-03-10-170507,170507,0,0,2,0,0.0,246.18141256675796,1
2020-03-11-170507,170507,0,0,4,0,0.0,212.88787373681197,2
2020-03-12-170507,170507,2,0,2,2,0.2857142857142857,151.90794485399752,3
2020-03-13-170507,170507,1,0,7,3,0.14285714285714285,131.7092070306903,4
2020-03-14-170507,170507,3,0,1,6,0.0,93.17937053104919,5
2020-03-15-170507,170507,1,0,0,7,0.42857142857142855,58.599893515245924,6
2020-03-16-170507,170507,1,0,1,8,0.7142857142857143,29.27260343631987,0
2020-03-17-170507,170507,0,0,1,8,0.8571428571428571,41.77879555987006,1
2020-03-18-170507,170507,0,0,2,8,0.5714285714285714,47.03566447303794,2
2020-03-19-170507,170507,3,0,2,11,1.2857142857142858,54.31313077691309,3
2020-03-20-170507,170507,4,0,0,15,1.0,57.78099659327032,4
2020-03-21-170507,170507,2,0,0,17,1.2857142857142858,66.58586750124144,5
2020-03-22-170507,170507,1,0,0,18,0.5714285714285714,71.77582807751216,6
2020-03-23-170507,170507,6,0,1,24,1.7142857142857142,67.44134678291277,0
2020-03-24-170507,170507,2,0,2,26,1.0,87.42316674136558,1
2020-03-25-170507,170507,4,0,2,30,0.0,90.71406471841927,2
2020-03-26-170507,170507,2,0,0,32,1.8571428571428568,87.83999188655744,3
2020-03-27-170507,170507,7,0,0,39,2.4285714285714284,106.00707717005793,4
2020-03-28-170507,170507,1,0,0,40,0.8571428571428571,118.03604246253384,5
2020-03-29-170507,170507,0,0,0,40,1.4285714285714286,113.89458974901855,6
2020-03-30-170507,170507,1,0,0,41,2.2857142857142856,92.81353789043916,0
2020-03-31-170507,170507,1,0,3,42,0.8571428571428571,101.83699918508889,1
2020-04-01-170507,170507,2,0,1,44,1.5714285714285714,8.99937129645756,2
2020-04-02-170507,170507,2,0,1,46,0.5714285714285714,73.38401116455594,3
2020-04-03-170507,170507,0,0,0,46,1.4285714285714286,35.374257755233316,4
2020-04-04-170507,170507,0,0,0,46,1.0,43.39627740915937,5
2020-04-05-170507,170507,0,0,1,46,1.1428571428571428,44.248927556122354,6
2020-04-06-170507,170507,1,1,1,47,1.1428571428571428,47.65966872229233,0
2020-04-07-170507,170507,2,0,0,49,1.0,52.43131194844434,1
2020-04-08-170507,170507,2,1,1,51,1.4285714285714286,55.06853838563165,2
2020-04-09-170507,170507,0,0,0,51,2.2857142857142856,66.06906477622589,3
2020-04-10-170507,170507,0,0,0,51,4.285714285714286,16.42608804103972,4
2020-04-11-170507,170507,0,0,0,51,0.8571428571428571,33.80932007192019,5
2020-04-12-170507,170507,0,0,0,51,0.5714285714285714,38.358591709979606,6
2020-04-13-170507,170507,0,0,0,51,2.0,40.887217156621475,0
2020-04-14-170507,170507,3,0,2,54,1.2857142857142858,53.86280174971524,1
2020-04-15-170507,170507,1,0,0,55,1.2857142857142858,68.13457739964605,2
2020-04-16-170507,170507,1,0,3,56,0.7142857142857143,78.75575214822769,3
2020-04-17-170507,170507,0,2,4,56,3.1428571428571432,74.69302540140774,4
2020-04-18-170507,170507,0,0,0,56,0.14285714285714285,78.7175064828588,5
2020-04-19-170507,170507,1,0,0,57,0.5714285714285714,75.80703795650184,6
2020-04-20-170507,170507,1,0,3,58,2.7142857142857144,75.49550472057594,0
2020-04-21-170507,170507,0,0,1,58,0.5714285714285714,86.68597865853752,1
2020-04-22-170507,170507,1,0,1,59,0.7142857142857143,78.07168719253353,2
2020-04-23-170507,170507,0,0,1,59,0.7142857142857143,81.49841830336013,3
2020-04-24-170507,170507,0,0,2,59,0.7142857142857143,62.28303729756803,4
2020-04-25-170507,170507,0,0,0,59,1.0,66.11072695963541,5
2020-04-26-170507,170507,0,0,0,59,0.42857142857142855,67.50598096232106,6
2020-04-27-170507,170507,0,0,1,59,0.2857142857142857,59.033856825886126,0
2020-04-28-170507,170507,2,0,1,61,0.2857142857142857,37.97664004247367,1
2020-04-29-170507,170507,0,1,0,61,1.0,41.78068780665616,2
2020-04-30-170507,170507,3,0,0,64,0.2857142857142857,43.295742906017594,3
2020-05-01-170507,170507,4,0,1,68,0.0,80.74780383403655,4
2020-05-02-170507,170507,0,0,0,68,0.5714285714285714,26.792242105363176,5
2020-05-03-170507,170507,0,0,0,68,0.14285714285714285,25.589953810860724,6
2020-05-04-170507,170507,3,0,1,71,1.7142857142857142,29.49387557403174,0
2020-05-05-170507,170507,1,0,0,72,0.42857142857142855,37.26272487593617,1
2020-05-06-170507,170507,1,0,2,73,0.7142857142857143,34.85344420878827,2
2020-05-07-170507,170507,1,0,1,74,0.2857142857142857,40.87702175027282,3
2020-05-08-170507,170507,2,0,5,76,1.1428571428571428,40.9661628920949,4
2020-05-09-170507,170507,0,0,0,76,0.2857142857142857,54.677506968198124,5
2020-05-10-170507,170507,0,0,0,76,0.42857142857142855,85.1923519075018,6
2020-05-11-170507,170507,1,0,1,77,1.1428571428571428,79.7105600232783,0
2020-05-12-170507,170507,1,0,2,78,0.7142857142857143,82.5040231068389,1
2020-05-13-170507,170507,0,0,1,78,0.5714285714285714,79.2430157625347,2
2020-05-14-170507,170507,0,3,0,78,0.42857142857142855,72.87727734043645,3
2020-05-15-170507,170507,1,0,0,79,0.7142857142857143,56.77719985617526,4
2020-05-16-170507,170507,0,0,0,79,0.0,47.53567497304084,5
2020-05-17-170507,170507,0,0,0,79,0.42857142857142855,38.69144844617134,6
2020-05-18-170507,170507,1,0,0,80,0.14285714285714285,39.677709538852426,0
2020-05-19-170507,170507,0,1,1,80,0.5714285714285714,33.957197820117415,1
2020-05-20-170507,170507,2,0,0,82,0.7142857142857143,31.31637242253719,2
2020-05-21-170507,170507,1,0,0,83,0.8571428571428571,38.127507586077826,3
2020-05-22-170507,170507,5,0,2,88,0.5714285714285714,38.90165736699916,4
2020-05-23-170507,170507,0,0,1,88,0.14285714285714285,57.94919152910356,5
2020-05-24-170507,170507,0,0,0,88,0.0,56.86901215550758,6
2020-05-25-170507,170507,1,0,0,89,0.14285714285714285,52.71279574202267,0
2020-05-26-170507,170507,2,0,0,91,0.7142857142857143,51.803495113175956,1
2020-05-27-170507,170507,1,0,1,92,0.2857142857142857,57.27848243778887,2
2020-05-28-170507,170507,0,3,1,92,0.42857142857142855,52.903849634397616,3
2020-05-29-170507,170507,0,0,0,92,0.7142857142857143,45.75351015477212,4
2020-05-30-170507,170507,0,0,0,92,0.14285714285714285,32.0287544376408,5
2020-05-31-170507,170507,0,0,0,92,0.8571428571428571,34.54608972548588,6
2020-06-01-170507,170507,0,0,1,92,0.7142857142857143,69.54096326062249,0
2020-06-02-170507,170507,1,0,0,93,1.2857142857142858,34.61858770724277,1
2020-06-03-170507,170507,0,0,0,93,0.8571428571428571,23.690362565834597,2
2020-06-04-170507,170507,0,0,0,93,0.8571428571428571,30.948644683836683,3
2020-06-05-170507,170507,2,1,0,95,1.1428571428571428,32.522806406657125,4
2020-06-06-170507,170507,1,0,0,96,0.2857142857142857,44.58744688485716,5
2020-06-07-170507,170507,0,0,0,96,0.0,44.02983543498641,6
2020-06-08-170507,170507,0,0,0,96,0.7142857142857143,44.08187807336951,0
2020-06-09-170507,170507,0,0,0,96,0.5714285714285714,49.463178245373555,1
2020-06-10-170507,170507,1,0,0,97,2.2857142857142856,67.91340015957627,2
2020-06-11-170507,170507,1,0,1,98,1.1428571428571428,65.25287939750514,3
2020-06-12-170507,170507,0,0,0,98,0.5714285714285714,73.33220907585421,4
2020-06-13-170507,170507,0,0,1,98,0.14285714285714285,66.84223483784831,5
2020-06-14-170507,170507,0,0,0,98,0.14285714285714285,60.69215288403602,6
2020-06-15-170507,170507,1,0,0,99,2.0,48.412913687849624,0
2020-06-16-170507,170507,0,0,0,99,0.5714285714285714,62.94661137964163,1
2020-06-17-170507,170507,0,0,0,99,0.2857142857142857,59.42770316816201,2
2020-06-18-170507,170507,0,0,0,99,0.42857142857142855,44.40128000057881,3
2020-06-19-170507,170507,0,0,0,99,0.42857142857142855,36.6936851897139,4
2020-06-20-170507,170507,0,0,0,99,0.5714285714285714,44.016016597290516,5
2020-06-21-170507,170507,0,0,1,99,0.42857142857142855,49.911572287665436,6
2020-06-22-170507,170507,0,0,0,99,0.0,37.14082788756555,0
2020-06-23-170507,170507,0,0,1,99,0.42857142857142855,33.58408169130517,1
2020-06-24-170507,170507,0,0,0,99,0.42857142857142855,34.81023411282387,2
2020-06-25-170507,170507,1,0,0,100,0.2857142857142857,36.99469190849631,3
2020-06-26-170507,170507,0,0,0,100,0.42857142857142855,37.04560428804123,4
2020-06-27-170507,170507,1,0,0,101,0.14285714285714285,29.06155988669663,5
2020-06-28-170507,170507,0,0,0,101,0.0,30.323689901847438,6
2020-06-29-170507,170507,0,0,0,101,0.2857142857142857,25.7332194080547,0
2020-06-30-170507,170507,0,0,0,101,0.7142857142857143,35.28904786316175,1
2020-07-01-170507,170507,0,0,0,101,0.42857142857142855,54.574206446169796,2
2020-07-02-170507,170507,0,0,0,101,0.8571428571428571,35.129123411840176,3
2020-07-03-170507,170507,0,0,0,101,0.14285714285714285,45.4089135769436,4
2020-07-04-170507,170507,0,0,0,101,0.2857142857142857,38.794125766928794,5
2020-07-05-170507,170507,1,0,0,102,0.42857142857142855,41.26021436092772,6
2020-07-06-170507,170507,0,0,0,102,1.7142857142857142,38.77872088329765,0
2020-07-07-170507,170507,1,1,0,103,0.42857142857142855,47.74329973991213,1
2020-07-08-170507,170507,0,0,0,103,0.42857142857142855,37.939501266428444,2
2020-07-09-170507,170507,0,0,0,103,0.14285714285714285,39.45774276032097,3
2020-07-10-170507,170507,0,0,0,103,0.5714285714285714,54.44475900468997,4
2020-07-11-170507,170507,0,0,0,103,0.2857142857142857,54.28147990186035,5
2020-07-12-170507,170507,0,0,0,103,0.42857142857142855,36.512130988780754,6
2020-07-13-170507,170507,0,0,0,103,0.14285714285714285,32.48550894211164,0
2020-07-14-170507,170507,0,0,0,103,0.2857142857142857,35.002184637429934,1
2020-07-15-170507,170507,0,0,0,103,1.0,30.26490810442062,2
2020-07-16-170507,170507,0,0,0,103,1.2857142857142858,28.279147346294046,3
2020-07-17-170507,170507,0,0,0,103,0.14285714285714285,39.26976445274012,4
2020-07-18-170507,170507,0,0,0,103,0.0,38.85353889880795,5
2020-07-19-170507,170507,0,0,0,103,0.14285714285714285,38.18393829562651,6
2020-07-20-170507,170507,0,0,0,103,0.0,45.188785362386994,0
2020-07-21-170507,170507,0,0,0,103,0.2857142857142857,40.76598847255063,1
2020-07-22-170507,170507,0,0,2,103,0.0,40.57549629747977,2
2020-07-23-170507,170507,0,0,0,103,0.14285714285714285,25.481907506346513,3
2020-07-24-170507,170507,0,0,0,103,0.5714285714285714,24.063678783664535,4
2020-07-25-170507,170507,0,0,0,103,0.8571428571428571,31.371752023380306,5
2020-07-26-170507,170507,0,0,0,103,0.14285714285714285,35.37350377474398,6
2020-07-27-170507,170507,0,0,0,103,0.5714285714285714,27.11197584352517,0
2020-07-28-170507,170507,0,0,4,103,0.7142857142857143,34.4282359853015,1
2020-07-29-170507,170507,0,0,0,103,1.2857142857142858,35.59259624829798,2
2020-07-30-170507,170507,0,0,0,103,0.2857142857142857,53.94159951856727,3
2020-07-31-170507,170507,0,0,0,103,0.8571428571428571,49.20388078223245,4
2020-08-01-170507,170507,0,0,0,103,0.2857142857142857,42.04566154702813,5
2020-08-02-170507,170507,0,0,1,103,0.2857142857142857,130.79042556246566,6
2020-08-03-170507,170507,0,0,0,103,0.42857142857142855,243.8149261971093,0
2020-08-04-170507,170507,0,0,0,103,1.0,175.60653756134246,1
2020-08-05-170507,170507,2,0,0,105,1.1428571428571428,122.80462986247505,2
2020-08-06-170507,170507,0,0,0,105,0.7142857142857143,96.9545992815649,3
2020-08-07-170507,170507,0,0,0,105,0.5714285714285714,96.76809491720212,4
2020-08-08-170507,170507,0,0,0,105,0.7142857142857143,97.37909498453453,5
2020-08-09-170507,170507,0,0,0,105,0.14285714285714285,96.59354697532459,6
2020-08-10-170507,170507,0,0,0,105,1.5714285714285714,46.4478178775225,0
2020-08-11-170507,170507,4,0,1,109,0.8571428571428571,61.445370007173324,1
2020-08-12-170507,170507,0,0,0,109,3.7142857142857135,80.13236423149387,2
2020-08-13-170507,170507,0,0,1,109,2.2857142857142856,110.14721262062966,3
2020-08-14-170507,170507,0,0,0,109,2.142857142857143,134.45912958952167,4
2020-08-15-170507,170507,0,0,0,109,0.5714285714285714,150.1707608910316,5
2020-08-16-170507,170507,1,0,3,110,1.2857142857142858,161.8761558286411,6
2020-08-17-170507,170507,0,0,0,110,1.1428571428571428,174.3153815677913,0
2020-08-18-170507,170507,0,0,0,110,3.1428571428571432,173.7220914209234,1
2020-08-19-170507,170507,0,0,0,110,1.2857142857142858,178.64719467458,2
2020-08-20-170507,170507,0,0,0,110,0.8571428571428571,121.06767922315984,3
2020-08-21-170507,170507,0,0,0,110,2.2857142857142856,112.1177259043286,4
2020-08-22-170507,170507,0,0,0,110,0.7142857142857143,139.4318821794637,5
2020-08-23-170507,170507,0,0,0,110,2.571428571428572,135.45624200308822,6
2020-08-24-170507,170507,0,0,0,110,3.571428571428572,140.72421233446937,0
2020-08-25-170507,170507,1,0,1,111,3.1428571428571432,153.2538903096105,1
2020-08-26-170507,170507,0,0,0,111,2.7142857142857144,191.216445224671,2
2020-08-27-170507,170507,1,0,0,112,4.428571428571429,257.9422949449017,3
2020-08-28-170507,170507,0,0,1,112,1.1428571428571428,287.0311995289696,4
2020-08-29-170507,170507,0,0,1,112,0.5714285714285714,258.1182422567903,5
2020-08-30-170507,170507,3,0,2,115,0.7142857142857143,226.52132601237537,6
2020-08-31-170507,170507,0,0,0,115,1.5714285714285714,200.46015489840065,0
2020-09-01-170507,170507,0,0,1,115,1.2857142857142858,74.23192764751501,1
2020-09-02-170507,170507,0,0,1,115,1.7142857142857142,172.01657923789168,2
2020-09-03-170507,170507,0,0,0,115,2.2857142857142856,153.33015719513034,3
2020-09-04-170507,170507,0,0,1,115,1.7142857142857142,142.04755948822327,4
2020-09-05-170507,170507,0,0,0,115,0.42857142857142855,137.00675881816554,5
2020-09-06-170507,170507,0,0,0,115,0.2857142857142857,119.40632566148474,6
2020-09-07-170507,170507,0,0,0,115,0.7142857142857143,111.49177714471503,0
2020-09-08-170507,170507,1,0,0,116,2.2857142857142856,102.77629246463738,1
2020-09-09-170507,170507,0,0,4,116,1.4285714285714286,96.80051056275495,2
2020-09-10-170507,170507,0,0,2,116,3.0,60.9909885012396,3
2020-09-11-170507,170507,1,0,0,117,1.8571428571428568,72.45596700850403,4
2020-09-12-170507,170507,1,0,3,118,1.0,82.43316966189491,5
2020-09-13-170507,170507,2,0,2,120,0.7142857142857143,91.0527820630096,6
2020-09-14-170507,170507,0,0,1,120,3.1428571428571432,103.54472299478795,0
2020-09-15-170507,170507,1,0,2,121,2.4285714285714284,132.36150044530902,1
2020-09-16-170507,170507,1,0,1,122,2.2857142857142856,150.66210697594755,2
2020-09-17-170507,170507,0,0,0,122,1.8571428571428568,163.73221011132705,3
2020-09-18-170507,170507,1,0,5,123,3.0,162.68995060630792,4
2020-09-19-170507,170507,0,0,5,123,1.4285714285714286,158.8012631478399,5
2020-09-20-170507,170507,0,0,0,123,2.142857142857143,147.34794070641306,6
2020-09-21-170507,170507,0,0,1,123,1.1428571428571428,133.43206908725512,0
2020-09-22-170507,170507,0,0,1,123,1.5714285714285714,123.17706475938866,1
2020-09-23-170507,170507,4,0,1,127,2.0,108.71551221047444,2
2020-09-24-170507,170507,2,1,0,129,1.5714285714285714,112.32881226652358,3
2020-09-25-170507,170507,0,0,0,129,1.8571428571428568,105.81867951135368,4
2020-09-26-170507,170507,3,1,1,132,1.2857142857142858,106.33308700237228,5
2020-09-27-170507,170507,2,0,0,134,1.2857142857142858,118.67808198969149,6
2020-09-28-170507,170507,1,0,1,135,0.5714285714285714,116.64892355850228,0
2020-09-29-170507,170507,2,0,0,137,1.8571428571428568,120.39995492702569,1
2020-09-30-170507,170507,1,0,1,138,1.5714285714285714,125.87696057147849,2
2020-10-01-170507,170507,0,0,0,138,2.4285714285714284,0.0,3
2020-10-02-170507,170507,5,0,0,143,1.8571428571428568,283.1189881601026,4
2020-10-03-170507,170507,5,0,1,148,1.0,441.11757245838345,5
2020-10-04-170507,170507,0,0,1,148,1.2857142857142858,362.4621060177468,6
2020-10-05-170507,170507,1,0,1,149,2.2857142857142856,326.61605307055424,0
2020-10-06-170507,170507,1,0,3,150,2.571428571428572,292.6320971694608,1
2020-10-07-170507,170507,1,1,0,151,1.2857142857142858,250.0015739827581,2
2020-10-08-170507,170507,0,0,5,151,1.8571428571428568,179.29343484346458,3
2020-10-09-170507,170507,0,0,8,151,1.8571428571428568,177.43418814627842,4
2020-10-10-170507,170507,1,0,2,152,3.0,22.486520075029972,5
2020-10-11-170507,170507,0,0,5,152,1.7142857142857142,55.57945520342254,6
2020-10-12-170507,170507,1,0,3,153,2.4285714285714284,76.43539879190294,0
2020-10-13-170507,170507,0,0,7,153,3.2857142857142856,102.68314971035437,1
2020-10-14-170507,170507,1,0,6,154,4.571428571428571,131.23084985282193,2
2020-10-15-170507,170507,0,0,6,154,2.142857142857143,182.71862527102692,3
2020-10-16-170507,170507,0,0,6,154,4.571428571428571,208.04492081154035,4
2020-10-17-170507,170507,1,0,2,155,5.571428571428571,228.98960006852133,5
2020-10-18-170507,170507,1,0,1,156,4.285714285714286,236.87645194454586,6
2020-10-19-170507,170507,1,0,2,157,3.1428571428571432,252.82911816676864,0
2020-10-20-170507,170507,3,0,7,160,9.714285714285714,270.0478488309715,1
2020-10-21-170507,170507,0,0,0,160,4.285714285714286,307.2407838377087,2
2020-10-22-170507,170507,5,0,6,165,8.142857142857142,310.49111771866893,3
2020-10-23-170507,170507,8,0,0,173,5.428571428571429,332.6484522694001,4
2020-10-24-170507,170507,2,0,2,175,4.857142857142857,345.15686034151213,5
2020-10-25-170507,170507,5,0,6,180,5.0,344.7191423883745,6
2020-10-26-170507,170507,3,1,0,183,4.0,357.3841087058571,0
2020-10-27-170507,170507,7,0,3,190,4.571428571428571,362.5294296962138,1
2020-10-28-170507,170507,6,0,1,196,5.142857142857143,330.79927056644635,2
2020-10-29-170507,170507,6,0,3,202,7.7142857142857135,359.2002833597331,3
2020-10-30-170507,170507,6,0,2,208,4.285714285714286,337.13127317979297,4
2020-10-31-170507,170507,2,0,0,210,2.2857142857142856,349.3902132648892,5
2020-11-01-170507,170507,1,0,0,211,3.571428571428572,135.95011869638608,6
2020-11-02-170507,170507,2,0,0,213,3.2857142857142856,246.3994924252405,0
2020-11-03-170507,170507,7,1,0,220,4.428571428571429,239.4526340159536,1
2020-11-04-170507,170507,0,0,0,220,4.0,260.18799544394,2
2020-11-05-170507,170507,6,0,0,226,4.428571428571429,255.86249379965824,3
2020-11-06-170507,170507,0,0,0,226,2.142857142857143,275.4370686065268,4
2020-11-07-170507,170507,2,1,0,228,3.7142857142857135,256.1657425771981,5
2020-11-08-170507,170507,6,0,0,234,3.0,268.07194684638273,6
2020-11-09-170507,170507,0,0,0,234,3.4285714285714284,259.73593764398584,0
2020-11-10-170507,170507,3,1,0,237,2.7142857142857144,129.6258585627943,1
2020-11-11-170507,170507,1,1,0,238,1.0,143.1133180098388,2
2020-11-12-170507,170507,3,1,0,241,4.142857142857143,138.5379328586164,3
2020-11-13-170507,170507,2,0,0,243,3.8571428571428568,161.68452228181354,4
2020-03-01-170508,170508,0,0,4,0,0.0,0.0,6
2020-03-02-170508,170508,0,0,1,0,0.0,80.69409639828453,0
2020-03-03-170508,170508,0,1,12,0,0.0,525.158605759415,1
2020-03-04-170508,170508,0,0,15,0,0.0,588.5992242447944,2
2020-03-05-170508,170508,0,0,20,0,0.0,609.448761390031,3
2020-03-06-170508,170508,0,0,12,0,0.0,528.4912899434668,4
2020-03-07-170508,170508,0,2,5,0,0.0,523.8337401413779,5
2020-03-08-170508,170508,0,0,8,0,0.0,508.07280564672334,6
2020-03-09-170508,170508,1,0,23,1,0.6666666666666666,510.7210304981596,0
2020-03-10-170508,170508,0,0,22,1,0.6666666666666666,1901.6883827616412,1
2020-03-11-170508,170508,0,0,19,1,1.0,1711.4094077512118,2
2020-03-12-170508,170508,1,0,21,2,1.0,1422.0746418036542,3
2020-03-13-170508,170508,1,0,15,3,0.6666666666666666,1237.3686240513518,4
2020-03-14-170508,170508,1,0,10,4,0.6666666666666666,379.59848978169356,5
2020-03-15-170508,170508,4,0,7,8,1.3333333333333333,282.0380096421512,6
2020-03-16-170508,170508,1,0,14,9,4.333333333333333,73.6515934591096,0
2020-03-17-170508,170508,12,0,14,21,6.333333333333332,161.94392684507278,1
2020-03-18-170508,170508,15,0,15,36,11.0,236.8466604797622,2
2020-03-19-170508,170508,20,1,15,56,12.666666666666664,339.8080666993186,3
2020-03-20-170508,170508,12,0,30,68,9.666666666666666,431.75380012297427,4
2020-03-21-170508,170508,5,0,3,73,9.333333333333334,521.6025482605038,5
2020-03-22-170508,170508,8,1,6,81,8.0,564.5801823798,6
2020-03-23-170508,170508,23,0,17,104,18.666666666666668,561.2770008580128,0
2020-03-24-170508,170508,22,0,12,126,15.666666666666664,712.672686833235,1
2020-03-25-170508,170508,19,0,32,145,19.0,810.55027445699,2
2020-03-26-170508,170508,21,0,16,166,19.33333333333333,841.3871258369346,3
2020-03-27-170508,170508,15,0,11,181,15.666666666666664,1022.3721742674991,4
2020-03-28-170508,170508,10,0,1,191,7.0,1077.5770211777317,5
2020-03-29-170508,170508,7,0,4,198,5.0,1066.5869881015296,6
2020-03-30-170508,170508,14,0,12,212,17.666666666666668,832.829272111514,0
2020-03-31-170508,170508,14,0,31,226,11.333333333333336,782.0910909172135,1
2020-04-01-170508,170508,15,0,29,241,5.666666666666668,113.91299923727317,2
2020-04-02-170508,170508,15,0,8,256,10.666666666666666,333.13421199773234,3
2020-04-03-170508,170508,30,0,9,286,7.666666666666668,232.72220529229787,4
2020-04-04-170508,170508,3,0,12,289,2.0,281.5028570474787,5
2020-04-05-170508,170508,6,1,0,295,5.333333333333333,298.68710279262655,6
2020-04-06-170508,170508,17,4,10,312,9.333333333333334,347.36488135553554,0
2020-04-07-170508,170508,12,0,16,324,6.333333333333332,423.28423876812747,1
2020-04-08-170508,170508,32,0,2,356,8.666666666666666,451.99555784260633,2
2020-04-09-170508,170508,16,0,2,372,6.333333333333332,501.2077801230041,3
2020-04-10-170508,170508,11,1,16,383,9.0,107.49521005699798,4
2020-04-11-170508,170508,1,0,4,384,8.666666666666666,172.72906423088435,5
2020-04-12-170508,170508,4,0,2,388,0.6666666666666666,231.12327078456732,6
2020-04-13-170508,170508,12,0,6,400,3.333333333333333,245.48886405860748,0
2020-04-14-170508,170508,31,0,10,431,6.333333333333332,303.2149129921018,1
2020-04-15-170508,170508,29,0,5,460,4.666666666666667,373.6296722378395,2
2020-04-16-170508,170508,8,0,7,468,4.0,438.1326142271724,3
2020-04-17-170508,170508,9,0,1,477,4.0,417.9785092832231,4
2020-04-18-170508,170508,12,0,2,489,1.3333333333333333,408.61831848700047,5
2020-04-19-170508,170508,0,0,4,489,2.0,363.6777983983638,6
2020-04-20-170508,170508,10,0,5,499,4.666666666666667,414.4799137365386,0
2020-04-21-170508,170508,16,0,3,515,7.333333333333332,404.68006069152426,1
2020-04-22-170508,170508,2,1,6,517,6.333333333333332,382.9449407716511,2
2020-04-23-170508,170508,2,0,8,519,3.333333333333333,386.0261057829938,3
2020-04-24-170508,170508,16,0,11,535,4.666666666666667,338.7288780417476,4
2020-04-25-170508,170508,4,0,2,539,1.3333333333333333,373.48210760136,5
2020-04-26-170508,170508,2,0,1,541,1.3333333333333333,373.52925824684723,6
2020-04-27-170508,170508,6,1,5,547,4.0,299.69346356896483,0
2020-04-28-170508,170508,10,0,5,557,3.333333333333333,276.3817078421148,1
2020-04-29-170508,170508,5,0,6,562,3.333333333333333,289.64741612704506,2
2020-04-30-170508,170508,7,0,5,569,3.0,322.3481316506366,3
2020-05-01-170508,170508,1,0,0,570,1.3333333333333333,590.8344880007689,4
2020-05-02-170508,170508,2,0,0,572,1.3333333333333333,227.85542913856602,5
2020-05-03-170508,170508,4,0,2,576,0.0,128.73025767653075,6
2020-05-04-170508,170508,5,0,8,581,4.666666666666667,135.65490741763628,0
2020-05-05-170508,170508,3,0,8,584,3.0,157.5490086095214,1
2020-05-06-170508,170508,6,0,5,590,2.6666666666666665,170.75887618962696,2
2020-05-07-170508,170508,8,0,6,598,3.333333333333333,201.66125660811903,3
2020-05-08-170508,170508,11,0,5,609,5.0,238.59464610913554,4
2020-05-09-170508,170508,2,1,1,611,1.6666666666666667,287.19625565318177,5
2020-05-10-170508,170508,1,0,0,612,1.0,685.7738844516226,6
2020-05-11-170508,170508,5,0,3,617,4.0,652.9104991821209,0
2020-05-12-170508,170508,5,1,2,622,4.0,607.1376348800077,1
2020-05-13-170508,170508,6,0,8,628,3.333333333333333,514.9616503214835,2
2020-05-14-170508,170508,5,0,5,633,3.6666666666666665,458.6765742245434,3
2020-05-15-170508,170508,0,1,3,633,3.333333333333333,384.39395443653035,4
2020-05-16-170508,170508,0,0,2,633,0.3333333333333333,284.45187980432786,5
2020-05-17-170508,170508,2,0,1,635,0.0,244.21914412056674,6
2020-05-18-170508,170508,8,0,6,643,4.333333333333333,243.31150415083573,0
2020-05-19-170508,170508,8,0,4,651,5.0,227.06847466775966,1
2020-05-20-170508,170508,5,0,5,656,0.6666666666666666,237.00572367615604,2
2020-05-21-170508,170508,6,0,6,662,1.6666666666666667,232.3669246405646,3
2020-05-22-170508,170508,5,0,0,667,2.333333333333333,222.65226856423106,4
2020-05-23-170508,170508,1,0,1,668,0.6666666666666666,285.7951165401171,5
2020-05-24-170508,170508,0,0,1,668,0.0,290.3577865733744,6
2020-05-25-170508,170508,3,0,7,671,2.6666666666666665,253.632111295213,0
2020-05-26-170508,170508,2,0,1,673,4.0,167.82500591056854,1
2020-05-27-170508,170508,8,0,3,681,4.0,200.32956909878973,2
2020-05-28-170508,170508,5,0,3,686,2.333333333333333,215.2869878718663,3
2020-05-29-170508,170508,3,0,1,689,2.333333333333333,214.85079978372676,4
2020-05-30-170508,170508,2,0,2,691,0.3333333333333333,182.45550184909442,5
2020-05-31-170508,170508,1,0,0,692,1.0,199.11244280888627,6
2020-06-01-170508,170508,6,0,1,698,2.6666666666666665,341.32853251374763,0
2020-06-02-170508,170508,4,0,1,702,1.6666666666666667,119.42235985043139,1
2020-06-03-170508,170508,5,0,2,707,1.0,74.02616765808642,2
2020-06-04-170508,170508,6,0,2,713,2.0,79.46728989247285,3
2020-06-05-170508,170508,0,0,0,713,1.6666666666666667,70.82389290717617,4
2020-06-06-170508,170508,1,0,1,714,0.3333333333333333,70.89049292551545,5
2020-06-07-170508,170508,1,0,0,715,0.0,65.48881749327873,6
2020-06-08-170508,170508,7,0,2,722,3.333333333333333,69.21531016767915,0
2020-06-09-170508,170508,1,0,1,723,1.0,85.79224231460951,1
2020-06-10-170508,170508,3,0,0,726,1.3333333333333333,390.9978841195858,2
2020-06-11-170508,170508,3,0,1,729,1.3333333333333333,345.7942855826841,3
2020-06-12-170508,170508,1,0,1,730,2.333333333333333,302.774138699214,4
2020-06-13-170508,170508,2,0,0,732,1.0,270.36046197232434,5
2020-06-14-170508,170508,0,0,0,732,0.0,201.5670030370602,6
2020-06-15-170508,170508,1,0,1,733,1.6666666666666667,143.60179629853045,0
2020-06-16-170508,170508,1,0,0,734,0.6666666666666666,137.26298570392692,1
2020-06-17-170508,170508,2,0,1,736,1.3333333333333333,129.74075804512114,2
2020-06-18-170508,170508,2,0,2,738,0.6666666666666666,127.04689457002874,3
2020-06-19-170508,170508,0,0,0,738,2.333333333333333,122.23152034174717,4
2020-06-20-170508,170508,1,0,2,739,0.6666666666666666,137.08458005115494,5
2020-06-21-170508,170508,0,0,0,739,0.6666666666666666,143.85701288245713,6
2020-06-22-170508,170508,2,0,0,741,0.6666666666666666,140.82521064192755,0
2020-06-23-170508,170508,1,0,0,742,0.6666666666666666,123.89411478220583,1
2020-06-24-170508,170508,0,1,0,742,0.6666666666666666,117.30537139509764,2
2020-06-25-170508,170508,1,0,2,743,0.3333333333333333,114.42693397752288,3
2020-06-26-170508,170508,1,0,0,744,1.0,91.67293300072231,4
2020-06-27-170508,170508,0,0,0,744,0.3333333333333333,91.9811525549342,5
2020-06-28-170508,170508,0,0,1,744,0.0,95.52465020461747,6
2020-06-29-170508,170508,1,0,1,745,1.6666666666666667,89.47536283003008,0
2020-06-30-170508,170508,0,0,1,745,0.3333333333333333,88.63211542604641,1
2020-07-01-170508,170508,1,0,1,746,0.3333333333333333,88.67382138151902,2
2020-07-02-170508,170508,2,0,2,748,1.0,45.67627176679588,3
2020-07-03-170508,170508,0,0,1,748,0.6666666666666666,77.88778872340218,4
2020-07-04-170508,170508,2,0,1,750,1.0,97.53268260940794,5
2020-07-05-170508,170508,0,0,0,750,0.0,102.15286449670484,6
2020-07-06-170508,170508,0,0,1,750,0.0,99.35501328069032,0
2020-07-07-170508,170508,0,0,0,750,1.3333333333333333,101.2229485895601,1
2020-07-08-170508,170508,0,0,3,750,1.0,93.74379170249168,2
2020-07-09-170508,170508,2,0,0,752,1.6666666666666667,84.16361533690639,3
2020-07-10-170508,170508,0,0,0,752,1.6666666666666667,80.75176849214407,4
2020-07-11-170508,170508,0,0,0,752,0.0,100.74773454129753,5
2020-07-12-170508,170508,1,0,0,753,0.3333333333333333,86.77596182229462,6
2020-07-13-170508,170508,1,0,0,754,0.6666666666666666,83.3885587340121,0
2020-07-14-170508,170508,1,0,0,755,2.333333333333333,83.2116447214899,1
2020-07-15-170508,170508,1,0,0,756,0.3333333333333333,66.07113154757303,2
2020-07-16-170508,170508,2,0,0,758,1.0,72.91352684953237,3
2020-07-17-170508,170508,1,0,3,759,0.3333333333333333,70.91925465119184,4
2020-07-18-170508,170508,1,0,1,760,0.3333333333333333,35.09359934853583,5
2020-07-19-170508,170508,0,0,1,760,0.6666666666666666,40.76974071606395,6
2020-07-20-170508,170508,1,0,2,761,0.0,46.10329427856425,0
2020-07-21-170508,170508,0,0,1,761,0.6666666666666666,39.27695240478744,1
2020-07-22-170508,170508,3,0,1,764,0.6666666666666666,26.004415609379535,2
2020-07-23-170508,170508,0,0,1,764,1.6666666666666667,42.03524390354136,3
2020-07-24-170508,170508,0,0,1,764,0.3333333333333333,84.28099506223009,4
2020-07-25-170508,170508,0,0,2,764,0.0,87.27809790682832,5
2020-07-26-170508,170508,0,0,1,764,0.0,84.59082359347076,6
2020-07-27-170508,170508,0,0,2,764,0.0,77.64154924768363,0
2020-07-28-170508,170508,0,0,4,764,0.0,79.0858110514622,1
2020-07-29-170508,170508,0,0,1,764,0.6666666666666666,80.04262590444128,2
2020-07-30-170508,170508,0,0,0,764,1.0,47.7527082775722,3
2020-07-31-170508,170508,3,0,1,767,0.0,80.14553058190812,4
2020-08-01-170508,170508,1,0,6,768,0.6666666666666666,46.39077487923654,5
2020-08-02-170508,170508,1,0,0,769,0.0,377.5592721757514,6
2020-08-03-170508,170508,2,0,2,771,0.6666666666666666,262.48984508513917,0
2020-08-04-170508,170508,1,0,1,772,0.6666666666666666,259.39348261775456,1
2020-08-05-170508,170508,1,0,6,773,1.6666666666666667,241.847247122073,2
2020-08-06-170508,170508,1,0,2,774,1.3333333333333333,242.22974267542142,3
2020-08-07-170508,170508,1,0,4,775,1.6666666666666667,243.34553777086384,4
2020-08-08-170508,170508,2,0,4,777,1.3333333333333333,248.276719977313,5
2020-08-09-170508,170508,1,0,2,778,1.3333333333333333,234.745571321727,6
2020-08-10-170508,170508,2,1,3,780,0.0,36.19652116917723,0
2020-08-11-170508,170508,4,0,0,784,1.6666666666666667,41.331847415416064,1
2020-08-12-170508,170508,1,0,6,785,1.6666666666666667,61.14606021533423,2
2020-08-13-170508,170508,0,0,2,785,3.333333333333333,100.9482364424378,3
2020-08-14-170508,170508,1,0,9,786,2.6666666666666665,126.98286719405084,4
2020-08-15-170508,170508,6,1,3,792,2.6666666666666665,202.64002523655967,5
2020-08-16-170508,170508,0,1,3,792,1.0,209.91257022012658,6
2020-08-17-170508,170508,2,0,2,794,3.0,217.81062610810298,0
2020-08-18-170508,170508,1,0,1,795,0.0,237.47525039347113,1
2020-08-19-170508,170508,6,0,0,801,2.6666666666666665,244.38113970708326,2
2020-08-20-170508,170508,2,0,3,803,1.6666666666666667,328.3169249902521,3
2020-08-21-170508,170508,4,0,6,807,2.0,263.90693458454,4
2020-08-22-170508,170508,4,0,7,811,4.333333333333333,312.80227668797124,5
2020-08-23-170508,170508,2,0,7,813,2.6666666666666665,359.33372609835413,6
2020-08-24-170508,170508,3,0,7,816,3.6666666666666665,341.86749225677,0
2020-08-25-170508,170508,0,0,3,816,4.666666666666667,362.65227112058324,1
2020-08-26-170508,170508,6,0,3,822,3.333333333333333,219.59678912580347,2
2020-08-27-170508,170508,2,0,11,824,0.6666666666666666,268.74256784720114,3
2020-08-28-170508,170508,9,0,8,833,4.0,290.7343839230108,4
2020-08-29-170508,170508,3,0,9,836,4.666666666666667,252.7223627796581,5
2020-08-30-170508,170508,3,0,18,839,1.3333333333333333,264.44899165557877,6
2020-08-31-170508,170508,2,0,2,841,3.333333333333333,244.7645573192722,0
2020-09-01-170508,170508,1,1,5,842,2.0,227.91741706348012,1
2020-09-02-170508,170508,0,1,7,842,6.0,607.7437151723254,2
2020-09-03-170508,170508,3,0,3,845,7.0,674.5677128113637,3
2020-09-04-170508,170508,6,0,14,851,5.0,689.0588761714644,4
2020-09-05-170508,170508,7,1,4,858,3.6666666666666665,687.743371799113,5
2020-09-06-170508,170508,7,1,23,865,6.333333333333332,638.4303919147833,6
2020-09-07-170508,170508,7,0,7,872,5.666666666666668,584.3393144880762,0
2020-09-08-170508,170508,3,0,8,875,6.666666666666668,576.1000912279928,1
2020-09-09-170508,170508,3,0,10,878,3.6666666666666665,621.5733586131446,2
2020-09-10-170508,170508,11,1,11,889,4.333333333333333,315.1313550385229,3
2020-09-11-170508,170508,8,0,12,897,5.333333333333333,361.7553869432597,4
2020-09-12-170508,170508,9,0,5,906,5.333333333333333,409.8873280507922,5
2020-09-13-170508,170508,18,0,4,924,5.0,446.8669808643748,6
2020-09-14-170508,170508,2,1,1,926,6.333333333333332,452.2546112999321,0
2020-09-15-170508,170508,5,0,10,931,10.0,554.7769629632853,1
2020-09-16-170508,170508,7,0,9,938,6.666666666666668,650.5729162354203,2
2020-09-17-170508,170508,3,0,3,941,10.333333333333334,626.5684639381794,3
2020-09-18-170508,170508,14,0,20,955,10.333333333333334,623.905274885115,4
2020-09-19-170508,170508,4,0,12,959,4.0,654.4994614055598,5
2020-09-20-170508,170508,23,0,6,982,9.0,603.5563730877087,6
2020-09-21-170508,170508,7,1,18,989,7.333333333333332,631.5161275163289,0
2020-09-22-170508,170508,8,1,6,997,6.333333333333332,624.9032994522437,1
2020-09-23-170508,170508,10,0,6,1007,11.666666666666664,620.8737596128282,2
2020-09-24-170508,170508,11,0,10,1018,5.666666666666668,651.5816910934369,3
2020-09-25-170508,170508,12,0,24,1030,7.333333333333332,645.4831483094363,4
2020-09-26-170508,170508,5,0,16,1035,7.666666666666668,668.4206046434765,5
2020-09-27-170508,170508,4,0,1,1039,8.333333333333334,758.6618019394298,6
2020-09-28-170508,170508,1,0,14,1040,10.333333333333334,752.7801592977519,0
2020-09-29-170508,170508,10,0,8,1050,6.666666666666668,754.8814109461414,1
2020-09-30-170508,170508,9,0,8,1059,7.333333333333332,728.2262350325682,2
2020-10-01-170508,170508,3,1,11,1062,5.666666666666668,0.0,3
2020-10-02-170508,170508,20,0,33,1082,9.666666666666666,1143.2112852493092,4
2020-10-03-170508,170508,12,0,31,1094,9.666666666666666,1039.9597258574313,5
2020-10-04-170508,170508,6,0,4,1100,3.0,1083.9292577313704,6
2020-10-05-170508,170508,18,1,8,1118,5.666666666666668,999.3702023664007,0
2020-10-06-170508,170508,6,0,7,1124,5.0,921.1848556655043,1
2020-10-07-170508,170508,6,1,9,1130,5.0,857.8878957828297,2
2020-10-08-170508,170508,10,0,21,1140,4.0,798.4296179574275,3
2020-10-09-170508,170508,24,0,19,1164,10.0,874.7933601872342,4
2020-10-10-170508,170508,16,0,17,1180,7.0,96.18265926397592,5
2020-10-11-170508,170508,1,0,6,1181,2.6666666666666665,209.65114314749007,6
2020-10-12-170508,170508,14,0,20,1195,5.0,236.09440109872236,0
2020-10-13-170508,170508,8,0,19,1203,6.333333333333332,335.7333421548301,1
2020-10-14-170508,170508,8,0,20,1211,9.333333333333334,460.2895939633112,2
2020-10-15-170508,170508,11,0,11,1222,12.0,637.1633702579591,3
2020-10-16-170508,170508,33,0,22,1255,13.666666666666664,820.0072220353704,4
2020-10-17-170508,170508,31,0,17,1286,12.666666666666664,946.3354646342775,5
2020-10-18-170508,170508,4,1,8,1290,4.666666666666667,999.7244091144668,6
2020-10-19-170508,170508,8,0,11,1298,9.333333333333334,1026.6967752899536,0
2020-10-20-170508,170508,7,0,9,1305,8.333333333333334,1096.2207106964738,1
2020-10-21-170508,170508,9,2,19,1314,3.6666666666666665,1035.1958052646078,2
2020-10-22-170508,170508,21,0,21,1335,8.666666666666666,903.2458496836433,3
2020-10-23-170508,170508,19,0,64,1354,11.333333333333336,838.1030329790758,4
2020-10-24-170508,170508,17,1,23,1371,8.0,794.6679553140038,5
2020-10-25-170508,170508,6,0,4,1377,13.666666666666664,870.4230083591594,6
2020-10-26-170508,170508,20,1,22,1397,10.0,843.9082442700942,0
2020-10-27-170508,170508,19,1,8,1416,9.666666666666666,825.3763533788164,1
2020-10-28-170508,170508,20,1,6,1436,10.333333333333334,868.5478408410946,2
2020-10-29-170508,170508,11,3,12,1447,16.666666666666668,979.7074689011275,3
2020-10-30-170508,170508,22,0,10,1469,13.666666666666664,978.3167608182257,4
2020-10-31-170508,170508,17,3,0,1486,14.333333333333336,1005.0902678291138,5
2020-11-01-170508,170508,8,1,0,1494,4.333333333333333,887.5800643436927,6
2020-11-02-170508,170508,11,2,0,1505,12.666666666666664,1132.6804521597496,0
2020-11-03-170508,170508,9,3,0,1514,7.666666666666668,949.4196334987589,1
2020-11-04-170508,170508,19,1,0,1533,10.0,977.2439227242903,2
2020-11-05-170508,170508,21,2,0,1554,10.0,990.574623943105,3
2020-11-06-170508,170508,64,4,0,1618,14.333333333333336,1119.8508953577098,4
2020-11-07-170508,170508,23,1,0,1641,24.66666666666667,1078.226611757412,5
2020-11-08-170508,170508,4,2,0,1645,7.333333333333332,1701.0291834540653,6
2020-11-09-170508,170508,22,2,0,1667,8.666666666666666,1636.6591697154684,0
2020-11-10-170508,170508,8,3,0,1675,9.0,803.6034140452688,1
2020-11-11-170508,170508,6,5,0,1681,7.0,862.9382278479763,2
2020-11-12-170508,170508,12,0,0,1693,10.333333333333334,841.9332272441463,3
2020-11-13-170508,170508,10,5,0,1703,14.0,945.7387772381692,4
2020-03-01-170509,170509,0,0,2,0,0.0,0.0,6
2020-03-02-170509,170509,0,0,6,0,0.0,22.809830749555644,0
2020-03-03-170509,170509,0,0,10,0,0.0,150.62094021559147,1
2020-03-04-170509,170509,0,0,18,0,0.25,171.1203508014605,2
2020-03-05-170509,170509,0,0,18,0,0.0,179.92745227024255,3
2020-03-06-170509,170509,0,0,7,0,0.0,158.89247914687252,4
2020-03-07-170509,170509,0,0,15,0,0.0,157.2702286932822,5
2020-03-08-170509,170509,0,1,12,0,0.0,149.6015302756136,6
2020-03-09-170509,170509,1,0,21,1,1.0,150.6723629733562,0
2020-03-10-170509,170509,1,0,20,2,0.25,553.7160558526693,1
2020-03-11-170509,170509,1,0,31,3,0.75,495.366100941275,2
2020-03-12-170509,170509,3,0,27,6,0.75,404.82424846620796,3
2020-03-13-170509,170509,1,0,20,7,1.25,338.23626860799396,4
2020-03-14-170509,170509,1,0,12,8,1.0,116.40462961178338,5
2020-03-15-170509,170509,2,0,8,10,1.5,86.72092124859711,6
2020-03-16-170509,170509,6,0,25,16,6.25,24.408498940206137,0
2020-03-17-170509,170509,10,1,17,26,7.0,51.244829836650915,1
2020-03-18-170509,170509,18,0,9,44,11.5,72.87265761676277,2
2020-03-19-170509,170509,18,0,13,62,14.75,102.9009177806306,3
2020-03-20-170509,170509,7,0,13,69,15.5,125.8845431605539,4
2020-03-21-170509,170509,15,0,3,84,7.25,147.0225155571548,5
2020-03-22-170509,170509,12,0,9,96,6.75,155.41641083649196,6
2020-03-23-170509,170509,21,0,11,117,24.0,150.83452240406797,0
2020-03-24-170509,170509,20,0,7,137,21.75,186.39482131586558,1
2020-03-25-170509,170509,31,0,18,168,17.5,207.87387591767623,2
2020-03-26-170509,170509,27,0,8,195,19.5,211.3261954592388,3
2020-03-27-170509,170509,20,0,16,215,16.25,254.17690082367253,4
2020-03-28-170509,170509,12,0,4,227,8.25,261.0081008938705,5
2020-03-29-170509,170509,8,0,0,235,6.25,261.6783344005469,6
2020-03-30-170509,170509,25,0,6,260,16.5,206.05204141194605,0
2020-03-31-170509,170509,17,0,7,277,13.25,189.35460701611277,1
2020-04-01-170509,170509,9,0,9,286,9.5,29.76062191430739,2
2020-04-02-170509,170509,13,0,6,299,11.0,96.94791288001528,3
2020-04-03-170509,170509,13,0,3,312,13.5,56.22398571197459,4
2020-04-04-170509,170509,3,0,1,315,3.5,70.78740657397228,5
2020-04-05-170509,170509,9,0,1,324,5.5,75.87298714729546,6
2020-04-06-170509,170509,11,0,7,335,13.25,86.63945051280666,0
2020-04-07-170509,170509,7,0,12,342,9.0,106.14280548512582,1
2020-04-08-170509,170509,18,0,8,360,14.0,114.79975347800556,2
2020-04-09-170509,170509,8,2,2,368,10.25,132.7711256830519,3
2020-04-10-170509,170509,16,0,10,384,8.0,26.97903309634588,4
2020-04-11-170509,170509,4,0,1,388,7.75,42.498216847452895,5
2020-04-12-170509,170509,0,0,0,388,2.5,54.38587030096903,6
2020-04-13-170509,170509,6,0,2,394,6.75,58.59591498818446,0
2020-04-14-170509,170509,7,0,2,401,13.0,73.3491680121889,1
2020-04-15-170509,170509,9,0,6,410,12.0,94.05884359659794,2
2020-04-16-170509,170509,6,1,5,416,9.0,113.46759383896443,3
2020-04-17-170509,170509,3,0,2,419,7.0,113.44655105042443,4
2020-04-18-170509,170509,1,0,0,420,4.5,114.31021146290186,5
2020-04-19-170509,170509,1,0,0,421,2.0,107.1856407262955,6
2020-04-20-170509,170509,7,0,4,428,7.0,115.31935607284709,0
2020-04-21-170509,170509,12,0,3,440,8.0,109.4816611124549,1
2020-04-22-170509,170509,8,0,3,448,8.25,100.26442359213945,2
2020-04-23-170509,170509,2,0,4,450,2.75,98.47795930767137,3
2020-04-24-170509,170509,10,0,3,460,6.75,83.63532446750872,4
2020-04-25-170509,170509,1,0,3,461,2.0,91.65133049295099,5
2020-04-26-170509,170509,0,0,1,461,2.5,91.31414241137702,6
2020-04-27-170509,170509,2,0,9,463,5.0,74.82865872680713,0
2020-04-28-170509,170509,2,0,4,465,6.25,69.42812366326895,1
2020-04-29-170509,170509,6,0,7,471,3.0,70.86903608668948,2
2020-04-30-170509,170509,5,0,6,476,5.0,81.4696552106028,3
2020-05-01-170509,170509,2,0,4,478,3.5,149.69860526393393,4
2020-05-02-170509,170509,0,0,0,478,1.75,55.56093114856991,5
2020-05-03-170509,170509,0,0,0,478,1.5,33.9660617211381,6
2020-05-04-170509,170509,4,0,7,482,5.0,34.70349775401524,0
2020-05-05-170509,170509,3,0,4,485,4.5,39.87031841487632,1
2020-05-06-170509,170509,3,0,0,488,6.0,42.52424303872374,2
2020-05-07-170509,170509,4,0,3,492,4.75,51.84829459262312,3
2020-05-08-170509,170509,3,0,4,495,6.75,60.85386318582541,4
2020-05-09-170509,170509,3,0,2,498,1.5,73.08027536033524,5
2020-05-10-170509,170509,1,0,0,499,1.25,177.0978968428968,6
2020-05-11-170509,170509,9,1,3,508,4.5,168.0851702871762,0
2020-05-12-170509,170509,4,0,7,512,5.0,160.3703661420028,1
2020-05-13-170509,170509,7,1,4,519,5.0,136.3562600202069,2
2020-05-14-170509,170509,6,0,3,525,4.25,123.8968848814713,3
2020-05-15-170509,170509,4,0,3,529,2.0,101.68202366213706,4
2020-05-16-170509,170509,0,0,0,529,0.5,76.73129769674095,5
2020-05-17-170509,170509,0,1,1,529,0.75,66.81282211269972,6
2020-05-18-170509,170509,7,0,5,536,5.0,66.9932509157158,0
2020-05-19-170509,170509,4,0,2,540,5.75,63.508536106591734,1
2020-05-20-170509,170509,0,0,2,540,3.25,59.61999164404658,2
2020-05-21-170509,170509,3,0,3,543,3.5,59.77144233792004,3
2020-05-22-170509,170509,4,2,2,547,4.75,60.774625686637606,4
2020-05-23-170509,170509,2,0,0,549,0.75,77.98314441951142,5
2020-05-24-170509,170509,0,0,0,549,0.0,79.1290433565824,6
2020-05-25-170509,170509,3,1,0,552,2.5,67.77395533348064,0
2020-05-26-170509,170509,7,0,1,559,3.0,49.95391511598196,1
2020-05-27-170509,170509,4,0,4,563,5.5,58.60923668135311,2
2020-05-28-170509,170509,3,2,1,566,2.5,63.355298234713935,3
2020-05-29-170509,170509,3,0,1,569,2.25,61.2109856327295,4
2020-05-30-170509,170509,0,0,1,569,0.75,53.347672975050855,5
2020-05-31-170509,170509,1,0,0,570,0.75,57.79682800657085,6
2020-06-01-170509,170509,5,0,2,575,2.75,97.41101706285014,0
2020-06-02-170509,170509,2,0,0,577,2.0,32.88967766493147,1
2020-06-03-170509,170509,2,0,0,579,2.0,22.39233751149439,2
2020-06-04-170509,170509,3,0,1,582,2.25,24.110702485302554,3
2020-06-05-170509,170509,2,0,3,584,1.25,23.36867619054143,4
2020-06-06-170509,170509,0,1,2,584,0.5,22.327399234085643,5
2020-06-07-170509,170509,0,4,0,584,0.5,20.80819875520914,6
2020-06-08-170509,170509,0,0,1,584,4.25,21.870784504936772,0
2020-06-09-170509,170509,1,0,1,585,1.0,27.07666799958946,1
2020-06-10-170509,170509,4,0,1,589,1.75,108.72768034769247,2
2020-06-11-170509,170509,1,0,0,590,2.0,98.5851364188563,3
2020-06-12-170509,170509,1,0,3,591,2.5,86.55645093014823,4
2020-06-13-170509,170509,1,0,0,592,1.25,75.91971669651285,5
2020-06-14-170509,170509,0,0,0,592,0.0,57.648092641781204,6
2020-06-15-170509,170509,2,0,1,594,1.0,41.21283255262223,0
2020-06-16-170509,170509,0,0,1,594,1.75,38.76642259238615,1
2020-06-17-170509,170509,0,0,1,594,2.0,36.07412141965389,2
2020-06-18-170509,170509,1,0,1,595,1.0,34.857323153175564,3
2020-06-19-170509,170509,3,0,0,598,1.75,34.043400709423565,4
2020-06-20-170509,170509,2,0,2,600,0.5,37.617160021909804,5
2020-06-21-170509,170509,0,0,0,600,0.75,39.9573283572239,6
2020-06-22-170509,170509,1,0,0,601,1.5,39.222552100115095,0
2020-06-23-170509,170509,1,0,3,602,1.0,35.65506256382955,1
2020-06-24-170509,170509,1,0,1,603,0.5,33.306967647463864,2
2020-06-25-170509,170509,0,0,3,603,1.0,32.48771132047358,3
2020-06-26-170509,170509,3,0,2,606,0.5,27.226351232467316,4
2020-06-27-170509,170509,0,0,0,606,0.75,28.102955172937385,5
2020-06-28-170509,170509,0,0,0,606,0.0,28.766540549534156,6
2020-06-29-170509,170509,1,0,1,607,1.25,27.288076595400838,0
2020-06-30-170509,170509,1,0,0,608,0.5,27.004859672560627,1
2020-07-01-170509,170509,1,0,0,609,0.5,27.987529868716074,2
2020-07-02-170509,170509,1,0,1,610,1.0,14.295564710372972,3
2020-07-03-170509,170509,0,0,0,610,0.5,20.36241813143115,4
2020-07-04-170509,170509,2,1,0,612,0.75,26.326556148088926,5
2020-07-05-170509,170509,0,0,1,612,0.0,27.86003219292435,6
2020-07-06-170509,170509,0,0,0,612,0.25,26.84964107805073,0
2020-07-07-170509,170509,3,0,2,615,0.75,27.521424131661774,1
2020-07-08-170509,170509,1,0,0,616,0.75,25.48674653330102,2
2020-07-09-170509,170509,3,0,1,619,1.0,23.172318785464505,3
2020-07-10-170509,170509,2,0,1,621,1.0,25.969036061668575,4
2020-07-11-170509,170509,0,0,0,621,0.0,28.157843497856717,5
2020-07-12-170509,170509,0,0,0,621,0.5,24.071582500140345,6
2020-07-13-170509,170509,1,0,0,622,0.5,22.997615773151445,0
2020-07-14-170509,170509,0,0,0,622,2.0,23.0299239692488,1
2020-07-15-170509,170509,0,0,1,622,1.75,17.645275915256306,2
2020-07-16-170509,170509,1,0,0,623,1.25,20.25819929596047,3
2020-07-17-170509,170509,0,0,0,623,0.5,19.857986329746254,4
2020-07-18-170509,170509,0,0,2,623,0.75,11.247369392359339,5
2020-07-19-170509,170509,1,0,0,624,0.25,13.03351734623476,6
2020-07-20-170509,170509,0,0,0,624,0.25,14.490400807101325,0
2020-07-21-170509,170509,2,0,0,626,0.0,12.623116587339716,1
2020-07-22-170509,170509,0,0,3,626,1.25,8.559675057870143,2
2020-07-23-170509,170509,1,0,3,627,1.0,12.205959588472531,3
2020-07-24-170509,170509,1,0,1,628,0.5,21.75815938337138,4
2020-07-25-170509,170509,0,0,2,628,0.0,22.448206804433134,5
2020-07-26-170509,170509,0,0,2,628,0.0,21.969242955179496,6
2020-07-27-170509,170509,0,0,0,628,0.0,19.674645508281383,0
2020-07-28-170509,170509,0,0,1,628,0.0,20.234730268682426,1
2020-07-29-170509,170509,1,0,0,629,1.0,20.467622309124593,2
2020-07-30-170509,170509,0,0,5,629,0.75,13.21828731913671,3
2020-07-31-170509,170509,0,0,2,629,1.75,20.640159248053294,4
2020-08-01-170509,170509,2,0,5,631,0.25,14.99365444603238,5
2020-08-02-170509,170509,0,0,1,631,0.5,103.6676136090928,6
2020-08-03-170509,170509,0,0,4,631,1.0,81.06605598860088,0
2020-08-04-170509,170509,0,0,0,631,1.0,79.59312488091668,1
2020-08-05-170509,170509,3,0,3,634,1.25,73.50127365225092,2
2020-08-06-170509,170509,3,0,1,637,1.0,70.73566246063916,3
2020-08-07-170509,170509,1,1,3,638,2.0,67.89421257844639,4
2020-08-08-170509,170509,2,0,7,640,1.0,65.73442181803081,5
2020-08-09-170509,170509,2,0,6,642,1.5,62.441698645375986,6
2020-08-10-170509,170509,0,0,5,642,1.25,10.896184786390833,0
2020-08-11-170509,170509,1,0,4,643,2.25,12.764977263903221,1
2020-08-12-170509,170509,0,0,7,643,2.5,18.273475216947627,2
2020-08-13-170509,170509,5,0,2,648,1.5,28.918594168960748,3
2020-08-14-170509,170509,2,0,4,650,3.25,36.23298197353891,4
2020-08-15-170509,170509,5,0,9,655,2.25,55.529668108204326,5
2020-08-16-170509,170509,1,0,2,656,0.5,58.36712482010661,6
2020-08-17-170509,170509,4,0,8,660,2.75,60.93138626080109,0
2020-08-18-170509,170509,0,0,0,660,1.75,66.12422897223082,1
2020-08-19-170509,170509,3,0,7,663,5.5,68.50202418887457,2
2020-08-20-170509,170509,1,0,12,664,1.75,89.11974871733602,3
2020-08-21-170509,170509,3,0,6,667,4.0,74.62666152417265,4
2020-08-22-170509,170509,7,0,7,674,4.0,88.51464246625814,5
2020-08-23-170509,170509,6,0,12,680,1.0,101.59234975372317,6
2020-08-24-170509,170509,5,0,7,685,4.0,96.03054625169561,0
2020-08-25-170509,170509,4,0,11,689,2.5,102.54786251564019,1
2020-08-26-170509,170509,7,0,5,696,3.75,65.4065695917395,2
2020-08-27-170509,170509,2,0,6,698,2.25,80.328078358525,3
2020-08-28-170509,170509,4,0,7,702,6.0,86.32657100235724,4
2020-08-29-170509,170509,9,0,8,711,4.25,77.00523255506295,5
2020-08-30-170509,170509,2,0,5,713,1.5,80.46922278386705,6
2020-08-31-170509,170509,8,1,7,721,2.25,75.10612679097419,0
2020-09-01-170509,170509,0,0,23,721,2.5,61.89901430888124,1
2020-09-02-170509,170509,7,1,9,728,3.5,179.55801107235993,2
2020-09-03-170509,170509,12,0,20,740,6.25,191.4487247709077,3
2020-09-04-170509,170509,6,0,16,746,6.0,196.150589093131,4
2020-09-05-170509,170509,7,1,5,753,5.25,195.26534330415848,5
2020-09-06-170509,170509,12,0,11,765,5.0,182.58643160444439,6
2020-09-07-170509,170509,7,0,7,772,8.0,170.38995297137012,0
2020-09-08-170509,170509,11,0,8,783,6.0,173.1706267691596,1
2020-09-09-170509,170509,5,0,19,788,4.0,184.9201975899158,2
2020-09-10-170509,170509,6,1,7,794,5.75,85.58195269180081,3
2020-09-11-170509,170509,7,1,12,801,7.25,100.37672553955318,4
2020-09-12-170509,170509,8,0,11,809,6.25,118.64583452649738,5
2020-09-13-170509,170509,5,0,14,814,7.75,130.46145765377247,6
2020-09-14-170509,170509,7,0,13,821,6.25,137.91047835402156,0
2020-09-15-170509,170509,23,0,7,844,5.25,165.10463596780426,1
2020-09-16-170509,170509,9,0,6,853,6.75,191.168204730023,2
2020-09-17-170509,170509,20,0,10,873,6.5,186.59944500214152,3
2020-09-18-170509,170509,16,0,14,889,11.25,185.2397331436772,4
2020-09-19-170509,170509,5,1,18,894,4.5,192.286635732706,5
2020-09-20-170509,170509,11,0,3,905,14.25,174.21648323063454,6
2020-09-21-170509,170509,7,0,10,912,9.0,187.62069862240963,0
2020-09-22-170509,170509,8,3,7,920,7.25,184.19880758811632,1
2020-09-23-170509,170509,19,1,10,939,9.25,184.01282012414958,2
2020-09-24-170509,170509,7,1,4,946,9.0,194.2918807226764,3
2020-09-25-170509,170509,12,0,16,958,8.0,191.28212160513434,4
2020-09-26-170509,170509,11,0,12,969,5.5,200.02067833695997,5
2020-09-27-170509,170509,14,0,4,983,6.0,225.43155133054924,6
2020-09-28-170509,170509,13,0,8,996,6.5,217.22668508916428,0
2020-09-29-170509,170509,7,0,6,1003,6.25,213.8758421653687,1
2020-09-30-170509,170509,6,0,15,1009,8.25,207.15742465649248,2
2020-10-01-170509,170509,10,0,17,1019,5.25,0.0,3
2020-10-02-170509,170509,14,0,18,1033,13.5,338.11994031219353,4
2020-10-03-170509,170509,18,1,15,1051,10.0,314.4312521855185,5
2020-10-04-170509,170509,3,1,4,1054,4.5,324.84267767042206,6
2020-10-05-170509,170509,10,0,12,1064,9.5,298.30971761161015,0
2020-10-06-170509,170509,7,0,16,1071,9.0,277.789360257021,1
2020-10-07-170509,170509,10,0,9,1081,6.25,259.78672243887013,2
2020-10-08-170509,170509,4,0,9,1085,10.25,246.0493825471859,3
2020-10-09-170509,170509,16,0,16,1101,18.25,269.01493571313074,4
2020-10-10-170509,170509,12,0,7,1113,9.0,27.816160311797418,5
2020-10-11-170509,170509,4,0,19,1117,1.5,64.69119479782432,6
2020-10-12-170509,170509,8,0,13,1125,9.75,72.76548643291773,0
2020-10-13-170509,170509,6,0,13,1131,9.25,102.67117976043433,1
2020-10-14-170509,170509,15,0,14,1146,10.25,137.7920844774808,2
2020-10-15-170509,170509,17,0,33,1163,13.75,189.10268368197748,3
2020-10-16-170509,170509,18,0,19,1181,20.75,239.12468800574382,4
2020-10-17-170509,170509,15,0,17,1196,19.0,277.60228796542515,5
2020-10-18-170509,170509,4,0,7,1200,5.0,293.71844554234235,6
2020-10-19-170509,170509,12,1,17,1212,8.75,300.50624984895353,0
2020-10-20-170509,170509,16,0,6,1228,6.5,321.8877180144333,1
2020-10-21-170509,170509,9,0,9,1237,4.75,301.7280605048344,2
2020-10-22-170509,170509,9,0,11,1246,13.5,268.54630301671403,3
2020-10-23-170509,170509,16,0,18,1262,15.25,251.72269861834525,4
2020-10-24-170509,170509,7,1,11,1269,11.75,240.00634796115813,5
2020-10-25-170509,170509,19,0,12,1288,9.25,264.2985227087677,6
2020-10-26-170509,170509,13,1,11,1301,11.0,253.23588744022356,0
2020-10-27-170509,170509,13,1,15,1314,15.25,250.9921390059055,1
2020-10-28-170509,170509,14,1,6,1328,12.25,269.25442453576954,2
2020-10-29-170509,170509,33,0,17,1361,9.0,299.29250089233807,3
2020-10-30-170509,170509,19,2,15,1380,15.75,291.3762232504271,4
2020-10-31-170509,170509,17,0,0,1397,12.25,295.1832463301436,5
2020-11-01-170509,170509,7,0,0,1404,4.5,260.3867158243914,6
2020-11-02-170509,170509,17,2,0,1421,12.75,319.2281739197066,0
2020-11-03-170509,170509,6,0,0,1427,8.0,272.36392210552384,1
2020-11-04-170509,170509,9,0,0,1436,11.75,277.67188807896565,2
2020-11-05-170509,170509,11,1,0,1447,15.25,280.1040367198464,3
2020-11-06-170509,170509,18,0,0,1465,27.0,317.88827678886094,4
2020-11-07-170509,170509,11,0,0,1476,24.25,317.02253582649547,5
2020-11-08-170509,170509,12,1,0,1488,5.5,453.03681336482646,6
2020-11-09-170509,170509,11,3,0,1499,12.5,431.21599040020726,0
2020-11-10-170509,170509,15,1,0,1514,8.5,238.92923532617684,1
2020-11-11-170509,170509,6,1,0,1520,7.5,255.74558375577035,2
2020-11-12-170509,170509,17,0,0,1537,14.25,245.9596466454631,3
2020-11-13-170509,170509,15,0,0,1552,14.75,272.79456760290986,4
2020-03-01-170510,170510,0,0,0,0,0.0,0.0,6
2020-03-02-170510,170510,0,0,3,0,0.0,6.8010307756636195,0
2020-03-03-170510,170510,0,3,0,0,0.0,44.5246809730758,1
2020-03-04-170510,170510,0,0,2,0,0.0,58.73580886356206,2
2020-03-05-170510,170510,0,0,1,0,0.0,65.50083622807642,3
2020-03-06-170510,170510,0,0,0,0,0.0,53.50413273826827,4
2020-03-07-170510,170510,0,0,0,0,0.0,53.98344827805993,5
2020-03-08-170510,170510,0,0,2,0,0.25,47.385872757199465,6
2020-03-09-170510,170510,0,0,0,0,0.0,49.63808165376793,0
2020-03-10-170510,170510,0,0,0,0,0.0,172.9555478829325,1
2020-03-11-170510,170510,0,0,0,0,0.0,151.69892054656182,2
2020-03-12-170510,170510,1,0,2,1,0.5,107.76161573698167,3
2020-03-13-170510,170510,0,0,2,1,0.5,94.01060888066647,4
2020-03-14-170510,170510,0,0,1,1,0.75,59.21561064821118,5
2020-03-15-170510,170510,0,0,4,1,0.5,37.42104801995484,6
2020-03-16-170510,170510,3,0,2,4,0.75,18.599440656497887,0
2020-03-17-170510,170510,0,0,0,4,0.25,30.26034964109501,1
2020-03-18-170510,170510,2,0,1,6,0.0,33.53815695112553,2
2020-03-19-170510,170510,1,0,1,7,1.25,40.01347925946881,3
2020-03-20-170510,170510,0,0,0,7,1.75,42.1486009411628,4
2020-03-21-170510,170510,0,0,1,7,0.75,49.40991944791183,5
2020-03-22-170510,170510,2,0,0,9,0.5,53.67521819097819,6
2020-03-23-170510,170510,0,0,0,9,2.0,50.93292926652357,0
2020-03-24-170510,170510,0,0,0,9,1.25,64.72860888187196,1
2020-03-25-170510,170510,0,0,2,9,1.25,69.56121349225143,2
2020-03-26-170510,170510,2,0,0,11,1.75,69.13604599978139,3
2020-03-27-170510,170510,2,0,2,13,4.25,83.6616656052651,4
2020-03-28-170510,170510,1,0,1,14,1.0,95.22420960818269,5
2020-03-29-170510,170510,4,0,0,18,0.5,94.1299792282656,6
2020-03-30-170510,170510,2,0,1,20,2.5,78.89357966712515,0
2020-03-31-170510,170510,0,0,1,20,0.75,87.28715762909506,1
2020-04-01-170510,170510,1,0,3,21,2.25,9.133100362204825,2
2020-04-02-170510,170510,1,0,0,22,1.25,61.468731627853245,3
2020-04-03-170510,170510,0,0,1,22,0.5,31.562170889427343,4
2020-04-04-170510,170510,1,0,0,23,0.75,33.725078020494585,5
2020-04-05-170510,170510,0,0,0,23,0.25,34.80242215401488,6
2020-04-06-170510,170510,0,4,1,23,2.0,36.80536368703855,0
2020-04-07-170510,170510,0,0,0,23,1.25,41.68197044814856,1
2020-04-08-170510,170510,2,0,2,25,3.25,44.327963702485874,2
2020-04-09-170510,170510,0,0,0,25,5.25,53.897535367345526,3
2020-04-10-170510,170510,2,0,1,27,2.5,14.849938176423889,4
2020-04-11-170510,170510,1,0,1,28,0.25,32.820027266151484,5
2020-04-12-170510,170510,0,0,0,28,0.75,36.4215369841657,6
2020-04-13-170510,170510,1,0,2,29,1.75,39.08454404890869,0
2020-04-14-170510,170510,1,0,0,30,2.0,50.3983484892009,1
2020-04-15-170510,170510,3,0,1,33,1.5,59.20355308772805,2
2020-04-16-170510,170510,0,0,1,33,1.0,68.16920307002513,3
2020-04-17-170510,170510,1,0,0,34,4.5,65.09999633221139,4
2020-04-18-170510,170510,0,0,0,34,0.0,68.1360165935786,5
2020-04-19-170510,170510,0,0,0,34,0.75,64.53960622677644,6
2020-04-20-170510,170510,1,0,0,35,4.0,61.47338712750865,0
2020-04-21-170510,170510,0,0,0,35,0.75,72.5580005807396,1
2020-04-22-170510,170510,2,0,1,37,0.75,66.37728141075945,2
2020-04-23-170510,170510,0,0,0,37,1.25,67.81091962681126,3
2020-04-24-170510,170510,1,0,0,38,0.5,48.99952057338946,4
2020-04-25-170510,170510,1,0,0,39,0.25,53.905050739222645,5
2020-04-26-170510,170510,0,0,1,39,0.25,56.508784695315974,6
2020-04-27-170510,170510,2,0,1,41,0.25,50.4570134625216,0
2020-04-28-170510,170510,0,0,0,41,0.75,34.142321045765804,1
2020-04-29-170510,170510,1,1,0,42,0.75,35.12788185553239,2
2020-04-30-170510,170510,1,0,0,43,1.0,35.62325714905117,3
2020-05-01-170510,170510,0,0,0,43,1.0,76.10844183085824,4
2020-05-02-170510,170510,0,0,0,43,0.75,20.634364838751782,5
2020-05-03-170510,170510,0,0,1,43,0.0,20.31535188730506,6
2020-05-04-170510,170510,0,0,0,43,1.25,23.22041181535575,0
2020-05-05-170510,170510,0,0,0,43,0.25,29.205983284505294,1
2020-05-06-170510,170510,1,0,0,44,0.25,26.416077119639176,2
2020-05-07-170510,170510,0,0,1,44,1.0,29.742418014091758,3
2020-05-08-170510,170510,0,0,1,44,1.25,28.841088490259743,4
2020-05-09-170510,170510,0,1,1,44,0.0,39.21308454147365,5
2020-05-10-170510,170510,1,1,0,45,0.0,86.76503957285877,6
2020-05-11-170510,170510,1,0,0,46,0.25,79.79742736661095,0
2020-05-12-170510,170510,0,0,0,46,1.0,76.12688185540338,1
2020-05-13-170510,170510,0,0,0,46,0.5,70.18158932132884,2
2020-05-14-170510,170510,0,3,0,46,0.25,67.1071202000598,3
2020-05-15-170510,170510,0,0,1,46,1.0,49.5252659818182,4
2020-05-16-170510,170510,0,0,0,46,0.0,33.456707958667245,5
2020-05-17-170510,170510,1,0,3,47,0.0,28.597737379402666,6
2020-05-18-170510,170510,0,0,0,47,0.25,28.908830145628926,0
2020-05-19-170510,170510,0,0,0,47,0.5,26.15704569336001,1
2020-05-20-170510,170510,0,0,0,47,1.5,25.736122768919913,2
2020-05-21-170510,170510,1,0,0,48,1.0,30.69119169122647,3
2020-05-22-170510,170510,1,0,0,49,1.25,31.968629656765447,4
2020-05-23-170510,170510,1,0,0,50,0.0,43.02960813812002,5
2020-05-24-170510,170510,0,0,0,50,0.0,43.1158310503495,6
2020-05-25-170510,170510,0,0,0,50,0.25,40.27834027584183,0
2020-05-26-170510,170510,0,0,1,50,0.5,37.555608267478206,1
2020-05-27-170510,170510,0,0,0,50,0.75,38.534161784929076,2
2020-05-28-170510,170510,0,0,0,50,0.75,36.0594011460096,3
2020-05-29-170510,170510,1,0,1,51,0.75,30.874435321628287,4
2020-05-30-170510,170510,0,1,0,51,0.0,26.31911216520787,5
2020-05-31-170510,170510,3,0,0,54,0.0,28.112910244044826,6
2020-06-01-170510,170510,0,0,0,54,1.0,49.336459052012295,0
2020-06-02-170510,170510,0,0,0,54,0.25,21.563732599028867,1
2020-06-03-170510,170510,0,0,0,54,0.75,18.267399546513442,2
2020-06-04-170510,170510,0,0,0,54,0.75,20.425167847165884,3
2020-06-05-170510,170510,0,2,0,54,1.75,22.352612879038098,4
2020-06-06-170510,170510,0,0,0,54,0.5,30.33577892046635,5
2020-06-07-170510,170510,0,0,1,54,0.0,29.47839570626725,6
2020-06-08-170510,170510,0,0,0,54,0.5,29.21142034076768,0
2020-06-09-170510,170510,1,0,0,55,0.25,32.27737940269182,1
2020-06-10-170510,170510,0,0,0,55,0.75,49.723691212482194,2
2020-06-11-170510,170510,0,0,1,55,1.5,51.9737628271492,3
2020-06-12-170510,170510,1,0,0,56,0.5,60.27895234956867,4
2020-06-13-170510,170510,0,0,0,56,0.25,57.304278455422995,5
2020-06-14-170510,170510,0,0,0,56,0.0,51.16479236064383,6
2020-06-15-170510,170510,0,0,0,56,0.75,41.89320473648753,0
2020-06-16-170510,170510,0,0,0,56,0.25,49.447832161064014,1
2020-06-17-170510,170510,0,0,0,56,0.25,43.06377641180676,2
2020-06-18-170510,170510,0,0,0,56,0.5,31.306817858672563,3
2020-06-19-170510,170510,0,0,0,56,0.25,25.062309119938273,4
2020-06-20-170510,170510,0,0,0,56,0.25,26.709648962603442,5
2020-06-21-170510,170510,1,0,0,57,0.0,30.131522556131902,6
2020-06-22-170510,170510,0,0,0,57,0.0,24.795463659881364,0
2020-06-23-170510,170510,0,0,0,57,0.0,23.5851467935223,1
2020-06-24-170510,170510,0,0,0,57,0.5,23.682583676248512,2
2020-06-25-170510,170510,1,0,0,58,0.25,23.019214386373104,3
2020-06-26-170510,170510,0,0,0,58,0.25,24.020351289553528,4
2020-06-27-170510,170510,0,0,0,58,0.5,21.857965249027423,5
2020-06-28-170510,170510,0,0,0,58,0.0,22.9967391949032,6
2020-06-29-170510,170510,0,0,0,58,0.25,19.88290590390438,0
2020-06-30-170510,170510,0,0,0,58,0.0,26.242496160178074,1
2020-07-01-170510,170510,0,0,0,58,0.25,39.10679230972009,2
2020-07-02-170510,170510,0,0,0,58,0.25,27.259273183827784,3
2020-07-03-170510,170510,0,0,0,58,0.25,25.973639916961858,4
2020-07-04-170510,170510,0,0,0,58,0.0,22.26439840878626,5
2020-07-05-170510,170510,0,0,1,58,0.5,22.846715587830836,6
2020-07-06-170510,170510,0,0,0,58,0.25,20.13266171116271,0
2020-07-07-170510,170510,0,0,0,58,0.25,23.94424171873907,1
2020-07-08-170510,170510,0,0,0,58,0.25,21.893579305861675,2
2020-07-09-170510,170510,0,0,1,58,0.0,19.92873676693031,3
2020-07-10-170510,170510,0,0,1,58,0.25,42.10260252959897,4
2020-07-11-170510,170510,0,0,0,58,0.25,39.75122459560091,5
2020-07-12-170510,170510,0,0,0,58,0.0,25.37365102279508,6
2020-07-13-170510,170510,0,0,0,58,0.0,22.757598927228283,0
2020-07-14-170510,170510,0,0,0,58,0.5,23.790119081987413,1
2020-07-15-170510,170510,0,0,0,58,1.0,23.79118080568588,2
2020-07-16-170510,170510,0,0,0,58,1.0,24.414172312193227,3
2020-07-17-170510,170510,0,0,0,58,0.0,31.31331247135785,4
2020-07-18-170510,170510,0,0,0,58,0.0,28.85477031748814,5
2020-07-19-170510,170510,1,0,0,59,0.0,28.052368272316365,6
2020-07-20-170510,170510,0,0,0,59,0.0,34.44016306775629,0
2020-07-21-170510,170510,0,0,0,59,0.0,28.20817625368564,1
2020-07-22-170510,170510,0,0,0,59,0.25,22.478917094966135,2
2020-07-23-170510,170510,1,0,2,60,0.25,14.668134870037495,3
2020-07-24-170510,170510,1,0,0,61,0.5,18.163245488505567,4
2020-07-25-170510,170510,0,0,0,61,0.25,25.322635786534185,5
2020-07-26-170510,170510,0,0,0,61,0.0,23.84105682178174,6
2020-07-27-170510,170510,0,0,1,61,0.75,19.236880963006172,0
2020-07-28-170510,170510,0,0,0,61,0.5,23.573178272285467,1
2020-07-29-170510,170510,0,0,0,61,0.0,26.783204012948843,2
2020-07-30-170510,170510,0,0,1,61,0.0,28.299862486894405,3
2020-07-31-170510,170510,0,0,1,61,1.0,23.19512785482033,4
2020-08-01-170510,170510,0,0,0,61,0.25,19.938587904998872,5
2020-08-02-170510,170510,0,0,1,61,0.0,70.11807516314516,6
2020-08-03-170510,170510,0,0,1,61,0.0,127.92934416985942,0
2020-08-04-170510,170510,0,0,0,61,0.5,102.03489900371397,1
2020-08-05-170510,170510,0,0,0,61,1.0,86.67186315332731,2
2020-08-06-170510,170510,2,0,1,63,0.0,54.01109096961406,3
2020-08-07-170510,170510,0,0,2,63,0.25,53.17125319933366,4
2020-08-08-170510,170510,0,0,0,63,1.0,50.4375289663329,5
2020-08-09-170510,170510,0,0,1,63,0.0,51.73180948840404,6
2020-08-10-170510,170510,1,0,0,64,0.25,20.439761670072627,0
2020-08-11-170510,170510,0,0,0,64,1.0,27.090288118572115,1
2020-08-12-170510,170510,0,0,0,64,1.5,35.54861606953507,2
2020-08-13-170510,170510,1,0,0,65,0.5,42.517814653575485,3
2020-08-14-170510,170510,1,1,0,66,0.75,50.55210673034341,4
2020-08-15-170510,170510,0,0,0,66,0.5,54.96610595321952,5
2020-08-16-170510,170510,1,0,0,67,1.75,59.576154879455544,6
2020-08-17-170510,170510,1,0,0,68,1.25,70.40278605401531,0
2020-08-18-170510,170510,0,0,0,68,1.75,75.36190213647963,1
2020-08-19-170510,170510,0,0,0,68,0.25,78.45575830321245,2
2020-08-20-170510,170510,1,0,1,69,1.25,67.49399862263778,3
2020-08-21-170510,170510,2,0,0,71,3.0,72.05943279059713,4
2020-08-22-170510,170510,0,0,0,71,2.25,99.69029683425339,5
2020-08-23-170510,170510,1,0,0,72,0.75,99.00596723165573,6
2020-08-24-170510,170510,0,0,0,72,1.25,96.14154779641228,0
2020-08-25-170510,170510,0,0,0,72,2.0,98.63511621115306,1
2020-08-26-170510,170510,0,0,0,72,1.0,108.40054485290953,2
2020-08-27-170510,170510,0,0,0,72,5.5,126.35763479336948,3
2020-08-28-170510,170510,0,0,4,72,1.5,155.10487569180862,4
2020-08-29-170510,170510,0,0,3,72,0.75,132.9906542991502,5
2020-08-30-170510,170510,0,0,1,72,1.5,116.2878392155668,6
2020-08-31-170510,170510,0,0,5,72,0.75,108.64961383738168,0
2020-09-01-170510,170510,0,0,0,72,1.5,40.50213328553533,1
2020-09-02-170510,170510,0,0,4,72,0.5,118.2534816899311,2
2020-09-03-170510,170510,1,0,1,73,0.75,101.46797961491,3
2020-09-04-170510,170510,0,0,1,73,2.25,93.499166024147,4
2020-09-05-170510,170510,0,0,0,73,0.75,98.15648958951252,5
2020-09-06-170510,170510,0,0,2,73,1.5,82.8201691246551,6
2020-09-07-170510,170510,0,0,0,73,0.5,82.96765136619521,0
2020-09-08-170510,170510,0,0,0,73,1.75,78.14035750422715,1
2020-09-09-170510,170510,0,0,1,73,3.25,81.9757816735235,2
2020-09-10-170510,170510,0,0,0,73,3.25,38.38697306146776,3
2020-09-11-170510,170510,4,0,0,77,2.75,53.13458559666277,4
2020-09-12-170510,170510,3,0,1,80,0.75,70.19293606420959,5
2020-09-13-170510,170510,1,0,0,81,0.5,75.7857702025292,6
2020-09-14-170510,170510,5,0,2,86,1.0,85.55307066569358,0
2020-09-15-170510,170510,0,0,0,86,1.5,105.57136766776961,1
2020-09-16-170510,170510,4,0,1,90,1.75,118.22417488763644,2
2020-09-17-170510,170510,1,0,1,91,1.0,127.82892219105105,3
2020-09-18-170510,170510,1,0,4,92,1.0,124.97235776169579,4
2020-09-19-170510,170510,0,0,0,92,0.0,113.54554576929971,5
2020-09-20-170510,170510,2,1,1,94,0.5,97.6726898238399,6
2020-09-21-170510,170510,0,0,1,94,0.0,90.26146322881259,0
2020-09-22-170510,170510,0,0,0,94,1.0,82.83018234294407,1
2020-09-23-170510,170510,1,0,0,95,2.25,68.16441419075207,2
2020-09-24-170510,170510,0,0,0,95,1.25,69.29328763129841,3
2020-09-25-170510,170510,0,0,0,95,1.25,65.14511625048097,4
2020-09-26-170510,170510,1,0,2,96,1.75,68.56461858940361,5
2020-09-27-170510,170510,0,0,2,96,0.75,82.69286484042857,6
2020-09-28-170510,170510,2,0,0,98,0.5,77.74892539729868,0
2020-09-29-170510,170510,0,0,0,98,0.75,82.52739581255449,1
2020-09-30-170510,170510,1,0,0,99,1.5,83.06131723490574,2
2020-10-01-170510,170510,1,0,0,100,1.0,0.0,3
2020-10-02-170510,170510,4,0,0,104,3.0,143.71330056852042,4
2020-10-03-170510,170510,0,1,0,104,2.25,214.9766240900879,5
2020-10-04-170510,170510,1,0,1,105,2.0,194.6360561396581,6
2020-10-05-170510,170510,1,0,1,106,0.75,183.11409852183849,0
2020-10-06-170510,170510,0,0,0,106,2.75,169.5774407265954,1
2020-10-07-170510,170510,0,1,0,106,2.0,151.38111250138857,2
2020-10-08-170510,170510,0,0,2,106,1.75,129.71911933377788,3
2020-10-09-170510,170510,0,0,0,106,1.0,135.22361269266273,4
2020-10-10-170510,170510,2,0,0,108,3.0,17.629723343693325,5
2020-10-11-170510,170510,2,0,1,110,0.0,45.98458824438955,6
2020-10-12-170510,170510,0,0,0,110,1.5,56.04803731248633,0
2020-10-13-170510,170510,0,0,2,110,2.5,65.20426082411468,1
2020-10-14-170510,170510,0,0,0,110,2.5,80.05561032131187,2
2020-10-15-170510,170510,0,0,1,110,1.75,105.5553297008723,3
2020-10-16-170510,170510,0,0,0,110,2.75,124.72794393662562,4
2020-10-17-170510,170510,0,0,2,110,2.25,136.459895479201,5
2020-10-18-170510,170510,1,0,0,111,0.5,122.32018046769315,6
2020-10-19-170510,170510,1,0,0,112,1.75,126.07148334774527,0
2020-10-20-170510,170510,0,0,1,112,4.5,148.67460233916754,1
2020-10-21-170510,170510,0,0,0,112,1.25,154.49849121922816,2
2020-10-22-170510,170510,2,0,4,114,3.0,149.5131691652299,3
2020-10-23-170510,170510,0,0,0,114,5.0,151.19429149315886,4
2020-10-24-170510,170510,0,0,1,114,1.75,159.22062237326816,5
2020-10-25-170510,170510,1,0,0,115,3.25,161.05237194104382,6
2020-10-26-170510,170510,0,0,0,115,2.75,168.33154792194523,0
2020-10-27-170510,170510,2,0,1,117,3.0,163.61755478221116,1
2020-10-28-170510,170510,0,0,1,117,2.75,161.33952271560315,2
2020-10-29-170510,170510,1,0,1,118,3.25,178.9693881757952,3
2020-10-30-170510,170510,0,0,0,118,4.0,174.30257031479988,4
2020-10-31-170510,170510,2,0,0,120,0.75,185.86314647422228,5
2020-11-01-170510,170510,0,0,0,120,1.25,108.6587162675431,6
2020-11-02-170510,170510,0,0,0,120,2.0,196.08330019009128,0
2020-11-03-170510,170510,1,0,0,121,5.0,191.36390379811147,1
2020-11-04-170510,170510,0,0,0,121,1.0,204.78357478274552,2
2020-11-05-170510,170510,4,0,0,125,3.0,191.5138921566528,3
2020-11-06-170510,170510,0,0,0,125,0.5,194.5753894158369,4
2020-11-07-170510,170510,1,0,0,126,2.0,176.0671939043978,5
2020-11-08-170510,170510,0,0,0,126,2.5,180.05393727073812,6
2020-11-09-170510,170510,0,0,0,126,1.75,175.83307745606652,0
2020-11-10-170510,170510,1,0,0,127,2.25,97.96604721174273,1
2020-11-11-170510,170510,1,1,0,128,0.5,106.44276923967556,2
2020-11-12-170510,170510,1,0,0,129,2.25,102.1750508723859,3
2020-11-13-170510,170510,0,0,0,129,2.75,113.8249729302253,4
2020-03-01-170511,170511,0,0,0,0,0.0,0.0,6
2020-03-02-170511,170511,0,0,0,0,0.0,135.94876017762402,0
2020-03-03-170511,170511,0,0,3,0,0.0,871.502717432275,1
2020-03-04-170511,170511,0,0,3,0,0.08333333333333333,973.8110440285433,2
2020-03-05-170511,170511,0,0,4,0,0.0,1009.3142825507466,3
2020-03-06-170511,170511,0,0,3,0,0.0,868.5144502400384,4
2020-03-07-170511,170511,0,0,3,0,0.0,853.26424043457,5
2020-03-08-170511,170511,0,0,2,0,0.16666666666666666,818.7563919327436,6
2020-03-09-170511,170511,0,0,9,0,0.5833333333333334,826.1283639160628,0
2020-03-10-170511,170511,0,0,7,0,0.25,3169.889768959657,1
2020-03-11-170511,170511,0,0,6,0,0.3333333333333333,2839.236036352835,2
2020-03-12-170511,170511,0,0,8,0,0.75,2350.727256964265,3
2020-03-13-170511,170511,0,0,9,0,0.5833333333333334,1984.80422583147,4
2020-03-14-170511,170511,0,0,2,0,0.75,655.4597547378169,5
2020-03-15-170511,170511,0,0,0,0,1.1666666666666667,492.9138589290674,6
2020-03-16-170511,170511,0,0,5,0,3.8333333333333335,133.70930851669198,0
2020-03-17-170511,170511,3,2,4,3,4.333333333333333,272.88245551750197,1
2020-03-18-170511,170511,3,0,5,6,6.916666666666668,414.5571414272865,2
2020-03-19-170511,170511,4,0,5,10,7.916666666666668,608.3653105991156,3
2020-03-20-170511,170511,3,0,2,13,7.833333333333332,786.2415871252067,4
2020-03-21-170511,170511,3,0,0,16,4.5,959.2155246492537,5
2020-03-22-170511,170511,2,0,5,18,3.8333333333333335,1023.3023936492802,6
2020-03-23-170511,170511,9,0,4,27,11.166666666666664,1022.0150091296907,0
2020-03-24-170511,170511,7,0,4,34,10.333333333333334,1270.2333655050686,1
2020-03-25-170511,170511,6,0,2,40,9.75,1419.3382816375522,2
2020-03-26-170511,170511,8,0,5,48,10.333333333333334,1464.6381414154196,3
2020-03-27-170511,170511,9,0,3,57,9.333333333333334,1776.4812490822142,4
2020-03-28-170511,170511,2,0,2,59,4.833333333333333,1880.4812254731376,5
2020-03-29-170511,170511,0,0,0,59,4.166666666666667,1873.8765370310384,6
2020-03-30-170511,170511,5,0,2,64,8.833333333333334,1468.5655517018608,0
2020-03-31-170511,170511,4,0,1,68,6.75,1373.536811040828,1
2020-04-01-170511,170511,5,0,1,73,5.416666666666668,201.27872016793606,2
2020-04-02-170511,170511,5,0,1,78,8.083333333333334,658.9209810072473,3
2020-04-03-170511,170511,2,0,1,80,6.5,432.7955154277258,4
2020-04-04-170511,170511,0,0,0,80,2.1666666666666665,534.3053412874461,5
2020-04-05-170511,170511,5,0,0,85,3.25,565.0098623415181,6
2020-04-06-170511,170511,4,6,2,89,6.75,648.6736139686344,0
2020-04-07-170511,170511,4,0,1,93,4.5,778.2116828631838,1
2020-04-08-170511,170511,2,0,2,95,8.0,834.7838138672697,2
2020-04-09-170511,170511,5,0,0,100,5.333333333333333,954.487961873254,3
2020-04-10-170511,170511,3,0,1,103,5.0,199.5851249078076,4
2020-04-11-170511,170511,2,0,0,105,3.25,320.46558233681276,5
2020-04-12-170511,170511,0,0,2,105,1.1666666666666667,400.33316012123765,6
2020-04-13-170511,170511,2,0,1,107,3.75,427.63108458863735,0
2020-04-14-170511,170511,1,0,2,108,5.25,534.7856352700148,1
2020-04-15-170511,170511,1,0,2,109,5.416666666666668,680.3206687111843,2
2020-04-16-170511,170511,1,0,1,110,4.416666666666667,819.3783608874801,3
2020-04-17-170511,170511,1,0,1,111,3.083333333333333,777.7071758367795,4
2020-04-18-170511,170511,0,0,0,111,1.5833333333333333,757.7480378181251,5
2020-04-19-170511,170511,0,0,0,111,1.0,714.9320692046527,6
2020-04-20-170511,170511,2,0,2,113,3.333333333333333,779.6991911905919,0
2020-04-21-170511,170511,1,0,1,114,4.416666666666667,742.0203414554186,1
2020-04-22-170511,170511,2,0,1,116,3.8333333333333335,691.4940756042283,2
2020-04-23-170511,170511,0,0,3,116,1.25,681.6349056538461,3
2020-04-24-170511,170511,1,0,1,117,3.583333333333333,587.9834359712154,4
2020-04-25-170511,170511,0,0,0,117,0.9166666666666666,650.6247110956655,5
2020-04-26-170511,170511,2,0,0,119,1.1666666666666667,654.8541778122832,6
2020-04-27-170511,170511,1,0,1,120,3.0,530.8158626755793,0
2020-04-28-170511,170511,2,0,1,122,2.5,493.6932922794962,1
2020-04-29-170511,170511,2,1,1,124,2.083333333333333,500.6488815525022,2
2020-04-30-170511,170511,1,0,0,125,2.333333333333333,609.8017051494201,3
2020-05-01-170511,170511,1,0,2,126,1.5,1071.9601000751031,4
2020-05-02-170511,170511,0,0,0,126,0.8333333333333334,396.4261670906394,5
2020-05-03-170511,170511,0,0,0,126,0.6666666666666666,237.6251206342692,6
2020-05-04-170511,170511,2,0,0,128,2.4166666666666665,253.0196850317375,0
2020-05-05-170511,170511,1,0,6,129,2.083333333333333,294.2008105750861,1
2020-05-06-170511,170511,1,0,0,130,2.9166666666666665,307.1508989001379,2
2020-05-07-170511,170511,3,0,0,133,2.5,358.81175613021617,3
2020-05-08-170511,170511,1,0,2,134,2.6666666666666665,423.49193588549554,4
2020-05-09-170511,170511,0,0,0,134,1.0833333333333333,510.5181598812871,5
2020-05-10-170511,170511,0,0,0,134,0.6666666666666666,1249.7286884271373,6
2020-05-11-170511,170511,1,0,0,135,3.0,1185.2874747759452,0
2020-05-12-170511,170511,1,0,1,136,2.583333333333333,1097.4318612118534,1
2020-05-13-170511,170511,1,0,0,137,2.75,931.0559916734792,2
2020-05-14-170511,170511,0,0,1,137,2.25,830.6546563711497,3
2020-05-15-170511,170511,2,2,1,139,1.5,655.9073562315482,4
2020-05-16-170511,170511,0,1,1,139,0.5,474.22779177576075,5
2020-05-17-170511,170511,0,0,0,139,0.3333333333333333,413.04060535147653,6
2020-05-18-170511,170511,0,0,1,139,2.833333333333333,416.8306852187919,0
2020-05-19-170511,170511,6,0,0,145,2.333333333333333,395.3279078923614,1
2020-05-20-170511,170511,0,0,0,145,1.5833333333333333,404.886334389273,2
2020-05-21-170511,170511,0,0,0,145,2.333333333333333,402.17594589754066,3
2020-05-22-170511,170511,2,0,0,147,2.4166666666666665,399.6651180355426,4
2020-05-23-170511,170511,0,0,0,147,0.5,507.2467946633783,5
2020-05-24-170511,170511,0,0,0,147,0.0,513.7462168759207,6
2020-05-25-170511,170511,0,0,0,147,1.5,444.5432006159887,0
2020-05-26-170511,170511,1,0,0,148,1.6666666666666667,303.0360942585568,1
2020-05-27-170511,170511,0,0,0,148,2.6666666666666665,352.76460835585226,2
2020-05-28-170511,170511,1,1,0,149,1.25,383.56329711705007,3
2020-05-29-170511,170511,1,0,1,150,1.4166666666666667,381.3363054311437,4
2020-05-30-170511,170511,1,0,0,151,0.16666666666666666,343.3418161737501,5
2020-05-31-170511,170511,0,0,0,151,0.4166666666666667,376.30245700426326,6
2020-06-01-170511,170511,1,0,0,152,1.6666666666666667,622.9243941224283,0
2020-06-02-170511,170511,0,0,1,152,1.0,211.62098866219907,1
2020-06-03-170511,170511,0,0,1,152,0.9166666666666666,139.99157755895735,2
2020-06-04-170511,170511,0,0,0,152,1.3333333333333333,155.49758153076536,3
2020-06-05-170511,170511,0,1,2,152,0.75,154.65159990487524,4
2020-06-06-170511,170511,0,0,0,152,0.25,146.57997926129565,5
2020-06-07-170511,170511,0,0,0,152,0.16666666666666666,140.49156477178283,6
2020-06-08-170511,170511,0,0,0,152,1.5,146.73595148687875,0
2020-06-09-170511,170511,0,0,0,152,0.5833333333333334,182.12286691096477,1
2020-06-10-170511,170511,0,1,1,152,1.0833333333333333,702.3798363502809,2
2020-06-11-170511,170511,0,0,1,152,1.0833333333333333,627.9159887657239,3
2020-06-12-170511,170511,1,0,0,153,1.3333333333333333,558.3738633971403,4
2020-06-13-170511,170511,0,0,0,153,0.5833333333333334,490.21179838082617,5
2020-06-14-170511,170511,0,2,0,153,0.0,370.14939099122046,6
2020-06-15-170511,170511,0,0,0,153,1.0,262.34519809193523,0
2020-06-16-170511,170511,1,0,0,154,0.8333333333333334,253.68909575484912,1
2020-06-17-170511,170511,1,0,0,155,0.9166666666666666,228.40752097991862,2
2020-06-18-170511,170511,0,0,0,155,0.9166666666666666,217.59445366040174,3
2020-06-19-170511,170511,2,0,1,157,0.9166666666666666,208.12420582057337,4
2020-06-20-170511,170511,0,0,0,157,0.3333333333333333,232.04342120661101,5
2020-06-21-170511,170511,0,0,0,157,0.25,247.2900947609835,6
2020-06-22-170511,170511,0,0,0,157,0.6666666666666666,239.54954489945385,0
2020-06-23-170511,170511,0,0,0,157,0.4166666666666667,215.81357049911006,1
2020-06-24-170511,170511,1,0,0,158,0.5,205.36239899492216,2
2020-06-25-170511,170511,1,0,0,159,0.3333333333333333,200.4898561180397,3
2020-06-26-170511,170511,0,0,2,159,0.75,168.60843438688414,4
2020-06-27-170511,170511,0,0,0,159,0.3333333333333333,170.4874853247863,5
2020-06-28-170511,170511,0,0,0,159,0.08333333333333333,172.8539614278119,6
2020-06-29-170511,170511,0,0,0,159,0.6666666666666666,164.06589130149018,0
2020-06-30-170511,170511,0,0,2,159,0.5,169.01720343139783,1
2020-07-01-170511,170511,0,0,0,159,0.25,182.44904442816528,2
2020-07-02-170511,170511,0,0,0,159,0.5833333333333334,89.32792850348596,3
2020-07-03-170511,170511,1,0,1,160,0.16666666666666666,136.15728323491348,4
2020-07-04-170511,170511,0,0,0,160,0.5,177.4533372391469,5
2020-07-05-170511,170511,0,0,0,160,0.08333333333333333,188.84236435300642,6
2020-07-06-170511,170511,0,0,0,160,0.25,181.22285405374785,0
2020-07-07-170511,170511,0,0,0,160,0.6666666666666666,182.53322726838297,1
2020-07-08-170511,170511,0,0,1,160,0.3333333333333333,170.28900022698252,2
2020-07-09-170511,170511,0,0,3,160,0.75,151.6740147328721,3
2020-07-10-170511,170511,2,0,0,162,0.5,169.14205442963726,4
2020-07-11-170511,170511,0,0,0,162,0.0,185.3346272663593,5
2020-07-12-170511,170511,0,0,0,162,0.16666666666666666,159.8516921071823,6
2020-07-13-170511,170511,0,0,0,162,0.3333333333333333,150.57586615274454,0
2020-07-14-170511,170511,2,0,0,164,0.75,151.25785419940743,1
2020-07-15-170511,170511,0,0,0,164,1.1666666666666667,115.31318660152156,2
2020-07-16-170511,170511,0,0,3,164,0.5833333333333334,128.68720675801433,3
2020-07-17-170511,170511,1,0,0,165,0.08333333333333333,129.40417039222444,4
2020-07-18-170511,170511,0,0,0,165,0.25,72.21570413191164,5
2020-07-19-170511,170511,0,0,0,165,0.25,82.29113231717506,6
2020-07-20-170511,170511,0,0,1,165,0.08333333333333333,94.52629278815715,0
2020-07-21-170511,170511,0,0,2,165,0.25,83.70665226121952,1
2020-07-22-170511,170511,1,0,2,166,0.4166666666666667,59.969368796419204,2
2020-07-23-170511,170511,3,0,1,169,0.25,85.68126113370604,3
2020-07-24-170511,170511,0,0,4,169,0.3333333333333333,154.84940243041999,4
2020-07-25-170511,170511,0,0,0,169,0.0,160.24015912833045,5
2020-07-26-170511,170511,0,0,0,169,0.08333333333333333,156.5238448007496,6
2020-07-27-170511,170511,0,0,0,169,0.5,139.29517088915975,0
2020-07-28-170511,170511,0,0,1,169,0.25,143.84632401667452,1
2020-07-29-170511,170511,0,0,2,169,0.5,149.28290530312995,2
2020-07-30-170511,170511,3,0,2,172,0.16666666666666666,92.12780412905303,3
2020-07-31-170511,170511,0,0,4,172,0.8333333333333334,147.2273401136026,4
2020-08-01-170511,170511,0,0,0,172,0.25,96.20253710384642,5
2020-08-02-170511,170511,0,0,0,172,0.16666666666666666,693.7663181348842,6
2020-08-03-170511,170511,1,0,0,173,0.3333333333333333,535.468570012571,0
2020-08-04-170511,170511,2,0,0,175,0.5,516.082387614521,1
2020-08-05-170511,170511,2,0,3,177,1.5,470.8073656702286,2
2020-08-06-170511,170511,1,0,1,178,0.75,458.5682478082541,3
2020-08-07-170511,170511,4,1,1,182,0.5,443.15442337993994,4
2020-08-08-170511,170511,0,0,1,182,0.6666666666666666,448.91328427813363,5
2020-08-09-170511,170511,0,0,0,182,0.9166666666666666,428.81897307929273,6
2020-08-10-170511,170511,0,0,2,182,0.5833333333333334,72.46266212806843,0
2020-08-11-170511,170511,1,0,3,183,1.1666666666666667,84.4412836424341,1
2020-08-12-170511,170511,2,0,1,185,1.3333333333333333,123.6479692399406,2
2020-08-13-170511,170511,2,0,0,187,1.5833333333333333,193.78663255109436,3
2020-08-14-170511,170511,4,0,1,191,1.8333333333333333,241.46777959623876,4
2020-08-15-170511,170511,0,0,0,191,1.5,371.673620866847,5
2020-08-16-170511,170511,0,0,1,191,0.8333333333333334,394.6437018294194,6
2020-08-17-170511,170511,0,0,0,191,2.5,412.1481351682725,0
2020-08-18-170511,170511,0,0,5,191,1.5,447.49494579064714,1
2020-08-19-170511,170511,3,0,0,194,2.1666666666666665,458.27067312497826,2
2020-08-20-170511,170511,1,0,0,195,1.5,597.3316602056883,3
2020-08-21-170511,170511,1,0,2,196,3.4166666666666665,507.89290261158317,4
2020-08-22-170511,170511,1,0,1,197,2.5,604.557940821519,5
2020-08-23-170511,170511,0,0,0,197,1.3333333333333333,686.805355034375,6
2020-08-24-170511,170511,2,0,0,199,1.9166666666666667,656.0875825689229,0
2020-08-25-170511,170511,3,0,1,202,1.25,703.1835256797059,1
2020-08-26-170511,170511,1,0,0,203,2.6666666666666665,458.5741739804173,2
2020-08-27-170511,170511,0,0,2,203,2.0,559.3177549648594,3
2020-08-28-170511,170511,1,0,0,204,3.083333333333333,594.2319114495801,4
2020-08-29-170511,170511,0,0,1,204,2.4166666666666665,522.5805810837462,5
2020-08-30-170511,170511,1,0,1,205,1.5833333333333333,527.7106997223328,6
2020-08-31-170511,170511,0,0,6,205,1.6666666666666667,491.27425454623085,0
2020-09-01-170511,170511,5,0,1,210,1.5,411.6734145819563,1
2020-09-02-170511,170511,0,0,2,210,1.9166666666666667,1147.9775117115673,2
2020-09-03-170511,170511,0,0,0,210,4.083333333333333,1220.9660601040919,3
2020-09-04-170511,170511,2,0,2,212,3.333333333333333,1232.5361950413612,4
2020-09-05-170511,170511,1,0,1,213,2.5,1226.4267751882976,5
2020-09-06-170511,170511,0,0,2,213,4.5,1156.0243235840771,6
2020-09-07-170511,170511,0,0,2,213,4.166666666666667,1082.034482674756,0
2020-09-08-170511,170511,1,0,2,214,4.666666666666667,1096.109767150751,1
2020-09-09-170511,170511,0,0,3,214,3.6666666666666665,1162.6725146372328,2
2020-09-10-170511,170511,2,0,3,216,3.333333333333333,555.0231513547417,3
2020-09-11-170511,170511,0,0,3,216,3.9166666666666665,646.6501624802621,4
2020-09-12-170511,170511,1,0,5,217,3.25,754.5215018699633,5
2020-09-13-170511,170511,1,0,4,218,4.916666666666667,823.2012732837409,6
2020-09-14-170511,170511,6,0,3,224,4.333333333333333,870.9847585487528,0
2020-09-15-170511,170511,1,0,0,225,6.333333333333332,1036.5043990627732,1
2020-09-16-170511,170511,2,0,4,227,3.8333333333333335,1203.1083697536571,2
2020-09-17-170511,170511,0,0,2,227,5.5,1168.024131216233,3
2020-09-18-170511,170511,2,0,2,229,7.666666666666668,1155.0410748913798,4
2020-09-19-170511,170511,1,0,2,230,3.75,1191.1240414611052,5
2020-09-20-170511,170511,2,0,1,232,6.75,1058.6922595240617,6
2020-09-21-170511,170511,2,0,1,234,4.666666666666667,1133.134387441014,0
2020-09-22-170511,170511,2,0,1,236,4.416666666666667,1106.8040951154908,1
2020-09-23-170511,170511,3,1,2,239,6.333333333333332,1103.2929218707854,2
2020-09-24-170511,170511,3,1,3,242,4.333333333333333,1167.19458265802,3
2020-09-25-170511,170511,3,0,3,245,4.166666666666667,1148.851156015428,4
2020-09-26-170511,170511,5,0,1,250,3.4166666666666665,1201.1595451785647,5
2020-09-27-170511,170511,4,0,0,254,3.6666666666666665,1354.028349761011,6
2020-09-28-170511,170511,3,0,1,257,3.583333333333333,1306.8260843723067,0
2020-09-29-170511,170511,0,0,2,257,3.25,1292.486737751173,1
2020-09-30-170511,170511,4,0,3,261,4.333333333333333,1250.1322904367626,2
2020-10-01-170511,170511,2,0,4,263,4.0,0.0,3
2020-10-02-170511,170511,2,0,2,265,7.416666666666668,2016.0942018290873,4
2020-10-03-170511,170511,2,1,1,267,5.75,1889.815421095986,5
2020-10-04-170511,170511,1,0,0,268,2.25,1952.891081341629,6
2020-10-05-170511,170511,1,0,0,269,4.916666666666667,1784.1268961305666,0
2020-10-06-170511,170511,1,0,4,270,4.916666666666667,1672.7356532408012,1
2020-10-07-170511,170511,2,0,0,272,3.6666666666666665,1533.8466759580333,2
2020-10-08-170511,170511,3,0,2,275,5.25,1462.4140246569168,3
2020-10-09-170511,170511,3,0,3,278,9.0,1584.5510747043893,4
2020-10-10-170511,170511,1,0,2,279,6.0,162.1641178121282,5
2020-10-11-170511,170511,0,0,1,279,1.5,386.8237827291131,6
2020-10-12-170511,170511,1,0,1,280,4.333333333333333,435.7868949126354,0
2020-10-13-170511,170511,2,0,1,282,4.5,612.2604375478204,1
2020-10-14-170511,170511,3,0,3,285,8.916666666666666,808.761914766829,2
2020-10-15-170511,170511,4,0,1,289,6.833333333333332,1145.7809156081303,3
2020-10-16-170511,170511,2,0,4,291,10.5,1442.9252496352574,4
2020-10-17-170511,170511,1,0,1,292,8.333333333333334,1685.3687031031827,5
2020-10-18-170511,170511,0,0,0,292,3.083333333333333,1776.7940075054535,6
2020-10-19-170511,170511,0,0,1,292,5.916666666666668,1822.6269928045274,0
2020-10-20-170511,170511,4,0,6,296,5.583333333333332,1939.8011864814084,1
2020-10-21-170511,170511,0,0,6,296,3.5,1810.5247924093035,2
2020-10-22-170511,170511,2,0,8,298,6.75,1622.7542121397316,3
2020-10-23-170511,170511,3,0,5,301,9.583333333333334,1511.867949655004,4
2020-10-24-170511,170511,2,0,47,303,6.583333333333332,1432.6775073935742,5
2020-10-25-170511,170511,1,0,1,304,5.5,1580.0682783073003,6
2020-10-26-170511,170511,1,0,6,305,6.75,1526.445956313218,0
2020-10-27-170511,170511,1,1,2,306,8.833333333333334,1507.7556281343318,1
2020-10-28-170511,170511,3,0,1,309,8.166666666666666,1595.6089687799727,2
2020-10-29-170511,170511,1,0,3,310,8.166666666666666,1799.6485994269701,3
2020-10-30-170511,170511,4,0,12,314,9.333333333333334,1757.6144674650432,4
2020-10-31-170511,170511,1,0,0,315,7.833333333333332,1797.3859575793422,5
2020-11-01-170511,170511,0,0,0,315,3.583333333333333,1539.2745662488264,6
2020-11-02-170511,170511,1,0,0,316,6.916666666666668,1940.501317653473,0
2020-11-03-170511,170511,6,0,0,322,4.166666666666667,1681.199606515936,1
2020-11-04-170511,170511,6,0,0,328,7.5,1729.3148246871738,2
2020-11-05-170511,170511,8,1,0,336,7.583333333333332,1781.1439374874792,3
2020-11-06-170511,170511,5,1,0,341,14.916666666666664,2015.4730152896727,4
2020-11-07-170511,170511,47,1,0,388,8.083333333333334,2007.4115146384556,5
2020-11-08-170511,170511,1,1,0,389,4.083333333333333,2934.832720860908,6
2020-11-09-170511,170511,6,0,0,395,6.416666666666668,2833.8002432668573,0
2020-11-10-170511,170511,2,1,0,397,6.333333333333332,1405.846476648947,1
2020-11-11-170511,170511,1,0,0,398,4.333333333333333,1510.4647223996494,2
2020-11-12-170511,170511,3,1,0,401,8.5,1457.4821247764726,3
2020-11-13-170511,170511,12,1,0,413,8.0,1646.4559176020257,4
2020-03-01-170512,170512,0,0,1,0,0.0,0.0,6
2020-03-02-170512,170512,0,0,1,0,0.0,7.538553470036378,0
2020-03-03-170512,170512,0,1,2,0,0.0,49.10823728925391,1
2020-03-04-170512,170512,0,0,3,0,0.0,58.55910310899071,2
2020-03-05-170512,170512,0,0,1,0,0.0,63.77556524881992,3
2020-03-06-170512,170512,0,0,2,0,0.0,50.68628022897926,4
2020-03-07-170512,170512,0,0,1,0,0.0,51.56959284185229,5
2020-03-08-170512,170512,0,0,1,0,0.2,48.66461795524575,6
2020-03-09-170512,170512,1,0,1,1,0.0,49.42686941441794,0
2020-03-10-170512,170512,0,0,1,1,0.0,171.22121190991572,1
2020-03-11-170512,170512,0,0,2,1,0.0,137.28840400587546,2
2020-03-12-170512,170512,0,0,2,1,0.0,110.26261185631591,3
2020-03-13-170512,170512,0,0,5,1,0.2,95.5141692553832,4
2020-03-14-170512,170512,0,0,1,1,0.0,40.30098924244935,5
2020-03-15-170512,170512,1,0,0,2,0.2,23.9830504222763,6
2020-03-16-170512,170512,1,0,1,3,0.2,8.977542955708778,0
2020-03-17-170512,170512,2,0,1,5,0.8,18.65230807217544,1
2020-03-18-170512,170512,3,0,1,8,1.0,25.625039401557938,2
2020-03-19-170512,170512,1,0,2,9,1.6,36.976420413556255,3
2020-03-20-170512,170512,2,0,1,11,3.2,46.01652089589318,4
2020-03-21-170512,170512,1,0,1,12,1.6,65.54638343927721,5
2020-03-22-170512,170512,1,0,0,13,1.4,69.27781802416499,6
2020-03-23-170512,170512,1,0,1,14,3.8,68.99336692527805,0
2020-03-24-170512,170512,1,0,0,15,2.6,87.98439077555169,1
2020-03-25-170512,170512,2,0,0,17,1.8,92.29125607727931,2
2020-03-26-170512,170512,2,0,0,19,3.4,92.83485170991702,3
2020-03-27-170512,170512,5,0,0,24,5.0,109.46599717486784,4
2020-03-28-170512,170512,1,0,0,25,1.2,118.03939269037306,5
2020-03-29-170512,170512,0,0,1,25,1.0,113.4709143854671,6
2020-03-30-170512,170512,1,0,0,26,3.8,88.06704004208994,0
2020-03-31-170512,170512,1,0,0,27,2.2,90.81741937821556,1
2020-04-01-170512,170512,1,0,0,28,3.2,13.759105867064847,2
2020-04-02-170512,170512,2,0,0,30,2.0,37.07296441369237,3
2020-04-03-170512,170512,1,0,0,31,1.0,24.725492983199157,4
2020-04-04-170512,170512,1,0,0,32,1.0,26.76195225158009,5
2020-04-05-170512,170512,0,0,0,32,1.4,30.018787387184354,6
2020-04-06-170512,170512,1,1,0,33,2.4,34.72482594105654,0
2020-04-07-170512,170512,0,0,0,33,2.0,38.0318427813431,1
2020-04-08-170512,170512,0,0,0,33,3.0,46.58157805160222,2
2020-04-09-170512,170512,0,0,0,33,5.0,49.308852280373834,3
2020-04-10-170512,170512,0,0,1,33,2.6,12.904894727551971,4
2020-04-11-170512,170512,0,0,0,33,1.0,22.401082663822468,5
2020-04-12-170512,170512,1,2,0,34,0.6,26.179831060311535,6
2020-04-13-170512,170512,0,0,2,34,2.2,27.9940307564001,0
2020-04-14-170512,170512,0,0,0,34,0.6,36.70987034720184,1
2020-04-15-170512,170512,0,0,0,34,0.8,39.683121319918286,2
2020-04-16-170512,170512,0,0,0,34,1.0,43.99271025842133,3
2020-04-17-170512,170512,0,0,0,34,3.8,40.501962552550474,4
2020-04-18-170512,170512,0,0,1,34,0.0,43.802245757329736,5
2020-04-19-170512,170512,0,0,0,34,0.4,39.417696760530866,6
2020-04-20-170512,170512,0,0,0,34,3.4,37.13459320525019,0
2020-04-21-170512,170512,0,0,0,34,1.2,40.88189719498485,1
2020-04-22-170512,170512,0,0,0,34,0.8,42.266058742175886,2
2020-04-23-170512,170512,0,0,0,34,0.8,40.62775537275119,3
2020-04-24-170512,170512,1,0,1,35,0.6,28.577477348539734,4
2020-04-25-170512,170512,0,0,0,35,0.4,32.74821908990063,5
2020-04-26-170512,170512,0,0,0,35,0.6,35.36436567146743,6
2020-04-27-170512,170512,2,0,0,37,0.4,30.26243200904353,0
2020-04-28-170512,170512,0,0,0,37,0.8,25.338053236077364,1
2020-04-29-170512,170512,0,0,0,37,1.4,23.08226211213129,2
2020-04-30-170512,170512,0,0,1,37,0.4,30.643996948773726,3
2020-05-01-170512,170512,0,0,0,37,0.2,59.49277684043851,4
2020-05-02-170512,170512,1,0,0,38,0.6,17.701890579491852,5
2020-05-03-170512,170512,0,0,0,38,0.0,14.171452601968046,6
2020-05-04-170512,170512,0,0,0,38,1.0,15.249096243999372,0
2020-05-05-170512,170512,0,0,1,38,0.2,18.230902696601138,1
2020-05-06-170512,170512,0,0,0,38,0.6,16.264324196238626,2
2020-05-07-170512,170512,0,0,0,38,1.2,19.66211107028967,3
2020-05-08-170512,170512,1,0,0,39,1.0,20.211314217169317,4
2020-05-09-170512,170512,0,0,0,39,0.0,27.41645476813943,5
2020-05-10-170512,170512,0,0,0,39,0.0,71.70339426352079,6
2020-05-11-170512,170512,0,0,0,39,0.2,63.685852382123855,0
2020-05-12-170512,170512,0,0,0,39,0.8,55.86882661190238,1
2020-05-13-170512,170512,0,0,0,39,0.8,48.09491051535226,2
2020-05-14-170512,170512,1,0,0,40,0.2,37.52988584710561,3
2020-05-15-170512,170512,0,0,0,40,1.2,26.783771840011894,4
2020-05-16-170512,170512,0,0,0,40,0.0,19.257101423418028,5
2020-05-17-170512,170512,0,0,0,40,0.0,17.76257871579461,6
2020-05-18-170512,170512,0,0,1,40,0.4,17.885673856509626,0
2020-05-19-170512,170512,1,0,0,41,1.6,19.07221197838473,1
2020-05-20-170512,170512,0,3,0,41,0.8,21.054822617614544,2
2020-05-21-170512,170512,0,0,0,41,0.6,23.2911391286156,3
2020-05-22-170512,170512,0,0,0,41,0.4,21.847291748805784,4
2020-05-23-170512,170512,0,0,0,41,0.0,25.685762955885423,5
2020-05-24-170512,170512,0,0,0,41,0.0,26.538906973359467,6
2020-05-25-170512,170512,0,0,0,41,0.0,23.261967505094596,0
2020-05-26-170512,170512,0,0,0,41,0.4,17.462528792481468,1
2020-05-27-170512,170512,0,0,0,41,0.6,18.828698032357845,2
2020-05-28-170512,170512,0,4,0,41,0.8,19.012646279263727,3
2020-05-29-170512,170512,0,0,0,41,1.0,19.720415331454703,4
2020-05-30-170512,170512,0,1,0,41,0.2,21.550479614494034,5
2020-05-31-170512,170512,0,0,0,41,0.0,23.462343470276686,6
2020-06-01-170512,170512,1,0,0,42,1.0,37.8240178304066,0
2020-06-02-170512,170512,0,0,0,42,0.4,15.477794357013964,1
2020-06-03-170512,170512,0,1,0,42,0.4,14.611889914474498,2
2020-06-04-170512,170512,0,0,0,42,0.6,20.60356290153563,3
2020-06-05-170512,170512,0,0,0,42,1.4,20.663512034126757,4
2020-06-06-170512,170512,0,0,0,42,0.2,20.278894091729704,5
2020-06-07-170512,170512,0,0,0,42,0.0,19.118360813853457,6
2020-06-08-170512,170512,0,0,0,42,0.6,18.74955645648267,0
2020-06-09-170512,170512,0,1,0,42,0.2,20.06375022673338,1
2020-06-10-170512,170512,0,0,0,42,0.6,38.802340571888664,2
2020-06-11-170512,170512,0,0,0,42,1.0,38.798007399543955,3
2020-06-12-170512,170512,0,0,0,42,0.6,39.48660221671807,4
2020-06-13-170512,170512,0,0,0,42,0.4,33.35925525488141,5
2020-06-14-170512,170512,0,0,0,42,0.0,29.127366413077358,6
2020-06-15-170512,170512,0,0,0,42,0.6,22.244138060234356,0
2020-06-16-170512,170512,0,0,0,42,0.2,25.59242714493798,1
2020-06-17-170512,170512,0,0,0,42,0.4,21.615066216059432,2
2020-06-18-170512,170512,0,0,0,42,0.4,16.075222097901026,3
2020-06-19-170512,170512,0,0,0,42,0.6,14.352140580700931,4
2020-06-20-170512,170512,0,0,0,42,0.2,17.455232821397537,5
2020-06-21-170512,170512,0,0,0,42,0.0,19.113580214914812,6
2020-06-22-170512,170512,0,0,0,42,0.0,15.66124366596361,0
2020-06-23-170512,170512,0,0,0,42,0.0,14.895260521075016,1
2020-06-24-170512,170512,0,0,0,42,0.6,15.3054048052635,2
2020-06-25-170512,170512,0,0,0,42,0.2,14.924481437358754,3
2020-06-26-170512,170512,0,0,0,42,0.6,13.916366396062374,4
2020-06-27-170512,170512,0,0,0,42,0.2,14.198211322798713,5
2020-06-28-170512,170512,0,0,0,42,0.0,14.291190214972618,6
2020-06-29-170512,170512,0,0,0,42,0.4,13.96502937562797,0
2020-06-30-170512,170512,0,0,0,42,0.4,18.97083868692173,1
2020-07-01-170512,170512,0,0,0,42,0.2,23.980807045601814,2
2020-07-02-170512,170512,0,0,0,42,0.2,14.710856346082279,3
2020-07-03-170512,170512,0,0,0,42,0.6,18.501323430926494,4
2020-07-04-170512,170512,0,0,0,42,0.0,22.60237891610788,5
2020-07-05-170512,170512,0,0,1,42,0.2,22.91049388350456,6
2020-07-06-170512,170512,0,0,0,42,0.2,19.132667829067977,0
2020-07-07-170512,170512,0,0,0,42,0.0,15.654616426816983,1
2020-07-08-170512,170512,0,0,0,42,0.2,13.906601798294338,2
2020-07-09-170512,170512,0,0,0,42,0.0,9.742645199198424,3
2020-07-10-170512,170512,0,0,0,42,0.8,20.606341635268514,4
2020-07-11-170512,170512,0,0,0,42,0.2,23.119061198705868,5
2020-07-12-170512,170512,0,0,0,42,0.0,16.41977613114368,6
2020-07-13-170512,170512,0,0,0,42,0.0,15.554424449761218,0
2020-07-14-170512,170512,0,0,0,42,0.8,15.669188906533385,1
2020-07-15-170512,170512,0,0,0,42,0.8,14.107668394899395,2
2020-07-16-170512,170512,0,0,0,42,0.8,16.30076721612597,3
2020-07-17-170512,170512,0,0,0,42,0.2,18.281915148142172,4
2020-07-18-170512,170512,0,0,0,42,0.0,13.401746824910573,5
2020-07-19-170512,170512,1,0,0,43,0.0,13.233470782393786,6
2020-07-20-170512,170512,0,0,0,43,0.2,17.23305400246869,0
2020-07-21-170512,170512,0,0,0,43,0.0,15.946444381596496,1
2020-07-22-170512,170512,0,0,0,43,0.4,12.021541782233282,2
2020-07-23-170512,170512,0,0,0,43,0.8,9.963801485024888,3
2020-07-24-170512,170512,0,0,1,43,0.4,13.343470386815735,4
2020-07-25-170512,170512,0,0,0,43,0.2,15.347759901686686,5
2020-07-26-170512,170512,0,0,0,43,0.0,13.332810664178027,6
2020-07-27-170512,170512,0,0,0,43,0.8,11.18486445739524,0
2020-07-28-170512,170512,0,0,0,43,0.8,12.398835315139191,1
2020-07-29-170512,170512,0,0,0,43,0.0,17.90392170661674,2
2020-07-30-170512,170512,0,0,1,43,0.6,19.40991711530491,3
2020-07-31-170512,170512,0,0,0,43,0.8,20.254951121522453,4
2020-08-01-170512,170512,0,0,0,43,0.2,7.457371817077057,5
2020-08-02-170512,170512,0,0,1,43,0.2,48.90460374933795,6
2020-08-03-170512,170512,0,0,1,43,0.2,70.61010492812058,0
2020-08-04-170512,170512,0,0,0,43,0.4,52.448590832114746,1
2020-08-05-170512,170512,0,0,1,43,0.8,42.1391932269609,2
2020-08-06-170512,170512,0,0,1,43,0.4,33.10605868567929,3
2020-08-07-170512,170512,1,0,4,44,0.8,33.627953365727876,4
2020-08-08-170512,170512,0,0,0,44,0.0,33.62105777019032,5
2020-08-09-170512,170512,0,0,2,44,0.0,32.968979270644965,6
2020-08-10-170512,170512,0,0,0,44,0.2,7.002724905458175,0
2020-08-11-170512,170512,0,0,0,44,0.6,9.052026251236345,1
2020-08-12-170512,170512,0,0,4,44,1.4,11.818305991799853,2
2020-08-13-170512,170512,1,0,0,45,1.0,14.634338855836173,3
2020-08-14-170512,170512,0,0,0,45,1.2,18.243273751951556,4
2020-08-15-170512,170512,0,0,0,45,0.2,25.14025698167787,5
2020-08-16-170512,170512,1,0,0,46,1.0,27.442964060157045,6
2020-08-17-170512,170512,1,0,0,47,0.8,35.068863243618424,0
2020-08-18-170512,170512,0,0,0,47,1.0,38.307301124532344,1
2020-08-19-170512,170512,1,0,0,48,0.8,39.80097716743606,2
2020-08-20-170512,170512,1,0,0,49,1.2,46.622579753697984,3
2020-08-21-170512,170512,4,0,0,53,2.4,46.37744712376606,4
2020-08-22-170512,170512,0,0,1,53,2.0,64.71016297227604,5
2020-08-23-170512,170512,2,0,1,55,0.6,62.1357164789932,6
2020-08-24-170512,170512,0,0,0,55,1.4,61.91300121271195,0
2020-08-25-170512,170512,0,0,0,55,2.0,70.7948203663399,1
2020-08-26-170512,170512,4,0,2,59,1.0,63.424075733193824,2
2020-08-27-170512,170512,0,0,0,59,4.0,74.23313451440603,3
2020-08-28-170512,170512,0,0,0,59,1.2,83.72818253273562,4
2020-08-29-170512,170512,0,0,0,59,0.2,67.67254827552522,5
2020-08-30-170512,170512,0,0,13,59,0.6,62.036820013256154,6
2020-08-31-170512,170512,0,0,5,59,0.6,51.82976248606517,0
2020-09-01-170512,170512,0,0,12,59,2.4,29.132702452894794,1
2020-09-02-170512,170512,0,0,0,59,0.0,106.09235827403722,2
2020-09-03-170512,170512,0,0,1,59,0.6,72.93978929967774,3
2020-09-04-170512,170512,0,0,3,59,2.2,72.756897530298,4
2020-09-05-170512,170512,1,0,4,60,0.8,75.23365636796501,5
2020-09-06-170512,170512,1,0,0,61,1.0,77.04674320259069,6
2020-09-07-170512,170512,0,0,1,61,0.6,73.81464501080539,0
2020-09-08-170512,170512,0,0,1,61,1.2,78.02704034417647,1
2020-09-09-170512,170512,2,0,4,63,3.6,81.01100217355219,2
2020-09-10-170512,170512,0,0,2,63,2.0,39.21686629963496,3
2020-09-11-170512,170512,0,0,0,63,1.6,45.71242482370128,4
2020-09-12-170512,170512,0,0,0,63,0.6,49.68972240965622,5
2020-09-13-170512,170512,13,0,2,76,0.4,50.298757240279784,6
2020-09-14-170512,170512,5,0,0,81,1.4,66.28390939459342,0
2020-09-15-170512,170512,12,0,0,93,0.6,79.35033660642267,1
2020-09-16-170512,170512,0,0,1,93,1.0,99.99462162902017,2
2020-09-17-170512,170512,1,0,2,94,0.8,92.63747905561776,3
2020-09-18-170512,170512,3,0,7,97,0.8,92.36241352666556,4
2020-09-19-170512,170512,4,0,1,101,0.2,94.87122797119096,5
2020-09-20-170512,170512,0,0,1,101,0.8,76.3114037819239,6
2020-09-21-170512,170512,1,0,1,102,1.0,69.70961836398097,0
2020-09-22-170512,170512,1,0,0,103,0.8,59.24651415649253,1
2020-09-23-170512,170512,4,1,0,107,0.8,57.895364164385406,2
2020-09-24-170512,170512,2,1,0,109,1.2,62.209294813573905,3
2020-09-25-170512,170512,0,2,0,109,1.4,59.177099370879276,4
2020-09-26-170512,170512,0,0,1,109,1.8,62.59421738394274,5
2020-09-27-170512,170512,2,0,1,111,1.0,71.96089731339704,6
2020-09-28-170512,170512,0,0,0,111,0.8,73.2815789482576,0
2020-09-29-170512,170512,0,0,2,111,0.0,71.52403637248138,1
2020-09-30-170512,170512,1,0,0,112,1.6,68.71407983659658,2
2020-10-01-170512,170512,2,0,0,114,1.4,0.0,3
2020-10-02-170512,170512,7,0,1,121,2.2,160.9602598623262,4
2020-10-03-170512,170512,1,0,0,122,0.8,155.1452978432099,5
2020-10-04-170512,170512,1,0,0,123,1.6,145.91444646943356,6
2020-10-05-170512,170512,1,0,7,124,0.6,131.9579676111607,0
2020-10-06-170512,170512,0,0,0,124,2.0,128.57776991702278,1
2020-10-07-170512,170512,0,1,1,124,1.6,92.79815468271173,2
2020-10-08-170512,170512,0,0,5,124,2.0,84.63747892206538,3
2020-10-09-170512,170512,0,1,0,124,1.4,93.41488406712551,4
2020-10-10-170512,170512,1,0,1,125,2.6,13.96273773713358,5
2020-10-11-170512,170512,1,0,1,126,0.0,29.76399308697708,6
2020-10-12-170512,170512,0,0,1,126,0.8,32.929357523245116,0
2020-10-13-170512,170512,2,0,1,128,1.4,38.18853434032964,1
2020-10-14-170512,170512,0,0,0,128,8.0,49.38974003928949,2
2020-10-15-170512,170512,0,0,3,128,2.0,127.384072732573,3
2020-10-16-170512,170512,1,0,0,129,1.8,139.4136985746904,4
2020-10-17-170512,170512,0,0,1,129,0.4,146.09396430418735,5
2020-10-18-170512,170512,0,0,2,129,0.4,140.2651468249291,6
2020-10-19-170512,170512,7,0,5,136,0.2,143.17971876734595,0
2020-10-20-170512,170512,0,0,0,136,2.6,167.064463421781,1
2020-10-21-170512,170512,1,0,10,137,0.6,107.16982898927861,2
2020-10-22-170512,170512,5,0,0,142,0.6,107.35605034238753,3
2020-10-23-170512,170512,0,0,5,142,2.8,104.43240361809923,4
2020-10-24-170512,170512,1,1,0,143,1.4,109.73133123402116,5
2020-10-25-170512,170512,1,0,3,144,1.6,116.050450781314,6
2020-10-26-170512,170512,1,0,1,145,1.6,112.73248317292939,0
2020-10-27-170512,170512,1,0,7,146,1.0,109.07415904591801,1
2020-10-28-170512,170512,0,1,1,146,4.4,104.59612466599566,2
2020-10-29-170512,170512,3,0,6,149,1.6,132.06700717007803,3
2020-10-30-170512,170512,0,0,1,149,1.6,122.66348307681265,4
2020-10-31-170512,170512,1,0,0,150,1.0,127.20297142627086,5
2020-11-01-170512,170512,2,0,0,152,0.8,78.23116363361625,6
2020-11-02-170512,170512,5,0,0,157,1.2,140.98997025144507,0
2020-11-03-170512,170512,0,0,0,157,2.6,136.7957854535938,1
2020-11-04-170512,170512,10,0,0,167,2.8,140.44883412920615,2
2020-11-05-170512,170512,0,0,0,167,2.8,156.27051192104383,3
2020-11-06-170512,170512,5,0,0,172,1.2,164.9378456173676,4
2020-11-07-170512,170512,0,0,0,172,10.8,155.07787323299723,5
2020-11-08-170512,170512,3,0,0,175,1.6,178.63151121567165,6
2020-11-09-170512,170512,1,0,0,176,2.4,175.23744544065508,0
2020-11-10-170512,170512,7,0,0,183,1.2,72.50070297892262,1
2020-11-11-170512,170512,1,0,0,184,1.0,81.65617338461122,2
2020-11-12-170512,170512,6,1,0,190,1.6,83.22743141579095,3
2020-11-13-170512,170512,1,0,0,191,4.2,95.7895686070834,4
2020-03-01-170513,170513,0,0,0,0,0.0,0.0,6
2020-03-02-170513,170513,0,0,17,0,0.0,201.78398257272917,0
2020-03-03-170513,170513,0,2,7,0,0.0,1300.5863461440063,1
2020-03-04-170513,170513,1,0,16,1,0.0,1475.4141374140268,2
2020-03-05-170513,170513,0,0,19,1,0.0,1547.2828711644063,3
2020-03-06-170513,170513,0,0,28,1,0.0,1374.1594113128835,4
2020-03-07-170513,170513,0,0,11,1,0.0,1351.4848535217368,5
2020-03-08-170513,170513,0,0,7,1,0.0,1285.5015518874807,6
2020-03-09-170513,170513,2,0,38,3,0.5,1289.9981288614877,0
2020-03-10-170513,170513,0,0,38,3,0.5,4679.802228141998,1
2020-03-11-170513,170513,1,0,25,4,0.75,4200.857018431321,2
2020-03-12-170513,170513,2,0,26,6,0.75,3450.576378539975,3
2020-03-13-170513,170513,3,0,23,9,0.5,2868.234388626679,4
2020-03-14-170513,170513,2,0,14,11,0.5,1011.2760704737805,5
2020-03-15-170513,170513,0,0,11,11,1.0,754.036048678496,6
2020-03-16-170513,170513,17,0,24,28,3.25,214.25524232540926,0
2020-03-17-170513,170513,7,0,22,35,5.0,449.40122959509654,1
2020-03-18-170513,170513,16,0,15,51,9.75,640.5511708658946,2
2020-03-19-170513,170513,19,0,10,70,10.25,906.312113097436,3
2020-03-20-170513,170513,28,0,14,98,8.25,1116.296757543792,4
2020-03-21-170513,170513,11,0,8,109,7.25,1316.29839672262,5
2020-03-22-170513,170513,7,0,9,116,6.25,1384.7184674266293,6
2020-03-23-170513,170513,38,0,19,154,14.0,1350.8041133793577,0
2020-03-24-170513,170513,38,0,12,192,13.25,1661.7943770033608,1
2020-03-25-170513,170513,25,0,16,217,15.0,1859.3528862086969,2
2020-03-26-170513,170513,26,0,14,243,15.5,1917.4416014604426,3
2020-03-27-170513,170513,23,0,10,266,12.0,2296.179843503714,4
2020-03-28-170513,170513,14,0,8,280,6.25,2348.084043313549,5
2020-03-29-170513,170513,11,0,4,291,4.0,2357.3921280792065,6
2020-03-30-170513,170513,24,0,11,315,15.25,1861.6039325760107,0
2020-03-31-170513,170513,22,1,9,337,9.25,1725.8809926746344,1
2020-04-01-170513,170513,15,0,14,352,5.25,273.0950044220344,2
2020-04-02-170513,170513,10,0,22,362,8.75,873.0721043324617,3
2020-04-03-170513,170513,14,0,10,376,6.0,507.8681065113923,4
2020-04-04-170513,170513,8,0,3,384,1.75,647.0895661855095,5
2020-04-05-170513,170513,9,0,3,393,4.5,695.600240383486,6
2020-04-06-170513,170513,19,0,11,412,7.75,790.257935566382,0
2020-04-07-170513,170513,12,0,6,424,5.0,963.6262436082243,1
2020-04-08-170513,170513,16,0,20,440,6.75,1041.5416827671177,2
2020-04-09-170513,170513,14,0,1,454,5.5,1197.5882789655032,3
2020-04-10-170513,170513,10,0,7,464,7.25,244.6226161419171,4
2020-04-11-170513,170513,8,0,1,472,7.25,379.6459357616492,5
2020-04-12-170513,170513,4,0,4,476,0.75,486.7230045396359,6
2020-04-13-170513,170513,11,0,4,487,2.75,525.4846540082395,0
2020-04-14-170513,170513,9,0,7,496,5.25,661.3406669763144,1
2020-04-15-170513,170513,14,0,3,510,4.0,838.4134806396894,2
2020-04-16-170513,170513,22,0,9,532,3.5,1013.5406625869389,3
2020-04-17-170513,170513,10,0,11,542,4.0,1020.048078336735,4
2020-04-18-170513,170513,3,0,1,545,1.0,1029.7556921382404,5
2020-04-19-170513,170513,3,0,2,548,1.5,962.4045767110456,6
2020-04-20-170513,170513,11,0,5,559,4.0,1040.0357143758129,0
2020-04-21-170513,170513,6,0,9,565,6.0,993.2820515337035,1
2020-04-22-170513,170513,20,0,13,585,5.0,909.9942376601025,2
2020-04-23-170513,170513,1,0,5,586,2.5,897.9724155576864,3
2020-04-24-170513,170513,7,0,4,593,3.5,757.5386444644721,4
2020-04-25-170513,170513,1,0,2,594,1.25,834.6589037425055,5
2020-04-26-170513,170513,4,0,2,598,2.0,828.5453114775663,6
2020-04-27-170513,170513,4,2,10,602,4.75,681.9259146741606,0
2020-04-28-170513,170513,7,0,7,609,2.5,637.2013160882188,1
2020-04-29-170513,170513,3,0,11,612,2.75,650.9835739821478,2
2020-04-30-170513,170513,9,0,7,621,2.25,735.1858713531243,3
2020-05-01-170513,170513,11,0,2,632,1.25,1363.161218856404,4
2020-05-02-170513,170513,1,0,1,633,1.0,507.390972858499,5
2020-05-03-170513,170513,2,0,1,635,0.25,309.5897150997199,6
2020-05-04-170513,170513,5,0,6,640,3.5,313.37543832427815,0
2020-05-05-170513,170513,9,0,4,649,2.5,358.5725294691199,1
2020-05-06-170513,170513,13,0,6,662,2.0,382.88713114005304,2
2020-05-07-170513,170513,5,0,6,667,2.75,468.6744787246946,3
2020-05-08-170513,170513,4,0,11,671,4.25,547.2807019485779,4
2020-05-09-170513,170513,2,0,2,673,1.75,656.813643759676,5
2020-05-10-170513,170513,2,1,0,675,0.75,1595.9461003771207,6
2020-05-11-170513,170513,10,2,2,685,3.25,1511.2120656379802,0
2020-05-12-170513,170513,7,0,5,692,3.25,1434.8638423792868,1
2020-05-13-170513,170513,11,0,6,703,3.0,1217.4261987929203,2
2020-05-14-170513,170513,7,2,1,710,3.0,1113.5278254891343,3
2020-05-15-170513,170513,2,1,2,712,3.0,917.9671348463592,4
2020-05-16-170513,170513,1,0,0,713,0.25,697.284973530679,5
2020-05-17-170513,170513,1,0,0,714,0.0,600.2191164406123,6
2020-05-18-170513,170513,6,0,2,720,3.25,603.3592894065949,0
2020-05-19-170513,170513,4,0,1,724,4.25,568.7009384834262,1
2020-05-20-170513,170513,6,1,2,730,1.0,530.3942251970733,2
2020-05-21-170513,170513,6,0,0,736,2.0,524.8100867513172,3
2020-05-22-170513,170513,11,0,2,747,1.75,536.6204403175833,4
2020-05-23-170513,170513,2,0,0,749,0.75,684.8774261865148,5
2020-05-24-170513,170513,0,0,1,749,0.0,699.562630389836,6
2020-05-25-170513,170513,2,0,0,751,2.25,598.2879018232261,0
2020-05-26-170513,170513,5,0,1,756,3.0,443.6402695436476,1
2020-05-27-170513,170513,6,0,4,762,3.75,518.8697718036492,2
2020-05-28-170513,170513,1,1,2,763,1.75,561.4846892423639,3
2020-05-29-170513,170513,2,1,3,765,2.0,535.6948560067157,4
2020-05-30-170513,170513,0,0,1,765,0.25,465.56792941809056,5
2020-05-31-170513,170513,0,0,0,765,0.75,501.75846041990724,6
2020-06-01-170513,170513,2,0,0,767,2.25,842.8292724477477,0
2020-06-02-170513,170513,1,0,4,768,1.5,285.54391277624063,1
2020-06-03-170513,170513,2,0,2,770,0.75,198.52569148444002,2
2020-06-04-170513,170513,0,0,1,770,2.0,212.30530787058848,3
2020-06-05-170513,170513,2,0,3,772,1.25,206.99095696590172,4
2020-06-06-170513,170513,0,1,1,772,0.25,196.61202427883882,5
2020-06-07-170513,170513,1,0,1,773,0.0,182.5180988418702,6
2020-06-08-170513,170513,0,0,3,773,2.75,190.66889884046617,0
2020-06-09-170513,170513,1,0,2,774,0.75,235.39447681738378,1
2020-06-10-170513,170513,4,0,1,778,1.25,952.8540715199107,2
2020-06-11-170513,170513,2,0,2,780,1.25,868.3155613271856,3
2020-06-12-170513,170513,3,0,1,783,1.75,765.6229366656383,4
2020-06-13-170513,170513,1,0,2,784,0.75,667.5996890106168,5
2020-06-14-170513,170513,0,0,0,784,0.0,511.07182659954356,6
2020-06-15-170513,170513,0,0,0,784,1.25,366.02060395864135,0
2020-06-16-170513,170513,4,0,2,788,0.75,342.93676179546924,1
2020-06-17-170513,170513,2,0,1,790,1.5,317.29568531784867,2
2020-06-18-170513,170513,1,0,0,791,0.5,305.40997186867094,3
2020-06-19-170513,170513,3,0,0,794,2.25,293.7311512708967,4
2020-06-20-170513,170513,1,0,0,795,0.5,326.780646533676,5
2020-06-21-170513,170513,1,0,0,796,0.5,345.0633066795525,6
2020-06-22-170513,170513,3,0,1,799,0.5,338.3233786729669,0
2020-06-23-170513,170513,2,0,2,801,0.5,306.94583538288316,1
2020-06-24-170513,170513,1,0,1,802,0.75,286.8785239493978,2
2020-06-25-170513,170513,2,3,0,804,0.25,280.5035591845048,3
2020-06-26-170513,170513,1,1,1,805,1.5,236.45750885726784,4
2020-06-27-170513,170513,2,0,0,807,0.25,245.43242339922955,5
2020-06-28-170513,170513,0,0,0,807,0.25,251.8924017552654,6
2020-06-29-170513,170513,0,0,0,807,1.25,240.6523188250742,0
2020-06-30-170513,170513,2,0,0,809,0.25,237.98320845883592,1
2020-07-01-170513,170513,1,0,5,810,0.25,240.53935572161225,2
2020-07-02-170513,170513,0,0,1,810,0.75,124.09364508100414,3
2020-07-03-170513,170513,0,0,0,810,0.75,172.90301859975324,4
2020-07-04-170513,170513,0,0,1,810,0.75,222.32981202426657,5
2020-07-05-170513,170513,0,0,0,810,0.25,235.80610311041661,6
2020-07-06-170513,170513,1,0,0,811,0.0,229.13588666411442,0
2020-07-07-170513,170513,2,0,0,813,1.0,235.9000978388042,1
2020-07-08-170513,170513,1,0,0,814,0.75,217.82867624820213,2
2020-07-09-170513,170513,0,0,0,814,1.5,198.40686725117453,3
2020-07-10-170513,170513,1,0,2,815,1.5,220.27779804259774,4
2020-07-11-170513,170513,0,0,0,815,0.0,239.7865189454935,5
2020-07-12-170513,170513,0,0,0,815,0.25,205.3318377710326,6
2020-07-13-170513,170513,0,0,0,815,0.75,195.28399287110875,0
2020-07-14-170513,170513,0,0,0,815,2.0,196.6608946960439,1
2020-07-15-170513,170513,5,0,3,820,0.5,150.79287921191852,2
2020-07-16-170513,170513,1,0,0,821,0.75,173.89730321430258,3
2020-07-17-170513,170513,0,0,4,821,0.25,171.119696087442,4
2020-07-18-170513,170513,1,0,0,822,0.25,98.11274364152628,5
2020-07-19-170513,170513,0,0,1,822,0.5,113.25044521624065,6
2020-07-20-170513,170513,0,0,0,822,0.0,125.89915821469603,0
2020-07-21-170513,170513,0,0,1,822,0.5,109.80480090602012,1
2020-07-22-170513,170513,0,0,2,822,0.5,73.89583045827217,2
2020-07-23-170513,170513,0,0,2,822,1.25,105.37636679044681,3
2020-07-24-170513,170513,2,0,3,824,0.25,186.54788818064563,4
2020-07-25-170513,170513,0,0,0,824,0.0,195.15894309913617,5
2020-07-26-170513,170513,0,0,3,824,0.0,190.39010855617852,6
2020-07-27-170513,170513,0,0,3,824,0.0,168.74754944645593,0
2020-07-28-170513,170513,0,0,1,824,0.0,173.86106635615653,1
2020-07-29-170513,170513,3,0,4,827,0.5,176.289018149195,2
2020-07-30-170513,170513,0,0,1,827,0.75,112.8858669028244,3
2020-07-31-170513,170513,4,1,6,831,0.0,174.71818505053977,4
2020-08-01-170513,170513,0,0,0,831,0.5,130.73124473634357,5
2020-08-02-170513,170513,1,0,0,832,0.0,879.1483132464787,6
2020-08-03-170513,170513,0,0,4,832,0.5,695.0637960205065,0
2020-08-04-170513,170513,1,0,6,833,0.75,682.8307264495845,1
2020-08-05-170513,170513,2,0,11,835,1.25,624.628385567199,2
2020-08-06-170513,170513,2,0,1,837,1.0,599.3568212909775,3
2020-08-07-170513,170513,3,0,9,840,1.25,577.0215532229774,4
2020-08-08-170513,170513,0,0,6,840,1.0,561.7024219653223,5
2020-08-09-170513,170513,3,0,0,843,1.25,534.7350260911124,6
2020-08-10-170513,170513,3,0,7,846,0.0,97.59598067093543,0
2020-08-11-170513,170513,1,0,0,847,1.25,112.65888239615501,1
2020-08-12-170513,170513,4,0,6,851,1.75,158.0720914264664,2
2020-08-13-170513,170513,1,0,7,852,2.75,249.23635742074293,3
2020-08-14-170513,170513,6,0,7,858,2.0,309.9755153544679,4
2020-08-15-170513,170513,0,0,9,858,2.0,472.6833937903556,5
2020-08-16-170513,170513,0,0,1,858,0.75,495.190621319593,6
2020-08-17-170513,170513,4,0,5,862,2.5,514.9246783818456,0
2020-08-18-170513,170513,6,0,3,868,0.25,562.6154572410336,1
2020-08-19-170513,170513,11,0,3,879,2.0,587.5700582470295,2
2020-08-20-170513,170513,1,0,13,880,1.75,755.791597631764,3
2020-08-21-170513,170513,9,0,9,889,1.5,638.2553265403087,4
2020-08-22-170513,170513,6,0,10,895,3.25,758.2765457489515,5
2020-08-23-170513,170513,0,0,6,895,2.5,876.9030102774743,6
2020-08-24-170513,170513,7,0,15,902,2.75,835.058942032439,0
2020-08-25-170513,170513,0,0,12,902,3.75,884.7946191984713,1
2020-08-26-170513,170513,6,0,7,908,2.75,567.5920088299646,2
2020-08-27-170513,170513,7,0,5,915,1.0,697.1835906724856,3
2020-08-28-170513,170513,7,0,12,922,3.0,750.3238367249592,4
2020-08-29-170513,170513,9,0,8,931,3.5,663.2520664124518,5
2020-08-30-170513,170513,1,0,3,932,1.0,691.3566235356182,6
2020-08-31-170513,170513,5,0,11,937,2.75,643.4806996013106,0
2020-09-01-170513,170513,3,1,9,940,3.25,525.201980090047,1
2020-09-02-170513,170513,3,0,9,943,4.5,1544.1420568729359,2
2020-09-03-170513,170513,13,0,12,956,5.75,1617.3147806496524,3
2020-09-04-170513,170513,9,0,16,965,4.0,1645.985695404763,4
2020-09-05-170513,170513,10,0,7,975,2.75,1641.7195216525033,5
2020-09-06-170513,170513,6,0,18,981,6.25,1548.263009003563,6
2020-09-07-170513,170513,15,0,14,996,4.25,1454.1953505192691,0
2020-09-08-170513,170513,12,0,10,1008,5.5,1487.5643820745324,1
2020-09-09-170513,170513,7,0,11,1015,3.25,1589.4493847123244,2
2020-09-10-170513,170513,5,0,15,1020,3.75,726.0550698468938,3
2020-09-11-170513,170513,12,0,10,1032,4.5,855.2115046824786,4
2020-09-12-170513,170513,8,0,5,1040,4.25,1016.3221700916379,5
2020-09-13-170513,170513,3,0,9,1043,5.0,1115.363765676812,6
2020-09-14-170513,170513,11,1,7,1054,5.0,1178.778606007537,0
2020-09-15-170513,170513,9,0,2,1063,9.75,1409.9984816291055,1
2020-09-16-170513,170513,9,0,8,1072,5.75,1652.6937003586104,2
2020-09-17-170513,170513,12,0,11,1084,8.5,1621.7195255409183,3
2020-09-18-170513,170513,16,0,19,1100,8.5,1621.0984596065996,4
2020-09-19-170513,170513,7,1,17,1107,3.5,1678.835791380513,5
2020-09-20-170513,170513,18,0,6,1125,7.25,1523.9774384394673,6
2020-09-21-170513,170513,14,0,13,1139,6.5,1639.6140652402353,0
2020-09-22-170513,170513,10,1,22,1149,5.0,1610.4285963359598,1
2020-09-23-170513,170513,11,1,14,1160,9.75,1600.340621915247,2
2020-09-24-170513,170513,15,1,23,1175,4.5,1682.9657874623067,3
2020-09-25-170513,170513,10,1,35,1185,5.5,1654.8139567541464,4
2020-09-26-170513,170513,5,0,11,1190,6.75,1731.4878401832452,5
2020-09-27-170513,170513,9,0,1,1199,7.5,1936.3416233511252,6
2020-09-28-170513,170513,7,0,18,1206,7.75,1873.1253559377487,0
2020-09-29-170513,170513,2,0,16,1208,5.5,1844.320657976693,1
2020-09-30-170513,170513,8,0,20,1216,7.0,1789.236497416321,2
2020-10-01-170513,170513,11,0,25,1227,5.0,0.0,3
2020-10-02-170513,170513,19,0,27,1246,7.75,2921.4854934422438,4
2020-10-03-170513,170513,17,0,22,1263,7.25,2728.211251164294,5
2020-10-04-170513,170513,6,2,6,1269,2.25,2819.7111048750794,6
2020-10-05-170513,170513,13,1,11,1282,4.25,2581.6044935247987,0
2020-10-06-170513,170513,22,2,10,1304,3.75,2406.30741229324,1
2020-10-07-170513,170513,14,0,8,1318,3.75,2238.044247041879,2
2020-10-08-170513,170513,23,0,16,1341,3.25,2105.4237257549203,3
2020-10-09-170513,170513,35,0,24,1376,8.0,2278.7335489938814,4
2020-10-10-170513,170513,11,0,13,1387,8.0,236.20364097770783,5
2020-10-11-170513,170513,1,0,9,1388,3.0,560.0179542951546,6
2020-10-12-170513,170513,18,0,7,1406,4.75,631.7291462960695,0
2020-10-13-170513,170513,16,0,26,1422,6.25,874.30399863016,1
2020-10-14-170513,170513,20,0,12,1442,7.75,1165.687335832317,2
2020-10-15-170513,170513,25,0,8,1467,9.75,1574.665792322845,3
2020-10-16-170513,170513,27,0,19,1494,11.75,2008.9419392541656,4
2020-10-17-170513,170513,22,0,6,1516,11.0,2350.7471684696457,5
2020-10-18-170513,170513,6,0,4,1522,4.0,2481.472228365342,6
2020-10-19-170513,170513,11,0,19,1533,8.5,2533.3042279009387,0
2020-10-20-170513,170513,10,1,6,1543,7.25,2724.7136352302396,1
2020-10-21-170513,170513,8,0,7,1551,3.5,2581.848522390087,2
2020-10-22-170513,170513,16,1,21,1567,6.75,2299.892244055916,3
2020-10-23-170513,170513,24,0,19,1591,9.0,2129.986577554282,4
2020-10-24-170513,170513,13,0,11,1604,6.0,2022.2935064517972,5
2020-10-25-170513,170513,9,0,8,1613,10.25,2220.169402384288,6
2020-10-26-170513,170513,7,0,13,1620,8.25,2139.9671172762505,0
2020-10-27-170513,170513,26,1,14,1646,7.25,2115.02289030698,1
2020-10-28-170513,170513,12,0,9,1658,8.0,2262.7277560083685,2
2020-10-29-170513,170513,8,0,31,1666,13.5,2536.5639620844586,3
2020-10-30-170513,170513,19,0,22,1685,10.75,2500.5284363440087,4
2020-10-31-170513,170513,6,1,0,1691,11.25,2539.070991803199,5
2020-11-01-170513,170513,4,2,0,1695,4.25,2250.2036501298235,6
2020-11-02-170513,170513,19,1,0,1714,11.0,2741.5891896065277,0
2020-11-03-170513,170513,6,1,0,1720,6.5,2356.019075440687,1
2020-11-04-170513,170513,7,0,0,1727,7.5,2416.183557535222,2
2020-11-05-170513,170513,21,1,0,1748,8.25,2441.7181219155927,3
2020-11-06-170513,170513,19,1,0,1767,14.0,2767.801493855096,4
2020-11-07-170513,170513,11,0,0,1778,20.5,2761.539000997921,5
2020-11-08-170513,170513,8,0,0,1786,7.25,3895.6397823764164,6
2020-11-09-170513,170513,13,1,0,1799,7.75,3723.3600327792647,0
2020-11-10-170513,170513,14,1,0,1813,7.0,2049.1875006881683,1
2020-11-11-170513,170513,9,0,0,1822,5.25,2181.3231646969243,2
2020-11-12-170513,170513,31,2,0,1853,9.25,2093.6146220176934,3
2020-11-13-170513,170513,22,1,0,1875,13.0,2331.9923101425456,4
2020-03-01-170514,170514,0,0,0,0,0.0,0.0,6
2020-03-02-170514,170514,0,0,0,0,0.0,9.240274342605584,0
2020-03-03-170514,170514,0,0,0,0,0.0,76.56906853822468,1
2020-03-04-170514,170514,0,2,0,0,0.0,93.27210124519732,2
2020-03-05-170514,170514,0,1,1,0,0.0,103.58955974315653,3
2020-03-06-170514,170514,0,0,0,0,0.0,85.4487338668988,4
2020-03-07-170514,170514,0,1,4,0,0.0,85.31036191603731,5
2020-03-08-170514,170514,0,0,0,0,0.0,79.68227868166579,6
2020-03-09-170514,170514,0,0,3,0,0.16666666666666666,80.72647216253277,0
2020-03-10-170514,170514,0,0,3,0,0.0,286.5250731819507,1
2020-03-11-170514,170514,0,0,0,0,0.0,235.47605810781775,2
2020-03-12-170514,170514,0,0,1,0,0.5,158.5077146178968,3
2020-03-13-170514,170514,0,0,2,0,0.3333333333333333,136.87563656606028,4
2020-03-14-170514,170514,0,0,1,0,0.6666666666666666,82.95425415963271,5
2020-03-15-170514,170514,0,0,1,0,0.3333333333333333,54.065210298398554,6
2020-03-16-170514,170514,0,0,2,0,1.0,20.842321628472956,0
2020-03-17-170514,170514,0,0,3,0,0.8333333333333334,32.34660534764494,1
2020-03-18-170514,170514,0,0,1,0,0.8333333333333334,38.88314403515773,2
2020-03-19-170514,170514,1,0,0,1,1.5,49.04129440465234,3
2020-03-20-170514,170514,0,0,3,1,3.1666666666666665,56.42265076348143,4
2020-03-21-170514,170514,4,0,1,5,1.8333333333333333,70.45049764191421,5
2020-03-22-170514,170514,0,0,4,5,0.8333333333333334,86.66474431125502,6
2020-03-23-170514,170514,3,0,2,8,4.166666666666667,83.82290148679884,0
2020-03-24-170514,170514,3,0,1,11,1.3333333333333333,113.92363634783723,1
2020-03-25-170514,170514,0,0,0,11,1.6666666666666667,128.52801890240147,2
2020-03-26-170514,170514,1,0,1,12,1.6666666666666667,122.83128816373855,3
2020-03-27-170514,170514,2,0,23,14,3.1666666666666665,140.56440513737238,4
2020-03-28-170514,170514,1,0,0,15,0.8333333333333334,156.51029791416272,5
2020-03-29-170514,170514,1,0,0,16,0.5,142.5235377615524,6
2020-03-30-170514,170514,2,0,2,18,2.5,111.5078972645991,0
2020-03-31-170514,170514,3,0,1,21,1.0,121.27175488888248,1
2020-04-01-170514,170514,1,0,2,22,2.1666666666666665,24.308338540954388,2
2020-04-02-170514,170514,0,0,1,22,1.1666666666666667,109.66915206815116,3
2020-04-03-170514,170514,3,0,0,25,1.1666666666666667,72.94016247412125,4
2020-04-04-170514,170514,1,0,0,26,0.6666666666666666,72.52027469493444,5
2020-04-05-170514,170514,4,0,1,30,0.3333333333333333,65.83802315517362,6
2020-04-06-170514,170514,2,3,1,32,1.1666666666666667,70.56481830240729,0
2020-04-07-170514,170514,1,0,1,33,1.1666666666666667,81.92532052973333,1
2020-04-08-170514,170514,0,0,0,33,2.0,84.83477468017932,2
2020-04-09-170514,170514,1,0,0,34,2.0,86.90692390936313,3
2020-04-10-170514,170514,23,0,2,57,0.5,28.136204262373873,4
2020-04-11-170514,170514,0,1,4,57,1.0,97.57629069124005,5
2020-04-12-170514,170514,0,0,2,57,0.8333333333333334,103.65868810501824,6
2020-04-13-170514,170514,2,0,0,59,1.6666666666666667,108.79724644463826,0
2020-04-14-170514,170514,1,0,0,60,1.6666666666666667,130.01542972973903,1
2020-04-15-170514,170514,2,0,1,62,1.0,146.1192558496979,2
2020-04-16-170514,170514,1,0,0,63,1.3333333333333333,156.83199687279895,3
2020-04-17-170514,170514,0,0,0,63,3.0,156.12828010370288,4
2020-04-18-170514,170514,0,0,0,63,0.16666666666666666,120.9624791344207,5
2020-04-19-170514,170514,1,0,0,64,0.5,115.23320583416816,6
2020-04-20-170514,170514,1,0,4,65,2.833333333333333,102.22339189839872,0
2020-04-21-170514,170514,1,0,0,66,0.3333333333333333,121.94476190793688,1
2020-04-22-170514,170514,0,0,0,66,0.6666666666666666,112.72789735991873,2
2020-04-23-170514,170514,0,0,0,66,0.8333333333333334,106.01939092179174,3
2020-04-24-170514,170514,2,0,2,68,0.8333333333333334,73.68313483249415,4
2020-04-25-170514,170514,4,0,0,72,0.6666666666666666,86.36642655277579,5
2020-04-26-170514,170514,2,0,1,74,0.3333333333333333,98.79111765041289,6
2020-04-27-170514,170514,0,0,1,74,0.0,96.29886610615003,0
2020-04-28-170514,170514,0,1,1,74,1.8333333333333333,66.54428969924643,1
2020-04-29-170514,170514,1,2,0,75,1.1666666666666667,69.68685119785093,2
2020-04-30-170514,170514,0,0,0,75,0.8333333333333334,82.56857087140382,3
2020-05-01-170514,170514,0,0,0,75,0.6666666666666666,109.69829780588842,4
2020-05-02-170514,170514,0,0,0,75,0.6666666666666666,30.525261631269576,5
2020-05-03-170514,170514,0,0,0,75,0.16666666666666666,36.72767653174721,6
2020-05-04-170514,170514,4,0,0,79,1.6666666666666667,39.65021549856378,0
2020-05-05-170514,170514,0,0,0,79,0.16666666666666666,49.82855924337897,1
2020-05-06-170514,170514,0,0,0,79,0.8333333333333334,44.75317900767888,2
2020-05-07-170514,170514,0,0,2,79,1.3333333333333333,49.80393570087191,3
2020-05-08-170514,170514,2,0,0,81,1.3333333333333333,44.656813730951214,4
2020-05-09-170514,170514,0,1,0,81,0.16666666666666666,65.40695555163298,5
2020-05-10-170514,170514,1,1,0,82,0.16666666666666666,130.06678781106808,6
2020-05-11-170514,170514,1,0,0,83,0.5,121.05391677892268,0
2020-05-12-170514,170514,1,0,1,84,0.8333333333333334,112.00881938421853,1
2020-05-13-170514,170514,0,0,0,84,1.0,100.57409878109185,2
2020-05-14-170514,170514,0,2,0,84,0.16666666666666666,93.43341623350346,3
2020-05-15-170514,170514,0,0,2,84,0.6666666666666666,72.07564302124669,4
2020-05-16-170514,170514,0,0,0,84,0.0,49.26916305263558,5
2020-05-17-170514,170514,0,0,0,84,0.16666666666666666,45.819487137255166,6
2020-05-18-170514,170514,0,0,1,84,0.8333333333333334,42.7673716480923,0
2020-05-19-170514,170514,0,0,2,84,0.3333333333333333,40.3467902717407,1
2020-05-20-170514,170514,0,0,1,84,1.3333333333333333,36.571474282216066,2
2020-05-21-170514,170514,2,0,2,86,0.8333333333333334,47.79253503554732,3
2020-05-22-170514,170514,0,0,0,86,1.0,55.554945375699404,4
2020-05-23-170514,170514,0,0,0,86,0.16666666666666666,65.22016742052801,5
2020-05-24-170514,170514,0,0,0,86,0.0,65.22076231033752,6
2020-05-25-170514,170514,0,0,0,86,0.3333333333333333,59.879529500753144,0
2020-05-26-170514,170514,1,0,1,87,0.8333333333333334,56.65117821362018,1
2020-05-27-170514,170514,0,0,13,87,0.6666666666666666,59.34533115120736,2
2020-05-28-170514,170514,0,1,3,87,0.3333333333333333,55.148540072240166,3
2020-05-29-170514,170514,2,0,0,89,1.0,40.88285473582697,4
2020-05-30-170514,170514,0,0,0,89,0.0,51.891746930092935,5
2020-05-31-170514,170514,0,0,0,89,0.0,56.1893134449113,6
2020-06-01-170514,170514,1,0,1,90,1.0,79.89605903232233,0
2020-06-02-170514,170514,2,0,0,92,0.5,45.88208103807223,1
2020-06-03-170514,170514,1,0,0,93,0.6666666666666666,43.4973819479181,2
2020-06-04-170514,170514,2,0,1,95,0.3333333333333333,53.24775100121799,3
2020-06-05-170514,170514,0,2,0,95,1.5,59.74909532832373,4
2020-06-06-170514,170514,0,0,1,95,0.3333333333333333,66.22025824589419,5
2020-06-07-170514,170514,0,0,0,95,0.0,62.67608481245286,6
2020-06-08-170514,170514,0,0,0,95,0.8333333333333334,61.688218220917605,0
2020-06-09-170514,170514,1,0,2,96,0.5,65.76080576614478,1
2020-06-10-170514,170514,13,0,0,109,1.3333333333333333,85.28750245081937,2
2020-06-11-170514,170514,3,0,1,112,0.8333333333333334,122.78265639082294,3
2020-06-12-170514,170514,0,0,1,112,0.6666666666666666,143.15800395034537,4
2020-06-13-170514,170514,0,0,0,112,0.3333333333333333,141.09229541844616,5
2020-06-14-170514,170514,0,0,0,112,0.0,130.52513249380442,6
2020-06-15-170514,170514,1,0,0,113,1.0,113.89484271035977,0
2020-06-16-170514,170514,0,0,1,113,0.3333333333333333,128.8134971351946,1
2020-06-17-170514,170514,0,0,1,113,0.3333333333333333,117.00068953230286,2
2020-06-18-170514,170514,1,0,2,114,0.8333333333333334,58.73740776064864,3
2020-06-19-170514,170514,0,0,0,114,0.3333333333333333,48.83607872254484,4
2020-06-20-170514,170514,1,0,0,115,0.5,55.632818981394,5
2020-06-21-170514,170514,0,0,0,115,0.0,65.0541570351606,6
2020-06-22-170514,170514,0,0,5,115,0.16666666666666666,51.615365165700204,0
2020-06-23-170514,170514,2,0,0,117,0.3333333333333333,52.32712733467329,1
2020-06-24-170514,170514,0,0,0,117,0.5,58.082757366755224,2
2020-06-25-170514,170514,1,0,0,118,0.5,51.54287096173066,3
2020-06-26-170514,170514,1,0,0,119,0.5,55.771951531568774,4
2020-06-27-170514,170514,0,1,1,119,0.3333333333333333,52.60875237793458,5
2020-06-28-170514,170514,0,0,0,119,0.0,49.06500159320111,6
2020-06-29-170514,170514,0,0,0,119,0.5,47.22251203776199,0
2020-06-30-170514,170514,1,0,0,120,1.0,51.78056074785113,1
2020-07-01-170514,170514,1,0,3,121,0.3333333333333333,73.7897976875534,2
2020-07-02-170514,170514,2,0,2,123,0.8333333333333334,48.684721432035154,3
2020-07-03-170514,170514,0,0,0,123,0.5,40.30085135827423,4
2020-07-04-170514,170514,0,0,0,123,0.16666666666666666,36.607026412941984,5
2020-07-05-170514,170514,0,0,0,123,0.3333333333333333,38.26704886422309,6
2020-07-06-170514,170514,5,0,0,128,0.6666666666666666,30.18509072332383,0
2020-07-07-170514,170514,0,0,0,128,0.3333333333333333,57.48348861503693,1
2020-07-08-170514,170514,0,0,0,128,0.5,52.11316792158499,2
2020-07-09-170514,170514,0,0,0,128,0.0,48.65287816933738,3
2020-07-10-170514,170514,0,0,0,128,0.8333333333333334,73.06749888144424,4
2020-07-11-170514,170514,1,0,0,129,0.16666666666666666,64.51530927455453,5
2020-07-12-170514,170514,0,0,0,129,0.0,50.179068613913955,6
2020-07-13-170514,170514,0,0,0,129,0.16666666666666666,47.7374803216911,0
2020-07-14-170514,170514,0,0,0,129,0.3333333333333333,49.82713840325658,1
2020-07-15-170514,170514,3,0,0,132,0.6666666666666666,47.78014072258102,2
2020-07-16-170514,170514,2,0,1,134,1.1666666666666667,46.1644045997173,3
2020-07-17-170514,170514,0,0,0,134,0.16666666666666666,59.1319258713699,4
2020-07-18-170514,170514,0,0,0,134,0.16666666666666666,53.37021204436337,5
2020-07-19-170514,170514,0,0,0,134,0.0,49.69425840001316,6
2020-07-20-170514,170514,0,0,0,134,0.16666666666666666,68.22428238390751,0
2020-07-21-170514,170514,0,0,0,134,0.3333333333333333,59.66766602988338,1
2020-07-22-170514,170514,0,0,0,134,0.0,52.963759592608746,2
2020-07-23-170514,170514,0,0,1,134,0.0,32.69488141196972,3
2020-07-24-170514,170514,0,0,0,134,0.3333333333333333,34.19279607346367,4
2020-07-25-170514,170514,0,0,0,134,0.6666666666666666,40.852395352464995,5
2020-07-26-170514,170514,0,0,1,134,0.0,43.8471031148758,6
2020-07-27-170514,170514,0,0,2,134,1.0,25.553647427324822,0
2020-07-28-170514,170514,0,0,1,134,0.8333333333333334,34.839297360734314,1
2020-07-29-170514,170514,0,0,4,134,0.8333333333333334,38.42526798587838,2
2020-07-30-170514,170514,1,0,2,135,0.0,53.35470905751638,3
2020-07-31-170514,170514,0,0,0,135,0.8333333333333334,45.87719714698816,4
2020-08-01-170514,170514,0,0,0,135,0.3333333333333333,52.72070654130659,5
2020-08-02-170514,170514,0,0,1,135,0.16666666666666666,124.53688959726034,6
2020-08-03-170514,170514,0,0,0,135,0.16666666666666666,337.65854832672255,0
2020-08-04-170514,170514,0,0,1,135,0.3333333333333333,220.0743914782318,1
2020-08-05-170514,170514,0,0,1,135,0.8333333333333334,166.48211615879404,2
2020-08-06-170514,170514,1,0,0,136,0.16666666666666666,80.07525522610817,3
2020-08-07-170514,170514,0,0,4,136,0.3333333333333333,79.2315450339405,4
2020-08-08-170514,170514,0,0,0,136,0.16666666666666666,74.01024527773052,5
2020-08-09-170514,170514,1,0,2,137,0.0,74.630452213168,6
2020-08-10-170514,170514,2,1,5,139,1.1666666666666667,57.29910507850597,0
2020-08-11-170514,170514,1,0,2,140,1.1666666666666667,73.89173546644642,1
2020-08-12-170514,170514,4,0,1,144,3.333333333333333,87.47371101256178,2
2020-08-13-170514,170514,2,0,6,146,1.1666666666666667,104.04720237701525,3
2020-08-14-170514,170514,0,0,0,146,0.8333333333333334,129.05563541389745,4
2020-08-15-170514,170514,0,0,0,146,0.3333333333333333,135.89495496100062,5
2020-08-16-170514,170514,1,0,0,147,0.3333333333333333,141.99720564090262,6
2020-08-17-170514,170514,0,0,1,147,0.8333333333333334,152.09603455578213,0
2020-08-18-170514,170514,1,0,0,148,1.5,146.6300047708246,1
2020-08-19-170514,170514,1,0,1,149,1.3333333333333333,162.93130082514364,2
2020-08-20-170514,170514,0,0,4,149,1.0,109.52263472457784,3
2020-08-21-170514,170514,4,0,2,153,4.666666666666667,114.96834882767213,4
2020-08-22-170514,170514,0,0,0,153,0.6666666666666666,193.45073610170508,5
2020-08-23-170514,170514,2,0,1,155,2.333333333333333,194.65963352372998,6
2020-08-24-170514,170514,5,0,2,160,2.1666666666666665,217.0404297645207,0
2020-08-25-170514,170514,2,0,7,162,4.166666666666667,243.6351359355619,1
2020-08-26-170514,170514,1,0,1,163,3.0,271.33990663902233,2
2020-08-27-170514,170514,6,0,4,169,4.666666666666667,328.8369618914893,3
2020-08-28-170514,170514,0,0,0,169,1.6666666666666667,408.1458469430779,4
2020-08-29-170514,170514,0,0,1,169,1.0,334.3356673048871,5
2020-08-30-170514,170514,0,0,0,169,1.3333333333333333,290.07667659696915,6
2020-08-31-170514,170514,1,0,0,170,1.6666666666666667,246.59446462379844,0
2020-09-01-170514,170514,0,0,3,170,0.8333333333333334,64.21853071265217,1
2020-09-02-170514,170514,1,0,2,171,0.6666666666666666,187.05030781346812,2
2020-09-03-170514,170514,4,0,0,175,0.6666666666666666,207.65976430117382,3
2020-09-04-170514,170514,2,0,4,177,1.1666666666666667,200.81737337034332,4
2020-09-05-170514,170514,0,0,0,177,0.3333333333333333,229.67322082074136,5
2020-09-06-170514,170514,1,0,4,178,0.6666666666666666,193.55224635595647,6
2020-09-07-170514,170514,2,0,0,180,0.5,200.1190402468373,0
2020-09-08-170514,170514,7,0,0,187,1.8333333333333333,198.7679671698425,1
2020-09-09-170514,170514,1,0,1,188,2.0,192.70204357575136,2
2020-09-10-170514,170514,4,0,2,192,1.5,51.45314711037381,3
2020-09-11-170514,170514,0,0,0,192,1.0,81.7909236433214,4
2020-09-12-170514,170514,1,0,4,193,0.5,97.23159004130358,5
2020-09-13-170514,170514,0,0,0,193,0.6666666666666666,98.1022536645393,6
2020-09-14-170514,170514,0,0,0,193,0.5,110.8175007979107,0
2020-09-15-170514,170514,3,0,5,196,0.6666666666666666,132.71384240564845,1
2020-09-16-170514,170514,2,0,1,198,1.0,159.58999043453002,2
2020-09-17-170514,170514,0,0,5,198,1.0,178.76612994050748,3
2020-09-18-170514,170514,4,0,2,202,1.1666666666666667,164.2827093621309,4
2020-09-19-170514,170514,0,0,0,202,0.3333333333333333,175.87873868657107,5
2020-09-20-170514,170514,4,0,1,206,0.6666666666666666,166.25620560442638,6
2020-09-21-170514,170514,0,0,7,206,1.0,174.5673875480112,0
2020-09-22-170514,170514,0,1,1,206,1.6666666666666667,161.69245830980134,1
2020-09-23-170514,170514,1,0,1,207,1.3333333333333333,138.0497185545225,2
2020-09-24-170514,170514,2,1,3,209,1.0,138.0786511730912,3
2020-09-25-170514,170514,0,1,0,209,1.3333333333333333,126.12035339328563,4
2020-09-26-170514,170514,4,0,3,213,2.333333333333333,132.62570995246676,5
2020-09-27-170514,170514,0,1,0,213,1.0,169.4409673169194,6
2020-09-28-170514,170514,0,0,0,213,1.1666666666666667,146.52722616814813,0
2020-09-29-170514,170514,5,0,0,218,2.0,147.5524657864854,1
2020-09-30-170514,170514,1,0,0,219,1.8333333333333333,180.75450402361986,2
2020-10-01-170514,170514,5,0,3,224,2.1666666666666665,0.0,3
2020-10-02-170514,170514,2,0,2,226,2.1666666666666665,291.7555365054077,4
2020-10-03-170514,170514,0,1,3,226,1.3333333333333333,343.8105542652555,5
2020-10-04-170514,170514,1,0,1,227,2.5,312.37307156966233,6
2020-10-05-170514,170514,7,0,2,234,2.1666666666666665,308.9342279614426,0
2020-10-06-170514,170514,1,0,3,235,2.1666666666666665,326.64876414565265,1
2020-10-07-170514,170514,1,0,3,236,2.0,266.19823606748787,2
2020-10-08-170514,170514,3,2,3,239,2.6666666666666665,246.5839338933677,3
2020-10-09-170514,170514,0,0,2,239,1.1666666666666667,286.17108031272477,4
2020-10-10-170514,170514,3,0,0,242,2.333333333333333,57.77968101802615,5
2020-10-11-170514,170514,0,0,0,242,0.8333333333333334,102.3899695788293,6
2020-10-12-170514,170514,0,0,1,242,2.833333333333333,117.69198722926129,0
2020-10-13-170514,170514,0,0,1,242,2.333333333333333,138.97059485355993,1
2020-10-14-170514,170514,0,0,3,242,3.0,168.66242674276162,2
2020-10-15-170514,170514,3,0,0,245,2.1666666666666665,204.04546771010655,3
2020-10-16-170514,170514,2,0,0,247,1.1666666666666667,244.55674082775664,4
2020-10-17-170514,170514,3,0,0,250,3.333333333333333,244.3507269696276,5
2020-10-18-170514,170514,1,0,0,251,2.1666666666666665,241.73570416521682,6
2020-10-19-170514,170514,2,0,0,253,3.1666666666666665,251.24485966158397,0
2020-10-20-170514,170514,3,1,0,256,8.333333333333334,283.7618641120508,1
2020-10-21-170514,170514,3,0,3,259,2.333333333333333,330.94488705514595,2
2020-10-22-170514,170514,3,1,8,262,4.5,332.63431786539854,3
2020-10-23-170514,170514,2,0,1,264,5.333333333333333,326.6214045859447,4
2020-10-24-170514,170514,0,0,1,264,4.666666666666667,319.0664581363551,5
2020-10-25-170514,170514,0,1,2,264,3.0,331.1171171597422,6
2020-10-26-170514,170514,1,0,1,265,2.6666666666666665,321.35173575491814,0
2020-10-27-170514,170514,1,1,7,266,2.6666666666666665,317.9375250381022,1
2020-10-28-170514,170514,3,0,2,269,7.833333333333332,270.91896228116366,2
2020-10-29-170514,170514,0,0,7,269,5.333333333333333,318.1561688189538,3
2020-10-30-170514,170514,0,0,2,269,4.333333333333333,293.1327346630293,4
2020-10-31-170514,170514,0,0,0,269,2.333333333333333,300.5360516252216,5
2020-11-01-170514,170514,0,0,0,269,3.8333333333333335,256.5065721186301,6
2020-11-02-170514,170514,0,1,0,269,2.6666666666666665,384.8430433631072,0
2020-11-03-170514,170514,0,1,0,269,6.166666666666668,374.2465720792673,1
2020-11-04-170514,170514,3,0,0,272,3.6666666666666665,404.29868676176085,2
2020-11-05-170514,170514,8,0,0,280,3.333333333333333,390.1141316021075,3
2020-11-06-170514,170514,1,0,0,281,1.8333333333333333,407.32683378616593,4
2020-11-07-170514,170514,1,0,0,282,2.833333333333333,346.7872737854599,5
2020-11-08-170514,170514,2,0,0,284,2.5,345.2886095892346,6
2020-11-09-170514,170514,1,0,0,285,2.5,330.44200355832015,0
2020-11-10-170514,170514,7,0,0,292,1.8333333333333333,239.5885654334034,1
2020-11-11-170514,170514,2,0,0,294,2.333333333333333,258.20750273209717,2
2020-11-12-170514,170514,7,0,0,301,4.5,227.0395227020519,3
2020-11-13-170514,170514,2,0,0,303,2.1666666666666665,278.78673378430574,4
2020-03-01-170515,170515,0,0,2,0,0.0,0.0,6
2020-03-02-170515,170515,0,0,7,0,0.0,61.326028269718016,0
2020-03-03-170515,170515,0,1,6,0,0.0,385.9767434937784,1
2020-03-04-170515,170515,0,0,12,0,0.25,436.2670487920841,2
2020-03-05-170515,170515,0,0,16,0,0.0,454.55082892632504,3
2020-03-06-170515,170515,0,0,19,0,0.0,397.7525636108371,4
2020-03-07-170515,170515,0,0,10,0,0.0,391.87577082278426,5
2020-03-08-170515,170515,0,0,10,0,0.0,374.76122673805503,6
2020-03-09-170515,170515,1,1,26,1,1.0,376.70768883792124,0
2020-03-10-170515,170515,1,0,20,2,0.25,1428.7930045813064,1
2020-03-11-170515,170515,2,0,20,4,0.5,1278.0266173302637,2
2020-03-12-170515,170515,0,0,23,4,1.5,1058.2133499057,3
2020-03-13-170515,170515,1,0,18,5,1.25,879.062097724491,4
2020-03-14-170515,170515,1,0,7,6,1.0,298.1993955672548,5
2020-03-15-170515,170515,2,0,7,8,1.5,225.14222818543007,6
2020-03-16-170515,170515,7,0,23,15,6.0,62.169818478212825,0
2020-03-17-170515,170515,6,0,13,21,8.0,124.00059869685364,1
2020-03-18-170515,170515,12,0,3,33,13.0,186.36830817390046,2
2020-03-19-170515,170515,16,0,14,49,15.25,269.4756768015118,3
2020-03-20-170515,170515,19,0,8,68,12.5,341.9277377044038,4
2020-03-21-170515,170515,10,0,3,78,8.5,405.79714364505014,5
2020-03-22-170515,170515,10,0,2,88,7.25,428.2032618656501,6
2020-03-23-170515,170515,26,0,13,114,22.75,425.6938481654678,0
2020-03-24-170515,170515,20,0,8,134,21.75,520.3049749293789,1
2020-03-25-170515,170515,20,0,6,154,20.25,580.4619097197958,2
2020-03-26-170515,170515,23,0,6,177,20.5,596.648859514588,3
2020-03-27-170515,170515,18,0,8,195,16.75,721.2217789238362,4
2020-03-28-170515,170515,7,0,20,202,9.5,753.0635039926053,5
2020-03-29-170515,170515,7,0,2,209,6.5,755.9622654850325,6
2020-03-30-170515,170515,23,0,2,232,17.0,595.7231785349945,0
2020-03-31-170515,170515,13,0,11,245,14.25,556.8095356704392,1
2020-04-01-170515,170515,3,0,4,248,11.0,85.16985819091941,2
2020-04-02-170515,170515,14,0,5,262,10.75,297.208959677421,3
2020-04-03-170515,170515,8,0,8,270,14.75,179.09568550564677,4
2020-04-04-170515,170515,3,0,3,273,3.5,227.02889697450422,5
2020-04-05-170515,170515,2,0,5,275,7.25,239.16302730353658,6
2020-04-06-170515,170515,13,0,5,288,12.75,270.73377878827915,0
2020-04-07-170515,170515,8,5,9,296,8.75,325.5871892895029,1
2020-04-08-170515,170515,6,0,9,302,17.0,348.2968114826643,2
2020-04-09-170515,170515,6,1,8,308,10.75,404.38852258732663,3
2020-04-10-170515,170515,8,0,3,316,10.0,81.74798043640205,4
2020-04-11-170515,170515,20,0,3,336,3.75,129.5744281596343,5
2020-04-12-170515,170515,2,0,2,338,2.0,161.47384803853342,6
2020-04-13-170515,170515,2,0,9,340,7.75,174.68267249924267,0
2020-04-14-170515,170515,11,0,6,351,12.0,221.14431166592,1
2020-04-15-170515,170515,4,0,2,355,13.25,290.4615735498139,2
2020-04-16-170515,170515,5,0,3,360,9.25,357.91854929412506,3
2020-04-17-170515,170515,8,0,1,368,5.75,348.1012681704565,4
2020-04-18-170515,170515,3,1,4,371,4.0,344.36440962841255,5
2020-04-19-170515,170515,5,0,0,376,1.0,332.2232298812243,6
2020-04-20-170515,170515,5,0,8,381,7.5,356.5984091639581,0
2020-04-21-170515,170515,9,0,5,390,8.75,331.1186436202253,1
2020-04-22-170515,170515,9,0,4,399,8.0,303.04268199118974,2
2020-04-23-170515,170515,8,0,3,407,1.25,297.63472589118464,3
2020-04-24-170515,170515,3,0,11,410,8.5,255.39591829530997,4
2020-04-25-170515,170515,3,0,2,413,1.5,280.98837731844105,5
2020-04-26-170515,170515,2,0,2,415,2.0,281.3085248383131,6
2020-04-27-170515,170515,9,0,2,424,3.25,229.85872462760375,0
2020-04-28-170515,170515,6,0,7,430,5.25,214.46156176959204,1
2020-04-29-170515,170515,2,0,2,432,4.0,216.90305474889863,2
2020-04-30-170515,170515,3,0,5,435,5.5,261.6645107761847,3
2020-05-01-170515,170515,1,0,4,436,3.75,452.3170058136631,4
2020-05-02-170515,170515,4,0,1,440,0.75,167.4294944592171,5
2020-05-03-170515,170515,0,0,0,440,1.5,102.71551067218226,6
2020-05-04-170515,170515,8,0,6,448,4.0,107.41407898441949,0
2020-05-05-170515,170515,5,0,5,453,4.0,123.7822529863588,1
2020-05-06-170515,170515,4,0,2,457,5.75,127.70074512824277,2
2020-05-07-170515,170515,3,0,2,460,5.0,152.10233027752906,3
2020-05-08-170515,170515,11,0,1,471,4.75,179.8776019636518,4
2020-05-09-170515,170515,2,0,0,473,1.75,218.20554782704392,5
2020-05-10-170515,170515,2,0,0,475,1.0,528.5779895267152,6
2020-05-11-170515,170515,2,0,5,477,6.25,502.6641313326053,0
2020-05-12-170515,170515,7,0,4,484,4.25,474.073399835248,1
2020-05-13-170515,170515,2,0,8,486,6.25,402.3769554165325,2
2020-05-14-170515,170515,5,1,3,491,4.5,363.9730928984317,3
2020-05-15-170515,170515,4,0,3,495,2.0,286.8835485338835,4
2020-05-16-170515,170515,1,0,0,496,0.25,209.4550282265372,5
2020-05-17-170515,170515,0,0,2,496,0.75,182.69131663080253,6
2020-05-18-170515,170515,6,0,2,502,5.25,184.67290222794097,0
2020-05-19-170515,170515,5,0,3,507,5.5,176.42199504687636,1
2020-05-20-170515,170515,2,0,1,509,2.75,173.53477709050276,2
2020-05-21-170515,170515,2,0,3,511,3.75,171.51872383856616,3
2020-05-22-170515,170515,1,0,3,512,5.5,173.76826545255844,4
2020-05-23-170515,170515,0,0,1,512,1.25,219.87855643774338,5
2020-05-24-170515,170515,0,0,0,512,0.0,222.80819425318745,6
2020-05-25-170515,170515,5,0,10,517,2.0,190.1673451284118,0
2020-05-26-170515,170515,4,0,2,521,3.75,134.84038659696716,1
2020-05-27-170515,170515,8,1,0,529,4.5,156.15723850404194,2
2020-05-28-170515,170515,3,1,3,532,2.5,170.73260592913982,3
2020-05-29-170515,170515,3,0,5,535,2.25,166.11905353960395,4
2020-05-30-170515,170515,0,0,2,535,0.75,148.2222593617391,5
2020-05-31-170515,170515,2,0,0,537,0.5,159.77992454128156,6
2020-06-01-170515,170515,2,1,3,539,3.5,261.7088413663056,0
2020-06-02-170515,170515,3,0,1,542,1.75,86.610683983813,1
2020-06-03-170515,170515,1,0,3,543,2.25,59.41593463687359,2
2020-06-04-170515,170515,3,0,1,546,2.25,64.33608286766376,3
2020-06-05-170515,170515,3,0,2,549,1.0,65.60636556414929,4
2020-06-06-170515,170515,1,0,0,550,0.25,60.91245620980148,5
2020-06-07-170515,170515,0,0,2,550,0.5,58.44037456326659,6
2020-06-08-170515,170515,10,0,1,560,1.75,61.65608097006463,0
2020-06-09-170515,170515,2,0,1,562,0.75,78.08710327596825,1
2020-06-10-170515,170515,0,0,0,562,2.75,300.0316591838504,2
2020-06-11-170515,170515,3,0,0,565,1.5,272.7002242284564,3
2020-06-12-170515,170515,5,0,0,570,1.5,243.48197047079873,4
2020-06-13-170515,170515,2,0,1,572,1.0,213.45752367565865,5
2020-06-14-170515,170515,0,1,0,572,0.0,162.68423133323762,6
2020-06-15-170515,170515,3,0,4,575,0.75,113.98841089018602,0
2020-06-16-170515,170515,1,0,0,576,1.5,108.23255205242512,1
2020-06-17-170515,170515,3,0,0,579,1.25,97.48855390754957,2
2020-06-18-170515,170515,1,0,2,580,1.0,93.3223076789843,3
2020-06-19-170515,170515,2,0,1,582,2.0,88.91059978745395,4
2020-06-20-170515,170515,0,0,1,582,1.0,98.86438225950523,5
2020-06-21-170515,170515,2,0,0,584,0.25,104.58360559781205,6
2020-06-22-170515,170515,1,0,0,585,1.5,101.45875739887961,0
2020-06-23-170515,170515,1,0,1,586,1.0,91.96029659629801,1
2020-06-24-170515,170515,0,0,2,586,0.75,86.14749749260956,2
2020-06-25-170515,170515,0,0,2,586,1.0,83.99768595317252,3
2020-06-26-170515,170515,0,1,1,586,1.25,71.34206017588623,4
2020-06-27-170515,170515,1,0,0,587,0.5,73.09220635338323,5
2020-06-28-170515,170515,0,0,1,587,0.0,74.01053114183357,6
2020-06-29-170515,170515,4,0,1,591,0.5,70.75225113670155,0
2020-06-30-170515,170515,0,0,5,591,0.75,71.52704350089492,1
2020-07-01-170515,170515,0,0,1,591,0.75,76.35463724651513,2
2020-07-02-170515,170515,2,0,2,593,0.75,37.70777412073781,3
2020-07-03-170515,170515,1,0,0,594,0.25,51.56956471519517,4
2020-07-04-170515,170515,1,0,1,595,1.0,69.18927693915296,5
2020-07-05-170515,170515,0,0,1,595,0.0,74.31302287886584,6
2020-07-06-170515,170515,0,0,0,595,0.25,71.9990269269687,0
2020-07-07-170515,170515,1,0,0,596,1.25,73.55324202235538,1
2020-07-08-170515,170515,2,0,1,598,0.5,68.61099049477903,2
2020-07-09-170515,170515,2,0,1,600,1.25,61.921000013315,3
2020-07-10-170515,170515,1,0,0,601,1.25,71.09080131027935,4
2020-07-11-170515,170515,0,0,0,601,0.0,75.36841027762452,5
2020-07-12-170515,170515,1,0,0,602,0.25,65.36965081100357,6
2020-07-13-170515,170515,1,0,0,603,0.5,61.79700379620701,0
2020-07-14-170515,170515,5,0,0,608,0.75,62.17567220681115,1
2020-07-15-170515,170515,1,0,1,609,1.5,46.23896722632822,2
2020-07-16-170515,170515,2,0,0,611,1.0,52.49364076169174,3
2020-07-17-170515,170515,0,0,0,611,0.5,52.43160857132818,4
2020-07-18-170515,170515,1,0,0,612,0.5,29.863961270292826,5
2020-07-19-170515,170515,1,0,0,613,0.25,34.59052363528679,6
2020-07-20-170515,170515,0,0,1,613,0.25,38.942475665718995,0
2020-07-21-170515,170515,0,0,0,613,0.5,34.568131878466275,1
2020-07-22-170515,170515,1,0,0,614,1.0,24.39388012372802,2
2020-07-23-170515,170515,1,0,0,615,1.0,34.74104915478636,3
2020-07-24-170515,170515,0,0,0,615,0.75,61.18492763179332,4
2020-07-25-170515,170515,0,0,2,615,0.0,63.2013768412675,5
2020-07-26-170515,170515,0,0,2,615,0.0,61.62156823101368,6
2020-07-27-170515,170515,0,0,0,615,0.0,54.54591990287503,0
2020-07-28-170515,170515,0,0,3,615,0.0,55.67196171690935,1
2020-07-29-170515,170515,1,0,3,616,1.0,56.54655665163069,2
2020-07-30-170515,170515,0,0,3,616,0.75,33.27445795536459,3
2020-07-31-170515,170515,0,0,2,616,1.75,54.509503470082166,4
2020-08-01-170515,170515,0,0,3,616,0.75,40.20365324035635,5
2020-08-02-170515,170515,0,0,2,616,0.5,269.0243572965531,6
2020-08-03-170515,170515,1,0,5,617,0.75,210.52031714745885,0
2020-08-04-170515,170515,0,0,0,617,1.0,206.04896276337107,1
2020-08-05-170515,170515,0,0,2,617,2.0,188.30852087132035,2
2020-08-06-170515,170515,0,0,3,617,1.75,181.39513688848297,3
2020-08-07-170515,170515,0,0,2,617,2.25,173.1358500045489,4
2020-08-08-170515,170515,2,0,5,619,1.0,172.27540601162244,5
2020-08-09-170515,170515,2,0,2,621,1.5,164.41346496087942,6
2020-08-10-170515,170515,0,0,4,621,1.25,29.398630750750247,0
2020-08-11-170515,170515,3,0,7,624,1.75,33.68779594188097,1
2020-08-12-170515,170515,3,0,2,627,1.75,48.95700513344002,2
2020-08-13-170515,170515,3,0,0,630,2.0,76.63243957473011,3
2020-08-14-170515,170515,2,0,7,632,3.25,95.89786923709806,4
2020-08-15-170515,170515,3,0,5,635,2.75,145.21937631588997,5
2020-08-16-170515,170515,2,0,1,637,0.25,154.09230952937395,6
2020-08-17-170515,170515,5,0,2,642,2.5,159.1718107083614,0
2020-08-18-170515,170515,0,0,1,642,1.75,172.4416183863174,1
2020-08-19-170515,170515,2,0,11,644,5.75,176.51833637774425,2
2020-08-20-170515,170515,3,0,9,647,1.25,229.97170216987647,3
2020-08-21-170515,170515,2,0,7,649,4.25,195.04589890152667,4
2020-08-22-170515,170515,5,0,3,654,4.5,229.83307316373958,5
2020-08-23-170515,170515,2,0,7,656,2.0,264.5279594938834,6
2020-08-24-170515,170515,4,0,10,660,4.25,252.90311922178276,0
2020-08-25-170515,170515,7,0,8,667,1.75,270.7604492412119,1
2020-08-26-170515,170515,2,0,6,669,5.0,173.19890940322568,2
2020-08-27-170515,170515,0,1,5,669,2.75,212.54973298705784,3
2020-08-28-170515,170515,7,0,9,676,5.25,226.48333429196768,4
2020-08-29-170515,170515,5,0,7,681,5.25,200.19596725928324,5
2020-08-30-170515,170515,1,0,9,682,1.75,204.89690198650243,6
2020-08-31-170515,170515,2,0,6,684,3.75,192.054251237509,0
2020-09-01-170515,170515,1,0,6,685,2.25,157.84881942004932,1
2020-09-02-170515,170515,11,0,9,696,2.5,452.9596863071773,2
2020-09-03-170515,170515,9,0,11,705,7.0,485.95444204646844,3
2020-09-04-170515,170515,7,0,13,712,5.75,489.5676588254513,4
2020-09-05-170515,170515,3,0,6,715,6.25,486.3390165328533,5
2020-09-06-170515,170515,7,0,14,722,6.25,461.60865141224946,6
2020-09-07-170515,170515,10,0,13,732,7.25,433.9461719406719,0
2020-09-08-170515,170515,8,0,9,740,6.75,442.80018756765094,1
2020-09-09-170515,170515,6,0,13,746,3.75,464.5351457896811,2
2020-09-10-170515,170515,5,0,7,751,6.0,218.9446053005169,3
2020-09-11-170515,170515,9,0,7,760,6.75,258.0776197960939,4
2020-09-12-170515,170515,7,0,7,767,6.5,308.33262184609447,5
2020-09-13-170515,170515,9,0,7,776,6.75,339.3644168243604,6
2020-09-14-170515,170515,6,0,15,782,6.5,364.10424624486757,0
2020-09-15-170515,170515,6,0,13,788,9.5,430.73928447071,1
2020-09-16-170515,170515,9,0,12,797,6.75,502.2609785620324,2
2020-09-17-170515,170515,11,0,5,808,8.75,492.9158346888591,3
2020-09-18-170515,170515,13,0,13,821,12.0,486.5267650305677,4
2020-09-19-170515,170515,6,0,9,827,4.25,497.6488765168953,5
2020-09-20-170515,170515,14,0,5,841,13.5,440.45554680129317,6
2020-09-21-170515,170515,13,0,6,854,7.5,480.0635400260795,0
2020-09-22-170515,170515,9,0,7,863,7.0,473.7095006814411,1
2020-09-23-170515,170515,13,0,3,876,10.75,472.64845485940003,2
2020-09-24-170515,170515,7,1,5,883,9.0,501.36905870374244,3
2020-09-25-170515,170515,7,0,11,890,9.25,496.2960244403949,4
2020-09-26-170515,170515,7,0,8,897,6.5,522.0785703887345,5
2020-09-27-170515,170515,7,0,4,904,7.75,586.7447373131245,6
2020-09-28-170515,170515,15,0,6,919,6.0,560.5476489409557,0
2020-09-29-170515,170515,13,0,11,932,4.75,548.8402248244546,1
2020-09-30-170515,170515,12,0,10,944,6.75,529.8378799754921,2
2020-10-01-170515,170515,5,0,15,949,6.5,0.0,3
2020-10-02-170515,170515,13,0,21,962,13.75,861.0257104337493,4
2020-10-03-170515,170515,9,0,22,971,12.25,807.1103368419881,5
2020-10-04-170515,170515,5,0,10,976,4.0,835.8871097511324,6
2020-10-05-170515,170515,6,0,16,982,10.5,765.2341110845965,0
2020-10-06-170515,170515,7,0,5,989,9.0,716.8770564059389,1
2020-10-07-170515,170515,3,1,2,992,8.0,659.8850955013648,2
2020-10-08-170515,170515,5,0,15,997,10.0,624.3921072031073,3
2020-10-09-170515,170515,11,1,15,1008,19.5,670.4290870945837,4
2020-10-10-170515,170515,8,0,15,1016,10.0,67.05069594275847,5
2020-10-11-170515,170515,4,0,21,1020,1.5,164.27336330623052,6
2020-10-12-170515,170515,6,0,16,1026,10.25,185.7634062578677,0
2020-10-13-170515,170515,11,0,15,1037,8.0,262.9423569127478,1
2020-10-14-170515,170515,10,0,14,1047,11.5,348.0393421989475,2
2020-10-15-170515,170515,15,0,16,1062,14.25,465.0630386017806,3
2020-10-16-170515,170515,21,0,18,1083,20.0,588.7078745486708,4
2020-10-17-170515,170515,22,0,25,1105,17.25,696.7672401256863,5
2020-10-18-170515,170515,10,0,6,1115,3.5,740.5835771953072,6
2020-10-19-170515,170515,16,0,20,1131,7.75,754.7872864425926,0
2020-10-20-170515,170515,5,0,11,1136,9.25,803.0218316326394,1
2020-10-21-170515,170515,2,0,15,1138,6.5,763.8688743061075,2
2020-10-22-170515,170515,15,0,11,1153,12.0,687.207711167171,3
2020-10-23-170515,170515,15,0,20,1168,15.5,637.8428691021181,4
2020-10-24-170515,170515,15,0,16,1183,9.75,599.095403461615,5
2020-10-25-170515,170515,21,1,9,1204,8.75,663.6013875496417,6
2020-10-26-170515,170515,16,1,9,1220,10.25,640.7717749711013,0
2020-10-27-170515,170515,15,1,10,1235,14.75,635.3136864082735,1
2020-10-28-170515,170515,14,0,14,1249,12.25,678.7849181796266,2
2020-10-29-170515,170515,16,1,11,1265,13.25,761.395037052265,3
2020-10-30-170515,170515,18,3,15,1283,16.0,743.7378173496139,4
2020-10-31-170515,170515,25,0,0,1308,10.25,749.3248529885783,5
2020-11-01-170515,170515,6,0,0,1314,4.75,652.3552756655894,6
2020-11-02-170515,170515,20,1,0,1334,12.0,788.0760265954025,0
2020-11-03-170515,170515,11,2,0,1345,6.75,674.7230850275754,1
2020-11-04-170515,170515,15,0,0,1360,10.25,694.1222806256154,2
2020-11-05-170515,170515,11,1,0,1371,15.25,708.9220908071657,3
2020-11-06-170515,170515,20,0,0,1391,26.5,804.917227779014,4
2020-11-07-170515,170515,16,0,0,1407,23.0,819.1231449695381,5
2020-11-08-170515,170515,9,4,0,1416,6.25,1177.6102491747486,6
2020-11-09-170515,170515,9,0,0,1425,13.0,1127.7986715120305,0
2020-11-10-170515,170515,10,2,0,1435,9.75,584.2379150649609,1
2020-11-11-170515,170515,14,2,0,1449,5.5,623.2190186730379,2
2020-11-12-170515,170515,11,0,0,1460,15.75,597.4787130985547,3
2020-11-13-170515,170515,15,2,0,1475,14.75,668.5269290677163,4
2020-03-01-170516,170516,0,0,0,0,0.0,0.0,6
2020-03-02-170516,170516,0,0,2,0,0.0,6.477356698538192,0
2020-03-03-170516,170516,0,0,0,0,0.0,36.26841347718767,1
2020-03-04-170516,170516,0,0,1,0,0.0,39.54858507158465,2
2020-03-05-170516,170516,0,0,2,0,0.0,42.80314552435119,3
2020-03-06-170516,170516,0,0,1,0,0.0,34.95075700033111,4
2020-03-07-170516,170516,0,0,0,0,0.0,34.10817808361577,5
2020-03-08-170516,170516,0,0,0,0,0.14285714285714285,29.958474601443196,6
2020-03-09-170516,170516,0,0,2,0,0.14285714285714285,30.805575528038933,0
2020-03-10-170516,170516,0,0,1,0,0.14285714285714285,179.96825029109402,1
2020-03-11-170516,170516,0,0,0,0,0.0,154.46314317540757,2
2020-03-12-170516,170516,0,0,0,0,0.0,102.76916324592406,3
2020-03-13-170516,170516,0,0,3,0,0.42857142857142855,77.40564067532047,4
2020-03-14-170516,170516,2,0,0,2,0.14285714285714285,36.255083164040435,5
2020-03-15-170516,170516,0,0,1,2,0.42857142857142855,33.456509965781166,6
2020-03-16-170516,170516,2,0,0,4,1.2857142857142858,12.211857695154677,0
2020-03-17-170516,170516,0,0,1,4,1.4285714285714286,20.212857971871543,1
2020-03-18-170516,170516,1,0,0,5,1.0,25.78725734778437,2
2020-03-19-170516,170516,2,0,1,7,2.142857142857143,32.160208422252595,3
2020-03-20-170516,170516,1,0,0,8,2.0,39.2733011885441,4
2020-03-21-170516,170516,0,3,0,8,1.7142857142857142,42.58822482347941,5
2020-03-22-170516,170516,0,2,3,8,1.7142857142857142,42.07884087896848,6
2020-03-23-170516,170516,2,0,1,10,3.1428571428571432,39.7273016627535,0
2020-03-24-170516,170516,1,0,0,11,3.0,47.83354228672685,1
2020-03-25-170516,170516,0,0,1,11,2.2857142857142856,52.34016999242577,2
2020-03-26-170516,170516,0,0,0,11,3.4285714285714284,52.29626858966114,3
2020-03-27-170516,170516,3,0,1,14,3.4285714285714284,62.14125000875124,4
2020-03-28-170516,170516,0,0,0,14,1.1428571428571428,64.37124391726795,5
2020-03-29-170516,170516,1,0,0,15,0.5714285714285714,64.83480898644551,6
2020-03-30-170516,170516,0,0,0,15,2.4285714285714284,52.0353682175299,0
2020-03-31-170516,170516,1,0,0,16,1.5714285714285714,49.01666569256724,1
2020-04-01-170516,170516,0,0,0,16,2.0,6.2258040730795985,2
2020-04-02-170516,170516,1,0,1,17,1.8571428571428568,18.16314098281683,3
2020-04-03-170516,170516,0,0,0,17,1.2857142857142858,10.183284763184037,4
2020-04-04-170516,170516,0,0,0,17,0.42857142857142855,12.831870205418927,5
2020-04-05-170516,170516,3,0,0,20,1.2857142857142858,14.201523967198373,6
2020-04-06-170516,170516,1,0,0,21,2.142857142857143,18.88304309728322,0
2020-04-07-170516,170516,0,0,0,21,2.0,22.2879067784944,1
2020-04-08-170516,170516,1,0,0,22,2.0,26.961719479475587,2
2020-04-09-170516,170516,0,1,0,22,2.571428571428572,31.433408692249813,3
2020-04-10-170516,170516,1,1,0,23,2.142857142857143,5.558252549674188,4
2020-04-11-170516,170516,0,0,0,23,0.5714285714285714,9.584223887733174,5
2020-04-12-170516,170516,0,0,0,23,1.2857142857142858,11.101487023892677,6
2020-04-13-170516,170516,0,0,0,23,0.8571428571428571,12.026261902002263,0
2020-04-14-170516,170516,0,0,0,23,1.1428571428571428,15.2230941156795,1
2020-04-15-170516,170516,0,0,0,23,1.7142857142857142,17.622572463235855,2
2020-04-16-170516,170516,1,0,0,24,0.7142857142857143,20.495094962908418,3
2020-04-17-170516,170516,0,0,0,24,1.1428571428571428,21.69695346958379,4
2020-04-18-170516,170516,0,0,0,24,0.14285714285714285,21.91201667148718,5
2020-04-19-170516,170516,0,0,0,24,0.0,20.51338180546155,6
2020-04-20-170516,170516,0,0,0,24,0.8571428571428571,22.243735349891026,0
2020-04-21-170516,170516,0,0,0,24,1.1428571428571428,23.597681677120576,1
2020-04-22-170516,170516,0,0,0,24,0.42857142857142855,22.549036406137215,2
2020-04-23-170516,170516,0,0,0,24,0.42857142857142855,21.14268155847731,3
2020-04-24-170516,170516,0,0,0,24,0.42857142857142855,17.710312751203084,4
2020-04-25-170516,170516,0,0,0,24,0.0,19.85891882403263,5
2020-04-26-170516,170516,0,1,0,24,0.2857142857142857,19.305669340222867,6
2020-04-27-170516,170516,0,0,0,24,0.2857142857142857,14.716001228089562,0
2020-04-28-170516,170516,0,0,0,24,0.7142857142857143,13.451084625669044,1
2020-04-29-170516,170516,0,0,0,24,0.42857142857142855,13.726576238938994,2
2020-04-30-170516,170516,0,0,0,24,0.7142857142857143,16.994980082657264,3
2020-05-01-170516,170516,0,0,0,24,0.2857142857142857,40.43623637819421,4
2020-05-02-170516,170516,0,0,0,24,0.14285714285714285,13.163419739548559,5
2020-05-03-170516,170516,0,0,0,24,0.42857142857142855,8.13015297994157,6
2020-05-04-170516,170516,0,0,0,24,0.5714285714285714,7.863133360718693,0
2020-05-05-170516,170516,0,0,0,24,0.5714285714285714,9.79191972733226,1
2020-05-06-170516,170516,0,0,0,24,0.42857142857142855,12.371756916610241,2
2020-05-07-170516,170516,0,0,2,24,1.1428571428571428,13.997189338484528,3
2020-05-08-170516,170516,0,0,3,24,0.42857142857142855,15.007704344017265,4
2020-05-09-170516,170516,0,0,0,24,0.0,17.570273729352728,5
2020-05-10-170516,170516,0,0,0,24,0.14285714285714285,48.145940219889994,6
2020-05-11-170516,170516,0,1,0,24,0.8571428571428571,45.62998706376257,0
2020-05-12-170516,170516,0,0,0,24,0.7142857142857143,42.49699170382261,1
2020-05-13-170516,170516,0,0,0,24,0.7142857142857143,37.54895513640267,2
2020-05-14-170516,170516,0,0,0,24,0.5714285714285714,30.87338915494945,3
2020-05-15-170516,170516,0,0,1,24,0.42857142857142855,24.75895449886046,4
2020-05-16-170516,170516,0,0,0,24,0.0,20.52227642544392,5
2020-05-17-170516,170516,0,0,0,24,0.14285714285714285,20.67980469790298,6
2020-05-18-170516,170516,0,0,0,24,0.7142857142857143,21.036999713125628,0
2020-05-19-170516,170516,0,0,0,24,1.1428571428571428,17.715511395646075,1
2020-05-20-170516,170516,0,0,0,24,0.5714285714285714,15.193670457554564,2
2020-05-21-170516,170516,2,0,0,26,0.42857142857142855,15.452969417474078,3
2020-05-22-170516,170516,3,0,1,29,0.2857142857142857,17.312473106479587,4
2020-05-23-170516,170516,0,0,0,29,0.0,23.43848882672122,5
2020-05-24-170516,170516,0,0,0,29,0.0,23.470862623133414,6
2020-05-25-170516,170516,0,0,0,29,0.2857142857142857,20.940907791366808,0
2020-05-26-170516,170516,0,0,0,29,0.42857142857142855,18.164574542366033,1
2020-05-27-170516,170516,0,0,0,29,0.7142857142857143,19.88486365553394,2
2020-05-28-170516,170516,0,2,0,29,1.1428571428571428,19.788295775986946,3
2020-05-29-170516,170516,1,0,1,30,0.8571428571428571,16.096639099493565,4
2020-05-30-170516,170516,0,1,0,30,0.14285714285714285,14.141496244812076,5
2020-05-31-170516,170516,0,0,0,30,0.0,15.350542535826623,6
2020-06-01-170516,170516,0,0,0,30,0.2857142857142857,24.032782874378487,0
2020-06-02-170516,170516,0,0,0,30,0.2857142857142857,13.155109660074435,1
2020-06-03-170516,170516,0,0,0,30,0.5714285714285714,5.969151198811353,2
2020-06-04-170516,170516,0,0,4,30,0.5714285714285714,5.816405993740242,3
2020-06-05-170516,170516,1,0,0,31,0.14285714285714285,5.895473804506988,4
2020-06-06-170516,170516,0,0,0,31,0.42857142857142855,6.962758530861832,5
2020-06-07-170516,170516,0,0,0,31,0.0,6.701314666961117,6
2020-06-08-170516,170516,0,0,0,31,0.14285714285714285,6.76404141857439,0
2020-06-09-170516,170516,0,0,0,31,0.2857142857142857,7.240231313173296,1
2020-06-10-170516,170516,0,0,0,31,0.14285714285714285,24.305155220324572,2
2020-06-11-170516,170516,0,0,0,31,0.42857142857142855,21.427248138082028,3
2020-06-12-170516,170516,1,0,0,32,0.2857142857142857,17.46332628182128,4
2020-06-13-170516,170516,0,0,0,32,0.2857142857142857,16.58832341453141,5
2020-06-14-170516,170516,0,1,0,32,0.0,12.358549020838897,6
2020-06-15-170516,170516,0,0,0,32,0.0,9.807201642931767,0
2020-06-16-170516,170516,0,0,0,32,0.7142857142857143,9.608875809003194,1
2020-06-17-170516,170516,0,1,0,32,0.14285714285714285,9.517730423731301,2
2020-06-18-170516,170516,4,0,1,36,0.42857142857142855,9.410665403301516,3
2020-06-19-170516,170516,0,0,0,36,0.7142857142857143,15.990884074729976,4
2020-06-20-170516,170516,0,0,0,36,0.2857142857142857,14.784779485151137,5
2020-06-21-170516,170516,0,0,0,36,0.0,15.069676534573635,6
2020-06-22-170516,170516,0,0,0,36,0.14285714285714285,14.912204417154955,0
2020-06-23-170516,170516,0,0,0,36,0.0,14.119522185704145,1
2020-06-24-170516,170516,0,0,0,36,0.8571428571428571,13.679874175513579,2
2020-06-25-170516,170516,0,0,0,36,0.14285714285714285,7.228402535781761,3
2020-06-26-170516,170516,0,0,0,36,0.42857142857142855,6.839647892412696,4
2020-06-27-170516,170516,0,0,0,36,0.0,6.834165093615634,5
2020-06-28-170516,170516,0,0,0,36,0.0,7.526252753293003,6
2020-06-29-170516,170516,0,0,0,36,0.0,7.479832011243571,0
2020-06-30-170516,170516,0,0,0,36,0.14285714285714285,8.242129536119752,1
2020-07-01-170516,170516,0,0,0,36,0.0,9.36721965595332,2
2020-07-02-170516,170516,1,0,0,37,0.0,3.5352773012286485,3
2020-07-03-170516,170516,0,0,0,37,0.14285714285714285,10.708419831097572,4
2020-07-04-170516,170516,0,0,0,37,0.0,11.548945434095714,5
2020-07-05-170516,170516,0,0,0,37,0.0,11.936333324973356,6
2020-07-06-170516,170516,0,0,0,37,0.2857142857142857,8.823742192921225,0
2020-07-07-170516,170516,0,0,1,37,0.14285714285714285,8.88440597917566,1
2020-07-08-170516,170516,0,0,0,37,0.0,9.007529676114189,2
2020-07-09-170516,170516,0,0,0,37,0.2857142857142857,8.576965166324793,3
2020-07-10-170516,170516,0,0,0,37,0.42857142857142855,9.602952861414408,4
2020-07-11-170516,170516,0,0,0,37,0.14285714285714285,9.18323275585686,5
2020-07-12-170516,170516,0,0,0,37,0.14285714285714285,5.582333595528468,6
2020-07-13-170516,170516,0,0,0,37,0.14285714285714285,5.241430940536218,0
2020-07-14-170516,170516,0,0,1,37,0.7142857142857143,5.55025816613083,1
2020-07-15-170516,170516,0,0,0,37,0.14285714285714285,4.855583161019871,2
2020-07-16-170516,170516,0,0,0,37,0.14285714285714285,4.987817947610009,3
2020-07-17-170516,170516,0,0,0,37,0.14285714285714285,4.910890266030328,4
2020-07-18-170516,170516,0,0,0,37,0.0,3.4761642096528163,5
2020-07-19-170516,170516,0,0,0,37,0.14285714285714285,3.638928262323443,6
2020-07-20-170516,170516,0,0,0,37,0.0,6.222902552839706,0
2020-07-21-170516,170516,1,0,0,38,0.14285714285714285,5.789669214665311,1
2020-07-22-170516,170516,0,0,0,38,0.2857142857142857,7.399576838615603,2
2020-07-23-170516,170516,0,0,0,38,0.7142857142857143,8.153850012921694,3
2020-07-24-170516,170516,0,0,0,38,0.0,10.38601476648822,4
2020-07-25-170516,170516,0,0,0,38,0.0,11.254061968842391,5
2020-07-26-170516,170516,0,0,0,38,0.0,11.137631926028334,6
2020-07-27-170516,170516,0,0,0,38,0.2857142857142857,8.025356239983921,0
2020-07-28-170516,170516,1,0,0,39,0.0,11.1854024738617,1
2020-07-29-170516,170516,0,0,0,39,0.2857142857142857,11.182046435622667,2
2020-07-30-170516,170516,0,0,0,39,0.42857142857142855,9.891773641867688,3
2020-07-31-170516,170516,0,0,0,39,0.0,11.626107268866566,4
2020-08-01-170516,170516,0,0,0,39,0.14285714285714285,7.695529764141305,5
2020-08-02-170516,170516,0,0,0,39,0.2857142857142857,47.15347071176417,6
2020-08-03-170516,170516,0,0,0,39,0.2857142857142857,44.57912991189525,0
2020-08-04-170516,170516,0,1,0,39,0.8571428571428571,51.86137166434568,1
2020-08-05-170516,170516,0,0,0,39,0.7142857142857143,48.93832243111456,2
2020-08-06-170516,170516,0,0,0,39,0.7142857142857143,47.278260868633716,3
2020-08-07-170516,170516,0,0,0,39,1.0,37.10381330055619,4
2020-08-08-170516,170516,0,1,0,39,0.7142857142857143,34.81057501292102,5
2020-08-09-170516,170516,0,0,0,39,0.14285714285714285,34.97372250993417,6
2020-08-10-170516,170516,0,0,0,39,0.14285714285714285,6.061494319394323,0
2020-08-11-170516,170516,0,0,0,39,0.5714285714285714,7.71407874618456,1
2020-08-12-170516,170516,0,0,0,39,1.5714285714285714,10.476047347532642,2
2020-08-13-170516,170516,0,0,0,39,2.0,14.567183890867867,3
2020-08-14-170516,170516,0,0,1,39,1.5714285714285714,16.649615312263087,4
2020-08-15-170516,170516,0,0,0,39,1.5714285714285714,23.565996158451192,5
2020-08-16-170516,170516,0,0,5,39,1.2857142857142858,25.65216219544743,6
2020-08-17-170516,170516,0,0,2,39,1.7142857142857142,28.19988490478994,0
2020-08-18-170516,170516,0,0,0,39,1.7142857142857142,34.2652674021977,1
2020-08-19-170516,170516,0,0,0,39,1.2857142857142858,38.652033377364,2
2020-08-20-170516,170516,0,0,1,39,2.2857142857142856,40.30116424961669,3
2020-08-21-170516,170516,0,0,2,39,3.4285714285714284,39.70015199666473,4
2020-08-22-170516,170516,0,0,0,39,1.4285714285714286,48.87221415780211,5
2020-08-23-170516,170516,0,0,1,39,1.4285714285714286,50.890278003544495,6
2020-08-24-170516,170516,0,0,0,39,2.7142857142857144,47.982274885974235,0
2020-08-25-170516,170516,0,0,12,39,1.1428571428571428,46.32831807551059,1
2020-08-26-170516,170516,0,0,1,39,0.7142857142857143,39.45900950828945,2
2020-08-27-170516,170516,0,0,3,39,1.2857142857142858,43.241754087651216,3
2020-08-28-170516,170516,1,0,1,40,1.4285714285714286,40.91200138441917,4
2020-08-29-170516,170516,0,0,0,40,0.8571428571428571,40.24368993313614,5
2020-08-30-170516,170516,5,0,2,45,0.7142857142857143,36.348012501875836,6
2020-08-31-170516,170516,2,0,0,47,0.2857142857142857,39.82457123638154,0
2020-09-01-170516,170516,0,0,0,47,1.8571428571428568,25.35794732844828,1
2020-09-02-170516,170516,0,0,0,47,1.0,83.02895609073809,2
2020-09-03-170516,170516,1,0,0,48,3.7142857142857135,51.63095573883604,3
2020-09-04-170516,170516,2,0,0,50,1.7142857142857142,66.52884253682791,4
2020-09-05-170516,170516,0,0,0,50,0.7142857142857143,71.47626944927936,5
2020-09-06-170516,170516,1,0,1,51,3.571428571428572,69.64036502623543,6
2020-09-07-170516,170516,0,0,2,51,1.1428571428571428,75.96512818406475,0
2020-09-08-170516,170516,12,0,0,63,0.8571428571428571,74.90673975013482,1
2020-09-09-170516,170516,1,0,0,64,3.0,94.07432371946575,2
2020-09-10-170516,170516,3,0,1,67,3.0,26.419216444098325,3
2020-09-11-170516,170516,1,0,0,68,3.2857142857142856,37.59606515566746,4
2020-09-12-170516,170516,0,0,0,68,2.571428571428572,45.75051560168239,5
2020-09-13-170516,170516,2,0,0,70,0.42857142857142855,47.956895914956306,6
2020-09-14-170516,170516,0,0,1,70,2.2857142857142856,52.72629912908389,0
2020-09-15-170516,170516,0,0,0,70,3.8571428571428568,61.52612929634011,1
2020-09-16-170516,170516,0,0,4,70,3.1428571428571432,81.30308814657441,2
2020-09-17-170516,170516,0,0,6,70,1.5714285714285714,81.51751904577003,3
2020-09-18-170516,170516,0,0,0,70,2.8571428571428568,74.45287132775839,4
2020-09-19-170516,170516,0,0,3,70,0.5714285714285714,82.75731542827461,5
2020-09-20-170516,170516,1,0,5,71,1.5714285714285714,73.74279217726144,6
2020-09-21-170516,170516,2,0,3,73,1.5714285714285714,73.21184524255574,0
2020-09-22-170516,170516,0,0,4,73,1.2857142857142858,64.59563469015484,1
2020-09-23-170516,170516,0,0,2,73,2.142857142857143,60.40991854489833,2
2020-09-24-170516,170516,1,0,0,74,1.4285714285714286,59.45596653811062,3
2020-09-25-170516,170516,0,0,1,74,2.142857142857143,48.38154281666357,4
2020-09-26-170516,170516,0,0,1,74,1.4285714285714286,49.89372226675305,5
2020-09-27-170516,170516,0,0,1,74,1.2857142857142858,54.538193334710016,6
2020-09-28-170516,170516,1,0,0,75,2.0,51.4662976210262,0
2020-09-29-170516,170516,0,0,0,75,2.571428571428572,49.37581580276517,1
2020-09-30-170516,170516,4,0,1,79,1.8571428571428568,56.72225553271343,2
2020-10-01-170516,170516,6,0,0,85,1.0,0.0,3
2020-10-02-170516,170516,0,0,0,85,1.8571428571428568,82.55227624743735,4
2020-10-03-170516,170516,3,0,0,88,1.2857142857142858,141.41508190272884,5
2020-10-04-170516,170516,5,0,0,93,0.5714285714285714,150.08614953915458,6
2020-10-05-170516,170516,3,0,2,96,0.42857142857142855,137.2629130775099,0
2020-10-06-170516,170516,4,0,1,100,2.0,126.51500773000274,1
2020-10-07-170516,170516,2,0,0,102,1.0,112.13393669908449,2
2020-10-08-170516,170516,0,1,1,102,2.142857142857143,98.30545676460143,3
2020-10-09-170516,170516,1,0,0,103,1.4285714285714286,100.41160986271888,4
2020-10-10-170516,170516,1,0,0,104,1.1428571428571428,6.048411535680151,5
2020-10-11-170516,170516,1,0,0,105,0.14285714285714285,16.592952856492055,6
2020-10-12-170516,170516,0,0,0,105,1.2857142857142858,20.94460797741142,0
2020-10-13-170516,170516,0,0,1,105,1.5714285714285714,23.999575874241998,1
2020-10-14-170516,170516,1,0,0,106,4.142857142857143,31.988261815136298,2
2020-10-15-170516,170516,0,0,0,106,2.571428571428572,45.77875561089691,3
2020-10-16-170516,170516,0,0,3,106,2.7142857142857144,58.3181717067236,4
2020-10-17-170516,170516,0,0,3,106,1.8571428571428568,65.61302927254678,5
2020-10-18-170516,170516,0,0,2,106,0.42857142857142855,62.09052831683253,6
2020-10-19-170516,170516,2,0,0,108,2.571428571428572,61.987990837087956,0
2020-10-20-170516,170516,1,0,1,109,3.0,76.7381327503276,1
2020-10-21-170516,170516,0,0,2,109,2.571428571428572,77.07011902404835,2
2020-10-22-170516,170516,1,0,1,110,2.4285714285714284,71.57830818995471,3
2020-10-23-170516,170516,0,0,0,110,3.8571428571428568,71.96658811321828,4
2020-10-24-170516,170516,0,0,0,110,2.2857142857142856,83.65791931072349,5
2020-10-25-170516,170516,0,0,0,110,1.4285714285714286,91.48082209155868,6
2020-10-26-170516,170516,0,0,0,110,2.8571428571428568,83.88177034242106,0
2020-10-27-170516,170516,1,0,1,111,2.0,93.95113204778735,1
2020-10-28-170516,170516,0,0,0,111,5.428571428571429,99.92409442407588,2
2020-10-29-170516,170516,0,0,0,111,3.8571428571428568,120.8472069337124,3
2020-10-30-170516,170516,3,0,1,114,5.857142857142858,125.654454922338,4
2020-10-31-170516,170516,3,0,0,117,1.7142857142857142,130.81894719666514,5
2020-11-01-170516,170516,2,0,0,119,2.571428571428572,92.1204720717178,6
2020-11-02-170516,170516,0,1,0,119,1.1428571428571428,140.64440049524114,0
2020-11-03-170516,170516,1,0,0,120,5.0,124.98234294194782,1
2020-11-04-170516,170516,2,0,0,122,4.714285714285714,131.60198624091507,2
2020-11-05-170516,170516,1,0,0,123,6.7142857142857135,150.69508602279925,3
2020-11-06-170516,170516,0,0,0,123,7.2857142857142865,182.04375042277007,4
2020-11-07-170516,170516,0,0,0,123,9.714285714285714,171.62952334299825,5
2020-11-08-170516,170516,0,0,0,123,2.2857142857142856,174.51109417561642,6
2020-11-09-170516,170516,0,0,0,123,3.0,163.96512107283073,0
2020-11-10-170516,170516,1,0,0,124,4.142857142857143,79.97454054495782,1
2020-11-11-170516,170516,0,0,0,124,2.0,85.97628412110208,2
2020-11-12-170516,170516,0,0,0,124,3.0,81.39164641305285,3
2020-11-13-170516,170516,1,0,0,125,8.571428571428571,88.08431603737311,4
2020-03-01-170517,170517,0,0,5,0,0.0,0.0,6
2020-03-02-170517,170517,0,0,5,0,0.0,42.5316558127183,0
2020-03-03-170517,170517,0,0,12,0,0.0,228.70778332930436,1
2020-03-04-170517,170517,0,0,7,0,0.0,254.11815141870977,2
2020-03-05-170517,170517,0,0,10,0,0.0,272.41450440478326,3
2020-03-06-170517,170517,0,0,9,0,0.0,252.19977045769642,4
2020-03-07-170517,170517,0,0,9,0,0.0,243.35441103239916,5
2020-03-08-170517,170517,1,0,4,1,0.0,211.76056211611666,6
2020-03-09-170517,170517,0,0,16,1,0.2,216.51817863682345,0
2020-03-10-170517,170517,0,0,10,1,0.2,874.2473563711089,1
2020-03-11-170517,170517,0,0,11,1,0.0,753.503491545684,2
2020-03-12-170517,170517,2,0,8,3,0.2,562.7951924401161,3
2020-03-13-170517,170517,1,0,6,4,0.2,451.49127378556835,4
2020-03-14-170517,170517,0,0,5,4,0.4,200.10459857729944,5
2020-03-15-170517,170517,5,0,8,9,0.0,153.03148873619267,6
2020-03-16-170517,170517,5,0,6,14,1.6,60.54638836159625,0
2020-03-17-170517,170517,12,0,5,26,1.4,104.93430855977309,1
2020-03-18-170517,170517,7,0,9,33,2.4,162.80687987931037,2
2020-03-19-170517,170517,10,0,6,43,2.2,222.48439143263715,3
2020-03-20-170517,170517,9,0,5,52,3.0,267.0577659670896,4
2020-03-21-170517,170517,9,0,5,61,1.0,312.81683131781097,5
2020-03-22-170517,170517,4,0,5,65,0.8,316.54750206785803,6
2020-03-23-170517,170517,16,0,3,81,2.8,308.5489326296085,0
2020-03-24-170517,170517,10,0,2,91,3.2,349.44505747237713,1
2020-03-25-170517,170517,11,0,4,102,3.2,376.3647806302477,2
2020-03-26-170517,170517,8,0,3,110,4.2,372.2486097516494,3
2020-03-27-170517,170517,6,0,1,116,5.0,437.9843756054149,4
2020-03-28-170517,170517,5,0,2,121,2.2,435.90607151721946,5
2020-03-29-170517,170517,8,0,1,129,0.6,429.73791931708456,6
2020-03-30-170517,170517,6,0,6,135,3.2,347.1763018596298,0
2020-03-31-170517,170517,5,0,1,140,1.8,319.1240538182209,1
2020-04-01-170517,170517,9,0,3,149,3.2,43.893964555134374,2
2020-04-02-170517,170517,6,0,7,155,7.8,150.1758512495618,3
2020-04-03-170517,170517,5,0,3,160,1.8,102.93318444100805,4
2020-04-04-170517,170517,5,0,0,165,0.4,119.751021171827,5
2020-04-05-170517,170517,5,1,2,170,1.6,136.11271680964632,6
2020-04-06-170517,170517,3,0,4,173,3.0,149.5222714236712,0
2020-04-07-170517,170517,2,0,2,175,2.6,163.86344555648122,1
2020-04-08-170517,170517,4,0,4,179,2.4,171.9530615569658,2
2020-04-09-170517,170517,3,0,2,182,2.8,186.6304421257693,3
2020-04-10-170517,170517,1,1,4,183,1.4,54.09369061929922,4
2020-04-11-170517,170517,2,0,1,185,1.4,68.13588570011132,5
2020-04-12-170517,170517,1,0,2,186,0.6,86.0288939890985,6
2020-04-13-170517,170517,6,0,1,192,1.8,94.02989097694906,0
2020-04-14-170517,170517,1,0,4,193,1.0,125.97919820413345,1
2020-04-15-170517,170517,3,0,2,196,1.6,142.21172413783992,2
2020-04-16-170517,170517,7,0,1,203,0.8,167.2634013236173,3
2020-04-17-170517,170517,3,0,0,206,1.0,164.7303947250249,4
2020-04-18-170517,170517,0,0,2,206,0.0,181.6588007166568,5
2020-04-19-170517,170517,2,0,1,208,0.4,163.10104444992413,6
2020-04-20-170517,170517,4,0,2,212,0.8,172.6062750672897,0
2020-04-21-170517,170517,2,0,3,214,0.8,182.08755924269136,1
2020-04-22-170517,170517,4,0,5,218,1.0,172.55075008624323,2
2020-04-23-170517,170517,2,0,5,220,0.0,163.1133578352476,3
2020-04-24-170517,170517,4,0,0,224,0.4,137.06945829700334,4
2020-04-25-170517,170517,1,0,1,225,0.2,150.26760766267697,5
2020-04-26-170517,170517,2,0,1,227,1.2,148.62159386115127,6
2020-04-27-170517,170517,1,1,6,228,2.4,122.65776880159689,0
2020-04-28-170517,170517,4,0,2,232,0.4,119.14025697111273,1
2020-04-29-170517,170517,2,0,2,234,1.4,124.20150373606506,2
2020-04-30-170517,170517,1,0,1,235,0.8,142.37945547241267,3
2020-05-01-170517,170517,0,0,5,235,0.8,227.69488431562525,4
2020-05-02-170517,170517,2,0,4,237,0.0,111.20451488878443,5
2020-05-03-170517,170517,1,0,1,238,0.2,57.78521217915646,6
2020-05-04-170517,170517,2,0,4,240,1.2,52.030249941692624,0
2020-05-05-170517,170517,3,0,1,243,0.6,55.09615879612817,1
2020-05-06-170517,170517,5,0,3,248,0.8,67.42387047233794,2
2020-05-07-170517,170517,5,0,2,253,1.4,90.2524024371506,3
2020-05-08-170517,170517,0,0,2,253,0.6,110.18240502193285,4
2020-05-09-170517,170517,1,1,0,254,0.6,123.08128271778423,5
2020-05-10-170517,170517,1,0,0,255,0.2,254.03160849519662,6
2020-05-11-170517,170517,6,3,3,261,1.2,229.40144450285283,0
2020-05-12-170517,170517,2,0,2,263,1.0,228.69716318754246,1
2020-05-13-170517,170517,2,0,0,265,1.0,203.2529522345096,2
2020-05-14-170517,170517,1,0,0,266,0.2,186.0869301523798,3
2020-05-15-170517,170517,5,0,1,271,0.8,160.35245548795416,4
2020-05-16-170517,170517,4,0,0,275,0.0,145.84128823773523,5
2020-05-17-170517,170517,1,0,1,276,0.0,148.50674723952145,6
2020-05-18-170517,170517,4,0,1,280,0.6,150.1499301801784,0
2020-05-19-170517,170517,1,0,1,281,2.2,132.05879411142402,1
2020-05-20-170517,170517,3,0,0,284,0.4,115.08752986164653,2
2020-05-21-170517,170517,2,0,0,286,1.2,119.33547006977675,3
2020-05-22-170517,170517,2,0,1,288,1.0,115.01235010135171,4
2020-05-23-170517,170517,0,1,0,288,0.2,125.17900034382093,5
2020-05-24-170517,170517,0,0,0,288,0.0,124.05172869588519,6
2020-05-25-170517,170517,3,0,0,291,0.6,101.73688688940564,0
2020-05-26-170517,170517,2,0,0,293,0.2,98.99615854764616,1
2020-05-27-170517,170517,0,3,1,293,0.8,111.49396861695578,2
2020-05-28-170517,170517,0,3,1,293,0.4,108.92407736027394,3
2020-05-29-170517,170517,1,0,2,294,0.4,90.30326447905993,4
2020-05-30-170517,170517,0,0,0,294,0.2,89.17977704939827,5
2020-05-31-170517,170517,1,0,0,295,0.0,94.66355821684442,6
2020-06-01-170517,170517,1,0,1,296,0.6,173.24169243400553,0
2020-06-02-170517,170517,1,0,0,297,0.2,57.5206804483333,1
2020-06-03-170517,170517,0,0,2,297,0.0,55.81109621869638,2
2020-06-04-170517,170517,0,0,0,297,0.4,51.11823451137009,3
2020-06-05-170517,170517,1,0,0,298,0.0,48.87689821407029,4
2020-06-06-170517,170517,0,0,0,298,0.0,43.8158750556381,5
2020-06-07-170517,170517,0,0,0,298,0.0,38.86952279261439,6
2020-06-08-170517,170517,0,0,0,298,0.6,36.80704020397227,0
2020-06-09-170517,170517,0,0,0,298,0.2,38.57842529013886,1
2020-06-10-170517,170517,1,2,1,299,0.2,179.2863188610047,2
2020-06-11-170517,170517,1,0,1,300,0.2,168.98316019106764,3
2020-06-12-170517,170517,2,0,1,302,0.6,144.37077079051934,4
2020-06-13-170517,170517,0,0,1,302,0.0,122.2488941760459,5
2020-06-14-170517,170517,0,1,0,302,0.0,83.40870477409601,6
2020-06-15-170517,170517,1,0,1,303,0.8,64.39748613076178,0
2020-06-16-170517,170517,0,0,1,303,1.0,60.21299727161389,1
2020-06-17-170517,170517,2,0,0,305,0.6,58.287505784875535,2
2020-06-18-170517,170517,0,0,1,305,0.4,58.92801438846279,3
2020-06-19-170517,170517,0,0,0,305,1.0,63.34490046737666,4
2020-06-20-170517,170517,0,0,1,305,0.0,69.61478955229694,5
2020-06-21-170517,170517,0,0,0,305,0.0,72.44341802852246,6
2020-06-22-170517,170517,0,0,1,305,0.2,66.88776473298768,0
2020-06-23-170517,170517,0,0,2,305,0.0,62.35997827371278,1
2020-06-24-170517,170517,1,1,0,306,0.6,52.878702467987026,2
2020-06-25-170517,170517,1,0,1,307,0.2,50.76662888092036,3
2020-06-26-170517,170517,1,0,0,308,0.6,47.56383195517353,4
2020-06-27-170517,170517,1,0,0,309,0.0,51.594507688414836,5
2020-06-28-170517,170517,0,0,0,309,0.2,56.46204728904776,6
2020-06-29-170517,170517,1,0,0,310,0.2,58.42206249316429,0
2020-06-30-170517,170517,1,0,1,311,0.0,63.25641552629523,1
2020-07-01-170517,170517,0,0,5,311,0.0,43.235700338343946,2
2020-07-02-170517,170517,1,0,1,312,0.0,21.788365683932916,3
2020-07-03-170517,170517,0,0,0,312,0.4,41.92422393843242,4
2020-07-04-170517,170517,1,0,0,313,0.0,47.42047639883017,5
2020-07-05-170517,170517,0,0,0,313,0.2,48.47586670688717,6
2020-07-06-170517,170517,1,0,0,314,0.2,41.03914854015671,0
2020-07-07-170517,170517,2,1,0,316,0.0,43.02110131851606,1
2020-07-08-170517,170517,0,0,0,316,0.0,45.78077417246365,2
2020-07-09-170517,170517,1,0,0,317,0.2,43.24091101527269,3
2020-07-10-170517,170517,0,0,1,317,0.8,43.625758135593784,4
2020-07-11-170517,170517,0,0,0,317,0.0,43.53149152437285,5
2020-07-12-170517,170517,0,0,1,317,0.0,32.766469588440756,6
2020-07-13-170517,170517,0,0,1,317,0.2,31.95213015073866,0
2020-07-14-170517,170517,1,0,0,318,0.8,35.29474474178409,1
2020-07-15-170517,170517,5,0,1,323,0.4,28.66707339076362,2
2020-07-16-170517,170517,1,0,2,324,0.0,31.99475036253041,3
2020-07-17-170517,170517,0,0,3,324,0.2,31.537043127833073,4
2020-07-18-170517,170517,0,0,0,324,0.0,21.52884633933856,5
2020-07-19-170517,170517,0,0,0,324,0.0,22.348450361344515,6
2020-07-20-170517,170517,0,0,1,324,0.0,26.78697444448637,0
2020-07-21-170517,170517,0,0,1,324,0.0,23.044143333256727,1
2020-07-22-170517,170517,0,0,1,324,0.2,19.86443453489295,2
2020-07-23-170517,170517,0,0,3,324,0.6,22.91536190126564,3
2020-07-24-170517,170517,1,0,0,325,0.0,31.596909929551657,4
2020-07-25-170517,170517,0,0,0,325,0.0,37.980199454698095,5
2020-07-26-170517,170517,1,0,1,326,0.0,37.34144816871956,6
2020-07-27-170517,170517,1,0,1,327,0.8,28.949121464700184,0
2020-07-28-170517,170517,0,0,1,327,0.2,38.32628471213603,1
2020-07-29-170517,170517,1,0,3,328,0.0,38.22452772640496,2
2020-07-30-170517,170517,2,0,2,330,0.6,36.1986292462204,3
2020-07-31-170517,170517,3,0,1,333,0.0,38.619073227719426,4
2020-08-01-170517,170517,0,0,2,333,0.0,38.10273845218642,5
2020-08-02-170517,170517,0,0,1,333,0.0,189.81966285943128,6
2020-08-03-170517,170517,1,0,6,334,0.2,203.0953309615927,0
2020-08-04-170517,170517,1,0,4,335,1.0,185.14780930313867,1
2020-08-05-170517,170517,1,0,0,336,2.4,162.93653004580239,2
2020-08-06-170517,170517,3,0,3,339,0.2,154.52325029025502,3
2020-08-07-170517,170517,0,0,6,339,0.8,134.00802450570262,4
2020-08-08-170517,170517,0,0,0,339,0.4,120.52068766459305,5
2020-08-09-170517,170517,1,0,2,340,0.4,115.71179226869724,6
2020-08-10-170517,170517,1,0,2,341,0.2,29.074637927371995,0
2020-08-11-170517,170517,1,0,3,342,1.2,33.57186317531434,1
2020-08-12-170517,170517,3,0,5,345,1.4,43.659705206442105,2
2020-08-13-170517,170517,2,0,9,347,2.0,59.49938208737247,3
2020-08-14-170517,170517,1,0,5,348,2.4,66.83455362525491,4
2020-08-15-170517,170517,2,0,3,350,0.2,95.93891668662087,5
2020-08-16-170517,170517,1,0,1,351,0.2,100.64614237888256,6
2020-08-17-170517,170517,6,0,0,357,0.8,106.37338765996262,0
2020-08-18-170517,170517,4,0,1,361,1.2,128.7961275918477,1
2020-08-19-170517,170517,0,0,2,361,1.2,153.84337977005845,2
2020-08-20-170517,170517,3,0,2,364,1.0,161.14962264016174,3
2020-08-21-170517,170517,6,0,5,370,0.8,153.67233389707494,4
2020-08-22-170517,170517,0,0,0,370,0.2,187.1647994601908,5
2020-08-23-170517,170517,2,0,2,372,0.4,196.18787178593487,6
2020-08-24-170517,170517,2,0,6,374,0.8,183.99128412886563,0
2020-08-25-170517,170517,3,0,4,377,0.8,180.35537049080096,1
2020-08-26-170517,170517,5,0,4,382,0.6,154.18183144934943,2
2020-08-27-170517,170517,9,0,5,391,0.4,184.40213508311825,3
2020-08-28-170517,170517,5,0,3,396,1.0,184.9770655172746,4
2020-08-29-170517,170517,3,1,3,399,0.0,179.87143421248086,5
2020-08-30-170517,170517,1,0,3,400,1.8,182.4444345591463,6
2020-08-31-170517,170517,0,0,10,400,0.2,174.52772361613006,0
2020-09-01-170517,170517,1,0,1,401,2.8,106.72965689521061,1
2020-09-02-170517,170517,2,0,4,403,0.0,436.27950314875045,2
2020-09-03-170517,170517,2,0,13,405,1.2,295.28178333180114,3
2020-09-04-170517,170517,5,1,16,410,1.4,325.1732898372835,4
2020-09-05-170517,170517,0,0,2,410,0.2,351.8409006625753,5
2020-09-06-170517,170517,2,0,6,412,2.6,334.3862589854158,6
2020-09-07-170517,170517,6,0,5,418,0.6,347.1377628591668,0
2020-09-08-170517,170517,4,0,6,422,1.4,368.6963002237901,1
2020-09-09-170517,170517,4,0,9,426,1.2,408.1670210560057,2
2020-09-10-170517,170517,5,0,7,431,0.8,136.3359142799282,3
2020-09-11-170517,170517,3,0,4,434,0.8,173.90230649257205,4
2020-09-12-170517,170517,3,0,2,437,1.0,219.51061228223364,5
2020-09-13-170517,170517,3,0,1,440,1.4,229.47244028553698,6
2020-09-14-170517,170517,10,0,3,450,3.6,258.0107667353412,0
2020-09-15-170517,170517,1,0,2,451,4.8,323.10794287554074,1
2020-09-16-170517,170517,4,0,4,455,2.2,394.9351735082497,2
2020-09-17-170517,170517,13,0,7,468,2.6,400.39285297951756,3
2020-09-18-170517,170517,16,0,9,484,3.2,415.8124020431726,4
2020-09-19-170517,170517,2,1,2,486,4.0,454.70861177271524,5
2020-09-20-170517,170517,6,2,0,492,2.0,423.4191806519365,6
2020-09-21-170517,170517,5,0,3,497,2.0,412.8038088523951,0
2020-09-22-170517,170517,6,1,10,503,2.8,389.18863688388103,1
2020-09-23-170517,170517,9,1,4,512,3.2,364.37020602008715,2
2020-09-24-170517,170517,7,0,14,519,0.8,354.1874734400434,3
2020-09-25-170517,170517,4,0,12,523,2.8,302.2286284204862,4
2020-09-26-170517,170517,2,0,7,525,3.4,301.73441081316463,5
2020-09-27-170517,170517,1,0,1,526,2.2,331.7928777110888,6
2020-09-28-170517,170517,3,0,0,529,1.0,315.16302129081305,0
2020-09-29-170517,170517,2,0,0,531,1.6,296.0741329392482,1
2020-09-30-170517,170517,4,0,8,535,2.2,308.239374108171,2
2020-10-01-170517,170517,7,0,6,542,1.2,0.0,3
2020-10-02-170517,170517,9,0,12,551,1.0,511.91827770287443,4
2020-10-03-170517,170517,2,1,3,553,1.4,762.1689800608389,5
2020-10-04-170517,170517,0,2,5,553,0.2,730.2558586912073,6
2020-10-05-170517,170517,3,0,6,556,1.4,635.4720890511059,0
2020-10-06-170517,170517,10,1,14,566,0.4,581.2487346623391,1
2020-10-07-170517,170517,4,0,3,570,1.4,519.862446253476,2
2020-10-08-170517,170517,14,0,11,584,1.2,440.1328403853769,3
2020-10-09-170517,170517,12,0,29,596,2.0,495.6026862231732,4
2020-10-10-170517,170517,7,0,20,603,2.8,50.1074380343203,5
2020-10-11-170517,170517,1,0,6,604,1.0,135.90774742262835,6
2020-10-12-170517,170517,0,0,12,604,1.2,156.16854995856647,0
2020-10-13-170517,170517,0,0,14,604,2.4,173.026124176449,1
2020-10-14-170517,170517,8,0,10,612,2.4,213.32868472953322,2
2020-10-15-170517,170517,6,0,14,618,1.8,288.0888081105041,3
2020-10-16-170517,170517,12,0,20,630,2.6,336.2548870505992,4
2020-10-17-170517,170517,3,0,13,633,1.4,391.25836111704695,5
2020-10-18-170517,170517,5,0,4,638,1.2,369.71416857476595,6
2020-10-19-170517,170517,6,0,2,644,1.8,386.39522880440063,0
2020-10-20-170517,170517,14,0,9,658,3.4,468.69847712402884,1
2020-10-21-170517,170517,3,0,10,661,2.0,486.11167566766755,2
2020-10-22-170517,170517,11,0,13,672,0.8,479.7878483817708,3
2020-10-23-170517,170517,29,0,13,701,1.8,463.16883226168693,4
2020-10-24-170517,170517,20,0,12,721,1.4,507.6173601554009,5
2020-10-25-170517,170517,6,0,2,727,0.8,583.3647184095942,6
2020-10-26-170517,170517,12,0,7,739,2.6,559.4545190131935,0
2020-10-27-170517,170517,14,0,5,753,4.4,608.1348162058177,1
2020-10-28-170517,170517,10,1,6,763,4.2,614.9993683002773,2
2020-10-29-170517,170517,14,0,5,777,2.6,681.0016654333068,3
2020-10-30-170517,170517,20,0,11,797,2.8,650.1755058394217,4
2020-10-31-170517,170517,13,0,0,810,2.4,620.3649232389034,5
2020-11-01-170517,170517,4,1,0,814,1.6,423.9610995609883,6
2020-11-02-170517,170517,2,0,0,816,1.6,839.94072827979,0
2020-11-03-170517,170517,9,1,0,825,2.8,746.8471650518609,1
2020-11-04-170517,170517,10,1,0,835,4.8,776.3484786946827,2
2020-11-05-170517,170517,13,0,0,848,3.8,833.5375212184777,3
2020-11-06-170517,170517,13,0,0,861,9.2,928.2744689977181,4
2020-11-07-170517,170517,12,0,0,873,13.0,882.287799085507,5
2020-11-08-170517,170517,2,1,0,875,2.0,800.5395976061106,6
2020-11-09-170517,170517,7,0,0,882,3.2,781.054209184077,0
2020-11-10-170517,170517,5,0,0,887,3.6,391.72104029515583,1
2020-11-11-170517,170517,6,2,0,893,1.8,436.8028736818782,2
2020-11-12-170517,170517,5,0,0,898,4.0,440.7134149879437,3
2020-11-13-170517,170517,11,1,0,909,6.6,482.0906819232142,4
2020-03-01-170518,170518,0,0,0,0,0.0,0.0,6
2020-03-02-170518,170518,0,0,0,0,0.0,13.26235954636001,0
2020-03-03-170518,170518,0,0,0,0,0.0,81.62871095508063,1
2020-03-04-170518,170518,0,0,2,0,0.0,97.08239344695133,2
2020-03-05-170518,170518,0,1,2,0,0.0,104.00591707609851,3
2020-03-06-170518,170518,0,0,2,0,0.0,81.80499329135542,4
2020-03-07-170518,170518,0,0,1,0,0.0,84.84470247895138,5
2020-03-08-170518,170518,0,0,2,0,0.0,80.57694894856706,6
2020-03-09-170518,170518,0,0,3,0,0.3333333333333333,82.63922246835959,0
2020-03-10-170518,170518,0,0,1,0,0.3333333333333333,318.6446669292619,1
2020-03-11-170518,170518,0,0,0,0,0.16666666666666666,258.85377134321095,2
2020-03-12-170518,170518,0,0,2,0,0.16666666666666666,211.54064282446788,3
2020-03-13-170518,170518,0,0,4,0,0.3333333333333333,182.39061959084052,4
2020-03-14-170518,170518,0,0,0,0,0.16666666666666666,65.82147358770922,5
2020-03-15-170518,170518,0,0,3,0,0.8333333333333334,40.53855069376654,6
2020-03-16-170518,170518,0,0,0,0,1.5,13.052095941588284,0
2020-03-17-170518,170518,0,0,3,0,1.8333333333333333,27.4940347691323,1
2020-03-18-170518,170518,2,0,1,2,1.8333333333333333,39.33977333475089,2
2020-03-19-170518,170518,2,1,0,4,2.0,59.42968352866405,3
2020-03-20-170518,170518,2,0,0,6,4.666666666666667,76.4853657410123,4
2020-03-21-170518,170518,1,2,1,7,1.8333333333333333,106.05732511460641,5
2020-03-22-170518,170518,2,0,1,9,1.5,112.59235719296944,6
2020-03-23-170518,170518,3,0,0,12,4.833333333333333,113.80241565791405,0
2020-03-24-170518,170518,1,0,3,13,3.333333333333333,143.5941746275266,1
2020-03-25-170518,170518,0,0,1,13,3.0,152.71060826295493,2
2020-03-26-170518,170518,2,0,0,15,4.333333333333333,152.76391422353626,3
2020-03-27-170518,170518,4,0,1,19,5.166666666666667,178.94139002520217,4
2020-03-28-170518,170518,0,0,0,19,1.5,195.4058102575456,5
2020-03-29-170518,170518,3,0,0,22,0.5,187.02060318606573,6
2020-03-30-170518,170518,0,0,0,22,3.0,144.47070989754724,0
2020-03-31-170518,170518,3,0,0,25,2.0,146.07126212721369,1
2020-04-01-170518,170518,1,0,0,26,3.333333333333333,22.181960415957615,2
2020-04-02-170518,170518,0,0,1,26,7.0,52.47422943137429,3
2020-04-03-170518,170518,0,0,0,26,2.1666666666666665,37.11597865166112,4
2020-04-04-170518,170518,1,0,0,27,1.0,41.040944252756404,5
2020-04-05-170518,170518,1,0,0,28,1.5,47.2913801359124,6
2020-04-06-170518,170518,0,0,0,28,2.6666666666666665,56.367843142857474,0
2020-04-07-170518,170518,3,0,2,31,2.5,63.0805373660395,1
2020-04-08-170518,170518,1,0,0,32,2.1666666666666665,78.51747267773898,2
2020-04-09-170518,170518,0,0,0,32,2.0,83.14699757823371,3
2020-04-10-170518,170518,1,0,0,33,1.0,20.503751157455596,4
2020-04-11-170518,170518,0,1,0,33,0.8333333333333334,30.241071756916117,5
2020-04-12-170518,170518,0,0,0,33,0.5,37.32458855497346,6
2020-04-13-170518,170518,0,0,0,33,2.1666666666666665,40.047033981922056,0
2020-04-14-170518,170518,0,0,0,33,1.0,50.73622453494278,1
2020-04-15-170518,170518,0,0,2,33,1.1666666666666667,56.32066533947664,2
2020-04-16-170518,170518,1,0,0,34,0.8333333333333334,61.98348416922585,3
2020-04-17-170518,170518,0,1,0,34,1.1666666666666667,55.040928493413034,4
2020-04-18-170518,170518,0,0,0,34,0.16666666666666666,62.819301942484365,5
2020-04-19-170518,170518,0,0,0,34,0.3333333333333333,55.9736929485826,6
2020-04-20-170518,170518,0,0,1,34,0.6666666666666666,55.21574244193778,0
2020-04-21-170518,170518,2,0,0,36,0.6666666666666666,59.72668631259482,1
2020-04-22-170518,170518,0,0,1,36,1.0,63.116193351109175,2
2020-04-23-170518,170518,0,0,0,36,0.16666666666666666,60.8496020166103,3
2020-04-24-170518,170518,0,0,0,36,0.8333333333333334,44.11531470293656,4
2020-04-25-170518,170518,0,0,0,36,0.3333333333333333,49.66065151101208,5
2020-04-26-170518,170518,0,0,0,36,0.3333333333333333,52.40846016741024,6
2020-04-27-170518,170518,0,1,0,36,1.1666666666666667,42.682740960089184,0
2020-04-28-170518,170518,0,0,0,36,0.6666666666666666,38.73527534801549,1
2020-04-29-170518,170518,2,0,0,38,1.1666666666666667,34.09504516674204,2
2020-04-30-170518,170518,0,0,0,38,0.8333333333333334,46.763353185186546,3
2020-05-01-170518,170518,0,0,0,38,0.5,96.14134170504391,4
2020-05-02-170518,170518,0,0,0,38,0.16666666666666666,29.545853018692394,5
2020-05-03-170518,170518,0,0,0,38,0.0,21.325720359958986,6
2020-05-04-170518,170518,1,0,0,39,0.8333333333333334,22.90055669333008,0
2020-05-05-170518,170518,0,0,0,39,0.16666666666666666,27.490003728626387,1
2020-05-06-170518,170518,1,0,1,40,1.3333333333333333,25.036345010108796,2
2020-05-07-170518,170518,0,0,0,40,1.5,30.720953898753915,3
2020-05-08-170518,170518,0,0,0,40,0.6666666666666666,32.68727415818084,4
2020-05-09-170518,170518,0,2,0,40,0.3333333333333333,42.15849801783054,5
2020-05-10-170518,170518,0,0,0,40,0.3333333333333333,113.77117424180986,6
2020-05-11-170518,170518,0,0,0,40,1.0,101.8850335953972,0
2020-05-12-170518,170518,0,0,0,40,0.5,89.3522647432221,1
2020-05-13-170518,170518,0,0,1,40,0.6666666666666666,76.47364087256136,2
2020-05-14-170518,170518,0,0,0,40,0.3333333333333333,56.60309904686859,3
2020-05-15-170518,170518,0,0,0,40,0.5,41.24323304422087,4
2020-05-16-170518,170518,0,0,0,40,0.0,30.288407103740578,5
2020-05-17-170518,170518,0,0,0,40,0.0,27.33146316604423,6
2020-05-18-170518,170518,0,0,0,40,1.0,27.528304794713574,0
2020-05-19-170518,170518,0,0,0,40,1.5,28.06269953138618,1
2020-05-20-170518,170518,1,0,0,41,0.0,31.123902080275034,2
2020-05-21-170518,170518,0,0,0,41,0.5,34.16892105469293,3
2020-05-22-170518,170518,0,0,0,41,0.8333333333333334,31.36351195330832,4
2020-05-23-170518,170518,0,0,0,41,0.0,37.94249561525824,5
2020-05-24-170518,170518,0,0,0,41,0.0,39.116524771516744,6
2020-05-25-170518,170518,0,0,0,41,0.16666666666666666,34.32224842665302,0
2020-05-26-170518,170518,0,0,0,41,0.5,24.283180666710823,1
2020-05-27-170518,170518,1,1,0,42,0.16666666666666666,27.28679520952634,2
2020-05-28-170518,170518,0,0,0,42,0.6666666666666666,28.345164758834645,3
2020-05-29-170518,170518,0,0,0,42,0.3333333333333333,31.112784901991063,4
2020-05-30-170518,170518,0,4,0,42,0.16666666666666666,32.042967522318456,5
2020-05-31-170518,170518,0,0,0,42,0.16666666666666666,35.84283069059215,6
2020-06-01-170518,170518,0,0,1,42,0.6666666666666666,60.708840497003635,0
2020-06-02-170518,170518,0,0,0,42,0.3333333333333333,23.46919089456187,1
2020-06-03-170518,170518,0,0,0,42,0.16666666666666666,17.730026857257315,2
2020-06-04-170518,170518,0,0,0,42,0.0,29.258918439450568,3
2020-06-05-170518,170518,0,0,0,42,0.3333333333333333,28.590772728585275,4
2020-06-06-170518,170518,0,0,0,42,0.0,27.58938260360393,5
2020-06-07-170518,170518,0,0,0,42,0.0,26.24672175574274,6
2020-06-08-170518,170518,0,0,0,42,0.16666666666666666,25.75417822992834,0
2020-06-09-170518,170518,0,0,0,42,0.3333333333333333,27.629174039390712,1
2020-06-10-170518,170518,0,0,0,42,0.16666666666666666,63.95412452370521,2
2020-06-11-170518,170518,0,0,0,42,0.0,56.98322898420578,3
2020-06-12-170518,170518,0,0,0,42,0.5,54.768291800411745,4
2020-06-13-170518,170518,0,0,0,42,0.16666666666666666,44.513524967331826,5
2020-06-14-170518,170518,0,0,0,42,0.16666666666666666,37.02908701606218,6
2020-06-15-170518,170518,1,0,0,43,0.6666666666666666,27.303084127974692,0
2020-06-16-170518,170518,0,0,2,43,0.6666666666666666,32.10728701534587,1
2020-06-17-170518,170518,0,0,0,43,0.16666666666666666,27.437263913142715,2
2020-06-18-170518,170518,0,0,0,43,0.3333333333333333,23.828197940419194,3
2020-06-19-170518,170518,0,0,0,43,0.5,22.22927246509733,4
2020-06-20-170518,170518,0,0,0,43,0.0,26.578202358015808,5
2020-06-21-170518,170518,0,0,0,43,0.0,28.18782865651041,6
2020-06-22-170518,170518,0,0,0,43,0.16666666666666666,22.72874010736227,0
2020-06-23-170518,170518,0,0,0,43,0.0,20.716267096315157,1
2020-06-24-170518,170518,0,0,0,43,0.16666666666666666,20.22492292404779,2
2020-06-25-170518,170518,0,0,0,43,0.16666666666666666,20.265700816485896,3
2020-06-26-170518,170518,0,0,0,43,0.3333333333333333,17.70504012177229,4
2020-06-27-170518,170518,0,0,0,43,0.0,18.323144826424198,5
2020-06-28-170518,170518,0,0,0,43,0.0,18.88380037627282,6
2020-06-29-170518,170518,0,0,0,43,0.3333333333333333,18.3919341211518,0
2020-06-30-170518,170518,2,0,0,45,0.0,24.757440805389674,1
2020-07-01-170518,170518,0,0,0,45,0.0,32.70606689166033,2
2020-07-02-170518,170518,0,0,0,45,0.0,17.090152623299346,3
2020-07-03-170518,170518,0,0,0,45,0.3333333333333333,25.82891737653335,4
2020-07-04-170518,170518,0,0,0,45,0.0,31.22249672418279,5
2020-07-05-170518,170518,0,0,0,45,0.0,32.03962339587848,6
2020-07-06-170518,170518,0,0,0,45,0.0,27.705482299751765,0
2020-07-07-170518,170518,0,0,0,45,0.0,20.623810685045758,1
2020-07-08-170518,170518,0,0,0,45,0.0,18.086152415856656,2
2020-07-09-170518,170518,0,0,0,45,0.0,13.403196654570689,3
2020-07-10-170518,170518,0,0,0,45,0.6666666666666666,22.795990491882485,4
2020-07-11-170518,170518,0,0,0,45,0.0,27.263328468665343,5
2020-07-12-170518,170518,0,0,0,45,0.0,20.462597714023985,6
2020-07-13-170518,170518,0,0,0,45,0.0,19.54616720981712,0
2020-07-14-170518,170518,0,0,1,45,0.3333333333333333,19.568528586127012,1
2020-07-15-170518,170518,0,0,0,45,0.16666666666666666,16.981110743356407,2
2020-07-16-170518,170518,0,0,0,45,0.16666666666666666,19.74286264949917,3
2020-07-17-170518,170518,0,0,0,45,0.3333333333333333,21.342224807044822,4
2020-07-18-170518,170518,0,0,0,45,0.0,13.81098907130299,5
2020-07-19-170518,170518,0,0,0,45,0.16666666666666666,13.954978578919434,6
2020-07-20-170518,170518,0,0,0,45,0.16666666666666666,17.41224904431608,0
2020-07-21-170518,170518,0,0,0,45,0.0,16.36365367887283,1
2020-07-22-170518,170518,0,0,1,45,0.16666666666666666,12.190052932316224,2
2020-07-23-170518,170518,0,0,0,45,0.5,12.613065856214366,3
2020-07-24-170518,170518,0,0,0,45,0.0,18.935611532431594,4
2020-07-25-170518,170518,0,0,0,45,0.0,20.386329071123562,5
2020-07-26-170518,170518,0,0,0,45,0.0,18.30998751827426,6
2020-07-27-170518,170518,0,0,0,45,0.6666666666666666,16.649068623136266,0
2020-07-28-170518,170518,1,0,1,46,0.3333333333333333,17.670451537477764,1
2020-07-29-170518,170518,0,0,0,46,0.0,24.840289512096845,2
2020-07-30-170518,170518,0,0,0,46,0.5,23.350214875896818,3
2020-07-31-170518,170518,0,0,1,46,0.0,27.695161181748695,4
2020-08-01-170518,170518,0,0,0,46,0.0,8.076115607746283,5
2020-08-02-170518,170518,0,0,1,46,0.16666666666666666,79.1647813014161,6
2020-08-03-170518,170518,0,0,0,46,0.16666666666666666,76.38898525653539,0
2020-08-04-170518,170518,0,0,0,46,0.6666666666666666,61.9690486933973,1
2020-08-05-170518,170518,1,0,0,47,2.0,51.53945598793041,2
2020-08-06-170518,170518,0,0,0,47,0.3333333333333333,49.88073596097173,3
2020-08-07-170518,170518,0,0,0,47,1.0,52.79744858600412,4
2020-08-08-170518,170518,0,0,0,47,0.3333333333333333,57.29106411948283,5
2020-08-09-170518,170518,0,0,0,47,0.0,55.509791914524165,6
2020-08-10-170518,170518,0,0,0,47,0.5,7.14161554694951,0
2020-08-11-170518,170518,1,0,0,48,1.0,8.62253304396627,1
2020-08-12-170518,170518,0,0,0,48,0.6666666666666666,12.680828164352752,2
2020-08-13-170518,170518,0,0,0,48,1.1666666666666667,19.32907400681682,3
2020-08-14-170518,170518,1,0,0,49,2.1666666666666665,24.77287272001115,4
2020-08-15-170518,170518,0,0,0,49,0.16666666666666666,41.0854850733587,5
2020-08-16-170518,170518,1,0,0,50,0.8333333333333334,44.41976974900828,6
2020-08-17-170518,170518,0,0,0,50,2.0,55.37880609506222,0
2020-08-18-170518,170518,0,0,1,50,1.0,61.131052613299346,1
2020-08-19-170518,170518,0,0,0,50,1.3333333333333333,62.388761362008225,2
2020-08-20-170518,170518,0,0,2,50,0.8333333333333334,76.58245333481698,3
2020-08-21-170518,170518,0,0,0,50,1.3333333333333333,69.18851262575286,4
2020-08-22-170518,170518,0,0,0,50,0.16666666666666666,89.89522754868463,5
2020-08-23-170518,170518,0,0,0,50,0.3333333333333333,88.32376238913537,6
2020-08-24-170518,170518,0,0,2,50,1.0,86.14530803567875,0
2020-08-25-170518,170518,0,0,0,50,0.8333333333333334,96.85999587073483,1
2020-08-26-170518,170518,0,0,4,50,0.8333333333333334,78.4138192518916,2
2020-08-27-170518,170518,0,0,0,50,0.5,92.61357347545031,3
2020-08-28-170518,170518,0,0,0,50,0.8333333333333334,99.79780720390804,4
2020-08-29-170518,170518,0,0,0,50,0.0,81.08173224472381,5
2020-08-30-170518,170518,0,0,0,50,1.5,74.91278341013835,6
2020-08-31-170518,170518,0,0,0,50,0.6666666666666666,63.74533579649908,0
2020-09-01-170518,170518,1,0,0,51,2.0,50.07718154282614,1
2020-09-02-170518,170518,0,0,0,51,0.16666666666666666,159.78832037292375,2
2020-09-03-170518,170518,2,0,0,53,0.16666666666666666,120.64855093443117,3
2020-09-04-170518,170518,0,0,0,53,1.3333333333333333,124.33186971322866,4
2020-09-05-170518,170518,0,0,0,53,0.5,125.07239193196023,5
2020-09-06-170518,170518,0,0,0,53,0.8333333333333334,125.9928415916662,6
2020-09-07-170518,170518,2,0,0,55,1.1666666666666667,115.32699926607768,0
2020-09-08-170518,170518,0,0,0,55,0.6666666666666666,122.03665153219553,1
2020-09-09-170518,170518,4,0,0,59,1.3333333333333333,127.09503809162571,2
2020-09-10-170518,170518,0,0,0,59,0.5,66.13695576883185,3
2020-09-11-170518,170518,0,0,0,59,0.3333333333333333,73.97000635786209,4
2020-09-12-170518,170518,0,0,0,59,1.1666666666666667,77.3973421932393,5
2020-09-13-170518,170518,0,0,0,59,2.6666666666666665,78.56523046519942,6
2020-09-14-170518,170518,0,0,0,59,3.333333333333333,98.8910191340352,0
2020-09-15-170518,170518,0,0,0,59,3.0,118.82901173340247,1
2020-09-16-170518,170518,0,0,1,59,0.8333333333333334,147.7377088950181,2
2020-09-17-170518,170518,0,0,0,59,0.6666666666666666,134.28309112593172,3
2020-09-18-170518,170518,0,0,2,59,2.0,135.18390003598267,4
2020-09-19-170518,170518,0,0,0,59,3.333333333333333,140.4714003841246,5
2020-09-20-170518,170518,0,0,0,59,1.1666666666666667,115.51243483262502,6
2020-09-21-170518,170518,0,0,0,59,1.5,107.26472824694557,0
2020-09-22-170518,170518,0,0,0,59,3.5,95.53292180383717,1
2020-09-23-170518,170518,0,0,0,59,2.5,97.01596303905646,2
2020-09-24-170518,170518,0,0,1,59,1.0,103.48141195957322,3
2020-09-25-170518,170518,0,0,1,59,1.1666666666666667,99.62184586803272,4
2020-09-26-170518,170518,0,0,0,59,2.0,104.23137695037062,5
2020-09-27-170518,170518,0,0,0,59,1.5,118.04126256265425,6
2020-09-28-170518,170518,0,0,0,59,0.6666666666666666,122.50479133299568,0
2020-09-29-170518,170518,0,0,0,59,0.5,118.29927665008145,1
2020-09-30-170518,170518,1,1,31,60,1.1666666666666667,110.64607249293462,2
2020-10-01-170518,170518,0,0,0,60,1.3333333333333333,0.0,3
2020-10-02-170518,170518,2,0,1,62,2.1666666666666665,270.3877733870567,4
2020-10-03-170518,170518,0,0,0,62,1.0,247.1122480078498,5
2020-10-04-170518,170518,0,1,1,62,0.3333333333333333,238.00200147225289,6
2020-10-05-170518,170518,0,0,0,62,1.3333333333333333,215.45354388569964,0
2020-10-06-170518,170518,0,0,3,62,0.8333333333333334,205.45920118389955,1
2020-10-07-170518,170518,0,0,0,62,1.1666666666666667,147.19110409944818,2
2020-10-08-170518,170518,1,0,0,63,1.6666666666666667,131.844897546299,3
2020-10-09-170518,170518,1,0,3,64,1.1666666666666667,142.21922918783034,4
2020-10-10-170518,170518,0,0,1,64,1.0,17.664132458878555,5
2020-10-11-170518,170518,0,0,0,64,2.1666666666666665,37.39254183583529,6
2020-10-12-170518,170518,0,0,0,64,1.3333333333333333,42.384624328002815,0
2020-10-13-170518,170518,0,0,0,64,2.833333333333333,50.98403035635216,1
2020-10-14-170518,170518,31,0,11,95,2.5,67.66078347689995,2
2020-10-15-170518,170518,0,0,1,95,1.8333333333333333,195.58394735952015,3
2020-10-16-170518,170518,1,0,0,96,2.5,214.233476757544,4
2020-10-17-170518,170518,0,0,1,96,2.333333333333333,226.8544581621316,5
2020-10-18-170518,170518,1,1,1,97,2.333333333333333,223.4483943539896,6
2020-10-19-170518,170518,0,0,0,97,7.833333333333332,225.94794476331037,0
2020-10-20-170518,170518,3,0,0,100,4.166666666666667,261.06042912923715,1
2020-10-21-170518,170518,0,0,2,100,10.5,168.64732675563397,2
2020-10-22-170518,170518,0,0,2,100,7.666666666666668,170.5708406565006,3
2020-10-23-170518,170518,3,0,0,103,6.333333333333332,172.87897534687204,4
2020-10-24-170518,170518,1,0,6,104,2.1666666666666665,184.55274286358122,5
2020-10-25-170518,170518,0,0,0,104,2.6666666666666665,195.8857585300314,6
2020-10-26-170518,170518,0,0,1,104,4.833333333333333,186.9107369095305,0
2020-10-27-170518,170518,0,0,0,104,5.333333333333333,182.76787465864464,1
2020-10-28-170518,170518,11,2,3,115,5.666666666666668,177.81697143021762,2
2020-10-29-170518,170518,1,1,1,116,2.833333333333333,218.84497785615875,3
2020-10-30-170518,170518,0,1,2,116,5.5,197.289493412657,4
2020-10-31-170518,170518,1,0,0,117,2.833333333333333,205.95561712153741,5
2020-11-01-170518,170518,1,1,0,118,0.8333333333333334,117.82618545750458,6
2020-11-02-170518,170518,0,2,0,118,2.0,205.86200422358624,0
2020-11-03-170518,170518,0,0,0,118,4.166666666666667,191.48589824149033,1
2020-11-04-170518,170518,2,0,0,120,7.0,198.8624311481114,2
2020-11-05-170518,170518,2,0,0,122,4.166666666666667,228.19050099142245,3
2020-11-06-170518,170518,0,0,0,122,5.0,245.6477998049764,4
2020-11-07-170518,170518,6,0,0,128,9.333333333333334,235.5733360918032,5
2020-11-08-170518,170518,0,0,0,128,2.1666666666666665,298.27806217880607,6
2020-11-09-170518,170518,1,0,0,129,3.1666666666666665,288.0355314359766,0
2020-11-10-170518,170518,0,0,0,129,3.6666666666666665,109.51381027312132,1
2020-11-11-170518,170518,3,0,0,132,2.5,122.96725176012524,2
2020-11-12-170518,170518,1,0,0,133,4.0,125.94232467017399,3
2020-11-13-170518,170518,2,0,0,135,3.8333333333333335,145.96575801297445,4
2020-03-01-170519,170519,0,0,1,0,0.0,0.0,6
2020-03-02-170519,170519,0,0,1,0,0.0,6.4381943039716525,0
2020-03-03-170519,170519,0,0,1,0,0.0,43.57669863798033,1
2020-03-04-170519,170519,0,0,0,0,0.0,52.048467809127054,2
2020-03-05-170519,170519,0,0,1,0,0.0,57.277981753059834,3
2020-03-06-170519,170519,0,0,9,0,0.0,45.81553744657296,4
2020-03-07-170519,170519,0,1,3,0,0.0,46.05953690121152,5
2020-03-08-170519,170519,0,0,2,0,0.0,43.289635481958406,6
2020-03-09-170519,170519,0,0,6,0,0.16666666666666666,43.692001209973256,0
2020-03-10-170519,170519,0,0,2,0,0.0,140.2286621711161,1
2020-03-11-170519,170519,0,0,2,0,0.16666666666666666,111.27530409726923,2
2020-03-12-170519,170519,0,0,3,0,0.0,88.11262841531732,3
2020-03-13-170519,170519,1,0,4,1,0.0,76.61300290390949,4
2020-03-14-170519,170519,0,0,2,1,0.0,36.16632002919664,5
2020-03-15-170519,170519,1,0,0,2,0.3333333333333333,21.052146446442002,6
2020-03-16-170519,170519,1,0,7,3,0.8333333333333334,8.610997171970439,0
2020-03-17-170519,170519,1,0,2,4,0.6666666666666666,17.761790841546876,1
2020-03-18-170519,170519,0,0,3,4,1.1666666666666667,23.861210780155204,2
2020-03-19-170519,170519,1,1,2,5,1.0,33.512765544521,3
2020-03-20-170519,170519,9,0,1,14,0.8333333333333334,40.83627002952626,4
2020-03-21-170519,170519,3,0,1,17,1.1666666666666667,59.16197007542932,5
2020-03-22-170519,170519,2,0,0,19,1.0,62.35793868680216,6
2020-03-23-170519,170519,6,0,1,25,2.333333333333333,61.52540832835031,0
2020-03-24-170519,170519,2,0,2,27,1.5,78.98668163299315,1
2020-03-25-170519,170519,2,0,1,29,0.8333333333333334,82.13400179397222,2
2020-03-26-170519,170519,3,0,0,32,1.5,82.90802877215671,3
2020-03-27-170519,170519,4,0,0,36,2.833333333333333,98.16832401607144,4
2020-03-28-170519,170519,2,0,2,38,0.6666666666666666,105.01162384481682,5
2020-03-29-170519,170519,0,1,0,38,0.8333333333333334,101.2283442372382,6
2020-03-30-170519,170519,7,0,2,45,1.5,78.7973562698462,0
2020-03-31-170519,170519,2,0,0,47,1.6666666666666667,82.25920768738648,1
2020-04-01-170519,170519,3,1,1,50,1.6666666666666667,12.44554679200636,2
2020-04-02-170519,170519,2,0,0,52,0.6666666666666666,36.045327820357485,3
2020-04-03-170519,170519,1,0,2,53,1.3333333333333333,23.309158033339997,4
2020-04-04-170519,170519,1,0,0,54,1.1666666666666667,24.93179903927644,5
2020-04-05-170519,170519,0,1,0,54,0.8333333333333334,27.533733263295453,6
2020-04-06-170519,170519,1,0,0,55,1.0,31.277570003773587,0
2020-04-07-170519,170519,2,0,0,57,0.6666666666666666,33.793127681942536,1
2020-04-08-170519,170519,1,0,0,58,1.1666666666666667,40.95986281492543,2
2020-04-09-170519,170519,0,0,0,58,2.1666666666666665,43.3442965004744,3
2020-04-10-170519,170519,0,0,0,58,4.333333333333333,11.776496764863728,4
2020-04-11-170519,170519,2,0,1,60,0.3333333333333333,22.283118057970867,5
2020-04-12-170519,170519,0,0,0,60,0.8333333333333334,25.359375528097264,6
2020-04-13-170519,170519,2,0,0,62,1.5,27.070480965919387,0
2020-04-14-170519,170519,0,0,1,62,0.8333333333333334,36.11293682967939,1
2020-04-15-170519,170519,1,0,0,63,0.8333333333333334,38.53079482287791,2
2020-04-16-170519,170519,0,0,0,63,1.1666666666666667,42.87001845584152,3
2020-04-17-170519,170519,2,0,0,65,2.833333333333333,40.16552702802931,4
2020-04-18-170519,170519,0,0,0,65,0.16666666666666666,42.3062781020174,5
2020-04-19-170519,170519,0,0,0,65,0.5,38.263849553710976,6
2020-04-20-170519,170519,0,0,0,65,2.833333333333333,35.18983356219261,0
2020-04-21-170519,170519,0,0,0,65,0.6666666666666666,39.10498341032838,1
2020-04-22-170519,170519,0,0,1,65,0.6666666666666666,39.96162538481898,2
2020-04-23-170519,170519,0,0,0,65,0.6666666666666666,38.350288304187664,3
2020-04-24-170519,170519,0,0,1,65,0.8333333333333334,26.52288386186012,4
2020-04-25-170519,170519,1,0,0,66,1.1666666666666667,30.701527015107544,5
2020-04-26-170519,170519,0,0,0,66,0.6666666666666666,33.574572932740075,6
2020-04-27-170519,170519,0,0,0,66,0.3333333333333333,29.47539423660648,0
2020-04-28-170519,170519,1,0,0,67,0.3333333333333333,23.648250489227408,1
2020-04-29-170519,170519,0,0,1,67,1.1666666666666667,21.950477469259802,2
2020-04-30-170519,170519,0,0,0,67,0.16666666666666666,28.629589023269844,3
2020-05-01-170519,170519,0,0,1,67,0.0,53.7301274371451,4
2020-05-02-170519,170519,0,0,0,67,0.6666666666666666,15.664479703797342,5
2020-05-03-170519,170519,0,0,0,67,0.0,13.341500436721844,6
2020-05-04-170519,170519,0,0,2,67,1.1666666666666667,14.371435955099276,0
2020-05-05-170519,170519,0,0,0,67,0.0,17.142780279953218,1
2020-05-06-170519,170519,1,0,0,68,0.3333333333333333,15.117164153677514,2
2020-05-07-170519,170519,0,0,0,68,0.8333333333333334,18.120031614399135,3
2020-05-08-170519,170519,1,0,0,69,1.1666666666666667,18.24508605724782,4
2020-05-09-170519,170519,0,0,0,69,0.16666666666666666,25.50100485992379,5
2020-05-10-170519,170519,0,0,0,69,0.3333333333333333,65.47927627498183,6
2020-05-11-170519,170519,0,0,0,69,0.3333333333333333,57.8693551995523,0
2020-05-12-170519,170519,0,0,1,69,0.5,50.77809513384615,1
2020-05-13-170519,170519,1,2,0,70,0.16666666666666666,43.866004980154315,2
2020-05-14-170519,170519,0,3,1,70,0.16666666666666666,35.283368934117284,3
2020-05-15-170519,170519,1,1,1,71,0.3333333333333333,24.89041227828551,4
2020-05-16-170519,170519,0,0,0,71,0.0,17.679450032632037,5
2020-05-17-170519,170519,0,0,0,71,0.0,16.51700349577895,6
2020-05-18-170519,170519,2,0,0,73,0.16666666666666666,16.628362836300653,0
2020-05-19-170519,170519,0,0,2,73,0.5,18.1766420484012,1
2020-05-20-170519,170519,0,0,0,73,0.6666666666666666,20.013717306313172,2
2020-05-21-170519,170519,0,0,0,73,0.6666666666666666,22.22915111114777,3
2020-05-22-170519,170519,0,0,2,73,0.0,21.087669587469414,4
2020-05-23-170519,170519,0,0,0,73,0.16666666666666666,24.424463576146934,5
2020-05-24-170519,170519,0,0,0,73,0.0,25.265516120810265,6
2020-05-25-170519,170519,0,0,1,73,0.0,22.13250508258036,0
2020-05-26-170519,170519,1,0,0,74,0.3333333333333333,17.126984412979894,1
2020-05-27-170519,170519,0,1,1,74,0.5,18.087183274496994,2
2020-05-28-170519,170519,1,0,0,75,0.0,17.990745020446536,3
2020-05-29-170519,170519,1,0,0,76,0.3333333333333333,18.071653129319532,4
2020-05-30-170519,170519,0,0,1,76,0.0,20.422785081566104,5
2020-05-31-170519,170519,0,0,0,76,0.16666666666666666,21.9050660102448,6
2020-06-01-170519,170519,0,0,0,76,1.1666666666666667,34.30927184744718,0
2020-06-02-170519,170519,2,0,0,78,0.3333333333333333,14.512060135134615,1
2020-06-03-170519,170519,0,0,0,78,0.3333333333333333,15.222985224061729,2
2020-06-04-170519,170519,0,0,0,78,0.5,20.000359618195343,3
2020-06-05-170519,170519,2,0,0,80,0.8333333333333334,20.31774786302927,4
2020-06-06-170519,170519,0,0,0,80,0.0,20.10089391139595,5
2020-06-07-170519,170519,0,0,0,80,0.0,18.869102368280956,6
2020-06-08-170519,170519,1,0,0,81,0.3333333333333333,18.500180774583033,0
2020-06-09-170519,170519,0,0,0,81,0.3333333333333333,19.772705166344483,1
2020-06-10-170519,170519,1,0,0,82,2.6666666666666665,34.62094638396551,2
2020-06-11-170519,170519,0,0,0,82,1.0,37.01517656057416,3
2020-06-12-170519,170519,0,0,2,82,0.16666666666666666,38.78226923606781,4
2020-06-13-170519,170519,1,1,0,83,0.0,33.367139427670196,5
2020-06-14-170519,170519,0,1,0,83,0.16666666666666666,29.76619945147985,6
2020-06-15-170519,170519,0,0,1,83,0.6666666666666666,23.06826569692852,0
2020-06-16-170519,170519,0,0,0,83,0.0,26.302198363208944,1
2020-06-17-170519,170519,0,0,0,83,0.16666666666666666,22.10442224896494,2
2020-06-18-170519,170519,0,0,0,83,0.5,15.259757103411157,3
2020-06-19-170519,170519,0,0,1,83,0.16666666666666666,13.295854434709138,4
2020-06-20-170519,170519,0,0,0,83,0.3333333333333333,16.329249288949278,5
2020-06-21-170519,170519,0,0,0,83,0.0,18.194787471585567,6
2020-06-22-170519,170519,0,0,0,83,0.0,15.033782114675134,0
2020-06-23-170519,170519,0,0,0,83,0.5,14.60833819373531,1
2020-06-24-170519,170519,0,0,0,83,0.16666666666666666,15.37680492694206,2
2020-06-25-170519,170519,0,0,0,83,0.16666666666666666,14.806385438010192,3
2020-06-26-170519,170519,2,0,1,85,0.3333333333333333,14.216668693413837,4
2020-06-27-170519,170519,0,0,0,85,0.16666666666666666,14.414765602908012,5
2020-06-28-170519,170519,0,0,0,85,0.0,14.357443906253518,6
2020-06-29-170519,170519,1,0,0,86,0.16666666666666666,14.051193482017073,0
2020-06-30-170519,170519,0,0,0,86,0.5,19.165196594884286,1
2020-07-01-170519,170519,0,0,0,86,0.3333333333333333,23.742514970406873,2
2020-07-02-170519,170519,0,0,0,86,0.5,15.587735957848958,3
2020-07-03-170519,170519,1,0,0,87,0.3333333333333333,18.111394846313118,4
2020-07-04-170519,170519,0,0,0,87,0.0,22.240144245657046,5
2020-07-05-170519,170519,0,0,0,87,0.16666666666666666,22.40838616240761,6
2020-07-06-170519,170519,0,0,1,87,1.0,18.386543973196112,0
2020-07-07-170519,170519,0,0,0,87,0.0,15.74801960051682,1
2020-07-08-170519,170519,0,0,0,87,0.16666666666666666,14.07054784143152,2
2020-07-09-170519,170519,0,0,0,87,0.0,9.60575771888187,3
2020-07-10-170519,170519,1,0,0,88,0.3333333333333333,22.226758683523656,4
2020-07-11-170519,170519,0,0,0,88,0.3333333333333333,24.35646376274869,5
2020-07-12-170519,170519,0,0,0,88,0.0,16.921290692540417,6
2020-07-13-170519,170519,0,0,1,88,0.0,15.974597623951999,0
2020-07-14-170519,170519,0,0,1,88,0.3333333333333333,16.13456019002403,1
2020-07-15-170519,170519,0,0,0,88,1.1666666666666667,14.745063607480839,2
2020-07-16-170519,170519,0,0,0,88,1.0,16.993904879677046,3
2020-07-17-170519,170519,0,0,0,88,0.16666666666666666,19.334528806506338,4
2020-07-18-170519,170519,0,0,0,88,0.0,14.805748252130774,5
2020-07-19-170519,170519,0,0,1,88,0.16666666666666666,14.509829536438017,6
2020-07-20-170519,170519,1,0,0,89,0.0,19.15678454593237,0
2020-07-21-170519,170519,0,0,0,89,0.0,17.640925734700687,1
2020-07-22-170519,170519,0,0,0,89,0.0,13.351585398616008,2
2020-07-23-170519,170519,0,0,1,89,0.0,10.202321457371522,3
2020-07-24-170519,170519,0,0,0,89,0.3333333333333333,12.95668348388171,4
2020-07-25-170519,170519,0,0,0,89,0.16666666666666666,15.381889935846377,5
2020-07-26-170519,170519,0,0,0,89,0.0,13.155792185324998,6
2020-07-27-170519,170519,1,0,1,90,0.3333333333333333,10.592829689539421,0
2020-07-28-170519,170519,1,0,1,91,0.5,12.01278808554896,1
2020-07-29-170519,170519,0,0,0,91,0.0,17.5785846307882,2
2020-07-30-170519,170519,0,0,2,91,0.16666666666666666,20.29075997225307,3
2020-07-31-170519,170519,0,0,0,91,0.8333333333333334,20.028400628991303,4
2020-08-01-170519,170519,0,0,0,91,0.16666666666666666,8.10474507604106,5
2020-08-02-170519,170519,1,0,1,92,0.0,44.12338102563104,6
2020-08-03-170519,170519,0,0,0,92,0.0,76.77292213727955,0
2020-08-04-170519,170519,0,0,0,92,0.0,55.22523395212382,1
2020-08-05-170519,170519,0,0,0,92,0.3333333333333333,43.76718745722341,2
2020-08-06-170519,170519,1,0,1,93,0.16666666666666666,31.153969963196236,3
2020-08-07-170519,170519,0,0,1,93,0.16666666666666666,30.909144970756316,4
2020-08-08-170519,170519,0,0,0,93,0.0,29.35156860105193,5
2020-08-09-170519,170519,0,0,0,93,0.16666666666666666,29.01273311423485,6
2020-08-10-170519,170519,1,0,4,94,0.5,7.762894930367765,0
2020-08-11-170519,170519,1,0,0,95,0.3333333333333333,10.244526899439514,1
2020-08-12-170519,170519,0,0,0,95,1.5,12.885972411511297,2
2020-08-13-170519,170519,2,0,2,97,0.5,14.707333011404637,3
2020-08-14-170519,170519,0,0,0,97,0.16666666666666666,18.101532749876135,4
2020-08-15-170519,170519,0,0,0,97,0.0,22.55314967524957,5
2020-08-16-170519,170519,1,0,0,98,0.5,24.765861841510485,6
2020-08-17-170519,170519,0,0,0,98,0.5,32.12337449107748,0
2020-08-18-170519,170519,0,0,3,98,0.8333333333333334,34.86897650238506,1
2020-08-19-170519,170519,0,0,0,98,0.8333333333333334,36.61506804325388,2
2020-08-20-170519,170519,1,0,0,99,0.3333333333333333,41.68178099039811,3
2020-08-21-170519,170519,1,0,2,100,2.5,43.869011550431665,4
2020-08-22-170519,170519,0,0,1,100,0.16666666666666666,63.49540252935638,5
2020-08-23-170519,170519,0,0,0,100,1.1666666666666667,60.27730002527443,6
2020-08-24-170519,170519,4,0,0,104,1.0,60.70338320817221,0
2020-08-25-170519,170519,0,0,0,104,2.1666666666666665,69.98046166036988,1
2020-08-26-170519,170519,0,0,5,104,2.333333333333333,65.57942508084776,2
2020-08-27-170519,170519,2,0,1,106,4.333333333333333,76.46876431094394,3
2020-08-28-170519,170519,0,0,1,106,1.3333333333333333,87.85472103192897,4
2020-08-29-170519,170519,0,0,1,106,1.0,70.86854041673327,5
2020-08-30-170519,170519,0,0,1,106,0.6666666666666666,64.76883791813532,6
2020-08-31-170519,170519,0,0,0,106,1.1666666666666667,53.71394852096681,0
2020-09-01-170519,170519,3,0,1,109,0.3333333333333333,25.283375763856778,1
2020-09-02-170519,170519,0,0,0,109,0.3333333333333333,99.85422289086026,2
2020-09-03-170519,170519,0,0,0,109,1.0,64.95178846296803,3
2020-09-04-170519,170519,2,0,1,111,1.0,63.41324811942113,4
2020-09-05-170519,170519,1,0,0,112,0.16666666666666666,66.75571131836134,5
2020-09-06-170519,170519,0,0,0,112,0.3333333333333333,69.08526058832359,6
2020-09-07-170519,170519,0,0,3,112,0.8333333333333334,68.03622447803795,0
2020-09-08-170519,170519,0,0,0,112,2.0,71.87887662883978,1
2020-09-09-170519,170519,5,0,0,117,2.0,74.49082321553729,2
2020-09-10-170519,170519,1,0,0,118,1.6666666666666667,34.468690416489736,3
2020-09-11-170519,170519,1,0,0,119,0.6666666666666666,41.254240470925886,4
2020-09-12-170519,170519,1,0,0,120,0.16666666666666666,45.87911945075281,5
2020-09-13-170519,170519,1,0,0,121,2.1666666666666665,46.36609165150014,6
2020-09-14-170519,170519,0,0,0,121,1.0,62.699634824550074,0
2020-09-15-170519,170519,1,0,0,122,2.5,74.90866142660553,1
2020-09-16-170519,170519,0,0,0,122,0.8333333333333334,95.08994971282692,2
2020-09-17-170519,170519,0,0,1,122,0.6666666666666666,88.98623156722019,3
2020-09-18-170519,170519,1,0,0,123,1.5,88.27783600527964,4
2020-09-19-170519,170519,0,0,0,123,0.6666666666666666,90.12126423223962,5
2020-09-20-170519,170519,0,0,0,123,1.0,71.63021559514742,6
2020-09-21-170519,170519,3,0,0,126,0.16666666666666666,64.82922401912315,0
2020-09-22-170519,170519,0,0,0,126,1.3333333333333333,53.59760048265938,1
2020-09-23-170519,170519,0,0,0,126,1.0,51.11705603359091,2
2020-09-24-170519,170519,0,0,1,126,1.0,55.18507842511976,3
2020-09-25-170519,170519,0,1,0,126,0.5,52.088187928008594,4
2020-09-26-170519,170519,0,0,1,126,1.3333333333333333,55.503010346394646,5
2020-09-27-170519,170519,0,0,0,126,0.5,64.41753779520269,6
2020-09-28-170519,170519,0,0,0,126,0.16666666666666666,64.81138469486032,0
2020-09-29-170519,170519,0,0,0,126,0.8333333333333334,63.69092996854143,1
2020-09-30-170519,170519,0,0,0,126,1.0,62.21971884307662,2
2020-10-01-170519,170519,1,0,0,127,1.8333333333333333,0.0,3
2020-10-02-170519,170519,0,0,0,127,2.6666666666666665,141.87759451762827,4
2020-10-03-170519,170519,0,0,0,127,0.16666666666666666,141.40942761044215,5
2020-10-04-170519,170519,0,0,0,127,1.5,131.0636228665738,6
2020-10-05-170519,170519,0,0,0,127,1.6666666666666667,118.45028636160836,0
2020-10-06-170519,170519,0,0,1,127,1.3333333333333333,116.9534150719488,1
2020-10-07-170519,170519,0,0,2,127,1.5,84.78288131954474,2
2020-10-08-170519,170519,1,0,0,128,1.3333333333333333,78.15236797538407,3
2020-10-09-170519,170519,0,0,2,128,0.3333333333333333,87.39685897117477,4
2020-10-10-170519,170519,1,0,2,129,2.0,14.299817147371073,5
2020-10-11-170519,170519,0,0,2,129,0.5,30.568791225580384,6
2020-10-12-170519,170519,0,0,5,129,1.6666666666666667,33.47271769705643,0
2020-10-13-170519,170519,0,0,1,129,1.5,38.18930162109817,1
2020-10-14-170519,170519,0,0,4,129,6.0,48.800974838080336,2
2020-10-15-170519,170519,0,0,2,129,1.8333333333333333,118.60699761286881,3
2020-10-16-170519,170519,0,0,0,129,1.6666666666666667,129.74736372460012,4
2020-10-17-170519,170519,0,0,2,129,1.8333333333333333,135.1514021517913,5
2020-10-18-170519,170519,0,0,1,129,0.8333333333333334,127.82033977791218,6
2020-10-19-170519,170519,0,0,1,129,3.0,131.21532610474375,0
2020-10-20-170519,170519,1,0,0,130,1.8333333333333333,153.99477124040095,1
2020-10-21-170519,170519,2,0,5,132,3.8333333333333335,98.38964265991416,2
2020-10-22-170519,170519,0,0,0,132,2.333333333333333,98.00891173107765,3
2020-10-23-170519,170519,2,0,0,134,2.0,92.9560734671442,4
2020-10-24-170519,170519,2,0,0,136,0.3333333333333333,96.68254348234072,5
2020-10-25-170519,170519,2,0,5,138,1.5,101.9985886340989,6
2020-10-26-170519,170519,5,1,0,143,0.8333333333333334,100.23738094598635,0
2020-10-27-170519,170519,1,0,1,144,1.1666666666666667,96.32878838280952,1
2020-10-28-170519,170519,4,0,0,148,3.0,91.49592680141913,2
2020-10-29-170519,170519,2,0,0,150,1.6666666666666667,117.46173062228254,3
2020-10-30-170519,170519,0,0,2,150,0.8333333333333334,111.137665677662,4
2020-10-31-170519,170519,2,0,0,152,0.8333333333333334,114.7865976365731,5
2020-11-01-170519,170519,1,1,0,153,1.0,73.62673354517761,6
2020-11-02-170519,170519,1,0,0,154,2.0,134.92920481593904,0
2020-11-03-170519,170519,0,0,0,154,1.6666666666666667,133.74930860603195,1
2020-11-04-170519,170519,5,0,0,159,3.333333333333333,136.54599026721206,2
2020-11-05-170519,170519,0,0,0,159,2.6666666666666665,149.55008646068606,3
2020-11-06-170519,170519,0,0,0,159,2.0,156.19008041790505,4
2020-11-07-170519,170519,0,0,0,159,1.3333333333333333,145.26950243487755,5
2020-11-08-170519,170519,5,0,0,164,0.8333333333333334,158.04673284477502,6
2020-11-09-170519,170519,0,0,0,164,1.3333333333333333,156.61782652829208,0
2020-11-10-170519,170519,1,1,0,165,3.333333333333333,68.12457286824612,1
2020-11-11-170519,170519,0,0,0,165,2.6666666666666665,76.85972584062192,2
2020-11-12-170519,170519,0,1,0,165,4.0,78.13367729150164,3
2020-11-13-170519,170519,2,0,0,167,1.6666666666666667,89.58022222768822,4
2020-03-01-170520,170520,0,0,0,0,0.0,0.0,6
2020-03-02-170520,170520,0,0,0,0,0.0,27.47451789528097,0
2020-03-03-170520,170520,0,0,1,0,0.0,202.38138559232425,1
2020-03-04-170520,170520,0,2,6,0,0.3333333333333333,239.93580590944924,2
2020-03-05-170520,170520,0,0,3,0,0.0,260.3908674727607,3
2020-03-06-170520,170520,0,0,4,0,0.0,238.76076346198545,4
2020-03-07-170520,170520,0,0,1,0,0.0,235.09462798320044,5
2020-03-08-170520,170520,0,0,1,0,0.3333333333333333,212.79738527064532,6
2020-03-09-170520,170520,0,0,0,0,0.6666666666666666,215.2595983212903,0
2020-03-10-170520,170520,0,0,6,0,0.0,787.0176238965548,1
2020-03-11-170520,170520,0,0,3,0,0.3333333333333333,697.7296270874297,2
2020-03-12-170520,170520,0,0,4,0,1.3333333333333333,554.3309111920889,3
2020-03-13-170520,170520,0,0,1,0,1.3333333333333333,457.9931548407058,4
2020-03-14-170520,170520,0,0,4,0,0.6666666666666666,181.8701530591536,5
2020-03-15-170520,170520,0,0,1,0,1.6666666666666667,133.30308290570537,6
2020-03-16-170520,170520,0,0,8,0,7.333333333333332,44.119892947076934,0
2020-03-17-170520,170520,1,0,3,1,7.333333333333332,84.81683228253343,1
2020-03-18-170520,170520,6,0,4,7,8.666666666666666,121.3218365733615,2
2020-03-19-170520,170520,3,0,3,10,11.0,165.73955157756723,3
2020-03-20-170520,170520,4,0,1,14,13.333333333333336,195.70684809401124,4
2020-03-21-170520,170520,1,0,1,15,7.666666666666668,221.21839555750094,5
2020-03-22-170520,170520,1,0,2,16,4.333333333333333,228.26595695567022,6
2020-03-23-170520,170520,0,0,3,16,21.0,220.8050455678254,0
2020-03-24-170520,170520,6,0,1,22,18.33333333333333,258.5672029539202,1
2020-03-25-170520,170520,3,0,1,25,14.0,278.67134833112755,2
2020-03-26-170520,170520,4,0,3,29,14.0,277.7311036550489,3
2020-03-27-170520,170520,1,0,2,30,12.666666666666664,325.06759917845955,4
2020-03-28-170520,170520,4,0,3,34,7.0,323.6507425351258,5
2020-03-29-170520,170520,1,0,1,35,6.333333333333332,327.7832439939468,6
2020-03-30-170520,170520,8,0,1,43,11.666666666666664,263.8674669914262,0
2020-03-31-170520,170520,3,0,2,46,10.333333333333334,240.6798149042661,1
2020-04-01-170520,170520,4,0,2,50,9.666666666666666,35.34195914613854,2
2020-04-02-170520,170520,3,0,2,53,7.0,110.47767584214475,3
2020-04-03-170520,170520,1,0,4,54,7.0,73.07649881962668,4
2020-04-04-170520,170520,1,0,0,55,4.333333333333333,87.1480195577066,5
2020-04-05-170520,170520,2,0,0,57,6.333333333333332,94.50804737620204,6
2020-04-06-170520,170520,3,7,2,60,8.666666666666666,103.15501691543543,0
2020-04-07-170520,170520,1,0,2,61,6.0,117.09644764752099,1
2020-04-08-170520,170520,1,0,1,62,7.333333333333332,125.68224395813736,2
2020-04-09-170520,170520,3,0,0,65,7.333333333333332,140.9398014841429,3
2020-04-10-170520,170520,2,0,0,67,4.666666666666667,34.746698394005406,4
2020-04-11-170520,170520,3,0,1,70,4.0,48.531989981489204,5
2020-04-12-170520,170520,1,0,4,71,1.6666666666666667,63.58920761796159,6
2020-04-13-170520,170520,1,0,7,72,6.333333333333332,68.41477191265204,0
2020-04-14-170520,170520,2,0,0,74,3.6666666666666665,89.00190606415242,1
2020-04-15-170520,170520,2,0,1,76,6.0,107.80925924819819,2
2020-04-16-170520,170520,2,0,0,78,10.0,129.95189429568796,3
2020-04-17-170520,170520,4,0,1,82,4.666666666666667,132.14707543030815,4
2020-04-18-170520,170520,0,0,0,82,1.0,143.36432191653662,5
2020-04-19-170520,170520,0,0,1,82,1.6666666666666667,129.36485681929344,6
2020-04-20-170520,170520,2,0,0,84,5.666666666666668,139.34531454130865,0
2020-04-21-170520,170520,2,0,1,86,3.0,140.4273872029886,1
2020-04-22-170520,170520,1,0,0,87,8.666666666666666,133.72357633274356,2
2020-04-23-170520,170520,0,0,1,87,1.0,131.16785079740964,3
2020-04-24-170520,170520,0,0,2,87,4.0,106.72263075586022,4
2020-04-25-170520,170520,1,0,2,88,0.6666666666666666,117.22155226202432,5
2020-04-26-170520,170520,4,0,0,92,2.6666666666666665,116.50656730018812,6
2020-04-27-170520,170520,7,0,1,99,2.0,98.69853671145178,0
2020-04-28-170520,170520,0,0,1,99,4.333333333333333,98.65936653585334,1
2020-04-29-170520,170520,1,0,2,100,2.333333333333333,100.10318033115979,2
2020-04-30-170520,170520,0,0,1,100,3.6666666666666665,114.0479293698483,3
2020-05-01-170520,170520,1,0,2,101,4.0,199.34326607848593,4
2020-05-02-170520,170520,0,0,0,101,1.0,83.73431672571475,5
2020-05-03-170520,170520,1,0,0,102,1.0,48.935845268296056,6
2020-05-04-170520,170520,0,0,0,102,3.0,46.25004864372694,0
2020-05-05-170520,170520,1,0,2,103,4.333333333333333,52.61507425889981,1
2020-05-06-170520,170520,0,0,2,103,6.333333333333332,59.043826732290356,2
2020-05-07-170520,170520,1,0,3,104,4.333333333333333,75.75953048676735,3
2020-05-08-170520,170520,2,0,0,106,1.6666666666666667,89.53583063355669,4
2020-05-09-170520,170520,2,0,1,108,1.0,109.5932825259109,5
2020-05-10-170520,170520,0,0,0,108,1.0,253.59715020918156,6
2020-05-11-170520,170520,1,2,1,109,5.666666666666668,236.55929297681737,0
2020-05-12-170520,170520,1,0,0,110,3.333333333333333,232.1960014184348,1
2020-05-13-170520,170520,2,0,3,112,4.666666666666667,200.72632422562992,2
2020-05-14-170520,170520,1,0,0,113,2.6666666666666665,182.03736004976412,3
2020-05-15-170520,170520,2,0,1,115,3.0,155.44111842248856,4
2020-05-16-170520,170520,0,0,0,115,1.6666666666666667,128.6832484540661,5
2020-05-17-170520,170520,0,1,0,115,0.6666666666666666,118.25437860233737,6
2020-05-18-170520,170520,0,0,1,115,3.333333333333333,117.56302204241413,0
2020-05-19-170520,170520,2,0,1,117,3.6666666666666665,106.98567468947041,1
2020-05-20-170520,170520,2,0,0,119,3.0,95.29682877312123,2
2020-05-21-170520,170520,3,0,2,122,2.6666666666666665,96.80528550503197,3
2020-05-22-170520,170520,0,0,0,122,5.0,96.35400785739108,4
2020-05-23-170520,170520,1,0,0,123,0.6666666666666666,113.07888279653652,5
2020-05-24-170520,170520,0,2,0,123,0.0,115.9519387502647,6
2020-05-25-170520,170520,1,1,1,124,1.6666666666666667,98.89879896103699,0
2020-05-26-170520,170520,0,0,0,124,2.6666666666666665,84.0990286173099,1
2020-05-27-170520,170520,3,0,1,127,2.0,96.342714843148,2
2020-05-28-170520,170520,0,4,1,127,0.6666666666666666,100.36845359358688,3
2020-05-29-170520,170520,1,0,0,128,1.3333333333333333,89.66066748397375,4
2020-05-30-170520,170520,0,0,0,128,0.3333333333333333,83.22369611162529,5
2020-05-31-170520,170520,0,0,0,128,0.3333333333333333,88.61966584092094,6
2020-06-01-170520,170520,1,0,0,129,1.3333333333333333,151.27260648563438,0
2020-06-02-170520,170520,1,0,1,130,0.6666666666666666,51.50390729990586,1
2020-06-03-170520,170520,0,0,2,130,0.6666666666666666,44.315182246440514,2
2020-06-04-170520,170520,2,0,0,132,0.0,43.52978201310461,3
2020-06-05-170520,170520,0,0,2,132,1.0,42.26799725351408,4
2020-06-06-170520,170520,0,0,0,132,0.0,37.86406812683203,5
2020-06-07-170520,170520,0,0,0,132,0.3333333333333333,34.51870697531838,6
2020-06-08-170520,170520,1,0,0,133,0.0,34.00168157112335,0
2020-06-09-170520,170520,0,0,0,133,0.3333333333333333,39.75518821251695,1
2020-06-10-170520,170520,1,0,1,134,1.6666666666666667,165.9395260331463,2
2020-06-11-170520,170520,1,0,0,135,1.0,156.31446918654382,3
2020-06-12-170520,170520,0,0,3,135,2.0,137.98660501068093,4
2020-06-13-170520,170520,0,0,0,135,0.3333333333333333,120.62297963582239,5
2020-06-14-170520,170520,0,1,1,135,0.0,89.82961865203578,6
2020-06-15-170520,170520,0,1,0,135,0.3333333333333333,65.79316275955303,0
2020-06-16-170520,170520,1,0,0,136,1.6666666666666667,60.16855386179488,1
2020-06-17-170520,170520,2,0,0,138,1.6666666666666667,57.1539628819826,2
2020-06-18-170520,170520,0,0,0,138,0.3333333333333333,56.69814616122245,3
2020-06-19-170520,170520,2,0,1,140,1.6666666666666667,55.21913875428643,4
2020-06-20-170520,170520,0,0,0,140,0.3333333333333333,63.37400773186616,5
2020-06-21-170520,170520,0,0,1,140,0.3333333333333333,66.08550266968983,6
2020-06-22-170520,170520,0,0,0,140,1.0,63.52746611874388,0
2020-06-23-170520,170520,0,0,0,140,0.6666666666666666,58.852508274071006,1
2020-06-24-170520,170520,1,0,0,141,1.0,51.85022020496275,2
2020-06-25-170520,170520,0,0,1,141,1.3333333333333333,52.57646987000024,3
2020-06-26-170520,170520,3,0,1,144,0.6666666666666666,45.262260694383905,4
2020-06-27-170520,170520,0,1,0,144,1.0,48.81216817001569,5
2020-06-28-170520,170520,1,0,0,145,0.0,50.99810773200772,6
2020-06-29-170520,170520,0,0,1,145,0.3333333333333333,50.84660687456717,0
2020-06-30-170520,170520,0,0,1,145,1.0,52.25599273318374,1
2020-07-01-170520,170520,0,0,1,145,0.3333333333333333,42.53241251267763,2
2020-07-02-170520,170520,0,0,0,145,0.3333333333333333,23.596078173651108,3
2020-07-03-170520,170520,1,0,0,146,0.3333333333333333,32.544367860387005,4
2020-07-04-170520,170520,0,0,0,146,0.3333333333333333,39.936181290130875,5
2020-07-05-170520,170520,1,0,0,147,0.0,42.13637500102825,6
2020-07-06-170520,170520,0,0,0,147,0.6666666666666666,40.15771533502524,0
2020-07-07-170520,170520,0,0,0,147,1.3333333333333333,41.87298126390831,1
2020-07-08-170520,170520,0,0,0,147,0.3333333333333333,40.769565502789995,2
2020-07-09-170520,170520,1,0,0,148,0.3333333333333333,38.11036086534479,3
2020-07-10-170520,170520,1,0,0,149,1.0,42.69410929570229,4
2020-07-11-170520,170520,0,0,0,149,0.0,44.40930811726662,5
2020-07-12-170520,170520,0,0,0,149,0.0,36.36573592452221,6
2020-07-13-170520,170520,1,0,0,150,0.0,35.23249087882534,0
2020-07-14-170520,170520,1,0,0,151,1.0,37.330837835000494,1
2020-07-15-170520,170520,1,0,0,152,3.333333333333333,30.717479836056157,2
2020-07-16-170520,170520,0,0,0,152,0.6666666666666666,35.42051563128623,3
2020-07-17-170520,170520,0,0,0,152,0.3333333333333333,34.73849110336564,4
2020-07-18-170520,170520,0,0,0,152,0.3333333333333333,22.145081723493714,5
2020-07-19-170520,170520,0,0,0,152,0.0,24.070893245628838,6
2020-07-20-170520,170520,0,0,0,152,0.0,25.735236519539974,0
2020-07-21-170520,170520,0,0,1,152,0.0,21.880173194913944,1
2020-07-22-170520,170520,0,0,0,152,0.3333333333333333,14.698953562966611,2
2020-07-23-170520,170520,0,0,0,152,1.0,19.277071829887092,3
2020-07-24-170520,170520,0,0,0,152,1.0,30.897720242732575,4
2020-07-25-170520,170520,0,0,0,152,0.0,35.073834387360876,5
2020-07-26-170520,170520,0,0,1,152,0.3333333333333333,34.37286513021013,6
2020-07-27-170520,170520,0,0,0,152,0.3333333333333333,29.22359438521808,0
2020-07-28-170520,170520,0,0,0,152,0.0,32.535763308379344,1
2020-07-29-170520,170520,0,0,2,152,1.3333333333333333,33.06885198023936,2
2020-07-30-170520,170520,0,0,1,152,1.6666666666666667,26.87817573184217,3
2020-07-31-170520,170520,0,0,0,152,2.333333333333333,33.27333053526705,4
2020-08-01-170520,170520,0,0,0,152,0.0,30.07377816338949,5
2020-08-02-170520,170520,0,0,0,152,0.3333333333333333,169.77551548198204,6
2020-08-03-170520,170520,0,0,1,152,0.6666666666666666,164.71068760653503,0
2020-08-04-170520,170520,1,0,1,153,1.3333333333333333,144.7419969443896,1
2020-08-05-170520,170520,0,0,0,153,1.6666666666666667,126.17318365667586,2
2020-08-06-170520,170520,0,0,2,153,2.0,111.63786267797039,3
2020-08-07-170520,170520,0,0,0,153,2.333333333333333,101.2876275185942,4
2020-08-08-170520,170520,0,0,0,153,0.0,90.63766409852693,5
2020-08-09-170520,170520,1,0,2,154,1.3333333333333333,86.88549020290503,6
2020-08-10-170520,170520,0,0,0,154,1.3333333333333333,19.878603521363104,0
2020-08-11-170520,170520,0,0,1,154,1.0,23.248943104184345,1
2020-08-12-170520,170520,2,0,1,156,3.0,29.476267533221076,2
2020-08-13-170520,170520,1,0,2,157,1.6666666666666667,44.130550820210956,3
2020-08-14-170520,170520,0,0,0,157,3.6666666666666665,52.88421231564334,4
2020-08-15-170520,170520,0,0,0,157,0.6666666666666666,76.11806885041518,5
2020-08-16-170520,170520,0,0,0,157,0.3333333333333333,78.53114957963002,6
2020-08-17-170520,170520,1,0,1,158,3.333333333333333,83.53381638621543,0
2020-08-18-170520,170520,1,0,7,159,3.333333333333333,95.18724809244985,1
2020-08-19-170520,170520,0,0,0,159,4.666666666666667,105.98079641657526,2
2020-08-20-170520,170520,2,0,2,161,1.6666666666666667,121.51752639942686,3
2020-08-21-170520,170520,0,0,1,161,5.333333333333333,110.03279464693551,4
2020-08-22-170520,170520,0,0,0,161,2.333333333333333,131.8518028930792,5
2020-08-23-170520,170520,2,0,6,163,0.6666666666666666,142.8615565084533,6
2020-08-24-170520,170520,0,0,0,163,3.6666666666666665,135.037371899883,0
2020-08-25-170520,170520,1,0,2,164,2.0,137.78004963967126,1
2020-08-26-170520,170520,1,0,2,165,4.0,106.01638540724109,2
2020-08-27-170520,170520,2,0,2,167,5.333333333333333,127.53705978798638,3
2020-08-28-170520,170520,0,0,2,167,4.333333333333333,134.8654482282996,4
2020-08-29-170520,170520,0,0,1,167,4.0,125.53327065235099,5
2020-08-30-170520,170520,0,0,5,167,1.0,128.019467377304,6
2020-08-31-170520,170520,1,0,1,168,1.6666666666666667,118.82242422164707,0
2020-09-01-170520,170520,7,0,9,175,3.0,82.266855705072,1
2020-09-02-170520,170520,0,0,3,175,1.6666666666666667,291.32029919250976,2
2020-09-03-170520,170520,2,0,3,177,5.0,247.14281302059254,3
2020-09-04-170520,170520,1,0,3,178,5.333333333333333,259.4893547164994,4
2020-09-05-170520,170520,0,0,2,178,3.6666666666666665,273.31101990059653,5
2020-09-06-170520,170520,6,0,2,184,2.6666666666666665,257.4845187241998,6
2020-09-07-170520,170520,0,0,4,184,7.0,254.94631238637143,0
2020-09-08-170520,170520,2,0,1,186,5.666666666666668,273.4010983036308,1
2020-09-09-170520,170520,2,0,4,188,3.6666666666666665,304.0132655172932,2
2020-09-10-170520,170520,2,0,1,190,4.0,125.45335700437974,3
2020-09-11-170520,170520,2,0,0,192,5.0,156.9222842180711,4
2020-09-12-170520,170520,1,0,4,193,4.0,195.1982240352258,5
2020-09-13-170520,170520,5,0,5,198,2.333333333333333,212.3661691856617,6
2020-09-14-170520,170520,1,0,0,199,9.0,230.76424420745582,0
2020-09-15-170520,170520,9,0,2,208,3.6666666666666665,281.38155913246874,1
2020-09-16-170520,170520,3,0,6,211,5.0,335.7395694139852,2
2020-09-17-170520,170520,3,0,3,214,8.333333333333334,330.561268680318,3
2020-09-18-170520,170520,3,0,2,217,11.333333333333336,334.06815099253527,4
2020-09-19-170520,170520,2,1,0,219,3.333333333333333,344.9807984971577,5
2020-09-20-170520,170520,2,0,0,221,8.666666666666666,315.9509513103792,6
2020-09-21-170520,170520,4,0,0,225,7.0,322.4169613526292,0
2020-09-22-170520,170520,1,0,0,226,6.0,300.4213137171136,1
2020-09-23-170520,170520,4,1,0,230,7.666666666666668,292.5369691112283,2
2020-09-24-170520,170520,1,0,1,231,8.333333333333334,296.42806248769506,3
2020-09-25-170520,170520,0,0,2,231,5.666666666666668,270.1957520431332,4
2020-09-26-170520,170520,4,0,11,235,4.0,275.0434649770508,5
2020-09-27-170520,170520,5,0,4,240,4.666666666666667,306.4788837042498,6
2020-09-28-170520,170520,0,0,4,240,4.333333333333333,296.634838308442,0
2020-09-29-170520,170520,2,0,6,242,1.3333333333333333,288.0409276020573,1
2020-09-30-170520,170520,6,0,3,248,5.333333333333333,283.4940347584986,2
2020-10-01-170520,170520,3,0,3,251,6.666666666666668,0.0,3
2020-10-02-170520,170520,2,0,6,253,10.0,495.24801337732134,4
2020-10-03-170520,170520,0,0,6,253,7.0,556.9874521415868,5
2020-10-04-170520,170520,0,0,2,253,2.333333333333333,552.7661705947598,6
2020-10-05-170520,170520,0,0,6,253,5.666666666666668,490.82494896439164,0
2020-10-06-170520,170520,0,0,4,253,11.0,459.4181013654635,1
2020-10-07-170520,170520,0,0,3,253,6.666666666666668,421.86839153578546,2
2020-10-08-170520,170520,1,0,1,254,13.333333333333336,374.8599088578962,3
2020-10-09-170520,170520,2,0,2,256,16.666666666666668,408.3763825077636,4
2020-10-10-170520,170520,11,0,0,267,6.333333333333332,44.06080346862518,5
2020-10-11-170520,170520,4,0,0,271,0.6666666666666666,111.88478298195554,6
2020-10-12-170520,170520,4,0,3,275,6.333333333333332,126.40944074114968,0
2020-10-13-170520,170520,6,0,0,281,6.0,150.85476212878785,1
2020-10-14-170520,170520,3,0,1,284,10.333333333333334,194.94961418239762,2
2020-10-15-170520,170520,3,0,4,287,11.666666666666664,263.26526073314267,3
2020-10-16-170520,170520,6,0,2,293,13.666666666666664,323.01238311332975,4
2020-10-17-170520,170520,6,0,2,299,8.666666666666666,374.5577804965031,5
2020-10-18-170520,170520,2,0,4,301,3.6666666666666665,374.38364511096313,6
2020-10-19-170520,170520,6,0,6,307,5.666666666666668,385.64724886485646,0
2020-10-20-170520,170520,4,0,3,311,9.333333333333334,441.28720239615154,1
2020-10-21-170520,170520,3,0,0,314,3.6666666666666665,433.43362177025443,2
2020-10-22-170520,170520,1,0,3,315,9.666666666666666,404.34205899941026,3
2020-10-23-170520,170520,2,0,13,317,18.666666666666668,383.9829652713629,4
2020-10-24-170520,170520,0,0,8,317,11.666666666666664,386.09728555953643,5
2020-10-25-170520,170520,0,0,7,317,5.333333333333333,428.1787659021164,6
2020-10-26-170520,170520,3,0,5,320,6.666666666666668,410.620927187097,0
2020-10-27-170520,170520,0,0,1,320,13.666666666666664,424.9181923642599,1
2020-10-28-170520,170520,1,0,0,321,8.333333333333334,439.6601701498137,2
2020-10-29-170520,170520,4,0,6,325,7.666666666666668,483.5523465890236,3
2020-10-30-170520,170520,2,0,10,327,14.333333333333336,471.62271550812653,4
2020-10-31-170520,170520,2,0,0,329,6.666666666666668,477.4366743135169,5
2020-11-01-170520,170520,4,0,0,333,2.6666666666666665,383.4616532862926,6
2020-11-02-170520,170520,6,0,0,339,7.333333333333332,578.3792936590526,0
2020-11-03-170520,170520,3,0,0,342,7.0,493.72858216270055,1
2020-11-04-170520,170520,0,0,0,342,7.666666666666668,497.4196133475383,2
2020-11-05-170520,170520,3,0,0,345,14.0,508.509997190739,3
2020-11-06-170520,170520,13,0,0,358,12.333333333333336,567.7818813091187,4
2020-11-07-170520,170520,8,0,0,366,23.33333333333333,549.0031926477141,5
2020-11-08-170520,170520,7,0,0,373,3.6666666666666665,638.5211015417673,6
2020-11-09-170520,170520,5,1,0,378,8.666666666666666,620.9592280671311,0
2020-11-10-170520,170520,1,0,0,379,7.0,348.3611145867686,1
2020-11-11-170520,170520,0,1,0,379,5.333333333333333,385.0016582285583,2
2020-11-12-170520,170520,6,0,0,385,13.0,382.3274616739741,3
2020-11-13-170520,170520,10,0,0,395,15.0,424.90222324027593,4
2020-03-01-170601,170601,0,0,2,0,0.16666666666666666,0.0,6
2020-03-02-170601,170601,0,0,3,0,0.16666666666666666,92.89679576647362,0
2020-03-03-170601,170601,0,0,4,0,0.3333333333333333,499.6866626229475,1
2020-03-04-170601,170601,0,1,6,0,0.16666666666666666,582.6955565743701,2
2020-03-05-170601,170601,0,0,10,0,0.0,623.0808276180046,3
2020-03-06-170601,170601,0,0,14,0,0.0,528.196753040985,4
2020-03-07-170601,170601,0,0,12,0,0.0,590.6165308264445,5
2020-03-08-170601,170601,0,0,14,0,0.0,590.823264513306,6
2020-03-09-170601,170601,0,0,20,0,0.16666666666666666,588.8842363399748,0
2020-03-10-170601,170601,0,0,17,0,0.5,874.3889131596425,1
2020-03-11-170601,170601,0,0,25,0,0.3333333333333333,672.1006943904689,2
2020-03-12-170601,170601,0,0,19,0,0.5,524.3193053546869,3
2020-03-13-170601,170601,0,0,35,0,1.3333333333333333,347.1244429077782,4
2020-03-14-170601,170601,1,0,2,1,2.1666666666666665,319.22943503430224,5
2020-03-15-170601,170601,2,0,5,3,3.6666666666666665,261.8199832233916,6
2020-03-16-170601,170601,3,0,27,6,6.833333333333332,144.4176388605877,0
2020-03-17-170601,170601,4,0,18,10,7.166666666666668,259.36374033831146,1
2020-03-18-170601,170601,6,0,21,16,7.333333333333332,374.52524367850185,2
2020-03-19-170601,170601,10,0,8,26,7.5,476.33389150908033,3
2020-03-20-170601,170601,14,0,9,40,8.0,559.6008866002242,4
2020-03-21-170601,170601,12,1,2,52,4.0,656.4992605690225,5
2020-03-22-170601,170601,14,0,4,66,4.666666666666667,660.5549271824798,6
2020-03-23-170601,170601,20,0,14,86,17.5,643.2570002369762,0
2020-03-24-170601,170601,17,0,4,103,12.333333333333336,769.6975283081306,1
2020-03-25-170601,170601,25,0,8,128,13.833333333333336,835.0229849695266,2
2020-03-26-170601,170601,19,0,3,147,11.166666666666664,929.6951158884233,3
2020-03-27-170601,170601,35,0,1,182,9.833333333333334,1106.3569810269134,4
2020-03-28-170601,170601,2,0,3,184,2.6666666666666665,1184.9814715982407,5
2020-03-29-170601,170601,5,0,0,189,4.0,1150.2613039724044,6
2020-03-30-170601,170601,27,0,6,216,11.333333333333336,888.3942759580856,0
2020-03-31-170601,170601,18,0,9,234,7.333333333333332,925.0047520708082,1
2020-04-01-170601,170601,21,0,16,255,7.833333333333332,142.42801250104367,2
2020-04-02-170601,170601,8,0,8,263,4.5,431.2948275840143,3
2020-04-03-170601,170601,9,0,7,272,7.0,264.2906443829936,4
2020-04-04-170601,170601,2,0,7,274,1.3333333333333333,333.1173339336128,5
2020-04-05-170601,170601,4,0,3,278,3.333333333333333,336.54165529140016,6
2020-04-06-170601,170601,14,0,5,292,6.5,359.1506364145333,0
2020-04-07-170601,170601,4,0,6,296,4.5,409.2423095209248,1
2020-04-08-170601,170601,8,0,10,304,4.833333333333333,420.4040270607727,2
2020-04-09-170601,170601,3,0,2,307,2.5,431.0011221845437,3
2020-04-10-170601,170601,1,0,6,308,1.8333333333333333,144.30323484274544,4
2020-04-11-170601,170601,3,0,3,311,1.6666666666666667,167.65702598928655,5
2020-04-12-170601,170601,0,0,0,311,0.8333333333333334,187.52458110460637,6
2020-04-13-170601,170601,6,0,7,317,7.333333333333332,202.50918636969752,0
2020-04-14-170601,170601,9,0,8,326,4.333333333333333,275.18690901907905,1
2020-04-15-170601,170601,16,0,11,342,4.666666666666667,350.23732721591773,2
2020-04-16-170601,170601,8,0,6,350,3.6666666666666665,434.83486735891836,3
2020-04-17-170601,170601,7,0,2,357,3.333333333333333,377.1998547563974,4
2020-04-18-170601,170601,7,0,6,364,3.333333333333333,428.3939882820363,5
2020-04-19-170601,170601,3,0,0,367,1.3333333333333333,448.9412558100188,6
2020-04-20-170601,170601,5,1,27,372,3.5,450.2049058060039,0
2020-04-21-170601,170601,6,0,6,378,3.8333333333333335,429.01726231528903,1
2020-04-22-170601,170601,10,0,60,388,4.666666666666667,404.69248923154237,2
2020-04-23-170601,170601,2,0,11,390,1.0,412.4823842037732,3
2020-04-24-170601,170601,6,0,6,396,2.0,353.2691373945235,4
2020-04-25-170601,170601,3,0,1,399,2.0,350.8252815808768,5
2020-04-26-170601,170601,0,0,1,399,2.5,353.0977298915249,6
2020-04-27-170601,170601,7,0,4,406,4.666666666666667,295.1507626094277,0
2020-04-28-170601,170601,8,0,2,414,2.333333333333333,302.73241832728473,1
2020-04-29-170601,170601,11,2,1,425,2.1666666666666665,288.4876670504946,2
2020-04-30-170601,170601,6,0,3,431,1.5,352.3198825060937,3
2020-05-01-170601,170601,2,0,2,433,2.1666666666666665,399.64009637449107,4
2020-05-02-170601,170601,6,0,0,439,0.8333333333333334,149.29991962884577,5
2020-05-03-170601,170601,0,0,1,439,0.6666666666666666,95.22397673446916,6
2020-05-04-170601,170601,27,0,2,466,3.8333333333333335,76.75257133109048,0
2020-05-05-170601,170601,6,0,4,472,3.1666666666666665,187.86724473377467,1
2020-05-06-170601,170601,60,0,2,532,1.6666666666666667,219.05770936313658,2
2020-05-07-170601,170601,11,0,1,543,3.0,430.52250897846096,3
2020-05-08-170601,170601,6,0,3,549,3.1666666666666665,500.78177469196515,4
2020-05-09-170601,170601,1,1,0,550,0.6666666666666666,579.2579620951346,5
2020-05-10-170601,170601,1,0,2,551,0.0,422.3937827222558,6
2020-05-11-170601,170601,4,0,0,555,4.5,396.27551721238603,0
2020-05-12-170601,170601,2,1,0,557,2.833333333333333,411.9742164136518,1
2020-05-13-170601,170601,1,1,1,558,2.333333333333333,329.41994091183983,2
2020-05-14-170601,170601,3,2,2,561,2.1666666666666665,295.8589112251373,3
2020-05-15-170601,170601,2,0,0,563,1.8333333333333333,247.6726155780736,4
2020-05-16-170601,170601,0,1,0,563,0.0,236.75346280869024,5
2020-05-17-170601,170601,1,0,0,564,0.0,211.4169416477912,6
2020-05-18-170601,170601,2,0,3,566,3.1666666666666665,211.7500592182039,0
2020-05-19-170601,170601,4,0,5,570,1.8333333333333333,185.79370148263052,1
2020-05-20-170601,170601,2,0,1,572,1.6666666666666667,177.56169119643647,2
2020-05-21-170601,170601,1,0,0,573,1.1666666666666667,164.91973039993564,3
2020-05-22-170601,170601,3,0,2,576,1.8333333333333333,151.8751194980345,4
2020-05-23-170601,170601,0,0,2,576,0.5,183.1157544030063,5
2020-05-24-170601,170601,2,0,0,578,0.0,184.51791508516848,6
2020-05-25-170601,170601,0,0,0,578,0.8333333333333334,164.2014142885318,0
2020-05-26-170601,170601,0,0,0,578,1.0,147.99520081432564,1
2020-05-27-170601,170601,1,0,0,579,1.5,127.29593042074913,2
2020-05-28-170601,170601,2,4,0,581,2.1666666666666665,128.11889221928192,3
2020-05-29-170601,170601,0,1,0,581,1.8333333333333333,136.60452831315968,4
2020-05-30-170601,170601,0,0,0,581,0.0,131.2320714778872,5
2020-05-31-170601,170601,0,0,0,581,0.16666666666666666,125.1844368869283,6
2020-06-01-170601,170601,3,0,0,584,1.8333333333333333,714.9719337430683,0
2020-06-02-170601,170601,5,0,2,589,0.5,93.8069338491569,1
2020-06-03-170601,170601,1,0,0,590,1.0,63.72469565425396,2
2020-06-04-170601,170601,0,0,0,590,1.5,58.419180963019926,3
2020-06-05-170601,170601,2,1,0,592,2.833333333333333,71.49946135388544,4
2020-06-06-170601,170601,2,0,0,594,0.0,106.0188204162377,5
2020-06-07-170601,170601,0,0,0,594,0.16666666666666666,114.45041389530411,6
2020-06-08-170601,170601,0,0,0,594,0.5,117.23856181504362,0
2020-06-09-170601,170601,0,0,1,594,0.8333333333333334,114.82669710768872,1
2020-06-10-170601,170601,0,0,1,594,0.6666666666666666,760.2181995588642,2
2020-06-11-170601,170601,0,0,0,594,0.8333333333333334,617.8094011494069,3
2020-06-12-170601,170601,0,0,0,594,0.6666666666666666,573.097583856232,4
2020-06-13-170601,170601,0,0,0,594,0.16666666666666666,277.6508130019075,5
2020-06-14-170601,170601,0,0,0,594,0.16666666666666666,171.10267615709645,6
2020-06-15-170601,170601,0,0,1,594,0.3333333333333333,94.9574052136773,0
2020-06-16-170601,170601,2,0,0,596,0.6666666666666666,88.74442001931463,1
2020-06-17-170601,170601,0,1,0,596,1.0,69.32759137341151,2
2020-06-18-170601,170601,0,0,1,596,1.5,72.48266710576796,3
2020-06-19-170601,170601,0,0,0,596,2.0,80.47978897886684,4
2020-06-20-170601,170601,0,0,0,596,0.0,134.50814836272542,5
2020-06-21-170601,170601,0,0,0,596,0.16666666666666666,133.46966435151757,6
2020-06-22-170601,170601,0,0,0,596,1.5,126.94801008271335,0
2020-06-23-170601,170601,1,0,0,597,1.5,124.47150277345708,1
2020-06-24-170601,170601,1,1,0,598,0.3333333333333333,132.06518759057212,2
2020-06-25-170601,170601,0,0,0,598,0.8333333333333334,118.95584246986965,3
2020-06-26-170601,170601,0,0,0,598,0.16666666666666666,103.67380348141471,4
2020-06-27-170601,170601,0,0,0,598,0.0,73.87807877618853,5
2020-06-28-170601,170601,0,0,1,598,0.0,75.48891671234199,6
2020-06-29-170601,170601,1,0,0,599,0.6666666666666666,74.91604263065545,0
2020-06-30-170601,170601,0,0,0,599,0.8333333333333334,70.7938073897845,1
2020-07-01-170601,170601,0,0,0,599,0.3333333333333333,125.37521584614973,2
2020-07-02-170601,170601,1,0,0,600,0.3333333333333333,48.32859647649881,3
2020-07-03-170601,170601,0,0,0,600,0.16666666666666666,52.38735008705683,4
2020-07-04-170601,170601,0,0,1,600,0.16666666666666666,76.09286600738324,5
2020-07-05-170601,170601,0,0,0,600,0.0,75.58771831939066,6
2020-07-06-170601,170601,0,0,0,600,0.3333333333333333,67.28155152094229,0
2020-07-07-170601,170601,0,1,1,600,0.6666666666666666,59.934737632714956,1
2020-07-08-170601,170601,0,0,1,600,0.3333333333333333,51.99484497417565,2
2020-07-09-170601,170601,0,0,0,600,0.6666666666666666,48.655793360953695,3
2020-07-10-170601,170601,0,0,0,600,0.16666666666666666,129.1997367073878,4
2020-07-11-170601,170601,0,0,0,600,0.16666666666666666,106.7949980471158,5
2020-07-12-170601,170601,1,0,0,601,0.3333333333333333,61.17861368592717,6
2020-07-13-170601,170601,0,0,0,601,0.6666666666666666,60.49090868416111,0
2020-07-14-170601,170601,0,0,0,601,1.0,67.37326256867107,1
2020-07-15-170601,170601,0,0,0,601,0.3333333333333333,67.02247411258658,2
2020-07-16-170601,170601,0,0,0,601,0.6666666666666666,52.772876395417185,3
2020-07-17-170601,170601,0,0,1,601,0.5,54.6193595859383,4
2020-07-18-170601,170601,1,0,0,602,0.0,57.100918941842785,5
2020-07-19-170601,170601,0,0,2,602,0.0,59.37000695061157,6
2020-07-20-170601,170601,0,0,0,602,0.3333333333333333,46.96802507845105,0
2020-07-21-170601,170601,1,1,2,603,0.16666666666666666,39.34223601147611,1
2020-07-22-170601,170601,1,0,2,604,0.8333333333333334,57.00817079930957,2
2020-07-23-170601,170601,0,0,1,604,0.5,57.634404230915536,3
2020-07-24-170601,170601,0,0,2,604,0.16666666666666666,60.98583426477201,4
2020-07-25-170601,170601,0,0,4,604,0.3333333333333333,60.532735876489106,5
2020-07-26-170601,170601,0,0,4,604,0.3333333333333333,61.41930550447066,6
2020-07-27-170601,170601,0,0,3,604,0.5,55.87343655007841,0
2020-07-28-170601,170601,0,0,1,604,1.0,59.0306961564073,1
2020-07-29-170601,170601,0,0,2,604,1.3333333333333333,52.42690991253872,2
2020-07-30-170601,170601,0,0,6,604,1.0,53.94908161131525,3
2020-07-31-170601,170601,1,0,7,605,1.3333333333333333,64.39773548308162,4
2020-08-01-170601,170601,0,0,0,605,0.6666666666666666,42.27935551611982,5
2020-08-02-170601,170601,2,0,2,607,1.1666666666666667,426.4267929559038,6
2020-08-03-170601,170601,0,0,2,607,0.5,638.6371087796504,0
2020-08-04-170601,170601,2,0,2,609,1.3333333333333333,594.3230640967786,1
2020-08-05-170601,170601,2,0,4,611,1.8333333333333333,499.67446155944754,2
2020-08-06-170601,170601,1,0,6,612,2.5,444.7696277956255,3
2020-08-07-170601,170601,2,0,9,614,2.5,387.25221225534915,4
2020-08-08-170601,170601,4,0,0,618,0.8333333333333334,388.8225884591853,5
2020-08-09-170601,170601,4,0,2,622,0.0,411.8010501040677,6
2020-08-10-170601,170601,3,0,4,625,1.6666666666666667,37.80170234661852,0
2020-08-11-170601,170601,1,0,5,626,2.6666666666666665,82.2581545504288,1
2020-08-12-170601,170601,2,0,7,628,3.5,138.06002968659388,2
2020-08-13-170601,170601,6,0,2,634,3.5,228.44832973849987,3
2020-08-14-170601,170601,7,0,6,641,2.333333333333333,308.4276315550318,4
2020-08-15-170601,170601,0,0,1,641,1.1666666666666667,383.13979401087335,5
2020-08-16-170601,170601,2,0,2,643,1.5,393.9913226413472,6
2020-08-17-170601,170601,2,0,7,645,2.833333333333333,415.9907504771826,0
2020-08-18-170601,170601,2,0,4,647,3.0,436.84579098824423,1
2020-08-19-170601,170601,4,1,1,651,3.0,433.0245331332778,2
2020-08-20-170601,170601,6,0,3,657,4.5,349.64350189973175,3
2020-08-21-170601,170601,9,0,1,666,3.6666666666666665,378.1154258141277,4
2020-08-22-170601,170601,0,0,4,666,0.6666666666666666,455.5659340219921,5
2020-08-23-170601,170601,2,0,9,668,1.1666666666666667,444.67046343427023,6
2020-08-24-170601,170601,4,0,4,672,3.8333333333333335,404.79536374614014,0
2020-08-25-170601,170601,5,0,2,677,5.5,455.3580774070124,1
2020-08-26-170601,170601,7,0,1,684,5.5,492.6098012498195,2
2020-08-27-170601,170601,2,0,7,686,4.833333333333333,585.1173043156056,3
2020-08-28-170601,170601,6,0,0,692,4.166666666666667,566.7999526596268,4
2020-08-29-170601,170601,1,0,8,693,3.0,570.2767569726905,5
2020-08-30-170601,170601,2,0,1,695,2.0,588.9788094979239,6
2020-08-31-170601,170601,7,0,8,702,5.166666666666667,525.7369183020054,0
2020-09-01-170601,170601,4,0,3,706,6.333333333333332,352.27783158616853,1
2020-09-02-170601,170601,1,0,5,707,5.833333333333332,780.98068805311,2
2020-09-03-170601,170601,3,1,0,710,5.833333333333332,776.0786152524662,3
2020-09-04-170601,170601,1,0,7,711,6.166666666666668,699.8399298543421,4
2020-09-05-170601,170601,4,0,8,715,4.833333333333333,661.4708912803965,5
2020-09-06-170601,170601,9,0,3,724,3.6666666666666665,660.964793190062,6
2020-09-07-170601,170601,4,0,2,728,7.5,716.4508064208817,0
2020-09-08-170601,170601,2,0,0,730,3.1666666666666665,731.0035981931758,1
2020-09-09-170601,170601,1,0,5,731,3.6666666666666665,677.8323316605291,2
2020-09-10-170601,170601,7,0,5,738,5.0,330.8557109926753,3
2020-09-11-170601,170601,0,0,4,738,7.666666666666668,390.0193667681451,4
2020-09-12-170601,170601,8,0,6,746,2.1666666666666665,452.385438933772,5
2020-09-13-170601,170601,1,0,2,747,3.0,490.0818327086379,6
2020-09-14-170601,170601,8,0,6,755,9.833333333333334,499.691395574824,0
2020-09-15-170601,170601,3,1,0,758,5.666666666666668,606.8849941426425,1
2020-09-16-170601,170601,5,0,4,763,4.166666666666667,675.9197432039936,2
2020-09-17-170601,170601,0,0,3,763,5.666666666666668,664.2071832322285,3
2020-09-18-170601,170601,7,0,5,770,17.166666666666668,677.6834312138396,4
2020-09-19-170601,170601,8,0,1,778,6.0,724.8506908096412,5
2020-09-20-170601,170601,3,0,0,781,6.0,774.1658736725678,6
2020-09-21-170601,170601,2,0,6,783,11.166666666666664,708.9704091088283,0
2020-09-22-170601,170601,0,0,3,783,8.666666666666666,766.9318010405368,1
2020-09-23-170601,170601,5,0,4,788,8.5,783.3186479114801,2
2020-09-24-170601,170601,5,0,1,793,11.0,800.8085715168003,3
2020-09-25-170601,170601,4,0,10,797,8.666666666666666,808.8112225173671,4
2020-09-26-170601,170601,6,0,6,803,2.333333333333333,811.7974673584869,5
2020-09-27-170601,170601,2,0,4,805,2.1666666666666665,811.7113968947469,6
2020-09-28-170601,170601,6,0,2,811,7.0,776.7292290935894,0
2020-09-29-170601,170601,0,0,3,811,6.666666666666668,744.0735001677201,1
2020-09-30-170601,170601,4,2,7,815,7.666666666666668,689.7772396199343,2
2020-10-01-170601,170601,3,0,1,818,6.166666666666668,0.0,3
2020-10-02-170601,170601,5,0,5,823,6.0,943.8859804982583,4
2020-10-03-170601,170601,1,1,3,824,1.5,1061.0076412508417,5
2020-10-04-170601,170601,0,0,1,824,4.166666666666667,930.9429031394934,6
2020-10-05-170601,170601,6,1,6,830,6.333333333333332,816.5205078950283,0
2020-10-06-170601,170601,3,1,2,833,5.333333333333333,779.6019647922742,1
2020-10-07-170601,170601,4,0,9,837,4.166666666666667,723.2593298284288,2
2020-10-08-170601,170601,1,1,5,838,5.166666666666667,664.3495894548145,3
2020-10-09-170601,170601,10,2,2,848,6.333333333333332,726.3811844399942,4
2020-10-10-170601,170601,6,0,1,854,3.6666666666666665,96.55245490414035,5
2020-10-11-170601,170601,4,0,3,858,4.5,168.9551895802578,6
2020-10-12-170601,170601,2,0,0,860,4.333333333333333,254.8798439510842,0
2020-10-13-170601,170601,3,0,3,863,6.166666666666668,306.4409485984675,1
2020-10-14-170601,170601,7,0,2,870,6.166666666666668,442.5253184757395,2
2020-10-15-170601,170601,1,0,2,871,10.333333333333334,576.8718176861994,3
2020-10-16-170601,170601,5,0,5,876,12.333333333333336,719.4170723225852,4
2020-10-17-170601,170601,3,0,2,879,3.0,824.2566250000011,5
2020-10-18-170601,170601,1,0,3,880,4.833333333333333,796.7827048703318,6
2020-10-19-170601,170601,6,0,3,886,12.666666666666664,771.3020056348328,0
2020-10-20-170601,170601,2,2,3,888,11.666666666666664,891.6135852209836,1
2020-10-21-170601,170601,9,0,5,897,9.5,925.5835976295822,2
2020-10-22-170601,170601,5,0,7,902,11.833333333333336,976.5970791901284,3
2020-10-23-170601,170601,2,1,11,904,11.0,1014.7030729506357,4
2020-10-24-170601,170601,1,0,1,905,4.166666666666667,1134.6468071303998,5
2020-10-25-170601,170601,3,0,8,908,4.5,1139.9596398634817,6
2020-10-26-170601,170601,0,0,12,908,10.0,1031.6605280980484,0
2020-10-27-170601,170601,3,0,3,911,7.833333333333332,1113.97818634019,1
2020-10-28-170601,170601,2,0,8,913,8.0,1116.8875350021844,2
2020-10-29-170601,170601,2,0,3,915,7.0,1084.8242698407248,3
2020-10-30-170601,170601,5,0,6,920,8.833333333333334,886.826879883042,4
2020-10-31-170601,170601,2,0,0,922,2.333333333333333,993.2505889233946,5
2020-11-01-170601,170601,3,0,0,925,3.0,694.8768915848782,6
2020-11-02-170601,170601,3,0,0,928,4.5,486.5567994105752,0
2020-11-03-170601,170601,3,1,0,931,9.0,450.8464155609049,1
2020-11-04-170601,170601,5,0,0,936,11.166666666666664,574.805418134056,2
2020-11-05-170601,170601,7,1,0,943,6.0,694.4030905540827,3
2020-11-06-170601,170601,11,1,0,954,7.333333333333332,757.9495929474162,4
2020-11-07-170601,170601,1,0,0,955,2.6666666666666665,830.2012582125377,5
2020-11-08-170601,170601,8,1,0,963,2.1666666666666665,786.6793378727199,6
2020-11-09-170601,170601,12,0,0,975,8.0,786.2992151927432,0
2020-11-10-170601,170601,3,0,0,978,6.5,686.0692736430183,1
2020-11-11-170601,170601,8,1,0,986,4.833333333333333,733.9650709926366,2
2020-11-12-170601,170601,3,0,0,989,8.0,723.0758910942507,3
2020-11-13-170601,170601,6,1,0,995,6.0,731.9447410042908,4
2020-03-01-170602,170602,0,0,0,0,0.0,0.0,6
2020-03-02-170602,170602,0,0,0,0,0.0,2.0044331327996234,0
2020-03-03-170602,170602,0,0,1,0,0.0,5.587117947285792,1
2020-03-04-170602,170602,0,2,1,0,0.0,10.18637683897968,2
2020-03-05-170602,170602,0,0,1,0,0.0,13.294510902994945,3
2020-03-06-170602,170602,0,0,1,0,0.0,14.077679084932445,4
2020-03-07-170602,170602,0,0,0,0,0.0,15.815774384934922,5
2020-03-08-170602,170602,0,0,0,0,0.0,16.048521246711847,6
2020-03-09-170602,170602,0,0,1,0,0.0,17.607219285356948,0
2020-03-10-170602,170602,0,0,2,0,0.0,40.34042784477195,1
2020-03-11-170602,170602,0,0,1,0,0.0,34.65689939440331,2
2020-03-12-170602,170602,0,0,2,0,0.5,24.2339049590233,3
2020-03-13-170602,170602,1,0,0,1,1.0,12.690602124158044,4
2020-03-14-170602,170602,0,0,0,1,0.0,13.712816941220266,5
2020-03-15-170602,170602,0,0,0,1,1.0,10.022744197872399,6
2020-03-16-170602,170602,0,0,1,1,0.5,5.9272477953045755,0
2020-03-17-170602,170602,1,0,0,2,2.5,8.42766941533526,1
2020-03-18-170602,170602,1,0,1,3,4.0,16.199095752706306,2
2020-03-19-170602,170602,1,1,2,4,2.5,23.918460779728434,3
2020-03-20-170602,170602,1,0,0,5,0.0,26.089970061792197,4
2020-03-21-170602,170602,0,0,0,5,0.5,24.741406056781344,5
2020-03-22-170602,170602,0,0,1,5,0.0,23.257515127315415,6
2020-03-23-170602,170602,1,0,1,6,1.5,21.857650513952567,0
2020-03-24-170602,170602,2,0,0,8,0.5,21.213876629943584,1
2020-03-25-170602,170602,1,0,0,9,0.5,17.182613950170197,2
2020-03-26-170602,170602,2,0,0,11,0.0,17.549477740023807,3
2020-03-27-170602,170602,0,0,0,11,1.5,18.257351441067023,4
2020-03-28-170602,170602,0,0,0,11,1.0,20.45353553898586,5
2020-03-29-170602,170602,0,0,0,11,0.5,19.266854172597714,6
2020-03-30-170602,170602,1,0,0,12,3.0,14.602958609934044,0
2020-03-31-170602,170602,0,0,0,12,1.5,15.92164085207001,1
2020-04-01-170602,170602,1,0,0,13,0.5,1.972702848309537,2
2020-04-02-170602,170602,2,0,0,15,0.5,6.678475127810392,3
2020-04-03-170602,170602,0,0,0,15,2.0,6.090261101547233,4
2020-04-04-170602,170602,0,0,0,15,0.0,7.219292673983064,5
2020-04-05-170602,170602,1,0,0,16,0.5,8.047071895854351,6
2020-04-06-170602,170602,1,0,0,17,1.5,9.776288279054253,0
2020-04-07-170602,170602,0,0,0,17,1.0,10.497986715651646,1
2020-04-08-170602,170602,0,1,0,17,0.0,9.860819549328307,2
2020-04-09-170602,170602,0,0,0,17,0.5,8.054878537723894,3
2020-04-10-170602,170602,0,1,0,17,1.0,1.0941882023098088,4
2020-04-11-170602,170602,0,0,0,17,0.0,2.0219493304544907,5
2020-04-12-170602,170602,0,0,0,17,0.5,2.2564323899466565,6
2020-04-13-170602,170602,0,0,0,17,0.0,2.7758898750743812,0
2020-04-14-170602,170602,0,0,0,17,1.0,4.188543220184632,1
2020-04-15-170602,170602,0,0,0,17,1.0,5.504935308469339,2
2020-04-16-170602,170602,0,0,0,17,0.5,7.780469369000827,3
2020-04-17-170602,170602,0,0,0,17,0.0,8.42070564306109,4
2020-04-18-170602,170602,0,0,0,17,0.5,7.892240761548939,5
2020-04-19-170602,170602,0,0,0,17,0.5,8.198166809234992,6
2020-04-20-170602,170602,0,0,0,17,2.0,11.900975528745828,0
2020-04-21-170602,170602,0,0,0,17,0.5,14.398294726123979,1
2020-04-22-170602,170602,0,0,2,17,0.0,14.77496786463848,2
2020-04-23-170602,170602,0,0,1,17,0.5,13.609030144182128,3
2020-04-24-170602,170602,0,0,0,17,0.0,14.60853373001401,4
2020-04-25-170602,170602,0,0,0,17,0.0,14.131361126639208,5
2020-04-26-170602,170602,0,0,0,17,0.0,13.302792869071698,6
2020-04-27-170602,170602,0,0,0,17,0.0,8.477042176669986,0
2020-04-28-170602,170602,0,0,0,17,2.0,4.994201206529079,1
2020-04-29-170602,170602,0,0,0,17,1.5,6.419030676261931,2
2020-04-30-170602,170602,0,0,0,17,0.0,9.880346816202685,3
2020-05-01-170602,170602,0,0,0,17,0.0,9.177048371171946,4
2020-05-02-170602,170602,0,0,0,17,0.5,4.175831171249128,5
2020-05-03-170602,170602,0,0,0,17,0.0,3.150461881639598,6
2020-05-04-170602,170602,0,0,0,17,0.5,2.969633587395138,0
2020-05-05-170602,170602,0,0,2,17,0.0,4.524408927867617,1
2020-05-06-170602,170602,2,0,0,19,0.5,4.82414930312679,2
2020-05-07-170602,170602,1,0,0,20,0.5,21.45155232370464,3
2020-05-08-170602,170602,0,2,0,20,0.0,21.925501823008382,4
2020-05-09-170602,170602,0,0,0,20,0.0,22.662388536300707,5
2020-05-10-170602,170602,0,0,0,20,0.0,8.47660723923812,6
2020-05-11-170602,170602,0,0,0,20,0.0,8.442451552001964,0
2020-05-12-170602,170602,0,0,0,20,0.5,7.11500851131686,1
2020-05-13-170602,170602,0,0,0,20,1.0,6.141673882165568,2
2020-05-14-170602,170602,0,0,0,20,0.5,5.514585627868833,3
2020-05-15-170602,170602,0,0,0,20,0.0,5.534092656375083,4
2020-05-16-170602,170602,0,0,0,20,0.0,4.746560098088661,5
2020-05-17-170602,170602,0,0,0,20,0.0,4.938602062161545,6
2020-05-18-170602,170602,0,0,0,20,0.0,4.9238650260304135,0
2020-05-19-170602,170602,2,0,0,22,0.0,4.727265129993248,1
2020-05-20-170602,170602,0,0,3,22,0.5,4.7750398922354345,2
2020-05-21-170602,170602,0,0,0,22,0.0,4.941184618264809,3
2020-05-22-170602,170602,0,0,2,22,0.0,5.173511217783879,4
2020-05-23-170602,170602,0,0,0,22,0.0,5.459847126405334,5
2020-05-24-170602,170602,0,0,0,22,0.0,5.601859918617496,6
2020-05-25-170602,170602,0,0,0,22,0.0,5.0115646613323275,0
2020-05-26-170602,170602,0,0,0,22,0.0,3.476566708395329,1
2020-05-27-170602,170602,0,1,0,22,1.0,2.58175405863259,2
2020-05-28-170602,170602,0,0,0,22,0.0,3.782347581369416,3
2020-05-29-170602,170602,0,0,0,22,0.5,3.412276262770899,4
2020-05-30-170602,170602,0,0,0,22,0.0,4.539693836148544,5
2020-05-31-170602,170602,0,0,0,22,0.0,4.739223453416351,6
2020-06-01-170602,170602,0,0,0,22,0.0,31.480510024606726,0
2020-06-02-170602,170602,0,0,0,22,0.0,1.2758668896826346,1
2020-06-03-170602,170602,3,1,0,25,0.5,2.293873297370541,2
2020-06-04-170602,170602,0,0,0,25,0.0,5.123451483321851,3
2020-06-05-170602,170602,2,0,0,27,0.5,4.759337417045993,4
2020-06-06-170602,170602,0,1,0,27,0.0,7.549196172965319,5
2020-06-07-170602,170602,0,0,0,27,0.0,7.551926433304059,6
2020-06-08-170602,170602,0,0,0,27,0.0,7.64986295816011,0
2020-06-09-170602,170602,0,0,0,27,0.0,7.425983928276558,1
2020-06-10-170602,170602,0,0,0,27,0.0,33.44210832874488,2
2020-06-11-170602,170602,0,0,0,27,0.0,30.908468442296602,3
2020-06-12-170602,170602,0,0,0,27,0.0,28.477690973572876,4
2020-06-13-170602,170602,0,0,0,27,0.0,6.975067452591887,5
2020-06-14-170602,170602,0,0,0,27,0.0,4.669208775847679,6
2020-06-15-170602,170602,0,0,0,27,0.0,3.0286911737731663,0
2020-06-16-170602,170602,0,1,0,27,0.0,2.603918227146111,1
2020-06-17-170602,170602,0,0,0,27,0.0,1.612145703176631,2
2020-06-18-170602,170602,0,0,0,27,0.0,1.5494600929097442,3
2020-06-19-170602,170602,0,0,0,27,0.0,1.6531889572206628,4
2020-06-20-170602,170602,0,0,0,27,0.0,1.878774383113499,5
2020-06-21-170602,170602,0,0,0,27,0.0,2.1341772284009255,6
2020-06-22-170602,170602,0,0,0,27,0.5,1.9917480816504693,0
2020-06-23-170602,170602,0,0,0,27,0.0,2.902174526357167,1
2020-06-24-170602,170602,0,2,0,27,0.0,2.9604915231299804,2
2020-06-25-170602,170602,0,0,0,27,0.5,2.947058362846498,3
2020-06-26-170602,170602,0,0,0,27,0.0,3.6529751613936963,4
2020-06-27-170602,170602,0,0,0,27,0.0,3.36564381255664,5
2020-06-28-170602,170602,0,0,0,27,0.0,3.1455217719434225,6
2020-06-29-170602,170602,0,0,0,27,0.0,3.2765683967467085,0
2020-06-30-170602,170602,0,0,0,27,0.0,6.137133372193542,1
2020-07-01-170602,170602,0,0,0,27,0.0,4.696782203692033,2
2020-07-02-170602,170602,0,0,0,27,0.0,2.3079590646721977,3
2020-07-03-170602,170602,0,0,0,27,0.0,1.9921003538336768,4
2020-07-04-170602,170602,0,0,0,27,0.0,2.3579831148262747,5
2020-07-05-170602,170602,0,0,0,27,0.0,2.374329558649335,6
2020-07-06-170602,170602,0,0,0,27,0.0,2.516667707256027,0
2020-07-07-170602,170602,0,0,0,27,0.0,2.278008275848036,1
2020-07-08-170602,170602,0,0,0,27,0.0,1.3989395622526866,2
2020-07-09-170602,170602,0,0,0,27,0.0,1.1516859396182453,3
2020-07-10-170602,170602,0,0,0,27,0.0,5.161687247960228,4
2020-07-11-170602,170602,0,0,0,27,0.0,4.442141104300192,5
2020-07-12-170602,170602,0,0,0,27,0.0,0.9807850164357046,6
2020-07-13-170602,170602,0,0,0,27,0.0,1.1677141620233265,0
2020-07-14-170602,170602,0,0,0,27,0.0,1.6197851392182074,1
2020-07-15-170602,170602,0,0,0,27,0.0,1.5979541069921606,2
2020-07-16-170602,170602,0,0,0,27,0.5,1.411160152865767,3
2020-07-17-170602,170602,0,0,0,27,0.0,2.500250343845199,4
2020-07-18-170602,170602,0,0,0,27,0.0,2.481253526763556,5
2020-07-19-170602,170602,0,0,0,27,0.0,2.6009977616259343,6
2020-07-20-170602,170602,0,0,0,27,0.0,2.0509136985181415,0
2020-07-21-170602,170602,0,0,1,27,0.0,1.853353079184014,1
2020-07-22-170602,170602,0,0,0,27,0.0,2.112542136988126,2
2020-07-23-170602,170602,0,0,0,27,0.0,0.9629683043974935,3
2020-07-24-170602,170602,0,0,0,27,0.0,1.2592101461459897,4
2020-07-25-170602,170602,0,0,0,27,0.0,1.4253075667465585,5
2020-07-26-170602,170602,0,0,2,27,0.0,1.4452535579987107,6
2020-07-27-170602,170602,0,0,0,27,0.0,1.127052048062755,0
2020-07-28-170602,170602,0,0,1,27,0.0,1.1675425609833805,1
2020-07-29-170602,170602,0,0,1,27,0.5,1.174508426676515,2
2020-07-30-170602,170602,0,0,0,27,0.0,2.04986349317963,3
2020-07-31-170602,170602,0,0,1,27,0.0,2.1594707047242894,4
2020-08-01-170602,170602,0,0,1,27,0.0,0.8972482215371946,5
2020-08-02-170602,170602,0,0,2,27,0.0,36.1163350024536,6
2020-08-03-170602,170602,0,0,2,27,0.0,67.04173037023267,0
2020-08-04-170602,170602,1,0,3,28,0.0,61.605103596486025,1
2020-08-05-170602,170602,0,0,1,28,0.0,50.9590289994337,2
2020-08-06-170602,170602,0,0,1,28,0.5,46.962231657701516,3
2020-08-07-170602,170602,0,0,1,28,1.0,34.50101921511605,4
2020-08-08-170602,170602,0,0,0,28,1.0,22.052708937069813,5
2020-08-09-170602,170602,2,0,1,30,0.5,23.810011922372222,6
2020-08-10-170602,170602,0,0,2,30,0.0,0.9355485248067932,0
2020-08-11-170602,170602,1,0,1,31,0.0,8.20072317241901,1
2020-08-12-170602,170602,1,0,0,32,1.0,10.269755102603312,2
2020-08-13-170602,170602,0,0,1,32,2.0,14.020858875732813,3
2020-08-14-170602,170602,1,0,1,33,1.0,19.60404850058713,4
2020-08-15-170602,170602,1,0,2,34,0.5,23.29850009724505,5
2020-08-16-170602,170602,2,0,0,36,1.5,25.76855518700639,6
2020-08-17-170602,170602,2,0,0,38,2.0,31.21202423128209,0
2020-08-18-170602,170602,3,0,0,41,1.0,33.597694546321534,1
2020-08-19-170602,170602,1,0,0,42,0.0,39.64314155515324,2
2020-08-20-170602,170602,1,0,5,43,0.5,33.63819837334512,3
2020-08-21-170602,170602,1,0,0,44,1.5,34.83876628443758,4
2020-08-22-170602,170602,0,0,2,44,0.5,38.40337450807088,5
2020-08-23-170602,170602,1,0,0,45,1.5,35.10336987944618,6
2020-08-24-170602,170602,2,0,1,47,2.0,27.774046160782838,0
2020-08-25-170602,170602,1,0,0,48,2.5,28.378407182341913,1
2020-08-26-170602,170602,0,0,0,48,1.0,34.03732189034644,2
2020-08-27-170602,170602,1,0,2,49,1.0,45.78067864040831,3
2020-08-28-170602,170602,1,0,0,50,1.0,43.75080387342511,4
2020-08-29-170602,170602,2,1,0,52,6.0,51.913748490242185,5
2020-08-30-170602,170602,0,0,0,52,0.5,62.7060314364104,6
2020-08-31-170602,170602,0,0,0,52,4.5,54.77359790625216,0
2020-09-01-170602,170602,0,0,0,52,7.5,24.0198096601714,1
2020-09-02-170602,170602,0,0,0,52,6.5,22.71374139427018,2
2020-09-03-170602,170602,5,0,0,57,4.5,40.77433463877475,3
2020-09-04-170602,170602,0,0,0,57,0.0,42.6436732578131,4
2020-09-05-170602,170602,2,0,0,59,4.0,35.47876818129871,5
2020-09-06-170602,170602,0,0,0,59,2.5,36.83975954260432,6
2020-09-07-170602,170602,1,0,0,60,5.0,40.29145571123408,0
2020-09-08-170602,170602,0,0,0,60,0.0,51.97062961449247,1
2020-09-09-170602,170602,0,0,1,60,0.5,47.75670643254744,2
2020-09-10-170602,170602,2,0,2,62,0.5,24.43724256878384,3
2020-09-11-170602,170602,0,0,1,62,1.5,27.07216355894866,4
2020-09-12-170602,170602,0,0,0,62,1.5,28.511189133922553,5
2020-09-13-170602,170602,0,0,0,62,0.5,30.7947106116482,6
2020-09-14-170602,170602,0,0,1,62,1.5,29.909199367424854,0
2020-09-15-170602,170602,0,0,0,62,0.0,33.20922980494303,1
2020-09-16-170602,170602,0,0,0,62,0.0,32.30023283192422,2
2020-09-17-170602,170602,0,0,1,62,1.0,18.923158215346945,3
2020-09-18-170602,170602,0,0,0,62,0.5,20.186796267203405,4
2020-09-19-170602,170602,0,1,0,62,0.5,20.987714523558925,5
2020-09-20-170602,170602,0,0,1,62,0.5,32.34277115594284,6
2020-09-21-170602,170602,0,0,0,62,1.0,30.644155148891162,0
2020-09-22-170602,170602,0,1,0,62,0.5,33.17097929390918,1
2020-09-23-170602,170602,1,0,0,63,0.5,38.24486400847968,2
2020-09-24-170602,170602,2,0,1,65,0.0,39.808748800493106,3
2020-09-25-170602,170602,1,0,0,66,0.5,45.4733746426135,4
2020-09-26-170602,170602,0,0,0,66,0.5,50.19125253721932,5
2020-09-27-170602,170602,0,0,1,66,0.5,37.22757477181401,6
2020-09-28-170602,170602,1,0,0,67,0.0,36.160837813552284,0
2020-09-29-170602,170602,0,0,0,67,1.5,35.32098410399614,1
2020-09-30-170602,170602,0,0,0,67,2.5,40.31022740932226,2
2020-10-01-170602,170602,1,0,2,68,2.5,0.0,3
2020-10-02-170602,170602,0,0,1,68,1.5,43.53972650235518,4
2020-10-03-170602,170602,0,0,1,68,0.0,75.4364277806996,5
2020-10-04-170602,170602,1,2,2,69,0.5,59.97365558844237,6
2020-10-05-170602,170602,0,0,3,69,0.5,49.07924413891982,0
2020-10-06-170602,170602,0,0,2,69,0.0,42.42625004115011,1
2020-10-07-170602,170602,0,0,1,69,0.5,34.084635265146815,2
2020-10-08-170602,170602,1,0,3,70,0.0,27.57265190894116,3
2020-10-09-170602,170602,0,0,2,70,1.5,28.21159919134947,4
2020-10-10-170602,170602,0,0,0,70,0.0,9.263153310859868,5
2020-10-11-170602,170602,1,0,2,71,0.0,11.618202878906231,6
2020-10-12-170602,170602,0,0,6,71,0.0,13.243933534272045,0
2020-10-13-170602,170602,0,0,7,71,2.0,14.599212239474419,1
2020-10-14-170602,170602,0,0,6,71,1.0,23.44349639877531,2
2020-10-15-170602,170602,2,0,7,73,1.0,29.571586037824368,3
2020-10-16-170602,170602,1,0,0,74,1.0,35.780576699149854,4
2020-10-17-170602,170602,1,0,3,75,0.5,32.10234235417893,5
2020-10-18-170602,170602,2,1,0,77,1.5,30.256342963236243,6
2020-10-19-170602,170602,3,0,0,80,2.5,33.57429668559809,0
2020-10-20-170602,170602,2,0,1,82,0.5,35.99630606175946,1
2020-10-21-170602,170602,1,0,0,83,0.5,37.82317203631309,2
2020-10-22-170602,170602,3,0,4,86,2.5,37.84085076356784,3
2020-10-23-170602,170602,2,0,2,88,0.5,44.8253932505299,4
2020-10-24-170602,170602,0,0,0,88,1.0,61.89908024465651,5
2020-10-25-170602,170602,2,0,0,90,0.0,58.419077454243045,6
2020-10-26-170602,170602,6,0,1,96,0.5,53.47329977325003,0
2020-10-27-170602,170602,7,0,0,103,0.5,62.93594935492284,1
2020-10-28-170602,170602,6,1,0,109,1.0,64.75668202041513,2
2020-10-29-170602,170602,7,0,0,116,1.0,67.67672587612178,3
2020-10-30-170602,170602,0,0,1,116,1.0,49.86127091279474,4
2020-10-31-170602,170602,3,0,0,119,0.0,54.82022524206157,5
2020-11-01-170602,170602,0,0,0,119,0.0,24.664313481901416,6
2020-11-02-170602,170602,0,0,0,119,0.0,26.518147728958354,0
2020-11-03-170602,170602,1,0,0,120,1.0,25.56167088709914,1
2020-11-04-170602,170602,0,1,0,120,0.5,28.902625295665917,2
2020-11-05-170602,170602,4,0,0,124,1.0,29.729274218850392,3
2020-11-06-170602,170602,2,1,0,126,2.0,35.81417930858113,4
2020-11-07-170602,170602,0,0,0,126,0.0,39.546467518751605,5
2020-11-08-170602,170602,0,1,0,126,0.5,34.22337562854679,6
2020-11-09-170602,170602,1,0,0,127,0.0,32.291811249246805,0
2020-11-10-170602,170602,0,1,0,127,0.0,19.061293785519382,1
2020-11-11-170602,170602,0,0,0,127,0.0,19.54006370580722,2
2020-11-12-170602,170602,0,1,0,127,0.0,21.15786608999725,3
2020-11-13-170602,170602,1,2,0,128,0.0,21.84593283943788,4
2020-03-01-170603,170603,0,0,1,0,0.0,0.0,6
2020-03-02-170603,170603,0,0,6,0,0.25,58.24858399460656,0
2020-03-03-170603,170603,0,0,5,0,0.0,350.06112625519785,1
2020-03-04-170603,170603,0,0,7,0,0.0,423.71423660592325,2
2020-03-05-170603,170603,0,0,8,0,0.0,467.10066222050347,3
2020-03-06-170603,170603,0,0,10,0,0.0,389.34542637082905,4
2020-03-07-170603,170603,0,0,2,0,0.0,410.1226036098919,5
2020-03-08-170603,170603,0,0,4,0,0.0,380.3026417958371,6
2020-03-09-170603,170603,0,0,24,0,0.0,379.7092080638331,0
2020-03-10-170603,170603,0,0,12,0,0.0,636.8489594891353,1
2020-03-11-170603,170603,0,0,10,0,0.0,453.4170507762834,2
2020-03-12-170603,170603,0,0,11,0,0.5,349.9278960281623,3
2020-03-13-170603,170603,2,0,22,2,0.75,226.32370607853647,4
2020-03-14-170603,170603,0,0,7,2,0.25,195.08329683833313,5
2020-03-15-170603,170603,1,0,8,3,0.5,130.4980133720429,6
2020-03-16-170603,170603,6,0,16,9,0.5,68.20396714235727,0
2020-03-17-170603,170603,5,1,13,14,1.75,133.3687853215883,1
2020-03-18-170603,170603,7,0,15,21,2.0,188.8857119225338,2
2020-03-19-170603,170603,8,0,12,29,3.25,256.1846863418223,3
2020-03-20-170603,170603,10,0,12,39,3.0,298.7522744963875,4
2020-03-21-170603,170603,2,0,9,41,0.75,360.71867636090906,5
2020-03-22-170603,170603,4,0,3,45,1.25,336.4969239673918,6
2020-03-23-170603,170603,24,0,19,69,4.25,316.3886745282259,0
2020-03-24-170603,170603,12,0,24,81,2.5,421.57534818098713,1
2020-03-25-170603,170603,10,0,9,91,3.5,441.02976831785566,2
2020-03-26-170603,170603,11,0,23,102,4.5,458.5624167264111,3
2020-03-27-170603,170603,22,0,5,124,3.75,540.114250219744,4
2020-03-28-170603,170603,7,0,3,131,0.25,611.91220732771,5
2020-03-29-170603,170603,8,0,7,139,2.0,641.3258826552545,6
2020-03-30-170603,170603,16,0,12,155,2.75,504.7418298720379,0
2020-03-31-170603,170603,13,0,14,168,3.25,517.7358880504505,1
2020-04-01-170603,170603,15,0,7,183,1.5,91.10468787805448,2
2020-04-02-170603,170603,12,0,6,195,2.25,310.0189916039932,3
2020-04-03-170603,170603,12,0,9,207,1.25,180.02090588916428,4
2020-04-04-170603,170603,9,0,2,216,0.5,218.70497862786794,5
2020-04-05-170603,170603,3,0,0,219,1.25,265.53069344219,6
2020-04-06-170603,170603,19,0,7,238,2.0,289.28734488744533,0
2020-04-07-170603,170603,24,0,5,262,1.25,357.48066451715056,1
2020-04-08-170603,170603,9,0,4,271,1.75,453.0923005840187,2
2020-04-09-170603,170603,23,1,7,294,3.0,490.5844181710314,3
2020-04-10-170603,170603,5,0,6,299,1.25,94.03136610355759,4
2020-04-11-170603,170603,3,1,1,302,0.5,120.23056120544459,5
2020-04-12-170603,170603,7,0,0,309,0.0,135.79851630129022,6
2020-04-13-170603,170603,12,0,7,321,1.75,169.57278690354968,0
2020-04-14-170603,170603,14,0,6,335,1.25,244.19643457594645,1
2020-04-15-170603,170603,7,0,5,342,5.25,323.5076473739863,2
2020-04-16-170603,170603,6,0,6,348,1.25,371.77705810464965,3
2020-04-17-170603,170603,9,0,3,357,3.0,337.9163657289842,4
2020-04-18-170603,170603,2,0,1,359,0.5,372.4274024075265,5
2020-04-19-170603,170603,0,0,0,359,0.5,373.5510240036574,6
2020-04-20-170603,170603,7,0,7,366,1.5,344.4662884567333,0
2020-04-21-170603,170603,5,1,4,371,1.75,321.74022138523,1
2020-04-22-170603,170603,4,0,82,375,0.75,313.625453921444,2
2020-04-23-170603,170603,7,0,25,382,0.0,305.44133641810686,3
2020-04-24-170603,170603,6,0,8,388,0.5,280.3426504032391,4
2020-04-25-170603,170603,1,0,0,389,0.25,300.74336283435133,5
2020-04-26-170603,170603,0,0,0,389,0.25,297.1207448500645,6
2020-04-27-170603,170603,7,1,11,396,1.25,211.8535943082577,0
2020-04-28-170603,170603,6,0,8,402,1.0,196.78245725300167,1
2020-04-29-170603,170603,5,0,10,407,1.5,191.43482511223863,2
2020-04-30-170603,170603,6,0,7,413,0.25,227.80429130262556,3
2020-05-01-170603,170603,3,0,1,416,0.25,563.6780195527624,4
2020-05-02-170603,170603,1,0,0,417,0.25,121.0899226398232,5
2020-05-03-170603,170603,0,0,0,417,0.5,70.09280770986598,6
2020-05-04-170603,170603,7,0,0,424,1.5,69.2861251316138,0
2020-05-05-170603,170603,4,0,1,428,1.25,123.29934872448332,1
2020-05-06-170603,170603,82,0,0,510,1.5,151.22120480950267,2
2020-05-07-170603,170603,25,0,4,535,2.0,658.9915306524041,3
2020-05-08-170603,170603,8,0,2,543,2.0,809.0504324983492,4
2020-05-09-170603,170603,0,0,0,543,0.0,913.7701243178811,5
2020-05-10-170603,170603,0,0,0,543,0.25,647.676175138124,6
2020-05-11-170603,170603,11,2,1,554,0.75,576.3422571030682,0
2020-05-12-170603,170603,8,0,0,562,0.5,619.1012081069618,1
2020-05-13-170603,170603,10,0,0,572,1.0,530.3891085473383,2
2020-05-14-170603,170603,7,1,1,579,1.0,441.04665229063494,3
2020-05-15-170603,170603,1,0,4,580,0.0,419.5173008501707,4
2020-05-16-170603,170603,0,0,1,580,0.0,279.8165365916092,5
2020-05-17-170603,170603,0,0,0,580,0.0,266.1465244175844,6
2020-05-18-170603,170603,0,0,3,580,0.5,268.11609782652306,0
2020-05-19-170603,170603,1,0,2,581,0.75,196.59763484392707,1
2020-05-20-170603,170603,0,0,3,581,0.75,96.7073588055675,2
2020-05-21-170603,170603,4,0,2,585,1.25,52.800741471286244,3
2020-05-22-170603,170603,2,0,1,587,1.0,79.38593194016664,4
2020-05-23-170603,170603,0,0,0,587,0.75,102.89555193404043,5
2020-05-24-170603,170603,0,0,0,587,0.0,105.99618033284425,6
2020-05-25-170603,170603,1,0,1,588,0.25,106.63253447923256,0
2020-05-26-170603,170603,0,0,3,588,1.25,106.84538761758637,1
2020-05-27-170603,170603,0,0,0,588,1.0,97.93225347248917,2
2020-05-28-170603,170603,1,0,3,589,0.75,101.17168665633987,3
2020-05-29-170603,170603,4,0,0,593,1.0,80.82894211851209,4
2020-05-30-170603,170603,1,0,0,594,0.0,108.34292886998294,5
2020-05-31-170603,170603,0,0,0,594,0.0,117.05137570947309,6
2020-06-01-170603,170603,3,0,0,597,1.0,1216.435893920344,0
2020-06-02-170603,170603,2,0,0,599,0.0,50.363908726285054,1
2020-06-03-170603,170603,3,0,3,602,0.75,35.56090549533037,2
2020-06-04-170603,170603,2,0,0,604,0.75,61.02415773294541,3
2020-06-05-170603,170603,1,0,0,605,0.75,88.04153086334213,4
2020-06-06-170603,170603,0,0,0,605,0.25,106.15807390564879,5
2020-06-07-170603,170603,0,0,0,605,0.0,90.19058928315971,6
2020-06-08-170603,170603,1,0,1,606,0.5,89.96736952862045,0
2020-06-09-170603,170603,3,0,0,609,0.5,99.50141392644413,1
2020-06-10-170603,170603,0,0,0,609,0.25,1276.048196970182,2
2020-06-11-170603,170603,3,0,0,612,0.75,1215.6358107825313,3
2020-06-12-170603,170603,0,0,0,612,0.25,1211.3230088575172,4
2020-06-13-170603,170603,0,0,2,612,0.25,443.2545019551394,5
2020-06-14-170603,170603,0,0,0,612,0.25,194.73882624329525,6
2020-06-15-170603,170603,0,0,0,612,0.0,96.48848803121334,0
2020-06-16-170603,170603,0,0,0,612,0.25,97.78695676954212,1
2020-06-17-170603,170603,3,0,0,615,0.5,64.98320243344841,2
2020-06-18-170603,170603,0,1,1,615,0.75,80.80433711981767,3
2020-06-19-170603,170603,0,0,1,615,0.75,45.80508199073958,4
2020-06-20-170603,170603,0,0,0,615,0.0,75.74672417382429,5
2020-06-21-170603,170603,0,0,0,615,0.0,74.994564735471,6
2020-06-22-170603,170603,1,0,1,616,1.0,71.88297441472852,0
2020-06-23-170603,170603,0,0,0,616,0.0,94.44961339441454,1
2020-06-24-170603,170603,0,0,0,616,0.5,76.12413972588644,2
2020-06-25-170603,170603,0,0,0,616,0.0,79.62832168433557,3
2020-06-26-170603,170603,0,1,0,616,0.25,68.9788878168113,4
2020-06-27-170603,170603,2,0,0,618,0.0,47.8132392351075,5
2020-06-28-170603,170603,0,0,0,618,0.0,68.60045330621365,6
2020-06-29-170603,170603,0,0,0,618,0.0,69.21148052332734,0
2020-06-30-170603,170603,0,0,0,618,0.25,82.08792561206809,1
2020-07-01-170603,170603,0,0,0,618,0.25,118.6799211847422,2
2020-07-02-170603,170603,1,0,1,619,0.25,51.66511626532102,3
2020-07-03-170603,170603,1,0,3,620,0.0,105.59330267430599,4
2020-07-04-170603,170603,0,0,0,620,0.25,85.02939309835907,5
2020-07-05-170603,170603,0,0,0,620,0.0,73.63059476920041,6
2020-07-06-170603,170603,1,0,0,621,0.75,72.59660691832529,0
2020-07-07-170603,170603,0,0,0,621,0.0,60.91721482825931,1
2020-07-08-170603,170603,0,0,1,621,0.0,49.838385920803546,2
2020-07-09-170603,170603,0,0,0,621,0.0,39.29624034899697,3
2020-07-10-170603,170603,0,0,2,621,0.0,117.36450239391903,4
2020-07-11-170603,170603,0,0,0,621,0.25,83.73658672451074,5
2020-07-12-170603,170603,0,0,1,621,0.25,61.12875909743348,6
2020-07-13-170603,170603,0,0,0,621,0.75,64.4809795652817,0
2020-07-14-170603,170603,0,0,3,621,0.75,70.00361347670534,1
2020-07-15-170603,170603,0,0,1,621,0.25,69.66084262925446,2
2020-07-16-170603,170603,1,0,2,622,0.0,29.29168184551593,3
2020-07-17-170603,170603,3,0,1,625,0.0,39.698597019802854,4
2020-07-18-170603,170603,0,0,2,625,0.0,61.53611626063895,5
2020-07-19-170603,170603,0,0,1,625,0.0,59.857453381168554,6
2020-07-20-170603,170603,0,0,3,625,0.25,61.91507274133172,0
2020-07-21-170603,170603,0,0,1,625,0.25,53.6697174393676,1
2020-07-22-170603,170603,1,0,0,626,0.5,60.83745200777841,2
2020-07-23-170603,170603,0,0,3,626,1.0,65.96568092441716,3
2020-07-24-170603,170603,2,0,4,628,0.0,77.00889393445242,4
2020-07-25-170603,170603,0,0,0,628,0.0,88.20462698875562,5
2020-07-26-170603,170603,1,0,0,629,0.0,88.88243760702986,6
2020-07-27-170603,170603,0,0,5,629,0.0,87.68335718692502,0
2020-07-28-170603,170603,3,1,1,632,1.5,83.10119393163353,1
2020-07-29-170603,170603,1,0,0,633,1.25,115.49486230436209,2
2020-07-30-170603,170603,2,0,6,635,0.5,90.82463439577491,3
2020-07-31-170603,170603,1,0,1,636,0.0,85.63958801052908,4
2020-08-01-170603,170603,2,0,1,638,0.0,36.4993169462725,5
2020-08-02-170603,170603,1,0,0,639,0.75,431.46379190821676,6
2020-08-03-170603,170603,3,1,6,642,0.25,261.0780100821183,0
2020-08-04-170603,170603,1,0,3,643,0.25,293.556693714168,1
2020-08-05-170603,170603,0,0,1,643,0.25,300.29760708797966,2
2020-08-06-170603,170603,3,0,8,646,4.5,259.7789193227454,3
2020-08-07-170603,170603,4,0,14,650,0.25,303.92328370471114,4
2020-08-08-170603,170603,0,1,0,650,0.25,303.94042514965065,5
2020-08-09-170603,170603,0,0,0,650,0.0,281.65928758344523,6
2020-08-10-170603,170603,5,0,0,655,1.5,65.72063234464161,0
2020-08-11-170603,170603,1,0,3,656,1.25,142.61504761214053,1
2020-08-12-170603,170603,0,0,0,656,1.5,173.32064521240693,2
2020-08-13-170603,170603,6,1,1,662,2.0,160.1954072037188,3
2020-08-14-170603,170603,1,1,0,663,1.0,251.81403814703233,4
2020-08-15-170603,170603,1,0,3,664,2.0,283.44897598042684,5
2020-08-16-170603,170603,0,0,1,664,0.75,311.0648553971336,6
2020-08-17-170603,170603,6,0,4,670,1.75,292.8395051313071,0
2020-08-18-170603,170603,3,0,2,673,1.0,307.65929531852373,1
2020-08-19-170603,170603,1,0,3,674,2.75,356.1359772058828,2
2020-08-20-170603,170603,8,0,1,682,3.0,379.70750061599995,3
2020-08-21-170603,170603,14,1,4,696,2.5,503.5452680427853,4
2020-08-22-170603,170603,0,0,1,696,0.75,630.9733745058518,5
2020-08-23-170603,170603,0,0,0,696,0.5,630.5018278984365,6
2020-08-24-170603,170603,0,0,0,696,1.75,544.2344530003115,0
2020-08-25-170603,170603,3,0,1,699,3.0,493.93054758281215,1
2020-08-26-170603,170603,0,0,9,699,1.0,439.9222508903405,2
2020-08-27-170603,170603,1,0,1,700,3.0,433.52392772999616,3
2020-08-28-170603,170603,0,0,3,700,2.0,334.19152786502997,4
2020-08-29-170603,170603,3,0,6,703,1.75,216.2466322159729,5
2020-08-30-170603,170603,1,0,0,704,0.75,288.90724079299775,6
2020-08-31-170603,170603,4,0,10,708,1.0,280.91218940421237,0
2020-09-01-170603,170603,2,0,5,710,1.25,239.22909660144842,1
2020-09-02-170603,170603,3,0,8,713,1.75,771.7583007748431,2
2020-09-03-170603,170603,1,0,12,714,2.75,913.2899888655634,3
2020-09-04-170603,170603,4,0,11,718,5.75,746.7462230728675,4
2020-09-05-170603,170603,1,0,5,719,0.25,661.5562403068941,5
2020-09-06-170603,170603,0,0,5,719,1.75,499.6620595617094,6
2020-09-07-170603,170603,0,0,4,719,2.5,500.4006774163995,0
2020-09-08-170603,170603,1,1,12,720,1.25,420.49908473984453,1
2020-09-09-170603,170603,9,0,4,729,1.0,340.28276522181443,2
2020-09-10-170603,170603,1,0,15,730,2.0,206.45958778942384,3
2020-09-11-170603,170603,3,0,8,733,1.5,225.9917415286178,4
2020-09-12-170603,170603,6,0,3,739,1.25,263.60371842338265,5
2020-09-13-170603,170603,0,0,1,739,1.0,261.4660070601401,6
2020-09-14-170603,170603,10,0,8,749,5.0,231.85653916617838,0
2020-09-15-170603,170603,5,0,3,754,1.25,352.3544649929328,1
2020-09-16-170603,170603,8,1,9,762,1.75,424.6964875148242,2
2020-09-17-170603,170603,12,0,12,774,3.5,467.90138812302126,3
2020-09-18-170603,170603,11,0,7,785,8.75,565.4586078503972,4
2020-09-19-170603,170603,5,0,2,790,2.5,672.7378159592747,5
2020-09-20-170603,170603,5,1,3,795,1.5,726.8321171818934,6
2020-09-21-170603,170603,4,0,3,799,7.75,643.022066656568,0
2020-09-22-170603,170603,12,0,2,811,7.75,716.169244908365,1
2020-09-23-170603,170603,4,0,17,815,5.25,789.4750062322468,2
2020-09-24-170603,170603,15,0,12,830,9.0,717.9197245846196,3
2020-09-25-170603,170603,8,1,11,838,13.5,770.3023685230244,4
2020-09-26-170603,170603,3,0,0,841,7.0,825.3793047347697,5
2020-09-27-170603,170603,1,0,4,842,0.5,933.0422613879574,6
2020-09-28-170603,170603,8,1,2,850,5.5,912.326172318702,0
2020-09-29-170603,170603,3,0,3,853,5.0,891.4712090009941,1
2020-09-30-170603,170603,9,0,2,862,5.0,786.6003316924752,2
2020-10-01-170603,170603,12,0,9,874,3.5,0.0,3
2020-10-02-170603,170603,7,1,2,881,5.25,641.0635119786833,4
2020-10-03-170603,170603,2,0,2,883,1.0,937.8463547740905,5
2020-10-04-170603,170603,3,0,4,886,4.25,838.2448430075749,6
2020-10-05-170603,170603,3,0,12,889,5.75,788.2602077698064,0
2020-10-06-170603,170603,2,2,4,891,3.75,666.8379196277883,1
2020-10-07-170603,170603,17,0,8,908,0.75,585.8897610364345,2
2020-10-08-170603,170603,12,0,2,920,3.25,658.2744502738981,3
2020-10-09-170603,170603,11,2,10,931,5.25,751.8981909636354,4
2020-10-10-170603,170603,0,0,5,931,2.75,177.91891741609976,5
2020-10-11-170603,170603,4,0,5,935,3.75,208.03690252780225,6
2020-10-12-170603,170603,2,0,5,937,2.0,295.9590583007673,0
2020-10-13-170603,170603,3,0,16,940,5.0,332.685506316573,1
2020-10-14-170603,170603,2,0,8,942,2.5,411.1748106672504,2
2020-10-15-170603,170603,9,0,5,951,3.5,464.9849674740233,3
2020-10-16-170603,170603,2,0,16,953,10.0,567.9182217902339,4
2020-10-17-170603,170603,2,0,3,955,1.25,491.2051657751623,5
2020-10-18-170603,170603,4,0,4,959,2.25,504.53722421400374,6
2020-10-19-170603,170603,12,1,11,971,4.5,470.9716467280574,0
2020-10-20-170603,170603,4,1,6,975,5.5,635.9881128245117,1
2020-10-21-170603,170603,8,0,13,983,3.25,684.3538854656717,2
2020-10-22-170603,170603,2,0,8,985,7.75,698.3983514730583,3
2020-10-23-170603,170603,10,0,8,995,6.0,702.9443859742639,4
2020-10-24-170603,170603,5,1,3,1000,2.75,792.7445196451745,5
2020-10-25-170603,170603,5,0,4,1005,2.25,805.2873686143064,6
2020-10-26-170603,170603,5,1,5,1010,3.75,701.128376207351,0
2020-10-27-170603,170603,16,1,6,1026,3.75,733.6286930269825,1
2020-10-28-170603,170603,8,0,19,1034,6.25,843.0169402013612,2
2020-10-29-170603,170603,5,1,13,1039,4.0,870.7555330183693,3
2020-10-30-170603,170603,16,0,28,1055,5.75,798.9598984366639,4
2020-10-31-170603,170603,3,1,0,1058,1.25,889.3744448297107,5
2020-11-01-170603,170603,4,0,0,1062,1.75,725.1066312700632,6
2020-11-02-170603,170603,11,0,0,1073,3.0,768.2036023799641,0
2020-11-03-170603,170603,6,0,0,1079,4.5,640.5275886876358,1
2020-11-04-170603,170603,13,0,0,1092,5.0,700.8819448299362,2
2020-11-05-170603,170603,8,0,0,1100,2.25,786.5782704228527,3
2020-11-06-170603,170603,8,3,0,1108,4.0,818.4569921078489,4
2020-11-07-170603,170603,3,1,0,1111,2.0,887.0827688877971,5
2020-11-08-170603,170603,4,0,0,1115,0.5,774.6628116323777,6
2020-11-09-170603,170603,5,0,0,1120,1.25,688.3245584586047,0
2020-11-10-170603,170603,6,1,0,1126,3.0,703.584767846992,1
2020-11-11-170603,170603,19,1,0,1145,3.75,724.9966615183811,2
2020-11-12-170603,170603,13,0,0,1158,4.5,848.5395192817941,3
2020-11-13-170603,170603,28,1,0,1186,2.75,964.0247841109294,4
2020-03-01-170604,170604,0,0,1,0,0.0,0.0,6
2020-03-02-170604,170604,0,0,1,0,0.0,25.134112851125025,0
2020-03-03-170604,170604,0,0,0,0,0.0,122.91212666513513,1
2020-03-04-170604,170604,0,1,1,0,0.0,132.51520760505446,2
2020-03-05-170604,170604,0,0,1,0,0.0,138.78083103728295,3
2020-03-06-170604,170604,0,0,3,0,0.0,119.15696294294882,4
2020-03-07-170604,170604,0,0,1,0,0.0,130.39278891925696,5
2020-03-08-170604,170604,0,0,1,0,0.16666666666666666,125.85792145268589,6
2020-03-09-170604,170604,0,0,3,0,0.0,125.8285699976535,0
2020-03-10-170604,170604,0,0,3,0,0.0,179.32949950575022,1
2020-03-11-170604,170604,1,0,5,1,0.3333333333333333,141.16383642113107,2
2020-03-12-170604,170604,0,0,4,1,0.0,105.0906351793126,3
2020-03-13-170604,170604,0,0,2,1,0.8333333333333334,71.74629495352596,4
2020-03-14-170604,170604,0,0,0,1,0.5,68.70780635609512,5
2020-03-15-170604,170604,1,0,2,2,2.333333333333333,60.82938757214701,6
2020-03-16-170604,170604,1,0,2,3,3.0,45.05536551265584,0
2020-03-17-170604,170604,0,0,2,3,4.333333333333333,76.58509300052273,1
2020-03-18-170604,170604,1,0,1,4,3.6666666666666665,112.82235667834604,2
2020-03-19-170604,170604,1,0,0,5,6.5,135.86353929349667,3
2020-03-20-170604,170604,3,2,1,8,5.666666666666668,160.63823019832986,4
2020-03-21-170604,170604,1,3,0,9,2.1666666666666665,194.09260609426522,5
2020-03-22-170604,170604,1,0,0,10,3.5,182.09355228722532,6
2020-03-23-170604,170604,3,0,0,13,11.333333333333336,173.0239459885404,0
2020-03-24-170604,170604,3,0,0,16,7.333333333333332,218.37625220307234,1
2020-03-25-170604,170604,5,0,2,21,9.0,246.88600249537694,2
2020-03-26-170604,170604,4,0,1,25,6.333333333333332,282.31691370365274,3
2020-03-27-170604,170604,2,0,0,27,8.5,338.4628051497154,4
2020-03-28-170604,170604,0,0,1,27,1.1666666666666667,354.5432581445207,5
2020-03-29-170604,170604,2,0,0,29,2.1666666666666665,351.6690108466586,6
2020-03-30-170604,170604,2,0,0,31,5.666666666666668,271.9311244522611,0
2020-03-31-170604,170604,2,0,0,33,5.833333333333332,274.0208372079678,1
2020-04-01-170604,170604,1,0,0,34,7.333333333333332,41.36206858441174,2
2020-04-02-170604,170604,0,1,1,34,2.6666666666666665,139.83175124654474,3
2020-04-03-170604,170604,1,0,0,35,4.5,74.96852483119919,4
2020-04-04-170604,170604,0,0,0,35,1.0,95.78177392377214,5
2020-04-05-170604,170604,0,0,0,35,1.0,95.57498436450979,6
2020-04-06-170604,170604,0,1,0,35,8.0,99.79448130038826,0
2020-04-07-170604,170604,0,0,0,35,8.666666666666666,138.72902595466982,1
2020-04-08-170604,170604,2,0,0,37,3.8333333333333335,164.25026675437292,2
2020-04-09-170604,170604,1,0,0,38,1.1666666666666667,172.97463919357327,3
2020-04-10-170604,170604,0,1,0,38,3.6666666666666665,38.30838699411559,4
2020-04-11-170604,170604,1,0,0,39,1.8333333333333333,62.70140759357993,5
2020-04-12-170604,170604,0,0,0,39,3.5,72.60405654004997,6
2020-04-13-170604,170604,0,0,1,39,3.8333333333333335,84.00786915940742,0
2020-04-14-170604,170604,0,0,0,39,8.166666666666666,111.97238554081603,1
2020-04-15-170604,170604,0,0,0,39,3.6666666666666665,145.45647541320204,2
2020-04-16-170604,170604,1,0,0,40,3.333333333333333,165.6863090270582,3
2020-04-17-170604,170604,0,0,0,40,4.833333333333333,147.8208805779289,4
2020-04-18-170604,170604,0,0,0,40,1.8333333333333333,144.82710318142438,5
2020-04-19-170604,170604,0,0,0,40,0.5,144.38363303267184,6
2020-04-20-170604,170604,0,0,0,40,3.1666666666666665,129.09468365762615,0
2020-04-21-170604,170604,0,0,0,40,7.833333333333332,111.60683830099396,1
2020-04-22-170604,170604,0,1,0,40,5.5,134.6941083897931,2
2020-04-23-170604,170604,0,0,1,40,1.0,141.7119949341062,3
2020-04-24-170604,170604,0,0,2,40,3.1666666666666665,125.89045333252221,4
2020-04-25-170604,170604,0,0,1,40,1.1666666666666667,131.91013011328354,5
2020-04-26-170604,170604,0,0,0,40,0.16666666666666666,137.8822018709054,6
2020-04-27-170604,170604,1,1,0,41,2.5,116.24352943061221,0
2020-04-28-170604,170604,0,0,0,41,1.8333333333333333,115.75534630077917,1
2020-04-29-170604,170604,0,0,0,41,2.833333333333333,81.10545147120669,2
2020-04-30-170604,170604,0,0,0,41,2.6666666666666665,99.85755401349273,3
2020-05-01-170604,170604,0,0,0,41,2.0,160.75847199559553,4
2020-05-02-170604,170604,0,0,0,41,0.5,46.784688249918005,5
2020-05-03-170604,170604,0,0,0,41,0.8333333333333334,30.487428001797888,6
2020-05-04-170604,170604,0,0,0,41,3.8333333333333335,20.811942851941183,0
2020-05-05-170604,170604,0,0,0,41,3.6666666666666665,35.46828249134853,1
2020-05-06-170604,170604,0,0,0,41,1.1666666666666667,42.51227133405333,2
2020-05-07-170604,170604,1,0,0,42,3.333333333333333,48.400612866479406,3
2020-05-08-170604,170604,2,0,0,44,4.0,81.51147094232023,4
2020-05-09-170604,170604,1,0,0,45,1.0,105.5103942582911,5
2020-05-10-170604,170604,0,0,0,45,0.3333333333333333,176.4233089915722,6
2020-05-11-170604,170604,0,1,0,45,2.5,169.84781559281276,0
2020-05-12-170604,170604,0,6,0,45,5.0,176.3935634366531,1
2020-05-13-170604,170604,0,0,0,45,3.8333333333333335,137.36625243713866,2
2020-05-14-170604,170604,0,0,0,45,0.6666666666666666,110.38019962774524,3
2020-05-15-170604,170604,0,1,0,45,2.833333333333333,89.17595532131233,4
2020-05-16-170604,170604,0,1,0,45,0.16666666666666666,85.45595522024709,5
2020-05-17-170604,170604,0,0,0,45,0.0,75.51566369507188,6
2020-05-18-170604,170604,0,0,0,45,0.8333333333333334,72.84759485712353,0
2020-05-19-170604,170604,0,0,0,45,1.6666666666666667,65.9404656659742,1
2020-05-20-170604,170604,0,0,2,45,0.6666666666666666,40.32777966990143,2
2020-05-21-170604,170604,0,0,0,45,1.3333333333333333,43.376454959792746,3
2020-05-22-170604,170604,0,0,1,45,1.1666666666666667,38.800694617531704,4
2020-05-23-170604,170604,0,0,0,45,0.16666666666666666,47.117854704254654,5
2020-05-24-170604,170604,0,0,0,45,0.0,49.940553985383985,6
2020-05-25-170604,170604,0,0,0,45,2.1666666666666665,42.17932318001995,0
2020-05-26-170604,170604,0,0,0,45,0.6666666666666666,47.13244036217195,1
2020-05-27-170604,170604,0,0,0,45,0.3333333333333333,48.63735002636702,2
2020-05-28-170604,170604,0,2,0,45,0.8333333333333334,43.541635778234095,3
2020-05-29-170604,170604,0,0,1,45,0.8333333333333334,41.33174077244276,4
2020-05-30-170604,170604,0,0,0,45,0.0,39.23702367282772,5
2020-05-31-170604,170604,0,0,0,45,0.0,41.22187203496036,6
2020-06-01-170604,170604,0,0,0,45,1.0,126.45450829691309,0
2020-06-02-170604,170604,0,0,0,45,0.5,20.430561640996988,1
2020-06-03-170604,170604,2,0,0,47,0.5,19.34007798330378,2
2020-06-04-170604,170604,0,0,0,47,0.6666666666666666,25.51887732427573,3
2020-06-05-170604,170604,1,0,0,48,0.3333333333333333,33.40834018551619,4
2020-06-06-170604,170604,0,0,0,48,0.0,38.62740217726582,5
2020-06-07-170604,170604,0,0,0,48,0.0,38.454813219695644,6
2020-06-08-170604,170604,0,0,0,48,0.5,36.775729969536734,0
2020-06-09-170604,170604,0,0,0,48,0.3333333333333333,37.86680120738231,1
2020-06-10-170604,170604,0,0,0,48,0.3333333333333333,132.25158992637233,2
2020-06-11-170604,170604,0,0,0,48,1.1666666666666667,112.7845977132001,3
2020-06-12-170604,170604,1,0,0,49,0.5,106.48339161262501,4
2020-06-13-170604,170604,0,0,0,49,0.0,95.49824012011194,5
2020-06-14-170604,170604,0,0,0,49,0.0,56.13874387025977,6
2020-06-15-170604,170604,0,0,0,49,0.0,31.22539974417845,0
2020-06-16-170604,170604,0,1,0,49,0.5,26.42061512512393,1
2020-06-17-170604,170604,0,0,0,49,0.16666666666666666,21.866944376171567,2
2020-06-18-170604,170604,0,0,0,49,0.3333333333333333,22.141678296739368,3
2020-06-19-170604,170604,0,0,0,49,0.6666666666666666,20.751580864570286,4
2020-06-20-170604,170604,0,0,0,49,0.16666666666666666,27.91924115230566,5
2020-06-21-170604,170604,0,0,0,49,0.0,28.252205381193697,6
2020-06-22-170604,170604,0,0,0,49,0.3333333333333333,26.45061471891591,0
2020-06-23-170604,170604,0,0,0,49,0.3333333333333333,27.01746531058098,1
2020-06-24-170604,170604,0,0,0,49,0.3333333333333333,27.913559810793686,2
2020-06-25-170604,170604,0,0,0,49,0.3333333333333333,26.800357996881072,3
2020-06-26-170604,170604,0,0,0,49,0.8333333333333334,21.768661686031486,4
2020-06-27-170604,170604,0,0,0,49,0.16666666666666666,19.481166475491776,5
2020-06-28-170604,170604,0,0,0,49,0.16666666666666666,20.0403063688899,6
2020-06-29-170604,170604,0,0,0,49,0.3333333333333333,22.146888165256176,0
2020-06-30-170604,170604,0,0,0,49,0.16666666666666666,27.50021912698408,1
2020-07-01-170604,170604,0,0,0,49,0.16666666666666666,36.133718118795144,2
2020-07-02-170604,170604,0,0,0,49,0.16666666666666666,9.150418935947513,3
2020-07-03-170604,170604,0,1,0,49,0.5,12.576271662682046,4
2020-07-04-170604,170604,0,0,0,49,0.16666666666666666,25.016581808218202,5
2020-07-05-170604,170604,0,0,0,49,0.16666666666666666,25.09674803758581,6
2020-07-06-170604,170604,0,0,0,49,0.0,23.63564931017413,0
2020-07-07-170604,170604,0,0,0,49,0.0,22.096929824986535,1
2020-07-08-170604,170604,0,0,0,49,0.0,20.815382077262143,2
2020-07-09-170604,170604,0,0,0,49,0.0,18.428291420768254,3
2020-07-10-170604,170604,0,0,0,49,0.3333333333333333,35.135080373158495,4
2020-07-11-170604,170604,0,0,0,49,0.0,26.406225708726204,5
2020-07-12-170604,170604,0,0,0,49,0.0,15.307757763740913,6
2020-07-13-170604,170604,0,0,0,49,0.5,15.74326376577302,0
2020-07-14-170604,170604,0,0,0,49,0.5,18.115374480572832,1
2020-07-15-170604,170604,0,0,0,49,0.0,15.482163990435613,2
2020-07-16-170604,170604,0,0,0,49,0.16666666666666666,10.979512446337731,3
2020-07-17-170604,170604,0,0,0,49,0.16666666666666666,10.341379710099469,4
2020-07-18-170604,170604,0,0,0,49,0.16666666666666666,10.12162335103224,5
2020-07-19-170604,170604,0,0,0,49,0.0,10.271289627747402,6
2020-07-20-170604,170604,0,0,0,49,0.3333333333333333,7.46262742411438,0
2020-07-21-170604,170604,0,0,0,49,0.0,7.571649349304003,1
2020-07-22-170604,170604,0,0,0,49,0.8333333333333334,11.106809275931392,2
2020-07-23-170604,170604,0,0,0,49,0.0,11.357999326155532,3
2020-07-24-170604,170604,0,0,0,49,0.0,12.348403929816415,4
2020-07-25-170604,170604,0,0,0,49,0.0,14.122820374589073,5
2020-07-26-170604,170604,0,0,0,49,0.0,14.129563339543312,6
2020-07-27-170604,170604,0,0,0,49,0.3333333333333333,13.698414184010966,0
2020-07-28-170604,170604,0,0,2,49,0.16666666666666666,14.82941975864884,1
2020-07-29-170604,170604,0,0,0,49,0.16666666666666666,13.016438063463356,2
2020-07-30-170604,170604,0,0,0,49,0.3333333333333333,14.479554334009055,3
2020-07-31-170604,170604,0,0,0,49,0.16666666666666666,22.47596896500507,4
2020-08-01-170604,170604,0,0,0,49,0.3333333333333333,11.193213154214064,5
2020-08-02-170604,170604,0,0,1,49,0.3333333333333333,90.04868938313241,6
2020-08-03-170604,170604,0,0,1,49,1.5,164.63651895720966,0
2020-08-04-170604,170604,0,0,1,49,0.3333333333333333,160.95419311344895,1
2020-08-05-170604,170604,0,0,0,49,1.0,136.41078227504767,2
2020-08-06-170604,170604,0,0,3,49,0.8333333333333334,126.418304235037,3
2020-08-07-170604,170604,0,1,0,49,1.0,103.22003625256355,4
2020-08-08-170604,170604,0,0,0,49,0.5,111.84594276690069,5
2020-08-09-170604,170604,0,0,0,49,0.0,104.599716194859,6
2020-08-10-170604,170604,0,0,0,49,2.333333333333333,10.356997248853501,0
2020-08-11-170604,170604,2,0,1,51,0.5,31.66814675696317,1
2020-08-12-170604,170604,0,0,2,51,0.6666666666666666,47.362365448673515,2
2020-08-13-170604,170604,0,0,0,51,1.0,56.911294651729236,3
2020-08-14-170604,170604,0,0,0,51,0.5,69.644361201469,4
2020-08-15-170604,170604,0,0,1,51,0.3333333333333333,80.02895660653226,5
2020-08-16-170604,170604,1,0,0,52,0.5,82.00072914368843,6
2020-08-17-170604,170604,1,0,1,53,0.8333333333333334,87.27752768022849,0
2020-08-18-170604,170604,1,0,1,54,1.6666666666666667,83.67174425295235,1
2020-08-19-170604,170604,0,0,1,54,0.8333333333333334,83.15105312910168,2
2020-08-20-170604,170604,3,0,0,57,1.6666666666666667,76.85509859023082,3
2020-08-21-170604,170604,0,0,2,57,1.0,88.95732164143259,4
2020-08-22-170604,170604,0,0,1,57,0.5,98.24109986903053,5
2020-08-23-170604,170604,0,0,0,57,2.6666666666666665,94.39847971264658,6
2020-08-24-170604,170604,0,0,1,57,3.0,86.98398604248558,0
2020-08-25-170604,170604,1,0,0,58,1.5,100.23993677089786,1
2020-08-26-170604,170604,2,0,0,60,2.5,108.13139923540297,2
2020-08-27-170604,170604,0,0,0,60,1.3333333333333333,134.37122223410626,3
2020-08-28-170604,170604,0,0,1,60,2.1666666666666665,133.11624498152236,4
2020-08-29-170604,170604,1,0,0,61,0.3333333333333333,153.52567086130256,5
2020-08-30-170604,170604,0,0,0,61,0.5,164.21366023102445,6
2020-08-31-170604,170604,1,0,2,62,1.6666666666666667,138.7517753978631,0
2020-09-01-170604,170604,1,0,0,63,0.8333333333333334,95.7891320417609,1
2020-09-02-170604,170604,1,0,0,64,0.8333333333333334,164.80592074161086,2
2020-09-03-170604,170604,0,0,0,64,2.0,172.5554129798039,3
2020-09-04-170604,170604,2,0,1,66,4.333333333333333,161.10546680894325,4
2020-09-05-170604,170604,1,0,0,67,0.3333333333333333,161.5185899695927,5
2020-09-06-170604,170604,0,0,0,67,0.0,156.7573146187157,6
2020-09-07-170604,170604,1,0,0,68,3.0,155.50413251037827,0
2020-09-08-170604,170604,0,0,1,68,1.6666666666666667,157.94197302934154,1
2020-09-09-170604,170604,0,0,0,68,1.0,141.54522246527875,2
2020-09-10-170604,170604,0,0,0,68,1.1666666666666667,76.07712206500491,3
2020-09-11-170604,170604,1,0,1,69,2.1666666666666665,89.59975180241139,4
2020-09-12-170604,170604,0,0,0,69,1.3333333333333333,118.02329835246152,5
2020-09-13-170604,170604,0,0,0,69,1.6666666666666667,117.38279039114036,6
2020-09-14-170604,170604,2,0,0,71,3.0,107.87018811608888,0
2020-09-15-170604,170604,0,0,1,71,1.6666666666666667,137.98679817190785,1
2020-09-16-170604,170604,0,0,2,71,0.6666666666666666,160.6313128152321,2
2020-09-17-170604,170604,0,0,0,71,2.1666666666666665,163.58762736963715,3
2020-09-18-170604,170604,1,0,1,72,4.0,160.0932984930203,4
2020-09-19-170604,170604,0,0,4,72,2.6666666666666665,154.4822660276081,5
2020-09-20-170604,170604,0,0,0,72,2.0,161.17403839488622,6
2020-09-21-170604,170604,0,0,1,72,7.166666666666668,142.20419885437394,0
2020-09-22-170604,170604,1,0,0,73,5.0,148.8694080104327,1
2020-09-23-170604,170604,0,0,2,73,5.333333333333333,158.58005288013837,2
2020-09-24-170604,170604,0,0,0,73,4.833333333333333,172.0212760841771,3
2020-09-25-170604,170604,1,1,1,74,5.166666666666667,168.0562847834554,4
2020-09-26-170604,170604,0,0,1,74,2.1666666666666665,183.9726522306788,5
2020-09-27-170604,170604,0,0,0,74,1.1666666666666667,179.59699696531027,6
2020-09-28-170604,170604,0,0,0,74,3.6666666666666665,172.97451345152757,0
2020-09-29-170604,170604,1,0,0,75,2.1666666666666665,166.6014045514766,1
2020-09-30-170604,170604,2,0,0,77,2.833333333333333,147.8689494159324,2
2020-10-01-170604,170604,0,1,1,77,2.6666666666666665,0.0,3
2020-10-02-170604,170604,1,0,5,78,3.0,261.63874409294436,4
2020-10-03-170604,170604,4,0,2,82,2.833333333333333,310.0697428200318,5
2020-10-04-170604,170604,0,0,0,82,1.3333333333333333,294.3084523026947,6
2020-10-05-170604,170604,1,0,1,83,11.333333333333336,247.70827297841126,0
2020-10-06-170604,170604,0,0,9,83,3.333333333333333,249.12995188412253,1
2020-10-07-170604,170604,2,1,5,85,4.166666666666667,225.74622071803287,2
2020-10-08-170604,170604,0,0,2,85,4.166666666666667,233.85267214523415,3
2020-10-09-170604,170604,1,0,2,86,3.1666666666666665,242.0594569754321,4
2020-10-10-170604,170604,1,0,1,87,1.6666666666666667,17.81117075313699,5
2020-10-11-170604,170604,0,0,1,87,1.3333333333333333,33.87853592679744,6
2020-10-12-170604,170604,0,0,3,87,1.0,48.81548507566663,0
2020-10-13-170604,170604,0,0,1,87,2.5,63.68972722214127,1
2020-10-14-170604,170604,0,0,0,87,2.6666666666666665,100.68323179385312,2
2020-10-15-170604,170604,1,0,0,88,3.5,126.11129618627368,3
2020-10-16-170604,170604,5,0,5,93,4.666666666666667,164.80878289984017,4
2020-10-17-170604,170604,2,0,2,95,1.3333333333333333,210.80066245724782,5
2020-10-18-170604,170604,0,0,2,95,1.6666666666666667,207.90530482917697,6
2020-10-19-170604,170604,1,0,1,96,4.166666666666667,209.61364177533187,0
2020-10-20-170604,170604,9,0,2,105,4.333333333333333,222.04029999689234,1
2020-10-21-170604,170604,5,0,1,110,10.166666666666666,249.3112313234096,2
2020-10-22-170604,170604,2,0,1,112,10.0,276.7557969378253,3
2020-10-23-170604,170604,2,0,0,114,7.0,269.4232328741115,4
2020-10-24-170604,170604,1,0,0,115,2.0,295.33289918912374,5
2020-10-25-170604,170604,1,0,0,116,3.0,287.6647517216599,6
2020-10-26-170604,170604,3,0,0,119,4.0,274.15946437260595,0
2020-10-27-170604,170604,1,0,4,120,5.666666666666668,302.89443731268045,1
2020-10-28-170604,170604,0,0,0,120,6.333333333333332,298.11794799135606,2
2020-10-29-170604,170604,0,0,0,120,5.166666666666667,281.1136734887665,3
2020-10-30-170604,170604,5,0,1,125,7.5,237.36172276774573,4
2020-10-31-170604,170604,2,0,0,127,2.0,276.13734257575356,5
2020-11-01-170604,170604,2,0,0,129,2.333333333333333,225.3243354634972,6
2020-11-02-170604,170604,1,0,0,130,1.0,117.78050711339196,0
2020-11-03-170604,170604,2,0,0,132,6.0,114.12076084259826,1
2020-11-04-170604,170604,1,0,0,133,3.6666666666666665,155.77052742194996,2
2020-11-05-170604,170604,1,1,0,134,5.833333333333332,174.04946744578118,3
2020-11-06-170604,170604,0,0,0,134,4.666666666666667,179.31439543994532,4
2020-11-07-170604,170604,0,0,0,134,1.6666666666666667,194.44193906033334,5
2020-11-08-170604,170604,0,0,0,134,2.333333333333333,182.70737888208396,6
2020-11-09-170604,170604,0,0,0,134,4.0,180.83177218149697,0
2020-11-10-170604,170604,4,0,0,138,2.333333333333333,218.58591899296437,1
2020-11-11-170604,170604,0,0,0,138,5.833333333333332,234.43615132129764,2
2020-11-12-170604,170604,0,0,0,138,2.0,205.88846241351507,3
2020-11-13-170604,170604,1,0,0,139,3.8333333333333335,204.16384613880672,4
2020-03-01-170605,170605,0,0,0,0,0.16666666666666666,0.0,6
2020-03-02-170605,170605,0,0,1,0,0.0,9.216620002311398,0
2020-03-03-170605,170605,0,0,1,0,0.0,54.44985524059448,1
2020-03-04-170605,170605,0,0,0,0,0.0,65.44689973784294,2
2020-03-05-170605,170605,0,0,0,0,0.0,71.8423471372544,3
2020-03-06-170605,170605,0,0,0,0,0.0,66.28212679784616,4
2020-03-07-170605,170605,0,0,0,0,0.0,71.6816877475718,5
2020-03-08-170605,170605,0,0,0,0,0.0,73.46304100244599,6
2020-03-09-170605,170605,0,0,1,0,0.0,74.1136494575377,0
2020-03-10-170605,170605,0,0,0,0,0.0,135.6702128310904,1
2020-03-11-170605,170605,0,0,1,0,0.16666666666666666,102.61085683707269,2
2020-03-12-170605,170605,0,0,1,0,0.16666666666666666,76.77569699908138,3
2020-03-13-170605,170605,0,0,2,0,0.3333333333333333,48.241833208002895,4
2020-03-14-170605,170605,0,0,1,0,0.3333333333333333,45.286120830120474,5
2020-03-15-170605,170605,0,0,0,0,0.0,38.51190259279842,6
2020-03-16-170605,170605,1,0,0,1,2.1666666666666665,15.498468336154748,0
2020-03-17-170605,170605,1,0,0,2,1.8333333333333333,31.874063370938657,1
2020-03-18-170605,170605,0,0,0,2,1.1666666666666667,44.28943119883763,2
2020-03-19-170605,170605,0,0,0,2,1.5,51.74524359174966,3
2020-03-20-170605,170605,0,0,3,2,2.5,53.311469414547176,4
2020-03-21-170605,170605,0,0,0,2,1.5,60.169240867503504,5
2020-03-22-170605,170605,0,0,0,2,1.0,59.632343199835006,6
2020-03-23-170605,170605,1,0,1,3,8.166666666666666,51.076499007739436,0
2020-03-24-170605,170605,0,0,1,3,3.0,70.35840395371012,1
2020-03-25-170605,170605,1,0,2,4,3.8333333333333335,77.64195553776989,2
2020-03-26-170605,170605,1,0,0,5,3.6666666666666665,90.88083171980249,3
2020-03-27-170605,170605,2,0,0,7,5.166666666666667,106.9743801275221,4
2020-03-28-170605,170605,1,0,1,8,1.5,115.76490828752287,5
2020-03-29-170605,170605,0,0,0,8,0.8333333333333334,117.60667066891227,6
2020-03-30-170605,170605,0,0,1,8,8.666666666666666,87.8409217928998,0
2020-03-31-170605,170605,0,0,0,8,2.833333333333333,99.42713873771864,1
2020-04-01-170605,170605,0,0,1,8,3.333333333333333,13.43210873746228,2
2020-04-02-170605,170605,0,0,1,8,2.1666666666666665,43.823373419390336,3
2020-04-03-170605,170605,3,0,0,11,2.5,24.83061166975667,4
2020-04-04-170605,170605,0,0,0,11,1.1666666666666667,33.11086421994631,5
2020-04-05-170605,170605,0,0,0,11,0.6666666666666666,34.39256707229411,6
2020-04-06-170605,170605,1,1,0,12,4.166666666666667,36.89040922631836,0
2020-04-07-170605,170605,1,0,0,13,1.6666666666666667,46.40743790135568,1
2020-04-08-170605,170605,2,0,0,15,1.8333333333333333,49.07336509539381,2
2020-04-09-170605,170605,0,0,0,15,0.3333333333333333,52.11922763519122,3
2020-04-10-170605,170605,0,1,1,15,1.8333333333333333,13.613974262997141,4
2020-04-11-170605,170605,1,0,0,16,0.6666666666666666,19.370157198320335,5
2020-04-12-170605,170605,0,0,0,16,0.8333333333333334,22.806977509508027,6
2020-04-13-170605,170605,1,0,0,17,2.333333333333333,24.112740326636533,0
2020-04-14-170605,170605,0,0,1,17,1.1666666666666667,33.66770377026678,1
2020-04-15-170605,170605,1,0,0,18,1.5,40.92635280393466,2
2020-04-16-170605,170605,1,0,0,19,1.1666666666666667,50.618464681063635,3
2020-04-17-170605,170605,0,0,0,19,1.8333333333333333,46.24448234975189,4
2020-04-18-170605,170605,0,0,0,19,0.16666666666666666,49.15761506762084,5
2020-04-19-170605,170605,0,0,0,19,0.5,46.883228753762985,6
2020-04-20-170605,170605,0,0,0,19,0.6666666666666666,46.594670877001235,0
2020-04-21-170605,170605,0,0,0,19,2.5,44.79811579318153,1
2020-04-22-170605,170605,0,0,0,19,0.6666666666666666,42.873250466034186,2
2020-04-23-170605,170605,0,0,0,19,0.5,40.31269700783743,3
2020-04-24-170605,170605,1,0,0,20,2.1666666666666665,32.96362558604728,4
2020-04-25-170605,170605,0,0,0,20,0.3333333333333333,36.91850931022523,5
2020-04-26-170605,170605,0,0,0,20,0.3333333333333333,36.83303298561087,6
2020-04-27-170605,170605,0,0,0,20,1.0,29.49085692830967,0
2020-04-28-170605,170605,1,0,0,21,1.3333333333333333,29.039094347553466,1
2020-04-29-170605,170605,0,0,0,21,1.3333333333333333,26.486805236516492,2
2020-04-30-170605,170605,0,0,0,21,0.6666666666666666,38.27846611064743,3
2020-05-01-170605,170605,0,0,0,21,0.3333333333333333,46.73794611287521,4
2020-05-02-170605,170605,0,0,0,21,0.3333333333333333,14.122589003181353,5
2020-05-03-170605,170605,0,0,0,21,0.0,13.375815742870184,6
2020-05-04-170605,170605,0,0,0,21,0.5,8.658512439025465,0
2020-05-05-170605,170605,0,0,0,21,0.5,13.531669739481288,1
2020-05-06-170605,170605,0,0,0,21,0.5,15.203044768904185,2
2020-05-07-170605,170605,0,0,0,21,2.1666666666666665,21.094805891944773,3
2020-05-08-170605,170605,0,0,0,21,1.0,29.876853645127156,4
2020-05-09-170605,170605,0,2,0,21,0.16666666666666666,37.903903986766,5
2020-05-10-170605,170605,0,0,0,21,0.0,55.617182004838746,6
2020-05-11-170605,170605,0,1,2,21,1.0,52.0043320318571,0
2020-05-12-170605,170605,0,0,0,21,0.3333333333333333,51.64065421226218,1
2020-05-13-170605,170605,0,4,1,21,0.5,37.55791056529276,2
2020-05-14-170605,170605,0,3,0,21,0.6666666666666666,30.864604713331147,3
2020-05-15-170605,170605,0,0,0,21,1.0,23.246988554103886,4
2020-05-16-170605,170605,0,0,0,21,0.0,23.078558084801042,5
2020-05-17-170605,170605,0,0,0,21,0.0,20.87711847162157,6
2020-05-18-170605,170605,0,0,0,21,1.1666666666666667,20.98387645485893,0
2020-05-19-170605,170605,0,0,0,21,0.3333333333333333,20.85866355563264,1
2020-05-20-170605,170605,0,0,0,21,1.0,18.197050376641904,2
2020-05-21-170605,170605,0,0,0,21,0.3333333333333333,18.219754090534508,3
2020-05-22-170605,170605,0,0,0,21,0.6666666666666666,14.696811197328078,4
2020-05-23-170605,170605,0,0,0,21,0.16666666666666666,19.114106811754368,5
2020-05-24-170605,170605,0,0,0,21,0.0,20.062342340592483,6
2020-05-25-170605,170605,2,0,0,23,1.0,15.34435809692069,0
2020-05-26-170605,170605,0,0,1,23,0.5,20.349367070714713,1
2020-05-27-170605,170605,1,2,0,24,0.3333333333333333,20.08847819561075,2
2020-05-28-170605,170605,0,0,0,24,1.5,20.33491492107006,3
2020-05-29-170605,170605,0,1,0,24,0.6666666666666666,24.19136017704424,4
2020-05-30-170605,170605,0,0,0,24,0.0,22.21291615277797,5
2020-05-31-170605,170605,0,0,0,24,0.0,22.725129762899666,6
2020-06-01-170605,170605,0,0,0,24,0.16666666666666666,51.22871139435932,0
2020-06-02-170605,170605,0,0,1,24,0.8333333333333334,15.6184848632161,1
2020-06-03-170605,170605,0,0,0,24,1.0,9.424386298054912,2
2020-06-04-170605,170605,0,0,1,24,0.5,9.52103530822742,3
2020-06-05-170605,170605,0,0,0,24,0.6666666666666666,9.971128156457759,4
2020-06-06-170605,170605,0,0,0,24,0.0,13.572634786755582,5
2020-06-07-170605,170605,0,0,0,24,0.0,13.694392864658731,6
2020-06-08-170605,170605,0,0,0,24,0.5,12.941447075931436,0
2020-06-09-170605,170605,1,0,0,25,0.3333333333333333,14.322686189974759,1
2020-06-10-170605,170605,0,0,0,25,0.3333333333333333,51.46647821924537,2
2020-06-11-170605,170605,0,0,0,25,0.16666666666666666,44.04676319058592,3
2020-06-12-170605,170605,0,0,0,25,0.3333333333333333,40.020156940276294,4
2020-06-13-170605,170605,0,0,0,25,0.0,29.20882290485775,5
2020-06-14-170605,170605,0,0,0,25,0.0,16.826275265569773,6
2020-06-15-170605,170605,0,1,0,25,0.0,9.430155467858896,0
2020-06-16-170605,170605,1,0,0,26,0.0,7.609162754528935,1
2020-06-17-170605,170605,0,0,0,26,0.16666666666666666,8.434285514224845,2
2020-06-18-170605,170605,1,0,0,27,0.5,8.250828212156186,3
2020-06-19-170605,170605,0,0,0,27,1.0,11.80993108677507,4
2020-06-20-170605,170605,0,0,0,27,0.0,19.899971847437172,5
2020-06-21-170605,170605,0,0,0,27,0.0,20.3406995635736,6
2020-06-22-170605,170605,0,0,0,27,0.3333333333333333,19.948342986547313,0
2020-06-23-170605,170605,0,0,0,27,0.5,20.31238680576207,1
2020-06-24-170605,170605,0,0,0,27,0.16666666666666666,22.955517770053966,2
2020-06-25-170605,170605,0,0,0,27,0.3333333333333333,19.624926555826796,3
2020-06-26-170605,170605,0,0,0,27,0.16666666666666666,15.991753697824974,4
2020-06-27-170605,170605,0,0,0,27,0.0,12.157491507090608,5
2020-06-28-170605,170605,0,0,0,27,0.16666666666666666,12.734665187901019,6
2020-06-29-170605,170605,0,0,0,27,0.0,13.60385899506287,0
2020-06-30-170605,170605,0,0,0,27,0.16666666666666666,11.76027748015133,1
2020-07-01-170605,170605,0,0,0,27,0.0,16.134498389763824,2
2020-07-02-170605,170605,0,0,0,27,0.16666666666666666,8.124937907232217,3
2020-07-03-170605,170605,0,0,0,27,0.0,5.805171695680597,4
2020-07-04-170605,170605,0,0,0,27,0.0,11.939041135805603,5
2020-07-05-170605,170605,0,0,0,27,0.3333333333333333,12.339887185962905,6
2020-07-06-170605,170605,0,0,0,27,0.0,11.683855239436415,0
2020-07-07-170605,170605,0,0,0,27,0.0,11.264674998664121,1
2020-07-08-170605,170605,0,0,0,27,0.16666666666666666,11.197206900872686,2
2020-07-09-170605,170605,0,1,0,27,0.16666666666666666,12.216066007369024,3
2020-07-10-170605,170605,0,0,0,27,0.0,17.089920223091717,4
2020-07-11-170605,170605,0,0,0,27,0.3333333333333333,14.001820840722836,5
2020-07-12-170605,170605,0,0,0,27,0.0,9.192591893559829,6
2020-07-13-170605,170605,0,0,0,27,0.16666666666666666,8.764705387827245,0
2020-07-14-170605,170605,0,0,0,27,0.16666666666666666,10.471298630059632,1
2020-07-15-170605,170605,0,0,0,27,0.3333333333333333,9.265039464446819,2
2020-07-16-170605,170605,0,0,0,27,0.8333333333333334,5.928928557637284,3
2020-07-17-170605,170605,0,0,1,27,0.0,8.137559489970428,4
2020-07-18-170605,170605,0,0,0,27,0.0,8.28775590679859,5
2020-07-19-170605,170605,0,0,0,27,0.5,7.751156757253245,6
2020-07-20-170605,170605,0,0,0,27,0.3333333333333333,7.344749022496205,0
2020-07-21-170605,170605,0,0,0,27,0.3333333333333333,7.521421373807582,1
2020-07-22-170605,170605,0,0,0,27,0.0,8.922224089539373,2
2020-07-23-170605,170605,0,0,0,27,0.16666666666666666,6.864325581181584,3
2020-07-24-170605,170605,0,0,0,27,0.3333333333333333,6.943152399645175,4
2020-07-25-170605,170605,0,0,0,27,0.0,7.403844474690674,5
2020-07-26-170605,170605,0,0,0,27,0.16666666666666666,6.542227227971519,6
2020-07-27-170605,170605,0,0,1,27,0.3333333333333333,6.50462293581643,0
2020-07-28-170605,170605,0,0,0,27,0.0,7.045732183552991,1
2020-07-29-170605,170605,0,0,0,27,0.0,5.614389592487994,2
2020-07-30-170605,170605,0,0,3,27,0.5,5.507632405160405,3
2020-07-31-170605,170605,1,0,2,28,0.16666666666666666,8.679571880592077,4
2020-08-01-170605,170605,0,0,0,28,0.0,9.038480008137125,5
2020-08-02-170605,170605,0,0,2,28,0.0,53.02102005192492,6
2020-08-03-170605,170605,0,0,0,28,0.6666666666666666,115.53685038724241,0
2020-08-04-170605,170605,0,0,0,28,0.5,118.76872949186334,1
2020-08-05-170605,170605,0,0,0,28,0.5,102.29401192702558,2
2020-08-06-170605,170605,0,0,0,28,0.3333333333333333,84.67306553084708,3
2020-08-07-170605,170605,0,1,0,28,1.1666666666666667,67.42526977645221,4
2020-08-08-170605,170605,0,0,0,28,0.0,63.03767157958299,5
2020-08-09-170605,170605,0,0,0,28,0.0,61.11356753987931,6
2020-08-10-170605,170605,1,0,2,29,0.3333333333333333,7.048187903447992,0
2020-08-11-170605,170605,0,0,0,29,0.5,12.630574872092835,1
2020-08-12-170605,170605,0,0,0,29,0.3333333333333333,17.687033954777583,2
2020-08-13-170605,170605,3,0,0,32,0.6666666666666666,23.934037419471956,3
2020-08-14-170605,170605,2,0,2,34,1.5,33.23225135196452,4
2020-08-15-170605,170605,0,0,0,34,0.16666666666666666,47.05836089987159,5
2020-08-16-170605,170605,2,0,0,36,0.3333333333333333,46.5311043650627,6
2020-08-17-170605,170605,0,0,0,36,0.8333333333333334,54.201929611660354,0
2020-08-18-170605,170605,0,0,0,36,0.6666666666666666,53.79867817281401,1
2020-08-19-170605,170605,0,0,1,36,2.0,55.041166584563186,2
2020-08-20-170605,170605,0,0,1,36,1.1666666666666667,47.664304775853275,3
2020-08-21-170605,170605,0,0,0,36,1.1666666666666667,43.72039306649752,4
2020-08-22-170605,170605,0,0,0,36,0.16666666666666666,49.439583202900394,5
2020-08-23-170605,170605,0,0,0,36,0.6666666666666666,46.42240468219578,6
2020-08-24-170605,170605,2,0,1,38,3.333333333333333,44.61306896425093,0
2020-08-25-170605,170605,0,0,0,38,3.333333333333333,53.900059350140545,1
2020-08-26-170605,170605,0,0,1,38,3.1666666666666665,65.11256141897715,2
2020-08-27-170605,170605,0,0,0,38,3.333333333333333,83.46446668759441,3
2020-08-28-170605,170605,2,0,2,40,2.1666666666666665,94.14094244227212,4
2020-08-29-170605,170605,0,0,1,40,0.8333333333333334,104.7331956114816,5
2020-08-30-170605,170605,0,0,0,40,1.6666666666666667,108.54888697877686,6
2020-08-31-170605,170605,0,0,1,40,3.8333333333333335,101.76229564990854,0
2020-09-01-170605,170605,0,0,0,40,3.0,47.3676779824867,1
2020-09-02-170605,170605,1,0,0,41,1.8333333333333333,151.48664617071466,2
2020-09-03-170605,170605,1,0,1,42,1.6666666666666667,83.04255400400939,3
2020-09-04-170605,170605,0,0,1,42,2.5,84.128361485542,4
2020-09-05-170605,170605,0,0,0,42,3.1666666666666665,85.34333451547673,5
2020-09-06-170605,170605,0,0,0,42,2.1666666666666665,93.44989801619354,6
2020-09-07-170605,170605,1,0,0,43,4.5,106.59153941382066,0
2020-09-08-170605,170605,0,0,0,43,1.6666666666666667,114.78167239423135,1
2020-09-09-170605,170605,1,0,1,44,1.0,111.2850234530904,2
2020-09-10-170605,170605,0,0,1,44,2.5,36.813661816075154,3
2020-09-11-170605,170605,2,0,0,46,5.0,45.753863318890694,4
2020-09-12-170605,170605,1,0,0,47,2.6666666666666665,64.48327359980196,5
2020-09-13-170605,170605,0,0,0,47,3.1666666666666665,73.2710164322558,6
2020-09-14-170605,170605,1,0,0,48,4.5,83.49614913009619,0
2020-09-15-170605,170605,0,0,0,48,5.833333333333332,97.13992153886386,1
2020-09-16-170605,170605,0,0,4,48,3.6666666666666665,116.9399547097,2
2020-09-17-170605,170605,1,0,0,49,3.0,123.98595479173594,3
2020-09-18-170605,170605,1,0,1,50,13.333333333333336,127.77178303059581,4
2020-09-19-170605,170605,0,0,0,50,6.333333333333332,123.99017248120546,5
2020-09-20-170605,170605,0,0,2,50,4.166666666666667,134.70274327085573,6
2020-09-21-170605,170605,0,0,0,50,2.333333333333333,137.9180743295509,0
2020-09-22-170605,170605,0,0,0,50,1.8333333333333333,136.4959441061374,1
2020-09-23-170605,170605,1,0,0,51,5.333333333333333,125.35139513449325,2
2020-09-24-170605,170605,1,0,0,52,4.833333333333333,126.13871279586931,3
2020-09-25-170605,170605,0,0,1,52,3.333333333333333,124.33347015791097,4
2020-09-26-170605,170605,0,0,1,52,3.1666666666666665,107.55356626194819,5
2020-09-27-170605,170605,0,0,0,52,1.3333333333333333,102.09778505981538,6
2020-09-28-170605,170605,0,0,0,52,2.1666666666666665,88.82394891522712,0
2020-09-29-170605,170605,0,0,1,52,1.8333333333333333,82.07218637109077,1
2020-09-30-170605,170605,4,0,0,56,3.8333333333333335,72.85715883545296,2
2020-10-01-170605,170605,0,0,3,56,2.6666666666666665,0.0,3
2020-10-02-170605,170605,1,0,5,57,2.0,150.696025036422,4
2020-10-03-170605,170605,0,0,4,57,1.6666666666666667,161.72221922527268,5
2020-10-04-170605,170605,2,0,1,59,1.3333333333333333,151.91378073430508,6
2020-10-05-170605,170605,0,0,1,59,1.5,126.505901327473,0
2020-10-06-170605,170605,0,0,1,59,3.333333333333333,114.1665761577014,1
2020-10-07-170605,170605,0,0,3,59,4.0,105.46140377196733,2
2020-10-08-170605,170605,0,0,3,59,3.0,101.51953081033797,3
2020-10-09-170605,170605,1,0,0,60,4.0,111.45191159793723,4
2020-10-10-170605,170605,1,0,2,61,1.0,11.912262162156612,5
2020-10-11-170605,170605,0,0,1,61,0.3333333333333333,21.01099035317411,6
2020-10-12-170605,170605,0,0,3,61,0.8333333333333334,27.148644658873515,0
2020-10-13-170605,170605,1,0,2,62,3.0,34.91828643214794,1
2020-10-14-170605,170605,0,0,0,62,1.8333333333333333,55.40318071587334,2
2020-10-15-170605,170605,3,0,1,65,3.333333333333333,67.72370516669088,3
2020-10-16-170605,170605,5,0,6,70,3.8333333333333335,94.19890972728872,4
2020-10-17-170605,170605,4,0,3,74,1.1666666666666667,114.96315694959972,5
2020-10-18-170605,170605,1,0,0,75,1.8333333333333333,116.68777154749195,6
2020-10-19-170605,170605,1,1,2,76,3.8333333333333335,121.73394940034214,0
2020-10-20-170605,170605,1,0,0,77,2.6666666666666665,138.14423094592536,1
2020-10-21-170605,170605,3,0,2,80,3.0,146.04630811239997,2
2020-10-22-170605,170605,3,0,5,83,4.166666666666667,146.53303112651636,3
2020-10-23-170605,170605,0,0,1,83,4.666666666666667,145.59156610400478,4
2020-10-24-170605,170605,2,0,0,85,1.3333333333333333,165.68097442921464,5
2020-10-25-170605,170605,1,0,0,86,0.6666666666666666,162.40510608562224,6
2020-10-26-170605,170605,3,0,0,89,9.166666666666666,140.14576826735865,0
2020-10-27-170605,170605,2,0,1,91,3.6666666666666665,160.25855886524286,1
2020-10-28-170605,170605,0,0,1,91,2.6666666666666665,163.6017515548663,2
2020-10-29-170605,170605,1,0,0,92,4.333333333333333,153.5783362031238,3
2020-10-30-170605,170605,6,0,4,98,4.166666666666667,122.91050809361215,4
2020-10-31-170605,170605,3,0,0,101,4.833333333333333,141.16455157973695,5
2020-11-01-170605,170605,0,0,0,101,2.6666666666666665,100.10124720486269,6
2020-11-02-170605,170605,2,0,0,103,4.333333333333333,105.94881680261501,0
2020-11-03-170605,170605,0,0,0,103,5.166666666666667,95.81954997921889,1
2020-11-04-170605,170605,2,0,0,105,5.166666666666667,109.17046203056503,2
2020-11-05-170605,170605,5,0,0,110,4.5,125.9949836740955,3
2020-11-06-170605,170605,1,0,0,111,3.8333333333333335,136.49507401587465,4
2020-11-07-170605,170605,0,0,0,111,2.5,140.55498038609613,5
2020-11-08-170605,170605,0,0,0,111,1.1666666666666667,126.36495024033098,6
2020-11-09-170605,170605,0,0,0,111,4.666666666666667,121.23303573751494,0
2020-11-10-170605,170605,1,0,0,112,4.0,84.94448074451194,1
2020-11-11-170605,170605,1,1,0,113,2.6666666666666665,93.92539740922817,2
2020-11-12-170605,170605,0,3,0,113,5.333333333333333,95.0387983973668,3
2020-11-13-170605,170605,4,0,0,117,2.6666666666666665,106.56996233909419,4
2020-03-01-170606,170606,0,0,4,0,0.0,0.0,6
2020-03-02-170606,170606,0,0,20,0,0.0,110.15847079033489,0
2020-03-03-170606,170606,0,0,11,0,0.0,449.67683093475205,1
2020-03-04-170606,170606,0,0,15,0,0.0,425.83289976632875,2
2020-03-05-170606,170606,0,0,14,0,0.14285714285714285,434.6952614159406,3
2020-03-06-170606,170606,0,0,20,0,0.14285714285714285,412.4274706290364,4
2020-03-07-170606,170606,0,0,5,0,0.0,393.46159640806155,5
2020-03-08-170606,170606,0,0,4,0,0.0,362.92047866702023,6
2020-03-09-170606,170606,0,0,24,0,0.0,359.08261560423693,0
2020-03-10-170606,170606,0,0,23,0,0.0,944.0683257751205,1
2020-03-11-170606,170606,0,0,25,0,0.14285714285714285,732.5241952691123,2
2020-03-12-170606,170606,0,0,16,0,0.0,648.8720834919458,3
2020-03-13-170606,170606,0,0,13,0,0.0,426.2525304542353,4
2020-03-14-170606,170606,1,0,11,1,0.42857142857142855,350.9166540008007,5
2020-03-15-170606,170606,4,0,7,5,0.42857142857142855,238.79988484153964,6
2020-03-16-170606,170606,20,0,13,25,0.5714285714285714,80.8164854011094,0
2020-03-17-170606,170606,11,0,12,36,1.0,275.59413239061445,1
2020-03-18-170606,170606,15,1,7,51,0.5714285714285714,380.2428519650656,2
2020-03-19-170606,170606,14,0,7,65,0.5714285714285714,489.58513590377447,3
2020-03-20-170606,170606,20,0,12,85,0.0,573.3966144148055,4
2020-03-21-170606,170606,5,0,3,90,0.14285714285714285,677.1741213476855,5
2020-03-22-170606,170606,4,1,5,94,0.14285714285714285,643.7890181789984,6
2020-03-23-170606,170606,24,0,13,118,1.0,530.0383872201364,0
2020-03-24-170606,170606,23,0,17,141,0.5714285714285714,632.1193410726536,1
2020-03-25-170606,170606,25,0,8,166,1.0,690.5940877738674,2
2020-03-26-170606,170606,16,0,3,182,1.2857142857142858,755.5036342305677,3
2020-03-27-170606,170606,13,0,4,195,0.8571428571428571,882.1542683932362,4
2020-03-28-170606,170606,11,0,9,206,0.14285714285714285,832.8780359606832,5
2020-03-29-170606,170606,7,0,5,213,0.2857142857142857,865.3146013972199,6
2020-03-30-170606,170606,13,0,19,226,1.0,690.29583969362,0
2020-03-31-170606,170606,12,0,2,238,0.8571428571428571,618.9259868985464,1
2020-04-01-170606,170606,7,0,10,245,0.7142857142857143,89.93266710210469,2
2020-04-02-170606,170606,7,0,2,252,4.285714285714286,347.28952383032174,3
2020-04-03-170606,170606,12,0,4,264,1.5714285714285714,154.6547756529201,4
2020-04-04-170606,170606,3,0,7,267,0.7142857142857143,228.7128142024757,5
2020-04-05-170606,170606,5,0,4,272,0.7142857142857143,238.82906704964785,6
2020-04-06-170606,170606,13,0,6,285,1.0,267.49823964031134,0
2020-04-07-170606,170606,17,0,5,302,0.7142857142857143,310.01612460528435,1
2020-04-08-170606,170606,8,0,4,310,0.42857142857142855,412.71228692338013,2
2020-04-09-170606,170606,3,0,6,313,0.0,439.94319814244966,3
2020-04-10-170606,170606,4,0,1,317,0.2857142857142857,59.92913714420566,4
2020-04-11-170606,170606,9,0,2,326,0.14285714285714285,84.43947406003373,5
2020-04-12-170606,170606,5,0,1,331,0.14285714285714285,134.04712966156842,6
2020-04-13-170606,170606,19,1,7,350,1.4285714285714286,166.23929235691418,0
2020-04-14-170606,170606,2,0,2,352,0.5714285714285714,298.53996851404065,1
2020-04-15-170606,170606,10,1,3,362,0.5714285714285714,320.8578092734312,2
2020-04-16-170606,170606,2,0,3,364,0.2857142857142857,399.62039641455925,3
2020-04-17-170606,170606,4,0,2,368,0.0,375.56803634788963,4
2020-04-18-170606,170606,7,0,1,375,0.2857142857142857,382.91926184221063,5
2020-04-19-170606,170606,4,0,1,379,0.5714285714285714,383.7315016342105,6
2020-04-20-170606,170606,6,0,11,385,2.8571428571428568,317.6506141438762,0
2020-04-21-170606,170606,5,0,7,390,0.2857142857142857,367.0840004082124,1
2020-04-22-170606,170606,4,0,5,394,0.0,338.34910727394447,2
2020-04-23-170606,170606,6,1,3,400,0.0,348.65982987198754,3
2020-04-24-170606,170606,1,0,2,401,0.42857142857142855,349.78075331486843,4
2020-04-25-170606,170606,2,0,8,403,0.0,306.8749724471735,5
2020-04-26-170606,170606,1,0,2,404,0.14285714285714285,286.66652214609985,6
2020-04-27-170606,170606,7,0,4,411,0.14285714285714285,214.6742324597335,0
2020-04-28-170606,170606,2,0,3,413,0.42857142857142855,200.02577283837238,1
2020-04-29-170606,170606,3,1,4,416,0.0,175.42942313862125,2
2020-04-30-170606,170606,3,0,0,419,0.14285714285714285,235.18480888332886,3
2020-05-01-170606,170606,2,0,2,421,0.14285714285714285,402.0823470064331,4
2020-05-02-170606,170606,1,0,1,422,0.42857142857142855,217.76037296213852,5
2020-05-03-170606,170606,1,0,1,423,0.0,119.65430638101408,6
2020-05-04-170606,170606,11,0,15,434,0.42857142857142855,86.72232366223037,0
2020-05-05-170606,170606,7,0,2,441,0.7142857142857143,155.3420336410198,1
2020-05-06-170606,170606,5,0,1,446,0.5714285714285714,204.23092727415838,2
2020-05-07-170606,170606,3,0,3,449,0.2857142857142857,235.42817167761177,3
2020-05-08-170606,170606,2,0,4,451,0.0,251.48608539859637,4
2020-05-09-170606,170606,8,0,1,459,0.14285714285714285,273.2076271465171,5
2020-05-10-170606,170606,2,0,1,461,0.0,451.18491221214316,6
2020-05-11-170606,170606,4,0,4,465,0.5714285714285714,431.8523128924422,0
2020-05-12-170606,170606,3,0,0,468,0.2857142857142857,428.18613394063277,1
2020-05-13-170606,170606,4,2,0,472,0.14285714285714285,346.63939749521313,2
2020-05-14-170606,170606,0,1,3,472,0.0,251.00646348380096,3
2020-05-15-170606,170606,2,0,3,474,0.2857142857142857,197.82062566905464,4
2020-05-16-170606,170606,1,0,1,475,0.14285714285714285,193.97504205286808,5
2020-05-17-170606,170606,1,0,0,476,0.0,189.60027729183838,6
2020-05-18-170606,170606,15,0,2,491,1.1428571428571428,183.8086146046665,0
2020-05-19-170606,170606,2,0,1,493,0.0,283.86385853878073,1
2020-05-20-170606,170606,1,0,0,494,0.0,234.12329508053622,2
2020-05-21-170606,170606,3,0,5,497,0.14285714285714285,243.17459377166645,3
2020-05-22-170606,170606,4,0,2,501,0.0,239.48610041640774,4
2020-05-23-170606,170606,1,0,0,502,0.0,256.8161598142421,5
2020-05-24-170606,170606,1,0,0,503,0.14285714285714285,260.2620672953495,6
2020-05-25-170606,170606,4,0,1,507,0.0,120.85779857400357,0
2020-05-26-170606,170606,0,0,0,507,0.0,132.77961757048175,1
2020-05-27-170606,170606,0,1,0,507,0.42857142857142855,130.7108968777994,2
2020-05-28-170606,170606,3,0,3,510,0.42857142857142855,134.97164908140547,3
2020-05-29-170606,170606,3,1,0,513,0.0,159.4999208582691,4
2020-05-30-170606,170606,1,0,1,514,0.0,169.98266218760998,5
2020-05-31-170606,170606,0,0,0,514,0.0,162.10611969328545,6
2020-06-01-170606,170606,2,0,0,516,0.0,419.8111431359606,0
2020-06-02-170606,170606,1,0,0,517,0.14285714285714285,46.46445401361626,1
2020-06-03-170606,170606,0,0,0,517,0.0,69.9650844908711,2
2020-06-04-170606,170606,5,0,0,522,0.42857142857142855,61.12683600966406,3
2020-06-05-170606,170606,2,0,2,524,0.14285714285714285,97.75767133367756,4
2020-06-06-170606,170606,0,0,0,524,0.0,112.69933425359966,5
2020-06-07-170606,170606,0,0,0,524,0.0,112.84736379545805,6
2020-06-08-170606,170606,1,0,0,525,0.0,94.50858574239012,0
2020-06-09-170606,170606,0,0,1,525,0.0,103.36387231388808,1
2020-06-10-170606,170606,0,0,0,525,0.0,458.7560498612047,2
2020-06-11-170606,170606,3,0,1,528,0.14285714285714285,357.34478662582796,3
2020-06-12-170606,170606,0,0,1,528,0.0,312.2388865348947,4
2020-06-13-170606,170606,1,0,0,529,0.0,225.0848636276379,5
2020-06-14-170606,170606,0,0,2,529,0.0,182.08118432071504,6
2020-06-15-170606,170606,0,0,0,529,0.2857142857142857,155.73272207540526,0
2020-06-16-170606,170606,0,0,0,529,0.0,75.7418247139581,1
2020-06-17-170606,170606,0,2,0,529,0.0,54.452090163016166,2
2020-06-18-170606,170606,0,0,1,529,0.0,53.43033484896116,3
2020-06-19-170606,170606,2,0,0,531,0.2857142857142857,22.630135867169827,4
2020-06-20-170606,170606,0,0,0,531,0.0,55.448339905968126,5
2020-06-21-170606,170606,0,0,1,531,0.0,55.62652674515991,6
2020-06-22-170606,170606,0,0,0,531,0.0,53.157150669263665,0
2020-06-23-170606,170606,1,0,1,532,0.14285714285714285,61.42079385662742,1
2020-06-24-170606,170606,0,0,0,532,0.14285714285714285,74.5895103685495,2
2020-06-25-170606,170606,1,1,0,533,0.0,74.94629933898867,3
2020-06-26-170606,170606,1,0,0,534,0.0,67.70118147307352,4
2020-06-27-170606,170606,0,0,0,534,0.0,65.08414606727521,5
2020-06-28-170606,170606,2,0,0,536,0.0,66.013900224834,6
2020-06-29-170606,170606,0,0,1,536,0.0,89.00586325370791,0
2020-06-30-170606,170606,0,0,0,536,0.0,73.78253516334901,1
2020-07-01-170606,170606,0,0,0,536,0.0,116.92155630856618,2
2020-07-02-170606,170606,1,0,1,537,0.0,38.39705815771649,3
2020-07-03-170606,170606,0,0,0,537,0.0,71.21580162437924,4
2020-07-04-170606,170606,0,0,0,537,0.0,31.93971612392824,5
2020-07-05-170606,170606,1,0,0,538,0.14285714285714285,31.17634914522253,6
2020-07-06-170606,170606,0,0,0,538,0.0,45.8081266042434,0
2020-07-07-170606,170606,1,0,1,539,0.0,34.11596472643747,1
2020-07-08-170606,170606,0,0,0,539,0.0,41.21968153090914,2
2020-07-09-170606,170606,0,0,0,539,0.0,39.79669104185457,3
2020-07-10-170606,170606,0,0,2,539,0.0,120.22892387806279,4
2020-07-11-170606,170606,0,0,1,539,0.0,51.59837307263246,5
2020-07-12-170606,170606,0,0,0,539,0.0,20.56193975537154,6
2020-07-13-170606,170606,1,0,0,540,0.0,24.3034420481409,0
2020-07-14-170606,170606,0,0,1,540,0.14285714285714285,35.582171979845405,1
2020-07-15-170606,170606,0,0,0,540,0.0,32.91057489860176,2
2020-07-16-170606,170606,1,0,1,541,0.2857142857142857,29.009665921607755,3
2020-07-17-170606,170606,0,0,0,541,0.0,44.08203999701444,4
2020-07-18-170606,170606,0,0,1,541,0.0,44.415859273617095,5
2020-07-19-170606,170606,0,0,0,541,0.0,44.447542007415265,6
2020-07-20-170606,170606,0,0,2,541,0.0,40.01737090892928,0
2020-07-21-170606,170606,1,0,0,542,0.0,31.2018464767102,1
2020-07-22-170606,170606,0,0,0,542,0.0,47.46560845380324,2
2020-07-23-170606,170606,0,0,0,542,0.8571428571428571,33.944070113927175,3
2020-07-24-170606,170606,2,0,2,544,0.0,51.033072110375954,4
2020-07-25-170606,170606,1,0,1,545,0.0,76.4883306751213,5
2020-07-26-170606,170606,0,0,0,545,0.14285714285714285,88.84437092324197,6
2020-07-27-170606,170606,0,0,0,545,0.14285714285714285,77.73164623396437,0
2020-07-28-170606,170606,1,0,11,546,0.0,76.7001512380597,1
2020-07-29-170606,170606,0,0,2,546,0.2857142857142857,74.49679242894061,2
2020-07-30-170606,170606,1,0,4,547,0.42857142857142855,61.45189757545767,3
2020-07-31-170606,170606,0,0,8,547,0.2857142857142857,40.501587554413334,4
2020-08-01-170606,170606,1,0,2,548,0.5714285714285714,37.352945276979646,5
2020-08-02-170606,170606,0,0,0,548,0.0,588.3945896188616,6
2020-08-03-170606,170606,2,0,4,550,0.0,388.3967629914465,0
2020-08-04-170606,170606,0,0,6,550,0.14285714285714285,372.8899190486728,1
2020-08-05-170606,170606,0,0,7,550,0.14285714285714285,328.7701125296718,2
2020-08-06-170606,170606,0,0,7,550,0.14285714285714285,215.61344849295494,3
2020-08-07-170606,170606,2,0,6,552,0.8571428571428571,171.56991420854064,4
2020-08-08-170606,170606,1,0,2,553,0.2857142857142857,217.6850988730974,5
2020-08-09-170606,170606,0,0,0,553,0.0,210.5402347075782,6
2020-08-10-170606,170606,0,0,6,553,0.7142857142857143,59.033486450287114,0
2020-08-11-170606,170606,11,0,1,564,0.7142857142857143,79.73051188385254,1
2020-08-12-170606,170606,2,0,3,566,0.14285714285714285,173.67156769643597,2
2020-08-13-170606,170606,4,0,8,570,0.0,240.51854803387587,3
2020-08-14-170606,170606,8,0,1,578,0.2857142857142857,375.6928797065796,4
2020-08-15-170606,170606,2,0,1,580,1.1428571428571428,495.68825161242523,5
2020-08-16-170606,170606,0,0,3,580,0.5714285714285714,549.6076621748829,6
2020-08-17-170606,170606,4,0,2,584,0.42857142857142855,534.2134832686106,0
2020-08-18-170606,170606,6,0,4,590,0.7142857142857143,587.0548943244307,1
2020-08-19-170606,170606,7,0,3,597,0.5714285714285714,579.1535170478778,2
2020-08-20-170606,170606,7,0,2,604,0.7142857142857143,480.8259190148942,3
2020-08-21-170606,170606,6,0,7,610,0.8571428571428571,464.2144378184815,4
2020-08-22-170606,170606,2,0,0,612,0.14285714285714285,461.36834225085937,5
2020-08-23-170606,170606,0,0,0,612,0.0,484.9694496341255,6
2020-08-24-170606,170606,6,0,0,618,0.5714285714285714,413.44057329599775,0
2020-08-25-170606,170606,1,0,0,619,0.14285714285714285,396.89143364740477,1
2020-08-26-170606,170606,3,0,4,622,0.5714285714285714,325.0245118914536,2
2020-08-27-170606,170606,8,0,12,630,0.42857142857142855,379.38040527741316,3
2020-08-28-170606,170606,1,0,2,631,0.7142857142857143,399.1267855773343,4
2020-08-29-170606,170606,1,0,0,632,1.5714285714285714,390.75097546314095,5
2020-08-30-170606,170606,3,0,2,635,0.5714285714285714,417.89939102785456,6
2020-08-31-170606,170606,2,1,10,637,0.8571428571428571,365.79604562784886,0
2020-09-01-170606,170606,4,0,3,641,2.4285714285714284,162.99494097744955,1
2020-09-02-170606,170606,3,0,0,644,1.8571428571428568,306.2728522703321,2
2020-09-03-170606,170606,2,0,5,646,1.5714285714285714,288.62474365981956,3
2020-09-04-170606,170606,7,0,1,653,0.14285714285714285,306.06270021699066,4
2020-09-05-170606,170606,0,0,2,653,1.1428571428571428,341.26577224447215,5
2020-09-06-170606,170606,0,0,2,653,0.8571428571428571,280.49009229127546,6
2020-09-07-170606,170606,0,0,3,653,1.8571428571428568,291.75672247120514,0
2020-09-08-170606,170606,0,0,3,653,0.8571428571428571,295.2380856976413,1
2020-09-09-170606,170606,4,0,0,657,0.2857142857142857,287.92070312236876,2
2020-09-10-170606,170606,12,0,4,669,0.42857142857142855,177.53518646529528,3
2020-09-11-170606,170606,2,0,1,671,0.5714285714285714,326.3439271816075,4
2020-09-12-170606,170606,0,0,4,671,0.42857142857142855,338.8522767001341,5
2020-09-13-170606,170606,2,1,0,673,0.14285714285714285,334.5524788410666,6
2020-09-14-170606,170606,10,0,2,683,0.8571428571428571,279.2818059894608,0
2020-09-15-170606,170606,3,0,2,686,0.2857142857142857,304.9894477478851,1
2020-09-16-170606,170606,0,0,3,686,0.2857142857142857,351.96111065471314,2
2020-09-17-170606,170606,5,0,6,691,0.42857142857142855,288.01713756660433,3
2020-09-18-170606,170606,1,0,3,692,1.8571428571428568,203.77802850755478,4
2020-09-19-170606,170606,2,0,3,694,0.5714285714285714,241.2387563147605,5
2020-09-20-170606,170606,2,1,0,696,0.42857142857142855,321.4482315039883,6
2020-09-21-170606,170606,3,0,3,699,0.42857142857142855,306.15606413759696,0
2020-09-22-170606,170606,3,0,0,702,0.42857142857142855,321.007535985136,1
2020-09-23-170606,170606,0,0,5,702,0.7142857142857143,359.51715618754747,2
2020-09-24-170606,170606,4,1,2,706,0.8571428571428571,302.7506404706899,3
2020-09-25-170606,170606,1,1,4,707,0.8571428571428571,318.66059144592793,4
2020-09-26-170606,170606,4,0,2,711,0.42857142857142855,309.20516517196603,5
2020-09-27-170606,170606,0,0,3,711,0.2857142857142857,300.3119695958893,6
2020-09-28-170606,170606,2,0,3,713,0.14285714285714285,292.60671529099807,0
2020-09-29-170606,170606,2,0,2,715,0.7142857142857143,269.66526675085777,1
2020-09-30-170606,170606,3,0,5,718,0.7142857142857143,293.4744468580202,2
2020-10-01-170606,170606,6,0,0,724,0.8571428571428571,0.0,3
2020-10-02-170606,170606,3,0,7,727,0.42857142857142855,503.4556898788542,4
2020-10-03-170606,170606,3,0,4,730,0.0,774.8711469349953,5
2020-10-04-170606,170606,0,0,0,730,0.5714285714285714,883.4610333602592,6
2020-10-05-170606,170606,3,1,8,733,0.42857142857142855,730.8115992005753,0
2020-10-06-170606,170606,0,0,3,733,1.4285714285714286,651.2461004731131,1
2020-10-07-170606,170606,5,1,5,738,1.1428571428571428,487.60240503324064,2
2020-10-08-170606,170606,2,1,3,740,0.0,499.9048460878811,3
2020-10-09-170606,170606,4,0,10,744,1.0,543.9887443717303,4
2020-10-10-170606,170606,2,0,0,746,0.0,88.5364084561094,5
2020-10-11-170606,170606,3,0,0,749,0.2857142857142857,131.97371225181502,6
2020-10-12-170606,170606,3,0,12,752,0.0,182.34201123663905,0
2020-10-13-170606,170606,2,0,8,754,0.42857142857142855,218.47301449649666,1
2020-10-14-170606,170606,5,0,8,759,0.42857142857142855,279.693148087964,2
2020-10-15-170606,170606,0,0,4,759,0.2857142857142857,373.6623270748497,3
2020-10-16-170606,170606,7,0,5,766,0.8571428571428571,422.9891355136763,4
2020-10-17-170606,170606,4,0,11,770,0.14285714285714285,445.40426849207745,5
2020-10-18-170606,170606,0,0,5,770,0.8571428571428571,444.37007168405313,6
2020-10-19-170606,170606,8,0,4,778,0.8571428571428571,404.2902612673682,0
2020-10-20-170606,170606,3,0,8,781,0.5714285714285714,469.2746390814232,1
2020-10-21-170606,170606,5,0,13,786,0.42857142857142855,450.6416886651016,2
2020-10-22-170606,170606,3,1,7,789,1.4285714285714286,465.494529357729,3
2020-10-23-170606,170606,10,0,14,799,0.7142857142857143,428.77765651442616,4
2020-10-24-170606,170606,0,2,3,799,0.42857142857142855,516.8772990442374,5
2020-10-25-170606,170606,0,0,9,799,0.42857142857142855,515.0945431141095,6
2020-10-26-170606,170606,12,0,12,811,0.2857142857142857,421.76309116076817,0
2020-10-27-170606,170606,8,2,3,819,0.7142857142857143,544.9969091901996,1
2020-10-28-170606,170606,8,1,5,827,1.7142857142857142,601.8298621816579,2
2020-10-29-170606,170606,4,0,8,831,0.2857142857142857,717.245839409858,3
2020-10-30-170606,170606,5,0,14,836,1.1428571428571428,645.9465925712925,4
2020-10-31-170606,170606,11,2,0,847,0.42857142857142855,760.9887629948341,5
2020-11-01-170606,170606,5,1,0,852,1.0,457.6701551421766,6
2020-11-02-170606,170606,4,0,0,856,0.14285714285714285,523.3178487939521,0
2020-11-03-170606,170606,8,1,0,864,1.2857142857142858,500.06623507847235,1
2020-11-04-170606,170606,13,0,0,877,1.5714285714285714,633.1372902312934,2
2020-11-05-170606,170606,7,0,0,884,0.42857142857142855,747.8809080718241,3
2020-11-06-170606,170606,14,4,0,898,1.5714285714285714,715.9013304380339,4
2020-11-07-170606,170606,3,1,0,901,0.7142857142857143,805.5485484559147,5
2020-11-08-170606,170606,9,0,0,910,0.2857142857142857,776.7797815356549,6
2020-11-09-170606,170606,12,1,0,922,0.7142857142857143,800.2979508094813,0
2020-11-10-170606,170606,3,1,0,925,1.0,377.9062025651132,1
2020-11-11-170606,170606,5,4,0,930,1.8571428571428568,432.42880731163456,2
2020-11-12-170606,170606,8,1,0,938,0.7142857142857143,467.63395883231584,3
2020-11-13-170606,170606,14,2,0,952,0.8571428571428571,590.7196646744618,4
2020-03-01-170607,170607,0,0,12,0,0.0,0.0,6
2020-03-02-170607,170607,1,0,16,1,0.16666666666666666,251.54664844930454,0
2020-03-03-170607,170607,1,0,18,2,0.0,1212.2997642237788,1
2020-03-04-170607,170607,0,0,23,2,0.0,1336.824974339163,2
2020-03-05-170607,170607,1,0,30,3,0.0,1376.9711921558858,3
2020-03-06-170607,170607,1,0,32,4,0.3333333333333333,1177.202859079445,4
2020-03-07-170607,170607,0,0,16,4,0.0,1241.284262329142,5
2020-03-08-170607,170607,0,0,15,4,0.16666666666666666,1155.3160329104421,6
2020-03-09-170607,170607,0,0,57,4,0.6666666666666666,1144.513564434033,0
2020-03-10-170607,170607,0,0,30,4,0.3333333333333333,1960.4744806724607,1
2020-03-11-170607,170607,4,0,32,8,1.5,1437.6250139920944,2
2020-03-12-170607,170607,2,0,33,10,1.0,1128.4834245567656,3
2020-03-13-170607,170607,5,0,34,15,2.333333333333333,752.3933907438525,4
2020-03-14-170607,170607,6,0,12,21,2.1666666666666665,737.4597050211406,5
2020-03-15-170607,170607,12,0,13,33,7.166666666666668,690.0871784490812,6
2020-03-16-170607,170607,16,0,25,49,11.5,506.84098915230334,0
2020-03-17-170607,170607,18,0,18,67,16.0,800.1931182095709,1
2020-03-18-170607,170607,23,0,19,90,13.666666666666664,1084.3889548576526,2
2020-03-19-170607,170607,30,0,9,120,15.333333333333336,1244.4710287162477,3
2020-03-20-170607,170607,32,0,19,152,19.666666666666668,1319.544754712145,4
2020-03-21-170607,170607,16,0,4,168,5.333333333333333,1464.7121884354444,5
2020-03-22-170607,170607,15,0,3,183,8.166666666666666,1394.5433490215662,6
2020-03-23-170607,170607,57,0,19,240,25.5,1311.6973705671871,0
2020-03-24-170607,170607,30,0,5,270,23.66666666666667,1489.4424395480446,1
2020-03-25-170607,170607,32,0,10,302,25.5,1601.0036257471922,2
2020-03-26-170607,170607,33,0,9,335,24.33333333333333,1739.825265170699,3
2020-03-27-170607,170607,34,0,10,369,23.66666666666667,2075.6631917602176,4
2020-03-28-170607,170607,12,0,2,381,8.333333333333334,2116.739679526844,5
2020-03-29-170607,170607,13,0,5,394,7.0,2094.243424386782,6
2020-03-30-170607,170607,25,0,10,419,17.166666666666668,1640.013718541505,0
2020-03-31-170607,170607,18,0,8,437,13.333333333333336,1568.7841848553542,1
2020-04-01-170607,170607,19,0,6,456,16.5,209.53583377677862,2
2020-04-02-170607,170607,9,0,8,465,8.333333333333334,582.6292635315504,3
2020-04-03-170607,170607,19,0,8,484,12.333333333333336,319.69351005959595,4
2020-04-04-170607,170607,4,0,2,488,3.6666666666666665,467.06030204734145,5
2020-04-05-170607,170607,3,0,1,491,3.8333333333333335,492.9603800273005,6
2020-04-06-170607,170607,19,0,20,510,12.166666666666664,527.5564933031598,0
2020-04-07-170607,170607,5,0,4,515,14.0,637.4637039697814,1
2020-04-08-170607,170607,10,0,3,525,7.0,698.688598402718,2
2020-04-09-170607,170607,9,2,1,534,4.166666666666667,749.8714352459953,3
2020-04-10-170607,170607,10,0,4,544,6.166666666666668,211.9784796102685,4
2020-04-11-170607,170607,2,0,1,546,2.333333333333333,299.05802192327684,5
2020-04-12-170607,170607,5,0,0,551,5.333333333333333,327.81040130131674,6
2020-04-13-170607,170607,10,0,6,561,8.0,367.74248328860773,0
2020-04-14-170607,170607,8,0,4,569,11.333333333333336,494.3641332998158,1
2020-04-15-170607,170607,6,0,2,575,4.333333333333333,593.9949256563177,2
2020-04-16-170607,170607,8,0,7,583,10.333333333333334,668.8075143178075,3
2020-04-17-170607,170607,8,0,0,591,9.166666666666666,611.7928698376347,4
2020-04-18-170607,170607,2,0,4,593,3.1666666666666665,634.1894048436766,5
2020-04-19-170607,170607,1,0,0,594,0.5,654.2412640502916,6
2020-04-20-170607,170607,20,0,13,614,4.666666666666667,614.431433397936,0
2020-04-21-170607,170607,4,0,7,618,9.833333333333334,649.7711705779182,1
2020-04-22-170607,170607,3,0,7,621,9.0,673.5497500477269,2
2020-04-23-170607,170607,1,0,4,622,1.1666666666666667,632.55841289858,3
2020-04-24-170607,170607,4,0,15,626,5.833333333333332,531.6927289121327,4
2020-04-25-170607,170607,1,0,2,627,2.1666666666666665,536.7030951240837,5
2020-04-26-170607,170607,0,0,1,627,0.3333333333333333,548.1714311661924,6
2020-04-27-170607,170607,6,0,11,633,5.333333333333333,443.4178074423284,0
2020-04-28-170607,170607,4,0,12,637,4.0,403.8574679184484,1
2020-04-29-170607,170607,2,0,5,639,7.0,353.2519788618587,2
2020-04-30-170607,170607,7,0,4,646,4.5,492.57899529752854,3
2020-05-01-170607,170607,0,0,5,646,3.333333333333333,692.9454094574257,4
2020-05-02-170607,170607,4,0,1,650,1.3333333333333333,284.2300840824496,5
2020-05-03-170607,170607,0,0,0,650,0.8333333333333334,185.01827836205695,6
2020-05-04-170607,170607,13,0,6,663,4.0,159.42270208723312,0
2020-05-05-170607,170607,7,0,1,670,4.833333333333333,217.2445723757803,1
2020-05-06-170607,170607,7,0,8,677,5.166666666666667,243.18982636314115,2
2020-05-07-170607,170607,4,0,4,681,4.0,314.46706939439855,3
2020-05-08-170607,170607,15,0,5,696,5.5,333.0754965180571,4
2020-05-09-170607,170607,2,0,0,698,1.3333333333333333,451.49550606709494,5
2020-05-10-170607,170607,1,0,0,699,0.5,755.9271110400434,6
2020-05-11-170607,170607,11,1,4,710,7.333333333333332,697.4714941077175,0
2020-05-12-170607,170607,12,6,3,722,10.333333333333334,738.9657263859867,1
2020-05-13-170607,170607,5,0,2,727,5.5,623.3270431126724,2
2020-05-14-170607,170607,4,0,1,731,3.0,567.6754191328444,3
2020-05-15-170607,170607,5,0,4,736,6.166666666666668,490.2880501320931,4
2020-05-16-170607,170607,1,0,0,737,0.6666666666666666,493.6627954706388,5
2020-05-17-170607,170607,0,0,0,737,0.16666666666666666,474.464509570319,6
2020-05-18-170607,170607,6,1,3,743,1.3333333333333333,474.9127560163361,0
2020-05-19-170607,170607,1,0,1,744,2.833333333333333,429.8792949669588,1
2020-05-20-170607,170607,8,0,3,752,1.8333333333333333,316.8348719874158,2
2020-05-21-170607,170607,4,0,2,756,2.833333333333333,322.26710777619775,3
2020-05-22-170607,170607,5,0,2,761,3.0,285.22228750101874,4
2020-05-23-170607,170607,0,0,0,761,0.0,337.8359150688498,5
2020-05-24-170607,170607,0,0,0,761,0.16666666666666666,339.33379205508237,6
2020-05-25-170607,170607,4,0,0,765,2.5,285.40295618305976,0
2020-05-26-170607,170607,3,0,1,768,2.1666666666666665,280.7866674045523,1
2020-05-27-170607,170607,2,0,2,770,1.6666666666666667,282.54586132431064,2
2020-05-28-170607,170607,1,0,2,771,1.6666666666666667,269.99442695852997,3
2020-05-29-170607,170607,4,0,0,775,3.0,248.07264042072657,4
2020-05-30-170607,170607,0,1,0,775,0.8333333333333334,258.8581787145166,5
2020-05-31-170607,170607,0,0,0,775,0.16666666666666666,263.3411486007251,6
2020-06-01-170607,170607,3,0,1,778,2.5,572.05092122837,0
2020-06-02-170607,170607,1,0,1,779,1.5,160.52406863615795,1
2020-06-03-170607,170607,3,0,2,782,1.8333333333333333,118.81359814207909,2
2020-06-04-170607,170607,2,0,1,784,1.6666666666666667,127.11643238353815,3
2020-06-05-170607,170607,2,1,3,786,0.8333333333333334,168.45026026217474,4
2020-06-06-170607,170607,0,0,0,786,0.0,186.09676048784303,5
2020-06-07-170607,170607,0,0,0,786,0.16666666666666666,186.8946169685874,6
2020-06-08-170607,170607,0,0,4,786,1.5,189.73800412922978,0
2020-06-09-170607,170607,1,0,2,787,1.6666666666666667,201.03808858510166,1
2020-06-10-170607,170607,2,0,1,789,1.3333333333333333,663.0948526453922,2
2020-06-11-170607,170607,2,0,0,791,3.333333333333333,580.1230555199938,3
2020-06-12-170607,170607,0,0,3,791,0.16666666666666666,552.9417671033102,4
2020-06-13-170607,170607,0,1,0,791,0.16666666666666666,410.4863440470297,5
2020-06-14-170607,170607,0,0,0,791,0.0,316.15922961162454,6
2020-06-15-170607,170607,1,1,2,792,1.3333333333333333,188.65483482364303,0
2020-06-16-170607,170607,1,0,0,793,3.6666666666666665,190.27026604124978,1
2020-06-17-170607,170607,2,1,1,795,2.333333333333333,156.35877683487456,2
2020-06-18-170607,170607,1,0,0,796,1.8333333333333333,150.75867191153245,3
2020-06-19-170607,170607,3,0,1,799,1.5,136.44869583640875,4
2020-06-20-170607,170607,0,0,0,799,0.0,218.88177206743853,5
2020-06-21-170607,170607,0,0,0,799,0.0,220.37186273750405,6
2020-06-22-170607,170607,4,0,0,803,1.0,192.527305270785,0
2020-06-23-170607,170607,2,0,0,805,1.5,198.40167581343945,1
2020-06-24-170607,170607,1,1,0,806,0.3333333333333333,199.99046234687304,2
2020-06-25-170607,170607,0,0,0,806,0.6666666666666666,178.88689339855014,3
2020-06-26-170607,170607,3,0,1,809,2.6666666666666665,154.20876537306893,4
2020-06-27-170607,170607,0,0,0,809,0.16666666666666666,144.06844828441268,5
2020-06-28-170607,170607,0,0,0,809,0.0,145.97576358307472,6
2020-06-29-170607,170607,2,0,1,811,1.3333333333333333,145.43756766497762,0
2020-06-30-170607,170607,0,0,0,811,0.5,145.8659929620325,1
2020-07-01-170607,170607,1,0,1,812,2.0,215.66266618081667,2
2020-07-02-170607,170607,0,0,1,812,0.5,73.60957959451756,3
2020-07-03-170607,170607,1,0,0,813,1.5,138.5833902591244,4
2020-07-04-170607,170607,0,0,0,813,0.0,181.96405315522298,5
2020-07-05-170607,170607,0,0,0,813,0.0,174.77654022647542,6
2020-07-06-170607,170607,0,0,1,813,0.16666666666666666,145.56363505213142,0
2020-07-07-170607,170607,0,1,1,813,0.8333333333333334,136.2181996165865,1
2020-07-08-170607,170607,0,0,0,813,0.3333333333333333,120.8942585531099,2
2020-07-09-170607,170607,0,0,1,813,0.6666666666666666,108.52606861372902,3
2020-07-10-170607,170607,1,0,0,814,0.3333333333333333,226.89818837437141,4
2020-07-11-170607,170607,0,0,0,814,0.0,174.00556351436933,5
2020-07-12-170607,170607,0,0,0,814,0.16666666666666666,120.20809986306811,6
2020-07-13-170607,170607,1,0,0,815,0.5,122.31917733527105,0
2020-07-14-170607,170607,0,0,2,815,0.16666666666666666,134.9474204948531,1
2020-07-15-170607,170607,1,0,0,816,0.5,113.8195149687057,2
2020-07-16-170607,170607,1,0,0,817,1.3333333333333333,83.39769811579134,3
2020-07-17-170607,170607,0,0,2,817,0.3333333333333333,72.20833728590362,4
2020-07-18-170607,170607,0,0,0,817,0.0,73.35163974048862,5
2020-07-19-170607,170607,0,0,1,817,0.0,73.12813781339678,6
2020-07-20-170607,170607,1,0,2,818,1.3333333333333333,61.140268983507056,0
2020-07-21-170607,170607,1,0,4,819,3.1666666666666665,68.7219578067598,1
2020-07-22-170607,170607,0,0,5,819,1.1666666666666667,114.9518445333016,2
2020-07-23-170607,170607,1,0,2,820,1.0,106.631624091617,3
2020-07-24-170607,170607,0,1,4,820,0.5,124.03421046416595,4
2020-07-25-170607,170607,0,0,2,820,0.16666666666666666,144.98688683420568,5
2020-07-26-170607,170607,0,0,0,820,0.5,145.94276009118983,6
2020-07-27-170607,170607,0,0,8,820,0.8333333333333334,145.77861086856853,0
2020-07-28-170607,170607,2,0,2,822,0.3333333333333333,151.55753409395587,1
2020-07-29-170607,170607,0,0,4,822,1.0,113.58051491022887,2
2020-07-30-170607,170607,0,0,1,822,1.3333333333333333,118.7429653387642,3
2020-07-31-170607,170607,2,0,2,824,3.0,137.3532491456439,4
2020-08-01-170607,170607,0,0,3,824,0.5,76.89716647206004,5
2020-08-02-170607,170607,1,0,0,825,1.1666666666666667,607.0288481584518,6
2020-08-03-170607,170607,2,0,8,827,3.333333333333333,933.4398298180611,0
2020-08-04-170607,170607,4,0,2,831,1.6666666666666667,862.3773745527017,1
2020-08-05-170607,170607,5,0,3,836,2.5,712.8401784657628,2
2020-08-06-170607,170607,2,0,5,838,2.5,669.7298028376321,3
2020-08-07-170607,170607,4,0,2,842,3.6666666666666665,527.192713877684,4
2020-08-08-170607,170607,2,0,0,844,1.6666666666666667,559.3259933096322,5
2020-08-09-170607,170607,0,0,0,844,0.8333333333333334,545.5165233128113,6
2020-08-10-170607,170607,8,0,10,852,3.6666666666666665,53.670826931184756,0
2020-08-11-170607,170607,2,0,5,854,3.333333333333333,126.37984391486543,1
2020-08-12-170607,170607,4,0,9,858,4.666666666666667,186.19029524994204,2
2020-08-13-170607,170607,1,1,2,859,4.0,261.22582845337814,3
2020-08-14-170607,170607,2,0,11,861,3.0,341.4009707672381,4
2020-08-15-170607,170607,3,0,2,864,1.3333333333333333,420.80275352668764,5
2020-08-16-170607,170607,0,0,2,864,1.8333333333333333,446.0285798306176,6
2020-08-17-170607,170607,8,0,15,872,4.666666666666667,465.3682997826005,0
2020-08-18-170607,170607,2,0,4,874,4.333333333333333,512.7244945402525,1
2020-08-19-170607,170607,3,0,1,877,5.333333333333333,519.6038807891978,2
2020-08-20-170607,170607,5,0,5,882,6.666666666666668,473.02767003429676,3
2020-08-21-170607,170607,2,0,9,884,4.166666666666667,508.1356350348831,4
2020-08-22-170607,170607,0,0,2,884,1.0,553.0847085994981,5
2020-08-23-170607,170607,0,0,1,884,2.5,549.4375489049224,6
2020-08-24-170607,170607,10,0,5,894,9.166666666666666,462.3178889276409,0
2020-08-25-170607,170607,5,0,4,899,6.333333333333332,545.1283161324262,1
2020-08-26-170607,170607,9,0,5,908,9.833333333333334,584.0155346986662,2
2020-08-27-170607,170607,2,0,7,910,7.0,742.6138755436525,3
2020-08-28-170607,170607,11,0,13,921,6.833333333333332,737.4619955463397,4
2020-08-29-170607,170607,2,0,0,923,1.8333333333333333,835.7613866758477,5
2020-08-30-170607,170607,2,0,0,925,2.6666666666666665,887.8458403983976,6
2020-08-31-170607,170607,15,0,7,940,6.666666666666668,781.5110946182215,0
2020-09-01-170607,170607,4,0,4,944,4.0,516.2896287971411,1
2020-09-02-170607,170607,1,0,5,945,3.0,813.5399721241881,2
2020-09-03-170607,170607,5,0,3,950,5.833333333333332,815.109821756477,3
2020-09-04-170607,170607,9,0,11,959,10.666666666666666,774.2045617508857,4
2020-09-05-170607,170607,2,0,3,961,3.6666666666666665,833.9642323602111,5
2020-09-06-170607,170607,1,0,5,962,2.333333333333333,866.8515551689078,6
2020-09-07-170607,170607,5,0,6,967,7.5,865.9746914255708,0
2020-09-08-170607,170607,4,0,11,971,1.3333333333333333,916.0017924533802,1
2020-09-09-170607,170607,5,0,4,976,5.333333333333333,820.3815496036696,2
2020-09-10-170607,170607,7,0,9,983,4.833333333333333,463.609824195715,3
2020-09-11-170607,170607,13,0,3,996,9.666666666666666,551.2288666866392,4
2020-09-12-170607,170607,0,0,3,996,1.8333333333333333,710.9800338210424,5
2020-09-13-170607,170607,0,0,5,996,1.3333333333333333,711.8713301570815,6
2020-09-14-170607,170607,7,0,2,1003,13.5,671.2046747165147,0
2020-09-15-170607,170607,4,0,6,1007,6.666666666666668,848.0410515240067,1
2020-09-16-170607,170607,5,0,6,1012,7.166666666666668,1000.0930141802822,2
2020-09-17-170607,170607,3,0,9,1015,8.333333333333334,997.2905320243051,3
2020-09-18-170607,170607,11,2,8,1026,12.833333333333336,1002.9776768632987,4
2020-09-19-170607,170607,3,0,2,1029,2.5,944.6124179804638,5
2020-09-20-170607,170607,5,2,6,1034,1.8333333333333333,989.6897049591182,6
2020-09-21-170607,170607,6,0,14,1040,11.5,830.3363318477966,0
2020-09-22-170607,170607,11,2,18,1051,14.666666666666664,902.1463465162409,1
2020-09-23-170607,170607,4,1,18,1055,13.333333333333336,997.0041723875366,2
2020-09-24-170607,170607,9,0,15,1064,9.5,1028.0048491373263,3
2020-09-25-170607,170607,3,0,21,1067,9.833333333333334,1002.6236157955532,4
2020-09-26-170607,170607,3,0,14,1070,2.0,1095.9175195226908,5
2020-09-27-170607,170607,5,0,11,1075,0.6666666666666666,1058.4900331231515,6
2020-09-28-170607,170607,2,0,9,1077,5.5,1063.2928651482312,0
2020-09-29-170607,170607,6,0,26,1083,5.333333333333333,1017.8510760107503,1
2020-09-30-170607,170607,6,1,18,1089,7.333333333333332,952.3606844108319,2
2020-10-01-170607,170607,9,0,23,1098,6.0,0.0,3
2020-10-02-170607,170607,8,0,28,1106,5.333333333333333,2223.784572080432,4
2020-10-03-170607,170607,2,1,12,1108,3.0,2721.4269442410123,5
2020-10-04-170607,170607,6,0,28,1114,1.6666666666666667,2409.011442543788,6
2020-10-05-170607,170607,14,0,42,1128,14.833333333333336,2012.9375073234896,0
2020-10-06-170607,170607,18,1,53,1146,6.5,1781.91096768855,1
2020-10-07-170607,170607,18,0,36,1164,9.0,1541.2855292297556,2
2020-10-08-170607,170607,15,1,44,1179,8.833333333333334,1502.2735640659528,3
2020-10-09-170607,170607,21,3,54,1200,11.333333333333336,1685.4172779751004,4
2020-10-10-170607,170607,14,0,10,1214,2.833333333333333,143.65253207964076,5
2020-10-11-170607,170607,11,0,45,1225,3.333333333333333,302.3550526515787,6
2020-10-12-170607,170607,9,0,32,1234,3.1666666666666665,437.0950059879615,0
2020-10-13-170607,170607,26,0,47,1260,10.666666666666666,546.2767694154231,1
2020-10-14-170607,170607,18,0,22,1278,9.833333333333334,902.156602494166,2
2020-10-15-170607,170607,23,0,19,1301,8.333333333333334,1216.6223114025963,3
2020-10-16-170607,170607,28,0,35,1329,14.666666666666664,1538.25633776746,4
2020-10-17-170607,170607,12,0,10,1341,2.0,1876.6901828895375,5
2020-10-18-170607,170607,28,0,8,1369,5.166666666666667,1831.5841207453268,6
2020-10-19-170607,170607,42,0,4,1411,12.666666666666664,1891.6285291682057,0
2020-10-20-170607,170607,53,0,18,1464,13.166666666666664,2053.125124062653,1
2020-10-21-170607,170607,36,2,24,1500,17.333333333333332,2163.3735462774275,2
2020-10-22-170607,170607,44,0,15,1544,16.166666666666668,2300.2002818210685,3
2020-10-23-170607,170607,54,0,11,1598,18.666666666666668,2344.3087251041807,4
2020-10-24-170607,170607,10,1,3,1608,3.5,2729.3433596046225,5
2020-10-25-170607,170607,45,0,6,1653,4.666666666666667,2656.69714155855,6
2020-10-26-170607,170607,32,0,20,1685,19.5,2455.4342539363415,0
2020-10-27-170607,170607,47,0,11,1732,14.166666666666664,2828.536396137188,1
2020-10-28-170607,170607,22,0,22,1754,14.833333333333336,2896.5793386581613,2
2020-10-29-170607,170607,19,0,15,1773,11.833333333333336,2873.042648993943,3
2020-10-30-170607,170607,35,0,11,1808,18.83333333333333,2220.728924281326,4
2020-10-31-170607,170607,10,0,0,1818,4.666666666666667,2519.7522328856944,5
2020-11-01-170607,170607,8,0,0,1826,5.333333333333333,1476.3753262889868,6
2020-11-02-170607,170607,4,0,0,1830,2.6666666666666665,775.0659535163427,0
2020-11-03-170607,170607,18,2,0,1848,17.333333333333332,717.9621895805888,1
2020-11-04-170607,170607,24,0,0,1872,14.166666666666664,1042.2795697194588,2
2020-11-05-170607,170607,15,0,0,1887,9.5,1293.6562305718444,3
2020-11-06-170607,170607,11,3,0,1898,10.666666666666666,1437.909435297958,4
2020-11-07-170607,170607,3,0,0,1901,3.0,1594.5850577685464,5
2020-11-08-170607,170607,6,1,0,1907,3.333333333333333,1540.4601239651656,6
2020-11-09-170607,170607,20,1,0,1927,13.166666666666664,1569.78966134993,0
2020-11-10-170607,170607,11,0,0,1938,7.666666666666668,1500.1625674486468,1
2020-11-11-170607,170607,22,1,0,1960,7.5,1638.7411397756894,2
2020-11-12-170607,170607,15,0,0,1975,6.666666666666668,1612.286754445812,3
2020-11-13-170607,170607,11,0,0,1986,5.666666666666668,1640.2577308727189,4
2020-03-01-170608,170608,0,0,0,0,0.0,0.0,6
2020-03-02-170608,170608,0,0,0,0,0.0,10.05318460277483,0
2020-03-03-170608,170608,0,0,1,0,0.0,52.65125013234052,1
2020-03-04-170608,170608,0,0,1,0,0.0,54.33033918291177,2
2020-03-05-170608,170608,0,0,2,0,0.2,52.574151575874275,3
2020-03-06-170608,170608,0,0,0,0,0.2,47.61968792596945,4
2020-03-07-170608,170608,0,0,0,0,0.0,51.15474658375294,5
2020-03-08-170608,170608,0,0,0,0,0.0,48.02368242618053,6
2020-03-09-170608,170608,0,0,3,0,0.0,48.294295705082604,0
2020-03-10-170608,170608,0,0,3,0,0.0,98.88392331573712,1
2020-03-11-170608,170608,0,0,2,0,0.2,75.85462626943387,2
2020-03-12-170608,170608,0,0,6,0,0.2,67.37705398813627,3
2020-03-13-170608,170608,0,0,3,0,0.4,44.061675227818796,4
2020-03-14-170608,170608,0,0,0,0,0.6,38.00680703126943,5
2020-03-15-170608,170608,0,0,2,0,1.4,32.99024717399958,6
2020-03-16-170608,170608,0,0,3,0,4.6,18.763890454866107,0
2020-03-17-170608,170608,1,0,2,1,3.6,32.79704483624788,1
2020-03-18-170608,170608,1,0,3,2,4.8,47.606824271790444,2
2020-03-19-170608,170608,2,0,25,4,3.8,59.728447074731925,3
2020-03-20-170608,170608,0,0,7,4,4.2,67.92950314027662,4
2020-03-21-170608,170608,0,0,4,4,1.2,72.3158262424765,5
2020-03-22-170608,170608,0,0,2,4,0.8,65.8427169334922,6
2020-03-23-170608,170608,3,0,0,7,6.0,59.898258127734366,0
2020-03-24-170608,170608,3,1,2,10,5.2,71.1507706905339,1
2020-03-25-170608,170608,2,0,2,12,6.0,74.27376836718437,2
2020-03-26-170608,170608,6,0,0,18,3.8,81.29335807410146,3
2020-03-27-170608,170608,3,0,1,21,3.4,101.52918173651271,4
2020-03-28-170608,170608,0,0,1,21,2.6,103.79178160150522,5
2020-03-29-170608,170608,2,0,0,23,1.6,105.43725913996025,6
2020-03-30-170608,170608,3,0,2,26,4.0,83.34800213830593,0
2020-03-31-170608,170608,2,0,0,28,3.2,78.94279628518008,1
2020-04-01-170608,170608,3,0,2,31,2.0,12.491828688598941,2
2020-04-02-170608,170608,25,0,1,56,2.4,41.95687705933439,3
2020-04-03-170608,170608,7,0,0,63,3.6,23.979310849991247,4
2020-04-04-170608,170608,4,0,0,67,0.8,33.96078138896826,5
2020-04-05-170608,170608,2,0,0,69,1.2,39.430402019344996,6
2020-04-06-170608,170608,0,0,18,69,3.6,43.751966703433965,0
2020-04-07-170608,170608,2,0,0,71,4.2,48.24077181364483,1
2020-04-08-170608,170608,2,0,0,73,1.6,48.42422274072005,2
2020-04-09-170608,170608,0,0,0,73,0.8,52.41444841304419,3
2020-04-10-170608,170608,1,1,3,74,1.2,10.266953005286435,4
2020-04-11-170608,170608,1,0,0,75,1.8,13.96310667069182,5
2020-04-12-170608,170608,0,0,0,75,1.2,14.644335628255872,6
2020-04-13-170608,170608,2,0,0,77,5.2,15.76638392534133,0
2020-04-14-170608,170608,0,1,2,77,1.6,28.708329815680575,1
2020-04-15-170608,170608,2,0,0,79,2.6,35.54543249731724,2
2020-04-16-170608,170608,1,0,0,80,0.8,42.161578964305605,3
2020-04-17-170608,170608,0,0,1,80,0.8,40.78845335108388,4
2020-04-18-170608,170608,0,0,0,80,1.8,41.85034073068232,5
2020-04-19-170608,170608,0,0,0,80,1.0,45.09439996338547,6
2020-04-20-170608,170608,18,0,2,98,2.2,70.83888852525443,0
2020-04-21-170608,170608,0,0,3,98,1.2,87.24215959882545,1
2020-04-22-170608,170608,0,0,0,98,0.8,84.60879617167294,2
2020-04-23-170608,170608,0,0,0,98,1.4,81.61134590226196,3
2020-04-24-170608,170608,3,0,0,101,0.2,77.88651535407696,4
2020-04-25-170608,170608,0,0,1,101,0.4,78.94127693220054,5
2020-04-26-170608,170608,0,0,0,101,0.2,78.43786477366399,6
2020-04-27-170608,170608,0,0,0,101,1.4,40.52499583722215,0
2020-04-28-170608,170608,2,0,2,103,1.8,20.54713199828974,1
2020-04-29-170608,170608,0,0,0,103,1.2,25.804215036989937,2
2020-04-30-170608,170608,0,0,0,103,0.8,38.199864325459245,3
2020-05-01-170608,170608,1,0,0,104,0.4,44.90833027151473,4
2020-05-02-170608,170608,0,0,0,104,0.8,14.084806782360015,5
2020-05-03-170608,170608,0,1,0,104,0.2,12.931548518595466,6
2020-05-04-170608,170608,2,0,2,106,2.4,11.438030965780857,0
2020-05-05-170608,170608,3,1,0,109,1.6,18.741413099431384,1
2020-05-06-170608,170608,0,0,0,109,1.6,23.547757930789707,2
2020-05-07-170608,170608,0,0,0,109,0.8,32.64113937543572,3
2020-05-08-170608,170608,0,0,0,109,0.4,36.55290141252257,4
2020-05-09-170608,170608,1,0,0,110,1.6,39.67883687219732,5
2020-05-10-170608,170608,0,0,0,110,0.4,50.91468310413947,6
2020-05-11-170608,170608,0,5,0,110,1.0,42.39584187223763,0
2020-05-12-170608,170608,2,1,0,112,0.8,41.90268605504,1
2020-05-13-170608,170608,0,0,0,112,1.2,36.888870385800274,2
2020-05-14-170608,170608,0,0,0,112,0.2,28.956751706140594,3
2020-05-15-170608,170608,0,0,0,112,0.4,23.027072075986162,4
2020-05-16-170608,170608,0,1,0,112,0.2,21.99823009072437,5
2020-05-17-170608,170608,0,0,0,112,0.2,19.75556242017544,6
2020-05-18-170608,170608,2,0,0,114,3.0,19.79365377690724,0
2020-05-19-170608,170608,0,0,1,114,0.4,22.121825210456,1
2020-05-20-170608,170608,0,0,0,114,0.6,17.963624557480912,2
2020-05-21-170608,170608,0,0,1,114,0.6,20.046677383412725,3
2020-05-22-170608,170608,0,0,0,114,0.8,20.388863515095494,4
2020-05-23-170608,170608,0,0,0,114,0.2,22.528615340771296,5
2020-05-24-170608,170608,0,0,0,114,0.4,22.92010835409378,6
2020-05-25-170608,170608,0,0,0,114,0.8,15.726973328594951,0
2020-05-26-170608,170608,0,0,0,114,0.0,16.35653791530015,1
2020-05-27-170608,170608,0,1,0,114,0.4,14.270888813346224,2
2020-05-28-170608,170608,0,0,0,114,0.6,15.123419227389975,3
2020-05-29-170608,170608,0,0,0,114,0.8,16.857158962457742,4
2020-05-30-170608,170608,0,0,0,114,0.2,20.37228454140015,5
2020-05-31-170608,170608,0,0,0,114,0.0,19.569529838453764,6
2020-06-01-170608,170608,0,0,1,114,0.4,59.66377765316756,0
2020-06-02-170608,170608,1,0,0,115,0.4,11.897042625953357,1
2020-06-03-170608,170608,0,0,0,115,0.2,12.47860617871393,2
2020-06-04-170608,170608,1,0,0,116,1.2,11.349466624106224,3
2020-06-05-170608,170608,0,4,0,116,0.6,16.92084992884199,4
2020-06-06-170608,170608,0,0,0,116,0.0,19.976970148384844,5
2020-06-07-170608,170608,0,0,0,116,0.2,19.99798626424581,6
2020-06-08-170608,170608,0,0,0,116,0.2,21.33045940115552,0
2020-06-09-170608,170608,0,0,0,116,0.0,17.77550732515702,1
2020-06-10-170608,170608,0,0,0,116,0.0,63.07071987505427,2
2020-06-11-170608,170608,0,0,0,116,0.8,52.48873163199478,3
2020-06-12-170608,170608,0,0,0,116,0.0,43.37400410886683,4
2020-06-13-170608,170608,0,0,0,116,0.2,27.10602520997953,5
2020-06-14-170608,170608,0,0,0,116,0.0,18.398927450605328,6
2020-06-15-170608,170608,1,0,0,117,0.2,14.233566221555774,0
2020-06-16-170608,170608,0,0,0,117,0.0,10.776641903339796,1
2020-06-17-170608,170608,0,0,0,117,0.2,8.763523895298256,2
2020-06-18-170608,170608,0,0,0,117,0.2,9.528548458466304,3
2020-06-19-170608,170608,0,0,0,117,0.6,9.758238293252465,4
2020-06-20-170608,170608,0,0,0,117,0.0,16.72938961586283,5
2020-06-21-170608,170608,0,0,0,117,0.0,16.475826699406007,6
2020-06-22-170608,170608,0,0,0,117,0.2,14.854402396455258,0
2020-06-23-170608,170608,0,0,0,117,0.6,17.734329085115434,1
2020-06-24-170608,170608,0,0,0,117,0.0,19.455702206127626,2
2020-06-25-170608,170608,0,1,0,117,0.4,17.210438046036103,3
2020-06-26-170608,170608,0,0,0,117,0.2,15.763109486449029,4
2020-06-27-170608,170608,0,0,0,117,0.0,11.643022471189681,5
2020-06-28-170608,170608,0,0,0,117,0.4,11.856501155923294,6
2020-06-29-170608,170608,0,0,0,117,0.4,12.702162257181177,0
2020-06-30-170608,170608,0,0,0,117,0.0,12.345181180283873,1
2020-07-01-170608,170608,0,0,0,117,0.0,18.260872991939426,2
2020-07-02-170608,170608,0,0,2,117,0.2,10.098103288652075,3
2020-07-03-170608,170608,0,0,0,117,0.2,10.877667831442562,4
2020-07-04-170608,170608,0,0,0,117,0.0,14.2636726764769,5
2020-07-05-170608,170608,0,0,0,117,0.2,13.797696705683235,6
2020-07-06-170608,170608,0,0,0,117,0.0,14.38696088819892,0
2020-07-07-170608,170608,0,0,0,117,0.2,12.023104872491041,1
2020-07-08-170608,170608,0,0,0,117,0.0,10.354683245665596,2
2020-07-09-170608,170608,0,0,0,117,0.0,8.124916681164423,3
2020-07-10-170608,170608,0,0,0,117,0.0,18.299400510894696,4
2020-07-11-170608,170608,0,0,0,117,0.0,10.65757494892064,5
2020-07-12-170608,170608,0,0,0,117,0.2,6.157915972472667,6
2020-07-13-170608,170608,0,0,0,117,0.2,8.982491913599414,0
2020-07-14-170608,170608,0,0,0,117,0.2,8.130566895399667,1
2020-07-15-170608,170608,0,0,0,117,0.0,10.400844195026254,2
2020-07-16-170608,170608,2,0,0,119,0.4,8.89111025543702,3
2020-07-17-170608,170608,0,0,2,119,0.0,13.382329316307375,4
2020-07-18-170608,170608,0,0,1,119,0.0,13.112254321455264,5
2020-07-19-170608,170608,0,0,0,119,0.0,13.28007481430194,6
2020-07-20-170608,170608,0,0,0,119,0.0,9.71686578306125,0
2020-07-21-170608,170608,0,0,0,119,0.2,6.777035036022977,1
2020-07-22-170608,170608,0,0,0,119,0.0,8.644772143576063,2
2020-07-23-170608,170608,0,0,0,119,0.0,4.492424253453502,3
2020-07-24-170608,170608,0,0,2,119,0.4,7.473431664679087,4
2020-07-25-170608,170608,0,0,0,119,0.2,8.516650798907701,5
2020-07-26-170608,170608,0,0,0,119,0.0,8.686371023048057,6
2020-07-27-170608,170608,0,0,3,119,0.0,8.71045754838663,0
2020-07-28-170608,170608,0,0,1,119,0.4,8.866511497803883,1
2020-07-29-170608,170608,0,0,0,119,0.2,9.708963663154686,2
2020-07-30-170608,170608,0,0,0,119,0.2,10.289875730859483,3
2020-07-31-170608,170608,2,0,0,121,0.0,10.881037180765121,4
2020-08-01-170608,170608,1,0,0,122,0.8,6.931030531519366,5
2020-08-02-170608,170608,0,0,1,122,0.0,60.89741554310096,6
2020-08-03-170608,170608,0,0,0,122,0.4,75.12003452045082,0
2020-08-04-170608,170608,0,0,2,122,0.2,67.76483510095157,1
2020-08-05-170608,170608,0,0,0,122,0.0,58.565630031264405,2
2020-08-06-170608,170608,0,1,1,122,0.2,52.34697125520168,3
2020-08-07-170608,170608,2,0,0,124,1.4,40.47945953206292,4
2020-08-08-170608,170608,0,0,0,124,0.6,43.76265816155425,5
2020-08-09-170608,170608,0,0,0,124,0.2,44.806991799346235,6
2020-08-10-170608,170608,3,0,2,127,0.2,10.158680409025145,0
2020-08-11-170608,170608,1,0,0,128,2.2,27.492078650159172,1
2020-08-12-170608,170608,0,0,0,128,0.8,37.44796404220217,2
2020-08-13-170608,170608,0,0,0,128,1.6,42.80700918122001,3
2020-08-14-170608,170608,0,0,0,128,2.0,52.32619156071918,4
2020-08-15-170608,170608,0,0,0,128,0.6,59.9678941482267,5
2020-08-16-170608,170608,1,0,1,129,0.6,63.67090771406824,6
2020-08-17-170608,170608,0,0,0,129,2.0,61.64625162981871,0
2020-08-18-170608,170608,2,0,1,131,1.6,58.018868831101706,1
2020-08-19-170608,170608,0,0,0,131,1.4,60.24198268070098,2
2020-08-20-170608,170608,1,0,2,132,1.8,52.909283149282395,3
2020-08-21-170608,170608,0,0,0,132,1.8,57.51000817353233,4
2020-08-22-170608,170608,0,0,0,132,0.8,61.99497509756887,5
2020-08-23-170608,170608,0,0,0,132,0.6,61.155113785022024,6
2020-08-24-170608,170608,2,0,0,134,2.4,49.74644159711522,0
2020-08-25-170608,170608,0,0,4,134,1.6,48.315651257253606,1
2020-08-26-170608,170608,0,0,0,134,1.2,52.849667546784445,2
2020-08-27-170608,170608,0,1,1,134,2.2,64.08617669185693,3
2020-08-28-170608,170608,0,0,1,134,0.8,60.778352201142596,4
2020-08-29-170608,170608,0,0,0,134,2.8,64.83484447587536,5
2020-08-30-170608,170608,1,0,0,135,0.8,72.65813028791729,6
2020-08-31-170608,170608,0,0,0,135,2.2,66.13133305505595,0
2020-09-01-170608,170608,1,0,0,136,4.4,36.68354111426459,1
2020-09-02-170608,170608,0,0,1,136,3.4,55.55648173724651,2
2020-09-03-170608,170608,2,0,0,138,2.2,77.69167465008242,3
2020-09-04-170608,170608,0,0,0,138,1.4,77.95958780846834,4
2020-09-05-170608,170608,0,0,0,138,1.6,77.3295798216567,5
2020-09-06-170608,170608,0,0,0,138,1.0,70.95081268988463,6
2020-09-07-170608,170608,0,0,2,138,2.0,70.56545647303741,0
2020-09-08-170608,170608,4,0,0,142,0.2,75.72174065026684,1
2020-09-09-170608,170608,0,0,1,142,1.2,72.05003879901358,2
2020-09-10-170608,170608,1,0,1,143,2.8,42.72824705353216,3
2020-09-11-170608,170608,1,0,3,144,1.0,52.59113861518977,4
2020-09-12-170608,170608,0,0,1,144,0.6,60.384103463514876,5
2020-09-13-170608,170608,0,0,1,144,0.8,60.31325806042202,6
2020-09-14-170608,170608,0,0,1,144,2.6,51.74949011065598,0
2020-09-15-170608,170608,0,0,1,144,0.6,58.53999935011326,1
2020-09-16-170608,170608,1,0,2,145,0.0,63.07676600187655,2
2020-09-17-170608,170608,0,0,1,145,1.6,50.36009651527742,3
2020-09-18-170608,170608,0,0,1,145,0.6,46.187260633624916,4
2020-09-19-170608,170608,0,0,0,145,0.6,53.30097585696971,5
2020-09-20-170608,170608,0,0,0,145,0.6,60.57078485662416,6
2020-09-21-170608,170608,2,0,0,147,1.8,55.04611916330042,0
2020-09-22-170608,170608,0,0,7,147,1.8,68.564237955718,1
2020-09-23-170608,170608,1,0,3,148,0.4,86.86149470796875,2
2020-09-24-170608,170608,1,0,0,149,1.0,87.6365350529062,3
2020-09-25-170608,170608,3,0,2,152,0.8,87.46023433618268,4
2020-09-26-170608,170608,1,0,0,153,1.2,93.21707850788192,5
2020-09-27-170608,170608,1,0,0,154,0.2,92.48291315286522,6
2020-09-28-170608,170608,1,0,0,155,0.4,93.45789030770064,0
2020-09-29-170608,170608,1,0,0,156,1.4,81.64119346900944,1
2020-09-30-170608,170608,2,0,0,158,1.6,76.9503128136239,2
2020-10-01-170608,170608,1,0,1,159,2.8,0.0,3
2020-10-02-170608,170608,1,0,0,160,1.4,117.0606217531209,4
2020-10-03-170608,170608,0,0,0,160,0.6,165.64523369607002,5
2020-10-04-170608,170608,0,0,1,160,0.6,147.19324889960782,6
2020-10-05-170608,170608,0,1,0,160,1.4,130.2373932605847,0
2020-10-06-170608,170608,7,0,1,167,0.6,116.94165517112415,1
2020-10-07-170608,170608,3,0,1,170,2.2,104.98474620048582,2
2020-10-08-170608,170608,0,0,4,170,0.4,94.18802807085567,3
2020-10-09-170608,170608,2,0,1,172,1.8,97.7377268691616,4
2020-10-10-170608,170608,0,0,1,172,0.4,16.041058653378627,5
2020-10-11-170608,170608,0,0,2,172,0.6,21.38449211231279,6
2020-10-12-170608,170608,0,0,0,172,0.6,26.396108820288692,0
2020-10-13-170608,170608,0,0,1,172,2.0,30.52095107053351,1
2020-10-14-170608,170608,0,0,5,172,2.6,49.230941234430134,2
2020-10-15-170608,170608,1,0,0,173,0.4,67.46573950827897,3
2020-10-16-170608,170608,0,0,2,173,3.2,79.52535629940249,4
2020-10-17-170608,170608,0,0,0,173,1.2,85.31030562683817,5
2020-10-18-170608,170608,1,0,0,174,0.8,83.11512725569304,6
2020-10-19-170608,170608,0,0,0,174,4.2,82.13673904725444,0
2020-10-20-170608,170608,1,0,0,175,1.6,96.5489334090681,1
2020-10-21-170608,170608,1,0,3,176,1.4,102.61682735383934,2
2020-10-22-170608,170608,4,0,0,180,2.0,103.54062689470639,3
2020-10-23-170608,170608,1,0,3,181,3.4,108.20862114023703,4
2020-10-24-170608,170608,1,0,1,182,0.4,125.59381811067257,5
2020-10-25-170608,170608,2,1,0,184,0.2,128.95331920565582,6
2020-10-26-170608,170608,0,0,3,184,3.8,117.94669971165942,0
2020-10-27-170608,170608,1,0,0,185,3.2,132.44626108878637,1
2020-10-28-170608,170608,5,0,0,190,2.4,134.67184861776764,2
2020-10-29-170608,170608,0,0,0,190,3.2,147.3146413187747,3
2020-10-30-170608,170608,2,1,0,192,2.0,128.60348869070273,4
2020-10-31-170608,170608,0,0,0,192,2.2,145.5408697628996,5
2020-11-01-170608,170608,0,0,0,192,1.2,87.19558270684212,6
2020-11-02-170608,170608,0,0,0,192,1.2,46.645767179677975,0
2020-11-03-170608,170608,0,1,0,192,2.2,52.95530132946118,1
2020-11-04-170608,170608,3,0,0,195,3.4,65.99335782467611,2
2020-11-05-170608,170608,0,0,0,195,2.2,85.20460929062564,3
2020-11-06-170608,170608,3,0,0,198,4.4,86.56653241490937,4
2020-11-07-170608,170608,1,0,0,199,0.6,98.79889540383132,5
2020-11-08-170608,170608,0,0,0,199,2.0,96.09121978407788,6
2020-11-09-170608,170608,3,0,0,202,2.6,91.47323312908644,0
2020-11-10-170608,170608,0,0,0,202,1.4,81.48750294227085,1
2020-11-11-170608,170608,0,1,0,202,1.8,86.97039575569781,2
2020-11-12-170608,170608,0,0,0,202,1.6,89.29084753457795,3
2020-11-13-170608,170608,0,0,0,202,2.8,87.66166973894747,4
2020-03-01-170609,170609,0,0,0,0,0.0,0.0,6
2020-03-02-170609,170609,0,0,0,0,0.0,4.407251183916279,0
2020-03-03-170609,170609,0,0,1,0,0.0,17.609184813853524,1
2020-03-04-170609,170609,0,0,1,0,0.0,17.765226905990964,2
2020-03-05-170609,170609,0,0,0,0,0.0,19.458871280438974,3
2020-03-06-170609,170609,0,0,0,0,0.0,18.896810561869728,4
2020-03-07-170609,170609,0,1,0,0,0.0,17.770638954788364,5
2020-03-08-170609,170609,0,0,0,0,0.0,16.813265214176614,6
2020-03-09-170609,170609,0,0,1,0,0.0,16.838911348817973,0
2020-03-10-170609,170609,0,0,0,0,0.0,44.12433540572667,1
2020-03-11-170609,170609,0,0,0,0,0.0,35.48583080978482,2
2020-03-12-170609,170609,0,0,0,0,0.0,32.044927406845744,3
2020-03-13-170609,170609,0,0,0,0,0.0,21.253825800993447,4
2020-03-14-170609,170609,0,0,1,0,0.3333333333333333,15.055411027060826,5
2020-03-15-170609,170609,0,0,0,0,1.3333333333333333,10.30271809405397,6
2020-03-16-170609,170609,0,0,1,0,6.666666666666668,3.1551621298094377,0
2020-03-17-170609,170609,1,0,0,1,4.0,11.825326509398097,1
2020-03-18-170609,170609,1,0,0,2,5.0,17.048730363312508,2
2020-03-19-170609,170609,0,0,0,2,4.666666666666667,21.96157545518279,3
2020-03-20-170609,170609,0,1,1,2,6.666666666666668,25.27060700182733,4
2020-03-21-170609,170609,0,0,0,2,1.6666666666666667,27.992632245886494,5
2020-03-22-170609,170609,0,0,0,2,1.3333333333333333,25.428640835125748,6
2020-03-23-170609,170609,1,0,1,3,8.666666666666666,20.610990444447893,0
2020-03-24-170609,170609,0,0,0,3,7.666666666666668,25.170903956011127,1
2020-03-25-170609,170609,0,0,0,3,8.333333333333334,25.790105955937378,2
2020-03-26-170609,170609,0,0,0,3,5.333333333333333,27.849260843515932,3
2020-03-27-170609,170609,0,0,0,3,4.333333333333333,32.00117210705763,4
2020-03-28-170609,170609,1,0,0,4,3.6666666666666665,30.789667414833662,5
2020-03-29-170609,170609,0,0,0,4,2.333333333333333,31.904217076144796,6
2020-03-30-170609,170609,1,0,0,5,4.333333333333333,24.64761346316899,0
2020-03-31-170609,170609,0,0,0,5,4.333333333333333,22.58997107359827,1
2020-04-01-170609,170609,0,0,0,5,2.333333333333333,4.18717581369451,2
2020-04-02-170609,170609,0,1,0,5,2.333333333333333,16.18308441724732,3
2020-04-03-170609,170609,1,0,0,6,4.0,7.67919986539928,4
2020-04-04-170609,170609,0,0,0,6,1.0,11.29210681689639,5
2020-04-05-170609,170609,0,0,2,6,1.6666666666666667,11.818607656137596,6
2020-04-06-170609,170609,1,0,1,7,5.666666666666668,12.558312684868186,0
2020-04-07-170609,170609,0,1,0,7,5.666666666666668,18.93620316451709,1
2020-04-08-170609,170609,0,0,0,7,3.0,21.91644198902469,2
2020-04-09-170609,170609,0,0,0,7,1.0,22.646038158580172,3
2020-04-10-170609,170609,0,0,0,7,1.6666666666666667,2.131555280755888,4
2020-04-11-170609,170609,0,0,0,7,3.0,3.854251552483597,5
2020-04-12-170609,170609,0,0,0,7,1.6666666666666667,5.683379112218367,6
2020-04-13-170609,170609,0,1,1,7,6.666666666666668,6.907766106821262,0
2020-04-14-170609,170609,0,0,1,7,0.6666666666666666,11.422970012713655,1
2020-04-15-170609,170609,0,0,0,7,3.333333333333333,12.077177854327951,2
2020-04-16-170609,170609,0,0,0,7,1.0,14.341410145596232,3
2020-04-17-170609,170609,0,0,0,7,1.3333333333333333,14.886253608087147,4
2020-04-18-170609,170609,0,0,0,7,2.6666666666666665,14.566558069260898,5
2020-04-19-170609,170609,2,0,0,9,1.3333333333333333,15.896140542782122,6
2020-04-20-170609,170609,1,0,0,10,2.0,15.139072437467618,0
2020-04-21-170609,170609,0,0,0,10,2.0,17.80832356692833,1
2020-04-22-170609,170609,0,0,1,10,1.3333333333333333,16.82236945258624,2
2020-04-23-170609,170609,0,0,0,10,2.0,16.281757587064142,3
2020-04-24-170609,170609,0,0,0,10,0.3333333333333333,16.375432822503427,4
2020-04-25-170609,170609,0,0,0,10,0.6666666666666666,13.68545620166099,5
2020-04-26-170609,170609,0,0,0,10,0.3333333333333333,11.09270766749964,6
2020-04-27-170609,170609,1,0,0,11,2.333333333333333,8.755790635398743,0
2020-04-28-170609,170609,1,0,0,12,0.6666666666666666,8.359653950739839,1
2020-04-29-170609,170609,0,0,0,12,1.0,8.317118119162533,2
2020-04-30-170609,170609,0,0,0,12,1.0,12.453741988632553,3
2020-05-01-170609,170609,0,0,2,12,0.6666666666666666,20.75395361736238,4
2020-05-02-170609,170609,0,0,0,12,0.3333333333333333,18.363913050116157,5
2020-05-03-170609,170609,0,0,0,12,0.3333333333333333,6.678396376472914,6
2020-05-04-170609,170609,0,0,4,12,4.0,5.601953499305356,0
2020-05-05-170609,170609,0,0,0,12,2.6666666666666665,9.682701237595552,1
2020-05-06-170609,170609,1,0,0,13,2.333333333333333,12.658445378931171,2
2020-05-07-170609,170609,0,0,0,13,1.3333333333333333,13.639394940721981,3
2020-05-08-170609,170609,0,0,0,13,0.6666666666666666,16.12625813051179,4
2020-05-09-170609,170609,0,0,0,13,2.6666666666666665,16.915541325478294,5
2020-05-10-170609,170609,0,0,0,13,0.6666666666666666,25.238320349156112,6
2020-05-11-170609,170609,0,0,0,13,2.333333333333333,24.35412642698001,0
2020-05-12-170609,170609,0,0,0,13,1.0,25.63433978487883,1
2020-05-13-170609,170609,0,0,0,13,1.6666666666666667,15.795735687572675,2
2020-05-14-170609,170609,0,0,1,13,0.0,14.21492071957964,3
2020-05-15-170609,170609,2,0,0,15,0.6666666666666666,11.743602624409958,4
2020-05-16-170609,170609,0,0,0,15,0.6666666666666666,13.759764274136277,5
2020-05-17-170609,170609,0,0,0,15,0.3333333333333333,15.247503019663176,6
2020-05-18-170609,170609,4,0,0,19,5.666666666666668,15.469248752738578,0
2020-05-19-170609,170609,0,0,0,19,0.6666666666666666,23.65271756539494,1
2020-05-20-170609,170609,0,0,0,19,0.3333333333333333,19.12522937410278,2
2020-05-21-170609,170609,0,0,0,19,1.0,19.209136637554547,3
2020-05-22-170609,170609,0,0,0,19,1.3333333333333333,16.825249856728416,4
2020-05-23-170609,170609,0,0,0,19,0.3333333333333333,16.35609078093108,5
2020-05-24-170609,170609,0,0,0,19,0.3333333333333333,16.668878573000057,6
2020-05-25-170609,170609,0,0,0,19,1.3333333333333333,4.9622996753233055,0
2020-05-26-170609,170609,0,0,0,19,0.0,5.642868634073216,1
2020-05-27-170609,170609,0,0,0,19,1.0,5.570744783626308,2
2020-05-28-170609,170609,1,0,0,20,1.6666666666666667,5.824103247910603,3
2020-05-29-170609,170609,0,0,0,20,1.0,9.972718767875802,4
2020-05-30-170609,170609,0,0,0,20,0.3333333333333333,10.1128256439607,5
2020-05-31-170609,170609,0,0,0,20,0.0,9.879294765087021,6
2020-06-01-170609,170609,0,0,0,20,0.6666666666666666,24.836918956065904,0
2020-06-02-170609,170609,0,1,0,20,0.3333333333333333,3.117607307500407,1
2020-06-03-170609,170609,0,0,0,20,0.0,3.0847610561243695,2
2020-06-04-170609,170609,0,0,0,20,1.6666666666666667,2.463953097528,3
2020-06-05-170609,170609,0,0,1,20,0.6666666666666666,3.8871027051557525,4
2020-06-06-170609,170609,0,0,0,20,0.0,4.511583234685391,5
2020-06-07-170609,170609,0,0,0,20,0.0,4.590416811290351,6
2020-06-08-170609,170609,0,1,0,20,0.3333333333333333,3.7659554705050287,0
2020-06-09-170609,170609,0,0,0,20,0.0,4.230405725765235,1
2020-06-10-170609,170609,0,0,0,20,0.0,27.134951363344804,2
2020-06-11-170609,170609,0,0,0,20,1.0,20.890146794083268,3
2020-06-12-170609,170609,0,0,0,20,0.0,17.86693461089991,4
2020-06-13-170609,170609,0,3,0,20,0.3333333333333333,11.45758195273254,5
2020-06-14-170609,170609,0,0,0,20,0.0,8.2152977430562,6
2020-06-15-170609,170609,0,0,0,20,0.0,7.0930830694235745,0
2020-06-16-170609,170609,0,0,0,20,0.0,3.3205023997476277,1
2020-06-17-170609,170609,0,0,0,20,0.0,2.2845094463260502,2
2020-06-18-170609,170609,0,0,0,20,0.0,2.2908063269712247,3
2020-06-19-170609,170609,1,0,0,21,0.6666666666666666,0.8232037910049007,4
2020-06-20-170609,170609,0,0,0,21,0.0,3.5593048069957227,5
2020-06-21-170609,170609,0,0,0,21,0.0,3.604006418169148,6
2020-06-22-170609,170609,0,0,0,21,0.0,3.5355404521172487,0
2020-06-23-170609,170609,0,0,0,21,0.3333333333333333,3.5612019900403866,1
2020-06-24-170609,170609,0,0,0,21,0.3333333333333333,4.082132650765872,2
2020-06-25-170609,170609,0,0,0,21,0.3333333333333333,4.123452869727044,3
2020-06-26-170609,170609,0,0,0,21,0.3333333333333333,2.6350103310438535,4
2020-06-27-170609,170609,0,0,0,21,0.0,2.5878224066680886,5
2020-06-28-170609,170609,0,0,0,21,0.6666666666666666,2.6367541926622784,6
2020-06-29-170609,170609,0,0,0,21,0.0,3.676100567603646,0
2020-06-30-170609,170609,0,0,1,21,0.0,3.158710445511648,1
2020-07-01-170609,170609,0,0,0,21,0.0,4.893791996477348,2
2020-07-02-170609,170609,0,0,0,21,0.3333333333333333,2.9572802834547445,3
2020-07-03-170609,170609,0,0,0,21,0.0,4.806589462099735,4
2020-07-04-170609,170609,0,0,0,21,0.0,1.151843889589809,5
2020-07-05-170609,170609,0,0,0,21,0.6666666666666666,1.1525388895189077,6
2020-07-06-170609,170609,0,0,0,21,0.0,1.8090780842656824,0
2020-07-07-170609,170609,0,0,0,21,0.3333333333333333,1.2444233176912733,1
2020-07-08-170609,170609,0,0,0,21,0.0,1.7178290532239082,2
2020-07-09-170609,170609,0,1,0,21,0.0,1.6513283340886924,3
2020-07-10-170609,170609,0,0,0,21,0.0,5.229023485805038,4
2020-07-11-170609,170609,0,0,0,21,0.0,2.3199999566898586,5
2020-07-12-170609,170609,0,0,0,21,0.0,0.9128684527074402,6
2020-07-13-170609,170609,0,0,0,21,0.3333333333333333,0.9615799781561223,0
2020-07-14-170609,170609,1,0,0,22,0.0,1.5280014005605593,1
2020-07-15-170609,170609,0,0,1,22,0.0,2.4343159538506245,2
2020-07-16-170609,170609,0,0,1,22,0.3333333333333333,2.3259694192421674,3
2020-07-17-170609,170609,0,0,0,22,0.0,2.912139336836369,4
2020-07-18-170609,170609,0,2,0,22,0.0,2.9926512625334882,5
2020-07-19-170609,170609,0,0,0,22,0.0,3.0373707982911085,6
2020-07-20-170609,170609,0,0,0,22,0.0,3.018777403162383,0
2020-07-21-170609,170609,0,0,0,22,0.3333333333333333,1.4520845910669142,1
2020-07-22-170609,170609,0,0,0,22,0.0,2.144401413415868,2
2020-07-23-170609,170609,0,0,0,22,1.0,1.4526479179172775,3
2020-07-24-170609,170609,0,0,0,22,0.6666666666666666,3.994885273655326,4
2020-07-25-170609,170609,0,0,0,22,0.3333333333333333,5.160915555146129,5
2020-07-26-170609,170609,0,0,0,22,0.0,5.744842757854777,6
2020-07-27-170609,170609,0,0,1,22,0.3333333333333333,5.211666391620031,0
2020-07-28-170609,170609,0,0,1,22,0.3333333333333333,5.216847979670385,1
2020-07-29-170609,170609,1,0,0,23,0.0,5.115605864669252,2
2020-07-30-170609,170609,1,0,0,24,1.0,2.76486554317443,3
2020-07-31-170609,170609,0,0,0,24,0.0,1.6809948157570722,4
2020-08-01-170609,170609,0,0,0,24,0.3333333333333333,1.7379181076823365,5
2020-08-02-170609,170609,0,0,0,24,0.0,46.83811187427361,6
2020-08-03-170609,170609,0,0,1,24,0.6666666666666666,23.790233401116026,0
2020-08-04-170609,170609,0,0,1,24,0.0,21.388835569427464,1
2020-08-05-170609,170609,0,0,4,24,0.0,17.577847059552283,2
2020-08-06-170609,170609,0,0,2,24,0.3333333333333333,10.23523862862342,3
2020-08-07-170609,170609,0,0,0,24,1.3333333333333333,10.184995525079552,4
2020-08-08-170609,170609,0,0,0,24,0.3333333333333333,15.050385303430446,5
2020-08-09-170609,170609,0,0,0,24,0.0,14.696971551174853,6
2020-08-10-170609,170609,1,0,0,25,0.0,2.78042179654347,0
2020-08-11-170609,170609,1,0,0,26,4.0,5.291223873386872,1
2020-08-12-170609,170609,0,0,1,26,0.6666666666666666,11.687848758949196,2
2020-08-13-170609,170609,0,0,0,26,1.3333333333333333,15.235843983356997,3
2020-08-14-170609,170609,0,0,0,26,2.6666666666666665,24.003935096601836,4
2020-08-15-170609,170609,0,0,0,26,2.0,30.134266201502413,5
2020-08-16-170609,170609,0,0,0,26,0.3333333333333333,41.71033460894331,6
2020-08-17-170609,170609,1,0,0,27,1.3333333333333333,40.37300955635753,0
2020-08-18-170609,170609,1,0,1,28,2.333333333333333,43.65102008073977,1
2020-08-19-170609,170609,4,0,1,32,2.333333333333333,43.259076619281764,2
2020-08-20-170609,170609,2,0,0,34,2.333333333333333,41.93237405487126,3
2020-08-21-170609,170609,0,0,0,34,2.333333333333333,44.31002361745628,4
2020-08-22-170609,170609,0,0,0,34,0.6666666666666666,35.17415555780547,5
2020-08-23-170609,170609,0,0,0,34,0.0,35.45405505090312,6
2020-08-24-170609,170609,0,0,0,34,2.0,30.557734298343433,0
2020-08-25-170609,170609,0,0,0,34,0.3333333333333333,27.42806265266222,1
2020-08-26-170609,170609,1,0,0,35,1.3333333333333333,19.843569626887515,2
2020-08-27-170609,170609,0,0,1,35,3.0,24.144172952493015,3
2020-08-28-170609,170609,0,0,0,35,1.0,23.475900138982563,4
2020-08-29-170609,170609,0,0,0,35,0.3333333333333333,23.22184337363929,5
2020-08-30-170609,170609,0,0,0,35,1.3333333333333333,23.820514077633966,6
2020-08-31-170609,170609,0,0,1,35,0.6666666666666666,21.1640368902755,0
2020-09-01-170609,170609,1,0,2,36,1.6666666666666667,10.767553007725024,1
2020-09-02-170609,170609,1,0,0,37,1.3333333333333333,23.020072988177706,2
2020-09-03-170609,170609,0,0,1,37,1.0,13.408564690724113,3
2020-09-04-170609,170609,0,0,0,37,2.333333333333333,16.22059515661435,4
2020-09-05-170609,170609,0,0,2,37,0.0,17.830605905154947,5
2020-09-06-170609,170609,0,0,0,37,0.0,15.817534781634627,6
2020-09-07-170609,170609,0,0,0,37,0.6666666666666666,18.182740418971708,0
2020-09-08-170609,170609,0,0,0,37,0.3333333333333333,20.33700244674173,1
2020-09-09-170609,170609,0,0,1,37,1.3333333333333333,18.564445884082435,2
2020-09-10-170609,170609,1,0,0,38,4.0,13.296427022679646,3
2020-09-11-170609,170609,0,0,0,38,0.6666666666666666,21.263858987394723,4
2020-09-12-170609,170609,0,0,0,38,0.0,21.631966982483103,5
2020-09-13-170609,170609,0,0,0,38,0.6666666666666666,20.129505145258925,6
2020-09-14-170609,170609,1,0,0,39,4.0,16.012379555942598,0
2020-09-15-170609,170609,2,0,1,41,1.0,19.973710685325006,1
2020-09-16-170609,170609,0,0,1,41,0.3333333333333333,23.004740499767248,2
2020-09-17-170609,170609,1,0,1,42,1.6666666666666667,19.36311281936239,3
2020-09-18-170609,170609,0,0,0,42,0.3333333333333333,15.543329825956551,4
2020-09-19-170609,170609,2,0,0,44,0.6666666666666666,17.178205216744328,5
2020-09-20-170609,170609,0,0,0,44,1.3333333333333333,24.009880026801916,6
2020-09-21-170609,170609,0,0,0,44,1.0,20.019332860466164,0
2020-09-22-170609,170609,0,0,0,44,1.0,18.66131883987764,1
2020-09-23-170609,170609,1,0,0,45,0.0,18.406026554587783,2
2020-09-24-170609,170609,0,0,0,45,1.3333333333333333,14.529599331301707,3
2020-09-25-170609,170609,0,0,0,45,0.6666666666666666,15.022373960120621,4
2020-09-26-170609,170609,0,0,0,45,1.3333333333333333,12.320366633010716,5
2020-09-27-170609,170609,0,0,2,45,0.0,10.726796688853426,6
2020-09-28-170609,170609,0,0,0,45,0.6666666666666666,10.2704984662472,0
2020-09-29-170609,170609,1,0,0,46,1.0,9.682137198972525,1
2020-09-30-170609,170609,1,0,0,47,1.0,14.896711597006494,2
2020-10-01-170609,170609,1,0,0,48,2.0,0.0,3
2020-10-02-170609,170609,0,0,2,48,1.3333333333333333,22.984492841521885,4
2020-10-03-170609,170609,0,0,0,48,1.0,43.822663868876994,5
2020-10-04-170609,170609,0,0,0,48,0.0,53.516395255802,6
2020-10-05-170609,170609,0,0,1,48,1.6666666666666667,44.59428456167787,0
2020-10-06-170609,170609,0,0,0,48,0.3333333333333333,42.2331666067589,1
2020-10-07-170609,170609,0,0,0,48,1.6666666666666667,29.214115327268004,2
2020-10-08-170609,170609,0,0,0,48,0.6666666666666666,29.377392984698062,3
2020-10-09-170609,170609,0,2,0,48,2.0,31.465859675369384,4
2020-10-10-170609,170609,0,0,0,48,0.6666666666666666,5.02699538531734,5
2020-10-11-170609,170609,2,0,0,50,1.0,6.839622588534172,6
2020-10-12-170609,170609,0,0,0,50,1.0,14.26366171186475,0
2020-10-13-170609,170609,0,0,1,50,0.6666666666666666,16.009231450593703,1
2020-10-14-170609,170609,0,0,5,50,2.0,18.26088770377354,2
2020-10-15-170609,170609,0,0,0,50,0.0,22.171888752661264,3
2020-10-16-170609,170609,2,0,0,52,2.333333333333333,23.84248542883575,4
2020-10-17-170609,170609,0,0,3,52,1.3333333333333333,24.489856020320087,5
2020-10-18-170609,170609,0,0,6,52,0.0,23.83118125679542,6
2020-10-19-170609,170609,1,0,0,53,3.0,17.6163020447956,0
2020-10-20-170609,170609,0,0,1,53,1.3333333333333333,21.515812974387572,1
2020-10-21-170609,170609,0,0,1,53,2.0,23.809690032900896,2
2020-10-22-170609,170609,0,0,0,53,1.0,24.30906582882864,3
2020-10-23-170609,170609,0,0,0,53,3.6666666666666665,21.344772731030503,4
2020-10-24-170609,170609,0,0,0,53,0.0,24.63930437131156,5
2020-10-25-170609,170609,0,0,0,53,0.0,24.643099727958052,6
2020-10-26-170609,170609,0,0,0,53,4.333333333333333,18.992404882000155,0
2020-10-27-170609,170609,1,0,0,54,2.6666666666666665,26.72387823082888,1
2020-10-28-170609,170609,5,1,0,59,3.0,27.35791674126549,2
2020-10-29-170609,170609,0,0,0,59,1.3333333333333333,37.61229864751886,3
2020-10-30-170609,170609,0,0,0,59,1.6666666666666667,37.62623891425487,4
2020-10-31-170609,170609,3,0,0,62,3.6666666666666665,44.22842351647919,5
2020-11-01-170609,170609,6,1,0,68,1.6666666666666667,27.47157195613805,6
2020-11-02-170609,170609,0,0,0,68,1.3333333333333333,26.103836544575547,0
2020-11-03-170609,170609,1,0,0,69,4.333333333333333,24.976091471390756,1
2020-11-04-170609,170609,1,0,0,70,4.666666666666667,39.91393294747065,2
2020-11-05-170609,170609,0,0,0,70,2.333333333333333,44.30769467339181,3
2020-11-06-170609,170609,0,0,0,70,6.333333333333332,43.226272111829594,4
2020-11-07-170609,170609,0,0,0,70,2.333333333333333,47.67741774384318,5
2020-11-08-170609,170609,0,0,0,70,3.333333333333333,47.357689216950135,6
2020-11-09-170609,170609,0,0,0,70,4.333333333333333,47.66657888949818,0
2020-11-10-170609,170609,0,0,0,70,1.6666666666666667,24.56249900365181,1
2020-11-11-170609,170609,0,0,0,70,4.666666666666667,26.79478252877532,2
2020-11-12-170609,170609,0,0,0,70,4.333333333333333,25.765204962746065,3
2020-11-13-170609,170609,0,0,0,70,6.666666666666668,31.39810366704458,4
2020-03-01-170610,170610,0,0,0,0,0.0,0.0,6
2020-03-02-170610,170610,0,0,0,0,0.0,5.385177575113662,0
2020-03-03-170610,170610,0,1,1,0,0.0,22.42092205428373,1
2020-03-04-170610,170610,0,1,0,0,0.0,23.09955464262779,2
2020-03-05-170610,170610,0,0,0,0,0.0,24.235526884801796,3
2020-03-06-170610,170610,0,0,0,0,0.0,23.70384436754052,4
2020-03-07-170610,170610,0,0,0,0,0.0,23.695284191115377,5
2020-03-08-170610,170610,0,0,0,0,0.0,22.996906837244225,6
2020-03-09-170610,170610,0,1,1,0,0.0,22.94517305848832,0
2020-03-10-170610,170610,0,0,0,0,0.0,61.98924733270126,1
2020-03-11-170610,170610,0,0,0,0,0.0,48.74859515027751,2
2020-03-12-170610,170610,0,0,0,0,0.0,42.469415862844606,3
2020-03-13-170610,170610,0,0,0,0,0.0,27.661594416754816,4
2020-03-14-170610,170610,0,0,0,0,0.3333333333333333,22.114718966068327,5
2020-03-15-170610,170610,0,0,0,0,1.6666666666666667,15.008952855785802,6
2020-03-16-170610,170610,0,0,0,0,6.666666666666668,5.312007568786375,0
2020-03-17-170610,170610,1,0,0,1,4.333333333333333,15.41865369349597,1
2020-03-18-170610,170610,0,0,0,1,5.333333333333333,22.933859996689165,2
2020-03-19-170610,170610,0,0,0,1,5.0,29.86677958524779,3
2020-03-20-170610,170610,0,0,0,1,6.666666666666668,33.95912220635509,4
2020-03-21-170610,170610,0,0,0,1,2.0,37.435929604381606,5
2020-03-22-170610,170610,0,0,0,1,1.3333333333333333,35.47258866471003,6
2020-03-23-170610,170610,1,0,0,2,8.666666666666666,29.475112120378157,0
2020-03-24-170610,170610,0,0,0,2,7.666666666666668,34.86791550160479,1
2020-03-25-170610,170610,0,0,1,2,8.666666666666666,37.38259525130052,2
2020-03-26-170610,170610,0,0,0,2,5.333333333333333,40.16063220016545,3
2020-03-27-170610,170610,0,0,0,2,5.0,46.61923105778736,4
2020-03-28-170610,170610,0,0,0,2,4.0,46.801125008513175,5
2020-03-29-170610,170610,0,0,0,2,2.333333333333333,46.75211898892817,6
2020-03-30-170610,170610,0,0,1,2,5.0,36.950059296215535,0
2020-03-31-170610,170610,0,0,0,2,4.0,33.251951781580075,1
2020-04-01-170610,170610,0,0,0,2,2.333333333333333,4.861516300939611,2
2020-04-02-170610,170610,0,0,0,2,2.6666666666666665,18.472415292112803,3
2020-04-03-170610,170610,0,0,0,2,4.333333333333333,8.76093940916861,4
2020-04-04-170610,170610,0,0,0,2,1.0,12.606795242237858,5
2020-04-05-170610,170610,0,0,0,2,1.6666666666666667,14.1296252968382,6
2020-04-06-170610,170610,0,0,0,2,4.666666666666667,15.643687758124818,0
2020-04-07-170610,170610,0,0,1,2,5.666666666666668,18.037572747285676,1
2020-04-08-170610,170610,1,0,0,3,2.6666666666666665,22.556895907555564,2
2020-04-09-170610,170610,0,0,0,3,1.0,24.50582430191012,3
2020-04-10-170610,170610,0,0,0,3,1.3333333333333333,3.4302608308153486,4
2020-04-11-170610,170610,0,0,0,3,3.0,4.562536269146239,5
2020-04-12-170610,170610,0,0,0,3,1.6666666666666667,6.3465284967769975,6
2020-04-13-170610,170610,1,0,0,4,6.333333333333332,7.668005876298235,0
2020-04-14-170610,170610,0,1,0,4,0.6666666666666666,14.263949860688014,1
2020-04-15-170610,170610,0,0,0,4,3.333333333333333,15.816673441609037,2
2020-04-16-170610,170610,0,0,0,4,0.6666666666666666,19.17929686985352,3
2020-04-17-170610,170610,0,0,0,4,1.3333333333333333,18.647765657569778,4
2020-04-18-170610,170610,0,0,0,4,2.6666666666666665,20.08862730926932,5
2020-04-19-170610,170610,0,0,0,4,2.333333333333333,21.225453127015705,6
2020-04-20-170610,170610,0,0,0,4,2.6666666666666665,24.063359126958524,0
2020-04-21-170610,170610,1,0,1,5,2.0,29.385908869522417,1
2020-04-22-170610,170610,0,0,1,5,1.3333333333333333,28.796213733741318,2
2020-04-23-170610,170610,0,0,0,5,2.0,28.158347362628675,3
2020-04-24-170610,170610,0,0,0,5,0.3333333333333333,26.734306542130682,4
2020-04-25-170610,170610,0,0,0,5,0.6666666666666666,24.216424188448507,5
2020-04-26-170610,170610,0,0,0,5,0.3333333333333333,21.997091230831266,6
2020-04-27-170610,170610,0,2,2,5,2.6666666666666665,13.735416063774721,0
2020-04-28-170610,170610,0,0,0,5,1.0,10.607528132869936,1
2020-04-29-170610,170610,0,0,0,5,1.0,9.500240405258031,2
2020-04-30-170610,170610,0,0,0,5,1.0,13.95778693096218,3
2020-05-01-170610,170610,0,0,0,5,0.6666666666666666,22.800603242021186,4
2020-05-02-170610,170610,0,0,0,5,0.3333333333333333,11.214300366427908,5
2020-05-03-170610,170610,0,0,0,5,0.3333333333333333,8.089985801540712,6
2020-05-04-170610,170610,0,0,1,5,3.6666666666666665,6.468641379752501,0
2020-05-05-170610,170610,1,0,0,6,2.333333333333333,9.869568287685588,1
2020-05-06-170610,170610,1,0,0,7,2.0,11.622054350131537,2
2020-05-07-170610,170610,0,0,0,7,1.0,14.90085761073172,3
2020-05-08-170610,170610,0,0,0,7,0.6666666666666666,16.074265337064958,4
2020-05-09-170610,170610,0,3,0,7,2.6666666666666665,17.345387313653475,5
2020-05-10-170610,170610,0,2,0,7,0.6666666666666666,25.77186608517878,6
2020-05-11-170610,170610,2,3,0,9,1.3333333333333333,23.93509635218039,0
2020-05-12-170610,170610,0,0,0,9,1.0,24.40335835940338,1
2020-05-13-170610,170610,0,0,3,9,1.3333333333333333,20.51604523157924,2
2020-05-14-170610,170610,0,0,1,9,0.0,15.361713596627517,3
2020-05-15-170610,170610,0,0,0,9,1.3333333333333333,12.004855348254678,4
2020-05-16-170610,170610,0,0,0,9,0.3333333333333333,11.868772789019728,5
2020-05-17-170610,170610,0,0,0,9,0.3333333333333333,11.788471039777422,6
2020-05-18-170610,170610,1,0,0,10,6.333333333333332,11.707820450483696,0
2020-05-19-170610,170610,0,0,0,10,0.6666666666666666,15.581808565311217,1
2020-05-20-170610,170610,0,0,0,10,0.3333333333333333,13.059389160143134,2
2020-05-21-170610,170610,0,0,0,10,1.0,13.667951775829941,3
2020-05-22-170610,170610,0,0,0,10,1.3333333333333333,13.397151433402493,4
2020-05-23-170610,170610,0,0,0,10,0.3333333333333333,14.356121809915662,5
2020-05-24-170610,170610,0,0,0,10,0.3333333333333333,14.38895755616118,6
2020-05-25-170610,170610,0,0,0,10,1.3333333333333333,7.232105236977335,0
2020-05-26-170610,170610,0,0,0,10,0.0,7.472791739879462,1
2020-05-27-170610,170610,3,0,0,13,0.0,7.096153035801508,2
2020-05-28-170610,170610,1,0,0,14,1.3333333333333333,8.945668581073804,3
2020-05-29-170610,170610,0,0,0,14,1.0,10.46310100543722,4
2020-05-30-170610,170610,0,0,0,14,0.3333333333333333,10.648239858362837,5
2020-05-31-170610,170610,0,0,0,14,0.0,10.1627161274784,6
2020-06-01-170610,170610,0,1,0,14,0.6666666666666666,26.340410978464078,0
2020-06-02-170610,170610,0,0,0,14,0.3333333333333333,2.880282462219847,1
2020-06-03-170610,170610,0,0,0,14,0.0,4.654182055205617,2
2020-06-04-170610,170610,0,0,0,14,1.6666666666666667,3.696643142486901,3
2020-06-05-170610,170610,0,0,0,14,1.0,5.645348975911924,4
2020-06-06-170610,170610,0,0,0,14,0.0,7.109248788754792,5
2020-06-07-170610,170610,0,0,0,14,0.0,7.135840879385812,6
2020-06-08-170610,170610,0,0,0,14,0.3333333333333333,6.489947030892761,0
2020-06-09-170610,170610,0,0,0,14,0.0,6.668926205012935,1
2020-06-10-170610,170610,0,0,1,14,0.0,28.75310308667134,2
2020-06-11-170610,170610,0,0,0,14,1.0,23.066647809950705,3
2020-06-12-170610,170610,0,0,0,14,0.0,19.894946958700796,4
2020-06-13-170610,170610,0,0,0,14,0.3333333333333333,12.11498398433873,5
2020-06-14-170610,170610,0,0,0,14,0.0,9.765569371578424,6
2020-06-15-170610,170610,0,0,0,14,0.0,8.4061391338085,0
2020-06-16-170610,170610,0,0,0,14,0.0,4.413357850266801,1
2020-06-17-170610,170610,0,0,0,14,0.0,3.268810240073524,2
2020-06-18-170610,170610,0,0,0,14,0.0,3.294248770013934,3
2020-06-19-170610,170610,0,0,0,14,1.0,1.7887864705879144,4
2020-06-20-170610,170610,0,0,0,14,0.0,3.8757625305827204,5
2020-06-21-170610,170610,0,0,1,14,0.0,3.928750922742911,6
2020-06-22-170610,170610,0,0,0,14,0.0,3.6254165411681676,0
2020-06-23-170610,170610,0,0,0,14,0.3333333333333333,3.9972775198654427,1
2020-06-24-170610,170610,1,0,0,15,0.0,4.719614932360708,2
2020-06-25-170610,170610,0,0,0,15,0.3333333333333333,5.177177602082473,3
2020-06-26-170610,170610,0,0,0,15,0.3333333333333333,4.710897296112471,4
2020-06-27-170610,170610,0,0,0,15,0.0,4.21085878216428,5
2020-06-28-170610,170610,0,0,0,15,0.6666666666666666,4.192017573767425,6
2020-06-29-170610,170610,0,0,0,15,0.0,5.361449938204598,0
2020-06-30-170610,170610,0,0,0,15,0.0,5.2982245656475655,1
2020-07-01-170610,170610,0,0,0,15,0.0,7.006326454543727,2
2020-07-02-170610,170610,0,0,0,15,0.3333333333333333,2.7097153614662592,3
2020-07-03-170610,170610,0,0,0,15,0.0,4.648453733029708,4
2020-07-04-170610,170610,0,0,0,15,0.0,2.7476338384584333,5
2020-07-05-170610,170610,1,0,0,16,0.3333333333333333,2.7148321876291437,6
2020-07-06-170610,170610,0,0,0,16,0.0,3.98448320384099,0
2020-07-07-170610,170610,0,0,0,16,0.3333333333333333,3.24355142143333,1
2020-07-08-170610,170610,0,1,0,16,0.0,3.4519346287184103,2
2020-07-09-170610,170610,0,0,2,16,0.0,3.1381257533555864,3
2020-07-10-170610,170610,0,0,0,16,0.0,7.567656740851723,4
2020-07-11-170610,170610,0,0,0,16,0.0,3.796085441922844,5
2020-07-12-170610,170610,0,0,0,16,0.0,1.3819322738672368,6
2020-07-13-170610,170610,0,0,1,16,0.3333333333333333,1.7282784482615812,0
2020-07-14-170610,170610,0,0,0,16,0.3333333333333333,2.158131799099856,1
2020-07-15-170610,170610,0,0,0,16,0.0,2.1248793405251396,2
2020-07-16-170610,170610,0,0,1,16,0.3333333333333333,1.921659796553762,3
2020-07-17-170610,170610,0,0,0,16,0.0,3.348513465692542,4
2020-07-18-170610,170610,0,0,0,16,0.0,3.3399156019504757,5
2020-07-19-170610,170610,0,0,0,16,0.0,3.2800312120643964,6
2020-07-20-170610,170610,0,0,0,16,0.0,2.8236886428606685,0
2020-07-21-170610,170610,0,0,0,16,0.3333333333333333,2.238387157208508,1
2020-07-22-170610,170610,0,0,0,16,0.0,3.080450321465247,2
2020-07-23-170610,170610,2,0,0,18,0.0,1.6663185170380115,3
2020-07-24-170610,170610,0,0,1,18,0.6666666666666666,3.6093246584768295,4
2020-07-25-170610,170610,0,0,0,18,0.3333333333333333,4.840881232237926,5
2020-07-26-170610,170610,0,0,0,18,0.0,5.414768515468361,6
2020-07-27-170610,170610,1,0,0,19,0.0,5.018102797859314,0
2020-07-28-170610,170610,0,0,1,19,0.3333333333333333,4.958348946681228,1
2020-07-29-170610,170610,0,0,0,19,0.3333333333333333,4.902788229689799,2
2020-07-30-170610,170610,1,0,0,20,0.6666666666666666,3.7254689080515497,3
2020-07-31-170610,170610,0,0,0,20,0.0,2.7363020995330003,4
2020-08-01-170610,170610,0,0,0,20,0.3333333333333333,3.22734428273896,5
2020-08-02-170610,170610,0,0,0,20,0.0,37.88821978798142,6
2020-08-03-170610,170610,0,1,0,20,0.6666666666666666,45.303920105412125,0
2020-08-04-170610,170610,0,0,1,20,0.0,45.91764441936195,1
2020-08-05-170610,170610,0,0,0,20,0.0,39.91290552285548,2
2020-08-06-170610,170610,0,0,0,20,0.0,33.008985782775305,3
2020-08-07-170610,170610,1,0,1,21,1.0,23.70848691053271,4
2020-08-08-170610,170610,0,0,0,21,0.6666666666666666,21.480249970967254,5
2020-08-09-170610,170610,0,0,0,21,0.0,21.970821866370102,6
2020-08-10-170610,170610,0,0,0,21,0.3333333333333333,4.613710877486145,0
2020-08-11-170610,170610,1,0,0,22,4.0,7.817964843898055,1
2020-08-12-170610,170610,0,0,1,22,1.0,13.134672693247282,2
2020-08-13-170610,170610,0,0,0,22,1.3333333333333333,17.25225460309232,3
2020-08-14-170610,170610,0,0,1,22,2.6666666666666665,25.067765528462186,4
2020-08-15-170610,170610,0,0,0,22,1.0,32.34450219135452,5
2020-08-16-170610,170610,0,0,1,22,0.6666666666666666,36.558359989754365,6
2020-08-17-170610,170610,0,0,0,22,2.0,37.36527779412041,0
2020-08-18-170610,170610,1,0,0,23,2.333333333333333,39.77813693291449,1
2020-08-19-170610,170610,0,0,1,23,3.6666666666666665,40.4543540744693,2
2020-08-20-170610,170610,0,0,0,23,3.333333333333333,34.16868932527905,3
2020-08-21-170610,170610,1,0,0,24,2.333333333333333,33.76220858878883,4
2020-08-22-170610,170610,0,0,0,24,1.0,34.7153330645649,5
2020-08-23-170610,170610,0,0,0,24,0.0,34.43377889127848,6
2020-08-24-170610,170610,0,0,0,24,2.6666666666666665,28.88624406379273,0
2020-08-25-170610,170610,0,0,0,24,0.6666666666666666,28.910375556189827,1
2020-08-26-170610,170610,1,0,0,25,1.6666666666666667,26.86535313710924,2
2020-08-27-170610,170610,0,0,0,25,3.0,35.40664086047217,3
2020-08-28-170610,170610,1,0,0,26,1.0,36.3421194382008,4
2020-08-29-170610,170610,0,0,0,26,4.0,41.257342643507386,5
2020-08-30-170610,170610,1,0,0,27,1.3333333333333333,49.92313794714366,6
2020-08-31-170610,170610,0,0,1,27,2.6666666666666665,45.211965015363084,0
2020-09-01-170610,170610,0,0,0,27,5.333333333333333,18.694262346460818,1
2020-09-02-170610,170610,1,0,0,28,5.0,23.99482780187053,2
2020-09-03-170610,170610,0,0,0,28,3.0,21.888862522083425,3
2020-09-04-170610,170610,0,0,0,28,2.333333333333333,27.797726956772294,4
2020-09-05-170610,170610,0,0,0,28,2.6666666666666665,28.782711213330657,5
2020-09-06-170610,170610,0,0,2,28,1.6666666666666667,26.973406506035992,6
2020-09-07-170610,170610,0,0,0,28,3.333333333333333,29.697794534484473,0
2020-09-08-170610,170610,0,0,0,28,0.0,34.72867620471579,1
2020-09-09-170610,170610,0,0,0,28,1.6666666666666667,34.32626233954097,2
2020-09-10-170610,170610,0,0,0,28,4.333333333333333,19.569466817957803,3
2020-09-11-170610,170610,0,0,1,28,1.3333333333333333,27.55946464299125,4
2020-09-12-170610,170610,0,0,0,28,1.0,29.027518293705757,5
2020-09-13-170610,170610,0,0,0,28,1.0,30.411285233882186,6
2020-09-14-170610,170610,1,0,0,29,4.333333333333333,25.76090879751949,0
2020-09-15-170610,170610,0,0,0,29,1.6666666666666667,28.825046495051804,1
2020-09-16-170610,170610,0,0,0,29,0.0,30.73770542976353,2
2020-09-17-170610,170610,0,0,0,29,2.6666666666666665,21.27486475155953,3
2020-09-18-170610,170610,0,0,1,29,0.3333333333333333,17.928843510648775,4
2020-09-19-170610,170610,0,0,0,29,1.6666666666666667,20.372903727507865,5
2020-09-20-170610,170610,2,0,0,31,1.0,29.586771083800123,6
2020-09-21-170610,170610,0,0,0,31,1.0,26.93491713927475,0
2020-09-22-170610,170610,0,0,1,31,1.3333333333333333,27.838922505293816,1
2020-09-23-170610,170610,0,0,0,31,0.6666666666666666,31.792570068170537,2
2020-09-24-170610,170610,0,0,0,31,1.3333333333333333,29.23620579705134,3
2020-09-25-170610,170610,1,0,2,32,0.3333333333333333,29.75840214341799,4
2020-09-26-170610,170610,0,0,0,32,1.6666666666666667,29.991064952798837,5
2020-09-27-170610,170610,0,0,0,32,0.0,22.723830882153983,6
2020-09-28-170610,170610,0,0,0,32,0.6666666666666666,22.243415305885293,0
2020-09-29-170610,170610,0,0,0,32,1.0,20.734263654264957,1
2020-09-30-170610,170610,0,0,1,32,1.6666666666666667,24.917078499722493,2
2020-10-01-170610,170610,0,0,0,32,2.6666666666666665,0.0,3
2020-10-02-170610,170610,1,0,0,33,1.0,42.55502455438442,4
2020-10-03-170610,170610,0,0,0,33,1.0,59.42681183768937,5
2020-10-04-170610,170610,0,0,0,33,0.0,61.36826295206215,6
2020-10-05-170610,170610,0,0,1,33,1.0,50.987713592136295,0
2020-10-06-170610,170610,1,0,0,34,0.0,44.91767939884879,1
2020-10-07-170610,170610,0,0,1,34,1.6666666666666667,34.41121201790551,2
2020-10-08-170610,170610,0,0,0,34,0.6666666666666666,35.25799340956155,3
2020-10-09-170610,170610,2,1,1,36,1.3333333333333333,38.05668104892216,4
2020-10-10-170610,170610,0,0,0,36,0.6666666666666666,6.828088800129034,5
2020-10-11-170610,170610,0,0,0,36,1.6666666666666667,10.00342995153644,6
2020-10-12-170610,170610,0,0,0,36,1.0,12.998271808748184,0
2020-10-13-170610,170610,0,0,0,36,1.6666666666666667,15.31046522551917,1
2020-10-14-170610,170610,1,0,0,37,2.0,22.812155630363872,2
2020-10-15-170610,170610,0,0,0,37,0.0,29.837660545261045,3
2020-10-16-170610,170610,0,0,0,37,3.0,34.967498131174466,4
2020-10-17-170610,170610,0,0,0,37,1.3333333333333333,35.4372129744497,5
2020-10-18-170610,170610,0,0,0,37,1.0,33.42753787008,6
2020-10-19-170610,170610,1,0,0,38,3.6666666666666665,33.44314479197949,0
2020-10-20-170610,170610,0,0,1,38,1.3333333333333333,37.8665790911067,1
2020-10-21-170610,170610,1,0,1,39,1.6666666666666667,36.93698383985158,2
2020-10-22-170610,170610,0,0,0,39,2.6666666666666665,38.43611443842018,3
2020-10-23-170610,170610,1,0,2,40,3.333333333333333,38.7994809711455,4
2020-10-24-170610,170610,0,0,2,40,0.0,46.87078044656448,5
2020-10-25-170610,170610,0,0,1,40,0.0,45.526437895241145,6
2020-10-26-170610,170610,0,0,1,40,4.333333333333333,38.01157465977778,0
2020-10-27-170610,170610,0,0,2,40,3.0,44.247820142991316,1
2020-10-28-170610,170610,0,0,9,40,4.666666666666667,47.39051993779364,2
2020-10-29-170610,170610,0,0,5,40,1.3333333333333333,55.803827757050584,3
2020-10-30-170610,170610,0,0,4,40,1.6666666666666667,45.98348157618979,4
2020-10-31-170610,170610,0,0,0,40,4.666666666666667,55.30290091631612,5
2020-11-01-170610,170610,0,0,0,40,3.6666666666666665,32.99287008077378,6
2020-11-02-170610,170610,0,0,0,40,1.3333333333333333,41.806275180307786,0
2020-11-03-170610,170610,1,0,0,41,3.333333333333333,39.07040599207489,1
2020-11-04-170610,170610,1,0,0,42,4.666666666666667,51.87819726643356,2
2020-11-05-170610,170610,0,0,0,42,2.6666666666666665,56.29320824561218,3
2020-11-06-170610,170610,2,0,0,44,5.0,55.95056408358542,4
2020-11-07-170610,170610,2,0,0,46,1.0,61.48488451036622,5
2020-11-08-170610,170610,1,1,0,47,3.0,58.11768936533714,6
2020-11-09-170610,170610,1,0,0,48,4.0,58.84261830757098,0
2020-11-10-170610,170610,2,0,0,50,1.0,28.626138201789402,1
2020-11-11-170610,170610,9,0,0,59,1.6666666666666667,30.63604730857667,2
2020-11-12-170610,170610,5,0,0,64,2.6666666666666665,37.853963861957354,3
2020-11-13-170610,170610,4,0,0,68,4.666666666666667,46.35878416003449,4
2020-03-01-170611,170611,0,0,12,0,0.25,0.0,6
2020-03-02-170611,170611,0,0,16,0,0.25,378.51230048575235,0
2020-03-03-170611,170611,0,0,25,0,0.0,1709.0806270932503,1
2020-03-04-170611,170611,0,0,22,0,0.0,1851.2187124008892,2
2020-03-05-170611,170611,0,0,21,0,0.0,1889.9512503936862,3
2020-03-06-170611,170611,0,0,32,0,0.75,1614.9195771140344,4
2020-03-07-170611,170611,0,0,12,0,0.0,1739.644058410728,5
2020-03-08-170611,170611,0,0,9,0,0.25,1663.813666015777,6
2020-03-09-170611,170611,0,0,31,0,1.0,1661.497398009098,0
2020-03-10-170611,170611,1,0,47,1,0.5,2763.4882428889855,1
2020-03-11-170611,170611,3,0,36,4,1.75,2049.6778899013116,2
2020-03-12-170611,170611,1,0,44,5,0.75,1616.7060279487007,3
2020-03-13-170611,170611,6,0,31,11,3.25,1084.2678810837442,4
2020-03-14-170611,170611,4,0,5,15,2.75,1065.9413994192453,5
2020-03-15-170611,170611,12,0,11,27,11.25,964.2294863121226,6
2020-03-16-170611,170611,16,0,29,43,19.25,717.6078801175081,0
2020-03-17-170611,170611,25,0,20,68,21.25,1157.6927261854332,1
2020-03-18-170611,170611,22,0,18,90,24.0,1572.67522993022,2
2020-03-19-170611,170611,21,0,15,111,22.5,1840.3351967953386,3
2020-03-20-170611,170611,32,0,17,143,24.75,1941.6596291742626,4
2020-03-21-170611,170611,12,0,8,155,11.75,2112.774085707704,5
2020-03-22-170611,170611,9,0,4,164,14.5,2019.4788262551158,6
2020-03-23-170611,170611,31,0,25,195,37.25,1885.73381617167,0
2020-03-24-170611,170611,47,0,10,242,33.75,2119.024147503101,1
2020-03-25-170611,170611,36,0,18,278,37.0,2315.2908111280994,2
2020-03-26-170611,170611,44,0,8,322,27.5,2499.811712344874,3
2020-03-27-170611,170611,31,0,12,353,31.5,2999.156074878337,4
2020-03-28-170611,170611,5,0,2,358,7.0,3037.407902972184,5
2020-03-29-170611,170611,11,0,5,369,8.0,2941.7286964854984,6
2020-03-30-170611,170611,29,0,14,398,22.25,2320.4226243600674,0
2020-03-31-170611,170611,20,0,11,418,20.25,2150.613712084517,1
2020-04-01-170611,170611,18,0,9,436,21.25,308.29641783239,2
2020-04-02-170611,170611,15,0,10,451,10.0,863.4643815684678,3
2020-04-03-170611,170611,17,0,9,468,14.5,480.83614410979413,4
2020-04-04-170611,170611,8,0,8,476,5.0,686.3524937421028,5
2020-04-05-170611,170611,4,0,2,480,6.0,724.137791433837,6
2020-04-06-170611,170611,25,1,27,505,17.75,772.3150534622267,0
2020-04-07-170611,170611,10,0,13,515,18.25,933.7263731047394,1
2020-04-08-170611,170611,18,0,4,533,14.75,1052.447641365875,2
2020-04-09-170611,170611,8,0,4,541,5.25,1162.745058314869,3
2020-04-10-170611,170611,12,1,1,553,9.25,305.80836669425867,4
2020-04-11-170611,170611,2,0,3,555,4.0,433.494094406832,5
2020-04-12-170611,170611,5,0,4,560,7.5,483.87727429281335,6
2020-04-13-170611,170611,14,0,16,574,10.75,551.3371617002845,0
2020-04-14-170611,170611,11,0,2,585,17.75,743.8247508746304,1
2020-04-15-170611,170611,9,0,4,594,5.25,920.889747822677,2
2020-04-16-170611,170611,10,0,6,604,6.0,1023.3732958877986,3
2020-04-17-170611,170611,9,0,1,613,8.5,901.6835298614942,4
2020-04-18-170611,170611,8,0,9,621,4.0,924.9363488377325,5
2020-04-19-170611,170611,2,0,0,623,2.5,949.7669963455601,6
2020-04-20-170611,170611,27,1,5,650,9.0,882.6615659845903,0
2020-04-21-170611,170611,13,0,3,663,13.5,916.7004779845973,1
2020-04-22-170611,170611,4,0,8,667,11.5,966.7601108692395,2
2020-04-23-170611,170611,4,0,3,671,2.25,952.9009752828265,3
2020-04-24-170611,170611,1,0,6,672,7.5,833.8321939986743,4
2020-04-25-170611,170611,3,0,1,675,3.25,825.9161677551373,5
2020-04-26-170611,170611,4,0,0,679,0.25,842.1821369476355,6
2020-04-27-170611,170611,16,0,5,695,6.5,696.575168218369,0
2020-04-28-170611,170611,2,0,11,697,5.75,632.6413234617887,1
2020-04-29-170611,170611,4,0,6,701,9.0,533.5461142152168,2
2020-04-30-170611,170611,6,0,5,707,5.5,719.099195824184,3
2020-05-01-170611,170611,1,0,9,708,4.5,1092.2048536680581,4
2020-05-02-170611,170611,9,0,1,717,3.0,421.0541887199505,5
2020-05-03-170611,170611,0,0,0,717,1.5,279.9736956776879,6
2020-05-04-170611,170611,5,0,6,722,6.25,234.2658506729438,0
2020-05-05-170611,170611,3,0,2,725,6.5,303.14359297715083,1
2020-05-06-170611,170611,8,0,7,733,4.75,327.2063078619959,2
2020-05-07-170611,170611,3,0,6,736,7.0,420.87069416634546,3
2020-05-08-170611,170611,6,0,7,742,9.25,471.7861135703838,4
2020-05-09-170611,170611,1,0,0,743,1.75,640.993629682044,5
2020-05-10-170611,170611,0,0,0,743,0.75,1235.1078391531435,6
2020-05-11-170611,170611,5,1,7,748,8.75,1137.1165692736472,0
2020-05-12-170611,170611,11,0,6,759,14.75,1185.3775789887964,1
2020-05-13-170611,170611,6,0,7,765,9.0,1021.5608646641247,2
2020-05-14-170611,170611,5,0,1,770,4.25,911.9759551868326,3
2020-05-15-170611,170611,9,0,4,779,8.0,755.6552934181899,4
2020-05-16-170611,170611,1,0,1,780,0.75,776.6481227636641,5
2020-05-17-170611,170611,0,0,0,780,0.25,741.289712497475,6
2020-05-18-170611,170611,6,0,8,786,3.5,740.1550332082893,0
2020-05-19-170611,170611,2,0,8,788,3.75,692.4804722072445,1
2020-05-20-170611,170611,7,0,4,795,2.5,493.0295100280746,2
2020-05-21-170611,170611,6,0,8,801,4.25,503.03027591550597,3
2020-05-22-170611,170611,7,0,8,808,4.0,441.48484669652015,4
2020-05-23-170611,170611,0,0,0,808,0.25,527.9904141580168,5
2020-05-24-170611,170611,0,1,0,808,0.25,535.108360229499,6
2020-05-25-170611,170611,7,0,5,815,4.5,448.39034902004767,0
2020-05-26-170611,170611,6,0,7,821,2.5,461.20344580344545,1
2020-05-27-170611,170611,7,0,4,828,2.0,450.8130095637921,2
2020-05-28-170611,170611,1,0,3,829,1.75,441.68442106296106,3
2020-05-29-170611,170611,4,0,1,833,2.0,408.43002188079976,4
2020-05-30-170611,170611,1,0,0,834,0.75,402.86561381579287,5
2020-05-31-170611,170611,0,0,0,834,0.0,412.96635031762077,6
2020-06-01-170611,170611,8,0,2,842,5.25,841.2666149871307,0
2020-06-02-170611,170611,8,0,1,850,2.5,238.78255695287913,1
2020-06-03-170611,170611,4,0,2,854,4.25,161.91097586914142,2
2020-06-04-170611,170611,8,0,1,862,3.0,189.88675978046786,3
2020-06-05-170611,170611,8,0,4,870,0.75,269.9738097945302,4
2020-06-06-170611,170611,0,0,0,870,0.0,303.21923236736365,5
2020-06-07-170611,170611,0,1,0,870,0.25,303.81202719718493,6
2020-06-08-170611,170611,5,1,6,875,1.75,307.29667524461996,0
2020-06-09-170611,170611,7,0,1,882,2.0,328.48197128156335,1
2020-06-10-170611,170611,4,0,1,886,1.5,999.4297461724889,2
2020-06-11-170611,170611,3,0,1,889,2.0,884.6112103517735,3
2020-06-12-170611,170611,1,0,0,890,0.25,837.288613619976,4
2020-06-13-170611,170611,0,0,0,890,0.25,638.8583224475761,5
2020-06-14-170611,170611,0,0,0,890,0.0,485.6408392113499,6
2020-06-15-170611,170611,2,0,3,892,2.25,292.2104050307532,0
2020-06-16-170611,170611,1,1,0,893,1.75,300.9948697619173,1
2020-06-17-170611,170611,2,0,1,895,2.0,228.6321956797904,2
2020-06-18-170611,170611,1,0,0,896,2.5,217.68975993028272,3
2020-06-19-170611,170611,4,0,0,900,2.0,204.4698355395647,4
2020-06-20-170611,170611,0,1,0,900,0.0,347.81248960682007,5
2020-06-21-170611,170611,0,0,0,900,0.0,348.96808942366505,6
2020-06-22-170611,170611,6,0,0,906,1.5,302.7154212415328,0
2020-06-23-170611,170611,1,0,2,907,0.5,320.95452654352096,1
2020-06-24-170611,170611,1,0,0,908,0.75,316.63857637035136,2
2020-06-25-170611,170611,1,0,1,909,0.5,286.0526416144899,3
2020-06-26-170611,170611,0,1,0,909,3.0,243.6882888758612,4
2020-06-27-170611,170611,0,0,0,909,0.25,211.87001624780783,5
2020-06-28-170611,170611,0,1,0,909,0.0,215.28748666895768,6
2020-06-29-170611,170611,3,1,1,912,1.0,215.51034081390912,0
2020-06-30-170611,170611,0,1,1,912,0.25,229.48196188857412,1
2020-07-01-170611,170611,1,0,0,913,0.75,368.77927238225925,2
2020-07-02-170611,170611,0,0,1,913,0.75,105.73105920995738,3
2020-07-03-170611,170611,0,0,1,913,1.75,228.56547231995881,4
2020-07-04-170611,170611,0,0,0,913,0.0,289.5526625847112,5
2020-07-05-170611,170611,0,0,0,913,0.0,280.8293839477288,6
2020-07-06-170611,170611,0,0,2,913,0.5,234.38070963714296,0
2020-07-07-170611,170611,2,0,2,915,0.25,215.71452202358478,1
2020-07-08-170611,170611,0,0,1,915,0.25,192.73298309845907,2
2020-07-09-170611,170611,1,0,3,916,0.5,171.333879573628,3
2020-07-10-170611,170611,0,0,6,916,0.75,371.32077590120576,4
2020-07-11-170611,170611,0,0,0,916,0.0,274.62634522013525,5
2020-07-12-170611,170611,0,0,0,916,0.0,189.21798349068413,6
2020-07-13-170611,170611,1,0,5,917,0.0,190.77376863147845,0
2020-07-14-170611,170611,1,0,2,918,0.0,207.32695287976208,1
2020-07-15-170611,170611,0,0,3,918,1.0,167.52138026956607,2
2020-07-16-170611,170611,1,0,2,919,0.75,113.13031980162981,3
2020-07-17-170611,170611,1,0,7,920,0.25,103.63291964567458,4
2020-07-18-170611,170611,0,0,2,920,0.0,103.30584594104704,5
2020-07-19-170611,170611,0,0,0,920,0.0,102.54621643193347,6
2020-07-20-170611,170611,2,0,2,922,1.5,87.56095835707407,0
2020-07-21-170611,170611,2,0,0,924,0.5,101.20810383958951,1
2020-07-22-170611,170611,1,0,10,925,1.75,143.40467233710214,2
2020-07-23-170611,170611,3,0,7,928,0.5,138.7050217529193,3
2020-07-24-170611,170611,6,1,7,934,0.75,164.78903083657931,4
2020-07-25-170611,170611,0,0,3,934,0.0,206.49052839849992,5
2020-07-26-170611,170611,0,0,4,934,0.0,208.48042591731308,6
2020-07-27-170611,170611,5,0,6,939,0.75,207.9728768054814,0
2020-07-28-170611,170611,2,1,3,941,0.75,219.65471550670296,1
2020-07-29-170611,170611,3,0,6,944,0.5,190.32110262449555,2
2020-07-30-170611,170611,2,0,6,946,1.0,196.13316384732968,3
2020-07-31-170611,170611,7,0,9,953,1.75,216.8161870785466,4
2020-08-01-170611,170611,2,0,7,955,0.5,118.21297107918346,5
2020-08-02-170611,170611,0,0,2,955,2.0,916.439075571079,6
2020-08-03-170611,170611,2,0,10,957,4.0,1473.8894246938896,0
2020-08-04-170611,170611,0,0,1,957,1.75,1347.1938457235235,1
2020-08-05-170611,170611,10,0,10,967,4.25,1119.8761127594098,2
2020-08-06-170611,170611,7,0,10,974,2.25,1046.9944058215506,3
2020-08-07-170611,170611,7,0,3,981,4.25,803.3927538452319,4
2020-08-08-170611,170611,3,0,2,984,1.25,856.4817796129031,5
2020-08-09-170611,170611,4,0,2,988,1.0,830.2208106209513,6
2020-08-10-170611,170611,6,0,4,994,3.0,87.72436273221291,0
2020-08-11-170611,170611,3,0,18,997,4.5,184.86890385780242,1
2020-08-12-170611,170611,6,0,12,1003,3.5,280.38009057045855,2
2020-08-13-170611,170611,6,0,12,1009,7.0,394.619787356496,3
2020-08-14-170611,170611,9,0,23,1018,2.5,526.4061696315201,4
2020-08-15-170611,170611,7,0,4,1025,2.0,649.4469067780286,5
2020-08-16-170611,170611,2,0,2,1027,2.0,694.6046857467579,6
2020-08-17-170611,170611,10,0,10,1037,3.75,725.3664180353508,0
2020-08-18-170611,170611,1,0,7,1038,4.75,800.7779230034988,1
2020-08-19-170611,170611,10,0,4,1048,3.5,806.4860406952189,2
2020-08-20-170611,170611,10,1,6,1058,4.5,725.3899360207039,3
2020-08-21-170611,170611,3,0,16,1061,6.5,767.2398021246537,4
2020-08-22-170611,170611,2,0,5,1063,1.0,843.2435696166949,5
2020-08-23-170611,170611,2,0,1,1065,4.5,838.9606801016266,6
2020-08-24-170611,170611,4,0,5,1069,9.5,726.2870137093985,0
2020-08-25-170611,170611,18,0,13,1087,9.25,850.4644694076767,1
2020-08-26-170611,170611,12,0,4,1099,8.5,929.6334056047965,2
2020-08-27-170611,170611,12,0,5,1111,6.25,1151.3876766931153,3
2020-08-28-170611,170611,23,0,14,1134,9.25,1180.3410470339984,4
2020-08-29-170611,170611,4,0,6,1138,2.5,1347.212272187997,5
2020-08-30-170611,170611,2,0,9,1140,2.25,1408.3327142358999,6
2020-08-31-170611,170611,10,0,12,1150,9.75,1261.16588599121,0
2020-09-01-170611,170611,7,0,10,1157,5.5,791.7661531080556,1
2020-09-02-170611,170611,4,0,10,1161,5.0,1297.1526226595436,2
2020-09-03-170611,170611,6,0,6,1167,7.25,1298.54770360541,3
2020-09-04-170611,170611,16,0,8,1183,14.25,1225.2307580699019,4
2020-09-05-170611,170611,5,0,3,1188,4.25,1344.345550477491,5
2020-09-06-170611,170611,1,0,7,1189,4.25,1391.4541792736159,6
2020-09-07-170611,170611,5,0,17,1194,12.0,1379.214162119141,0
2020-09-08-170611,170611,13,0,14,1207,1.5,1435.4374181475403,1
2020-09-09-170611,170611,4,0,9,1211,4.25,1290.276111909085,2
2020-09-10-170611,170611,5,0,15,1216,6.75,710.1018326264076,3
2020-09-11-170611,170611,14,0,13,1230,16.25,860.1993697477824,4
2020-09-12-170611,170611,6,0,3,1236,3.5,1113.609807637959,5
2020-09-13-170611,170611,9,0,7,1245,3.25,1124.4816535428058,6
2020-09-14-170611,170611,12,0,12,1257,15.5,1082.239472755414,0
2020-09-15-170611,170611,10,0,9,1267,9.75,1362.6281557490834,1
2020-09-16-170611,170611,10,0,5,1277,7.75,1606.0149516540166,2
2020-09-17-170611,170611,6,0,5,1283,9.25,1580.0087512585337,3
2020-09-18-170611,170611,8,0,10,1291,11.0,1560.9021812183719,4
2020-09-19-170611,170611,3,2,0,1294,3.0,1450.8900275890114,5
2020-09-20-170611,170611,7,0,6,1301,3.25,1489.4741331541245,6
2020-09-21-170611,170611,17,0,10,1318,13.5,1247.1724044467933,0
2020-09-22-170611,170611,14,1,4,1332,12.0,1362.9048455854756,1
2020-09-23-170611,170611,9,2,10,1341,10.5,1506.1576454237,2
2020-09-24-170611,170611,15,0,9,1356,8.5,1573.325150640557,3
2020-09-25-170611,170611,13,1,7,1369,10.0,1543.635447479154,4
2020-09-26-170611,170611,3,0,7,1372,2.5,1684.4121945049067,5
2020-09-27-170611,170611,7,1,5,1379,0.75,1621.9958787571916,6
2020-09-28-170611,170611,12,0,3,1391,7.25,1627.9638070944613,0
2020-09-29-170611,170611,9,0,18,1400,7.25,1546.3198205760991,1
2020-09-30-170611,170611,5,0,10,1405,8.25,1446.1881030110856,2
2020-10-01-170611,170611,5,0,11,1410,4.25,0.0,3
2020-10-02-170611,170611,10,0,16,1420,6.0,2951.9436403402774,4
2020-10-03-170611,170611,0,0,6,1420,4.5,3686.8246048872033,5
2020-10-04-170611,170611,6,1,13,1426,2.25,3306.962552425807,6
2020-10-05-170611,170611,10,0,13,1436,21.25,2772.9771104485385,0
2020-10-06-170611,170611,4,0,12,1440,9.75,2520.859421790179,1
2020-10-07-170611,170611,10,0,12,1450,11.0,2156.8636688614984,2
2020-10-08-170611,170611,9,0,13,1459,8.25,2094.7386922058286,3
2020-10-09-170611,170611,7,0,15,1466,12.25,2363.6335735588673,4
2020-10-10-170611,170611,7,0,4,1473,4.0,193.5652230985875,5
2020-10-11-170611,170611,5,0,0,1478,5.25,408.8406452471845,6
2020-10-12-170611,170611,3,0,22,1481,3.75,607.214450959267,0
2020-10-13-170611,170611,18,0,17,1499,11.0,755.5297996430808,1
2020-10-14-170611,170611,10,0,14,1509,9.5,1226.5747263213686,2
2020-10-15-170611,170611,11,0,13,1520,8.0,1628.3774609704715,3
2020-10-16-170611,170611,16,0,17,1536,15.5,2061.509227440289,4
2020-10-17-170611,170611,6,0,0,1542,3.75,2532.082975470571,5
2020-10-18-170611,170611,13,0,3,1555,2.5,2460.3353840874875,6
2020-10-19-170611,170611,13,0,4,1568,10.75,2497.7394092554705,0
2020-10-20-170611,170611,12,0,16,1580,11.25,2739.0165313282796,1
2020-10-21-170611,170611,12,0,18,1592,15.75,2890.240298900916,2
2020-10-22-170611,170611,13,0,6,1605,17.25,3072.001585354858,3
2020-10-23-170611,170611,15,1,21,1620,22.5,3120.2546952197067,4
2020-10-24-170611,170611,4,0,4,1624,3.25,3645.9154760360075,5
2020-10-25-170611,170611,0,1,5,1624,9.75,3540.085725753699,6
2020-10-26-170611,170611,22,1,18,1646,18.5,3238.1587189836573,0
2020-10-27-170611,170611,17,0,10,1663,14.0,3706.0694944315283,1
2020-10-28-170611,170611,14,1,12,1677,16.5,3824.681103892479,2
2020-10-29-170611,170611,13,1,9,1690,14.25,3830.9166033310303,3
2020-10-30-170611,170611,17,0,2,1707,20.5,2993.9525490732685,4
2020-10-31-170611,170611,0,1,0,1707,3.0,3402.913370033848,5
2020-11-01-170611,170611,3,2,0,1710,6.5,2019.2182462108906,6
2020-11-02-170611,170611,4,0,0,1714,3.75,1102.9031106393356,0
2020-11-03-170611,170611,16,0,0,1730,19.5,1011.2343425047422,1
2020-11-04-170611,170611,18,2,0,1748,12.75,1479.8364806634236,2
2020-11-05-170611,170611,6,0,0,1754,12.0,1823.6543471587615,3
2020-11-06-170611,170611,21,3,0,1775,12.0,1995.5667303440368,4
2020-11-07-170611,170611,4,1,0,1779,2.5,2215.2739674884892,5
2020-11-08-170611,170611,5,0,0,1784,5.0,2141.541087553369,6
2020-11-09-170611,170611,18,0,0,1802,12.0,2176.89185364503,0
2020-11-10-170611,170611,10,0,0,1812,7.75,2017.4221928854918,1
2020-11-11-170611,170611,12,2,0,1824,8.75,2187.2540902935516,2
2020-11-12-170611,170611,9,3,0,1833,6.75,2086.2349160510294,3
2020-11-13-170611,170611,2,0,0,1835,9.75,2095.0016231661034,4
2020-03-01-170612,170612,1,0,18,1,0.0,0.0,6
2020-03-02-170612,170612,0,0,43,1,0.0,334.9249387688713,0
2020-03-03-170612,170612,0,0,28,1,0.0,1460.1225999595383,1
2020-03-04-170612,170612,0,0,49,1,0.2,1584.4864034724399,2
2020-03-05-170612,170612,0,0,39,1,0.0,1623.1445782025228,3
2020-03-06-170612,170612,1,0,37,2,0.0,1395.7766355109,4
2020-03-07-170612,170612,0,1,29,2,0.0,1503.8607120597453,5
2020-03-08-170612,170612,0,0,26,2,0.2,1445.0225955159835,6
2020-03-09-170612,170612,2,0,50,4,0.4,1435.1858138530822,0
2020-03-10-170612,170612,1,0,54,5,0.4,2333.900593259978,1
2020-03-11-170612,170612,0,0,37,5,2.2,1736.3421247641056,2
2020-03-12-170612,170612,2,0,41,7,1.4,1354.735060749133,3
2020-03-13-170612,170612,3,0,44,10,4.0,902.5172419210019,4
2020-03-14-170612,170612,4,0,7,14,3.2,872.4220042801041,5
2020-03-15-170612,170612,18,0,9,32,8.8,792.9640692056555,6
2020-03-16-170612,170612,43,0,41,75,16.8,583.6108716006775,0
2020-03-17-170612,170612,28,0,34,103,20.4,965.9960729213652,1
2020-03-18-170612,170612,49,0,25,152,21.8,1315.9170633369338,2
2020-03-19-170612,170612,39,0,19,191,20.4,1548.7835013781976,3
2020-03-20-170612,170612,37,0,21,228,26.2,1645.633165894453,4
2020-03-21-170612,170612,29,0,9,257,9.0,1790.9879732303332,5
2020-03-22-170612,170612,26,0,12,283,11.0,1714.959116603781,6
2020-03-23-170612,170612,50,0,24,333,38.2,1591.3148282277548,0
2020-03-24-170612,170612,54,0,13,387,35.4,1801.0076894571687,1
2020-03-25-170612,170612,37,0,25,424,34.0,1962.607196586183,2
2020-03-26-170612,170612,41,0,9,465,27.8,2107.3235684752917,3
2020-03-27-170612,170612,44,0,15,509,26.0,2524.6868663952855,4
2020-03-28-170612,170612,7,0,6,516,6.8,2562.704909008015,5
2020-03-29-170612,170612,9,0,4,525,8.4,2501.297421103565,6
2020-03-30-170612,170612,41,0,17,566,23.0,1952.86696356386,0
2020-03-31-170612,170612,34,0,15,600,18.4,1841.0221819646868,1
2020-04-01-170612,170612,25,0,7,625,20.0,266.52507162737487,2
2020-04-02-170612,170612,19,0,6,644,10.0,786.5409690439636,3
2020-04-03-170612,170612,21,0,7,665,15.8,444.33166264655443,4
2020-04-04-170612,170612,9,0,2,674,5.2,612.5442217685211,5
2020-04-05-170612,170612,12,0,8,686,6.2,633.6613466366193,6
2020-04-06-170612,170612,24,0,17,710,24.6,676.5376618012403,0
2020-04-07-170612,170612,13,0,13,723,18.2,807.960945958941,1
2020-04-08-170612,170612,25,0,10,748,13.2,915.2889335289467,2
2020-04-09-170612,170612,9,0,5,757,4.8,993.556874593059,3
2020-04-10-170612,170612,15,0,6,772,7.4,261.2178479383816,4
2020-04-11-170612,170612,6,0,3,778,4.8,360.5103514165203,5
2020-04-12-170612,170612,4,0,0,782,7.6,407.85732126939047,6
2020-04-13-170612,170612,17,0,8,799,15.8,467.8144768228442,0
2020-04-14-170612,170612,15,0,8,814,17.2,644.6053357749736,1
2020-04-15-170612,170612,7,0,7,821,8.8,801.0006354113837,2
2020-04-16-170612,170612,6,0,6,827,7.6,893.8039023554578,3
2020-04-17-170612,170612,7,0,2,834,10.0,799.2169701865214,4
2020-04-18-170612,170612,2,0,7,836,5.2,829.5842274720162,5
2020-04-19-170612,170612,8,0,1,844,1.0,849.8090333243772,6
2020-04-20-170612,170612,17,0,8,861,12.0,781.6131770655371,0
2020-04-21-170612,170612,13,0,9,874,11.2,778.0805507806056,1
2020-04-22-170612,170612,10,0,4,884,10.2,815.3524851075116,2
2020-04-23-170612,170612,5,0,16,889,1.8,807.8336800767902,3
2020-04-24-170612,170612,6,0,18,895,5.2,703.8668345955896,4
2020-04-25-170612,170612,3,0,1,898,3.2,696.6547137007234,5
2020-04-26-170612,170612,0,0,0,898,1.8,711.4620738864043,6
2020-04-27-170612,170612,8,0,9,906,10.4,592.3897409430563,0
2020-04-28-170612,170612,8,0,17,914,4.6,564.7807010956402,1
2020-04-29-170612,170612,7,0,13,921,7.6,489.25178263983423,2
2020-04-30-170612,170612,6,0,9,927,5.2,636.549940278325,3
2020-05-01-170612,170612,2,0,6,929,3.8,922.9550500689452,4
2020-05-02-170612,170612,7,0,1,936,3.0,367.32683169700147,5
2020-05-03-170612,170612,1,0,1,937,1.4,235.36151889272773,6
2020-05-04-170612,170612,8,0,8,945,7.0,202.9200110656621,0
2020-05-05-170612,170612,9,0,7,954,6.8,274.14728333931964,1
2020-05-06-170612,170612,4,0,5,958,4.2,303.2054161817199,2
2020-05-07-170612,170612,16,0,6,974,4.8,368.3571826227793,3
2020-05-08-170612,170612,18,0,7,992,8.2,415.78735575446746,4
2020-05-09-170612,170612,1,0,1,993,1.8,556.7807094871375,5
2020-05-10-170612,170612,0,0,1,993,0.8,1035.2075124950024,6
2020-05-11-170612,170612,9,5,6,1002,8.2,954.4908982616129,0
2020-05-12-170612,170612,17,0,4,1019,21.8,986.00478321677,1
2020-05-13-170612,170612,13,0,5,1032,7.0,867.9394766713131,2
2020-05-14-170612,170612,9,0,2,1041,4.0,770.0382609627217,3
2020-05-15-170612,170612,6,0,2,1047,8.6,648.8178836041959,4
2020-05-16-170612,170612,1,0,0,1048,0.8,662.1337640639063,5
2020-05-17-170612,170612,1,0,0,1049,0.0,626.0958613985425,6
2020-05-18-170612,170612,8,0,10,1057,3.2,628.8963356357172,0
2020-05-19-170612,170612,7,0,4,1064,3.6,582.5919406622993,1
2020-05-20-170612,170612,5,0,8,1069,3.6,406.7435233990727,2
2020-05-21-170612,170612,6,0,7,1075,3.0,404.94649964889976,3
2020-05-22-170612,170612,7,0,1,1082,5.0,354.50428060973377,4
2020-05-23-170612,170612,1,0,0,1083,0.2,423.0132334452901,5
2020-05-24-170612,170612,1,0,0,1084,0.0,428.31778795567436,6
2020-05-25-170612,170612,6,0,2,1090,3.8,359.94201110466366,0
2020-05-26-170612,170612,4,0,2,1094,3.0,354.3707883433977,1
2020-05-27-170612,170612,5,0,3,1099,3.4,350.4860487390856,2
2020-05-28-170612,170612,2,2,1,1101,2.0,347.8250491093506,3
2020-05-29-170612,170612,2,0,0,1103,2.8,332.4559337633531,4
2020-05-30-170612,170612,0,0,0,1103,0.8,342.19654104001944,5
2020-05-31-170612,170612,0,0,0,1103,0.2,349.81193512834204,6
2020-06-01-170612,170612,10,0,5,1113,4.2,737.8724838068453,0
2020-06-02-170612,170612,4,0,2,1117,2.2,207.29774851538062,1
2020-06-03-170612,170612,8,0,2,1125,3.0,142.9144364892764,2
2020-06-04-170612,170612,7,0,6,1132,4.0,160.3928492470712,3
2020-06-05-170612,170612,1,0,3,1133,2.2,222.82681537664877,4
2020-06-06-170612,170612,0,0,0,1133,0.2,254.9465085443745,5
2020-06-07-170612,170612,0,0,0,1133,0.2,256.3926512804797,6
2020-06-08-170612,170612,2,0,3,1135,2.2,260.591910311847,0
2020-06-09-170612,170612,2,0,0,1137,3.6,280.195785284052,1
2020-06-10-170612,170612,3,0,1,1140,1.4,871.8164144592674,2
2020-06-11-170612,170612,1,0,0,1141,2.8,765.9749480627595,3
2020-06-12-170612,170612,0,0,3,1141,1.0,721.5635354621695,4
2020-06-13-170612,170612,0,0,0,1141,0.2,556.1229590387807,5
2020-06-14-170612,170612,0,0,0,1141,0.0,416.5486625375131,6
2020-06-15-170612,170612,5,0,2,1146,1.6,249.9892454983974,0
2020-06-16-170612,170612,2,0,0,1148,1.6,257.9181720955514,1
2020-06-17-170612,170612,2,0,0,1150,1.4,199.79505297083148,2
2020-06-18-170612,170612,6,0,1,1156,1.2,190.9370766011175,3
2020-06-19-170612,170612,3,0,1,1159,3.4,180.11153783187143,4
2020-06-20-170612,170612,0,0,0,1159,0.0,291.41161311081555,5
2020-06-21-170612,170612,0,0,0,1159,0.2,292.5588655386207,6
2020-06-22-170612,170612,3,0,2,1162,3.2,253.20155273815462,0
2020-06-23-170612,170612,0,0,1,1162,1.4,267.27804453599333,1
2020-06-24-170612,170612,1,1,0,1163,1.2,270.9049447443244,2
2020-06-25-170612,170612,0,0,0,1163,1.4,242.25859227468726,3
2020-06-26-170612,170612,3,0,2,1166,2.0,208.0279596016149,4
2020-06-27-170612,170612,0,0,0,1166,0.2,189.24745475052407,5
2020-06-28-170612,170612,0,0,0,1166,0.0,192.17282451411532,6
2020-06-29-170612,170612,2,0,0,1168,1.2,190.87183795363165,0
2020-06-30-170612,170612,0,0,0,1168,0.8,192.27104761641425,1
2020-07-01-170612,170612,0,0,4,1168,1.0,314.10503619207236,2
2020-07-02-170612,170612,1,0,2,1169,0.8,97.29158903632991,3
2020-07-03-170612,170612,1,0,0,1170,1.6,185.99780728538127,4
2020-07-04-170612,170612,0,0,0,1170,0.0,244.33835151314557,5
2020-07-05-170612,170612,0,0,0,1170,0.0,236.0023216714045,6
2020-07-06-170612,170612,2,0,1,1172,0.2,196.60194407733508,0
2020-07-07-170612,170612,1,0,0,1173,1.2,183.68389916314806,1
2020-07-08-170612,170612,0,0,1,1173,0.2,166.40408148730705,2
2020-07-09-170612,170612,0,0,0,1173,1.4,149.3929088667266,3
2020-07-10-170612,170612,2,0,1,1175,1.0,317.98635786634884,4
2020-07-11-170612,170612,0,0,0,1175,0.0,239.26837828654865,5
2020-07-12-170612,170612,0,0,0,1175,0.0,163.89342294129216,6
2020-07-13-170612,170612,0,0,1,1175,0.4,165.66088248716844,0
2020-07-14-170612,170612,0,0,1,1175,0.8,179.03765522255287,1
2020-07-15-170612,170612,4,0,0,1179,0.4,149.8530830240191,2
2020-07-16-170612,170612,2,0,1,1181,0.6,106.62894866757352,3
2020-07-17-170612,170612,0,1,3,1181,0.8,94.52327143637825,4
2020-07-18-170612,170612,0,0,0,1181,0.0,95.54181277118613,5
2020-07-19-170612,170612,0,0,2,1181,0.0,94.8002737762529,6
2020-07-20-170612,170612,1,0,2,1182,1.6,82.83186497105756,0
2020-07-21-170612,170612,0,0,3,1182,0.8,90.13733708228898,1
2020-07-22-170612,170612,1,0,9,1183,2.0,137.43896067658986,2
2020-07-23-170612,170612,0,0,3,1183,0.6,131.74038074268282,3
2020-07-24-170612,170612,1,0,10,1184,1.6,149.8718316271097,4
2020-07-25-170612,170612,0,0,1,1184,0.4,180.48947364892587,5
2020-07-26-170612,170612,0,0,3,1184,0.2,183.09588634664175,6
2020-07-27-170612,170612,1,0,1,1185,1.8,183.18330696141282,0
2020-07-28-170612,170612,1,0,6,1186,1.8,194.58181945333016,1
2020-07-29-170612,170612,0,0,5,1186,1.0,158.29887630262743,2
2020-07-30-170612,170612,1,0,22,1187,1.4,165.36475474788108,3
2020-07-31-170612,170612,3,0,3,1190,2.6,186.03189545441103,4
2020-08-01-170612,170612,0,0,5,1190,1.4,114.8733985446861,5
2020-08-02-170612,170612,2,0,2,1192,1.8,831.5132737762298,6
2020-08-03-170612,170612,2,0,7,1194,3.4,1286.1954841833976,0
2020-08-04-170612,170612,3,0,9,1197,1.2,1181.5396050090953,1
2020-08-05-170612,170612,9,0,5,1206,5.6,979.1274311090269,2
2020-08-06-170612,170612,3,0,4,1209,3.6,924.5562531708815,3
2020-08-07-170612,170612,10,0,19,1219,4.0,722.6669852076851,4
2020-08-08-170612,170612,1,0,0,1220,1.6,770.4467473735501,5
2020-08-09-170612,170612,3,0,5,1223,1.0,750.4433489021399,6
2020-08-10-170612,170612,1,0,15,1224,3.6,84.76939763534807,0
2020-08-11-170612,170612,6,0,16,1230,2.6,164.63490039774658,1
2020-08-12-170612,170612,5,0,14,1235,2.8,243.51734960584736,2
2020-08-13-170612,170612,22,0,10,1257,4.4,343.55936576607604,3
2020-08-14-170612,170612,3,0,24,1260,4.2,467.2270077007198,4
2020-08-15-170612,170612,5,0,4,1265,2.6,570.7691705267381,5
2020-08-16-170612,170612,2,0,0,1267,2.2,605.7176922400606,6
2020-08-17-170612,170612,7,0,26,1274,7.2,633.8123337652012,0
2020-08-18-170612,170612,9,0,14,1283,3.0,710.9723924272337,1
2020-08-19-170612,170612,5,0,13,1288,7.2,725.0622422265565,2
2020-08-20-170612,170612,4,0,11,1292,8.0,648.0864848995484,3
2020-08-21-170612,170612,19,0,25,1311,3.4,693.3936319179136,4
2020-08-22-170612,170612,0,0,8,1311,1.8,766.6174682406834,5
2020-08-23-170612,170612,5,0,6,1316,3.4,758.2104338494989,6
2020-08-24-170612,170612,15,0,29,1331,7.6,655.6345267516032,0
2020-08-25-170612,170612,16,0,1,1347,8.4,764.5597082139691,1
2020-08-26-170612,170612,14,0,8,1361,9.6,823.9593067161987,2
2020-08-27-170612,170612,10,0,19,1371,5.8,1019.7997126246207,3
2020-08-28-170612,170612,24,0,37,1395,10.0,1031.1413653017412,4
2020-08-29-170612,170612,4,0,7,1399,2.8,1161.817182848616,5
2020-08-30-170612,170612,0,0,8,1399,2.6,1217.8485523008892,6
2020-08-31-170612,170612,26,0,36,1425,6.8,1072.9755052900316,0
2020-09-01-170612,170612,14,0,14,1439,5.6,709.9907787525947,1
2020-09-02-170612,170612,13,0,9,1452,4.4,1119.6594950238439,2
2020-09-03-170612,170612,11,0,14,1463,7.4,1115.699155820834,3
2020-09-04-170612,170612,25,0,12,1488,12.2,1066.8069641177826,4
2020-09-05-170612,170612,8,0,0,1496,4.0,1172.0719790319772,5
2020-09-06-170612,170612,6,0,4,1502,3.4,1217.750223445037,6
2020-09-07-170612,170612,29,0,25,1531,7.0,1215.8005046045155,0
2020-09-08-170612,170612,1,0,12,1532,4.2,1280.1087629327612,1
2020-09-09-170612,170612,8,0,7,1540,4.6,1149.0035877650216,2
2020-09-10-170612,170612,19,0,13,1559,4.2,644.8597415065401,3
2020-09-11-170612,170612,37,0,11,1596,10.6,766.8480322333019,4
2020-09-12-170612,170612,7,0,4,1603,3.8,970.9089236979751,5
2020-09-13-170612,170612,8,0,2,1611,4.0,977.1234655081197,6
2020-09-14-170612,170612,36,1,13,1647,10.0,931.9051042316452,0
2020-09-15-170612,170612,14,0,16,1661,5.8,1196.5073437297326,1
2020-09-16-170612,170612,9,0,16,1670,5.0,1396.1296923998325,2
2020-09-17-170612,170612,14,0,4,1684,5.2,1358.514628764806,3
2020-09-18-170612,170612,12,0,12,1696,8.0,1339.172314395123,4
2020-09-19-170612,170612,0,1,2,1696,3.4,1244.576016554379,5
2020-09-20-170612,170612,4,0,2,1700,4.0,1284.4091339597326,6
2020-09-21-170612,170612,25,0,18,1725,9.8,1056.4393321010007,0
2020-09-22-170612,170612,12,1,18,1737,11.8,1167.6215366083645,1
2020-09-23-170612,170612,7,1,10,1744,7.8,1290.0830204481576,2
2020-09-24-170612,170612,13,0,9,1757,8.8,1345.7517056191618,3
2020-09-25-170612,170612,11,0,20,1768,9.2,1334.8662833094522,4
2020-09-26-170612,170612,4,0,8,1772,2.4,1460.2338251064934,5
2020-09-27-170612,170612,2,0,9,1774,1.8,1399.2680159622057,6
2020-09-28-170612,170612,13,0,6,1787,8.0,1392.0772203884824,0
2020-09-29-170612,170612,16,0,19,1803,4.8,1311.4227861979757,1
2020-09-30-170612,170612,16,0,13,1819,5.4,1240.0420545759434,2
2020-10-01-170612,170612,4,0,11,1823,4.6,0.0,3
2020-10-02-170612,170612,12,0,27,1835,5.2,2531.820441820094,4
2020-10-03-170612,170612,2,1,5,1837,1.4,3085.949408496799,5
2020-10-04-170612,170612,2,0,1,1839,3.4,2796.2116373404497,6
2020-10-05-170612,170612,18,0,13,1857,17.0,2339.2843050039646,0
2020-10-06-170612,170612,18,1,10,1875,8.4,2141.4292733284065,1
2020-10-07-170612,170612,10,1,16,1885,9.6,1833.6067913410484,2
2020-10-08-170612,170612,9,1,17,1894,9.0,1777.1699803900838,3
2020-10-09-170612,170612,20,4,33,1914,9.6,2013.8407925369802,4
2020-10-10-170612,170612,8,0,2,1922,3.6,157.00013490302686,5
2020-10-11-170612,170612,9,0,21,1931,5.0,323.2843114510222,6
2020-10-12-170612,170612,6,0,18,1937,4.2,495.35734409524053,0
2020-10-13-170612,170612,19,0,21,1956,9.0,619.7604550731337,1
2020-10-14-170612,170612,13,0,24,1969,9.4,1016.7720152242262,2
2020-10-15-170612,170612,11,0,18,1980,13.2,1346.9630564370354,3
2020-10-16-170612,170612,27,0,22,2007,12.4,1736.8545101491695,4
2020-10-17-170612,170612,5,0,3,2012,3.8,2110.4090659457092,5
2020-10-18-170612,170612,1,1,6,2013,6.6,2041.0039817772943,6
2020-10-19-170612,170612,13,0,4,2026,20.2,2041.575487851709,0
2020-10-20-170612,170612,10,0,20,2036,16.8,2235.842458824689,1
2020-10-21-170612,170612,16,1,23,2052,16.0,2335.984487286638,2
2020-10-22-170612,170612,17,0,21,2069,15.0,2454.880152783706,3
2020-10-23-170612,170612,33,0,23,2102,18.2,2475.8696762181426,4
2020-10-24-170612,170612,2,1,3,2104,3.4,2904.6663766023858,5
2020-10-25-170612,170612,21,1,7,2125,5.8,2829.640745976332,6
2020-10-26-170612,170612,18,1,20,2143,17.4,2561.8283711538506,0
2020-10-27-170612,170612,21,0,15,2164,15.0,2951.9722686569307,1
2020-10-28-170612,170612,24,2,13,2188,12.8,3063.886925296024,2
2020-10-29-170612,170612,18,1,13,2206,11.8,3080.6311394516542,3
2020-10-30-170612,170612,22,2,24,2228,20.0,2424.4516476904164,4
2020-10-31-170612,170612,3,2,0,2231,2.8,2763.9643474713766,5
2020-11-01-170612,170612,6,2,0,2237,6.4,1680.4414954016527,6
2020-11-02-170612,170612,4,0,0,2241,5.0,985.960671923365,0
2020-11-03-170612,170612,20,1,0,2261,19.2,906.969947123767,1
2020-11-04-170612,170612,23,2,0,2284,13.0,1288.4705277449568,2
2020-11-05-170612,170612,21,1,0,2305,9.0,1567.5407844482897,3
2020-11-06-170612,170612,23,2,0,2328,10.6,1704.8650760358212,4
2020-11-07-170612,170612,3,0,0,2331,4.4,1877.4147729605604,5
2020-11-08-170612,170612,7,0,0,2338,4.8,1799.0118459254409,6
2020-11-09-170612,170612,20,1,0,2358,14.2,1814.7648882335257,0
2020-11-10-170612,170612,15,2,0,2373,8.8,1654.152648895291,1
2020-11-11-170612,170612,13,1,0,2386,9.6,1799.3444757167033,2
2020-11-12-170612,170612,13,3,0,2399,6.6,1708.1399137876028,3
2020-11-13-170612,170612,24,3,0,2423,5.8,1715.0063283728616,4
2020-03-01-170613,170613,0,0,2,0,0.0,0.0,6
2020-03-02-170613,170613,0,0,2,0,0.2,51.603034705224474,0
2020-03-03-170613,170613,0,0,6,0,0.2,298.7499329883823,1
2020-03-04-170613,170613,0,0,7,0,0.0,372.3770547042383,2
2020-03-05-170613,170613,0,1,10,0,0.0,384.2539262222949,3
2020-03-06-170613,170613,0,0,3,0,0.0,335.66839432272326,4
2020-03-07-170613,170613,0,0,1,0,0.0,385.08325709105986,5
2020-03-08-170613,170613,0,0,0,0,0.0,355.9331773787336,6
2020-03-09-170613,170613,0,0,7,0,0.0,355.33021101560394,0
2020-03-10-170613,170613,0,0,3,0,0.0,692.3801877752937,1
2020-03-11-170613,170613,0,0,8,0,0.0,488.4934667854477,2
2020-03-12-170613,170613,1,0,10,1,0.2,379.4088070017493,3
2020-03-13-170613,170613,1,0,6,2,0.8,235.14460568578764,4
2020-03-14-170613,170613,0,0,0,2,0.4,186.2495668874144,5
2020-03-15-170613,170613,2,0,4,4,0.8,150.1613526341439,6
2020-03-16-170613,170613,2,0,8,6,1.8,80.45331354358312,0
2020-03-17-170613,170613,6,0,9,12,2.0,130.5875032747179,1
2020-03-18-170613,170613,7,0,5,19,3.0,206.12256449316675,2
2020-03-19-170613,170613,10,0,4,29,4.6,288.49679999215823,3
2020-03-20-170613,170613,3,0,3,32,6.4,367.3565646465433,4
2020-03-21-170613,170613,1,0,0,33,3.2,429.37455562331945,5
2020-03-22-170613,170613,0,0,2,33,5.2,420.46492902526916,6
2020-03-23-170613,170613,7,0,0,40,11.6,415.53068580284173,0
2020-03-24-170613,170613,3,0,2,43,6.8,488.4554881673354,1
2020-03-25-170613,170613,8,0,2,51,8.2,495.06520695676113,2
2020-03-26-170613,170613,10,0,1,61,7.8,522.7706070055029,3
2020-03-27-170613,170613,6,0,0,67,13.4,645.1254660182576,4
2020-03-28-170613,170613,0,0,1,67,2.0,681.6389316678365,5
2020-03-29-170613,170613,4,0,0,71,3.6,667.9136168580461,6
2020-03-30-170613,170613,8,0,1,79,9.4,545.9771883777919,0
2020-03-31-170613,170613,9,0,3,88,7.2,566.1326441119802,1
2020-04-01-170613,170613,5,0,3,93,7.2,102.94398177969325,2
2020-04-02-170613,170613,4,0,2,97,5.0,263.5566457987982,3
2020-04-03-170613,170613,3,0,3,100,5.0,138.22620566316476,4
2020-04-04-170613,170613,0,0,1,100,2.6,185.42498567380625,5
2020-04-05-170613,170613,2,1,1,102,1.6,194.75376208452758,6
2020-04-06-170613,170613,0,0,2,102,9.0,210.04045226701692,0
2020-04-07-170613,170613,2,0,3,104,6.6,226.5628620964377,1
2020-04-08-170613,170613,2,0,1,106,4.6,241.93936607434173,2
2020-04-09-170613,170613,1,1,0,107,7.4,263.20816385434335,3
2020-04-10-170613,170613,0,1,0,107,2.2,77.01549906160015,4
2020-04-11-170613,170613,1,0,0,108,1.4,89.48349378939571,5
2020-04-12-170613,170613,0,0,1,108,1.4,99.4148484127264,6
2020-04-13-170613,170613,1,0,3,109,5.2,105.68224204624701,0
2020-04-14-170613,170613,3,0,1,112,5.0,146.62418511422717,1
2020-04-15-170613,170613,3,0,0,115,8.2,191.93757435840544,2
2020-04-16-170613,170613,2,0,0,117,3.6,248.94506266603162,3
2020-04-17-170613,170613,3,0,0,120,5.0,227.8805852074899,4
2020-04-18-170613,170613,1,0,1,121,2.2,269.9406512241214,5
2020-04-19-170613,170613,1,0,0,122,1.0,280.37239673017996,6
2020-04-20-170613,170613,2,1,3,124,3.2,297.8502233416742,0
2020-04-21-170613,170613,3,0,2,127,3.4,274.1022741283397,1
2020-04-22-170613,170613,1,0,2,128,3.4,264.7843725004437,2
2020-04-23-170613,170613,0,0,2,128,1.8,264.7142531631715,3
2020-04-24-170613,170613,0,0,6,128,2.4,221.85342801338584,4
2020-04-25-170613,170613,0,0,0,128,1.0,212.60298139008637,5
2020-04-26-170613,170613,1,0,0,129,0.0,210.26578035757709,6
2020-04-27-170613,170613,3,0,2,132,3.4,160.845642717984,0
2020-04-28-170613,170613,1,0,0,133,3.4,167.9570882422159,1
2020-04-29-170613,170613,0,0,1,133,4.6,150.44870967785099,2
2020-04-30-170613,170613,0,0,3,133,2.6,186.41566309895012,3
2020-05-01-170613,170613,0,0,0,133,1.2,261.5876027699593,4
2020-05-02-170613,170613,1,0,0,134,1.4,99.43488043873278,5
2020-05-03-170613,170613,0,0,0,134,0.4,88.85138722639256,6
2020-05-04-170613,170613,3,0,2,137,7.4,74.87313378663175,0
2020-05-05-170613,170613,2,0,3,139,2.6,130.99342337729738,1
2020-05-06-170613,170613,2,0,1,141,29.4,143.86411462345876,2
2020-05-07-170613,170613,2,0,3,143,8.8,289.43304216517714,3
2020-05-08-170613,170613,6,0,2,149,3.2,347.7085697742745,4
2020-05-09-170613,170613,0,0,1,149,0.2,427.64964307588707,5
2020-05-10-170613,170613,0,0,0,149,0.4,280.12280439328345,6
2020-05-11-170613,170613,2,1,0,151,3.0,258.70999832324674,0
2020-05-12-170613,170613,0,12,1,151,2.6,267.2645191221146,1
2020-05-13-170613,170613,1,1,1,152,3.0,216.78224738758138,2
2020-05-14-170613,170613,3,0,0,155,2.4,192.8883151365119,3
2020-05-15-170613,170613,0,0,1,155,0.6,172.63552219705653,4
2020-05-16-170613,170613,0,0,0,155,0.0,141.8387435775703,5
2020-05-17-170613,170613,0,0,0,155,0.2,132.01243220742685,6
2020-05-18-170613,170613,2,0,4,157,1.0,131.98056348522113,0
2020-05-19-170613,170613,3,0,0,160,1.0,110.10226654769771,1
2020-05-20-170613,170613,1,0,0,161,1.4,112.40620585281656,2
2020-05-21-170613,170613,3,0,1,164,2.0,88.50254708913207,3
2020-05-22-170613,170613,2,0,1,166,1.8,107.12635767127746,4
2020-05-23-170613,170613,1,0,0,167,0.4,134.25668024383972,5
2020-05-24-170613,170613,0,0,0,167,0.4,141.5631150716194,6
2020-05-25-170613,170613,0,0,0,167,0.6,137.9484972545921,0
2020-05-26-170613,170613,1,0,1,168,0.8,118.58072760553023,1
2020-05-27-170613,170613,1,0,1,169,0.8,110.10293066868034,2
2020-05-28-170613,170613,0,0,0,169,1.4,127.58636340668748,3
2020-05-29-170613,170613,1,0,1,170,1.4,115.24022520099146,4
2020-05-30-170613,170613,0,0,1,170,0.2,116.15389554649161,5
2020-05-31-170613,170613,0,0,1,170,0.0,108.03032641769826,6
2020-06-01-170613,170613,4,0,0,174,1.2,524.1708772807558,0
2020-06-02-170613,170613,0,0,1,174,1.6,83.22737926483333,1
2020-06-03-170613,170613,0,0,1,174,1.4,27.93757867948779,2
2020-06-04-170613,170613,1,0,2,175,0.8,35.72070147041599,3
2020-06-05-170613,170613,1,0,1,176,1.0,55.226562792304996,4
2020-06-06-170613,170613,0,0,0,176,0.6,83.87131125830186,5
2020-06-07-170613,170613,0,0,0,176,0.0,85.22368373813902,6
2020-06-08-170613,170613,0,0,0,176,0.6,86.461556801825,0
2020-06-09-170613,170613,1,0,0,177,0.8,84.56076602525997,1
2020-06-10-170613,170613,1,0,0,178,0.0,555.8046447754837,2
2020-06-11-170613,170613,0,0,0,178,0.6,483.24550803581315,3
2020-06-12-170613,170613,1,0,0,179,0.0,458.7920898156228,4
2020-06-13-170613,170613,1,1,0,180,0.0,248.53827302456108,5
2020-06-14-170613,170613,1,0,0,181,0.0,157.57215165002896,6
2020-06-15-170613,170613,0,0,0,181,0.0,90.05294177468983,0
2020-06-16-170613,170613,1,0,0,182,0.4,89.72604519206007,1
2020-06-17-170613,170613,1,0,0,183,0.8,68.09561675609012,2
2020-06-18-170613,170613,2,0,0,185,0.2,70.04480303689033,3
2020-06-19-170613,170613,1,0,0,186,0.2,78.63797421162255,4
2020-06-20-170613,170613,0,0,0,186,0.0,95.15659803113186,5
2020-06-21-170613,170613,0,0,0,186,0.0,88.48227606262611,6
2020-06-22-170613,170613,0,0,0,186,1.0,83.59125440849164,0
2020-06-23-170613,170613,0,0,0,186,0.2,92.2647141735937,1
2020-06-24-170613,170613,0,0,0,186,0.6,86.38393136839605,2
2020-06-25-170613,170613,0,1,0,186,0.0,69.10960445071211,3
2020-06-26-170613,170613,0,0,0,186,0.2,55.56197136785339,4
2020-06-27-170613,170613,0,0,1,186,0.4,42.50086922852876,5
2020-06-28-170613,170613,0,0,0,186,0.0,45.6371454575004,6
2020-06-29-170613,170613,0,0,2,186,0.8,46.129771516418934,0
2020-06-30-170613,170613,0,0,1,186,0.2,41.1229895205487,1
2020-07-01-170613,170613,0,0,0,186,0.2,93.36833352499994,2
2020-07-02-170613,170613,0,0,0,186,0.6,43.10828509536562,3
2020-07-03-170613,170613,0,0,0,186,0.2,55.72758682704973,4
2020-07-04-170613,170613,0,0,0,186,0.2,59.26906593190112,5
2020-07-05-170613,170613,0,0,0,186,0.0,57.79922177127361,6
2020-07-06-170613,170613,0,0,0,186,0.4,55.4756339881558,0
2020-07-07-170613,170613,0,0,0,186,0.0,51.170791464685635,1
2020-07-08-170613,170613,0,0,1,186,0.2,30.255679947097086,2
2020-07-09-170613,170613,0,0,0,186,0.0,27.133196515723572,3
2020-07-10-170613,170613,0,0,0,186,0.0,92.94939164293856,4
2020-07-11-170613,170613,1,0,0,187,0.0,68.57188034337526,5
2020-07-12-170613,170613,0,1,0,187,0.6,42.55753986719972,6
2020-07-13-170613,170613,2,0,0,189,0.2,46.864333524191096,0
2020-07-14-170613,170613,1,0,0,190,0.4,60.23193833760169,1
2020-07-15-170613,170613,0,0,2,190,0.2,72.00833287090691,2
2020-07-16-170613,170613,0,0,0,190,0.2,54.17734617077795,3
2020-07-17-170613,170613,0,0,0,190,0.8,55.36340270792142,4
2020-07-18-170613,170613,0,0,0,190,0.2,59.10709167905887,5
2020-07-19-170613,170613,0,0,0,190,0.0,54.045777113272095,6
2020-07-20-170613,170613,0,0,0,190,0.0,34.43751020188151,0
2020-07-21-170613,170613,0,0,0,190,0.4,19.956768011911148,1
2020-07-22-170613,170613,1,0,0,191,0.8,29.04695178855706,2
2020-07-23-170613,170613,0,0,5,191,0.6,34.982691819319435,3
2020-07-24-170613,170613,0,0,0,191,0.4,45.52443029793933,4
2020-07-25-170613,170613,0,0,1,191,0.0,46.41135249369456,5
2020-07-26-170613,170613,0,0,0,191,0.2,46.72650179698706,6
2020-07-27-170613,170613,0,0,0,191,0.2,44.87848449498554,0
2020-07-28-170613,170613,0,0,2,191,2.4,44.25054378796105,1
2020-07-29-170613,170613,2,0,4,193,1.2,48.98909297633996,2
2020-07-30-170613,170613,0,0,1,193,0.8,52.71697622613774,3
2020-07-31-170613,170613,0,0,1,193,0.4,57.92224594544,4
2020-08-01-170613,170613,0,0,3,193,0.4,21.996036617577968,5
2020-08-02-170613,170613,0,0,2,193,1.0,333.47025638033705,6
2020-08-03-170613,170613,0,0,4,193,0.6,381.53419947563873,0
2020-08-04-170613,170613,0,0,2,193,0.8,311.6768639570222,1
2020-08-05-170613,170613,0,0,5,193,0.6,278.7810013613006,2
2020-08-06-170613,170613,5,0,8,198,3.8,228.65681163864548,3
2020-08-07-170613,170613,0,0,7,198,2.0,243.84649944050355,4
2020-08-08-170613,170613,1,0,1,199,0.8,223.40894573763816,5
2020-08-09-170613,170613,0,0,0,199,0.8,236.85533377340226,6
2020-08-10-170613,170613,0,0,4,199,2.6,30.683878832592313,0
2020-08-11-170613,170613,2,0,6,201,2.0,59.72671664049646,1
2020-08-12-170613,170613,4,0,2,205,1.0,116.56587469400955,2
2020-08-13-170613,170613,1,0,3,206,3.8,162.18086158698412,3
2020-08-14-170613,170613,1,0,3,207,2.2,229.81197488292167,4
2020-08-15-170613,170613,3,0,4,210,1.2,266.39461583632874,5
2020-08-16-170613,170613,2,0,1,212,0.6,293.93048376210106,6
2020-08-17-170613,170613,4,0,0,216,2.2,302.29277494055395,0
2020-08-18-170613,170613,2,0,2,218,1.4,326.92430786141114,1
2020-08-19-170613,170613,5,0,5,223,2.2,307.1493851261113,2
2020-08-20-170613,170613,8,0,8,231,3.4,275.48104727287665,3
2020-08-21-170613,170613,7,0,4,238,5.4,332.4463423111199,4
2020-08-22-170613,170613,1,0,0,239,0.4,402.8113199700472,5
2020-08-23-170613,170613,0,1,4,239,0.8,385.6433342006874,6
2020-08-24-170613,170613,4,0,6,243,1.6,336.7668478017638,0
2020-08-25-170613,170613,6,0,3,249,3.0,367.99272528190147,1
2020-08-26-170613,170613,2,0,3,251,1.6,376.15410163322593,2
2020-08-27-170613,170613,3,0,4,254,2.2,405.0417948298019,3
2020-08-28-170613,170613,3,0,4,257,2.0,373.8529834355105,4
2020-08-29-170613,170613,4,0,4,261,1.4,319.0606771352861,5
2020-08-30-170613,170613,1,0,2,262,1.0,356.7675428587553,6
2020-08-31-170613,170613,0,0,11,262,3.4,314.7562712047134,0
2020-09-01-170613,170613,2,0,4,264,2.0,190.35700640214904,1
2020-09-02-170613,170613,5,0,3,269,1.2,665.8941063630052,2
2020-09-03-170613,170613,8,0,9,277,1.6,1045.6779914367216,3
2020-09-04-170613,170613,4,0,14,281,4.6,848.6709670425378,4
2020-09-05-170613,170613,0,0,8,281,1.2,713.517074462037,5
2020-09-06-170613,170613,4,0,3,285,2.4,647.6844945168691,6
2020-09-07-170613,170613,6,1,12,291,0.8,669.1165087442146,0
2020-09-08-170613,170613,3,0,21,294,1.2,605.7457278826463,1
2020-09-09-170613,170613,3,0,20,297,2.8,494.2064111890331,2
2020-09-10-170613,170613,4,0,28,301,2.4,196.7141499603606,3
2020-09-11-170613,170613,4,0,25,305,1.2,257.2059573794886,4
2020-09-12-170613,170613,4,0,4,309,2.8,305.32972019516734,5
2020-09-13-170613,170613,2,0,1,311,0.2,310.0656320809072,6
2020-09-14-170613,170613,11,0,20,322,4.4,311.928085358207,0
2020-09-15-170613,170613,4,0,17,326,2.0,408.087406817747,1
2020-09-16-170613,170613,3,0,19,329,2.8,456.7366641699474,2
2020-09-17-170613,170613,9,0,13,338,2.6,449.1728987946089,3
2020-09-18-170613,170613,14,0,19,352,4.2,489.5630627956176,4
2020-09-19-170613,170613,8,0,3,360,2.6,610.262273149415,5
2020-09-20-170613,170613,3,0,16,363,1.6,666.4829729055755,6
2020-09-21-170613,170613,12,0,18,375,1.8,590.0238024568756,0
2020-09-22-170613,170613,21,0,15,396,4.2,675.8008872453212,1
2020-09-23-170613,170613,20,0,3,416,2.4,806.0967707562356,2
2020-09-24-170613,170613,28,1,6,444,5.4,826.6979377437756,3
2020-09-25-170613,170613,25,1,14,469,2.8,892.4892011307002,4
2020-09-26-170613,170613,4,0,8,473,1.8,995.7969252491033,5
2020-09-27-170613,170613,1,0,8,474,0.8,1022.9363895949451,6
2020-09-28-170613,170613,20,0,6,494,4.0,1011.1577117514141,0
2020-09-29-170613,170613,17,0,12,511,0.8,1024.7974094510512,1
2020-09-30-170613,170613,19,0,9,530,3.0,914.4896146483228,2
2020-10-01-170613,170613,13,0,11,543,3.2,0.0,3
2020-10-02-170613,170613,19,0,31,562,2.8,774.8387492316843,4
2020-10-03-170613,170613,3,0,4,565,0.6,988.662661972852,5
2020-10-04-170613,170613,16,0,5,581,0.8,856.955973810025,6
2020-10-05-170613,170613,18,1,14,599,3.2,840.1926453632692,0
2020-10-06-170613,170613,15,0,18,614,1.0,836.7292358715422,1
2020-10-07-170613,170613,3,1,9,617,4.4,784.7708543004537,2
2020-10-08-170613,170613,6,1,27,623,4.8,669.543094294222,3
2020-10-09-170613,170613,14,0,20,637,5.6,717.5518169133542,4
2020-10-10-170613,170613,8,0,10,645,2.6,131.36734844559174,5
2020-10-11-170613,170613,8,0,7,653,3.2,209.16968226411706,6
2020-10-12-170613,170613,6,0,10,659,2.0,317.3864619016935,0
2020-10-13-170613,170613,12,0,12,671,3.2,362.12481412092336,1
2020-10-14-170613,170613,9,0,23,680,2.0,478.6131822455875,2
2020-10-15-170613,170613,11,0,14,691,2.6,579.3160093863844,3
2020-10-16-170613,170613,31,0,15,722,2.4,675.1216701150909,4
2020-10-17-170613,170613,4,0,4,726,1.2,715.4742277262912,5
2020-10-18-170613,170613,5,0,4,731,1.8,680.2015183875505,6
2020-10-19-170613,170613,14,0,7,745,5.0,626.4659770112388,0
2020-10-20-170613,170613,18,0,12,763,2.0,787.4703202183559,1
2020-10-21-170613,170613,9,0,18,772,4.4,869.3684974361975,2
2020-10-22-170613,170613,27,0,8,799,2.2,911.9770978542731,3
2020-10-23-170613,170613,20,0,11,819,3.4,963.7883084351487,4
2020-10-24-170613,170613,10,0,6,829,1.4,1061.4222514713856,5
2020-10-25-170613,170613,7,0,2,836,2.0,1093.8152009255668,6
2020-10-26-170613,170613,10,1,4,846,1.2,1003.934677581175,0
2020-10-27-170613,170613,12,0,11,858,5.8,981.3877050746767,1
2020-10-28-170613,170613,23,2,9,881,2.6,932.1895887401631,2
2020-10-29-170613,170613,14,0,13,895,1.8,980.3786465766411,3
2020-10-30-170613,170613,15,0,8,910,6.0,852.5742521116357,4
2020-10-31-170613,170613,4,1,0,914,1.2,919.6967995014452,5
2020-11-01-170613,170613,4,0,0,918,2.0,715.2567021956413,6
2020-11-02-170613,170613,7,0,0,925,3.8,376.6827877168685,0
2020-11-03-170613,170613,12,0,0,937,3.2,328.7742102943971,1
2020-11-04-170613,170613,18,0,0,955,3.8,449.2784230885135,2
2020-11-05-170613,170613,8,0,0,963,3.0,570.6656045827383,3
2020-11-06-170613,170613,11,0,0,974,5.4,616.6836654869837,4
2020-11-07-170613,170613,6,2,0,980,1.0,692.1457493267743,5
2020-11-08-170613,170613,2,0,0,982,2.6,668.5627609109922,6
2020-11-09-170613,170613,4,0,0,986,3.4,609.4702345516457,0
2020-11-10-170613,170613,11,0,0,997,2.0,707.7575417893785,1
2020-11-11-170613,170613,9,0,0,1006,6.2,697.0198738677784,2
2020-11-12-170613,170613,13,0,0,1019,4.2,671.7900333124946,3
2020-11-13-170613,170613,8,0,0,1027,7.4,654.7412115740908,4
2020-03-01-170614,170614,0,0,6,0,0.16666666666666666,0.0,6
2020-03-02-170614,170614,0,0,24,0,0.0,87.0733702388753,0
2020-03-03-170614,170614,0,1,23,0,0.3333333333333333,371.9660578476533,1
2020-03-04-170614,170614,0,0,34,0,0.16666666666666666,404.08021333781704,2
2020-03-05-170614,170614,0,0,24,0,0.0,414.3138513606874,3
2020-03-06-170614,170614,0,0,34,0,0.16666666666666666,357.544594287722,4
2020-03-07-170614,170614,0,0,7,0,0.0,385.22753092998107,5
2020-03-08-170614,170614,0,0,9,0,0.0,371.0557580067186,6
2020-03-09-170614,170614,0,0,44,0,1.1666666666666667,368.6422018718211,0
2020-03-10-170614,170614,0,0,34,0,0.6666666666666666,597.2913887766706,1
2020-03-11-170614,170614,1,0,40,1,1.0,444.7548309649132,2
2020-03-12-170614,170614,5,0,24,6,1.0,346.12344017139264,3
2020-03-13-170614,170614,5,0,25,11,2.833333333333333,229.99075553504,4
2020-03-14-170614,170614,3,0,6,14,3.333333333333333,220.52455210809129,5
2020-03-15-170614,170614,6,0,6,20,7.333333333333332,201.57218498601364,6
2020-03-16-170614,170614,24,0,27,44,16.166666666666668,147.55953293992758,0
2020-03-17-170614,170614,23,0,17,67,15.833333333333336,247.77127625764922,1
2020-03-18-170614,170614,34,0,12,101,23.33333333333333,338.1575357040888,2
2020-03-19-170614,170614,24,0,8,125,17.333333333333332,399.1689886552485,3
2020-03-20-170614,170614,34,0,8,159,18.83333333333333,427.8008835536425,4
2020-03-21-170614,170614,7,0,8,166,11.666666666666664,469.3055095853316,5
2020-03-22-170614,170614,9,0,3,175,11.5,450.7982344541419,6
2020-03-23-170614,170614,44,0,44,219,28.5,416.0816235760441,0
2020-03-24-170614,170614,34,0,9,253,26.5,473.39935036258294,1
2020-03-25-170614,170614,40,0,9,293,24.83333333333333,513.3911691763784,2
2020-03-26-170614,170614,24,0,2,317,24.0,549.2006695809662,3
2020-03-27-170614,170614,25,0,6,342,20.33333333333333,653.0949081878833,4
2020-03-28-170614,170614,6,0,6,348,6.666666666666668,663.091178643696,5
2020-03-29-170614,170614,6,0,6,354,6.0,648.7951988814946,6
2020-03-30-170614,170614,27,1,15,381,20.5,505.23849942394116,0
2020-03-31-170614,170614,17,0,13,398,16.833333333333332,480.0528139572908,1
2020-04-01-170614,170614,12,0,8,410,14.166666666666664,69.77533084825731,2
2020-04-02-170614,170614,8,0,3,418,9.666666666666666,208.58810691399708,3
2020-04-03-170614,170614,8,0,13,426,11.666666666666664,118.33104610894705,4
2020-04-04-170614,170614,8,0,3,434,3.1666666666666665,162.06813617533524,5
2020-04-05-170614,170614,3,0,1,437,6.166666666666668,166.51117769309354,6
2020-04-06-170614,170614,44,1,5,481,12.5,178.2246974189346,0
2020-04-07-170614,170614,9,0,6,490,9.0,211.50931560041053,1
2020-04-08-170614,170614,9,0,7,499,9.0,238.9396070843983,2
2020-04-09-170614,170614,2,1,1,501,4.166666666666667,256.1927516419553,3
2020-04-10-170614,170614,6,0,4,507,5.833333333333332,68.23377265837813,4
2020-04-11-170614,170614,6,0,2,513,4.0,92.86461440916344,5
2020-04-12-170614,170614,6,0,2,519,2.6666666666666665,105.41276534609452,6
2020-04-13-170614,170614,15,0,14,534,12.166666666666664,120.28350739292009,0
2020-04-14-170614,170614,13,0,4,547,7.0,167.47817068595836,1
2020-04-15-170614,170614,8,0,10,555,5.333333333333333,206.88371422367928,2
2020-04-16-170614,170614,3,0,0,558,7.166666666666668,232.73847013458257,3
2020-04-17-170614,170614,13,0,3,571,5.666666666666668,209.74852761938686,4
2020-04-18-170614,170614,3,0,1,574,2.333333333333333,219.49695338644855,5
2020-04-19-170614,170614,1,0,2,575,1.8333333333333333,224.88661054334474,6
2020-04-20-170614,170614,5,0,11,580,7.333333333333332,206.69611564087143,0
2020-04-21-170614,170614,6,0,8,586,4.833333333333333,203.3782244133992,1
2020-04-22-170614,170614,7,0,5,593,6.666666666666668,212.22352553690178,2
2020-04-23-170614,170614,1,0,7,594,1.3333333333333333,209.231573906423,3
2020-04-24-170614,170614,4,0,8,598,4.166666666666667,181.52524793219357,4
2020-04-25-170614,170614,2,0,1,600,1.8333333333333333,179.09126344187655,5
2020-04-26-170614,170614,2,0,1,602,1.0,182.78811341578273,6
2020-04-27-170614,170614,14,0,8,616,6.0,152.13160965396412,0
2020-04-28-170614,170614,4,0,51,620,4.166666666666667,147.90406404923402,1
2020-04-29-170614,170614,10,0,4,630,4.666666666666667,129.57320093369327,2
2020-04-30-170614,170614,0,0,5,630,4.5,167.17650951974912,3
2020-05-01-170614,170614,3,0,6,633,1.1666666666666667,236.54594067964246,4
2020-05-02-170614,170614,1,0,1,634,2.0,96.4196113745451,5
2020-05-03-170614,170614,2,0,0,636,1.1666666666666667,60.78537182342587,6
2020-05-04-170614,170614,11,0,1,647,3.8333333333333335,53.08565342696257,0
2020-05-05-170614,170614,8,0,5,655,6.666666666666668,73.21248298795808,1
2020-05-06-170614,170614,5,0,6,660,3.8333333333333335,81.98845694517195,2
2020-05-07-170614,170614,7,0,3,667,4.333333333333333,98.09644559726203,3
2020-05-08-170614,170614,8,0,7,675,7.333333333333332,109.54521572290034,4
2020-05-09-170614,170614,1,0,0,676,1.3333333333333333,145.94910806741134,5
2020-05-10-170614,170614,1,0,0,677,0.3333333333333333,262.24041095866187,6
2020-05-11-170614,170614,8,0,1,685,6.333333333333332,241.95842583164705,0
2020-05-12-170614,170614,51,0,4,736,9.166666666666666,249.79774198718798,1
2020-05-13-170614,170614,4,0,4,740,5.333333333333333,221.68167434126167,2
2020-05-14-170614,170614,5,1,2,745,4.0,197.20893709624735,3
2020-05-15-170614,170614,6,0,3,751,5.5,167.90356364393028,4
2020-05-16-170614,170614,1,0,0,752,0.8333333333333334,170.32167653719014,5
2020-05-17-170614,170614,0,0,0,752,0.16666666666666666,160.9265115382498,6
2020-05-18-170614,170614,1,0,4,753,2.833333333333333,161.74682697054885,0
2020-05-19-170614,170614,5,0,2,758,3.1666666666666665,148.59588584764944,1
2020-05-20-170614,170614,6,0,2,764,1.5,103.70468775403283,2
2020-05-21-170614,170614,3,0,4,767,2.833333333333333,101.84198884789188,3
2020-05-22-170614,170614,7,0,2,774,3.333333333333333,89.31407407030306,4
2020-05-23-170614,170614,0,0,1,774,0.3333333333333333,105.82295673522209,5
2020-05-24-170614,170614,0,0,0,774,0.16666666666666666,106.79628645892276,6
2020-05-25-170614,170614,1,0,3,775,1.8333333333333333,89.83900066272864,0
2020-05-26-170614,170614,4,0,3,779,1.5,86.14745684189108,1
2020-05-27-170614,170614,4,1,2,783,2.6666666666666665,85.73613734699708,2
2020-05-28-170614,170614,2,5,1,785,2.5,85.41994682603013,3
2020-05-29-170614,170614,3,0,0,788,2.5,82.75719308440345,4
2020-05-30-170614,170614,0,0,0,788,0.6666666666666666,87.35308972253904,5
2020-05-31-170614,170614,0,0,0,788,0.16666666666666666,88.86521916723899,6
2020-06-01-170614,170614,4,0,2,792,3.0,191.99612619364189,0
2020-06-02-170614,170614,2,0,1,794,1.1666666666666667,53.9605197217154,1
2020-06-03-170614,170614,2,0,0,796,3.1666666666666665,37.494007036195924,2
2020-06-04-170614,170614,4,0,1,800,3.333333333333333,41.14841737407717,3
2020-06-05-170614,170614,2,0,4,802,1.0,56.20449523048848,4
2020-06-06-170614,170614,1,0,0,803,0.0,64.44898447054643,5
2020-06-07-170614,170614,0,0,0,803,0.16666666666666666,64.95437867546374,6
2020-06-08-170614,170614,3,0,4,806,1.1666666666666667,66.10021129813119,0
2020-06-09-170614,170614,3,0,2,809,2.1666666666666665,71.02017858801216,1
2020-06-10-170614,170614,2,0,1,811,1.5,225.4436214841359,2
2020-06-11-170614,170614,1,0,2,812,2.0,197.89566465369208,3
2020-06-12-170614,170614,0,0,2,812,0.6666666666666666,187.18888884311036,4
2020-06-13-170614,170614,0,0,0,812,0.3333333333333333,145.06733252283487,5
2020-06-14-170614,170614,0,0,0,812,0.0,108.09268300793629,6
2020-06-15-170614,170614,2,0,1,814,2.833333333333333,64.77264342488024,0
2020-06-16-170614,170614,1,0,1,815,1.5,66.99910507343604,1
2020-06-17-170614,170614,0,0,2,815,1.8333333333333333,52.58497689897777,2
2020-06-18-170614,170614,1,0,0,816,2.6666666666666665,50.37271556807291,3
2020-06-19-170614,170614,4,0,3,820,2.0,47.45788579821866,4
2020-06-20-170614,170614,0,0,0,820,0.0,74.85136245995365,5
2020-06-21-170614,170614,0,0,0,820,0.16666666666666666,75.40965507164026,6
2020-06-22-170614,170614,4,0,1,824,1.5,65.07945127291427,0
2020-06-23-170614,170614,2,0,0,826,1.5,68.57189608943757,1
2020-06-24-170614,170614,1,0,0,827,1.5,70.25275668148151,2
2020-06-25-170614,170614,2,0,2,829,1.1666666666666667,62.34481959427292,3
2020-06-26-170614,170614,2,0,4,831,2.0,53.58975925415622,4
2020-06-27-170614,170614,0,0,0,831,0.0,49.962319501797595,5
2020-06-28-170614,170614,0,0,0,831,0.0,50.785884214777816,6
2020-06-29-170614,170614,1,0,1,832,0.8333333333333334,50.203841247980534,0
2020-06-30-170614,170614,1,0,1,833,1.0,49.398381068886934,1
2020-07-01-170614,170614,2,0,1,835,0.5,80.27340396410959,2
2020-07-02-170614,170614,0,0,0,835,1.3333333333333333,26.12959821048045,3
2020-07-03-170614,170614,3,1,0,838,0.6666666666666666,46.5085066634459,4
2020-07-04-170614,170614,0,0,0,838,0.0,62.643003911324456,5
2020-07-05-170614,170614,0,0,0,838,0.0,60.262670480671666,6
2020-07-06-170614,170614,1,0,0,839,0.6666666666666666,50.26614141935483,0
2020-07-07-170614,170614,0,0,2,839,1.5,47.379623449672636,1
2020-07-08-170614,170614,0,1,2,839,0.3333333333333333,43.189145679438845,2
2020-07-09-170614,170614,2,0,0,841,0.8333333333333334,39.22714710039379,3
2020-07-10-170614,170614,4,0,1,845,0.5,82.19737799031435,4
2020-07-11-170614,170614,0,0,0,845,0.16666666666666666,62.42124992858173,5
2020-07-12-170614,170614,0,0,0,845,0.16666666666666666,42.63819200014209,6
2020-07-13-170614,170614,1,0,0,846,0.3333333333333333,43.125200196509454,0
2020-07-14-170614,170614,1,0,2,847,0.8333333333333334,46.56624825980834,1
2020-07-15-170614,170614,1,0,0,848,1.0,39.64596315034162,2
2020-07-16-170614,170614,0,0,2,848,1.1666666666666667,29.005737075692444,3
2020-07-17-170614,170614,0,0,3,848,0.8333333333333334,25.38648674554061,4
2020-07-18-170614,170614,0,0,2,848,0.0,25.763282996312164,5
2020-07-19-170614,170614,0,0,1,848,0.0,25.55617224055465,6
2020-07-20-170614,170614,0,0,2,848,1.0,22.534797537523602,0
2020-07-21-170614,170614,2,0,1,850,0.3333333333333333,23.866062942043314,1
2020-07-22-170614,170614,2,0,4,852,0.6666666666666666,37.66574370542957,2
2020-07-23-170614,170614,0,0,2,852,0.6666666666666666,35.938366758781136,3
2020-07-24-170614,170614,1,1,4,853,0.5,40.21588997537006,4
2020-07-25-170614,170614,0,0,0,853,0.3333333333333333,47.249227905533075,5
2020-07-26-170614,170614,0,1,0,853,0.6666666666666666,48.01073890809536,6
2020-07-27-170614,170614,0,0,0,853,0.6666666666666666,47.98096094853405,0
2020-07-28-170614,170614,2,0,1,855,1.0,51.120767360192275,1
2020-07-29-170614,170614,0,0,1,855,0.8333333333333334,39.96990976183264,2
2020-07-30-170614,170614,2,0,2,857,0.8333333333333334,42.03389121443739,3
2020-07-31-170614,170614,3,2,5,860,2.333333333333333,47.9807863320008,4
2020-08-01-170614,170614,2,0,2,862,0.16666666666666666,31.388347766175254,5
2020-08-02-170614,170614,1,0,4,863,1.3333333333333333,222.23447155965442,6
2020-08-03-170614,170614,2,0,11,865,2.6666666666666665,337.7592565210381,0
2020-08-04-170614,170614,1,0,2,866,1.6666666666666667,311.3882514895643,1
2020-08-05-170614,170614,4,0,16,870,4.333333333333333,257.189262981683,2
2020-08-06-170614,170614,2,0,17,872,3.333333333333333,243.93856119189127,3
2020-08-07-170614,170614,4,0,7,876,5.833333333333332,192.39475521687308,4
2020-08-08-170614,170614,0,0,2,876,0.8333333333333334,204.69810295886919,5
2020-08-09-170614,170614,0,0,1,876,0.8333333333333334,199.715385072413,6
2020-08-10-170614,170614,0,0,9,876,2.6666666666666665,22.687107558137292,0
2020-08-11-170614,170614,1,0,3,877,3.8333333333333335,43.31821952071796,1
2020-08-12-170614,170614,1,0,9,878,3.333333333333333,63.600771951668136,2
2020-08-13-170614,170614,2,0,2,880,8.166666666666666,89.63909455064223,3
2020-08-14-170614,170614,5,0,10,885,4.166666666666667,122.68676986463987,4
2020-08-15-170614,170614,2,0,4,887,2.0,149.14476459304228,5
2020-08-16-170614,170614,4,0,4,891,1.1666666666666667,157.30325095683236,6
2020-08-17-170614,170614,11,1,9,902,6.666666666666668,164.48762263119679,0
2020-08-18-170614,170614,2,0,4,904,4.666666666666667,185.60415063882442,1
2020-08-19-170614,170614,16,0,3,920,4.0,190.69330462629136,2
2020-08-20-170614,170614,17,0,6,937,4.333333333333333,169.4643568767707,3
2020-08-21-170614,170614,7,0,13,944,6.0,182.86703168030235,4
2020-08-22-170614,170614,2,0,1,946,0.6666666666666666,203.18738574337382,5
2020-08-23-170614,170614,1,0,5,947,1.6666666666666667,200.51913817806513,6
2020-08-24-170614,170614,9,0,7,956,6.666666666666668,172.50842443981463,0
2020-08-25-170614,170614,3,2,4,959,7.666666666666668,201.207805191179,1
2020-08-26-170614,170614,9,0,6,968,8.166666666666666,215.01119709129395,2
2020-08-27-170614,170614,2,1,3,970,6.833333333333332,266.5506327444042,3
2020-08-28-170614,170614,10,0,10,980,9.833333333333334,266.3140215204925,4
2020-08-29-170614,170614,4,0,6,984,2.6666666666666665,297.2553181805973,5
2020-08-30-170614,170614,4,0,5,988,1.3333333333333333,313.01674616771754,6
2020-08-31-170614,170614,9,0,6,997,10.5,273.60494148515807,0
2020-09-01-170614,170614,4,0,1,1001,7.666666666666668,187.01012195997308,1
2020-09-02-170614,170614,3,0,1,1004,6.666666666666668,287.2696244618073,2
2020-09-03-170614,170614,6,0,3,1010,7.166666666666668,286.3257839293975,3
2020-09-04-170614,170614,13,0,6,1023,8.833333333333334,276.20425961790124,4
2020-09-05-170614,170614,1,0,6,1024,4.333333333333333,303.6807826545912,5
2020-09-06-170614,170614,5,0,1,1029,3.1666666666666665,315.44685129750513,6
2020-09-07-170614,170614,7,1,6,1036,11.166666666666664,316.04954227576604,0
2020-09-08-170614,170614,4,0,5,1040,1.3333333333333333,335.70710099875794,1
2020-09-09-170614,170614,6,0,2,1046,5.666666666666668,301.3924341890017,2
2020-09-10-170614,170614,3,1,7,1049,7.0,169.9505148109788,3
2020-09-11-170614,170614,10,0,5,1059,12.666666666666664,200.49648959817029,4
2020-09-12-170614,170614,6,1,2,1065,2.0,251.6017811816278,5
2020-09-13-170614,170614,5,0,0,1070,2.6666666666666665,253.1280091257256,6
2020-09-14-170614,170614,6,1,3,1076,13.666666666666664,239.60193440400272,0
2020-09-15-170614,170614,1,0,6,1077,7.0,309.6821343060441,1
2020-09-16-170614,170614,1,1,2,1078,5.333333333333333,360.1880795857362,2
2020-09-17-170614,170614,3,0,3,1081,5.333333333333333,349.4853904084555,3
2020-09-18-170614,170614,6,0,3,1087,6.666666666666668,344.06077334613786,4
2020-09-19-170614,170614,6,1,0,1093,0.6666666666666666,319.20645144577895,5
2020-09-20-170614,170614,1,0,4,1094,3.5,331.3628580824214,6
2020-09-21-170614,170614,6,0,5,1100,10.833333333333336,269.91844201452045,0
2020-09-22-170614,170614,5,1,14,1105,7.5,300.962863465816,1
2020-09-23-170614,170614,2,2,8,1107,5.333333333333333,331.3706383228284,2
2020-09-24-170614,170614,7,0,7,1114,7.666666666666668,345.2430134569391,3
2020-09-25-170614,170614,5,1,4,1119,5.5,342.6299836755193,4
2020-09-26-170614,170614,2,0,1,1121,1.1666666666666667,374.8003570290422,5
2020-09-27-170614,170614,0,0,1,1121,1.3333333333333333,359.18197483815743,6
2020-09-28-170614,170614,3,0,6,1124,5.666666666666668,357.2280269711203,0
2020-09-29-170614,170614,6,0,3,1130,5.833333333333332,334.66663150614147,1
2020-09-30-170614,170614,2,0,11,1132,6.833333333333332,319.0167208471894,2
2020-10-01-170614,170614,3,0,4,1135,4.5,0.0,3
2020-10-02-170614,170614,3,0,10,1138,4.666666666666667,664.4617946873788,4
2020-10-03-170614,170614,0,0,0,1138,1.8333333333333333,804.6457070407173,5
2020-10-04-170614,170614,4,0,2,1142,2.0,728.5078183013893,6
2020-10-05-170614,170614,5,0,37,1147,8.5,608.9656870290344,0
2020-10-06-170614,170614,14,1,17,1161,8.833333333333334,556.8582085496519,1
2020-10-07-170614,170614,8,0,17,1169,6.5,476.6905507984063,2
2020-10-08-170614,170614,7,1,14,1176,6.833333333333332,459.1102363851546,3
2020-10-09-170614,170614,4,4,16,1180,12.166666666666664,522.148284651496,4
2020-10-10-170614,170614,1,0,1,1181,3.5,40.23406225730536,5
2020-10-11-170614,170614,1,0,0,1182,5.0,82.02832761022454,6
2020-10-12-170614,170614,6,0,9,1188,3.5,126.9046808219455,0
2020-10-13-170614,170614,3,0,17,1191,12.0,159.58074557466938,1
2020-10-14-170614,170614,11,0,9,1202,9.833333333333334,264.8009500672398,2
2020-10-15-170614,170614,4,0,11,1206,13.833333333333336,351.92223009018494,3
2020-10-16-170614,170614,10,0,16,1216,16.0,456.14662812768336,4
2020-10-17-170614,170614,0,0,2,1216,3.0,552.3821063397304,5
2020-10-18-170614,170614,2,0,3,1218,4.333333333333333,534.9400614030908,6
2020-10-19-170614,170614,37,0,3,1255,14.833333333333336,532.1729130466263,0
2020-10-20-170614,170614,17,0,20,1272,15.166666666666664,579.9988844429361,1
2020-10-21-170614,170614,17,0,11,1289,15.166666666666664,603.9289602978071,2
2020-10-22-170614,170614,14,0,12,1303,15.833333333333336,631.4003898798494,3
2020-10-23-170614,170614,16,1,7,1319,20.0,635.5256148410162,4
2020-10-24-170614,170614,1,1,8,1320,2.6666666666666665,744.8209192597425,5
2020-10-25-170614,170614,0,1,4,1320,8.0,725.3783579555463,6
2020-10-26-170614,170614,9,0,20,1329,19.33333333333333,655.9686205857226,0
2020-10-27-170614,170614,17,0,10,1346,14.166666666666664,756.612209617264,1
2020-10-28-170614,170614,9,1,6,1355,15.0,783.8027666666673,2
2020-10-29-170614,170614,11,0,2,1366,11.333333333333336,788.9556548434975,3
2020-10-30-170614,170614,16,0,7,1382,18.5,621.2585668403307,4
2020-10-31-170614,170614,2,0,0,1384,4.833333333333333,709.8150740970709,5
2020-11-01-170614,170614,3,1,0,1387,6.0,434.5348630824126,6
2020-11-02-170614,170614,3,0,0,1390,3.1666666666666665,260.96887856971273,0
2020-11-03-170614,170614,20,0,0,1410,17.666666666666668,241.92310302479663,1
2020-11-04-170614,170614,11,0,0,1421,14.333333333333336,339.45390649259934,2
2020-11-05-170614,170614,12,0,0,1433,10.833333333333336,412.5680470943074,3
2020-11-06-170614,170614,7,1,0,1440,12.0,449.6981787207826,4
2020-11-07-170614,170614,8,0,0,1448,2.6666666666666665,494.51733958151726,5
2020-11-08-170614,170614,4,0,0,1452,4.0,471.4600831443053,6
2020-11-09-170614,170614,20,0,0,1472,11.166666666666664,471.2097971778802,0
2020-11-10-170614,170614,10,1,0,1482,9.833333333333334,421.72300418040635,1
2020-11-11-170614,170614,6,2,0,1488,8.666666666666666,460.48913445498846,2
2020-11-12-170614,170614,2,2,0,1490,11.166666666666664,439.22953322689614,3
2020-11-13-170614,170614,7,0,0,1497,10.166666666666666,440.3563852050578,4
2020-03-01-170615,170615,0,0,1,0,0.0,0.0,6
2020-03-02-170615,170615,0,0,3,0,0.0,5.6655826820946515,0
2020-03-03-170615,170615,0,0,2,0,0.0,31.904289840680523,1
2020-03-04-170615,170615,0,0,1,0,0.0,30.44613098761529,2
2020-03-05-170615,170615,0,0,1,0,0.3333333333333333,26.94982782693951,3
2020-03-06-170615,170615,0,0,0,0,0.3333333333333333,22.05878624860371,4
2020-03-07-170615,170615,0,0,0,0,0.0,23.91109041508505,5
2020-03-08-170615,170615,0,0,1,0,0.0,21.241384818644846,6
2020-03-09-170615,170615,0,0,0,0,0.0,21.107898654893816,0
2020-03-10-170615,170615,0,0,0,0,0.0,44.84238908008905,1
2020-03-11-170615,170615,0,0,2,0,0.3333333333333333,31.710124638651706,2
2020-03-12-170615,170615,0,0,0,0,0.0,27.441163351007088,3
2020-03-13-170615,170615,0,0,1,0,0.0,18.238576113825523,4
2020-03-14-170615,170615,1,0,0,1,1.0,15.268520809881963,5
2020-03-15-170615,170615,1,0,0,2,1.6666666666666667,14.744496919843453,6
2020-03-16-170615,170615,3,0,1,5,7.0,11.103781714061737,0
2020-03-17-170615,170615,2,0,2,7,4.0,16.40286499875397,1
2020-03-18-170615,170615,1,1,0,8,5.333333333333333,21.07222112479038,2
2020-03-19-170615,170615,1,0,0,9,4.666666666666667,26.493377975162176,3
2020-03-20-170615,170615,0,0,1,9,7.0,29.119688714192105,4
2020-03-21-170615,170615,0,0,0,9,1.6666666666666667,35.879851915198664,5
2020-03-22-170615,170615,1,0,3,10,1.6666666666666667,33.482808129447534,6
2020-03-23-170615,170615,0,0,0,10,8.0,34.02762681593602,0
2020-03-24-170615,170615,0,0,1,10,8.666666666666666,42.63228944149148,1
2020-03-25-170615,170615,2,0,0,12,9.333333333333334,45.6399728493457,2
2020-03-26-170615,170615,0,0,0,12,6.333333333333332,49.91016772877389,3
2020-03-27-170615,170615,1,0,0,13,4.333333333333333,62.80702675765649,4
2020-03-28-170615,170615,0,0,0,13,3.6666666666666665,62.60266921269126,5
2020-03-29-170615,170615,0,0,1,13,2.333333333333333,63.51782545809509,6
2020-03-30-170615,170615,1,0,0,14,4.666666666666667,48.63247485288937,0
2020-03-31-170615,170615,2,0,1,16,4.333333333333333,42.568226752622344,1
2020-04-01-170615,170615,0,0,1,16,3.333333333333333,5.845243189784514,2
2020-04-02-170615,170615,0,0,0,16,4.0,18.159300568334388,3
2020-04-03-170615,170615,1,0,0,17,4.666666666666667,10.222224129257317,4
2020-04-04-170615,170615,0,0,0,17,1.3333333333333333,14.03553658812298,5
2020-04-05-170615,170615,3,0,1,20,2.333333333333333,15.72576119875678,6
2020-04-06-170615,170615,0,0,0,20,5.666666666666668,17.419393941397914,0
2020-04-07-170615,170615,1,0,0,21,6.333333333333332,20.768805929384783,1
2020-04-08-170615,170615,0,1,0,21,3.0,21.723446755027375,2
2020-04-09-170615,170615,0,0,0,21,1.0,24.662649862981628,3
2020-04-10-170615,170615,0,0,0,21,1.3333333333333333,4.799570816779782,4
2020-04-11-170615,170615,0,0,0,21,3.0,8.505226541085687,5
2020-04-12-170615,170615,1,0,1,22,1.6666666666666667,8.925200069843171,6
2020-04-13-170615,170615,0,0,0,22,8.666666666666666,9.238704467640957,0
2020-04-14-170615,170615,1,0,0,23,1.6666666666666667,15.164846982182201,1
2020-04-15-170615,170615,1,0,0,24,3.6666666666666665,18.517677438145967,2
2020-04-16-170615,170615,0,0,0,24,0.6666666666666666,21.95315242730937,3
2020-04-17-170615,170615,0,0,0,24,1.3333333333333333,20.897763627449397,4
2020-04-18-170615,170615,0,0,1,24,2.333333333333333,19.621167561645834,5
2020-04-19-170615,170615,1,0,0,25,1.3333333333333333,21.269726127895805,6
2020-04-20-170615,170615,0,0,0,25,2.333333333333333,25.119722997843965,0
2020-04-21-170615,170615,0,0,0,25,1.6666666666666667,27.27827183950921,1
2020-04-22-170615,170615,0,0,0,25,1.3333333333333333,27.472036964338706,2
2020-04-23-170615,170615,0,0,1,25,2.0,28.227226438609357,3
2020-04-24-170615,170615,0,0,0,25,1.0,26.46209995724144,4
2020-04-25-170615,170615,0,0,0,25,0.6666666666666666,25.643150140628002,5
2020-04-26-170615,170615,1,0,0,26,0.3333333333333333,26.15525300078408,6
2020-04-27-170615,170615,0,0,1,26,2.333333333333333,16.102121578067045,0
2020-04-28-170615,170615,0,0,0,26,0.6666666666666666,12.346203234340425,1
2020-04-29-170615,170615,0,0,0,26,1.0,13.101421738168407,2
2020-04-30-170615,170615,0,0,0,26,1.3333333333333333,15.208168488038996,3
2020-05-01-170615,170615,0,0,0,26,0.6666666666666666,26.156424421433627,4
2020-05-02-170615,170615,1,0,0,27,1.0,7.479489961358579,5
2020-05-03-170615,170615,0,0,0,27,0.3333333333333333,11.96296502576784,6
2020-05-04-170615,170615,0,0,0,27,3.6666666666666665,11.938951563766032,0
2020-05-05-170615,170615,0,0,0,27,2.6666666666666665,15.956454487856561,1
2020-05-06-170615,170615,0,0,0,27,2.0,17.400226553023973,2
2020-05-07-170615,170615,1,0,1,28,1.0,26.48803079291643,3
2020-05-08-170615,170615,0,0,0,28,0.6666666666666666,32.718926634139805,4
2020-05-09-170615,170615,0,1,0,28,2.6666666666666665,35.030503067817676,5
2020-05-10-170615,170615,0,1,0,28,0.6666666666666666,29.136648855865626,6
2020-05-11-170615,170615,1,4,0,29,1.6666666666666667,25.064767910640754,0
2020-05-12-170615,170615,0,2,0,29,1.0,24.554927693370296,1
2020-05-13-170615,170615,0,0,0,29,1.3333333333333333,18.77873789969825,2
2020-05-14-170615,170615,0,1,0,29,0.0,16.277101543640725,3
2020-05-15-170615,170615,0,0,0,29,0.6666666666666666,13.195897055018103,4
2020-05-16-170615,170615,0,1,0,29,0.3333333333333333,11.148290253034634,5
2020-05-17-170615,170615,0,0,0,29,0.3333333333333333,10.373442641172812,6
2020-05-18-170615,170615,0,0,0,29,5.0,10.513594958776341,0
2020-05-19-170615,170615,0,0,0,29,0.6666666666666666,9.974491848539486,1
2020-05-20-170615,170615,0,0,0,29,0.3333333333333333,7.095696164679852,2
2020-05-21-170615,170615,1,0,1,30,1.0,6.776620877028231,3
2020-05-22-170615,170615,0,0,0,30,1.3333333333333333,7.40454963884934,4
2020-05-23-170615,170615,0,0,0,30,0.3333333333333333,9.62206232621557,5
2020-05-24-170615,170615,0,0,0,30,0.6666666666666666,10.021598134214035,6
2020-05-25-170615,170615,0,0,0,30,1.3333333333333333,8.489794736955448,0
2020-05-26-170615,170615,0,0,0,30,0.0,9.746678490537631,1
2020-05-27-170615,170615,0,0,0,30,0.0,9.31588105623031,2
2020-05-28-170615,170615,0,1,0,30,1.0,12.155927885464191,3
2020-05-29-170615,170615,0,0,0,30,1.0,14.892741758162517,4
2020-05-30-170615,170615,0,0,0,30,0.3333333333333333,20.31667091188799,5
2020-05-31-170615,170615,0,0,0,30,0.0,19.670746772645572,6
2020-06-01-170615,170615,0,0,0,30,0.6666666666666666,44.03939751182443,0
2020-06-02-170615,170615,0,0,0,30,0.3333333333333333,6.420938915665111,1
2020-06-03-170615,170615,0,0,0,30,0.0,3.547155832494268,2
2020-06-04-170615,170615,1,0,0,31,2.0,6.501792546275478,3
2020-06-05-170615,170615,0,1,0,31,0.6666666666666666,9.788581530929124,4
2020-06-06-170615,170615,0,0,0,31,0.0,12.187990258690377,5
2020-06-07-170615,170615,0,0,0,31,0.0,11.949221820394031,6
2020-06-08-170615,170615,0,0,0,31,0.3333333333333333,11.964742824319657,0
2020-06-09-170615,170615,0,0,0,31,0.0,11.742545813244112,1
2020-06-10-170615,170615,0,0,0,31,0.0,44.67876718257783,2
2020-06-11-170615,170615,0,0,0,31,2.333333333333333,39.65497346527246,3
2020-06-12-170615,170615,0,0,0,31,0.0,37.56739140237923,4
2020-06-13-170615,170615,0,4,0,31,0.3333333333333333,23.612599284105833,5
2020-06-14-170615,170615,0,0,0,31,0.0,11.437854037742543,6
2020-06-15-170615,170615,0,0,0,31,0.3333333333333333,7.717499444525673,0
2020-06-16-170615,170615,0,1,0,31,0.0,7.174281592047228,1
2020-06-17-170615,170615,0,0,0,31,0.0,6.050881585473633,2
2020-06-18-170615,170615,0,0,0,31,0.0,5.687835547199473,3
2020-06-19-170615,170615,0,0,0,31,1.3333333333333333,5.060255694424479,4
2020-06-20-170615,170615,0,0,0,31,0.0,7.6025946413183885,5
2020-06-21-170615,170615,0,0,0,31,0.0,7.649099602809242,6
2020-06-22-170615,170615,0,0,0,31,0.0,6.666402675302283,0
2020-06-23-170615,170615,0,0,0,31,0.6666666666666666,12.510032072494125,1
2020-06-24-170615,170615,0,0,0,31,0.0,13.501016283308804,2
2020-06-25-170615,170615,0,0,0,31,0.3333333333333333,11.64017562104643,3
2020-06-26-170615,170615,0,0,0,31,0.3333333333333333,10.242228444420377,4
2020-06-27-170615,170615,0,0,0,31,0.0,9.193427891417809,5
2020-06-28-170615,170615,0,0,0,31,0.6666666666666666,9.38854716989067,6
2020-06-29-170615,170615,0,0,0,31,0.0,9.581441679498255,0
2020-06-30-170615,170615,0,0,0,31,0.0,5.970082559895856,1
2020-07-01-170615,170615,0,0,0,31,0.0,11.908507375277011,2
2020-07-02-170615,170615,0,0,0,31,0.3333333333333333,4.371146591694532,3
2020-07-03-170615,170615,0,0,0,31,0.0,7.020031101846529,4
2020-07-04-170615,170615,0,0,0,31,0.0,7.754189565884737,5
2020-07-05-170615,170615,0,0,0,31,0.3333333333333333,7.451348769839955,6
2020-07-06-170615,170615,0,0,0,31,1.0,7.689957537840742,0
2020-07-07-170615,170615,0,0,0,31,0.3333333333333333,8.226264405354142,1
2020-07-08-170615,170615,0,0,0,31,0.0,5.921756073989706,2
2020-07-09-170615,170615,0,0,3,31,0.0,5.473402779858523,3
2020-07-10-170615,170615,0,0,0,31,0.0,11.5422535796172,4
2020-07-11-170615,170615,0,0,0,31,0.0,6.653201268829038,5
2020-07-12-170615,170615,0,0,1,31,0.0,3.7841571551763153,6
2020-07-13-170615,170615,0,0,0,31,0.3333333333333333,5.826274726641634,0
2020-07-14-170615,170615,0,0,0,31,0.3333333333333333,6.165924510788189,1
2020-07-15-170615,170615,0,0,1,31,0.0,8.562167298613137,2
2020-07-16-170615,170615,0,0,0,31,0.3333333333333333,6.1268307988651465,3
2020-07-17-170615,170615,0,0,0,31,0.0,6.962929560949801,4
2020-07-18-170615,170615,0,0,0,31,0.0,7.208748818105248,5
2020-07-19-170615,170615,0,0,0,31,0.0,7.131016401026163,6
2020-07-20-170615,170615,0,0,0,31,0.3333333333333333,4.7088281648821075,0
2020-07-21-170615,170615,0,0,0,31,0.3333333333333333,2.3328968807763966,1
2020-07-22-170615,170615,0,0,1,31,0.0,4.681232134484986,2
2020-07-23-170615,170615,3,0,0,34,1.0,5.685274813539713,3
2020-07-24-170615,170615,0,0,0,34,0.6666666666666666,8.347066058995456,4
2020-07-25-170615,170615,0,0,1,34,0.3333333333333333,8.941635022139122,5
2020-07-26-170615,170615,1,0,0,35,0.0,9.099959859978362,6
2020-07-27-170615,170615,0,0,0,35,0.0,9.314609778270345,0
2020-07-28-170615,170615,0,0,2,35,0.3333333333333333,8.75638491909352,1
2020-07-29-170615,170615,1,0,0,36,0.0,7.482930625282509,2
2020-07-30-170615,170615,0,0,0,36,0.3333333333333333,5.811220901404691,3
2020-07-31-170615,170615,0,0,2,36,0.0,7.336635946634317,4
2020-08-01-170615,170615,0,0,3,36,1.3333333333333333,4.057878383820843,5
2020-08-02-170615,170615,0,0,0,36,0.3333333333333333,32.768211212320466,6
2020-08-03-170615,170615,0,0,0,36,1.0,33.41357661350771,0
2020-08-04-170615,170615,0,0,1,36,0.6666666666666666,29.130686950240186,1
2020-08-05-170615,170615,1,0,0,37,0.3333333333333333,28.93026242879754,2
2020-08-06-170615,170615,0,0,1,37,0.0,22.603140080261507,3
2020-08-07-170615,170615,0,0,4,37,1.0,21.561014591647798,4
2020-08-08-170615,170615,1,0,0,38,0.3333333333333333,19.679448575212586,5
2020-08-09-170615,170615,0,0,0,38,0.0,19.901041212607247,6
2020-08-10-170615,170615,0,0,0,38,1.0,7.203276033316898,0
2020-08-11-170615,170615,2,0,0,40,4.0,11.087187558916051,1
2020-08-12-170615,170615,0,0,1,40,0.6666666666666666,17.5153891371976,2
2020-08-13-170615,170615,0,0,0,40,2.0,18.323733095819602,3
2020-08-14-170615,170615,2,0,1,42,3.0,26.340104294055315,4
2020-08-15-170615,170615,3,0,0,45,0.6666666666666666,30.142437456572235,5
2020-08-16-170615,170615,0,0,1,45,0.0,34.03889173167234,6
2020-08-17-170615,170615,0,0,0,45,1.6666666666666667,32.4310925655532,0
2020-08-18-170615,170615,1,0,0,46,2.0,33.40615226613143,1
2020-08-19-170615,170615,0,0,0,46,2.333333333333333,31.45145600534755,2
2020-08-20-170615,170615,1,0,1,47,2.6666666666666665,30.78750710040733,3
2020-08-21-170615,170615,4,0,1,51,2.0,34.44741896925514,4
2020-08-22-170615,170615,0,0,0,51,0.6666666666666666,39.05601826023819,5
2020-08-23-170615,170615,0,0,1,51,0.3333333333333333,36.85270687750843,6
2020-08-24-170615,170615,0,0,1,51,2.0,31.52148380058723,0
2020-08-25-170615,170615,0,0,0,51,0.3333333333333333,33.13629972961225,1
2020-08-26-170615,170615,1,0,0,52,1.3333333333333333,32.66452034926531,2
2020-08-27-170615,170615,0,0,0,52,3.6666666666666665,34.56402580954352,3
2020-08-28-170615,170615,1,0,1,53,0.6666666666666666,35.48219112480048,4
2020-08-29-170615,170615,0,0,0,53,0.3333333333333333,29.793425929249587,5
2020-08-30-170615,170615,1,0,0,54,1.3333333333333333,36.14510638715721,6
2020-08-31-170615,170615,0,0,1,54,0.6666666666666666,32.20078462353331,0
2020-09-01-170615,170615,0,0,0,54,2.333333333333333,16.159002418092847,1
2020-09-02-170615,170615,0,0,0,54,1.0,48.55060029077474,2
2020-09-03-170615,170615,1,0,0,55,1.0,67.64876419328172,3
2020-09-04-170615,170615,1,0,13,56,3.333333333333333,54.96697135595113,4
2020-09-05-170615,170615,0,0,1,56,0.0,51.073604745709126,5
2020-09-06-170615,170615,1,0,0,57,0.0,37.64319374585021,6
2020-09-07-170615,170615,1,0,1,58,1.3333333333333333,37.57806595901637,0
2020-09-08-170615,170615,0,0,2,58,0.3333333333333333,38.275265143459464,1
2020-09-09-170615,170615,0,0,1,58,1.6666666666666667,35.264144796597634,2
2020-09-10-170615,170615,0,0,5,58,4.333333333333333,19.996183597291818,3
2020-09-11-170615,170615,1,0,1,59,0.6666666666666666,29.10767672374329,4
2020-09-12-170615,170615,0,0,1,59,0.3333333333333333,34.26652656081189,5
2020-09-13-170615,170615,0,0,1,59,1.3333333333333333,34.22313944905002,6
2020-09-14-170615,170615,1,0,0,60,5.0,32.27362449318497,0
2020-09-15-170615,170615,0,0,2,60,1.3333333333333333,36.979697534579245,1
2020-09-16-170615,170615,0,0,1,60,1.3333333333333333,39.21204176965431,2
2020-09-17-170615,170615,0,0,2,60,3.333333333333333,33.83752529399047,3
2020-09-18-170615,170615,13,0,0,73,7.0,29.615662805247126,4
2020-09-19-170615,170615,1,1,0,74,1.3333333333333333,38.07801645622974,5
2020-09-20-170615,170615,0,0,2,74,1.6666666666666667,41.79372007180316,6
2020-09-21-170615,170615,1,0,0,75,7.0,37.32721369111778,0
2020-09-22-170615,170615,2,0,0,77,2.6666666666666665,47.41350795473835,1
2020-09-23-170615,170615,1,0,0,78,0.3333333333333333,58.25660039384326,2
2020-09-24-170615,170615,5,0,0,83,3.0,58.37138033253957,3
2020-09-25-170615,170615,1,0,2,84,10.0,58.063076040361295,4
2020-09-26-170615,170615,1,0,0,85,9.333333333333334,61.523983007993785,5
2020-09-27-170615,170615,1,0,0,86,0.3333333333333333,68.99379516082075,6
2020-09-28-170615,170615,0,0,0,86,1.0,69.6027551203342,0
2020-09-29-170615,170615,2,0,0,88,1.6666666666666667,61.51172511010477,1
2020-09-30-170615,170615,1,0,1,89,1.3333333333333333,54.10587027025011,2
2020-10-01-170615,170615,2,0,1,91,2.6666666666666665,0.0,3
2020-10-02-170615,170615,0,0,2,91,1.6666666666666667,53.191749538501504,4
2020-10-03-170615,170615,0,0,0,91,1.3333333333333333,62.18006995658609,5
2020-10-04-170615,170615,2,1,1,93,0.6666666666666666,59.301385779845106,6
2020-10-05-170615,170615,0,0,1,93,1.6666666666666667,55.835748753518466,0
2020-10-06-170615,170615,0,0,1,93,0.6666666666666666,51.90562240945647,1
2020-10-07-170615,170615,0,1,1,93,3.333333333333333,49.034037007822604,2
2020-10-08-170615,170615,0,0,0,93,0.6666666666666666,45.780303610173505,3
2020-10-09-170615,170615,2,0,0,95,2.333333333333333,49.54481634307636,4
2020-10-10-170615,170615,0,0,2,95,0.6666666666666666,7.67125046264384,5
2020-10-11-170615,170615,0,0,0,95,1.3333333333333333,11.686631464943513,6
2020-10-12-170615,170615,0,0,0,95,1.0,16.543687256686766,0
2020-10-13-170615,170615,0,0,1,95,0.6666666666666666,20.50133085856022,1
2020-10-14-170615,170615,1,0,0,96,1.6666666666666667,28.41458170339908,2
2020-10-15-170615,170615,1,0,2,97,0.0,36.10513609080624,3
2020-10-16-170615,170615,2,0,5,99,4.333333333333333,42.67982301868549,4
2020-10-17-170615,170615,0,0,0,99,1.6666666666666667,47.099718584186604,5
2020-10-18-170615,170615,1,0,1,100,0.6666666666666666,45.91315582036606,6
2020-10-19-170615,170615,1,0,0,101,3.0,41.73649823293211,0
2020-10-20-170615,170615,1,0,1,102,1.0,50.56744686234986,1
2020-10-21-170615,170615,1,0,4,103,1.6666666666666667,56.817060265639846,2
2020-10-22-170615,170615,0,0,0,103,1.3333333333333333,58.08067184567591,3
2020-10-23-170615,170615,0,0,0,103,4.333333333333333,56.861813559376266,4
2020-10-24-170615,170615,2,0,0,105,0.0,61.03380552248324,5
2020-10-25-170615,170615,0,0,1,105,0.3333333333333333,60.786986435161424,6
2020-10-26-170615,170615,0,0,0,105,5.333333333333333,52.23450628833656,0
2020-10-27-170615,170615,1,0,1,106,3.333333333333333,56.22777134985533,1
2020-10-28-170615,170615,0,0,0,106,2.6666666666666665,52.58054990148662,2
2020-10-29-170615,170615,2,0,0,108,1.3333333333333333,54.456496764161386,3
2020-10-30-170615,170615,5,0,0,113,2.333333333333333,47.695599881602035,4
2020-10-31-170615,170615,0,0,0,113,3.6666666666666665,57.77683114901599,5
2020-11-01-170615,170615,1,0,0,114,1.6666666666666667,43.517011496649765,6
2020-11-02-170615,170615,0,0,0,114,1.6666666666666667,22.214121652558916,0
2020-11-03-170615,170615,1,0,0,115,3.333333333333333,27.000624461398846,1
2020-11-04-170615,170615,4,0,0,119,5.333333333333333,33.70951435936548,2
2020-11-05-170615,170615,0,0,0,119,3.333333333333333,44.634695948481145,3
2020-11-06-170615,170615,0,0,0,119,5.333333333333333,46.026924508003695,4
2020-11-07-170615,170615,0,0,0,119,1.3333333333333333,52.52510038654644,5
2020-11-08-170615,170615,1,0,0,120,3.0,50.393655255680386,6
2020-11-09-170615,170615,0,0,0,120,4.666666666666667,40.136785143369835,0
2020-11-10-170615,170615,1,0,0,121,2.333333333333333,40.17211343961017,1
2020-11-11-170615,170615,0,0,0,121,3.6666666666666665,41.40287029752538,2
2020-11-12-170615,170615,0,0,0,121,2.6666666666666665,45.65311965065081,3
2020-11-13-170615,170615,0,0,0,121,5.0,46.38591658296985,4
2020-03-01-170616,170616,0,0,0,0,0.0,0.0,6
2020-03-02-170616,170616,0,0,0,0,0.0,13.12364632234032,0
2020-03-03-170616,170616,0,0,2,0,0.16666666666666666,57.16503106886077,1
2020-03-04-170616,170616,0,1,3,0,0.0,64.20548115291051,2
2020-03-05-170616,170616,0,0,1,0,0.0,66.95382541039369,3
2020-03-06-170616,170616,0,0,1,0,0.0,59.592756324826574,4
2020-03-07-170616,170616,0,0,0,0,0.0,65.4395346042912,5
2020-03-08-170616,170616,0,0,0,0,0.16666666666666666,61.975014073264305,6
2020-03-09-170616,170616,0,0,0,0,0.0,62.34710189807344,0
2020-03-10-170616,170616,0,0,0,0,0.3333333333333333,104.78803719673566,1
2020-03-11-170616,170616,0,0,2,0,0.3333333333333333,83.45371393896528,2
2020-03-12-170616,170616,0,0,2,0,0.16666666666666666,65.35178720880411,3
2020-03-13-170616,170616,0,0,1,0,1.1666666666666667,43.64641359990304,4
2020-03-14-170616,170616,0,0,0,0,1.3333333333333333,43.95704645567871,5
2020-03-15-170616,170616,0,0,1,0,4.5,36.07267619249187,6
2020-03-16-170616,170616,0,0,0,0,5.666666666666668,24.78071713782455,0
2020-03-17-170616,170616,2,0,0,2,7.5,38.40317590285197,1
2020-03-18-170616,170616,3,0,2,5,5.833333333333332,58.58423402713223,2
2020-03-19-170616,170616,1,0,0,6,8.666666666666666,77.73075834624444,3
2020-03-20-170616,170616,1,0,0,7,8.166666666666666,85.47650846063414,4
2020-03-21-170616,170616,0,0,0,7,2.5,93.22505173532065,5
2020-03-22-170616,170616,0,0,0,7,3.0,86.13091155247791,6
2020-03-23-170616,170616,0,0,0,7,16.333333333333332,82.65253730606386,0
2020-03-24-170616,170616,0,0,0,7,11.5,93.51360506953087,1
2020-03-25-170616,170616,2,0,0,9,13.0,94.98370302490633,2
2020-03-26-170616,170616,2,0,0,11,10.5,105.81131905589363,3
2020-03-27-170616,170616,1,0,0,12,10.333333333333334,128.94034037129103,4
2020-03-28-170616,170616,0,0,0,12,1.8333333333333333,133.71615752335856,5
2020-03-29-170616,170616,1,0,0,13,3.5,131.90079873676714,6
2020-03-30-170616,170616,0,0,1,13,10.0,105.00789760862011,0
2020-03-31-170616,170616,0,0,0,13,7.166666666666668,103.74304128964881,1
2020-04-01-170616,170616,2,0,0,15,8.166666666666666,13.472785769729535,2
2020-04-02-170616,170616,0,0,1,15,3.1666666666666665,41.99193310517898,3
2020-04-03-170616,170616,0,0,0,15,6.0,28.01273331749801,4
2020-04-04-170616,170616,0,0,0,15,1.3333333333333333,34.53366814964432,5
2020-04-05-170616,170616,0,1,0,15,1.0,35.34489681866471,6
2020-04-06-170616,170616,0,0,2,15,7.333333333333332,36.82904624578447,0
2020-04-07-170616,170616,0,0,0,15,8.666666666666666,42.11141100628593,1
2020-04-08-170616,170616,0,0,0,15,5.0,44.5934274785069,2
2020-04-09-170616,170616,0,2,0,15,2.6666666666666665,45.73067547093656,3
2020-04-10-170616,170616,0,0,0,15,3.333333333333333,13.518103406542666,4
2020-04-11-170616,170616,0,1,0,15,1.3333333333333333,18.377985499435614,5
2020-04-12-170616,170616,0,0,0,15,3.6666666666666665,20.6007682610853,6
2020-04-13-170616,170616,1,0,0,16,3.8333333333333335,22.96686149631742,0
2020-04-14-170616,170616,0,0,0,16,9.166666666666666,30.504007981234775,1
2020-04-15-170616,170616,0,0,1,16,2.833333333333333,39.1274812515397,2
2020-04-16-170616,170616,1,0,0,17,3.5,44.00582853194325,3
2020-04-17-170616,170616,0,0,0,17,3.5,40.830135317568846,4
2020-04-18-170616,170616,0,0,0,17,3.6666666666666665,41.81211158847968,5
2020-04-19-170616,170616,0,0,0,17,0.8333333333333334,43.53602497676182,6
2020-04-20-170616,170616,2,0,1,19,3.8333333333333335,46.918991772484034,0
2020-04-21-170616,170616,0,0,0,19,7.0,52.305734088542664,1
2020-04-22-170616,170616,0,0,0,19,6.5,54.45679126180997,2
2020-04-23-170616,170616,0,0,0,19,1.8333333333333333,53.145601437367034,3
2020-04-24-170616,170616,0,0,0,19,2.833333333333333,49.704558224584005,4
2020-04-25-170616,170616,0,0,0,19,1.6666666666666667,49.51344847682058,5
2020-04-26-170616,170616,0,0,0,19,2.0,51.27059161752471,6
2020-04-27-170616,170616,0,0,0,19,4.666666666666667,39.08007005524471,0
2020-04-28-170616,170616,0,1,0,19,2.6666666666666665,31.048353878814453,1
2020-04-29-170616,170616,1,0,0,20,3.5,29.782371725501022,2
2020-04-30-170616,170616,0,0,0,20,2.0,39.12126141841395,3
2020-05-01-170616,170616,0,0,0,20,3.5,45.67792661723602,4
2020-05-02-170616,170616,0,0,0,20,1.1666666666666667,15.428779927141427,5
2020-05-03-170616,170616,0,0,0,20,0.6666666666666666,10.488961422494473,6
2020-05-04-170616,170616,1,0,0,21,4.5,8.92406958239319,0
2020-05-05-170616,170616,0,1,0,21,3.1666666666666665,16.50825029972914,1
2020-05-06-170616,170616,0,0,0,21,1.3333333333333333,19.05106960096657,2
2020-05-07-170616,170616,0,0,1,21,2.333333333333333,32.75773774120722,3
2020-05-08-170616,170616,0,0,0,21,4.166666666666667,39.44806395365745,4
2020-05-09-170616,170616,0,0,0,21,0.8333333333333334,49.0683782512988,5
2020-05-10-170616,170616,0,1,0,21,0.3333333333333333,55.04743224222713,6
2020-05-11-170616,170616,0,4,0,21,4.666666666666667,52.6222348656259,0
2020-05-12-170616,170616,0,5,0,21,5.5,54.731117991559685,1
2020-05-13-170616,170616,0,0,0,21,4.166666666666667,47.460068658816446,2
2020-05-14-170616,170616,0,0,0,21,1.0,41.329955105121485,3
2020-05-15-170616,170616,0,0,0,21,2.6666666666666665,34.41791003910838,4
2020-05-16-170616,170616,0,0,0,21,0.16666666666666666,30.69862952372268,5
2020-05-17-170616,170616,0,0,0,21,0.0,27.243320763924647,6
2020-05-18-170616,170616,0,0,0,21,1.8333333333333333,26.589472676498218,0
2020-05-19-170616,170616,0,1,0,21,1.5,23.797020934676528,1
2020-05-20-170616,170616,0,0,0,21,1.5,16.947798794148085,2
2020-05-21-170616,170616,1,0,0,22,0.8333333333333334,17.9376119463181,3
2020-05-22-170616,170616,0,0,0,22,1.1666666666666667,18.57680082201119,4
2020-05-23-170616,170616,0,0,0,22,0.16666666666666666,20.62027114494802,5
2020-05-24-170616,170616,0,0,0,22,0.0,20.898963086024185,6
2020-05-25-170616,170616,0,0,0,22,1.6666666666666667,17.74690632163447,0
2020-05-26-170616,170616,0,0,0,22,0.8333333333333334,17.6232175429493,1
2020-05-27-170616,170616,0,1,0,22,1.1666666666666667,17.10097655142554,2
2020-05-28-170616,170616,0,0,0,22,0.8333333333333334,17.190063879819547,3
2020-05-29-170616,170616,0,0,1,22,1.5,15.007837123644624,4
2020-05-30-170616,170616,0,0,0,22,0.0,17.528212565304216,5
2020-05-31-170616,170616,0,0,0,22,0.0,18.4844285713424,6
2020-06-01-170616,170616,0,0,0,22,2.0,70.43042169129316,0
2020-06-02-170616,170616,0,1,0,22,0.3333333333333333,10.722205671382682,1
2020-06-03-170616,170616,0,0,0,22,0.6666666666666666,10.260546459627086,2
2020-06-04-170616,170616,0,0,0,22,1.0,14.251669809835795,3
2020-06-05-170616,170616,0,0,0,22,2.1666666666666665,16.15444372462089,4
2020-06-06-170616,170616,0,1,0,22,0.0,21.25068388791358,5
2020-06-07-170616,170616,0,1,0,22,0.3333333333333333,21.271004520508484,6
2020-06-08-170616,170616,0,0,0,22,0.6666666666666666,22.542957500202427,0
2020-06-09-170616,170616,0,0,0,22,0.5,21.40316941560685,1
2020-06-10-170616,170616,0,0,0,22,0.6666666666666666,74.97808138308736,2
2020-06-11-170616,170616,0,0,0,22,1.0,64.33739138248538,3
2020-06-12-170616,170616,1,0,0,23,0.3333333333333333,58.92421242355111,4
2020-06-13-170616,170616,0,0,0,23,0.0,40.8215086669786,5
2020-06-14-170616,170616,0,0,0,23,0.0,27.899405607593092,6
2020-06-15-170616,170616,0,0,0,23,0.16666666666666666,16.941917427550912,0
2020-06-16-170616,170616,0,0,0,23,0.8333333333333334,14.75111119162791,1
2020-06-17-170616,170616,0,0,0,23,0.6666666666666666,11.64024561679529,2
2020-06-18-170616,170616,0,0,0,23,0.8333333333333334,12.105740342197109,3
2020-06-19-170616,170616,0,0,0,23,0.8333333333333334,12.287382477897236,4
2020-06-20-170616,170616,0,0,0,23,0.16666666666666666,14.514873585121748,5
2020-06-21-170616,170616,0,0,0,23,0.0,14.962191195261926,6
2020-06-22-170616,170616,0,0,0,23,0.8333333333333334,13.956360636558212,0
2020-06-23-170616,170616,0,0,0,23,1.0,15.154455935222254,1
2020-06-24-170616,170616,0,1,0,23,0.16666666666666666,15.653140359893047,2
2020-06-25-170616,170616,0,1,0,23,0.3333333333333333,13.711564855147206,3
2020-06-26-170616,170616,0,1,0,23,0.6666666666666666,12.959018170062434,4
2020-06-27-170616,170616,0,0,0,23,0.16666666666666666,11.324469914022462,5
2020-06-28-170616,170616,0,0,0,23,0.0,11.342750568604309,6
2020-06-29-170616,170616,0,0,1,23,0.8333333333333334,11.567876171964624,0
2020-06-30-170616,170616,0,0,0,23,0.3333333333333333,16.55272899689596,1
2020-07-01-170616,170616,0,0,0,23,0.3333333333333333,19.245747297543872,2
2020-07-02-170616,170616,0,0,0,23,0.16666666666666666,8.813454648509083,3
2020-07-03-170616,170616,0,0,0,23,0.6666666666666666,7.849172356609612,4
2020-07-04-170616,170616,0,0,0,23,0.0,13.007506967811427,5
2020-07-05-170616,170616,0,0,0,23,0.0,12.86148809396083,6
2020-07-06-170616,170616,0,0,0,23,0.16666666666666666,11.786715648998118,0
2020-07-07-170616,170616,0,0,0,23,0.0,10.508410536120557,1
2020-07-08-170616,170616,0,0,0,23,0.0,9.054081054435315,2
2020-07-09-170616,170616,0,0,0,23,0.16666666666666666,7.246266128762834,3
2020-07-10-170616,170616,0,0,0,23,0.16666666666666666,20.055696383788543,4
2020-07-11-170616,170616,0,0,0,23,0.0,16.362632794404274,5
2020-07-12-170616,170616,0,1,0,23,0.16666666666666666,8.235173200671754,6
2020-07-13-170616,170616,1,0,0,24,0.16666666666666666,9.390615415495052,0
2020-07-14-170616,170616,0,0,0,24,0.3333333333333333,11.381955312764685,1
2020-07-15-170616,170616,0,0,0,24,0.0,11.029385989435303,2
2020-07-16-170616,170616,0,0,0,24,0.16666666666666666,9.16893039812775,3
2020-07-17-170616,170616,0,0,0,24,0.0,10.53049858263729,4
2020-07-18-170616,170616,0,0,0,24,0.0,10.43366715746838,5
2020-07-19-170616,170616,0,0,0,24,0.0,10.475430939276837,6
2020-07-20-170616,170616,0,0,0,24,0.3333333333333333,6.734649961485858,0
2020-07-21-170616,170616,0,0,0,24,0.0,5.678360412319788,1
2020-07-22-170616,170616,0,0,0,24,0.8333333333333334,7.963669036411776,2
2020-07-23-170616,170616,0,0,1,24,0.16666666666666666,6.1221020496441465,3
2020-07-24-170616,170616,0,0,1,24,0.0,6.900568655395607,4
2020-07-25-170616,170616,0,0,0,24,0.0,7.778174591243587,5
2020-07-26-170616,170616,0,0,0,24,0.16666666666666666,7.722619478104424,6
2020-07-27-170616,170616,0,0,11,24,0.16666666666666666,7.137504348298652,0
2020-07-28-170616,170616,0,0,2,24,0.3333333333333333,7.326096096452934,1
2020-07-29-170616,170616,0,0,0,24,0.3333333333333333,6.89757795621012,2
2020-07-30-170616,170616,0,0,0,24,0.3333333333333333,8.999143043951687,3
2020-07-31-170616,170616,0,0,0,24,1.3333333333333333,10.829921157828514,4
2020-08-01-170616,170616,0,1,0,24,0.8333333333333334,5.393641877331207,5
2020-08-02-170616,170616,0,0,0,24,0.6666666666666666,72.49586528250043,6
2020-08-03-170616,170616,0,0,0,24,1.1666666666666667,114.74602391598859,0
2020-08-04-170616,170616,0,0,1,24,1.0,102.10951247586574,1
2020-08-05-170616,170616,0,0,0,24,1.5,83.28730973551053,2
2020-08-06-170616,170616,1,0,1,25,1.0,78.09209129402439,3
2020-08-07-170616,170616,1,0,1,26,1.5,60.55833018976939,4
2020-08-08-170616,170616,0,0,0,26,1.1666666666666667,59.367613216106555,5
2020-08-09-170616,170616,0,0,0,26,0.16666666666666666,60.4277095456101,6
2020-08-10-170616,170616,11,0,0,37,0.8333333333333334,5.251388806726296,0
2020-08-11-170616,170616,2,0,1,39,1.0,34.79105135329391,1
2020-08-12-170616,170616,0,0,2,39,2.5,48.548672360316516,2
2020-08-13-170616,170616,0,0,0,39,1.8333333333333333,55.33739593396428,3
2020-08-14-170616,170616,0,0,3,39,1.1666666666666667,65.69243396867276,4
2020-08-15-170616,170616,0,0,0,39,0.3333333333333333,72.52297789789499,5
2020-08-16-170616,170616,0,0,0,39,1.3333333333333333,74.14962779852613,6
2020-08-17-170616,170616,0,0,0,39,2.333333333333333,79.70331607080334,0
2020-08-18-170616,170616,1,0,1,40,3.5,67.16539699488516,1
2020-08-19-170616,170616,0,0,0,40,1.3333333333333333,71.28283526395347,2
2020-08-20-170616,170616,1,0,0,41,3.0,62.75970879010144,3
2020-08-21-170616,170616,1,0,1,42,2.0,70.01349166458371,4
2020-08-22-170616,170616,0,0,0,42,0.8333333333333334,77.8501661788575,5
2020-08-23-170616,170616,0,1,0,42,3.5,74.99993413233022,6
2020-08-24-170616,170616,0,0,0,42,3.6666666666666665,63.330727601192194,0
2020-08-25-170616,170616,1,0,0,43,2.833333333333333,62.921233407489495,1
2020-08-26-170616,170616,2,0,0,45,3.5,72.82727871315117,2
2020-08-27-170616,170616,0,0,0,45,2.0,94.32137200569558,3
2020-08-28-170616,170616,3,0,1,48,1.8333333333333333,87.93514587872698,4
2020-08-29-170616,170616,0,0,0,48,1.6666666666666667,100.68795086128134,5
2020-08-30-170616,170616,0,0,0,48,0.6666666666666666,109.8086518515484,6
2020-08-31-170616,170616,0,0,1,48,3.0,93.98388477384852,0
2020-09-01-170616,170616,1,0,0,49,3.0,55.901084972808334,1
2020-09-02-170616,170616,0,0,0,49,3.6666666666666665,76.3560054885653,2
2020-09-03-170616,170616,0,0,0,49,4.0,115.41116886462711,3
2020-09-04-170616,170616,1,0,1,50,6.166666666666668,105.25733576223148,4
2020-09-05-170616,170616,0,0,0,50,2.6666666666666665,96.29025239980587,5
2020-09-06-170616,170616,0,0,3,50,0.8333333333333334,93.46876232186315,6
2020-09-07-170616,170616,0,0,1,50,6.333333333333332,91.26636935139591,0
2020-09-08-170616,170616,0,0,2,50,1.8333333333333333,101.45308225826231,1
2020-09-09-170616,170616,0,0,3,50,2.1666666666666665,90.75865200173112,2
2020-09-10-170616,170616,0,0,2,50,1.5,53.79026103873686,3
2020-09-11-170616,170616,1,0,2,51,4.666666666666667,60.67357302606424,4
2020-09-12-170616,170616,0,0,0,51,1.6666666666666667,72.17917906885222,5
2020-09-13-170616,170616,0,0,1,51,1.6666666666666667,70.44351200251977,6
2020-09-14-170616,170616,1,0,0,52,7.5,65.20555668576131,0
2020-09-15-170616,170616,0,0,3,52,4.0,79.93746911681359,1
2020-09-16-170616,170616,0,0,0,52,2.5,84.50485240086246,2
2020-09-17-170616,170616,0,0,0,52,4.833333333333333,72.35371800693726,3
2020-09-18-170616,170616,1,0,1,53,6.166666666666668,71.93298691098208,4
2020-09-19-170616,170616,0,0,1,53,2.1666666666666665,71.30185446766252,5
2020-09-20-170616,170616,3,0,0,56,1.8333333333333333,80.12388594951682,6
2020-09-21-170616,170616,1,0,0,57,7.333333333333332,72.6662541048684,0
2020-09-22-170616,170616,2,0,4,59,6.5,83.58302211358983,1
2020-09-23-170616,170616,3,0,3,62,6.166666666666668,101.47610792956128,2
2020-09-24-170616,170616,2,0,0,64,6.5,109.83096114159258,3
2020-09-25-170616,170616,2,0,1,66,7.5,114.15807248178349,4
2020-09-26-170616,170616,0,0,2,66,2.6666666666666665,128.98051485360673,5
2020-09-27-170616,170616,1,0,0,67,1.0,120.21733122845342,6
2020-09-28-170616,170616,0,0,1,67,3.6666666666666665,114.28289165191941,0
2020-09-29-170616,170616,3,0,1,70,4.5,107.44376647147796,1
2020-09-30-170616,170616,0,0,1,70,4.166666666666667,97.12485535961054,2
2020-10-01-170616,170616,0,1,0,70,4.333333333333333,0.0,3
2020-10-02-170616,170616,1,0,0,71,3.8333333333333335,144.4197664358903,4
2020-10-03-170616,170616,1,0,0,72,2.333333333333333,197.6036053057431,5
2020-10-04-170616,170616,0,0,0,72,1.3333333333333333,172.1160659401877,6
2020-10-05-170616,170616,0,0,1,72,12.5,142.1391781007037,0
2020-10-06-170616,170616,4,0,2,76,3.0,131.23428021482223,1
2020-10-07-170616,170616,3,0,0,79,4.5,119.9542762352298,2
2020-10-08-170616,170616,0,0,1,79,3.5,119.26327997021697,3
2020-10-09-170616,170616,1,1,0,80,3.333333333333333,119.48881509022969,4
2020-10-10-170616,170616,2,0,0,82,0.6666666666666666,14.28236032843035,5
2020-10-11-170616,170616,0,0,8,82,2.0,22.340565971057536,6
2020-10-12-170616,170616,1,0,3,83,2.0,29.180571821462333,0
2020-10-13-170616,170616,1,0,0,84,3.1666666666666665,36.47160915369176,1
2020-10-14-170616,170616,1,0,1,85,5.0,58.80253898442729,2
2020-10-15-170616,170616,0,0,2,85,3.6666666666666665,78.19764819633619,3
2020-10-16-170616,170616,0,0,3,85,8.166666666666666,96.74249871851774,4
2020-10-17-170616,170616,0,0,1,85,1.8333333333333333,113.47871227133051,5
2020-10-18-170616,170616,0,0,0,85,2.5,110.78631348491203,6
2020-10-19-170616,170616,1,0,1,86,5.666666666666668,110.90612734701482,0
2020-10-20-170616,170616,2,0,0,88,6.5,119.90860087649716,1
2020-10-21-170616,170616,0,0,0,88,8.166666666666666,133.25376219453346,2
2020-10-22-170616,170616,1,0,1,89,7.0,146.6482576017726,3
2020-10-23-170616,170616,0,0,0,89,7.5,146.26143475173328,4
2020-10-24-170616,170616,0,0,0,89,3.1666666666666665,164.4895946314407,5
2020-10-25-170616,170616,8,0,2,97,2.333333333333333,161.38463703568493,6
2020-10-26-170616,170616,3,2,2,100,6.166666666666668,162.4407241928611,0
2020-10-27-170616,170616,0,0,0,100,6.0,183.89293932646075,1
2020-10-28-170616,170616,1,0,0,101,6.5,181.0699675972025,2
2020-10-29-170616,170616,2,0,0,103,6.166666666666668,178.68843397717413,3
2020-10-30-170616,170616,3,0,0,106,8.166666666666666,156.87264662883635,4
2020-10-31-170616,170616,1,1,0,107,1.1666666666666667,178.68605582448697,5
2020-11-01-170616,170616,0,0,0,107,2.333333333333333,115.69260665403877,6
2020-11-02-170616,170616,1,0,0,108,1.6666666666666667,60.280117710040116,0
2020-11-03-170616,170616,0,0,0,108,7.5,62.42263243613276,1
2020-11-04-170616,170616,0,0,0,108,5.166666666666667,78.02822169528805,2
2020-11-05-170616,170616,1,0,0,109,5.5,88.20677839606876,3
2020-11-06-170616,170616,0,1,0,109,5.333333333333333,93.50224632087988,4
2020-11-07-170616,170616,0,0,0,109,1.5,102.11436892663396,5
2020-11-08-170616,170616,2,0,0,111,2.333333333333333,93.74217666797087,6
2020-11-09-170616,170616,2,0,0,113,6.333333333333332,90.73396780908632,0
2020-11-10-170616,170616,0,0,0,113,2.833333333333333,101.73475540571044,1
2020-11-11-170616,170616,0,1,0,113,6.0,111.29288777399177,2
2020-11-12-170616,170616,0,0,0,113,3.333333333333333,103.17811506755962,3
2020-11-13-170616,170616,0,0,0,113,4.333333333333333,96.6138544376634,4
2020-03-01-170617,170617,0,0,0,0,0.0,0.0,6
2020-03-02-170617,170617,1,0,0,1,0.0,20.180619592795274,0
2020-03-03-170617,170617,0,0,1,1,0.14285714285714285,96.58733492409768,1
2020-03-04-170617,170617,0,0,1,1,0.0,102.7434492180064,2
2020-03-05-170617,170617,0,0,2,1,0.14285714285714285,99.38756981102958,3
2020-03-06-170617,170617,0,2,8,1,0.14285714285714285,86.592639644215,4
2020-03-07-170617,170617,0,0,2,1,0.0,98.18990419905293,5
2020-03-08-170617,170617,0,0,4,1,0.0,93.05993572888153,6
2020-03-09-170617,170617,0,1,9,1,0.0,92.95676524325063,0
2020-03-10-170617,170617,0,0,5,1,0.2857142857142857,178.42560232018045,1
2020-03-11-170617,170617,0,0,3,1,0.14285714285714285,124.03265055841534,2
2020-03-12-170617,170617,1,0,8,2,0.14285714285714285,101.94436243998466,3
2020-03-13-170617,170617,1,0,6,3,1.0,69.53324843724224,4
2020-03-14-170617,170617,1,0,1,4,1.1428571428571428,56.14597550745263,5
2020-03-15-170617,170617,0,0,2,4,2.4285714285714284,52.63515633299683,6
2020-03-16-170617,170617,0,0,1,4,4.0,37.881970687823454,0
2020-03-17-170617,170617,1,0,1,5,5.142857142857143,61.207151255322685,1
2020-03-18-170617,170617,1,0,0,6,5.285714285714286,83.58249451075945,2
2020-03-19-170617,170617,2,0,0,8,6.7142857142857135,106.13744560574848,3
2020-03-20-170617,170617,8,0,0,16,6.857142857142858,119.90877740260795,4
2020-03-21-170617,170617,2,0,1,18,3.1428571428571432,137.9300597410397,5
2020-03-22-170617,170617,4,0,0,22,3.2857142857142856,127.93631736278286,6
2020-03-23-170617,170617,9,0,1,31,13.285714285714285,123.69152961274374,0
2020-03-24-170617,170617,5,0,0,36,9.142857142857142,152.87414536666773,1
2020-03-25-170617,170617,3,0,1,39,11.428571428571427,155.96324179873207,2
2020-03-26-170617,170617,8,0,0,47,10.142857142857142,170.39254590332166,3
2020-03-27-170617,170617,6,0,3,53,12.0,208.60851848287808,4
2020-03-28-170617,170617,1,0,0,54,2.0,212.92380560895373,5
2020-03-29-170617,170617,2,0,0,56,3.4285714285714284,214.52275980899822,6
2020-03-30-170617,170617,1,0,0,57,11.571428571428573,168.6841994935648,0
2020-03-31-170617,170617,1,0,0,58,7.142857142857142,160.0352399040635,1
2020-04-01-170617,170617,0,0,1,58,8.0,27.453790805075663,2
2020-04-02-170617,170617,0,0,0,58,5.285714285714286,84.102300459133,3
2020-04-03-170617,170617,0,0,1,58,4.857142857142857,41.9472256575932,4
2020-04-04-170617,170617,1,0,1,59,2.142857142857143,56.44826996836214,5
2020-04-05-170617,170617,0,0,0,59,1.7142857142857142,61.052018357870466,6
2020-04-06-170617,170617,1,0,0,60,7.0,65.74945402545197,0
2020-04-07-170617,170617,0,0,2,60,5.0,76.05298859133109,1
2020-04-08-170617,170617,1,0,2,61,4.0,81.67861787511016,2
2020-04-09-170617,170617,0,0,0,61,4.857142857142857,89.54677775959408,3
2020-04-10-170617,170617,3,0,0,64,1.5714285714285714,23.145911166935726,4
2020-04-11-170617,170617,0,0,1,64,1.0,32.24306758828548,5
2020-04-12-170617,170617,0,0,0,64,1.1428571428571428,34.000985496841636,6
2020-04-13-170617,170617,0,1,0,64,4.857142857142857,36.30888151541624,0
2020-04-14-170617,170617,0,0,2,64,5.428571428571429,60.66290761995673,1
2020-04-15-170617,170617,1,0,0,65,4.714285714285714,79.70371437442465,2
2020-04-16-170617,170617,0,0,1,65,2.8571428571428568,93.65070288539656,3
2020-04-17-170617,170617,1,0,0,66,3.4285714285714284,84.43362457211023,4
2020-04-18-170617,170617,1,0,0,67,3.2857142857142856,88.19764613537585,5
2020-04-19-170617,170617,0,0,2,67,1.0,92.4143830524548,6
2020-04-20-170617,170617,0,0,2,67,3.0,92.001759576598,0
2020-04-21-170617,170617,2,0,1,69,3.4285714285714284,86.50787591894539,1
2020-04-22-170617,170617,2,0,3,71,3.8571428571428568,83.33803600516234,2
2020-04-23-170617,170617,0,0,6,71,2.0,85.45065352932252,3
2020-04-24-170617,170617,0,0,1,71,2.571428571428572,79.24587671272178,4
2020-04-25-170617,170617,1,0,0,72,1.2857142857142858,77.53328202686949,5
2020-04-26-170617,170617,0,0,0,72,1.7142857142857142,77.54242879498923,6
2020-04-27-170617,170617,0,0,0,72,4.571428571428571,54.20088432904335,0
2020-04-28-170617,170617,2,0,0,74,2.7142857142857144,50.928632777597024,1
2020-04-29-170617,170617,0,0,2,74,3.0,50.69513702944296,2
2020-04-30-170617,170617,1,0,0,75,2.0,60.49593336610381,3
2020-05-01-170617,170617,0,0,0,75,2.142857142857143,100.56223152882953,4
2020-05-02-170617,170617,0,0,0,75,1.8571428571428568,28.95553007755332,5
2020-05-03-170617,170617,2,0,0,77,0.14285714285714285,34.21728363735548,6
2020-05-04-170617,170617,2,0,0,79,7.2857142857142865,31.862543271807233,0
2020-05-05-170617,170617,1,0,0,80,2.7142857142857144,46.124945737151236,1
2020-05-06-170617,170617,3,0,0,83,21.0,52.10157862001714,2
2020-05-07-170617,170617,6,0,0,89,5.857142857142858,100.07613493526497,3
2020-05-08-170617,170617,1,0,1,90,3.1428571428571432,121.56532710166579,4
2020-05-09-170617,170617,0,0,0,90,0.14285714285714285,131.1351592572251,5
2020-05-10-170617,170617,0,0,0,90,0.14285714285714285,111.62090631364909,6
2020-05-11-170617,170617,0,2,1,90,5.0,100.95043101230546,0
2020-05-12-170617,170617,0,1,1,90,2.4285714285714284,102.4375280544441,1
2020-05-13-170617,170617,2,0,2,92,2.4285714285714284,80.2185807298865,2
2020-05-14-170617,170617,0,0,2,92,2.4285714285714284,67.07855084813568,3
2020-05-15-170617,170617,0,0,3,92,1.0,58.07164842488219,4
2020-05-16-170617,170617,0,0,0,92,0.0,47.635944192942446,5
2020-05-17-170617,170617,0,1,0,92,0.14285714285714285,44.15435497949166,6
2020-05-18-170617,170617,0,0,0,92,1.7142857142857142,43.93338795811597,0
2020-05-19-170617,170617,0,0,0,92,1.5714285714285714,36.95452803627384,1
2020-05-20-170617,170617,0,0,2,92,1.2857142857142858,32.91716493753149,2
2020-05-21-170617,170617,0,0,1,92,1.1428571428571428,29.86896196493787,3
2020-05-22-170617,170617,1,0,1,93,1.1428571428571428,34.05270407383615,4
2020-05-23-170617,170617,0,0,0,93,0.2857142857142857,40.84399175450199,5
2020-05-24-170617,170617,0,0,0,93,0.42857142857142855,42.40233889167393,6
2020-05-25-170617,170617,1,0,0,94,0.2857142857142857,39.4904629858071,0
2020-05-26-170617,170617,1,0,1,95,0.5714285714285714,39.495299893791795,1
2020-05-27-170617,170617,2,1,0,97,0.7142857142857143,33.523698341694356,2
2020-05-28-170617,170617,2,0,0,99,0.8571428571428571,37.864103499829916,3
2020-05-29-170617,170617,3,0,0,102,1.2857142857142858,39.10240920378198,4
2020-05-30-170617,170617,0,0,0,102,0.14285714285714285,49.698189695593946,5
2020-05-31-170617,170617,0,1,0,102,0.0,47.243292333696274,6
2020-06-01-170617,170617,0,0,0,102,2.2857142857142856,167.28400366306352,0
2020-06-02-170617,170617,0,0,0,102,1.2857142857142858,26.698049967128654,1
2020-06-03-170617,170617,2,0,0,104,0.5714285714285714,14.281560097844844,2
2020-06-04-170617,170617,1,0,1,105,1.1428571428571428,17.958130528475234,3
2020-06-05-170617,170617,1,0,0,106,2.2857142857142856,29.110971662145403,4
2020-06-06-170617,170617,0,7,0,106,0.2857142857142857,37.557433501637036,5
2020-06-07-170617,170617,0,0,0,106,0.2857142857142857,37.467476054745845,6
2020-06-08-170617,170617,0,0,4,106,0.42857142857142855,38.06955285002236,0
2020-06-09-170617,170617,1,0,0,107,0.7142857142857143,37.34186215474142,1
2020-06-10-170617,170617,0,0,0,107,0.42857142857142855,174.04714846778137,2
2020-06-11-170617,170617,0,0,0,107,1.1428571428571428,158.06719260270557,3
2020-06-12-170617,170617,0,0,0,107,0.14285714285714285,154.3660625689032,4
2020-06-13-170617,170617,0,3,0,107,0.14285714285714285,87.91032887370218,5
2020-06-14-170617,170617,0,0,0,107,0.14285714285714285,49.21061531229612,6
2020-06-15-170617,170617,0,0,0,107,0.2857142857142857,32.73743152134365,0
2020-06-16-170617,170617,0,0,1,107,0.7142857142857143,33.298894355743975,1
2020-06-17-170617,170617,0,1,1,107,1.1428571428571428,27.702212930650294,2
2020-06-18-170617,170617,1,0,0,108,0.7142857142857143,26.51362011185713,3
2020-06-19-170617,170617,0,0,0,108,0.8571428571428571,22.335374846174943,4
2020-06-20-170617,170617,0,0,1,108,0.0,32.78042753713281,5
2020-06-21-170617,170617,0,0,0,108,0.0,32.42616018423739,6
2020-06-22-170617,170617,4,0,0,112,0.42857142857142855,28.262821197046183,0
2020-06-23-170617,170617,0,0,0,112,1.0,40.56178864681969,1
2020-06-24-170617,170617,0,1,0,112,0.14285714285714285,42.340190925971605,2
2020-06-25-170617,170617,0,1,0,112,0.14285714285714285,35.9620695679577,3
2020-06-26-170617,170617,0,0,0,112,0.0,29.393350823325314,4
2020-06-27-170617,170617,0,0,0,112,0.2857142857142857,25.346687032671838,5
2020-06-28-170617,170617,0,0,1,112,0.0,26.429142352912077,6
2020-06-29-170617,170617,0,0,1,112,0.5714285714285714,26.783311410048775,0
2020-06-30-170617,170617,1,0,1,113,0.2857142857142857,18.726117129216114,1
2020-07-01-170617,170617,1,0,1,114,0.14285714285714285,40.14795138830627,2
2020-07-02-170617,170617,0,0,0,114,0.2857142857142857,14.973623115209897,3
2020-07-03-170617,170617,0,0,0,114,0.2857142857142857,28.5036805541744,4
2020-07-04-170617,170617,1,0,0,115,0.0,27.960027286960603,5
2020-07-05-170617,170617,0,0,0,115,0.0,26.03908637320396,6
2020-07-06-170617,170617,0,0,0,115,0.7142857142857143,25.50890952721862,0
2020-07-07-170617,170617,0,0,1,115,0.0,27.713309157321575,1
2020-07-08-170617,170617,0,0,1,115,0.0,20.435919507608958,2
2020-07-09-170617,170617,0,1,0,115,0.14285714285714285,18.227081085933882,3
2020-07-10-170617,170617,0,0,0,115,0.14285714285714285,39.83355125785455,4
2020-07-11-170617,170617,0,0,0,115,0.14285714285714285,24.23220783614785,5
2020-07-12-170617,170617,1,0,0,116,0.2857142857142857,14.253932822243758,6
2020-07-13-170617,170617,1,0,0,117,0.42857142857142855,18.939402987158672,0
2020-07-14-170617,170617,1,0,0,118,0.5714285714285714,20.41878180654826,1
2020-07-15-170617,170617,1,0,1,119,0.0,26.6789203630969,2
2020-07-16-170617,170617,0,0,2,119,0.14285714285714285,19.719354961093828,3
2020-07-17-170617,170617,0,0,0,119,0.42857142857142855,21.060032428664968,4
2020-07-18-170617,170617,0,0,0,119,0.14285714285714285,22.321734926939506,5
2020-07-19-170617,170617,0,0,0,119,0.0,21.90404456536349,6
2020-07-20-170617,170617,0,0,0,119,0.14285714285714285,14.75858325956305,0
2020-07-21-170617,170617,1,0,0,120,0.14285714285714285,8.636155973694018,1
2020-07-22-170617,170617,1,0,0,121,0.5714285714285714,14.289289135775388,2
2020-07-23-170617,170617,0,0,1,121,0.5714285714285714,16.648784977206375,3
2020-07-24-170617,170617,0,0,0,121,0.2857142857142857,28.687661551552345,4
2020-07-25-170617,170617,0,0,0,121,0.0,30.591103138905414,5
2020-07-26-170617,170617,0,0,0,121,0.2857142857142857,30.87951762829366,6
2020-07-27-170617,170617,0,0,1,121,0.0,32.61676162411831,0
2020-07-28-170617,170617,0,0,1,121,0.5714285714285714,30.99587070552221,1
2020-07-29-170617,170617,1,0,1,122,0.5714285714285714,29.41321774668119,2
2020-07-30-170617,170617,2,0,1,124,0.5714285714285714,22.20256738323358,3
2020-07-31-170617,170617,0,0,0,124,1.2857142857142858,25.83485970540511,4
2020-08-01-170617,170617,0,0,1,124,1.1428571428571428,15.475123297597825,5
2020-08-02-170617,170617,0,0,1,124,0.8571428571428571,117.11320667991541,6
2020-08-03-170617,170617,0,0,0,124,0.8571428571428571,117.56181442809319,0
2020-08-04-170617,170617,0,0,1,124,1.2857142857142858,104.15331625674219,1
2020-08-05-170617,170617,0,0,2,124,1.0,100.83412999838099,2
2020-08-06-170617,170617,1,0,1,125,1.7142857142857142,84.93023339641644,3
2020-08-07-170617,170617,0,0,1,125,2.142857142857143,82.61318916918201,4
2020-08-08-170617,170617,0,0,0,125,1.1428571428571428,81.84344894639297,5
2020-08-09-170617,170617,0,0,0,125,0.5714285714285714,82.67535965124621,6
2020-08-10-170617,170617,1,0,1,126,2.0,26.82497959882462,0
2020-08-11-170617,170617,1,0,3,127,1.2857142857142858,40.683050911655926,1
2020-08-12-170617,170617,1,0,1,128,2.4285714285714284,62.370278980480514,2
2020-08-13-170617,170617,1,0,2,129,2.7142857142857144,67.35297473498404,3
2020-08-14-170617,170617,0,0,0,129,1.8571428571428568,91.57129829915326,4
2020-08-15-170617,170617,1,0,2,130,0.5714285714285714,104.17795636884821,5
2020-08-16-170617,170617,1,0,0,131,1.0,115.92344973616582,6
2020-08-17-170617,170617,0,0,1,131,2.7142857142857144,106.1888493382174,0
2020-08-18-170617,170617,1,0,2,132,2.2857142857142856,113.59094864765096,1
2020-08-19-170617,170617,2,0,1,134,2.142857142857143,109.81791545468327,2
2020-08-20-170617,170617,1,0,2,135,4.714285714285714,103.27453615906148,3
2020-08-21-170617,170617,1,0,1,136,5.285714285714286,122.82952921934405,4
2020-08-22-170617,170617,0,0,0,136,0.42857142857142855,146.95729134515923,5
2020-08-23-170617,170617,0,0,0,136,1.0,141.70175136036545,6
2020-08-24-170617,170617,1,0,0,137,2.142857142857143,122.03156971083754,0
2020-08-25-170617,170617,3,0,2,140,2.7142857142857144,124.2254168035852,1
2020-08-26-170617,170617,1,0,0,141,2.4285714285714284,122.27250574356302,2
2020-08-27-170617,170617,2,0,4,143,2.142857142857143,128.9778068171974,3
2020-08-28-170617,170617,0,0,2,143,2.2857142857142856,122.21275161220835,4
2020-08-29-170617,170617,2,0,0,145,2.0,98.33121288182456,5
2020-08-30-170617,170617,0,0,0,145,0.8571428571428571,116.30205324198978,6
2020-08-31-170617,170617,1,0,0,146,3.0,104.37954055915979,0
2020-09-01-170617,170617,2,0,0,148,3.1428571428571432,66.53597332737118,1
2020-09-02-170617,170617,1,0,0,149,3.4285714285714284,220.08942572955107,2
2020-09-03-170617,170617,2,0,0,151,3.2857142857142856,290.8477701697916,3
2020-09-04-170617,170617,1,0,0,152,4.0,233.52656193535458,4
2020-09-05-170617,170617,0,0,0,152,2.571428571428572,211.91195984943715,5
2020-09-06-170617,170617,0,0,0,152,2.571428571428572,163.70350644629588,6
2020-09-07-170617,170617,0,0,1,152,5.142857142857143,166.87095102247852,0
2020-09-08-170617,170617,2,0,3,154,2.2857142857142856,167.74137015952974,1
2020-09-09-170617,170617,0,0,1,154,3.2857142857142856,144.5333042403572,2
2020-09-10-170617,170617,4,0,3,158,2.571428571428572,77.90792611243245,3
2020-09-11-170617,170617,2,0,1,160,3.1428571428571432,100.82984089386676,4
2020-09-12-170617,170617,0,0,0,160,3.0,118.43351995705048,5
2020-09-13-170617,170617,0,0,0,160,1.1428571428571428,121.55189341583358,6
2020-09-14-170617,170617,0,0,0,160,8.857142857142858,115.18054962083683,0
2020-09-15-170617,170617,0,0,0,160,4.142857142857143,140.36956309033246,1
2020-09-16-170617,170617,0,0,0,160,4.714285714285714,153.61257888134446,2
2020-09-17-170617,170617,0,0,0,160,6.0,140.07087977270447,3
2020-09-18-170617,170617,0,0,0,160,9.714285714285714,139.3687379862929,4
2020-09-19-170617,170617,0,0,0,160,3.4285714285714284,187.2665016509402,5
2020-09-20-170617,170617,0,0,1,160,3.0,198.78296814459327,6
2020-09-21-170617,170617,1,0,0,161,9.857142857142858,177.22475155727773,0
2020-09-22-170617,170617,3,0,0,164,7.0,213.99438474520284,1
2020-09-23-170617,170617,1,0,0,165,6.0,252.7141132184135,2
2020-09-24-170617,170617,3,0,1,168,10.285714285714286,253.60380663081332,3
2020-09-25-170617,170617,1,0,1,169,11.857142857142858,247.69201605117422,4
2020-09-26-170617,170617,0,0,1,169,6.571428571428571,270.4511706959894,5
2020-09-27-170617,170617,0,0,0,169,1.2857142857142858,304.84491389059065,6
2020-09-28-170617,170617,0,0,1,169,5.571428571428571,308.2608575603356,0
2020-09-29-170617,170617,0,0,1,169,6.0,284.3051543339023,1
2020-09-30-170617,170617,0,0,1,169,5.571428571428571,250.38165061439952,2
2020-10-01-170617,170617,0,0,0,169,5.857142857142858,0.0,3
2020-10-02-170617,170617,0,0,2,169,6.142857142857142,227.8068440153453,4
2020-10-03-170617,170617,0,1,1,169,1.5714285714285714,273.26178873638094,5
2020-10-04-170617,170617,1,0,0,170,3.2857142857142856,246.84880195477635,6
2020-10-05-170617,170617,0,0,4,170,5.285714285714286,233.17772791302707,0
2020-10-06-170617,170617,0,0,4,170,4.714285714285714,219.68562817394246,1
2020-10-07-170617,170617,0,0,1,170,5.0,208.39454717782814,2
2020-10-08-170617,170617,1,0,2,171,3.571428571428572,191.43399580013192,3
2020-10-09-170617,170617,1,2,2,172,6.0,204.82599144684428,4
2020-10-10-170617,170617,1,0,0,173,2.142857142857143,34.978873856010274,5
2020-10-11-170617,170617,0,0,1,173,3.1428571428571432,51.89147823254362,6
2020-10-12-170617,170617,1,0,1,174,2.4285714285714284,75.65565633904272,0
2020-10-13-170617,170617,1,0,0,175,4.428571428571429,90.50142194959791,1
2020-10-14-170617,170617,1,0,0,176,5.571428571428571,123.67552124693313,2
2020-10-15-170617,170617,0,0,2,176,4.0,155.6982492301029,3
2020-10-16-170617,170617,2,0,3,178,9.571428571428571,186.93737113756538,4
2020-10-17-170617,170617,1,0,1,179,2.2857142857142856,201.5126900520068,5
2020-10-18-170617,170617,0,0,2,179,2.7142857142857144,193.1428229994656,6
2020-10-19-170617,170617,4,0,4,183,6.7142857142857135,179.02707771470705,0
2020-10-20-170617,170617,4,0,0,187,5.7142857142857135,214.99365077952436,1
2020-10-21-170617,170617,1,0,1,188,6.857142857142858,235.72659283999172,2
2020-10-22-170617,170617,2,0,0,190,7.857142857142858,242.7371114142896,3
2020-10-23-170617,170617,2,0,2,192,6.428571428571429,240.80380094865183,4
2020-10-24-170617,170617,0,0,0,192,3.4285714285714284,260.8053965072706,5
2020-10-25-170617,170617,1,0,0,193,3.0,263.34240715573173,6
2020-10-26-170617,170617,1,0,0,194,5.428571428571429,228.91550677087398,0
2020-10-27-170617,170617,0,0,1,194,6.428571428571429,239.6146878005504,1
2020-10-28-170617,170617,0,0,2,194,6.2857142857142865,234.00397208634195,2
2020-10-29-170617,170617,2,0,1,196,5.285714285714286,237.810522059558,3
2020-10-30-170617,170617,3,0,0,199,6.857142857142858,211.60143101243932,4
2020-10-31-170617,170617,1,0,0,200,1.2857142857142858,245.08663913289848,5
2020-11-01-170617,170617,2,1,0,202,2.142857142857143,193.14962819389913,6
2020-11-02-170617,170617,4,0,0,206,3.7142857142857135,100.99619689098495,0
2020-11-03-170617,170617,0,0,0,206,5.571428571428571,108.73809718615837,1
2020-11-04-170617,170617,1,0,0,207,7.142857142857142,141.9148266993729,2
2020-11-05-170617,170617,0,0,0,207,5.428571428571429,186.28421325099256,3
2020-11-06-170617,170617,2,0,0,209,5.7142857142857135,197.26813850141338,4
2020-11-07-170617,170617,0,0,0,209,2.2857142857142856,219.72226953007612,5
2020-11-08-170617,170617,0,0,0,209,2.4285714285714284,209.26809265908486,6
2020-11-09-170617,170617,0,0,0,209,5.7142857142857135,175.94899372709324,0
2020-11-10-170617,170617,1,0,0,210,4.0,182.4336024580699,1
2020-11-11-170617,170617,2,0,0,212,6.428571428571429,185.16101263091082,2
2020-11-12-170617,170617,1,0,0,213,5.7142857142857135,197.0946548721424,3
2020-11-13-170617,170617,0,0,0,213,7.0,197.6962136669099,4
2020-03-01-170618,170618,0,0,1,0,0.0,0.0,6
2020-03-02-170618,170618,0,0,0,0,0.0,8.476893129628273,0
2020-03-03-170618,170618,0,0,1,0,0.0,28.434499967080964,1
2020-03-04-170618,170618,0,0,0,0,0.0,32.663780397423565,2
2020-03-05-170618,170618,0,0,1,0,0.0,36.1483968896806,3
2020-03-06-170618,170618,0,0,0,0,0.0,35.628612169801464,4
2020-03-07-170618,170618,0,0,1,0,0.0,37.61788406125146,5
2020-03-08-170618,170618,0,0,0,0,0.0,37.00071116508844,6
2020-03-09-170618,170618,0,0,1,0,0.0,37.83540618329452,0
2020-03-10-170618,170618,0,0,0,0,0.0,85.52010325394637,1
2020-03-11-170618,170618,0,0,1,0,0.0,71.3914032665433,2
2020-03-12-170618,170618,0,0,0,0,0.2,55.86508064216245,3
2020-03-13-170618,170618,0,0,2,0,0.6,32.98628058259617,4
2020-03-14-170618,170618,0,0,0,0,0.2,30.158732496750275,5
2020-03-15-170618,170618,1,0,0,1,1.0,21.380517013438336,6
2020-03-16-170618,170618,0,0,1,1,4.2,10.420767584386272,0
2020-03-17-170618,170618,1,0,0,2,3.6,20.082894535943712,1
2020-03-18-170618,170618,0,0,0,2,5.0,35.4030977662071,2
2020-03-19-170618,170618,1,0,1,3,4.2,50.57891140807537,3
2020-03-20-170618,170618,0,0,0,3,4.2,57.19604327178603,4
2020-03-21-170618,170618,1,0,0,4,1.0,57.88620556024924,5
2020-03-22-170618,170618,0,0,0,4,0.8,54.76342569497203,6
2020-03-23-170618,170618,1,0,0,5,6.2,48.734496438547964,0
2020-03-24-170618,170618,0,0,0,5,5.8,50.806884419865796,1
2020-03-25-170618,170618,1,0,0,6,5.6,48.19452211468611,2
2020-03-26-170618,170618,0,1,0,6,4.8,48.70471137058733,3
2020-03-27-170618,170618,2,0,0,8,3.4,55.874678671404844,4
2020-03-28-170618,170618,0,0,0,8,2.6,59.461935994226806,5
2020-03-29-170618,170618,0,0,0,8,2.0,59.09465389300409,6
2020-03-30-170618,170618,1,0,0,9,4.4,46.522329381900924,0
2020-03-31-170618,170618,0,0,0,9,3.4,46.532236022476404,1
2020-04-01-170618,170618,0,0,0,9,2.4,6.078027412341713,2
2020-04-02-170618,170618,1,0,0,10,6.8,21.996533011223114,3
2020-04-03-170618,170618,0,0,0,10,4.6,13.317658186587249,4
2020-04-04-170618,170618,0,0,1,10,1.4,18.123681909950015,5
2020-04-05-170618,170618,0,0,1,10,1.8,19.924821767657363,6
2020-04-06-170618,170618,0,0,1,10,3.4,22.742865837055334,0
2020-04-07-170618,170618,0,0,1,10,4.2,25.716298012492203,1
2020-04-08-170618,170618,0,0,0,10,2.2,27.640426325909583,2
2020-04-09-170618,170618,0,0,0,10,0.8,27.579464562411275,3
2020-04-10-170618,170618,0,1,0,10,1.4,3.5901109850415924,4
2020-04-11-170618,170618,0,0,0,10,2.0,5.582358749308893,5
2020-04-12-170618,170618,0,0,0,10,1.2,7.092144251812216,6
2020-04-13-170618,170618,0,0,0,10,4.4,8.79682105437658,0
2020-04-14-170618,170618,0,0,0,10,0.8,15.12268976334278,1
2020-04-15-170618,170618,0,0,0,10,2.8,18.00377828007899,2
2020-04-16-170618,170618,0,0,0,10,0.8,22.869069918255548,3
2020-04-17-170618,170618,0,0,0,10,0.8,23.29182081891455,4
2020-04-18-170618,170618,1,0,0,11,1.4,23.505420565862142,5
2020-04-19-170618,170618,1,0,0,12,0.8,25.86176565853421,6
2020-04-20-170618,170618,1,0,0,13,5.4,35.62756693408224,0
2020-04-21-170618,170618,1,0,0,14,1.2,43.54254146591784,1
2020-04-22-170618,170618,0,0,0,14,0.8,43.84321522251766,2
2020-04-23-170618,170618,0,0,0,14,1.4,42.095922715514035,3
2020-04-24-170618,170618,0,0,0,14,0.8,41.47023584754953,4
2020-04-25-170618,170618,0,0,0,14,0.4,38.519406152714325,5
2020-04-26-170618,170618,0,0,0,14,0.2,35.433836645420314,6
2020-04-27-170618,170618,0,0,0,14,1.4,20.349827278265764,0
2020-04-28-170618,170618,0,0,0,14,1.6,12.459779786161315,1
2020-04-29-170618,170618,0,0,0,14,1.2,13.865573506133694,2
2020-04-30-170618,170618,0,0,0,14,0.6,22.013175295351594,3
2020-05-01-170618,170618,0,0,0,14,0.6,27.33516669626948,4
2020-05-02-170618,170618,0,0,0,14,0.4,12.67702363988732,5
2020-05-03-170618,170618,0,0,0,14,0.2,9.618539210573008,6
2020-05-04-170618,170618,0,0,0,14,2.8,8.29866330719562,0
2020-05-05-170618,170618,0,1,0,14,2.2,12.767092481602313,1
2020-05-06-170618,170618,0,0,0,14,1.8,12.432972791466348,2
2020-05-07-170618,170618,0,0,0,14,1.0,39.52049333732727,3
2020-05-08-170618,170618,0,0,0,14,0.4,40.65143552300093,4
2020-05-09-170618,170618,0,0,0,14,1.8,42.23148151548523,5
2020-05-10-170618,170618,0,1,0,14,0.4,29.407776781709224,6
2020-05-11-170618,170618,0,1,0,14,1.2,27.39633304596434,0
2020-05-12-170618,170618,0,2,0,14,1.2,26.442977369616646,1
2020-05-13-170618,170618,0,1,0,14,1.2,22.40937987826491,2
2020-05-14-170618,170618,0,0,0,14,0.2,17.499624774795777,3
2020-05-15-170618,170618,0,0,0,14,0.4,14.888365295440916,4
2020-05-16-170618,170618,0,0,0,14,0.2,13.877554386621782,5
2020-05-17-170618,170618,0,0,0,14,0.2,13.80795694993981,6
2020-05-18-170618,170618,0,1,0,14,3.6,13.768981469017666,0
2020-05-19-170618,170618,0,0,0,14,0.8,16.43090041303808,1
2020-05-20-170618,170618,0,0,0,14,0.4,15.243392516911909,2
2020-05-21-170618,170618,0,0,0,14,0.6,16.020375285637176,3
2020-05-22-170618,170618,0,0,1,14,0.8,16.221701113608827,4
2020-05-23-170618,170618,0,0,0,14,0.2,17.172454587419868,5
2020-05-24-170618,170618,0,0,0,14,0.2,17.224085274896588,6
2020-05-25-170618,170618,0,0,0,14,0.8,11.273804697322507,0
2020-05-26-170618,170618,0,0,0,14,0.0,9.26906178286087,1
2020-05-27-170618,170618,0,0,0,14,1.0,8.127907300749246,2
2020-05-28-170618,170618,0,3,0,14,0.8,11.168324514447594,3
2020-05-29-170618,170618,0,1,0,14,0.8,12.0663116001279,4
2020-05-30-170618,170618,0,0,0,14,0.2,13.618351964023965,5
2020-05-31-170618,170618,0,0,0,14,0.0,13.462770078861189,6
2020-06-01-170618,170618,0,0,0,14,0.4,58.675213239493694,0
2020-06-02-170618,170618,0,0,0,14,0.4,3.4237831563065138,1
2020-06-03-170618,170618,0,0,0,14,0.8,6.263528337435025,2
2020-06-04-170618,170618,0,0,0,14,1.2,9.741938229555643,3
2020-06-05-170618,170618,1,1,0,15,0.8,10.51638874025666,4
2020-06-06-170618,170618,0,3,0,15,0.0,15.78951229948537,5
2020-06-07-170618,170618,0,0,0,15,0.0,15.849436297168666,6
2020-06-08-170618,170618,0,0,0,15,0.2,15.525494161502797,0
2020-06-09-170618,170618,0,0,0,15,0.0,15.246548632450411,1
2020-06-10-170618,170618,0,0,0,15,0.0,61.85829704472624,2
2020-06-11-170618,170618,0,0,0,15,0.6,54.92375150893885,3
2020-06-12-170618,170618,0,0,0,15,0.0,51.355965870238414,4
2020-06-13-170618,170618,0,0,0,15,0.2,15.557918455986512,5
2020-06-14-170618,170618,0,0,0,15,0.0,11.066876375655719,6
2020-06-15-170618,170618,0,0,0,15,0.2,9.366420204110048,0
2020-06-16-170618,170618,0,0,0,15,0.0,6.0028025334869834,1
2020-06-17-170618,170618,0,0,0,15,0.0,3.9329094068866195,2
2020-06-18-170618,170618,0,0,0,15,0.0,4.142898170206717,3
2020-06-19-170618,170618,0,0,0,15,0.4,3.0969292994201822,4
2020-06-20-170618,170618,0,0,0,15,0.0,4.842014512005139,5
2020-06-21-170618,170618,0,0,0,15,0.0,4.95387904644182,6
2020-06-22-170618,170618,0,0,0,15,0.2,4.653879219263219,0
2020-06-23-170618,170618,0,0,0,15,0.2,6.171095530693531,1
2020-06-24-170618,170618,0,0,0,15,0.2,6.6972307557431545,2
2020-06-25-170618,170618,0,1,0,15,0.4,7.044796260419589,3
2020-06-26-170618,170618,0,0,0,15,0.2,7.632415570324829,4
2020-06-27-170618,170618,0,0,0,15,0.0,6.785752207726111,5
2020-06-28-170618,170618,0,0,0,15,0.4,6.757411034436062,6
2020-06-29-170618,170618,0,0,0,15,0.0,7.731226641812688,0
2020-06-30-170618,170618,0,0,0,15,0.0,11.636482881011126,1
2020-07-01-170618,170618,0,0,0,15,0.0,11.736411629548822,2
2020-07-02-170618,170618,0,0,0,15,0.2,4.941380672162079,3
2020-07-03-170618,170618,0,0,0,15,0.0,5.972913542307644,4
2020-07-04-170618,170618,0,0,0,15,0.0,4.946047586143772,5
2020-07-05-170618,170618,0,0,0,15,0.4,4.915576714191426,6
2020-07-06-170618,170618,0,0,0,15,0.0,6.119169221652713,0
2020-07-07-170618,170618,0,0,0,15,0.2,5.232979743842046,1
2020-07-08-170618,170618,0,0,0,15,0.0,4.238262960430268,2
2020-07-09-170618,170618,0,0,0,15,0.0,3.6701904548028583,3
2020-07-10-170618,170618,0,0,0,15,0.0,12.445458892718266,4
2020-07-11-170618,170618,0,0,0,15,0.0,8.911891203600502,5
2020-07-12-170618,170618,0,0,0,15,0.0,1.9850357768120226,6
2020-07-13-170618,170618,0,0,0,15,0.2,2.559420731443008,0
2020-07-14-170618,170618,0,0,0,15,0.0,3.398831249418941,1
2020-07-15-170618,170618,0,0,0,15,0.0,3.4937220187135885,2
2020-07-16-170618,170618,0,0,0,15,0.8,3.201336848154854,3
2020-07-17-170618,170618,0,0,0,15,0.0,5.801228115506866,4
2020-07-18-170618,170618,0,0,0,15,0.0,5.823732440688575,5
2020-07-19-170618,170618,0,0,0,15,0.0,5.871880798561914,6
2020-07-20-170618,170618,0,0,0,15,0.0,4.413356038505083,0
2020-07-21-170618,170618,0,0,0,15,0.2,3.70166071651452,1
2020-07-22-170618,170618,0,0,0,15,0.0,4.553067375446929,2
2020-07-23-170618,170618,0,0,0,15,0.4,1.8078956643481447,3
2020-07-24-170618,170618,0,0,1,15,0.4,3.647499638412404,4
2020-07-25-170618,170618,0,0,1,15,0.2,4.78123239996159,5
2020-07-26-170618,170618,0,0,0,15,0.0,5.215075191758449,6
2020-07-27-170618,170618,0,0,0,15,0.2,4.873629800577286,0
2020-07-28-170618,170618,0,0,0,15,0.2,4.846156248541229,1
2020-07-29-170618,170618,0,0,1,15,0.2,4.947345317826102,2
2020-07-30-170618,170618,0,0,0,15,0.4,5.26129349002552,3
2020-07-31-170618,170618,0,0,0,15,0.4,4.564718331180808,4
2020-08-01-170618,170618,0,0,1,15,0.4,3.495571738238982,5
2020-08-02-170618,170618,0,0,2,15,0.0,73.52954761118787,6
2020-08-03-170618,170618,0,0,1,15,0.4,137.93100428132226,0
2020-08-04-170618,170618,0,0,0,15,0.2,133.5241553798575,1
2020-08-05-170618,170618,0,0,0,15,0.0,113.80773806230485,2
2020-08-06-170618,170618,0,0,1,15,0.2,102.06569639262105,3
2020-08-07-170618,170618,1,0,1,16,1.2,75.48286945314982,4
2020-08-08-170618,170618,1,0,1,17,0.4,50.36922803411504,5
2020-08-09-170618,170618,0,0,0,17,0.6,53.40455718169618,6
2020-08-10-170618,170618,0,0,2,17,0.6,4.492376005141088,0
2020-08-11-170618,170618,0,0,1,17,2.8,16.429112990517044,1
2020-08-12-170618,170618,1,0,1,18,0.8,22.602138770209496,2
2020-08-13-170618,170618,0,0,1,18,1.6,30.818343471393078,3
2020-08-14-170618,170618,0,0,2,18,2.2,42.768469913195624,4
2020-08-15-170618,170618,1,0,11,19,0.6,53.29880199147296,5
2020-08-16-170618,170618,2,0,1,21,0.8,60.69710690073887,6
2020-08-17-170618,170618,1,0,6,22,1.8,68.93871118174128,0
2020-08-18-170618,170618,0,0,11,22,2.8,73.68839694808436,1
2020-08-19-170618,170618,0,0,11,22,1.6,81.22475390981522,2
2020-08-20-170618,170618,1,0,7,23,1.8,67.38467504497488,3
2020-08-21-170618,170618,1,0,0,24,2.0,69.78557018458721,4
2020-08-22-170618,170618,1,0,8,25,0.4,73.82696499836437,5
2020-08-23-170618,170618,0,0,5,25,0.8,67.85563137490394,6
2020-08-24-170618,170618,2,0,10,27,2.4,54.1509276773233,0
2020-08-25-170618,170618,1,0,0,28,1.2,57.343934662951824,1
2020-08-26-170618,170618,1,0,1,29,1.0,64.12018185381275,2
2020-08-27-170618,170618,1,0,0,30,2.0,89.29959560171545,3
2020-08-28-170618,170618,2,0,2,32,0.6,87.32755393872705,4
2020-08-29-170618,170618,11,0,3,43,0.8,106.057764205819,5
2020-08-30-170618,170618,1,0,1,44,1.0,132.99199781403206,6
2020-08-31-170618,170618,6,0,2,50,1.0,118.68321541896648,0
2020-09-01-170618,170618,11,0,0,61,1.8,48.46304721112806,1
2020-09-02-170618,170618,11,0,0,72,1.2,39.059394931894815,2
2020-09-03-170618,170618,7,0,2,79,2.2,49.09537802278132,3
2020-09-04-170618,170618,0,0,0,79,1.4,68.27861222922215,4
2020-09-05-170618,170618,8,0,1,87,0.4,63.95326333485379,5
2020-09-06-170618,170618,5,0,1,92,0.0,66.58970115981018,6
2020-09-07-170618,170618,10,0,0,102,0.2,75.60255204278616,0
2020-09-08-170618,170618,0,0,1,102,0.8,95.78874493451309,1
2020-09-09-170618,170618,1,0,1,103,0.8,89.26113097698423,2
2020-09-10-170618,170618,0,0,0,103,3.2,50.041827238316614,3
2020-09-11-170618,170618,2,0,0,105,0.8,59.23959155928113,4
2020-09-12-170618,170618,3,0,1,108,0.0,62.13889983072173,5
2020-09-13-170618,170618,1,1,0,109,0.4,67.75245410062334,6
2020-09-14-170618,170618,2,0,0,111,2.4,61.59347339895303,0
2020-09-15-170618,170618,0,0,0,111,0.6,68.7116154132075,1
2020-09-16-170618,170618,0,0,1,111,0.2,69.02211276466869,2
2020-09-17-170618,170618,2,0,1,113,1.0,38.68587688020448,3
2020-09-18-170618,170618,0,1,0,113,0.4,38.27350331356781,4
2020-09-19-170618,170618,1,0,0,114,0.4,41.563095552195946,5
2020-09-20-170618,170618,1,0,0,115,0.8,69.2540254824167,6
2020-09-21-170618,170618,0,0,0,115,1.4,63.68298609007934,0
2020-09-22-170618,170618,1,0,0,116,0.6,66.58931469077609,1
2020-09-23-170618,170618,1,1,0,117,0.4,76.32693846148162,2
2020-09-24-170618,170618,0,0,0,117,1.4,75.3333806383531,3
2020-09-25-170618,170618,0,0,0,117,1.4,79.32836189462671,4
2020-09-26-170618,170618,1,0,0,118,1.0,84.55921692672447,5
2020-09-27-170618,170618,0,0,0,118,0.4,54.17582638688655,6
2020-09-28-170618,170618,0,0,0,118,0.8,52.42303036571724,0
2020-09-29-170618,170618,0,0,3,118,1.2,50.37570846340011,1
2020-09-30-170618,170618,1,0,1,119,1.8,66.38877644919725,2
2020-10-01-170618,170618,1,0,0,120,2.4,0.0,3
2020-10-02-170618,170618,0,0,0,120,1.6,94.87227988093248,4
2020-10-03-170618,170618,0,0,0,120,0.6,147.96068015503312,5
2020-10-04-170618,170618,0,0,3,120,0.4,124.37110249384807,6
2020-10-05-170618,170618,0,2,2,120,0.8,101.31650740117956,0
2020-10-06-170618,170618,0,1,1,120,1.6,85.6968410358544,1
2020-10-07-170618,170618,0,0,0,120,1.8,66.80897812157474,2
2020-10-08-170618,170618,0,0,5,120,0.6,58.08552051972046,3
2020-10-09-170618,170618,0,2,0,120,2.2,61.53308302167289,4
2020-10-10-170618,170618,0,0,0,120,0.4,16.420487005193376,5
2020-10-11-170618,170618,0,0,0,120,0.8,22.06798097198995,6
2020-10-12-170618,170618,0,0,1,120,0.6,26.26414982951907,0
2020-10-13-170618,170618,3,0,0,123,0.6,28.945762620827303,1
2020-10-14-170618,170618,1,0,1,124,1.4,48.590571066540065,2
2020-10-15-170618,170618,0,0,0,124,1.0,62.7228437313445,3
2020-10-16-170618,170618,0,0,0,124,2.0,75.1170158310007,4
2020-10-17-170618,170618,0,0,0,124,1.2,71.04486934375291,5
2020-10-18-170618,170618,3,0,0,127,0.6,67.02239963653528,6
2020-10-19-170618,170618,2,0,0,129,3.0,74.22996745833294,0
2020-10-20-170618,170618,1,0,1,130,1.2,80.27987846082561,1
2020-10-21-170618,170618,0,0,0,130,1.8,80.55871006839459,2
2020-10-22-170618,170618,5,0,1,135,2.0,80.77437256652343,3
2020-10-23-170618,170618,0,0,1,135,3.0,92.99534892802987,4
2020-10-24-170618,170618,0,0,0,135,0.6,124.8682352918516,5
2020-10-25-170618,170618,0,0,0,135,0.8,115.53669010820673,6
2020-10-26-170618,170618,1,0,0,136,3.6,102.0371229018776,0
2020-10-27-170618,170618,0,0,0,136,3.4,120.17128988900546,1
2020-10-28-170618,170618,1,1,0,137,4.0,126.1962636293678,2
2020-10-29-170618,170618,0,0,0,137,2.6,135.29701736846383,3
2020-10-30-170618,170618,0,0,0,137,1.8,99.65649732335592,4
2020-10-31-170618,170618,0,0,0,137,2.8,112.5193653606131,5
2020-11-01-170618,170618,0,0,0,137,1.0,53.48453305053772,6
2020-11-02-170618,170618,0,1,0,137,0.8,57.15769022709928,0
2020-11-03-170618,170618,1,0,0,138,2.2,55.0458207735092,1
2020-11-04-170618,170618,0,0,0,138,3.6,68.38392017200611,2
2020-11-05-170618,170618,1,0,0,139,2.4,72.90712605001062,3
2020-11-06-170618,170618,1,0,0,140,4.8,80.74949914326706,4
2020-11-07-170618,170618,0,1,0,140,1.2,90.19206077689489,5
2020-11-08-170618,170618,0,1,0,140,2.2,81.29075626237776,6
2020-11-09-170618,170618,0,0,0,140,3.4,81.15057057489103,0
2020-11-10-170618,170618,0,0,0,140,1.0,44.421188316409086,1
2020-11-11-170618,170618,0,0,0,140,2.8,46.158381112108785,2
2020-11-12-170618,170618,0,0,0,140,2.6,51.67120039685054,3
2020-11-13-170618,170618,0,0,0,140,3.8,58.4494755562441,4
2020-03-01-170619,170619,0,0,0,0,0.0,0.0,6
2020-03-02-170619,170619,0,0,1,0,0.16666666666666666,21.506544717343054,0
2020-03-03-170619,170619,0,1,1,0,0.16666666666666666,102.63836293052208,1
2020-03-04-170619,170619,0,0,0,0,0.0,108.98667467604906,2
2020-03-05-170619,170619,0,0,0,0,0.16666666666666666,108.77152908992984,3
2020-03-06-170619,170619,0,0,1,0,0.16666666666666666,93.34203212294338,4
2020-03-07-170619,170619,0,0,0,0,0.0,102.26035501337408,5
2020-03-08-170619,170619,0,0,0,0,0.0,99.39409100218481,6
2020-03-09-170619,170619,0,0,3,0,0.0,99.45574596264204,0
2020-03-10-170619,170619,0,0,1,0,0.3333333333333333,165.8048884884779,1
2020-03-11-170619,170619,0,0,2,0,0.16666666666666666,126.77837244972739,2
2020-03-12-170619,170619,0,0,0,0,0.3333333333333333,104.16646533047502,3
2020-03-13-170619,170619,0,0,1,0,1.1666666666666667,69.76840249259604,4
2020-03-14-170619,170619,0,0,0,0,1.3333333333333333,64.05039505671473,5
2020-03-15-170619,170619,0,0,0,0,2.1666666666666665,57.304444054693064,6
2020-03-16-170619,170619,1,0,0,1,2.833333333333333,37.891169801639236,0
2020-03-17-170619,170619,1,0,0,2,4.666666666666667,62.04775373031846,1
2020-03-18-170619,170619,0,0,0,2,5.0,90.14069481918715,2
2020-03-19-170619,170619,0,0,0,2,4.666666666666667,114.70641496916834,3
2020-03-20-170619,170619,1,0,0,3,4.666666666666667,131.18866008135075,4
2020-03-21-170619,170619,0,4,0,3,1.5,149.1050317705251,5
2020-03-22-170619,170619,0,0,0,3,1.3333333333333333,140.570618712721,6
2020-03-23-170619,170619,3,0,0,6,8.833333333333334,132.95179593709747,0
2020-03-24-170619,170619,1,0,0,7,6.333333333333332,160.47383820534583,1
2020-03-25-170619,170619,2,0,0,9,6.833333333333332,170.54616529341132,2
2020-03-26-170619,170619,0,0,0,9,7.833333333333332,186.1637504672344,3
2020-03-27-170619,170619,1,0,0,10,5.166666666666667,227.10169396594006,4
2020-03-28-170619,170619,0,0,0,10,1.3333333333333333,233.21653000815516,5
2020-03-29-170619,170619,0,0,0,10,2.1666666666666665,230.70918566818386,6
2020-03-30-170619,170619,0,0,0,10,6.5,179.6691594994785,0
2020-03-31-170619,170619,0,0,1,10,2.6666666666666665,178.21196032434,1
2020-04-01-170619,170619,0,0,0,10,3.333333333333333,25.260212378777823,2
2020-04-02-170619,170619,0,0,1,10,6.166666666666668,82.72454277181419,3
2020-04-03-170619,170619,0,0,0,10,3.5,53.6732317173729,4
2020-04-04-170619,170619,0,0,1,10,1.5,68.68501651323434,5
2020-04-05-170619,170619,0,0,0,10,0.6666666666666666,72.49306965761289,6
2020-04-06-170619,170619,0,1,1,10,3.0,75.59539343268668,0
2020-04-07-170619,170619,0,0,0,10,1.5,84.07149282289626,1
2020-04-08-170619,170619,0,0,0,10,1.8333333333333333,83.52033518294573,2
2020-04-09-170619,170619,0,1,0,10,1.3333333333333333,87.64932453641043,3
2020-04-10-170619,170619,0,0,0,10,1.8333333333333333,24.684211788021557,4
2020-04-11-170619,170619,0,0,0,10,0.16666666666666666,32.231125001875554,5
2020-04-12-170619,170619,0,0,0,10,0.3333333333333333,34.3108639455294,6
2020-04-13-170619,170619,0,0,0,10,3.0,36.38034559280285,0
2020-04-14-170619,170619,1,0,3,11,2.1666666666666665,55.13950970282423,1
2020-04-15-170619,170619,0,0,0,11,2.0,70.31703482871418,2
2020-04-16-170619,170619,1,0,0,12,1.0,83.52158565509276,3
2020-04-17-170619,170619,0,0,0,12,1.0,76.76482540158143,4
2020-04-18-170619,170619,1,0,0,13,2.1666666666666665,80.32066088720421,5
2020-04-19-170619,170619,0,0,0,13,0.5,87.36495328499748,6
2020-04-20-170619,170619,1,1,0,14,4.666666666666667,102.82040754914976,0
2020-04-21-170619,170619,0,0,0,14,2.0,110.23258520589798,1
2020-04-22-170619,170619,0,0,1,14,2.333333333333333,106.74736611978184,2
2020-04-23-170619,170619,0,0,0,14,1.0,105.08695152508906,3
2020-04-24-170619,170619,0,1,0,14,1.1666666666666667,97.07585103385128,4
2020-04-25-170619,170619,0,0,0,14,1.0,95.30206008512957,5
2020-04-26-170619,170619,0,0,0,14,1.8333333333333333,96.7406084218731,6
2020-04-27-170619,170619,0,0,1,14,2.5,66.10654138863656,0
2020-04-28-170619,170619,3,0,0,17,1.5,53.77864874957994,1
2020-04-29-170619,170619,0,0,0,17,1.5,56.647846969651525,2
2020-04-30-170619,170619,0,0,0,17,0.5,71.13217825007308,3
2020-05-01-170619,170619,0,0,0,17,1.8333333333333333,78.2931288891713,4
2020-05-02-170619,170619,0,0,0,17,1.0,28.904454197017273,5
2020-05-03-170619,170619,0,0,0,17,0.5,24.735304267365407,6
2020-05-04-170619,170619,0,0,0,17,3.333333333333333,22.437601231604262,0
2020-05-05-170619,170619,0,0,0,17,1.8333333333333333,39.05297420909933,1
2020-05-06-170619,170619,1,0,1,18,1.0,45.548593491441004,2
2020-05-07-170619,170619,0,0,0,18,1.6666666666666667,70.88326290010063,3
2020-05-08-170619,170619,0,0,0,18,0.5,82.18387462470758,4
2020-05-09-170619,170619,0,0,0,18,0.16666666666666666,93.1199206186645,5
2020-05-10-170619,170619,0,0,0,18,0.0,87.52923122325285,6
2020-05-11-170619,170619,1,1,0,19,2.6666666666666665,78.25628239256669,0
2020-05-12-170619,170619,0,3,0,19,1.6666666666666667,82.66963730109696,1
2020-05-13-170619,170619,0,0,0,19,1.5,69.00172367043416,2
2020-05-14-170619,170619,0,0,0,19,0.8333333333333334,61.662906547472936,3
2020-05-15-170619,170619,0,0,0,19,0.6666666666666666,52.4569666225856,4
2020-05-16-170619,170619,0,0,0,19,0.0,50.005142167325744,5
2020-05-17-170619,170619,0,0,0,19,0.0,44.394347777504215,6
2020-05-18-170619,170619,0,0,0,19,1.6666666666666667,44.633432340558954,0
2020-05-19-170619,170619,0,0,1,19,0.5,40.28350516006395,1
2020-05-20-170619,170619,1,0,0,20,1.0,33.8020257179608,2
2020-05-21-170619,170619,0,0,0,20,0.16666666666666666,34.84019623779368,3
2020-05-22-170619,170619,0,0,0,20,0.3333333333333333,33.47863544780992,4
2020-05-23-170619,170619,0,0,0,20,0.16666666666666666,38.33303353804734,5
2020-05-24-170619,170619,0,0,1,20,0.16666666666666666,38.88805240341756,6
2020-05-25-170619,170619,0,0,0,20,0.3333333333333333,32.12319258182633,0
2020-05-26-170619,170619,0,0,0,20,0.6666666666666666,31.30532744218811,1
2020-05-27-170619,170619,0,0,0,20,1.1666666666666667,28.58911191691282,2
2020-05-28-170619,170619,0,0,0,20,0.8333333333333334,29.002152849701474,3
2020-05-29-170619,170619,0,0,0,20,1.3333333333333333,31.317145454713934,4
2020-05-30-170619,170619,0,1,0,20,0.0,37.5020267124151,5
2020-05-31-170619,170619,0,0,0,20,0.0,37.53096492437715,6
2020-06-01-170619,170619,0,0,0,20,1.0,129.02940590905322,0
2020-06-02-170619,170619,1,0,0,21,0.3333333333333333,24.53554653289876,1
2020-06-03-170619,170619,0,0,1,21,0.5,19.694013102862876,2
2020-06-04-170619,170619,0,0,1,21,1.1666666666666667,19.751486182270728,3
2020-06-05-170619,170619,0,0,0,21,2.1666666666666665,26.700284487299164,4
2020-06-06-170619,170619,0,2,0,21,0.0,35.40773909947396,5
2020-06-07-170619,170619,1,1,0,22,0.16666666666666666,35.94972863333886,6
2020-06-08-170619,170619,0,0,0,22,0.3333333333333333,38.34051751994117,0
2020-06-09-170619,170619,0,0,1,22,0.3333333333333333,34.12431609285147,1
2020-06-10-170619,170619,0,0,0,22,0.3333333333333333,132.9794989729029,2
2020-06-11-170619,170619,0,0,0,22,0.3333333333333333,110.14280367146709,3
2020-06-12-170619,170619,0,0,0,22,0.16666666666666666,100.53933194738961,4
2020-06-13-170619,170619,0,0,0,22,0.0,61.09374225634677,5
2020-06-14-170619,170619,0,0,0,22,0.0,38.02886478787197,6
2020-06-15-170619,170619,0,1,2,22,0.5,24.85556162636239,0
2020-06-16-170619,170619,0,0,0,22,0.3333333333333333,23.29062047567686,1
2020-06-17-170619,170619,1,0,0,23,0.5,18.38145263908923,2
2020-06-18-170619,170619,1,0,0,24,0.5,19.847134172912355,3
2020-06-19-170619,170619,0,0,1,24,0.6666666666666666,21.688727369652824,4
2020-06-20-170619,170619,0,0,0,24,0.0,32.90777025372007,5
2020-06-21-170619,170619,0,0,0,24,0.0,32.99896117789109,6
2020-06-22-170619,170619,0,0,0,24,1.1666666666666667,30.19195234191659,0
2020-06-23-170619,170619,1,0,0,25,0.8333333333333334,34.836476100361224,1
2020-06-24-170619,170619,0,0,0,25,0.0,36.69847952153307,2
2020-06-25-170619,170619,0,0,0,25,0.3333333333333333,31.376925182914245,3
2020-06-26-170619,170619,0,0,0,25,0.0,27.901181313911867,4
2020-06-27-170619,170619,0,0,0,25,0.0,22.11130356563529,5
2020-06-28-170619,170619,0,0,1,25,0.0,22.268001609386626,6
2020-06-29-170619,170619,2,0,0,27,0.16666666666666666,22.59434600341032,0
2020-06-30-170619,170619,0,0,1,27,0.5,21.533291038140085,1
2020-07-01-170619,170619,0,0,0,27,0.3333333333333333,36.685518901660544,2
2020-07-02-170619,170619,0,0,0,27,0.0,15.182901802495092,3
2020-07-03-170619,170619,1,0,0,28,0.0,16.430947667014514,4
2020-07-04-170619,170619,0,0,0,28,0.16666666666666666,24.937159647068462,5
2020-07-05-170619,170619,0,0,0,28,0.0,24.65350394111569,6
2020-07-06-170619,170619,0,0,0,28,0.16666666666666666,23.399410600081623,0
2020-07-07-170619,170619,0,0,0,28,0.0,20.77296121595346,1
2020-07-08-170619,170619,0,0,0,28,0.0,17.59082349723472,2
2020-07-09-170619,170619,0,1,0,28,0.16666666666666666,14.34514119908034,3
2020-07-10-170619,170619,0,0,0,28,0.16666666666666666,37.53414596514644,4
2020-07-11-170619,170619,0,0,0,28,0.0,28.12811891466908,5
2020-07-12-170619,170619,1,0,0,29,0.16666666666666666,15.98756332311044,6
2020-07-13-170619,170619,0,0,0,29,0.5,19.734573852242658,0
2020-07-14-170619,170619,1,0,1,30,0.3333333333333333,19.275268917072307,1
2020-07-15-170619,170619,0,0,0,30,0.16666666666666666,21.922279793318197,2
2020-07-16-170619,170619,0,0,0,30,0.5,17.913477108450998,3
2020-07-17-170619,170619,0,0,0,30,0.0,19.807841092922963,4
2020-07-18-170619,170619,0,0,0,30,0.0,19.61917652412893,5
2020-07-19-170619,170619,0,0,0,30,0.0,19.754882789460844,6
2020-07-20-170619,170619,0,0,0,30,0.0,13.635046645579822,0
2020-07-21-170619,170619,0,0,0,30,0.16666666666666666,9.163533665396054,1
2020-07-22-170619,170619,0,0,0,30,0.3333333333333333,14.268004787786609,2
2020-07-23-170619,170619,0,0,0,30,0.16666666666666666,12.637606975970435,3
2020-07-24-170619,170619,0,0,2,30,0.0,15.335933220012766,4
2020-07-25-170619,170619,0,0,0,30,0.0,16.462628876083905,5
2020-07-26-170619,170619,0,0,0,30,0.16666666666666666,16.733956169667294,6
2020-07-27-170619,170619,0,0,0,30,0.0,16.31796658638736,0
2020-07-28-170619,170619,1,0,0,31,0.0,16.898750164623596,1
2020-07-29-170619,170619,0,0,0,31,0.5,15.160762483783508,2
2020-07-30-170619,170619,0,0,0,31,0.6666666666666666,16.979429771952617,3
2020-07-31-170619,170619,0,0,0,31,1.5,20.162311773463745,4
2020-08-01-170619,170619,0,0,0,31,1.1666666666666667,11.271195346575604,5
2020-08-02-170619,170619,0,0,0,31,0.3333333333333333,101.04979539450801,6
2020-08-03-170619,170619,0,0,1,31,0.3333333333333333,141.76700318471387,0
2020-08-04-170619,170619,0,0,0,31,0.8333333333333334,123.57585465873991,1
2020-08-05-170619,170619,0,0,0,31,0.6666666666666666,104.18250880563238,2
2020-08-06-170619,170619,0,0,1,31,1.0,95.71058757627469,3
2020-08-07-170619,170619,2,0,0,33,1.8333333333333333,78.84851591869419,4
2020-08-08-170619,170619,0,0,1,33,0.6666666666666666,82.13104648805114,5
2020-08-09-170619,170619,0,0,0,33,0.16666666666666666,84.0721365871642,6
2020-08-10-170619,170619,0,0,2,33,3.1666666666666665,13.048400577444852,0
2020-08-11-170619,170619,0,0,2,33,1.3333333333333333,33.615719765098405,1
2020-08-12-170619,170619,0,0,1,33,2.1666666666666665,49.065788418642484,2
2020-08-13-170619,170619,0,0,0,33,1.5,62.01271784793414,3
2020-08-14-170619,170619,0,0,1,33,0.8333333333333334,77.582814985234,4
2020-08-15-170619,170619,0,0,1,33,0.16666666666666666,89.66568065270482,5
2020-08-16-170619,170619,0,0,0,33,1.0,94.33283006818283,6
2020-08-17-170619,170619,1,0,0,34,1.5,94.5556721558207,0
2020-08-18-170619,170619,0,0,0,34,2.5,94.95632931890434,1
2020-08-19-170619,170619,0,0,1,34,1.1666666666666667,96.53002766285692,2
2020-08-20-170619,170619,1,0,0,35,2.0,84.76087603892375,3
2020-08-21-170619,170619,0,0,0,35,1.8333333333333333,94.84414098894877,4
2020-08-22-170619,170619,1,0,0,36,0.16666666666666666,107.08872223758868,5
2020-08-23-170619,170619,0,0,0,36,1.1666666666666667,104.98857169185712,6
2020-08-24-170619,170619,2,0,0,38,1.6666666666666667,89.67362806742352,0
2020-08-25-170619,170619,2,0,0,40,1.8333333333333333,95.52198466128772,1
2020-08-26-170619,170619,1,0,0,41,1.6666666666666667,104.876712261186,2
2020-08-27-170619,170619,0,0,0,41,1.6666666666666667,126.00771511093815,3
2020-08-28-170619,170619,1,0,0,42,1.3333333333333333,119.75580409152477,4
2020-08-29-170619,170619,1,0,0,43,1.3333333333333333,123.08490662526998,5
2020-08-30-170619,170619,0,0,1,43,0.3333333333333333,133.05918629453947,6
2020-08-31-170619,170619,0,0,0,43,2.333333333333333,114.87692005998824,0
2020-09-01-170619,170619,0,0,0,43,3.6666666666666665,72.59944772066473,1
2020-09-02-170619,170619,1,0,0,44,2.833333333333333,127.92614652630945,2
2020-09-03-170619,170619,0,0,1,44,2.6666666666666665,166.24344918781156,3
2020-09-04-170619,170619,0,0,1,44,3.0,151.77035513447487,4
2020-09-05-170619,170619,0,0,0,44,2.1666666666666665,146.28143948317108,5
2020-09-06-170619,170619,0,0,0,44,0.8333333333333334,140.73017176122178,6
2020-09-07-170619,170619,0,0,4,44,3.6666666666666665,143.67399172073004,0
2020-09-08-170619,170619,0,0,5,44,2.6666666666666665,150.4866758272497,1
2020-09-09-170619,170619,0,0,0,44,1.6666666666666667,137.20550881083656,2
2020-09-10-170619,170619,0,0,1,44,2.0,76.62815240898574,3
2020-09-11-170619,170619,0,0,1,44,3.333333333333333,91.75236108861552,4
2020-09-12-170619,170619,0,0,1,44,0.3333333333333333,109.7270000356421,5
2020-09-13-170619,170619,1,0,0,45,0.3333333333333333,110.87012788366812,6
2020-09-14-170619,170619,0,0,0,45,5.0,101.54527888800826,0
2020-09-15-170619,170619,0,0,2,45,2.6666666666666665,122.6400841759874,1
2020-09-16-170619,170619,0,0,0,45,2.333333333333333,133.15315126245173,2
2020-09-17-170619,170619,1,0,2,46,2.5,119.89651275762769,3
2020-09-18-170619,170619,1,0,0,47,2.833333333333333,117.15046687406485,4
2020-09-19-170619,170619,0,0,0,47,0.16666666666666666,125.2540561873607,5
2020-09-20-170619,170619,0,0,0,47,1.6666666666666667,134.53261119818978,6
2020-09-21-170619,170619,4,0,2,51,5.833333333333332,117.55741653155758,0
2020-09-22-170619,170619,5,0,1,56,1.8333333333333333,140.04661250884777,1
2020-09-23-170619,170619,0,0,0,56,3.0,166.36044070869337,2
2020-09-24-170619,170619,1,0,0,57,4.0,172.7502024960479,3
2020-09-25-170619,170619,1,0,1,58,4.0,172.58063842573986,4
2020-09-26-170619,170619,1,0,0,59,1.5,185.0607027752322,5
2020-09-27-170619,170619,0,0,0,59,1.1666666666666667,184.96656319063393,6
2020-09-28-170619,170619,0,0,0,59,0.8333333333333334,183.62392684915227,0
2020-09-29-170619,170619,2,0,4,61,4.0,165.5119728566633,1
2020-09-30-170619,170619,0,0,6,61,2.0,148.69306923670518,2
2020-10-01-170619,170619,2,0,0,63,2.5,0.0,3
2020-10-02-170619,170619,0,0,5,63,2.6666666666666665,221.28661197754857,4
2020-10-03-170619,170619,0,0,0,63,0.8333333333333334,273.88029576765086,5
2020-10-04-170619,170619,0,0,0,63,1.0,237.93454352661064,6
2020-10-05-170619,170619,2,0,7,65,1.3333333333333333,208.65287290536295,0
2020-10-06-170619,170619,1,0,4,66,3.8333333333333335,191.76269866685217,1
2020-10-07-170619,170619,0,1,1,66,3.0,178.9257878846148,2
2020-10-08-170619,170619,0,0,1,66,1.1666666666666667,157.28914973049635,3
2020-10-09-170619,170619,1,0,3,67,1.8333333333333333,168.10800313716402,4
2020-10-10-170619,170619,0,0,0,67,0.6666666666666666,23.52310885798738,5
2020-10-11-170619,170619,0,0,0,67,0.8333333333333334,36.127504133573865,6
2020-10-12-170619,170619,0,0,6,67,1.5,49.61706952161279,0
2020-10-13-170619,170619,4,0,5,71,2.0,60.88256744288764,1
2020-10-14-170619,170619,6,0,2,77,3.0,95.76317584869147,2
2020-10-15-170619,170619,0,0,10,77,1.6666666666666667,129.92864269917624,3
2020-10-16-170619,170619,5,0,2,82,4.0,156.08925861666629,4
2020-10-17-170619,170619,0,0,0,82,1.5,175.7664990605972,5
2020-10-18-170619,170619,0,0,1,82,1.5,168.06353459968506,6
2020-10-19-170619,170619,7,0,1,89,2.6666666666666665,163.94446597630412,0
2020-10-20-170619,170619,4,0,0,93,3.1666666666666665,183.10359829977418,1
2020-10-21-170619,170619,1,0,1,94,4.0,193.25300323740723,2
2020-10-22-170619,170619,1,0,0,95,4.5,200.692007669073,3
2020-10-23-170619,170619,3,0,2,98,2.333333333333333,202.42816383263568,4
2020-10-24-170619,170619,0,0,0,98,1.8333333333333333,226.38087693094934,5
2020-10-25-170619,170619,0,0,0,98,2.833333333333333,232.2349742262182,6
2020-10-26-170619,170619,6,0,0,104,2.833333333333333,212.08666326511312,0
2020-10-27-170619,170619,5,0,0,109,1.8333333333333333,238.47751465681557,1
2020-10-28-170619,170619,2,0,0,111,2.6666666666666665,239.35913553147503,2
2020-10-29-170619,170619,10,0,0,121,2.0,243.897676379137,3
2020-10-30-170619,170619,2,0,0,123,3.1666666666666665,213.45041342715382,4
2020-10-31-170619,170619,0,0,0,123,0.3333333333333333,241.6911114977801,5
2020-11-01-170619,170619,1,0,0,124,0.8333333333333334,153.41886693980277,6
2020-11-02-170619,170619,1,0,0,125,1.5,80.3962988937362,0
2020-11-03-170619,170619,0,0,0,125,3.0,86.4475593111153,1
2020-11-04-170619,170619,1,0,0,126,2.833333333333333,111.91122406961918,2
2020-11-05-170619,170619,0,0,0,126,2.6666666666666665,140.39965834999907,3
2020-11-06-170619,170619,2,1,0,128,2.6666666666666665,149.47545903674603,4
2020-11-07-170619,170619,0,0,0,128,1.0,168.70135691243098,5
2020-11-08-170619,170619,0,0,0,128,1.0,162.09865824531482,6
2020-11-09-170619,170619,0,0,0,128,3.8333333333333335,152.6007628906089,0
2020-11-10-170619,170619,0,0,0,128,1.5,150.17326321875476,1
2020-11-11-170619,170619,0,0,0,128,1.5,160.07647075165858,2
2020-11-12-170619,170619,0,0,0,128,2.0,157.8745518194878,3
2020-11-13-170619,170619,0,0,0,128,1.0,152.3374882573369,4
2020-03-01-170620,170620,0,0,0,0,0.0,0.0,6
2020-03-02-170620,170620,0,0,0,0,0.25,6.704920181518662,0
2020-03-03-170620,170620,0,0,0,0,0.0,34.60090926556571,1
2020-03-04-170620,170620,0,0,0,0,0.0,37.76935665434663,2
2020-03-05-170620,170620,0,0,0,0,0.25,38.01875886937293,3
2020-03-06-170620,170620,0,0,1,0,0.25,31.8310816685589,4
2020-03-07-170620,170620,0,0,0,0,0.0,34.84729122513431,5
2020-03-08-170620,170620,0,0,1,0,0.0,32.14741091699258,6
2020-03-09-170620,170620,0,0,0,0,0.0,32.09314345950871,0
2020-03-10-170620,170620,0,0,2,0,0.0,61.04907512193513,1
2020-03-11-170620,170620,0,0,1,0,0.25,42.89244911494242,2
2020-03-12-170620,170620,0,0,0,0,0.25,34.30678473099657,3
2020-03-13-170620,170620,0,0,0,0,0.75,23.131703146932868,4
2020-03-14-170620,170620,0,0,0,0,1.0,19.088065646214098,5
2020-03-15-170620,170620,0,0,0,0,0.75,16.528647646530736,6
2020-03-16-170620,170620,0,0,0,0,2.5,11.421369777176306,0
2020-03-17-170620,170620,0,0,0,0,2.25,18.09814289703523,1
2020-03-18-170620,170620,0,0,1,0,2.5,24.586104992351796,2
2020-03-19-170620,170620,0,0,1,0,2.75,32.47042018881232,3
2020-03-20-170620,170620,1,0,0,1,4.5,37.38243173207573,4
2020-03-21-170620,170620,0,0,0,1,1.0,45.90160629782959,5
2020-03-22-170620,170620,1,0,2,2,2.25,42.872355513082326,6
2020-03-23-170620,170620,0,2,2,2,8.25,41.76488994568016,0
2020-03-24-170620,170620,2,0,0,4,4.5,52.64556442046123,1
2020-03-25-170620,170620,1,0,1,5,4.25,54.689500076783105,2
2020-03-26-170620,170620,0,0,0,5,5.5,58.29936928193639,3
2020-03-27-170620,170620,0,0,0,5,7.25,70.68779170725733,4
2020-03-28-170620,170620,0,0,0,5,2.0,73.94312750531793,5
2020-03-29-170620,170620,0,0,0,5,2.5,76.62016268297921,6
2020-03-30-170620,170620,0,0,0,5,4.75,60.58702144853079,0
2020-03-31-170620,170620,0,0,0,5,4.25,57.41288327209601,1
2020-04-01-170620,170620,1,0,0,6,4.25,9.43013990331726,2
2020-04-02-170620,170620,1,0,0,7,4.0,29.528934937051456,3
2020-04-03-170620,170620,0,0,0,7,3.75,15.759780961456336,4
2020-04-04-170620,170620,0,0,0,7,2.75,19.72003243309738,5
2020-04-05-170620,170620,2,0,0,9,1.5,22.33263662540433,6
2020-04-06-170620,170620,2,0,1,11,5.5,24.519150613738493,0
2020-04-07-170620,170620,0,0,0,11,6.75,30.38549878350384,1
2020-04-08-170620,170620,1,0,0,12,2.5,35.34977817696146,2
2020-04-09-170620,170620,0,0,0,12,5.75,39.22818539587141,3
2020-04-10-170620,170620,0,0,2,12,2.0,8.370713628361438,4
2020-04-11-170620,170620,0,0,0,12,0.75,12.168062203437852,5
2020-04-12-170620,170620,0,0,0,12,2.0,13.067152288791643,6
2020-04-13-170620,170620,0,0,0,12,4.75,14.96269525479159,0
2020-04-14-170620,170620,0,0,0,12,4.5,22.642327893520267,1
2020-04-15-170620,170620,0,0,0,12,2.5,29.180630219420806,2
2020-04-16-170620,170620,0,0,0,12,1.5,34.03708043832991,3
2020-04-17-170620,170620,0,0,0,12,2.5,30.688159913944936,4
2020-04-18-170620,170620,0,0,0,12,0.75,32.03220092519034,5
2020-04-19-170620,170620,0,0,0,12,0.25,33.15636027984189,6
2020-04-20-170620,170620,1,0,0,13,1.75,31.312153272518795,0
2020-04-21-170620,170620,0,0,0,13,1.75,28.89363826275575,1
2020-04-22-170620,170620,0,0,0,13,1.5,28.70856684425692,2
2020-04-23-170620,170620,0,0,0,13,1.75,29.112954525450824,3
2020-04-24-170620,170620,2,0,0,15,1.5,26.759886748878504,4
2020-04-25-170620,170620,0,0,0,15,0.5,27.48997151637199,5
2020-04-26-170620,170620,0,0,0,15,0.25,27.595979457842752,6
2020-04-27-170620,170620,0,0,1,15,1.75,19.951535111736753,0
2020-04-28-170620,170620,0,0,0,15,2.0,18.991249227773185,1
2020-04-29-170620,170620,0,0,0,15,1.25,18.131624359051525,2
2020-04-30-170620,170620,0,0,0,15,2.0,21.112556328291276,3
2020-05-01-170620,170620,0,0,0,15,0.75,45.61012766634461,4
2020-05-02-170620,170620,0,0,0,15,1.0,10.908674523820267,5
2020-05-03-170620,170620,0,0,0,15,0.5,12.18518776228027,6
2020-05-04-170620,170620,0,0,0,15,2.25,12.09655482650426,0
2020-05-05-170620,170620,0,0,0,15,1.5,17.034113350962176,1
2020-05-06-170620,170620,0,0,0,15,21.5,19.003685674853617,2
2020-05-07-170620,170620,0,0,0,15,8.0,49.64660293448761,3
2020-05-08-170620,170620,0,0,0,15,2.25,60.511708518857105,4
2020-05-09-170620,170620,0,1,0,15,0.0,67.49455373797551,5
2020-05-10-170620,170620,0,0,0,15,0.0,50.76779574625584,6
2020-05-11-170620,170620,1,4,0,16,3.0,45.41388043244089,0
2020-05-12-170620,170620,0,2,0,16,2.0,46.827083987994286,1
2020-05-13-170620,170620,0,0,0,16,3.0,37.45622573346877,2
2020-05-14-170620,170620,0,0,0,16,1.75,31.544976597508523,3
2020-05-15-170620,170620,0,0,0,16,0.25,29.260618955299083,4
2020-05-16-170620,170620,0,0,0,16,0.0,20.859232484523133,5
2020-05-17-170620,170620,0,0,0,16,0.0,19.492829878933005,6
2020-05-18-170620,170620,0,0,0,16,0.0,19.590294618505204,0
2020-05-19-170620,170620,0,0,0,16,0.25,14.956581996673194,1
2020-05-20-170620,170620,0,0,0,16,0.0,9.878802157630442,2
2020-05-21-170620,170620,0,0,0,16,1.25,7.326418630099177,3
2020-05-22-170620,170620,0,0,0,16,0.75,9.411316102139061,4
2020-05-23-170620,170620,0,0,0,16,0.0,12.12210440879836,5
2020-05-24-170620,170620,0,0,0,16,0.25,12.534679769311012,6
2020-05-25-170620,170620,0,0,0,16,0.5,12.370951995357265,0
2020-05-26-170620,170620,0,0,0,16,0.25,12.891816812902622,1
2020-05-27-170620,170620,0,0,0,16,0.5,11.644737289030937,2
2020-05-28-170620,170620,0,7,3,16,0.75,13.428714865368185,3
2020-05-29-170620,170620,0,0,0,16,1.75,13.456947268893476,4
2020-05-30-170620,170620,0,0,0,16,0.25,18.222685546436967,5
2020-05-31-170620,170620,0,0,0,16,0.0,18.26665043906098,6
2020-06-01-170620,170620,0,0,0,16,0.75,87.85401339613844,0
2020-06-02-170620,170620,0,0,0,16,0.5,7.854815002096352,1
2020-06-03-170620,170620,0,0,0,16,1.25,3.7168436839882997,2
2020-06-04-170620,170620,0,0,0,16,1.25,7.057540830246353,3
2020-06-05-170620,170620,0,0,1,16,0.5,10.826629254000386,4
2020-06-06-170620,170620,0,1,0,16,0.0,13.370823395238068,5
2020-06-07-170620,170620,0,0,0,16,0.0,12.724486215709469,6
2020-06-08-170620,170620,0,0,0,16,0.25,12.742075747756965,0
2020-06-09-170620,170620,0,0,0,16,1.0,13.18288248007346,1
2020-06-10-170620,170620,0,0,0,16,0.0,93.48412759916984,2
2020-06-11-170620,170620,3,0,0,19,1.0,86.15215791279579,3
2020-06-12-170620,170620,0,0,0,19,0.0,85.3637847304229,4
2020-06-13-170620,170620,0,0,0,19,0.0,39.890458869356465,5
2020-06-14-170620,170620,0,1,0,19,0.0,18.973959621850753,6
2020-06-15-170620,170620,0,0,0,19,0.25,11.369347041731093,0
2020-06-16-170620,170620,0,0,0,19,0.0,11.72324861338244,1
2020-06-17-170620,170620,0,0,0,19,0.75,9.33838130688472,2
2020-06-18-170620,170620,0,0,0,19,0.25,9.47765339200004,3
2020-06-19-170620,170620,1,0,0,20,0.25,6.537446634074853,4
2020-06-20-170620,170620,0,0,0,20,0.0,9.768108989278588,5
2020-06-21-170620,170620,0,0,0,20,0.0,9.614631043309561,6
2020-06-22-170620,170620,0,0,3,20,1.25,8.635827523826414,0
2020-06-23-170620,170620,0,0,0,20,0.25,13.448120453274187,1
2020-06-24-170620,170620,0,0,0,20,0.0,13.065564225002813,2
2020-06-25-170620,170620,0,0,0,20,0.0,11.693098847849717,3
2020-06-26-170620,170620,0,0,0,20,0.0,9.645457994462486,4
2020-06-27-170620,170620,0,0,0,20,0.5,8.208959581283445,5
2020-06-28-170620,170620,0,0,0,20,0.0,9.393519324483053,6
2020-06-29-170620,170620,0,0,0,20,0.0,9.484905757903817,0
2020-06-30-170620,170620,0,0,1,20,0.25,7.562592441303016,1
2020-07-01-170620,170620,0,0,0,20,0.25,14.031434711292173,2
2020-07-02-170620,170620,0,0,0,20,0.25,5.691245919951667,3
2020-07-03-170620,170620,0,0,0,20,0.25,11.119656937754295,4
2020-07-04-170620,170620,0,0,0,20,0.25,9.550411381255469,5
2020-07-05-170620,170620,0,0,0,20,0.0,8.57599089288095,6
2020-07-06-170620,170620,3,0,1,23,0.25,8.482114484903954,0
2020-07-07-170620,170620,0,0,0,23,0.0,9.569405404556658,1
2020-07-08-170620,170620,0,0,0,23,0.0,7.222559422249444,2
2020-07-09-170620,170620,0,0,3,23,0.0,6.505065332139958,3
2020-07-10-170620,170620,0,0,0,23,0.0,13.516938178775295,4
2020-07-11-170620,170620,0,0,0,23,0.0,8.73824138630832,5
2020-07-12-170620,170620,0,0,0,23,0.25,5.674306814256081,6
2020-07-13-170620,170620,0,0,0,23,0.25,7.131101033630344,0
2020-07-14-170620,170620,1,0,0,24,0.25,7.87697812738534,1
2020-07-15-170620,170620,0,0,0,24,0.25,9.857128782167896,2
2020-07-16-170620,170620,0,0,0,24,0.25,6.1984772796350285,3
2020-07-17-170620,170620,0,0,0,24,0.75,6.904404977512964,4
2020-07-18-170620,170620,0,0,0,24,0.0,8.169830796884856,5
2020-07-19-170620,170620,0,0,1,24,0.0,8.00413005328868,6
2020-07-20-170620,170620,1,0,1,25,0.0,6.247327730144621,0
2020-07-21-170620,170620,0,0,1,25,0.25,4.200773508144921,1
2020-07-22-170620,170620,0,0,1,25,0.5,6.166334501044883,2
2020-07-23-170620,170620,3,0,0,28,0.75,7.649863287029715,3
2020-07-24-170620,170620,0,0,0,28,0.5,11.381726322384374,4
2020-07-25-170620,170620,0,0,0,28,0.0,12.225034852462533,5
2020-07-26-170620,170620,0,0,0,28,0.5,12.317632150845682,6
2020-07-27-170620,170620,0,0,2,28,0.0,12.582035946678124,0
2020-07-28-170620,170620,0,0,1,28,0.75,11.778510989573695,1
2020-07-29-170620,170620,0,0,0,28,0.75,12.20742539333511,2
2020-07-30-170620,170620,0,0,2,28,1.0,8.537684371206925,3
2020-07-31-170620,170620,0,0,1,28,0.25,9.661120655099861,4
2020-08-01-170620,170620,0,0,0,28,1.25,5.675422755671111,5
2020-08-02-170620,170620,1,0,0,29,0.25,45.64413215301583,6
2020-08-03-170620,170620,1,0,0,30,0.75,37.39330967484052,0
2020-08-04-170620,170620,1,0,0,31,0.5,36.05611376845221,1
2020-08-05-170620,170620,1,0,0,32,0.25,36.71312348824746,2
2020-08-06-170620,170620,0,0,1,32,1.0,30.230850141261385,3
2020-08-07-170620,170620,0,0,0,32,1.25,32.487322198128204,4
2020-08-08-170620,170620,0,0,0,32,0.25,30.963487355633596,5
2020-08-09-170620,170620,0,0,1,32,0.0,29.993695721122485,6
2020-08-10-170620,170620,2,0,0,34,1.75,9.650882003620794,0
2020-08-11-170620,170620,1,0,0,35,1.0,16.406812607690195,1
2020-08-12-170620,170620,0,0,1,35,0.25,22.9679867931411,2
2020-08-13-170620,170620,2,1,2,37,1.75,21.822607618044408,3
2020-08-14-170620,170620,1,0,1,38,0.75,32.4965752502752,4
2020-08-15-170620,170620,0,0,0,38,1.25,36.75292834438876,5
2020-08-16-170620,170620,0,0,1,38,0.25,40.98707398561977,6
2020-08-17-170620,170620,0,0,0,38,1.75,38.92595386116986,0
2020-08-18-170620,170620,0,0,0,38,1.25,41.03654913762645,1
2020-08-19-170620,170620,0,0,0,38,0.75,41.83272531702452,2
2020-08-20-170620,170620,1,0,1,39,2.5,42.352862786439694,3
2020-08-21-170620,170620,0,0,3,39,4.75,53.08296734735411,4
2020-08-22-170620,170620,0,0,0,39,0.0,64.63143130297993,5
2020-08-23-170620,170620,1,0,0,40,0.0,62.883205521650495,6
2020-08-24-170620,170620,0,0,4,40,0.25,53.9534434471736,0
2020-08-25-170620,170620,0,0,0,40,1.5,51.886464091008065,1
2020-08-26-170620,170620,1,0,0,41,0.5,48.23791545642598,2
2020-08-27-170620,170620,2,0,0,43,1.0,48.35084087809636,3
2020-08-28-170620,170620,1,0,0,44,0.25,43.84371067344877,4
2020-08-29-170620,170620,0,0,1,44,1.25,32.34251358159811,5
2020-08-30-170620,170620,1,0,2,45,0.5,40.96708919770212,6
2020-08-31-170620,170620,0,0,5,45,1.25,38.109028016768434,0
2020-09-01-170620,170620,0,0,1,45,1.75,25.29038688551104,1
2020-09-02-170620,170620,0,0,4,45,1.0,94.96974073893254,2
2020-09-03-170620,170620,1,0,5,46,1.0,121.52370905189179,3
2020-09-04-170620,170620,3,0,20,49,1.5,96.26230378179939,4
2020-09-05-170620,170620,0,0,2,49,0.25,86.16634660747289,5
2020-09-06-170620,170620,0,0,3,49,0.25,60.78741195274074,6
2020-09-07-170620,170620,4,0,18,53,0.25,61.215717532472944,0
2020-09-08-170620,170620,0,0,5,53,1.0,58.30316237612921,1
2020-09-09-170620,170620,0,0,0,53,2.5,49.32052092067079,2
2020-09-10-170620,170620,0,0,5,53,1.5,26.451320901916823,3
2020-09-11-170620,170620,0,0,28,53,1.5,33.529544234354574,4
2020-09-12-170620,170620,1,0,24,54,1.5,39.31573071434441,5
2020-09-13-170620,170620,2,0,1,56,0.0,39.559189122895255,6
2020-09-14-170620,170620,5,0,1,61,2.75,37.200406174011135,0
2020-09-15-170620,170620,1,0,3,62,1.25,47.9388579408628,1
2020-09-16-170620,170620,4,0,1,66,2.0,53.9904605929984,2
2020-09-17-170620,170620,5,0,1,71,3.0,53.252114226249894,3
2020-09-18-170620,170620,20,0,1,91,6.0,57.349340371255266,4
2020-09-19-170620,170620,2,0,1,93,1.5,75.11382602302484,5
2020-09-20-170620,170620,3,0,0,96,1.25,79.80319229326778,6
2020-09-21-170620,170620,18,0,1,114,1.5,71.52075223685328,0
2020-09-22-170620,170620,5,0,0,119,4.25,86.41492523876562,1
2020-09-23-170620,170620,0,0,0,119,1.75,97.70737461775857,2
2020-09-24-170620,170620,5,0,0,124,5.75,92.81490463200025,3
2020-09-25-170620,170620,28,0,2,152,2.75,91.62687695766957,4
2020-09-26-170620,170620,24,0,0,176,1.0,98.42955647904512,5
2020-09-27-170620,170620,1,0,1,177,0.5,116.33319947529183,6
2020-09-28-170620,170620,1,0,0,178,2.0,116.47362524397944,0
2020-09-29-170620,170620,3,0,0,181,1.25,106.29267336020713,1
2020-09-30-170620,170620,1,0,0,182,2.5,94.27487565684783,2
2020-10-01-170620,170620,1,0,0,183,3.75,0.0,3
2020-10-02-170620,170620,1,0,4,184,2.0,72.1915300662682,4
2020-10-03-170620,170620,1,0,0,185,0.5,91.88004479317033,5
2020-10-04-170620,170620,0,1,1,185,2.0,84.5128236565053,6
2020-10-05-170620,170620,1,0,0,186,1.0,79.79998090323718,0
2020-10-06-170620,170620,0,0,0,186,1.0,72.74472219515721,1
2020-10-07-170620,170620,0,0,0,186,5.5,67.89596614622158,2
2020-10-08-170620,170620,0,0,0,186,3.25,67.26111131823689,3
2020-10-09-170620,170620,2,0,0,188,3.75,73.55530122235226,4
2020-10-10-170620,170620,0,0,0,188,0.25,14.582395733455312,5
2020-10-11-170620,170620,1,0,0,189,1.0,19.725927512905606,6
2020-10-12-170620,170620,0,0,4,189,0.75,28.94701708941969,0
2020-10-13-170620,170620,0,0,0,189,1.0,34.5246187941941,1
2020-10-14-170620,170620,0,0,0,189,1.0,44.362192663782196,2
2020-10-15-170620,170620,0,0,0,189,2.5,53.58948970389184,3
2020-10-16-170620,170620,4,0,1,193,2.0,65.02380635034766,4
2020-10-17-170620,170620,0,0,0,193,1.0,66.4417397497302,5
2020-10-18-170620,170620,1,0,0,194,1.5,65.17089466581757,6
2020-10-19-170620,170620,0,0,0,194,4.5,59.93679256899602,0
2020-10-20-170620,170620,0,0,1,194,2.25,75.18685399861279,1
2020-10-21-170620,170620,0,0,1,194,2.5,83.69004404061629,2
2020-10-22-170620,170620,0,0,1,194,1.25,84.52388205078674,3
2020-10-23-170620,170620,0,0,0,194,3.75,82.53020083756401,4
2020-10-24-170620,170620,0,0,1,194,1.75,89.40254859923377,5
2020-10-25-170620,170620,0,0,0,194,1.75,90.01249746890397,6
2020-10-26-170620,170620,4,0,1,198,1.5,77.90459170230547,0
2020-10-27-170620,170620,0,0,0,198,4.75,81.06188325358667,1
2020-10-28-170620,170620,0,0,2,198,2.0,81.27966840278143,2
2020-10-29-170620,170620,0,1,0,198,2.25,83.07832480568513,3
2020-10-30-170620,170620,1,0,1,199,6.25,75.02681390193311,4
2020-10-31-170620,170620,0,0,0,199,1.0,87.19765068664586,5
2020-11-01-170620,170620,0,1,0,199,1.75,70.94021989181444,6
2020-11-02-170620,170620,0,0,0,199,4.0,51.472581477947095,0
2020-11-03-170620,170620,1,0,0,200,2.0,50.178947800497504,1
2020-11-04-170620,170620,1,0,0,201,5.0,59.86109866369241,2
2020-11-05-170620,170620,1,0,0,202,2.5,72.99645449044782,3
2020-11-06-170620,170620,0,0,0,202,3.0,76.84169065667174,4
2020-11-07-170620,170620,1,0,0,203,0.75,84.46432134447709,5
2020-11-08-170620,170620,0,0,0,203,1.25,77.90909453577035,6
2020-11-09-170620,170620,1,0,0,204,1.5,64.94341992294241,0
2020-11-10-170620,170620,0,0,0,204,3.0,66.72347028328691,1
2020-11-11-170620,170620,2,0,0,206,6.25,67.78567691754367,2
2020-11-12-170620,170620,0,0,0,206,3.5,75.74664261591842,3
2020-11-13-170620,170620,1,0,0,207,7.0,80.43659918572142,4
2020-03-01-170621,170621,0,0,0,0,0.0,0.0,6
2020-03-02-170621,170621,0,0,0,0,0.0,30.981539830299425,0
2020-03-03-170621,170621,0,0,2,0,0.0,158.69400091061098,1
2020-03-04-170621,170621,0,0,1,0,0.0,169.13660674555013,2
2020-03-05-170621,170621,0,0,2,0,0.0,179.29916602930973,3
2020-03-06-170621,170621,0,0,2,0,0.0,152.83005560815718,4
2020-03-07-170621,170621,0,0,1,0,0.0,166.33641084784804,5
2020-03-08-170621,170621,0,0,0,0,0.16666666666666666,163.60653732925104,6
2020-03-09-170621,170621,0,0,5,0,0.0,163.98892422511568,0
2020-03-10-170621,170621,0,0,2,0,0.0,234.8234691435183,1
2020-03-11-170621,170621,0,0,7,0,0.6666666666666666,187.6918557686634,2
2020-03-12-170621,170621,0,0,2,0,0.0,134.12041532585965,3
2020-03-13-170621,170621,0,0,4,0,0.8333333333333334,88.08236641824611,4
2020-03-14-170621,170621,0,0,1,0,0.5,81.81221593474805,5
2020-03-15-170621,170621,0,0,0,0,2.5,72.24622475525388,6
2020-03-16-170621,170621,0,0,5,0,4.166666666666667,52.632683980010896,0
2020-03-17-170621,170621,2,0,3,2,4.333333333333333,92.73631929615127,1
2020-03-18-170621,170621,1,0,1,3,3.1666666666666665,137.8743581898091,2
2020-03-19-170621,170621,2,0,4,5,6.0,166.1303116243049,3
2020-03-20-170621,170621,2,0,2,7,6.666666666666668,203.2908620506474,4
2020-03-21-170621,170621,1,0,0,8,2.333333333333333,251.81338693800242,5
2020-03-22-170621,170621,0,0,1,8,3.333333333333333,240.01034125453796,6
2020-03-23-170621,170621,5,0,14,13,14.333333333333336,227.43752041200483,0
2020-03-24-170621,170621,2,0,2,15,8.5,295.4062355125659,1
2020-03-25-170621,170621,7,0,1,22,8.833333333333334,337.85267561331267,2
2020-03-26-170621,170621,2,0,0,24,7.5,384.8866436512234,3
2020-03-27-170621,170621,4,0,6,28,11.0,455.2435986083338,4
2020-03-28-170621,170621,1,0,1,29,1.8333333333333333,481.00168698278253,5
2020-03-29-170621,170621,0,0,0,29,2.333333333333333,480.18583269858016,6
2020-03-30-170621,170621,5,0,6,34,9.666666666666666,366.2504189341264,0
2020-03-31-170621,170621,3,0,2,37,6.0,375.1272395951728,1
2020-04-01-170621,170621,1,0,6,38,7.166666666666668,59.26407421152284,2
2020-04-02-170621,170621,4,0,0,42,2.833333333333333,211.95937315621558,3
2020-04-03-170621,170621,2,0,2,44,5.166666666666667,110.00352022659547,4
2020-04-04-170621,170621,0,0,1,44,1.1666666666666667,139.76526023880427,5
2020-04-05-170621,170621,1,0,0,45,0.8333333333333334,138.96816800199642,6
2020-04-06-170621,170621,14,0,1,59,5.5,146.4220440618631,0
2020-04-07-170621,170621,2,0,10,61,8.666666666666666,212.12910172913098,1
2020-04-08-170621,170621,1,0,0,62,4.5,252.2300886121719,2
2020-04-09-170621,170621,0,1,1,62,1.3333333333333333,264.19920306564416,3
2020-04-10-170621,170621,6,0,3,68,3.333333333333333,52.66266283739869,4
2020-04-11-170621,170621,1,0,1,69,1.5,93.07400085640887,5
2020-04-12-170621,170621,0,0,0,69,3.5,108.1030060364517,6
2020-04-13-170621,170621,6,0,1,75,2.6666666666666665,125.99604832755671,0
2020-04-14-170621,170621,2,0,1,77,7.833333333333332,169.92268800798416,1
2020-04-15-170621,170621,6,0,2,83,2.833333333333333,220.7829587080037,2
2020-04-16-170621,170621,0,0,2,83,2.833333333333333,255.85986349988127,3
2020-04-17-170621,170621,2,0,0,85,4.666666666666667,230.5686956513499,4
2020-04-18-170621,170621,1,0,0,86,1.5,222.6095987592765,5
2020-04-19-170621,170621,0,0,0,86,0.3333333333333333,219.99064911885017,6
2020-04-20-170621,170621,1,0,1,87,2.5,195.6826600172158,0
2020-04-21-170621,170621,10,0,1,97,5.666666666666668,163.8957079395418,1
2020-04-22-170621,170621,0,0,1,97,5.333333333333333,200.90262206266073,2
2020-04-23-170621,170621,1,0,9,98,0.6666666666666666,211.35716960251784,3
2020-04-24-170621,170621,3,0,1,101,2.6666666666666665,184.22309310742543,4
2020-04-25-170621,170621,1,0,0,102,0.8333333333333334,198.98006158220855,5
2020-04-26-170621,170621,0,0,0,102,0.3333333333333333,207.35778117903422,6
2020-04-27-170621,170621,1,0,2,103,2.5,172.9424282088114,0
2020-04-28-170621,170621,1,0,1,104,2.1666666666666665,174.42624192819994,1
2020-04-29-170621,170621,2,0,0,106,2.5,116.87756764471378,2
2020-04-30-170621,170621,2,0,1,108,2.333333333333333,143.8093522149182,3
2020-05-01-170621,170621,0,0,1,108,2.1666666666666665,242.40793635798488,4
2020-05-02-170621,170621,0,0,0,108,0.16666666666666666,69.69186980927451,5
2020-05-03-170621,170621,0,0,0,108,0.6666666666666666,46.15516363716221,6
2020-05-04-170621,170621,1,0,1,109,2.833333333333333,30.217911993058117,0
2020-05-05-170621,170621,1,0,0,110,1.6666666666666667,50.90883868615266,1
2020-05-06-170621,170621,1,0,2,111,0.6666666666666666,63.60841784809909,2
2020-05-07-170621,170621,9,0,1,120,2.1666666666666665,70.65529478879647,3
2020-05-08-170621,170621,1,0,0,121,3.1666666666666665,125.47488239882395,4
2020-05-09-170621,170621,0,0,1,121,1.0,157.71778694531076,5
2020-05-10-170621,170621,0,0,0,121,0.3333333333333333,258.2322073495232,6
2020-05-11-170621,170621,2,0,1,123,2.333333333333333,247.2947600548736,0
2020-05-12-170621,170621,1,10,0,124,4.666666666666667,254.54412375867008,1
2020-05-13-170621,170621,0,0,0,124,3.333333333333333,190.7590898295399,2
2020-05-14-170621,170621,1,1,1,125,0.5,149.87550088918644,3
2020-05-15-170621,170621,1,0,1,126,2.333333333333333,122.19711368862721,4
2020-05-16-170621,170621,0,3,0,126,0.16666666666666666,119.76762472361199,5
2020-05-17-170621,170621,0,0,0,126,0.0,106.7145997098834,6
2020-05-18-170621,170621,1,0,0,127,1.0,103.28359530138604,0
2020-05-19-170621,170621,0,0,1,127,1.5,95.44529583559905,1
2020-05-20-170621,170621,2,0,1,129,1.0,56.97850633732794,2
2020-05-21-170621,170621,1,0,2,130,0.8333333333333334,62.375989709387156,3
2020-05-22-170621,170621,0,0,1,130,1.1666666666666667,55.10772870066517,4
2020-05-23-170621,170621,1,0,0,131,0.0,68.73225562785538,5
2020-05-24-170621,170621,0,0,0,131,0.0,73.80494701834179,6
2020-05-25-170621,170621,1,0,0,132,2.1666666666666665,62.09948805526551,0
2020-05-26-170621,170621,0,0,0,132,0.6666666666666666,69.72074483052555,1
2020-05-27-170621,170621,0,1,0,132,0.5,72.91033231012001,2
2020-05-28-170621,170621,1,3,0,133,0.8333333333333334,63.330628511295956,3
2020-05-29-170621,170621,1,0,1,134,0.8333333333333334,61.81225996352302,4
2020-05-30-170621,170621,0,0,0,134,0.0,55.108740585249784,5
2020-05-31-170621,170621,0,0,0,134,0.0,57.4929442475294,6
2020-06-01-170621,170621,0,1,0,134,1.0,175.5164024092943,0
2020-06-02-170621,170621,1,0,0,135,0.6666666666666666,24.680443749097332,1
2020-06-03-170621,170621,1,0,0,136,1.0,26.544880090835,2
2020-06-04-170621,170621,2,0,0,138,0.3333333333333333,33.67610556469273,3
2020-06-05-170621,170621,1,0,1,139,0.3333333333333333,44.653339956258506,4
2020-06-06-170621,170621,0,0,0,139,0.0,49.657193521396906,5
2020-06-07-170621,170621,0,0,0,139,0.0,49.29158063753102,6
2020-06-08-170621,170621,0,0,0,139,0.5,44.508776331289056,0
2020-06-09-170621,170621,0,0,0,139,0.8333333333333334,46.89851419039458,1
2020-06-10-170621,170621,0,0,1,139,0.16666666666666666,179.61471433381365,2
2020-06-11-170621,170621,0,0,0,139,1.0,154.6162628212394,3
2020-06-12-170621,170621,1,0,0,140,0.3333333333333333,143.9947948320338,4
2020-06-13-170621,170621,0,0,0,140,0.0,127.70145820298242,5
2020-06-14-170621,170621,0,1,1,140,0.0,68.90272062228884,6
2020-06-15-170621,170621,0,0,0,140,0.0,36.884309654095915,0
2020-06-16-170621,170621,0,0,1,140,0.6666666666666666,30.324021968010143,1
2020-06-17-170621,170621,0,2,0,140,0.16666666666666666,25.641258036010864,2
2020-06-18-170621,170621,0,0,0,140,0.3333333333333333,25.862837502807075,3
2020-06-19-170621,170621,1,0,0,141,0.3333333333333333,23.357339312686165,4
2020-06-20-170621,170621,0,0,0,141,0.0,35.37254330423379,5
2020-06-21-170621,170621,0,0,1,141,0.0,35.62491614945386,6
2020-06-22-170621,170621,0,0,0,141,0.5,33.65421942002791,0
2020-06-23-170621,170621,0,0,0,141,0.3333333333333333,33.82870910244995,1
2020-06-24-170621,170621,1,0,0,142,0.0,34.87013894721541,2
2020-06-25-170621,170621,0,1,0,142,0.3333333333333333,35.43745879374687,3
2020-06-26-170621,170621,0,0,0,142,0.6666666666666666,28.79778269558202,4
2020-06-27-170621,170621,0,0,0,142,0.16666666666666666,24.31654527824948,5
2020-06-28-170621,170621,1,0,0,143,0.0,25.359344597256992,6
2020-06-29-170621,170621,0,0,0,143,0.3333333333333333,29.764849049365797,0
2020-06-30-170621,170621,1,0,0,144,0.0,35.41977925972685,1
2020-07-01-170621,170621,0,0,0,144,0.16666666666666666,44.99059727142554,2
2020-07-02-170621,170621,0,0,0,144,0.0,11.867953815679925,3
2020-07-03-170621,170621,0,0,0,144,0.5,15.027779030235408,4
2020-07-04-170621,170621,0,0,0,144,0.16666666666666666,33.42197268775189,5
2020-07-05-170621,170621,1,0,0,145,0.0,34.20430126558357,6
2020-07-06-170621,170621,0,0,0,145,0.0,32.94779776100442,0
2020-07-07-170621,170621,0,0,0,145,0.0,31.46012769669174,1
2020-07-08-170621,170621,0,0,0,145,0.0,29.481504561722126,2
2020-07-09-170621,170621,0,0,0,145,0.0,26.90442816412755,3
2020-07-10-170621,170621,0,0,0,145,0.3333333333333333,42.134506395090696,4
2020-07-11-170621,170621,0,0,0,145,0.0,30.92602578538344,5
2020-07-12-170621,170621,0,0,0,145,0.0,19.34493747154424,6
2020-07-13-170621,170621,0,0,0,145,0.3333333333333333,19.357851670535865,0
2020-07-14-170621,170621,0,0,0,145,0.5,22.23552066159465,1
2020-07-15-170621,170621,0,0,0,145,0.0,19.31085954931376,2
2020-07-16-170621,170621,0,0,0,145,0.3333333333333333,13.580596394843322,3
2020-07-17-170621,170621,0,0,0,145,0.16666666666666666,13.716278869387889,4
2020-07-18-170621,170621,0,0,0,145,0.0,12.772082739875156,5
2020-07-19-170621,170621,0,0,0,145,0.0,13.037915019419938,6
2020-07-20-170621,170621,0,0,3,145,0.3333333333333333,10.276059574998689,0
2020-07-21-170621,170621,0,0,0,145,0.16666666666666666,9.751018098133121,1
2020-07-22-170621,170621,0,0,1,145,0.6666666666666666,12.88206987040657,2
2020-07-23-170621,170621,0,0,2,145,0.0,13.107376812418817,3
2020-07-24-170621,170621,0,0,4,145,0.0,13.349893522651517,4
2020-07-25-170621,170621,0,0,0,145,0.0,15.190614042945224,5
2020-07-26-170621,170621,0,0,0,145,0.0,15.175037301926764,6
2020-07-27-170621,170621,0,0,1,145,0.5,14.940038239795564,0
2020-07-28-170621,170621,0,0,1,145,0.16666666666666666,17.346123931505858,1
2020-07-29-170621,170621,0,0,0,145,0.16666666666666666,15.579023613790326,2
2020-07-30-170621,170621,0,0,1,145,0.16666666666666666,17.52569075128733,3
2020-07-31-170621,170621,0,0,1,145,0.3333333333333333,30.91134721490322,4
2020-08-01-170621,170621,0,0,0,145,0.3333333333333333,14.77483388770365,5
2020-08-02-170621,170621,0,0,0,145,0.3333333333333333,100.06181421621876,6
2020-08-03-170621,170621,3,0,1,148,1.1666666666666667,197.96133429695612,0
2020-08-04-170621,170621,0,0,0,148,0.3333333333333333,202.72501486016506,1
2020-08-05-170621,170621,1,0,2,149,0.8333333333333334,176.2104232812591,2
2020-08-06-170621,170621,2,1,1,151,0.3333333333333333,160.23484679794853,3
2020-08-07-170621,170621,4,1,1,155,0.16666666666666666,131.75796657594006,4
2020-08-08-170621,170621,0,0,0,155,0.5,144.6793805740724,5
2020-08-09-170621,170621,0,1,0,155,0.0,130.76729422396892,6
2020-08-10-170621,170621,1,0,4,156,0.5,13.678901474969656,0
2020-08-11-170621,170621,1,0,0,157,0.3333333333333333,25.079432511765773,1
2020-08-12-170621,170621,0,0,2,157,0.6666666666666666,36.52116410311463,2
2020-08-13-170621,170621,1,0,3,158,1.1666666666666667,47.53671161975126,3
2020-08-14-170621,170621,1,0,4,159,0.6666666666666666,63.67050964044594,4
2020-08-15-170621,170621,0,0,0,159,0.3333333333333333,77.36338936001113,5
2020-08-16-170621,170621,0,0,0,159,1.0,79.44896805688072,6
2020-08-17-170621,170621,1,0,5,160,0.6666666666666666,85.63035798665484,0
2020-08-18-170621,170621,0,0,1,160,1.0,92.01515315993524,1
2020-08-19-170621,170621,2,0,1,162,0.3333333333333333,92.88064918908638,2
2020-08-20-170621,170621,1,0,0,163,2.0,84.86550653066136,3
2020-08-21-170621,170621,1,0,4,164,0.5,98.63192932725005,4
2020-08-22-170621,170621,0,0,0,164,0.3333333333333333,108.78457847197541,5
2020-08-23-170621,170621,0,0,0,164,2.6666666666666665,104.78451915424985,6
2020-08-24-170621,170621,4,0,2,168,2.6666666666666665,100.48204159347263,0
2020-08-25-170621,170621,0,0,1,168,1.6666666666666667,122.7589060321343,1
2020-08-26-170621,170621,2,0,0,170,2.0,129.9466128800799,2
2020-08-27-170621,170621,3,0,2,173,1.1666666666666667,159.49031632464394,3
2020-08-28-170621,170621,4,1,1,177,1.3333333333333333,163.1629619275408,4
2020-08-29-170621,170621,0,0,0,177,0.5,189.30440311144477,5
2020-08-30-170621,170621,0,0,2,177,0.8333333333333334,203.41644821724154,6
2020-08-31-170621,170621,5,0,2,182,1.5,172.54217229621776,0
2020-09-01-170621,170621,1,0,2,183,1.3333333333333333,121.03240081170945,1
2020-09-02-170621,170621,1,0,2,184,0.8333333333333334,221.56020302174224,2
2020-09-03-170621,170621,0,0,0,184,2.5,205.68221731363798,3
2020-09-04-170621,170621,4,0,2,188,3.5,195.50914412246544,4
2020-09-05-170621,170621,0,0,0,188,1.0,199.82771720321256,5
2020-09-06-170621,170621,0,0,0,188,0.16666666666666666,190.85071009714585,6
2020-09-07-170621,170621,2,0,1,190,1.5,191.77366132630442,0
2020-09-08-170621,170621,1,0,0,191,0.3333333333333333,188.00117390214785,1
2020-09-09-170621,170621,0,0,3,191,0.8333333333333334,170.51469841699478,2
2020-09-10-170621,170621,2,0,2,193,0.8333333333333334,86.57422508126622,3
2020-09-11-170621,170621,1,0,0,194,2.833333333333333,105.47150194598173,4
2020-09-12-170621,170621,0,0,1,194,1.5,142.6240647619786,5
2020-09-13-170621,170621,2,0,1,196,0.0,145.85686220991528,6
2020-09-14-170621,170621,2,0,2,198,3.333333333333333,133.08926896347842,0
2020-09-15-170621,170621,2,0,4,200,3.8333333333333335,170.09083422083765,1
2020-09-16-170621,170621,2,0,4,202,1.1666666666666667,203.36291460116587,2
2020-09-17-170621,170621,0,0,2,202,2.333333333333333,215.0166862395356,3
2020-09-18-170621,170621,2,0,2,204,2.833333333333333,211.98906189469494,4
2020-09-19-170621,170621,0,0,1,204,1.6666666666666667,205.99774824004626,5
2020-09-20-170621,170621,0,0,1,204,1.0,215.39638420552913,6
2020-09-21-170621,170621,1,0,1,205,1.5,192.04281865862538,0
2020-09-22-170621,170621,0,0,3,205,4.5,195.65413760703987,1
2020-09-23-170621,170621,3,0,2,208,3.333333333333333,195.50390745787084,2
2020-09-24-170621,170621,2,0,5,210,2.1666666666666665,209.75043744029654,3
2020-09-25-170621,170621,0,0,5,210,3.1666666666666665,199.36748581816232,4
2020-09-26-170621,170621,1,0,2,211,2.0,210.32221409243337,5
2020-09-27-170621,170621,1,0,0,212,0.0,207.89215905210241,6
2020-09-28-170621,170621,2,0,0,214,2.833333333333333,202.5399839962656,0
2020-09-29-170621,170621,4,0,5,218,0.6666666666666666,196.3921007832899,1
2020-09-30-170621,170621,4,0,0,222,2.833333333333333,179.4336706575364,2
2020-10-01-170621,170621,2,0,2,224,1.0,0.0,3
2020-10-02-170621,170621,2,0,3,226,2.0,333.6863690370462,4
2020-10-03-170621,170621,1,0,1,227,1.6666666666666667,379.07652779626835,5
2020-10-04-170621,170621,1,0,1,228,1.5,369.76332154461915,6
2020-10-05-170621,170621,1,0,1,229,10.166666666666666,317.04959492625756,0
2020-10-06-170621,170621,3,3,1,232,1.6666666666666667,322.08004722537544,1
2020-10-07-170621,170621,2,0,2,234,3.6666666666666665,289.02411668513315,2
2020-10-08-170621,170621,5,0,1,239,3.0,294.4389828620319,3
2020-10-09-170621,170621,5,1,2,244,2.833333333333333,310.113729553649,4
2020-10-10-170621,170621,2,0,0,246,1.1666666666666667,22.353918696465758,5
2020-10-11-170621,170621,0,0,0,246,1.3333333333333333,44.180383273280775,6
2020-10-12-170621,170621,0,0,2,246,0.6666666666666666,63.19459315732272,0
2020-10-13-170621,170621,5,0,0,251,1.6666666666666667,81.42631715056267,1
2020-10-14-170621,170621,0,0,2,251,2.5,127.65906810550311,2
2020-10-15-170621,170621,2,0,2,253,3.6666666666666665,156.64304936232688,3
2020-10-16-170621,170621,3,0,2,256,6.333333333333332,209.02670656296687,4
2020-10-17-170621,170621,1,0,0,257,2.1666666666666665,267.7338077054093,5
2020-10-18-170621,170621,1,0,2,258,1.6666666666666667,265.2111458093459,6
2020-10-19-170621,170621,1,0,0,259,3.8333333333333335,272.0081067126103,0
2020-10-20-170621,170621,1,0,3,260,5.166666666666667,288.41622016703803,1
2020-10-21-170621,170621,2,0,0,262,5.666666666666668,320.7359883496262,2
2020-10-22-170621,170621,1,0,3,263,4.5,351.14591269839354,3
2020-10-23-170621,170621,2,0,1,265,6.666666666666668,346.22909215125514,4
2020-10-24-170621,170621,0,0,0,265,2.333333333333333,382.14260245306355,5
2020-10-25-170621,170621,0,0,0,265,2.0,373.904813884431,6
2020-10-26-170621,170621,2,0,0,267,5.166666666666667,344.4536532390267,0
2020-10-27-170621,170621,0,0,0,267,6.333333333333332,375.07328463419105,1
2020-10-28-170621,170621,2,0,1,269,4.5,376.49771457839336,2
2020-10-29-170621,170621,2,0,2,271,4.5,352.9564803083123,3
2020-10-30-170621,170621,2,0,0,273,7.666666666666668,289.9756252799698,4
2020-10-31-170621,170621,0,0,0,273,3.5,340.37103461072775,5
2020-11-01-170621,170621,2,0,0,275,2.1666666666666665,290.0616112801373,6
2020-11-02-170621,170621,0,0,0,275,1.8333333333333333,164.85126327601384,0
2020-11-03-170621,170621,3,1,0,278,5.833333333333332,155.4592085372494,1
2020-11-04-170621,170621,0,1,0,278,3.0,211.54475533771398,2
2020-11-05-170621,170621,3,1,0,281,5.166666666666667,233.64600227585794,3
2020-11-06-170621,170621,1,1,0,282,2.6666666666666665,241.72197599809977,4
2020-11-07-170621,170621,0,2,0,282,2.1666666666666665,262.09849835588824,5
2020-11-08-170621,170621,0,0,0,282,1.8333333333333333,249.30418794566896,6
2020-11-09-170621,170621,0,0,0,282,3.5,249.59880721176762,0
2020-11-10-170621,170621,0,0,0,282,2.5,288.9515570920871,1
2020-11-11-170621,170621,1,1,0,283,3.6666666666666665,306.31400419828526,2
2020-11-12-170621,170621,2,0,0,285,1.3333333333333333,264.90310135012896,3
2020-11-13-170621,170621,0,0,0,285,3.333333333333333,265.46321360855535,4
2020-03-01-170622,170622,0,0,14,0,0.08333333333333333,0.0,6
2020-03-02-170622,170622,0,0,16,0,0.16666666666666666,256.34619788331497,0
2020-03-03-170622,170622,0,1,21,0,0.16666666666666666,1166.8286098929336,1
2020-03-04-170622,170622,0,0,9,0,0.08333333333333333,1257.7431626730631,2
2020-03-05-170622,170622,0,0,27,0,0.08333333333333333,1302.5168124223185,3
2020-03-06-170622,170622,0,0,26,0,0.3333333333333333,1122.4811959500612,4
2020-03-07-170622,170622,0,1,6,0,0.0,1215.1626980504843,5
2020-03-08-170622,170622,1,0,13,1,0.0,1167.4452716747169,6
2020-03-09-170622,170622,0,0,49,1,0.3333333333333333,1156.3113527193377,0
2020-03-10-170622,170622,0,0,36,1,0.5,1725.3345960336633,1
2020-03-11-170622,170622,1,0,37,2,1.1666666666666667,1309.3114045083857,2
2020-03-12-170622,170622,0,0,30,2,0.75,1006.2069942278413,3
2020-03-13-170622,170622,1,0,37,3,2.1666666666666665,673.3037826718112,4
2020-03-14-170622,170622,3,0,4,6,2.583333333333333,652.9562893335931,5
2020-03-15-170622,170622,14,0,10,20,6.833333333333332,596.4058809732148,6
2020-03-16-170622,170622,16,0,22,36,12.333333333333336,453.43463117158774,0
2020-03-17-170622,170622,21,0,28,57,12.833333333333336,774.3332478651647,1
2020-03-18-170622,170622,9,0,35,66,13.75,1092.3190281933003,2
2020-03-19-170622,170622,27,0,10,93,13.333333333333336,1303.8242004316276,3
2020-03-20-170622,170622,26,0,22,119,17.166666666666668,1460.9542733476674,4
2020-03-21-170622,170622,6,0,5,125,7.666666666666668,1654.778900702579,5
2020-03-22-170622,170622,13,0,4,138,7.166666666666668,1581.6773268435309,6
2020-03-23-170622,170622,49,0,28,187,25.5,1468.378311296116,0
2020-03-24-170622,170622,36,0,47,223,21.83333333333333,1736.3839221994413,1
2020-03-25-170622,170622,37,0,20,260,21.75,1902.6795586133621,2
2020-03-26-170622,170622,30,0,6,290,19.58333333333333,2084.8744889174404,3
2020-03-27-170622,170622,37,0,12,327,20.5,2467.11042765031,4
2020-03-28-170622,170622,4,0,7,331,6.083333333333332,2534.869573595757,5
2020-03-29-170622,170622,10,0,20,341,6.333333333333332,2486.899817489587,6
2020-03-30-170622,170622,22,0,14,363,18.916666666666668,1922.170338202577,0
2020-03-31-170622,170622,28,0,44,391,11.083333333333336,1861.6331831339317,1
2020-04-01-170622,170622,35,0,9,426,11.583333333333336,272.00211851155893,2
2020-04-02-170622,170622,10,0,9,436,8.333333333333334,860.0133153754424,3
2020-04-03-170622,170622,22,0,16,458,10.916666666666664,475.3970347569643,4
2020-04-04-170622,170622,5,0,9,463,3.1666666666666665,633.1515759600705,5
2020-04-05-170622,170622,4,0,1,467,4.166666666666667,644.4750810595708,6
2020-04-06-170622,170622,28,0,12,495,11.666666666666664,687.942776255901,0
2020-04-07-170622,170622,47,0,31,542,6.333333333333332,877.0694219476308,1
2020-04-08-170622,170622,20,0,27,562,7.416666666666668,1014.3263760931513,2
2020-04-09-170622,170622,6,4,4,568,4.5,1083.4371006976958,3
2020-04-10-170622,170622,12,0,11,580,5.833333333333332,262.21329487557637,4
2020-04-11-170622,170622,7,0,4,587,1.75,385.76253111177334,5
2020-04-12-170622,170622,20,0,1,607,2.1666666666666665,438.7526495535432,6
2020-04-13-170622,170622,14,0,9,621,9.0,504.9601872100899,0
2020-04-14-170622,170622,44,0,8,665,5.5,696.8216690340491,1
2020-04-15-170622,170622,9,0,13,674,5.583333333333332,894.6857611633418,2
2020-04-16-170622,170622,9,0,11,683,6.166666666666668,1019.9848763978997,3
2020-04-17-170622,170622,16,0,11,699,5.833333333333332,912.2808374998725,4
2020-04-18-170622,170622,9,0,1,708,3.083333333333333,938.3157829087747,5
2020-04-19-170622,170622,1,0,2,709,1.3333333333333333,953.3489752246035,6
2020-04-20-170622,170622,12,0,12,721,7.833333333333332,864.9061308834171,0
2020-04-21-170622,170622,31,0,4,752,5.916666666666668,809.6427574570478,1
2020-04-22-170622,170622,27,0,3,779,4.333333333333333,895.2119345807159,2
2020-04-23-170622,170622,4,0,9,783,1.5833333333333333,922.9786088766145,3
2020-04-24-170622,170622,11,0,14,794,3.25,803.3592428846669,4
2020-04-25-170622,170622,4,0,4,798,2.0,816.6892336421705,5
2020-04-26-170622,170622,1,0,2,799,1.5,847.8534385416989,6
2020-04-27-170622,170622,9,0,10,808,5.833333333333332,716.3060067063174,0
2020-04-28-170622,170622,8,1,24,816,2.9166666666666665,697.6883793819434,1
2020-04-29-170622,170622,13,0,16,829,3.6666666666666665,549.2470251875313,2
2020-04-30-170622,170622,11,0,1,840,2.833333333333333,695.0257869710686,3
2020-05-01-170622,170622,11,1,12,851,1.9166666666666667,1065.8269939176944,4
2020-05-02-170622,170622,1,0,1,852,2.1666666666666665,374.18994323507843,5
2020-05-03-170622,170622,2,0,0,854,0.3333333333333333,231.60680677649742,6
2020-05-04-170622,170622,12,0,3,866,4.583333333333333,184.20436215218382,0
2020-05-05-170622,170622,4,0,6,870,3.583333333333333,273.6751945988547,1
2020-05-06-170622,170622,3,0,2,873,3.1666666666666665,312.46174657915714,2
2020-05-07-170622,170622,9,0,5,882,4.083333333333333,369.3922252310822,3
2020-05-08-170622,170622,14,0,6,896,5.25,487.862699002093,4
2020-05-09-170622,170622,4,0,0,900,1.0,642.8007370719633,5
2020-05-10-170622,170622,2,0,0,902,0.08333333333333333,1136.4546698347826,6
2020-05-11-170622,170622,10,0,9,912,6.083333333333332,1072.2404781609334,0
2020-05-12-170622,170622,24,4,2,936,6.166666666666668,1113.5081931658474,1
2020-05-13-170622,170622,16,0,2,952,3.9166666666666665,934.2954106388604,2
2020-05-14-170622,170622,1,0,2,953,3.583333333333333,793.9987357440659,3
2020-05-15-170622,170622,12,1,4,965,3.4166666666666665,665.4043592926084,4
2020-05-16-170622,170622,1,0,0,966,0.25,675.7154786342019,5
2020-05-17-170622,170622,0,0,0,966,0.16666666666666666,624.8317822520207,6
2020-05-18-170622,170622,3,0,6,969,3.333333333333333,624.1596277144542,0
2020-05-19-170622,170622,6,0,0,975,2.333333333333333,573.5326007198289,1
2020-05-20-170622,170622,2,0,1,977,3.083333333333333,377.4498554028562,2
2020-05-21-170622,170622,5,0,2,982,2.4166666666666665,382.13253144884624,3
2020-05-22-170622,170622,6,0,0,988,2.333333333333333,331.26445665179773,4
2020-05-23-170622,170622,0,0,0,988,0.3333333333333333,398.42175472378244,5
2020-05-24-170622,170622,0,0,0,988,0.16666666666666666,410.136427102021,6
2020-05-25-170622,170622,9,0,2,997,1.8333333333333333,342.4028380573894,0
2020-05-26-170622,170622,2,0,2,999,2.1666666666666665,348.6355819643774,1
2020-05-27-170622,170622,2,0,1,1001,1.9166666666666667,352.3202863136757,2
2020-05-28-170622,170622,2,1,5,1003,1.75,337.07578494700726,3
2020-05-29-170622,170622,4,0,1,1007,2.4166666666666665,326.61617890723505,4
2020-05-30-170622,170622,0,0,0,1007,0.16666666666666666,326.1333177972184,5
2020-05-31-170622,170622,0,0,0,1007,0.16666666666666666,335.05895796029984,6
2020-06-01-170622,170622,6,0,0,1013,2.75,817.5023227076882,0
2020-06-02-170622,170622,0,0,3,1013,2.0,186.35170830584252,1
2020-06-03-170622,170622,1,0,0,1014,2.333333333333333,144.94683721491467,2
2020-06-04-170622,170622,2,0,1,1016,2.4166666666666665,166.4549763786344,3
2020-06-05-170622,170622,0,1,2,1016,2.4166666666666665,225.69542823098718,4
2020-06-06-170622,170622,0,3,0,1016,0.0,256.73402519213886,5
2020-06-07-170622,170622,0,0,0,1016,0.08333333333333333,256.2382696821126,6
2020-06-08-170622,170622,2,0,2,1018,1.25,253.09937698652635,0
2020-06-09-170622,170622,2,0,1,1020,1.4166666666666667,268.41420169200507,1
2020-06-10-170622,170622,1,0,0,1021,1.25,919.349094486065,2
2020-06-11-170622,170622,5,0,0,1026,1.9166666666666667,791.5927113368286,3
2020-06-12-170622,170622,1,0,4,1027,0.5833333333333334,741.7485093370024,4
2020-06-13-170622,170622,0,0,1,1027,0.0,601.9228175545263,5
2020-06-14-170622,170622,0,0,0,1027,0.0,409.1234999733942,6
2020-06-15-170622,170622,0,0,2,1027,1.1666666666666667,237.76434497597893,0
2020-06-16-170622,170622,3,0,0,1030,1.8333333333333333,229.35337924579937,1
2020-06-17-170622,170622,0,0,1,1030,1.6666666666666667,179.56185693903626,2
2020-06-18-170622,170622,1,0,0,1031,1.6666666666666667,175.71090191658786,3
2020-06-19-170622,170622,2,0,3,1033,1.9166666666666667,164.7513881482111,4
2020-06-20-170622,170622,0,0,0,1033,0.0,257.51200570729696,5
2020-06-21-170622,170622,0,0,0,1033,0.08333333333333333,259.1847012224179,6
2020-06-22-170622,170622,2,0,0,1035,1.75,230.297608120192,0
2020-06-23-170622,170622,1,0,0,1036,1.3333333333333333,239.95836987347377,1
2020-06-24-170622,170622,0,0,0,1036,0.5,245.84831147728448,2
2020-06-25-170622,170622,0,1,0,1036,0.6666666666666666,225.2259841399101,3
2020-06-26-170622,170622,4,0,0,1040,1.1666666666666667,187.9967009155319,4
2020-06-27-170622,170622,1,1,0,1041,0.0,174.21438441725866,5
2020-06-28-170622,170622,0,0,0,1041,0.08333333333333333,178.40581191059297,6
2020-06-29-170622,170622,2,0,0,1043,1.1666666666666667,182.60494101852336,0
2020-06-30-170622,170622,0,1,0,1043,0.5833333333333334,189.09550255793934,1
2020-07-01-170622,170622,1,0,0,1044,1.0,287.2297565052414,2
2020-07-02-170622,170622,0,0,0,1044,0.3333333333333333,81.75825499647286,3
2020-07-03-170622,170622,3,0,0,1047,0.6666666666666666,149.19249605035398,4
2020-07-04-170622,170622,0,0,0,1047,0.0,220.7727924678734,5
2020-07-05-170622,170622,0,0,0,1047,0.08333333333333333,217.0671007302878,6
2020-07-06-170622,170622,0,0,2,1047,0.3333333333333333,188.19604024230037,0
2020-07-07-170622,170622,0,0,0,1047,0.75,175.7171552794472,1
2020-07-08-170622,170622,0,0,4,1047,0.08333333333333333,162.4854112919966,2
2020-07-09-170622,170622,0,0,0,1047,0.5,145.28280560088967,3
2020-07-10-170622,170622,0,0,0,1047,0.4166666666666667,295.47554204120917,4
2020-07-11-170622,170622,0,0,0,1047,0.0,218.67035442726615,5
2020-07-12-170622,170622,0,0,0,1047,0.0,144.3329069284473,6
2020-07-13-170622,170622,0,0,1,1047,0.4166666666666667,145.55877598939955,0
2020-07-14-170622,170622,0,0,1,1047,0.4166666666666667,157.39786609784935,1
2020-07-15-170622,170622,0,0,0,1047,0.6666666666666666,132.28220967891738,2
2020-07-16-170622,170622,0,0,0,1047,1.0,91.94242959358891,3
2020-07-17-170622,170622,0,0,1,1047,0.3333333333333333,81.2962293358171,4
2020-07-18-170622,170622,0,0,2,1047,0.0,83.0730313246585,5
2020-07-19-170622,170622,0,0,2,1047,0.0,82.6196554107356,6
2020-07-20-170622,170622,2,1,5,1049,0.8333333333333334,73.01694753080967,0
2020-07-21-170622,170622,0,1,2,1049,1.9166666666666667,79.07601435642482,1
2020-07-22-170622,170622,4,0,5,1053,0.4166666666666667,119.43157299756254,2
2020-07-23-170622,170622,0,2,2,1053,0.8333333333333334,118.88051004349347,3
2020-07-24-170622,170622,0,0,0,1053,0.8333333333333334,131.99561206697638,4
2020-07-25-170622,170622,0,0,3,1053,0.25,155.65303423377918,5
2020-07-26-170622,170622,0,0,0,1053,0.16666666666666666,157.94699173020092,6
2020-07-27-170622,170622,1,1,2,1054,1.0,155.87046201064513,0
2020-07-28-170622,170622,1,1,0,1055,0.6666666666666666,165.4707804949914,1
2020-07-29-170622,170622,0,0,3,1055,0.9166666666666666,136.3843380938784,2
2020-07-30-170622,170622,0,0,3,1055,1.0,144.11909889757726,3
2020-07-31-170622,170622,1,1,2,1056,2.75,177.9535039264747,4
2020-08-01-170622,170622,2,0,2,1058,0.5833333333333334,102.86933948939472,5
2020-08-02-170622,170622,2,0,3,1060,1.1666666666666667,748.5587388556171,6
2020-08-03-170622,170622,5,0,2,1065,1.5,1220.3385730869609,0
2020-08-04-170622,170622,2,0,5,1067,1.5,1138.09234097946,1
2020-08-05-170622,170622,5,0,2,1072,3.4166666666666665,951.6755164809888,2
2020-08-06-170622,170622,2,0,5,1074,2.4166666666666665,901.2291596864825,3
2020-08-07-170622,170622,0,0,2,1074,4.0,718.032600031898,4
2020-08-08-170622,170622,3,0,2,1077,1.1666666666666667,770.3478207554363,5
2020-08-09-170622,170622,0,0,13,1077,0.8333333333333334,737.4231937389816,6
2020-08-10-170622,170622,2,0,13,1079,3.8333333333333335,81.66524076363422,0
2020-08-11-170622,170622,0,0,7,1079,2.6666666666666665,161.8966761479153,1
2020-08-12-170622,170622,3,0,10,1082,3.75,237.34696608864246,2
2020-08-13-170622,170622,3,0,5,1085,5.0,323.9563724178159,3
2020-08-14-170622,170622,2,0,4,1087,2.5,435.0500877830942,4
2020-08-15-170622,170622,2,1,2,1089,1.75,524.5369038073275,5
2020-08-16-170622,170622,3,0,3,1092,1.25,555.5673182340048,6
2020-08-17-170622,170622,2,0,3,1094,4.583333333333333,584.426639224501,0
2020-08-18-170622,170622,5,0,2,1099,3.4166666666666665,639.8539200027255,1
2020-08-19-170622,170622,2,0,3,1101,4.166666666666667,655.9339587919569,2
2020-08-20-170622,170622,5,0,12,1106,5.5,590.9922291309181,3
2020-08-21-170622,170622,2,0,19,1108,3.8333333333333335,649.1443749170312,4
2020-08-22-170622,170622,2,0,2,1110,0.5,713.6104166835138,5
2020-08-23-170622,170622,13,0,0,1123,1.1666666666666667,698.8513114375005,6
2020-08-24-170622,170622,13,0,6,1136,6.333333333333332,621.6739599053753,0
2020-08-25-170622,170622,7,0,0,1143,6.166666666666668,735.289975731833,1
2020-08-26-170622,170622,10,0,3,1153,7.666666666666668,790.1495881452931,2
2020-08-27-170622,170622,5,0,2,1158,4.583333333333333,976.2801016994158,3
2020-08-28-170622,170622,4,0,10,1162,8.25,983.3272726256885,4
2020-08-29-170622,170622,2,0,6,1164,2.25,1118.1297026148814,5
2020-08-30-170622,170622,3,0,0,1167,1.5,1172.467480915857,6
2020-08-31-170622,170622,3,0,14,1170,8.583333333333334,1016.8096848758023,0
2020-09-01-170622,170622,2,2,7,1172,5.25,695.5570718518197,1
2020-09-02-170622,170622,3,0,2,1175,4.5,1116.2319587052446,2
2020-09-03-170622,170622,12,0,11,1187,4.416666666666667,1116.1341241498103,3
2020-09-04-170622,170622,19,0,14,1206,8.916666666666666,1066.6110933870737,4
2020-09-05-170622,170622,2,0,6,1208,4.25,1144.3286242518461,5
2020-09-06-170622,170622,0,0,1,1208,1.75,1167.413910432177,6
2020-09-07-170622,170622,6,1,9,1214,7.333333333333332,1159.9206994887081,0
2020-09-08-170622,170622,0,0,24,1214,3.0,1193.967933607978,1
2020-09-09-170622,170622,3,0,17,1217,4.166666666666667,1072.4517348860861,2
2020-09-10-170622,170622,2,0,10,1219,5.5,585.0177606213358,3
2020-09-11-170622,170622,10,0,18,1229,10.0,688.1019024998737,4
2020-09-12-170622,170622,6,0,5,1235,1.75,878.7905286433671,5
2020-09-13-170622,170622,0,1,0,1235,2.1666666666666665,882.7265515685336,6
2020-09-14-170622,170622,14,0,13,1249,12.666666666666664,831.7342076404007,0
2020-09-15-170622,170622,7,0,2,1256,7.5,1072.797550787383,1
2020-09-16-170622,170622,2,0,10,1258,6.583333333333332,1269.5768601582715,2
2020-09-17-170622,170622,11,0,5,1269,6.333333333333332,1260.8668096611204,3
2020-09-18-170622,170622,14,0,8,1283,8.833333333333334,1248.6128854898448,4
2020-09-19-170622,170622,6,1,3,1289,1.1666666666666667,1177.9646613328061,5
2020-09-20-170622,170622,1,0,4,1290,3.083333333333333,1222.5163825586217,6
2020-09-21-170622,170622,9,0,58,1299,11.833333333333336,1018.4317891388391,0
2020-09-22-170622,170622,24,2,6,1323,9.75,1087.52781331886,1
2020-09-23-170622,170622,17,0,18,1340,8.166666666666666,1175.0485758777893,2
2020-09-24-170622,170622,10,0,13,1350,8.416666666666666,1255.2686278928809,3
2020-09-25-170622,170622,18,0,11,1368,7.25,1219.6161298210623,4
2020-09-26-170622,170622,5,0,2,1373,2.25,1330.9429035500414,5
2020-09-27-170622,170622,0,0,7,1373,2.0,1281.8117103453037,6
2020-09-28-170622,170622,13,0,3,1386,4.666666666666667,1267.7367173536786,0
2020-09-29-170622,170622,2,0,5,1388,6.916666666666668,1217.0518683314622,1
2020-09-30-170622,170622,10,1,8,1398,6.083333333333332,1122.305072248961,2
2020-10-01-170622,170622,5,0,12,1403,5.166666666666667,0.0,3
2020-10-02-170622,170622,8,0,18,1411,5.666666666666668,2132.881897800472,4
2020-10-03-170622,170622,3,0,2,1414,2.25,2544.9823462459117,5
2020-10-04-170622,170622,4,0,8,1418,2.1666666666666665,2318.9268062006104,6
2020-10-05-170622,170622,58,0,14,1476,6.5,1953.203221612596,0
2020-10-06-170622,170622,6,1,10,1482,6.416666666666668,1879.45960147744,1
2020-10-07-170622,170622,18,0,21,1500,6.666666666666668,1650.4610705430227,2
2020-10-08-170622,170622,13,1,19,1513,6.416666666666668,1651.7179928361588,3
2020-10-09-170622,170622,11,0,29,1524,9.083333333333334,1826.0737680606203,4
2020-10-10-170622,170622,2,0,7,1526,4.166666666666667,135.98399317569636,5
2020-10-11-170622,170622,7,0,8,1533,4.083333333333333,272.7293374218384,6
2020-10-12-170622,170622,3,0,12,1536,3.25,418.83864695660316,0
2020-10-13-170622,170622,5,0,21,1541,10.083333333333334,525.5209073439252,1
2020-10-14-170622,170622,8,0,22,1549,7.25,848.2483069839377,2
2020-10-15-170622,170622,12,0,18,1561,9.25,1109.726878599724,3
2020-10-16-170622,170622,18,0,28,1579,12.0,1461.9614146658846,4
2020-10-17-170622,170622,2,1,5,1581,3.1666666666666665,1806.9893595854794,5
2020-10-18-170622,170622,8,0,8,1589,5.833333333333332,1750.232536879576,6
2020-10-19-170622,170622,14,0,5,1603,11.666666666666664,1751.7350112705774,0
2020-10-20-170622,170622,10,0,24,1613,13.25,1936.7922041537556,1
2020-10-21-170622,170622,21,1,11,1634,12.083333333333336,2029.736158863734,2
2020-10-22-170622,170622,19,1,14,1653,11.25,2078.4515512200605,3
2020-10-23-170622,170622,29,0,9,1682,14.583333333333336,2077.85423319882,4
2020-10-24-170622,170622,7,0,3,1689,2.5,2399.0151331110665,5
2020-10-25-170622,170622,8,5,8,1697,8.333333333333334,2368.9199908776864,6
2020-10-26-170622,170622,12,0,19,1709,12.5,2195.7457984342927,0
2020-10-27-170622,170622,21,1,7,1730,11.5,2499.0329014682,1
2020-10-28-170622,170622,22,0,18,1752,9.166666666666666,2610.180853707403,2
2020-10-29-170622,170622,18,0,6,1770,7.583333333333332,2667.774634973838,3
2020-10-30-170622,170622,28,0,10,1798,12.166666666666664,2129.160434653896,4
2020-10-31-170622,170622,5,1,0,1803,2.1666666666666665,2458.697812827691,5
2020-11-01-170622,170622,8,2,0,1811,3.1666666666666665,1721.942708569101,6
2020-11-02-170622,170622,5,0,0,1816,2.25,969.4389403898217,0
2020-11-03-170622,170622,24,0,0,1840,10.583333333333334,907.8262990964896,1
2020-11-04-170622,170622,11,0,0,1851,11.416666666666664,1273.6112688440458,2
2020-11-05-170622,170622,14,0,0,1865,7.833333333333332,1491.752027856852,3
2020-11-06-170622,170622,9,1,0,1874,8.083333333333334,1585.307814338079,4
2020-11-07-170622,170622,3,1,0,1877,2.1666666666666665,1727.0388038253705,5
2020-11-08-170622,170622,8,0,0,1885,2.333333333333333,1636.8322159831482,6
2020-11-09-170622,170622,19,0,0,1904,9.833333333333334,1652.5922440229651,0
2020-11-10-170622,170622,7,2,0,1911,6.25,1724.0374060000113,1
2020-11-11-170622,170622,18,0,0,1929,6.166666666666668,1854.5374300954895,2
2020-11-12-170622,170622,6,0,0,1935,6.5,1677.899878626984,3
2020-11-13-170622,170622,10,0,0,1945,5.583333333333332,1679.8055315744693,4
2020-03-01-170623,170623,0,0,11,0,0.0,0.0,6
2020-03-02-170623,170623,0,0,15,0,0.125,149.50033279940376,0
2020-03-03-170623,170623,1,0,19,1,0.25,713.8705799735063,1
2020-03-04-170623,170623,0,1,16,1,0.125,790.259951361716,2
2020-03-05-170623,170623,0,0,19,1,0.0,823.8526281336513,3
2020-03-06-170623,170623,0,0,19,1,0.0,713.470624058566,4
2020-03-07-170623,170623,0,0,7,1,0.0,768.0042873092683,5
2020-03-08-170623,170623,0,0,4,1,0.125,743.1101642221413,6
2020-03-09-170623,170623,0,1,39,1,0.125,739.9514875483915,0
2020-03-10-170623,170623,2,0,28,3,0.25,1102.986365011951,1
2020-03-11-170623,170623,0,0,32,3,0.5,841.165727207311,2
2020-03-12-170623,170623,0,0,28,3,0.375,652.2068329048087,3
2020-03-13-170623,170623,4,0,20,7,1.0,437.55712025674285,4
2020-03-14-170623,170623,5,0,5,12,2.625,421.0923177667204,5
2020-03-15-170623,170623,11,0,7,23,4.5,395.12103259846606,6
2020-03-16-170623,170623,15,0,29,38,7.75,291.88853211870816,0
2020-03-17-170623,170623,19,0,9,57,10.0,509.51960059201195,1
2020-03-18-170623,170623,16,0,12,73,7.625,722.6368760970033,2
2020-03-19-170623,170623,19,0,8,92,9.875,886.0071905797923,3
2020-03-20-170623,170623,19,0,8,111,13.375,998.1038198360399,4
2020-03-21-170623,170623,7,0,3,118,5.75,1132.6018872823433,5
2020-03-22-170623,170623,4,0,1,122,7.125,1091.9196296477307,6
2020-03-23-170623,170623,39,0,12,161,21.75,1012.8057007033533,0
2020-03-24-170623,170623,28,0,3,189,16.0,1169.6040926518822,1
2020-03-25-170623,170623,32,0,8,221,17.875,1259.5343280330155,2
2020-03-26-170623,170623,28,1,7,249,13.875,1348.2051417225948,3
2020-03-27-170623,170623,20,0,5,269,17.625,1603.3606746253067,4
2020-03-28-170623,170623,5,0,0,274,4.0,1648.3082866267744,5
2020-03-29-170623,170623,7,1,1,281,5.0,1620.1638205374998,6
2020-03-30-170623,170623,29,0,8,310,15.0,1256.894663296446,0
2020-03-31-170623,170623,9,0,8,319,11.125,1250.393844819434,1
2020-04-01-170623,170623,12,0,6,331,12.125,173.4708611549373,2
2020-04-02-170623,170623,8,0,3,339,6.125,548.7289373967131,3
2020-04-03-170623,170623,8,0,5,347,9.625,329.1880398130388,4
2020-04-04-170623,170623,3,0,12,350,1.75,433.6760605082167,5
2020-04-05-170623,170623,1,0,3,351,3.75,439.104547789245,6
2020-04-06-170623,170623,12,0,5,363,10.125,459.87290552005754,0
2020-04-07-170623,170623,3,0,10,366,9.5,531.1436355528125,1
2020-04-08-170623,170623,8,0,12,374,5.625,582.0434176541739,2
2020-04-09-170623,170623,7,0,5,381,2.875,602.2633027897177,3
2020-04-10-170623,170623,5,0,4,386,3.375,170.41714350682244,4
2020-04-11-170623,170623,0,0,5,386,2.75,220.03607564401207,5
2020-04-12-170623,170623,1,0,11,387,3.25,246.25708987940342,6
2020-04-13-170623,170623,8,0,15,395,8.375,275.230319368441,0
2020-04-14-170623,170623,8,0,1,403,8.375,387.43386237226025,1
2020-04-15-170623,170623,6,0,5,409,6.625,483.84916525972443,2
2020-04-16-170623,170623,3,0,1,412,6.375,556.5611745301609,3
2020-04-17-170623,170623,5,0,10,417,5.5,501.08055548345703,4
2020-04-18-170623,170623,12,0,3,429,3.375,542.3148185664672,5
2020-04-19-170623,170623,3,0,1,432,0.625,566.8086374999998,6
2020-04-20-170623,170623,5,0,14,437,5.125,537.054962403678,0
2020-04-21-170623,170623,10,1,6,447,6.375,523.6638143185891,1
2020-04-22-170623,170623,12,0,1,459,7.25,532.6697299037714,2
2020-04-23-170623,170623,5,0,3,464,1.25,537.262923320252,3
2020-04-24-170623,170623,4,0,2,468,3.125,473.2438929064641,4
2020-04-25-170623,170623,5,0,0,473,1.75,460.3463747898279,5
2020-04-26-170623,170623,11,0,0,484,0.625,474.5625252593977,6
2020-04-27-170623,170623,15,0,16,499,4.375,399.6742894701923,0
2020-04-28-170623,170623,1,0,7,500,4.375,399.3462472740175,1
2020-04-29-170623,170623,5,0,5,505,4.875,360.25396765820324,2
2020-04-30-170623,170623,1,0,4,506,3.75,445.8106769146531,3
2020-05-01-170623,170623,10,0,4,516,1.875,565.2457440401699,4
2020-05-02-170623,170623,3,1,0,519,1.125,237.66317345481315,5
2020-05-03-170623,170623,1,0,0,520,0.875,149.46774482540224,6
2020-05-04-170623,170623,14,0,8,534,6.625,131.69123992871675,0
2020-05-05-170623,170623,6,0,3,540,2.75,207.90409323241073,1
2020-05-06-170623,170623,1,0,5,541,9.125,236.10839535574212,2
2020-05-07-170623,170623,3,0,0,544,4.0,310.12146668020773,3
2020-05-08-170623,170623,2,0,1,546,5.0,350.7309427875085,4
2020-05-09-170623,170623,0,0,1,546,1.5,437.15239771226265,5
2020-05-10-170623,170623,0,2,0,546,0.5,605.835838524502,6
2020-05-11-170623,170623,16,0,1,562,3.875,564.9474224236023,0
2020-05-12-170623,170623,7,0,3,569,5.25,595.2423969791867,1
2020-05-13-170623,170623,5,0,3,574,4.0,518.6393299075926,2
2020-05-14-170623,170623,4,1,3,578,1.875,465.1225888409258,3
2020-05-15-170623,170623,4,0,4,582,3.25,403.67950096435214,4
2020-05-16-170623,170623,0,0,0,582,0.25,403.3693646518756,5
2020-05-17-170623,170623,0,0,0,582,0.25,369.7724638994571,6
2020-05-18-170623,170623,8,0,6,590,1.375,371.2726741428723,0
2020-05-19-170623,170623,3,0,1,593,3.125,329.2861098256695,1
2020-05-20-170623,170623,5,0,0,598,1.0,244.061132360977,2
2020-05-21-170623,170623,0,0,4,598,1.875,236.20715574723658,3
2020-05-22-170623,170623,1,0,12,599,2.125,206.9535121748334,4
2020-05-23-170623,170623,1,0,0,600,0.125,240.371875761368,5
2020-05-24-170623,170623,0,1,1,600,0.375,243.13832833636206,6
2020-05-25-170623,170623,1,0,2,601,1.375,204.29429693302043,0
2020-05-26-170623,170623,3,0,1,604,0.875,185.2876212936987,1
2020-05-27-170623,170623,3,1,2,607,1.125,183.0125035050512,2
2020-05-28-170623,170623,3,0,1,610,2.0,178.1655919558292,3
2020-05-29-170623,170623,4,0,0,614,2.25,183.05392389841222,4
2020-05-30-170623,170623,0,0,0,614,0.0,203.3730264886064,5
2020-05-31-170623,170623,0,0,0,614,0.125,204.49747907629555,6
2020-06-01-170623,170623,6,0,1,620,1.625,563.6871195024836,0
2020-06-02-170623,170623,1,0,2,621,0.75,132.25196904184625,1
2020-06-03-170623,170623,0,0,3,621,1.375,96.24577028668558,2
2020-06-04-170623,170623,4,0,2,625,0.875,98.05873626553009,3
2020-06-05-170623,170623,12,0,3,637,0.875,126.09598947990966,4
2020-06-06-170623,170623,0,0,0,637,0.25,158.80785470903183,5
2020-06-07-170623,170623,1,0,0,638,0.125,161.4622437034001,6
2020-06-08-170623,170623,2,0,2,640,0.75,165.4442124276819,0
2020-06-09-170623,170623,1,0,4,641,1.375,171.8130393656749,1
2020-06-10-170623,170623,2,0,0,643,0.5,627.5574018798155,2
2020-06-11-170623,170623,1,0,1,644,2.375,525.4533342971686,3
2020-06-12-170623,170623,0,0,0,644,0.625,494.65164753882823,4
2020-06-13-170623,170623,0,0,0,644,0.0,355.1207740625897,5
2020-06-14-170623,170623,0,0,0,644,0.0,251.11412074414665,6
2020-06-15-170623,170623,1,0,1,645,0.875,150.61989595189863,0
2020-06-16-170623,170623,2,0,2,647,1.375,150.56942234733881,1
2020-06-17-170623,170623,3,0,1,650,1.0,120.93520664093064,2
2020-06-18-170623,170623,2,0,0,652,1.625,121.21697176972486,3
2020-06-19-170623,170623,3,0,0,655,1.125,116.16481431689934,4
2020-06-20-170623,170623,0,0,0,655,0.0,173.69874370426365,5
2020-06-21-170623,170623,0,0,0,655,0.125,174.29996484669076,6
2020-06-22-170623,170623,2,0,1,657,1.5,155.94101616756666,0
2020-06-23-170623,170623,4,0,0,661,1.25,162.67230423402754,1
2020-06-24-170623,170623,0,0,0,661,0.75,170.94600245127126,2
2020-06-25-170623,170623,1,3,1,662,0.875,150.1706370962917,3
2020-06-26-170623,170623,0,0,1,662,1.0,131.5282201979673,4
2020-06-27-170623,170623,0,0,0,662,0.125,122.12803581882837,5
2020-06-28-170623,170623,0,0,0,662,0.0,123.27446255258866,6
2020-06-29-170623,170623,1,0,1,663,1.375,121.03023671468091,0
2020-06-30-170623,170623,2,1,1,665,0.625,112.50763135077901,1
2020-07-01-170623,170623,1,0,0,666,1.0,188.99132417517643,2
2020-07-02-170623,170623,0,0,0,666,0.875,65.89986542564894,3
2020-07-03-170623,170623,0,0,0,666,0.75,89.88304899238886,4
2020-07-04-170623,170623,0,0,0,666,0.125,134.74989717774588,5
2020-07-05-170623,170623,0,0,0,666,0.0,131.76120123266745,6
2020-07-06-170623,170623,1,0,0,667,0.25,112.89102713506448,0
2020-07-07-170623,170623,0,0,0,667,0.625,107.940276563286,1
2020-07-08-170623,170623,0,0,1,667,0.125,97.76162272777212,2
2020-07-09-170623,170623,1,0,1,668,0.5,88.8794567142619,3
2020-07-10-170623,170623,1,0,0,669,0.125,200.09084294486428,4
2020-07-11-170623,170623,0,0,0,669,0.0,158.94972194258872,5
2020-07-12-170623,170623,0,0,1,669,0.375,100.569594670637,6
2020-07-13-170623,170623,1,0,0,670,0.375,103.51458645225836,0
2020-07-14-170623,170623,1,0,0,671,0.875,109.36231406067361,1
2020-07-15-170623,170623,0,0,1,671,0.25,100.78757848214303,2
2020-07-16-170623,170623,0,0,2,671,0.75,78.38474416979176,3
2020-07-17-170623,170623,0,0,7,671,0.625,67.94974825863689,4
2020-07-18-170623,170623,0,0,3,671,0.125,69.9863167448337,5
2020-07-19-170623,170623,0,0,2,671,0.0,70.47236735644073,6
2020-07-20-170623,170623,0,0,2,671,0.625,59.747708618261086,0
2020-07-21-170623,170623,0,0,4,671,2.5,54.982532024782614,1
2020-07-22-170623,170623,1,0,4,672,0.875,96.61757783437342,2
2020-07-23-170623,170623,1,1,3,673,0.625,93.64160593553127,3
2020-07-24-170623,170623,0,0,6,673,0.125,100.20742940303587,4
2020-07-25-170623,170623,0,0,3,673,0.25,109.00340657839428,5
2020-07-26-170623,170623,1,1,0,674,0.125,110.43911995547272,6
2020-07-27-170623,170623,0,0,3,674,0.75,106.84994523825605,0
2020-07-28-170623,170623,0,1,4,674,0.625,112.35116482679933,1
2020-07-29-170623,170623,1,0,11,675,0.75,78.9730195172645,2
2020-07-30-170623,170623,2,0,4,677,0.75,83.77377716068736,3
2020-07-31-170623,170623,7,0,3,684,1.25,100.80980545608321,4
2020-08-01-170623,170623,3,0,0,687,0.375,70.70419838588236,5
2020-08-02-170623,170623,2,0,3,689,1.25,511.6093366175726,6
2020-08-03-170623,170623,2,0,5,691,1.25,754.5443687217808,0
2020-08-04-170623,170623,4,0,9,695,1.625,692.3558694258741,1
2020-08-05-170623,170623,4,0,5,699,2.75,574.1454533943007,2
2020-08-06-170623,170623,3,0,9,702,2.0,551.1576105274044,3
2020-08-07-170623,170623,6,0,7,708,2.625,453.68831901048134,4
2020-08-08-170623,170623,3,0,1,711,1.375,477.4212261115216,5
2020-08-09-170623,170623,0,0,4,711,0.625,478.46218070526174,6
2020-08-10-170623,170623,3,0,5,714,3.625,56.44885575314543,0
2020-08-11-170623,170623,4,0,3,718,0.875,113.68255129334206,1
2020-08-12-170623,170623,11,0,6,729,2.25,165.79302294890556,2
2020-08-13-170623,170623,4,0,6,733,3.5,235.69169636921862,3
2020-08-14-170623,170623,3,1,5,736,3.0,314.9429759270289,4
2020-08-15-170623,170623,0,0,5,736,1.0,377.80985425113664,5
2020-08-16-170623,170623,3,0,1,739,1.375,389.74895712674186,6
2020-08-17-170623,170623,5,0,10,744,4.125,404.81687401554325,0
2020-08-18-170623,170623,9,0,11,753,2.75,445.00850368913564,1
2020-08-19-170623,170623,5,0,14,758,3.375,461.1795051254377,2
2020-08-20-170623,170623,9,0,10,767,5.125,408.57836167749775,3
2020-08-21-170623,170623,7,0,16,774,3.0,451.81517066840775,4
2020-08-22-170623,170623,1,0,13,775,0.625,510.46762368546547,5
2020-08-23-170623,170623,4,0,5,779,2.375,502.4194705409277,6
2020-08-24-170623,170623,5,0,22,784,6.5,437.37606161342444,0
2020-08-25-170623,170623,3,0,9,787,5.375,503.96262569299023,1
2020-08-26-170623,170623,6,0,9,793,8.125,529.8025640400676,2
2020-08-27-170623,170623,6,0,5,799,3.25,648.1524809118606,3
2020-08-28-170623,170623,5,0,15,804,4.5,624.5455532392434,4
2020-08-29-170623,170623,5,0,2,809,2.125,669.3345104369171,5
2020-08-30-170623,170623,1,0,2,810,1.25,709.7595402083114,6
2020-08-31-170623,170623,10,0,28,820,5.375,607.2047449929883,0
2020-09-01-170623,170623,11,0,16,831,3.25,444.1364355096705,1
2020-09-02-170623,170623,14,0,13,845,3.25,701.280776395107,2
2020-09-03-170623,170623,10,0,15,855,4.5,719.1609304153151,3
2020-09-04-170623,170623,16,0,15,871,6.125,682.6225728377921,4
2020-09-05-170623,170623,13,0,1,884,3.125,723.7809397499993,5
2020-09-06-170623,170623,5,1,7,889,1.625,743.1141356741871,6
2020-09-07-170623,170623,22,0,29,911,3.875,757.0906967413091,0
2020-09-08-170623,170623,9,0,6,920,0.75,799.7885701146681,1
2020-09-09-170623,170623,9,1,12,929,2.5,722.0896353792407,2
2020-09-10-170623,170623,5,0,18,934,3.875,404.1910981173379,3
2020-09-11-170623,170623,15,0,16,949,4.5,468.4817040027839,4
2020-09-12-170623,170623,2,0,8,951,2.25,572.0597623293525,5
2020-09-13-170623,170623,2,0,4,953,0.625,582.2060678046504,6
2020-09-14-170623,170623,28,0,4,981,8.0,544.0244993309971,0
2020-09-15-170623,170623,16,0,17,997,2.5,701.2917066109654,1
2020-09-16-170623,170623,13,0,6,1010,3.0,802.0341219961434,2
2020-09-17-170623,170623,15,0,9,1025,3.625,783.7103903078398,3
2020-09-18-170623,170623,15,1,10,1040,5.375,780.0286992736051,4
2020-09-19-170623,170623,1,0,4,1041,2.0,751.531512881124,5
2020-09-20-170623,170623,7,2,2,1048,2.125,800.6380469307311,6
2020-09-21-170623,170623,29,0,6,1077,6.375,664.5182560496169,0
2020-09-22-170623,170623,6,1,10,1083,8.5,747.6789848563358,1
2020-09-23-170623,170623,12,1,6,1095,5.875,814.742509952235,2
2020-09-24-170623,170623,18,1,6,1113,5.375,843.0363559808678,3
2020-09-25-170623,170623,16,0,3,1129,5.75,832.7989209243195,4
2020-09-26-170623,170623,8,0,1,1137,1.75,896.8139747900623,5
2020-09-27-170623,170623,4,0,5,1141,0.625,865.6382663937725,6
2020-09-28-170623,170623,4,0,7,1145,4.5,851.5756565855615,0
2020-09-29-170623,170623,17,0,9,1162,2.75,789.9409142707572,1
2020-09-30-170623,170623,6,0,15,1168,4.375,742.9045166169726,2
2020-10-01-170623,170623,9,1,7,1177,3.125,0.0,3
2020-10-02-170623,170623,10,1,18,1187,3.375,1391.1876887735266,4
2020-10-03-170623,170623,4,1,6,1191,1.25,1599.8369506420809,5
2020-10-04-170623,170623,2,2,7,1193,1.625,1435.1569862745018,6
2020-10-05-170623,170623,6,1,7,1199,11.125,1205.8633927284004,0
2020-10-06-170623,170623,10,2,12,1209,4.25,1123.0514297093553,1
2020-10-07-170623,170623,6,1,21,1215,6.125,1002.0014799588955,2
2020-10-08-170623,170623,6,0,19,1221,4.875,965.2215353200737,3
2020-10-09-170623,170623,3,2,7,1224,7.625,1086.2253313737322,4
2020-10-10-170623,170623,1,0,8,1225,2.25,93.02105252846867,5
2020-10-11-170623,170623,5,0,5,1230,3.125,170.4366745421952,6
2020-10-12-170623,170623,7,0,13,1237,1.875,266.64984813563154,0
2020-10-13-170623,170623,9,0,7,1246,6.0,336.4980459678943,1
2020-10-14-170623,170623,15,0,9,1261,5.875,549.6547569109191,2
2020-10-15-170623,170623,7,0,6,1268,7.875,739.9641638209514,3
2020-10-16-170623,170623,18,0,8,1286,7.75,963.2891715611892,4
2020-10-17-170623,170623,6,0,0,1292,1.25,1147.7526674995936,5
2020-10-18-170623,170623,7,0,3,1299,2.625,1116.3739322831425,6
2020-10-19-170623,170623,7,0,3,1306,9.875,1099.2532840293547,0
2020-10-20-170623,170623,12,0,16,1318,8.25,1214.8583698878786,1
2020-10-21-170623,170623,21,0,10,1339,7.5,1268.504800051513,2
2020-10-22-170623,170623,19,0,12,1358,6.625,1301.8794781389965,3
2020-10-23-170623,170623,7,0,6,1365,10.0,1315.6172047262776,4
2020-10-24-170623,170623,8,0,5,1373,1.25,1491.844324277702,5
2020-10-25-170623,170623,5,0,3,1378,4.5,1476.3765751428232,6
2020-10-26-170623,170623,13,1,17,1391,7.375,1347.745591181931,0
2020-10-27-170623,170623,7,0,4,1398,8.125,1538.196181913078,1
2020-10-28-170623,170623,9,1,3,1407,7.125,1572.1126879088122,2
2020-10-29-170623,170623,6,0,11,1413,6.875,1571.6010522502274,3
2020-10-30-170623,170623,8,0,6,1421,10.0,1263.543411959494,4
2020-10-31-170623,170623,0,1,0,1421,2.375,1449.0341164429647,5
2020-11-01-170623,170623,3,1,0,1424,3.625,975.5601961445918,6
2020-11-02-170623,170623,3,0,0,1427,3.0,592.8172504618201,0
2020-11-03-170623,170623,16,0,0,1443,7.875,574.9990342642644,1
2020-11-04-170623,170623,10,0,0,1453,6.875,772.5589449466491,2
2020-11-05-170623,170623,12,0,0,1465,6.125,918.7291269064392,3
2020-11-06-170623,170623,6,2,0,1471,6.5,994.1111879363004,4
2020-11-07-170623,170623,5,0,0,1476,1.25,1090.8084628040774,5
2020-11-08-170623,170623,3,1,0,1479,3.25,1022.9413469009924,6
2020-11-09-170623,170623,17,0,0,1496,7.125,1024.7484002652845,0
2020-11-10-170623,170623,4,1,0,1500,4.5,980.4011358718458,1
2020-11-11-170623,170623,3,1,0,1503,6.25,1061.651139806088,2
2020-11-12-170623,170623,11,0,0,1514,5.875,998.5919044945387,3
2020-11-13-170623,170623,6,0,0,1520,5.5,993.1275412549624,4
2020-03-01-170624,170624,1,0,0,1,0.0,0.0,6
2020-03-02-170624,170624,0,0,8,1,0.0,44.82284420220647,0
2020-03-03-170624,170624,0,0,5,1,0.1111111111111111,257.506292575819,1
2020-03-04-170624,170624,0,0,3,1,0.1111111111111111,316.4022176388562,2
2020-03-05-170624,170624,0,0,0,1,0.0,349.118809376506,3
2020-03-06-170624,170624,0,0,4,1,0.0,316.12781235325804,4
2020-03-07-170624,170624,0,0,3,1,0.0,344.67468923956,5
2020-03-08-170624,170624,0,0,3,1,0.0,356.23246521015994,6
2020-03-09-170624,170624,0,0,10,1,0.1111111111111111,355.9311708356813,0
2020-03-10-170624,170624,0,0,6,1,0.1111111111111111,748.1345201382402,1
2020-03-11-170624,170624,0,0,8,1,0.2222222222222222,563.2218714913045,2
2020-03-12-170624,170624,1,0,7,2,0.0,436.6152372637779,3
2020-03-13-170624,170624,0,0,6,2,0.5555555555555556,275.73676681350463,4
2020-03-14-170624,170624,2,0,2,4,0.6666666666666666,261.3249565291348,5
2020-03-15-170624,170624,0,0,2,4,1.2222222222222223,217.50369855049033,6
2020-03-16-170624,170624,8,0,13,12,2.888888888888889,72.40451605220778,0
2020-03-17-170624,170624,5,1,9,17,2.333333333333333,152.05513857697116,1
2020-03-18-170624,170624,3,0,10,20,3.2222222222222223,211.77833821839548,2
2020-03-19-170624,170624,0,0,3,20,3.111111111111111,252.39964470050649,3
2020-03-20-170624,170624,4,1,7,24,4.111111111111111,259.44058214326844,4
2020-03-21-170624,170624,3,0,2,27,3.111111111111111,293.0263231064871,5
2020-03-22-170624,170624,3,0,2,30,3.4444444444444446,300.06722729991395,6
2020-03-23-170624,170624,10,0,5,40,10.0,268.000964228503,0
2020-03-24-170624,170624,6,0,2,46,6.777777777777778,344.82794205983,1
2020-03-25-170624,170624,8,0,4,54,7.777777777777778,380.08074210187783,2
2020-03-26-170624,170624,7,0,1,61,5.111111111111111,451.73989839604076,3
2020-03-27-170624,170624,6,0,0,67,8.888888888888891,534.025279753497,4
2020-03-28-170624,170624,2,1,2,69,2.4444444444444446,576.3767661605674,5
2020-03-29-170624,170624,2,0,0,71,2.4444444444444446,569.9147991033569,6
2020-03-30-170624,170624,13,0,3,84,8.888888888888891,431.2065527126374,0
2020-03-31-170624,170624,9,0,3,93,4.666666666666667,482.81892782010635,1
2020-04-01-170624,170624,10,0,1,103,5.5555555555555545,78.14917338036373,2
2020-04-02-170624,170624,3,0,4,106,3.4444444444444446,218.37883449286755,3
2020-04-03-170624,170624,7,0,5,113,4.4444444444444455,126.82540130401162,4
2020-04-04-170624,170624,2,0,0,115,0.7777777777777778,167.79841898846445,5
2020-04-05-170624,170624,2,0,2,117,2.2222222222222223,177.6829311422556,6
2020-04-06-170624,170624,5,1,2,122,5.0,187.3042922262253,0
2020-04-07-170624,170624,2,2,4,124,3.2222222222222223,224.90293579677075,1
2020-04-08-170624,170624,4,0,3,128,3.0,226.39974006167566,2
2020-04-09-170624,170624,1,0,1,129,1.2222222222222223,241.79869006052252,3
2020-04-10-170624,170624,0,0,3,129,2.4444444444444446,83.94982379741461,4
2020-04-11-170624,170624,2,0,1,131,1.2222222222222223,100.08774605079574,5
2020-04-12-170624,170624,0,0,1,131,0.8888888888888888,115.79031495111423,6
2020-04-13-170624,170624,3,0,0,134,4.777777777777779,122.62187113825551,0
2020-04-14-170624,170624,3,0,3,137,2.4444444444444446,161.04491877834317,1
2020-04-15-170624,170624,1,0,2,138,5.777777777777778,196.8068863844236,2
2020-04-16-170624,170624,4,0,2,142,3.333333333333333,235.98528760419205,3
2020-04-17-170624,170624,5,0,1,147,1.8888888888888888,194.20660646630577,4
2020-04-18-170624,170624,0,0,1,147,1.4444444444444444,225.22952923644715,5
2020-04-19-170624,170624,2,0,0,149,0.6666666666666666,219.36902712176203,6
2020-04-20-170624,170624,2,0,0,151,2.0,229.01215810859918,0
2020-04-21-170624,170624,4,0,1,155,1.1111111111111112,221.57672090373643,1
2020-04-22-170624,170624,3,1,0,158,2.2222222222222223,217.2765360424494,2
2020-04-23-170624,170624,1,0,2,159,0.2222222222222222,209.84975607691348,3
2020-04-24-170624,170624,3,0,1,162,1.7777777777777777,171.07627548973517,4
2020-04-25-170624,170624,1,0,1,163,0.8888888888888888,188.9821617326872,5
2020-04-26-170624,170624,1,0,0,164,0.3333333333333333,180.91127215758908,6
2020-04-27-170624,170624,0,0,1,164,2.333333333333333,149.56225573564598,0
2020-04-28-170624,170624,3,1,0,167,2.333333333333333,144.67090857660781,1
2020-04-29-170624,170624,2,0,0,169,2.333333333333333,138.71128129944057,2
2020-04-30-170624,170624,2,0,0,171,1.4444444444444444,190.0084134792225,3
2020-05-01-170624,170624,1,0,2,172,0.5555555555555556,214.36696263811083,4
2020-05-02-170624,170624,1,0,0,173,0.7777777777777778,62.76531126757523,5
2020-05-03-170624,170624,0,0,0,173,0.1111111111111111,55.03893914681706,6
2020-05-04-170624,170624,0,0,1,173,3.6666666666666665,35.21048744936428,0
2020-05-05-170624,170624,1,0,0,174,1.6666666666666667,72.11931672580688,1
2020-05-06-170624,170624,0,0,0,174,7.333333333333332,83.74904605134441,2
2020-05-07-170624,170624,2,0,0,176,2.0,146.3394191838779,3
2020-05-08-170624,170624,1,0,2,177,1.7777777777777777,182.56216722049533,4
2020-05-09-170624,170624,1,1,0,178,0.4444444444444444,215.00343374553432,5
2020-05-10-170624,170624,0,0,0,178,0.1111111111111111,237.49917422305325,6
2020-05-11-170624,170624,1,0,2,179,1.8888888888888888,218.73177687698865,0
2020-05-12-170624,170624,0,1,0,179,1.6666666666666667,218.5818244308928,1
2020-05-13-170624,170624,0,0,0,179,1.0,162.38616045048389,2
2020-05-14-170624,170624,0,0,2,179,1.2222222222222223,136.12254414366222,3
2020-05-15-170624,170624,2,0,0,181,1.1111111111111112,97.45751242437372,4
2020-05-16-170624,170624,0,0,0,181,0.0,99.85224826981138,5
2020-05-17-170624,170624,0,0,0,181,0.1111111111111111,87.92697498765523,6
2020-05-18-170624,170624,1,0,0,182,1.8888888888888888,87.31104511738396,0
2020-05-19-170624,170624,0,0,1,182,1.0,83.33700350911457,1
2020-05-20-170624,170624,0,0,1,182,0.8888888888888888,83.66423286252133,2
2020-05-21-170624,170624,0,0,0,182,0.5555555555555556,81.73610091974014,3
2020-05-22-170624,170624,2,0,2,184,1.0,65.58794807917266,4
2020-05-23-170624,170624,0,0,0,184,0.1111111111111111,86.71501323381865,5
2020-05-24-170624,170624,0,0,0,184,0.2222222222222222,87.97860107047954,6
2020-05-25-170624,170624,2,0,1,186,0.6666666666666666,72.45546680723604,0
2020-05-26-170624,170624,0,0,0,186,0.5555555555555556,87.69039960015816,1
2020-05-27-170624,170624,0,0,1,186,0.8888888888888888,77.90527146575963,2
2020-05-28-170624,170624,2,0,0,188,1.0,80.39684704987317,3
2020-05-29-170624,170624,0,0,0,188,0.4444444444444444,98.00038869677114,4
2020-05-30-170624,170624,0,0,0,188,0.0,83.98286665111297,5
2020-05-31-170624,170624,0,0,0,188,0.1111111111111111,83.11928871369629,6
2020-06-01-170624,170624,0,0,0,188,0.4444444444444444,284.3134753149885,0
2020-06-02-170624,170624,1,0,0,189,1.0,70.93136804740227,1
2020-06-03-170624,170624,1,0,1,190,0.7777777777777778,40.76558556587467,2
2020-06-04-170624,170624,0,0,2,190,0.3333333333333333,35.1001430300351,3
2020-06-05-170624,170624,2,0,3,192,0.5555555555555556,33.040446218059586,4
2020-06-06-170624,170624,0,0,0,192,0.2222222222222222,53.32310234978061,5
2020-06-07-170624,170624,0,0,0,192,0.0,56.4509975746834,6
2020-06-08-170624,170624,1,0,0,193,0.0,56.072620791678105,0
2020-06-09-170624,170624,0,0,2,193,0.6666666666666666,60.99810705775796,1
2020-06-10-170624,170624,1,0,0,194,0.1111111111111111,288.7811716869823,2
2020-06-11-170624,170624,0,0,1,194,0.4444444444444444,242.30573447532302,3
2020-06-12-170624,170624,0,0,0,194,0.4444444444444444,221.6421633157234,4
2020-06-13-170624,170624,0,0,0,194,0.0,122.82476682060091,5
2020-06-14-170624,170624,0,0,0,194,0.0,73.47834007082423,6
2020-06-15-170624,170624,0,0,0,194,0.1111111111111111,41.06429750590041,0
2020-06-16-170624,170624,0,0,0,194,0.5555555555555556,32.46826449047959,1
2020-06-17-170624,170624,1,0,0,195,0.1111111111111111,32.50270027565549,2
2020-06-18-170624,170624,2,0,0,197,0.5555555555555556,32.66000970715234,3
2020-06-19-170624,170624,3,0,0,200,0.8888888888888888,50.76105768450711,4
2020-06-20-170624,170624,0,0,0,200,0.0,94.31295779232008,5
2020-06-21-170624,170624,0,0,0,200,0.1111111111111111,93.59927733764131,6
2020-06-22-170624,170624,0,0,0,200,0.4444444444444444,91.64460095691231,0
2020-06-23-170624,170624,2,0,0,202,0.6666666666666666,92.66990215665535,1
2020-06-24-170624,170624,0,0,1,202,0.4444444444444444,103.17325970210477,2
2020-06-25-170624,170624,1,0,1,203,0.3333333333333333,86.76205359025158,3
2020-06-26-170624,170624,0,0,0,203,0.1111111111111111,70.88252037817976,4
2020-06-27-170624,170624,0,0,0,203,0.1111111111111111,52.01075957893829,5
2020-06-28-170624,170624,0,0,0,203,0.1111111111111111,53.79305406232563,6
2020-06-29-170624,170624,0,0,0,203,0.4444444444444444,54.92189476470949,0
2020-06-30-170624,170624,0,0,0,203,0.2222222222222222,43.55809233739452,1
2020-07-01-170624,170624,0,0,0,203,0.0,64.82514918428176,2
2020-07-02-170624,170624,0,0,2,203,0.3333333333333333,36.13139501218982,3
2020-07-03-170624,170624,0,0,0,203,0.1111111111111111,20.3322818482528,4
2020-07-04-170624,170624,0,0,0,203,0.0,39.138024804949886,5
2020-07-05-170624,170624,0,0,0,203,0.1111111111111111,39.75426706715206,6
2020-07-06-170624,170624,0,0,0,203,0.2222222222222222,36.71618356920731,0
2020-07-07-170624,170624,0,0,0,203,0.4444444444444444,34.66959438351626,1
2020-07-08-170624,170624,1,1,0,204,0.2222222222222222,34.047596783699234,2
2020-07-09-170624,170624,1,0,0,205,0.2222222222222222,40.037738203406214,3
2020-07-10-170624,170624,0,0,0,205,0.0,68.28299258521491,4
2020-07-11-170624,170624,0,0,0,205,0.2222222222222222,60.18585689942999,5
2020-07-12-170624,170624,0,0,0,205,0.2222222222222222,35.421964338983166,6
2020-07-13-170624,170624,0,0,0,205,0.1111111111111111,33.86829344350454,0
2020-07-14-170624,170624,0,0,0,205,0.3333333333333333,42.33494992185984,1
2020-07-15-170624,170624,0,0,0,205,0.2222222222222222,35.651901061055284,2
2020-07-16-170624,170624,2,0,1,207,0.2222222222222222,25.2320761954519,3
2020-07-17-170624,170624,0,0,0,207,0.3333333333333333,37.37432347954831,4
2020-07-18-170624,170624,0,0,0,207,0.1111111111111111,38.322537237704196,5
2020-07-19-170624,170624,0,0,0,207,0.3333333333333333,38.055247726971146,6
2020-07-20-170624,170624,0,0,0,207,0.3333333333333333,32.03177684589124,0
2020-07-21-170624,170624,0,0,2,207,0.3333333333333333,31.631793681331814,1
2020-07-22-170624,170624,0,0,0,207,0.3333333333333333,37.51257619474006,2
2020-07-23-170624,170624,0,0,0,207,0.3333333333333333,26.327426141307033,3
2020-07-24-170624,170624,0,0,1,207,0.1111111111111111,27.618049806101837,4
2020-07-25-170624,170624,0,0,0,207,0.2222222222222222,28.026682626237648,5
2020-07-26-170624,170624,0,0,0,207,0.2222222222222222,25.55159756984653,6
2020-07-27-170624,170624,0,0,1,207,0.4444444444444444,24.58129787809137,0
2020-07-28-170624,170624,0,0,1,207,0.6666666666666666,26.44552865029894,1
2020-07-29-170624,170624,0,0,2,207,0.4444444444444444,21.881003299106094,2
2020-07-30-170624,170624,1,0,2,208,0.1111111111111111,20.255527119862187,3
2020-07-31-170624,170624,0,0,7,208,0.4444444444444444,30.253257155664734,4
2020-08-01-170624,170624,0,0,1,208,0.1111111111111111,35.43804977511874,5
2020-08-02-170624,170624,0,0,2,208,0.7777777777777778,259.72945734688415,6
2020-08-03-170624,170624,0,0,1,208,0.2222222222222222,581.2079837728036,0
2020-08-04-170624,170624,2,0,2,210,0.5555555555555556,587.3328733076141,1
2020-08-05-170624,170624,0,0,2,210,1.1111111111111112,498.95563633959244,2
2020-08-06-170624,170624,0,0,4,210,0.7777777777777778,394.1431261848244,3
2020-08-07-170624,170624,1,0,4,211,1.1111111111111112,319.4560248513949,4
2020-08-08-170624,170624,0,0,1,211,0.5555555555555556,293.8860221873124,5
2020-08-09-170624,170624,0,0,1,211,0.4444444444444444,299.2360676216399,6
2020-08-10-170624,170624,1,0,6,212,1.1111111111111112,29.70433258413784,0
2020-08-11-170624,170624,1,0,11,213,1.1111111111111112,55.724837008275685,1
2020-08-12-170624,170624,2,0,14,215,0.5555555555555556,85.6083979913923,2
2020-08-13-170624,170624,2,0,14,217,2.4444444444444446,128.5164263298244,3
2020-08-14-170624,170624,7,0,8,224,1.3333333333333333,174.53032123231458,4
2020-08-15-170624,170624,1,0,3,225,0.2222222222222222,248.59659734281828,5
2020-08-16-170624,170624,2,0,7,227,0.5555555555555556,244.2165689338495,6
2020-08-17-170624,170624,1,0,10,228,1.1111111111111112,276.78905764248134,0
2020-08-18-170624,170624,2,0,11,230,0.6666666666666666,274.20217519546827,1
2020-08-19-170624,170624,2,0,5,232,1.1111111111111112,277.8607536368521,2
2020-08-20-170624,170624,4,0,5,236,1.4444444444444444,230.1411949021466,3
2020-08-21-170624,170624,4,0,10,240,1.3333333333333333,202.68980118348156,4
2020-08-22-170624,170624,1,0,9,241,0.2222222222222222,237.7926148798369,5
2020-08-23-170624,170624,1,0,10,242,0.6666666666666666,230.9688683147442,6
2020-08-24-170624,170624,6,0,11,248,2.4444444444444446,226.42737609674742,0
2020-08-25-170624,170624,11,0,2,259,3.2222222222222223,269.8137249691442,1
2020-08-26-170624,170624,14,0,2,273,2.0,334.1688962181294,2
2020-08-27-170624,170624,14,0,9,287,1.2222222222222223,430.29513260762224,3
2020-08-28-170624,170624,8,0,19,295,2.2222222222222223,493.86432796928545,4
2020-08-29-170624,170624,3,0,6,298,1.0,534.1530447116455,5
2020-08-30-170624,170624,7,0,12,305,0.7777777777777778,539.3134411232631,6
2020-08-31-170624,170624,10,0,8,315,2.333333333333333,512.8023462381765,0
2020-09-01-170624,170624,11,0,7,326,2.2222222222222223,218.47671598314895,1
2020-09-02-170624,170624,5,1,4,331,1.8888888888888888,784.3189997339085,2
2020-09-03-170624,170624,5,0,6,336,1.7777777777777777,405.0268635519683,3
2020-09-04-170624,170624,10,0,68,346,1.3333333333333333,411.26495164523783,4
2020-09-05-170624,170624,9,0,27,355,1.6666666666666667,419.2667550579682,5
2020-09-06-170624,170624,10,0,20,365,1.4444444444444444,457.8750546903011,6
2020-09-07-170624,170624,11,0,10,376,1.3333333333333333,546.2783656753503,0
2020-09-08-170624,170624,2,0,5,378,0.7777777777777778,599.9435408443143,1
2020-09-09-170624,170624,2,0,9,380,1.1111111111111112,595.0472765971426,2
2020-09-10-170624,170624,9,0,8,389,1.8888888888888888,183.87534173673018,3
2020-09-11-170624,170624,19,0,2,408,1.5555555555555556,227.65952318211015,4
2020-09-12-170624,170624,6,0,0,414,1.3333333333333333,305.68374244057156,5
2020-09-13-170624,170624,12,0,6,426,0.3333333333333333,367.48301131736144,6
2020-09-14-170624,170624,8,0,4,434,2.555555555555556,443.2973173044462,0
2020-09-15-170624,170624,7,0,1,441,3.0,495.79238494511173,1
2020-09-16-170624,170624,4,0,12,445,2.2222222222222223,565.8589140409509,2
2020-09-17-170624,170624,6,0,6,451,0.7777777777777778,599.9907830061437,3
2020-09-18-170624,170624,68,0,3,519,1.7777777777777777,632.5761163601633,4
2020-09-19-170624,170624,27,0,1,546,1.2222222222222223,641.3715682414276,5
2020-09-20-170624,170624,20,1,3,566,1.2222222222222223,706.8937649233292,6
2020-09-21-170624,170624,10,0,5,576,2.0,763.7749072732961,0
2020-09-22-170624,170624,5,1,2,581,2.2222222222222223,786.6431201387229,1
2020-09-23-170624,170624,9,1,11,590,2.2222222222222223,718.1640421039558,2
2020-09-24-170624,170624,8,0,6,598,2.2222222222222223,716.1658371806303,3
2020-09-25-170624,170624,2,0,4,600,1.5555555555555556,705.1442464571546,4
2020-09-26-170624,170624,0,1,2,600,0.8888888888888888,567.7500815114162,5
2020-09-27-170624,170624,6,0,1,606,0.4444444444444444,533.7592134570376,6
2020-09-28-170624,170624,4,4,3,610,2.4444444444444446,450.27431213767693,0
2020-09-29-170624,170624,1,3,5,611,0.7777777777777778,406.87438177903107,1
2020-09-30-170624,170624,12,1,7,623,2.0,362.4855795688219,2
2020-10-01-170624,170624,6,0,10,629,1.4444444444444444,0.0,3
2020-10-02-170624,170624,3,0,12,632,1.6666666666666667,690.586430153412,4
2020-10-03-170624,170624,1,0,3,633,0.3333333333333333,776.7749997999189,5
2020-10-04-170624,170624,3,0,7,636,0.6666666666666666,696.9170174156899,6
2020-10-05-170624,170624,5,1,20,641,1.7777777777777777,566.0600144583393,0
2020-10-06-170624,170624,2,1,6,643,0.8888888888888888,515.0447732149122,1
2020-10-07-170624,170624,11,0,10,654,1.1111111111111112,482.8984091270567,2
2020-10-08-170624,170624,6,0,15,660,1.7777777777777777,457.06098412925235,3
2020-10-09-170624,170624,4,1,17,664,3.4444444444444446,502.6848259296603,4
2020-10-10-170624,170624,2,0,5,666,2.0,63.036894132422155,5
2020-10-11-170624,170624,1,0,2,667,1.8888888888888888,102.69064870570784,6
2020-10-12-170624,170624,3,0,21,670,1.5555555555555556,133.3175137211505,0
2020-10-13-170624,170624,5,0,10,675,2.4444444444444446,164.8252701144887,1
2020-10-14-170624,170624,7,0,5,682,1.4444444444444444,245.48058223609814,2
2020-10-15-170624,170624,10,0,14,692,5.0,312.91735574337633,3
2020-10-16-170624,170624,12,0,8,704,2.888888888888889,426.5010802380993,4
2020-10-17-170624,170624,3,0,5,707,1.6666666666666667,517.0043636238751,5
2020-10-18-170624,170624,7,0,2,714,1.3333333333333333,524.1488904372343,6
2020-10-19-170624,170624,20,0,6,734,4.222222222222221,549.2179774186498,0
2020-10-20-170624,170624,6,0,12,740,3.888888888888889,658.4659465025377,1
2020-10-21-170624,170624,10,0,21,750,4.222222222222221,683.4122519262551,2
2020-10-22-170624,170624,15,0,8,765,2.2222222222222223,701.9905472675794,3
2020-10-23-170624,170624,17,0,16,782,3.111111111111111,706.9318055565407,4
2020-10-24-170624,170624,5,0,2,787,0.6666666666666666,825.2280666439076,5
2020-10-25-170624,170624,2,1,5,789,2.4444444444444446,813.8979259311643,6
2020-10-26-170624,170624,21,0,20,810,2.2222222222222223,687.9542607749545,0
2020-10-27-170624,170624,10,1,12,820,3.333333333333333,809.598621810358,1
2020-10-28-170624,170624,5,1,6,825,1.5555555555555556,836.7448987497988,2
2020-10-29-170624,170624,14,0,13,839,1.4444444444444444,781.9300460519007,3
2020-10-30-170624,170624,8,3,13,847,4.0,614.0703795734812,4
2020-10-31-170624,170624,5,0,0,852,1.2222222222222223,680.7350222781918,5
2020-11-01-170624,170624,2,0,0,854,1.4444444444444444,460.7756199521218,6
2020-11-02-170624,170624,6,0,0,860,1.5555555555555556,515.283435758577,0
2020-11-03-170624,170624,12,1,0,872,2.555555555555556,456.2763473967609,1
2020-11-04-170624,170624,21,0,0,893,2.888888888888889,510.5291118031553,2
2020-11-05-170624,170624,8,2,0,901,3.2222222222222223,612.1919559184645,3
2020-11-06-170624,170624,16,1,0,917,2.7777777777777777,675.5820783523437,4
2020-11-07-170624,170624,2,3,0,919,0.4444444444444444,717.963039453628,5
2020-11-08-170624,170624,5,0,0,924,1.6666666666666667,659.861286602409,6
2020-11-09-170624,170624,20,0,0,944,2.555555555555556,654.048965247445,0
2020-11-10-170624,170624,12,1,0,956,2.1111111111111107,412.51264369740875,1
2020-11-11-170624,170624,6,1,0,962,2.555555555555556,468.35289764061383,2
2020-11-12-170624,170624,13,1,0,975,2.6666666666666665,479.66154166841784,3
2020-11-13-170624,170624,13,1,0,988,2.888888888888889,544.2100246877386,4
2020-03-01-170625,170625,0,0,5,0,0.0,0.0,6
2020-03-02-170625,170625,0,0,17,0,0.6666666666666666,56.07950494973906,0
2020-03-03-170625,170625,0,0,13,0,0.3333333333333333,271.0385670962803,1
2020-03-04-170625,170625,0,0,13,0,0.0,298.1690325021597,2
2020-03-05-170625,170625,0,0,15,0,0.3333333333333333,306.6397276868089,3
2020-03-06-170625,170625,0,0,25,0,1.0,261.84281424670286,4
2020-03-07-170625,170625,0,1,6,0,0.0,276.33898655377453,5
2020-03-08-170625,170625,0,0,7,0,0.3333333333333333,257.01663586827783,6
2020-03-09-170625,170625,0,0,16,0,0.3333333333333333,254.8553582024773,0
2020-03-10-170625,170625,0,0,25,0,0.3333333333333333,436.394543814277,1
2020-03-11-170625,170625,1,0,15,1,2.333333333333333,320.04517579784226,2
2020-03-12-170625,170625,4,0,28,5,0.6666666666666666,251.56629418185855,3
2020-03-13-170625,170625,1,0,23,6,3.0,168.00715972692464,4
2020-03-14-170625,170625,0,0,16,6,4.0,165.2835806849502,5
2020-03-15-170625,170625,5,0,8,11,11.666666666666664,154.75141664907053,6
2020-03-16-170625,170625,17,0,19,28,12.666666666666664,114.20170309132959,0
2020-03-17-170625,170625,13,0,13,41,18.0,180.62460648957142,1
2020-03-18-170625,170625,13,0,17,54,14.0,245.71989100339502,2
2020-03-19-170625,170625,15,0,13,69,21.0,283.70552287271937,3
2020-03-20-170625,170625,25,0,20,94,23.0,302.3719717799528,4
2020-03-21-170625,170625,6,0,6,100,8.333333333333334,336.41477604611913,5
2020-03-22-170625,170625,7,0,5,107,12.0,320.6497733191103,6
2020-03-23-170625,170625,16,0,13,123,41.66666666666666,301.74225165430283,0
2020-03-24-170625,170625,25,0,14,148,27.66666666666667,342.4509460921165,1
2020-03-25-170625,170625,15,1,2,163,39.0,368.9635576361334,2
2020-03-26-170625,170625,28,0,4,191,24.66666666666667,401.0353302649313,3
2020-03-27-170625,170625,23,0,4,214,33.0,478.59273512320635,4
2020-03-28-170625,170625,16,0,1,230,7.333333333333332,487.70321302471984,5
2020-03-29-170625,170625,8,0,2,238,9.666666666666666,481.304393793953,6
2020-03-30-170625,170625,19,0,9,257,17.333333333333332,377.4176099301219,0
2020-03-31-170625,170625,13,0,4,270,17.666666666666668,359.2504837389898,1
2020-04-01-170625,170625,17,0,6,287,21.33333333333333,48.27100767231047,2
2020-04-02-170625,170625,13,0,6,300,8.0,133.93290536737788,3
2020-04-03-170625,170625,20,0,12,320,15.333333333333336,73.50774819154051,4
2020-04-04-170625,170625,6,0,1,326,4.0,107.54712859909847,5
2020-04-05-170625,170625,5,0,0,331,3.333333333333333,113.64534352393872,6
2020-04-06-170625,170625,13,0,4,344,18.33333333333333,121.59944944157627,0
2020-04-07-170625,170625,14,0,7,358,19.33333333333333,147.14793188357422,1
2020-04-08-170625,170625,2,0,4,360,12.333333333333336,161.70542613706402,2
2020-04-09-170625,170625,4,0,0,364,6.333333333333332,174.3648487777832,3
2020-04-10-170625,170625,4,0,5,368,9.333333333333334,48.902008298934085,4
2020-04-11-170625,170625,1,0,1,369,3.333333333333333,69.19155933349813,5
2020-04-12-170625,170625,2,0,0,371,9.333333333333334,75.89823856084715,6
2020-04-13-170625,170625,9,0,2,380,10.0,85.23778826264201,0
2020-04-14-170625,170625,4,0,2,384,19.33333333333333,114.43276265976961,1
2020-04-15-170625,170625,6,0,1,390,6.333333333333332,137.8759853525562,2
2020-04-16-170625,170625,6,0,2,396,7.333333333333332,155.08467757403395,3
2020-04-17-170625,170625,12,0,4,408,9.666666666666666,140.96491806541295,4
2020-04-18-170625,170625,1,0,2,409,5.0,145.73543541872888,5
2020-04-19-170625,170625,0,1,0,409,1.0,150.30633105136548,6
2020-04-20-170625,170625,4,0,2,413,11.333333333333336,141.07218711303346,0
2020-04-21-170625,170625,7,0,4,420,13.666666666666664,149.48582557334038,1
2020-04-22-170625,170625,4,0,3,424,11.666666666666664,155.30028930722,2
2020-04-23-170625,170625,0,0,6,424,1.6666666666666667,146.50756178177605,3
2020-04-24-170625,170625,5,0,3,429,7.666666666666668,123.73342950202147,4
2020-04-25-170625,170625,1,0,1,430,3.0,124.58974285579838,5
2020-04-26-170625,170625,0,0,0,430,0.3333333333333333,127.23838844099109,6
2020-04-27-170625,170625,2,0,10,432,6.666666666666668,103.17976068359869,0
2020-04-28-170625,170625,2,1,7,434,5.666666666666668,93.42957874962704,1
2020-04-29-170625,170625,1,0,5,435,8.333333333333334,81.20293802031128,2
2020-04-30-170625,170625,2,0,6,437,6.333333333333332,113.22623842313351,3
2020-05-01-170625,170625,4,0,5,441,4.666666666666667,161.1837160671322,4
2020-05-02-170625,170625,2,0,0,443,1.6666666666666667,65.49740599680686,5
2020-05-03-170625,170625,0,0,0,443,1.0,42.84031466863155,6
2020-05-04-170625,170625,2,0,1,445,9.0,36.68134744848503,0
2020-05-05-170625,170625,4,0,1,449,4.666666666666667,49.53573533991002,1
2020-05-06-170625,170625,3,0,4,452,6.666666666666668,55.104291666511,2
2020-05-07-170625,170625,6,0,0,458,4.666666666666667,71.5561532809215,3
2020-05-08-170625,170625,3,0,3,461,10.0,76.13028430183084,4
2020-05-09-170625,170625,1,0,0,462,2.6666666666666665,103.24734498113818,5
2020-05-10-170625,170625,0,0,0,462,1.0,176.28564503940174,6
2020-05-11-170625,170625,10,0,2,472,9.0,162.5723682207251,0
2020-05-12-170625,170625,7,0,4,479,13.333333333333336,171.99366391646174,1
2020-05-13-170625,170625,5,0,3,484,8.0,145.12932085594306,2
2020-05-14-170625,170625,6,0,2,490,2.6666666666666665,131.86068945667034,3
2020-05-15-170625,170625,5,0,2,495,6.666666666666668,113.15141405088268,4
2020-05-16-170625,170625,0,0,1,495,0.6666666666666666,114.28026114843718,5
2020-05-17-170625,170625,0,0,1,495,0.0,109.84181075462298,6
2020-05-18-170625,170625,1,0,1,496,3.6666666666666665,109.84250584040257,0
2020-05-19-170625,170625,1,0,2,497,3.0,99.8856162115692,1
2020-05-20-170625,170625,4,0,0,501,3.6666666666666665,73.46847183237199,2
2020-05-21-170625,170625,0,0,2,501,5.0,74.89150759815304,3
2020-05-22-170625,170625,3,0,0,504,4.0,66.17658549844569,4
2020-05-23-170625,170625,0,0,0,504,0.0,78.45139802950968,5
2020-05-24-170625,170625,0,0,0,504,0.0,78.83832696258588,6
2020-05-25-170625,170625,2,0,3,506,4.666666666666667,66.2317329179085,0
2020-05-26-170625,170625,4,0,0,510,2.333333333333333,65.74513967045114,1
2020-05-27-170625,170625,3,0,0,513,1.3333333333333333,65.80577625149851,2
2020-05-28-170625,170625,2,0,4,515,2.0,62.92970401394264,3
2020-05-29-170625,170625,2,0,0,517,3.333333333333333,57.63360628426298,4
2020-05-30-170625,170625,1,0,0,518,0.0,59.46698727462049,5
2020-05-31-170625,170625,1,0,0,519,0.0,60.50385214749615,6
2020-06-01-170625,170625,1,0,1,520,4.0,130.1945154145314,0
2020-06-02-170625,170625,2,0,12,522,2.0,36.534748538623994,1
2020-06-03-170625,170625,0,0,5,522,2.333333333333333,26.811256412377784,2
2020-06-04-170625,170625,2,0,2,524,1.3333333333333333,29.021569484561844,3
2020-06-05-170625,170625,0,0,2,524,1.3333333333333333,38.81023270354228,4
2020-06-06-170625,170625,0,7,0,524,0.0,42.86577303877184,5
2020-06-07-170625,170625,0,0,0,524,0.0,42.99624118013974,6
2020-06-08-170625,170625,3,0,1,527,1.3333333333333333,43.583378847838176,0
2020-06-09-170625,170625,0,0,3,527,1.0,46.176568912234764,1
2020-06-10-170625,170625,0,0,0,527,1.6666666666666667,150.66948205405902,2
2020-06-11-170625,170625,4,0,1,531,2.6666666666666665,131.9769662340657,3
2020-06-12-170625,170625,0,0,4,531,0.3333333333333333,125.7508828123961,4
2020-06-13-170625,170625,0,0,0,531,0.0,93.6266735701386,5
2020-06-14-170625,170625,0,1,0,531,0.0,72.05390917022964,6
2020-06-15-170625,170625,1,0,3,532,0.6666666666666666,43.03988486705688,0
2020-06-16-170625,170625,12,2,0,544,1.3333333333333333,43.45286739824222,1
2020-06-17-170625,170625,5,0,2,549,1.3333333333333333,35.35584781245289,2
2020-06-18-170625,170625,2,0,0,551,1.3333333333333333,34.03877337406526,3
2020-06-19-170625,170625,2,0,2,553,2.0,30.877481603858335,4
2020-06-20-170625,170625,0,0,0,553,0.0,50.00311441776457,5
2020-06-21-170625,170625,0,0,0,553,0.0,50.31775521722145,6
2020-06-22-170625,170625,1,0,0,554,2.0,43.9555310906251,0
2020-06-23-170625,170625,3,0,2,557,1.3333333333333333,45.45487471586865,1
2020-06-24-170625,170625,0,0,0,557,0.3333333333333333,45.58830444538298,2
2020-06-25-170625,170625,1,1,1,558,0.3333333333333333,40.87845618178675,3
2020-06-26-170625,170625,4,0,0,562,3.0,35.14389788345774,4
2020-06-27-170625,170625,0,0,0,562,0.3333333333333333,32.41395000238897,5
2020-06-28-170625,170625,0,0,0,562,0.0,32.81542013127534,6
2020-06-29-170625,170625,3,0,0,565,1.3333333333333333,32.711779692961656,0
2020-06-30-170625,170625,0,0,1,565,0.0,33.132851529480796,1
2020-07-01-170625,170625,2,0,2,567,1.0,49.412260213653994,2
2020-07-02-170625,170625,0,0,2,567,0.0,16.411765560704456,3
2020-07-03-170625,170625,2,0,0,569,2.0,31.762121413920752,4
2020-07-04-170625,170625,0,0,0,569,0.0,41.4017676923191,5
2020-07-05-170625,170625,0,0,0,569,0.0,39.8321362933106,6
2020-07-06-170625,170625,0,0,2,569,0.0,33.20287819585691,0
2020-07-07-170625,170625,2,0,1,571,0.0,30.954943903721706,1
2020-07-08-170625,170625,0,0,1,571,0.0,27.455304655856054,2
2020-07-09-170625,170625,1,0,0,572,0.0,24.583261766218243,3
2020-07-10-170625,170625,0,0,0,572,0.3333333333333333,51.73022173248419,4
2020-07-11-170625,170625,0,0,1,572,0.0,39.4392569846952,5
2020-07-12-170625,170625,0,0,0,572,0.0,27.21567859058249,6
2020-07-13-170625,170625,0,1,0,572,0.3333333333333333,27.663818909739305,0
2020-07-14-170625,170625,1,0,0,573,0.0,30.48253728190653,1
2020-07-15-170625,170625,2,0,0,575,0.3333333333333333,25.510461794793642,2
2020-07-16-170625,170625,2,0,3,577,0.6666666666666666,18.429805830810032,3
2020-07-17-170625,170625,0,0,6,577,0.0,16.10553102278709,4
2020-07-18-170625,170625,0,0,1,577,0.0,16.33181538068246,5
2020-07-19-170625,170625,0,0,0,577,0.0,16.28485194911297,6
2020-07-20-170625,170625,2,0,2,579,1.3333333333333333,13.590489291158256,0
2020-07-21-170625,170625,1,0,1,580,1.0,15.419700634563432,1
2020-07-22-170625,170625,1,0,1,581,1.3333333333333333,25.21784053326097,2
2020-07-23-170625,170625,0,0,3,581,1.0,23.49713594816341,3
2020-07-24-170625,170625,0,0,2,581,0.6666666666666666,27.5129479107781,4
2020-07-25-170625,170625,1,0,1,582,0.0,32.521111928591985,5
2020-07-26-170625,170625,0,0,2,582,0.0,32.740889224386585,6
2020-07-27-170625,170625,0,0,4,582,0.3333333333333333,32.724525372807356,0
2020-07-28-170625,170625,0,0,4,582,1.0,34.06785184909631,1
2020-07-29-170625,170625,0,0,6,582,0.6666666666666666,26.137623237655248,2
2020-07-30-170625,170625,3,0,9,585,0.3333333333333333,27.24192269595176,3
2020-07-31-170625,170625,6,0,4,591,1.6666666666666667,31.30549686968726,4
2020-08-01-170625,170625,1,0,2,592,0.6666666666666666,17.198654130696152,5
2020-08-02-170625,170625,0,0,2,592,2.0,136.61041777925323,6
2020-08-03-170625,170625,2,0,3,594,3.0,211.97621265120193,0
2020-08-04-170625,170625,1,0,9,595,2.0,195.44832552799807,1
2020-08-05-170625,170625,1,0,9,596,3.333333333333333,161.72154727051776,2
2020-08-06-170625,170625,3,0,8,599,1.6666666666666667,151.66092472457285,3
2020-08-07-170625,170625,2,0,2,601,2.333333333333333,118.83729039075737,4
2020-08-08-170625,170625,1,0,2,602,1.6666666666666667,126.1399557000399,5
2020-08-09-170625,170625,2,0,1,604,0.0,122.84449260295953,6
2020-08-10-170625,170625,4,0,9,608,4.333333333333333,12.078846202945902,0
2020-08-11-170625,170625,4,0,3,612,2.333333333333333,28.429000300847044,1
2020-08-12-170625,170625,6,0,7,618,3.6666666666666665,42.07686609159107,2
2020-08-13-170625,170625,9,0,10,627,2.333333333333333,59.01733802774546,3
2020-08-14-170625,170625,4,1,5,631,2.0,77.05210338443405,4
2020-08-15-170625,170625,2,0,1,633,2.0,95.06532357725116,5
2020-08-16-170625,170625,2,0,4,635,1.6666666666666667,100.90994222434483,6
2020-08-17-170625,170625,3,0,3,638,3.333333333333333,105.21667353963853,0
2020-08-18-170625,170625,9,0,5,647,3.0,115.71356791559896,1
2020-08-19-170625,170625,9,0,3,656,2.6666666666666665,117.00323023557277,2
2020-08-20-170625,170625,8,0,7,664,5.333333333333333,106.44190859809922,3
2020-08-21-170625,170625,2,0,9,666,2.0,114.04471091007896,4
2020-08-22-170625,170625,2,0,1,668,0.6666666666666666,124.0716278194696,5
2020-08-23-170625,170625,1,0,0,669,4.333333333333333,123.33140691080959,6
2020-08-24-170625,170625,9,1,10,678,9.0,104.13716158377,0
2020-08-25-170625,170625,3,0,2,681,7.0,122.72912469613921,1
2020-08-26-170625,170625,7,0,15,688,7.333333333333332,132.09526651689092,2
2020-08-27-170625,170625,10,0,11,698,3.333333333333333,167.64297738473846,3
2020-08-28-170625,170625,5,1,15,703,6.666666666666668,167.38132499485894,4
2020-08-29-170625,170625,1,0,0,704,2.6666666666666665,190.21928053171862,5
2020-08-30-170625,170625,4,0,2,708,3.0,201.68342771988557,6
2020-08-31-170625,170625,3,0,27,711,8.0,178.17704360444785,0
2020-09-01-170625,170625,5,0,10,716,2.6666666666666665,116.35112886767499,1
2020-09-02-170625,170625,3,0,9,719,2.0,184.98996905019015,2
2020-09-03-170625,170625,7,0,16,726,6.0,185.47282004441522,3
2020-09-04-170625,170625,9,0,31,735,10.666666666666666,175.80105909074152,4
2020-09-05-170625,170625,1,0,3,736,2.0,189.5816631816241,5
2020-09-06-170625,170625,0,0,1,736,1.3333333333333333,196.9032463505134,6
2020-09-07-170625,170625,10,0,26,746,4.333333333333333,196.36049704515403,0
2020-09-08-170625,170625,2,0,31,748,2.333333333333333,206.9653806047583,1
2020-09-09-170625,170625,15,0,26,763,3.0,185.55439470436755,2
2020-09-10-170625,170625,11,0,22,774,4.0,104.37853526413033,3
2020-09-11-170625,170625,15,1,17,789,9.0,124.5610324328959,4
2020-09-12-170625,170625,0,0,5,789,2.333333333333333,161.12707459017457,5
2020-09-13-170625,170625,2,0,3,791,0.3333333333333333,161.48402274089796,6
2020-09-14-170625,170625,27,0,8,818,9.0,152.69632600368482,0
2020-09-15-170625,170625,10,0,7,828,7.666666666666668,192.39611250104664,1
2020-09-16-170625,170625,9,0,15,837,6.333333333333332,227.08632170778625,2
2020-09-17-170625,170625,16,0,13,853,7.666666666666668,226.25510654758,3
2020-09-18-170625,170625,31,0,15,884,11.666666666666664,227.19728417597662,4
2020-09-19-170625,170625,3,1,1,887,4.333333333333333,213.67188845073025,5
2020-09-20-170625,170625,1,0,0,888,3.0,223.33304637565766,6
2020-09-21-170625,170625,26,0,11,914,10.333333333333334,187.83790107066375,0
2020-09-22-170625,170625,31,1,5,945,14.666666666666664,203.8084701954978,1
2020-09-23-170625,170625,26,0,7,971,11.666666666666664,225.2214751417141,2
2020-09-24-170625,170625,22,1,10,993,7.666666666666668,232.68081634307697,3
2020-09-25-170625,170625,17,0,12,1010,9.666666666666666,226.64795333701838,4
2020-09-26-170625,170625,5,0,4,1015,3.0,247.58353034464398,5
2020-09-27-170625,170625,3,0,3,1018,1.6666666666666667,239.05895657115042,6
2020-09-28-170625,170625,8,0,3,1026,5.0,240.1907692825296,0
2020-09-29-170625,170625,7,1,6,1033,5.333333333333333,229.91337518705333,1
2020-09-30-170625,170625,15,0,9,1048,6.666666666666668,214.67260292458712,2
2020-10-01-170625,170625,13,0,7,1061,6.666666666666668,0.0,3
2020-10-02-170625,170625,15,0,9,1076,6.0,494.910863390689,4
2020-10-03-170625,170625,1,0,1,1077,5.0,607.9027675505814,5
2020-10-04-170625,170625,0,0,10,1077,4.333333333333333,538.0098777154519,6
2020-10-05-170625,170625,11,0,15,1088,25.0,449.85227079148694,0
2020-10-06-170625,170625,5,0,10,1093,8.666666666666666,399.334222699008,1
2020-10-07-170625,170625,7,1,13,1100,14.666666666666664,345.0507833730517,2
2020-10-08-170625,170625,10,0,7,1110,10.333333333333334,336.1091356161338,3
2020-10-09-170625,170625,12,0,10,1122,12.666666666666664,376.96797785058516,4
2020-10-10-170625,170625,4,0,2,1126,6.666666666666668,32.15989520124537,5
2020-10-11-170625,170625,3,0,3,1129,7.333333333333332,67.89277521700906,6
2020-10-12-170625,170625,3,0,14,1132,4.666666666666667,98.04781562981668,0
2020-10-13-170625,170625,6,0,11,1138,13.333333333333336,122.40790401266165,1
2020-10-14-170625,170625,9,0,2,1147,10.0,201.5338168063219,2
2020-10-15-170625,170625,7,0,6,1154,13.0,271.2158943760635,3
2020-10-16-170625,170625,9,0,14,1163,18.666666666666668,342.5383195326599,4
2020-10-17-170625,170625,1,0,0,1164,5.0,418.5635529023888,5
2020-10-18-170625,170625,10,0,1,1174,12.0,408.87492671025564,6
2020-10-19-170625,170625,15,0,0,1189,21.0,422.6010765375933,0
2020-10-20-170625,170625,10,0,12,1199,24.33333333333333,459.18041879973157,1
2020-10-21-170625,170625,13,0,21,1212,22.66666666666667,484.613531587138,2
2020-10-22-170625,170625,7,0,3,1219,25.0,515.9891392988952,3
2020-10-23-170625,170625,10,0,8,1229,33.0,526.4418159173499,4
2020-10-24-170625,170625,2,0,7,1231,6.0,613.2514817527783,5
2020-10-25-170625,170625,3,1,0,1234,18.0,596.9359902686282,6
2020-10-26-170625,170625,14,0,18,1248,19.666666666666668,552.0259697273492,0
2020-10-27-170625,170625,11,0,6,1259,24.33333333333333,635.1925615364145,1
2020-10-28-170625,170625,2,1,6,1261,18.33333333333333,650.50342970723,2
2020-10-29-170625,170625,6,0,9,1267,15.666666666666664,645.644807259543,3
2020-10-30-170625,170625,14,1,7,1281,24.33333333333333,499.3051356422069,4
2020-10-31-170625,170625,0,0,0,1281,5.333333333333333,566.5495910495681,5
2020-11-01-170625,170625,1,0,0,1282,5.666666666666668,331.5408704014088,6
2020-11-02-170625,170625,0,1,0,1282,3.0,173.16496966722582,0
2020-11-03-170625,170625,12,1,0,1294,17.333333333333332,160.30235508438471,1
2020-11-04-170625,170625,21,0,0,1315,14.666666666666664,233.6153898613406,2
2020-11-05-170625,170625,3,0,0,1318,12.333333333333336,290.22059759680207,3
2020-11-06-170625,170625,8,1,0,1326,8.666666666666666,322.0406838648424,4
2020-11-07-170625,170625,7,0,0,1333,2.0,357.7184113530575,5
2020-11-08-170625,170625,0,0,0,1333,4.666666666666667,346.22290159241913,6
2020-11-09-170625,170625,18,0,0,1351,13.666666666666664,352.8718130654619,0
2020-11-10-170625,170625,6,0,0,1357,7.0,336.69629447415707,1
2020-11-11-170625,170625,6,1,0,1363,13.666666666666664,367.47229907020517,2
2020-11-12-170625,170625,9,1,0,1372,7.666666666666668,360.7614126327852,3
2020-11-13-170625,170625,7,0,0,1379,8.0,366.84863359728547,4
2020-03-01-170626,170626,0,0,0,0,0.0,0.0,6
2020-03-02-170626,170626,0,0,0,0,0.0,5.816100819948255,0
2020-03-03-170626,170626,0,0,0,0,0.0,23.238879945726076,1
2020-03-04-170626,170626,0,0,0,0,0.0,23.444500949142487,2
2020-03-05-170626,170626,0,2,0,0,0.0,25.67925949444648,3
2020-03-06-170626,170626,0,0,0,0,0.0,24.93710996420478,4
2020-03-07-170626,170626,0,0,0,0,0.0,23.450866537166434,5
2020-03-08-170626,170626,0,0,0,0,0.0,22.18719760191654,6
2020-03-09-170626,170626,0,0,1,0,0.0,22.2210470003443,0
2020-03-10-170626,170626,0,0,0,0,0.0,58.22627334482427,1
2020-03-11-170626,170626,0,0,0,0,0.0,46.82685897991532,2
2020-03-12-170626,170626,0,0,0,0,0.0,42.28656861192947,3
2020-03-13-170626,170626,0,0,0,0,0.0,28.046726869273403,4
2020-03-14-170626,170626,0,0,0,0,0.5,19.86682898474826,5
2020-03-15-170626,170626,0,0,0,0,2.0,13.595673933326545,6
2020-03-16-170626,170626,0,0,0,0,10.0,4.164012804051692,0
2020-03-17-170626,170626,0,0,1,0,6.0,15.605335524790233,1
2020-03-18-170626,170626,0,0,0,0,8.0,22.498007766719596,2
2020-03-19-170626,170626,0,1,0,0,7.0,28.98100313051125,3
2020-03-20-170626,170626,0,0,0,0,10.0,33.34765347659818,4
2020-03-21-170626,170626,0,0,0,0,2.5,36.94008417272635,5
2020-03-22-170626,170626,0,0,0,0,2.0,33.556263501009475,6
2020-03-23-170626,170626,1,0,4,1,12.5,27.199204273171915,0
2020-03-24-170626,170626,0,0,0,1,11.5,33.21705506218801,1
2020-03-25-170626,170626,0,0,0,1,12.5,34.03397657749011,2
2020-03-26-170626,170626,0,0,0,1,8.0,36.751452130207056,3
2020-03-27-170626,170626,0,0,1,1,6.5,42.23092444941032,4
2020-03-28-170626,170626,0,0,0,1,6.0,40.631829318742476,5
2020-03-29-170626,170626,0,2,0,1,3.5,42.10297297426948,6
2020-03-30-170626,170626,0,0,0,1,7.0,32.52640417137743,0
2020-03-31-170626,170626,1,0,0,2,6.0,29.810964183488522,1
2020-04-01-170626,170626,0,0,0,2,3.5,5.5257551602308155,2
2020-04-02-170626,170626,0,0,1,2,3.5,21.35629997296502,3
2020-04-03-170626,170626,0,0,0,2,6.5,10.134153333768795,4
2020-04-04-170626,170626,0,0,1,2,1.5,14.902050864515113,5
2020-04-05-170626,170626,0,0,0,2,2.5,15.596727669503872,6
2020-04-06-170626,170626,4,0,0,6,7.0,16.57280618173684,0
2020-04-07-170626,170626,0,1,0,6,8.5,24.99042475370713,1
2020-04-08-170626,170626,0,1,0,6,4.0,28.92286655835543,2
2020-04-09-170626,170626,0,0,0,6,1.5,29.88560572565089,3
2020-04-10-170626,170626,1,0,0,7,2.0,2.8128949746935454,4
2020-04-11-170626,170626,0,0,0,7,4.5,5.086663734319591,5
2020-04-12-170626,170626,0,0,0,7,2.5,7.500446097684418,6
2020-04-13-170626,170626,0,0,0,7,9.5,9.11615847224385,0
2020-04-14-170626,170626,0,0,0,7,1.0,15.074447279682747,1
2020-04-15-170626,170626,0,0,0,7,5.0,15.937787977669526,2
2020-04-16-170626,170626,1,0,0,8,1.0,18.92570938675574,3
2020-04-17-170626,170626,0,0,0,8,2.0,19.64488599163087,4
2020-04-18-170626,170626,1,0,0,9,3.5,19.222435251145228,5
2020-04-19-170626,170626,0,0,0,9,3.0,20.97716352154664,6
2020-04-20-170626,170626,0,0,1,9,3.5,19.977612639317787,0
2020-04-21-170626,170626,0,0,0,9,2.5,23.49955299146685,1
2020-04-22-170626,170626,0,0,1,9,2.0,22.19840852683334,2
2020-04-23-170626,170626,0,0,1,9,3.0,21.48510236986834,3
2020-04-24-170626,170626,0,0,0,9,0.5,21.60894202044318,4
2020-04-25-170626,170626,0,0,0,9,1.0,18.059102980928362,5
2020-04-26-170626,170626,0,0,0,9,0.5,14.637643673804169,6
2020-04-27-170626,170626,0,0,1,9,4.0,11.554395160840436,0
2020-04-28-170626,170626,0,0,0,9,1.5,11.031973049050013,1
2020-04-29-170626,170626,0,0,1,9,1.5,10.97618330839296,2
2020-04-30-170626,170626,0,0,0,9,1.5,16.435009461128672,3
2020-05-01-170626,170626,0,0,0,9,1.0,27.388847553666206,4
2020-05-02-170626,170626,0,0,1,9,0.5,24.235632146637005,5
2020-05-03-170626,170626,0,0,0,9,0.5,8.813587039197747,6
2020-05-04-170626,170626,1,0,1,10,5.5,7.393243596189408,0
2020-05-05-170626,170626,0,0,0,10,3.5,12.778759052335177,1
2020-05-06-170626,170626,1,0,0,11,3.0,16.706008877133776,2
2020-05-07-170626,170626,1,0,0,12,1.5,18.00063281574538,3
2020-05-08-170626,170626,0,0,0,12,1.0,21.28318890396652,4
2020-05-09-170626,170626,0,0,0,12,4.0,22.32481174681718,5
2020-05-10-170626,170626,0,1,0,12,1.0,33.307096733565075,6
2020-05-11-170626,170626,1,0,0,13,2.0,32.14017964777799,0
2020-05-12-170626,170626,0,8,0,13,1.5,33.82971207080516,1
2020-05-13-170626,170626,1,0,0,14,2.0,20.84461221229352,2
2020-05-14-170626,170626,0,0,1,14,0.0,18.759245899307377,3
2020-05-15-170626,170626,0,2,0,14,2.0,15.49801738095626,4
2020-05-16-170626,170626,1,0,0,15,0.5,18.158938686120955,5
2020-05-17-170626,170626,0,0,0,15,0.5,20.12249953857982,6
2020-05-18-170626,170626,1,0,0,16,9.5,20.415207706733625,0
2020-05-19-170626,170626,0,1,0,16,1.0,31.215242196856963,1
2020-05-20-170626,170626,0,0,0,16,0.5,25.239951561791393,2
2020-05-21-170626,170626,0,0,0,16,1.5,25.350525378005738,3
2020-05-22-170626,170626,0,0,0,16,2.0,22.20424171770408,4
2020-05-23-170626,170626,0,0,0,16,0.5,21.58497304702878,5
2020-05-24-170626,170626,0,0,0,16,0.5,21.997834611919604,6
2020-05-25-170626,170626,0,0,0,16,2.0,6.548436331547641,0
2020-05-26-170626,170626,0,0,0,16,0.0,7.4467548215547605,1
2020-05-27-170626,170626,0,0,0,16,0.0,7.351634359238875,2
2020-05-28-170626,170626,1,1,0,17,2.0,7.685833298899213,3
2020-05-29-170626,170626,0,0,0,17,1.5,13.161310982719584,4
2020-05-30-170626,170626,0,0,0,17,0.5,13.346682636598345,5
2020-05-31-170626,170626,0,0,0,17,0.0,13.038521656254709,6
2020-06-01-170626,170626,0,0,0,17,1.0,32.778440245059954,0
2020-06-02-170626,170626,0,0,0,17,0.5,4.114628510728902,1
2020-06-03-170626,170626,0,0,0,17,0.0,4.070593627413977,2
2020-06-04-170626,170626,0,0,0,17,2.5,3.2517302330858002,3
2020-06-05-170626,170626,0,0,0,17,1.0,5.129885927278181,4
2020-06-06-170626,170626,0,0,0,17,0.0,5.95395579417929,5
2020-06-07-170626,170626,0,0,0,17,0.0,6.057975608685569,6
2020-06-08-170626,170626,0,0,0,17,0.5,4.969963709227595,0
2020-06-09-170626,170626,0,0,0,17,0.0,5.582907725612607,1
2020-06-10-170626,170626,0,0,0,17,0.0,35.81095753982491,2
2020-06-11-170626,170626,0,0,0,17,1.5,27.569665758162394,3
2020-06-12-170626,170626,0,0,0,17,0.0,23.58004696171192,4
2020-06-13-170626,170626,0,0,0,17,0.5,15.121399697566513,5
2020-06-14-170626,170626,0,1,0,17,0.0,10.841561560812494,6
2020-06-15-170626,170626,0,0,0,17,0.0,9.360424004301567,0
2020-06-16-170626,170626,0,0,0,17,0.0,4.382087786124055,1
2020-06-17-170626,170626,0,0,0,17,0.0,3.014916176119956,2
2020-06-18-170626,170626,0,0,0,17,0.0,3.023190171720196,3
2020-06-19-170626,170626,0,1,0,17,1.5,1.0864912181286632,4
2020-06-20-170626,170626,0,0,0,17,0.0,4.697455776544856,5
2020-06-21-170626,170626,0,0,0,17,0.0,4.7564484014494415,6
2020-06-22-170626,170626,0,0,0,17,0.0,4.6660763369372145,0
2020-06-23-170626,170626,0,0,0,17,0.5,4.700383827914521,1
2020-06-24-170626,170626,0,0,0,17,0.0,5.387850366752357,2
2020-06-25-170626,170626,0,0,0,17,0.5,5.442111304881252,3
2020-06-26-170626,170626,0,1,0,17,0.5,3.477577453523108,4
2020-06-27-170626,170626,0,0,0,17,0.0,3.4153306135296093,5
2020-06-28-170626,170626,0,0,0,17,1.0,3.4799336052099687,6
2020-06-29-170626,170626,0,0,0,17,0.0,4.85145076763106,0
2020-06-30-170626,170626,0,0,0,17,0.0,4.168258210341841,1
2020-07-01-170626,170626,0,0,0,17,0.0,6.458407786153037,2
2020-07-02-170626,170626,0,0,0,17,0.5,3.902898815206692,3
2020-07-03-170626,170626,0,0,0,17,0.0,6.343454479138142,4
2020-07-04-170626,170626,0,0,0,17,0.0,1.520255217839071,5
2020-07-05-170626,170626,0,0,0,17,0.5,1.5211580501158877,6
2020-07-06-170626,170626,0,0,0,17,0.0,2.3874053024919055,0
2020-07-07-170626,170626,0,0,0,17,0.5,1.6423688494038302,1
2020-07-08-170626,170626,0,0,0,17,0.0,2.2669451713358977,2
2020-07-09-170626,170626,0,2,1,17,0.0,2.1792148097473256,3
2020-07-10-170626,170626,0,0,0,17,0.0,6.900691832118056,4
2020-07-11-170626,170626,0,0,0,17,0.0,3.0617041546806316,5
2020-07-12-170626,170626,0,0,0,17,0.0,1.2048399282039024,6
2020-07-13-170626,170626,0,1,0,17,0.5,1.2692305584473862,0
2020-07-14-170626,170626,0,0,0,17,0.5,2.0167479332539457,1
2020-07-15-170626,170626,0,0,0,17,0.0,3.2131776733955943,2
2020-07-16-170626,170626,0,0,1,17,0.5,3.0700107042817857,3
2020-07-17-170626,170626,0,0,0,17,0.0,3.843393518380024,4
2020-07-18-170626,170626,0,0,0,17,0.0,3.9496795667747095,5
2020-07-19-170626,170626,0,0,0,17,0.0,4.008711981595956,6
2020-07-20-170626,170626,0,0,0,17,0.0,3.984071205424369,0
2020-07-21-170626,170626,0,0,0,17,0.5,1.9161897903030294,1
2020-07-22-170626,170626,0,0,0,17,0.0,2.8299530338084318,2
2020-07-23-170626,170626,1,0,1,18,0.0,1.9173787487851532,3
2020-07-24-170626,170626,0,0,1,18,1.0,5.272508347530067,4
2020-07-25-170626,170626,0,0,0,18,0.5,6.8112491418093475,5
2020-07-26-170626,170626,0,0,0,18,0.0,7.581822537018255,6
2020-07-27-170626,170626,0,0,0,18,0.0,6.878217918145108,0
2020-07-28-170626,170626,0,0,0,18,0.5,6.885023245814056,1
2020-07-29-170626,170626,0,0,0,18,0.5,6.751291090173344,2
2020-07-30-170626,170626,1,0,0,19,1.0,3.648800495101086,3
2020-07-31-170626,170626,0,0,0,19,0.0,2.218628171998594,4
2020-08-01-170626,170626,0,0,4,19,0.5,2.293348512206446,5
2020-08-02-170626,170626,0,0,1,19,0.0,61.81310955803967,6
2020-08-03-170626,170626,0,0,0,19,1.0,31.39136839339548,0
2020-08-04-170626,170626,0,1,0,19,0.0,28.22132714034393,1
2020-08-05-170626,170626,0,0,0,19,0.0,23.192840212045553,2
2020-08-06-170626,170626,1,0,0,20,0.0,13.502783909106812,3
2020-08-07-170626,170626,1,0,0,21,1.0,13.438692622528835,4
2020-08-08-170626,170626,0,0,0,21,0.5,19.86070080241975,5
2020-08-09-170626,170626,0,0,0,21,0.0,19.394141128256628,6
2020-08-10-170626,170626,0,0,0,21,0.5,3.669228325303958,0
2020-08-11-170626,170626,0,0,0,21,6.0,6.982671390873616,1
2020-08-12-170626,170626,0,0,0,21,1.0,15.424549599446797,2
2020-08-13-170626,170626,0,0,1,21,2.0,20.106444828496212,3
2020-08-14-170626,170626,0,0,1,21,4.0,31.67784909964472,4
2020-08-15-170626,170626,4,0,0,25,1.0,39.767541816049736,5
2020-08-16-170626,170626,1,0,0,26,0.0,55.0456188325136,6
2020-08-17-170626,170626,0,0,0,26,2.5,53.28021419281973,0
2020-08-18-170626,170626,0,1,1,26,3.5,57.60619643405672,1
2020-08-19-170626,170626,0,0,0,26,5.5,57.08853889795054,2
2020-08-20-170626,170626,0,0,1,26,4.5,55.33900151111124,3
2020-08-21-170626,170626,0,0,0,26,3.0,58.47755882959642,4
2020-08-22-170626,170626,0,0,0,26,1.0,46.41962434376284,5
2020-08-23-170626,170626,0,0,0,26,0.0,46.78892475143293,6
2020-08-24-170626,170626,0,0,2,26,3.0,40.32739638648456,0
2020-08-25-170626,170626,0,0,1,26,0.5,36.19681704111073,1
2020-08-26-170626,170626,0,0,0,26,2.0,26.186824387387613,2
2020-08-27-170626,170626,1,0,0,27,4.0,31.861055625465262,3
2020-08-28-170626,170626,1,0,0,28,0.5,30.97890853922648,4
2020-08-29-170626,170626,0,0,0,28,0.5,30.641891620546428,5
2020-08-30-170626,170626,0,0,0,28,1.5,31.43045018071424,6
2020-08-31-170626,170626,0,0,1,28,1.0,27.92509708072153,0
2020-09-01-170626,170626,1,0,0,29,2.5,14.208365094037465,1
2020-09-02-170626,170626,0,0,1,29,2.0,30.381292090651602,2
2020-09-03-170626,170626,1,0,0,30,1.0,17.697603205028557,3
2020-09-04-170626,170626,0,0,0,30,3.5,21.406571792299644,4
2020-09-05-170626,170626,0,0,0,30,0.0,23.531009395730724,5
2020-09-06-170626,170626,0,0,0,30,0.0,20.873346803419913,6
2020-09-07-170626,170626,2,0,0,32,0.0,23.99439025640643,0
2020-09-08-170626,170626,1,0,0,33,0.0,26.83652542189116,1
2020-09-09-170626,170626,0,0,0,33,2.0,24.496883365914247,2
2020-09-10-170626,170626,0,0,0,33,6.5,17.54624162072038,3
2020-09-11-170626,170626,0,0,0,33,1.0,28.060956848833108,4
2020-09-12-170626,170626,0,0,0,33,0.0,28.54689119808641,5
2020-09-13-170626,170626,0,0,0,33,1.0,26.563491456628412,6
2020-09-14-170626,170626,1,0,0,34,5.5,21.13045292600451,0
2020-09-15-170626,170626,0,0,1,34,2.5,26.358469016412712,1
2020-09-16-170626,170626,1,0,0,35,0.0,30.35870124614773,2
2020-09-17-170626,170626,0,0,0,35,3.0,25.554144212329057,3
2020-09-18-170626,170626,0,0,0,35,0.5,20.512988393812833,4
2020-09-19-170626,170626,0,0,0,35,2.0,22.670841279400815,5
2020-09-20-170626,170626,0,0,0,35,1.0,31.68571951103065,6
2020-09-21-170626,170626,0,0,2,35,1.5,26.419051279806894,0
2020-09-22-170626,170626,0,0,0,35,1.5,24.62730142846664,1
2020-09-23-170626,170626,0,0,0,35,0.5,24.290296031181718,2
2020-09-24-170626,170626,0,0,0,35,2.0,19.17460491729327,3
2020-09-25-170626,170626,0,0,0,35,0.5,19.824859386043865,4
2020-09-26-170626,170626,0,0,0,35,2.0,16.2587912091862,5
2020-09-27-170626,170626,0,0,0,35,0.0,14.157924007409495,6
2020-09-28-170626,170626,0,0,0,35,1.0,13.55584056764903,0
2020-09-29-170626,170626,1,0,0,36,1.5,12.778949388061633,1
2020-09-30-170626,170626,0,0,0,36,2.0,19.65980189217185,2
2020-10-01-170626,170626,0,0,0,36,3.5,0.0,3
2020-10-02-170626,170626,0,0,0,36,1.5,30.330160177086935,4
2020-10-03-170626,170626,0,0,0,36,1.5,57.830142709725976,5
2020-10-04-170626,170626,0,0,0,36,0.0,70.62382535311505,6
2020-10-05-170626,170626,2,1,0,38,1.5,58.8501801028215,0
2020-10-06-170626,170626,0,0,1,38,0.0,55.73500907289618,1
2020-10-07-170626,170626,0,0,0,38,2.5,38.55406502694115,2
2020-10-08-170626,170626,0,0,0,38,1.0,38.76909075152807,3
2020-10-09-170626,170626,0,0,0,38,2.0,41.52520106839649,4
2020-10-10-170626,170626,0,0,0,38,1.0,6.633857491153854,5
2020-10-11-170626,170626,0,0,0,38,2.5,9.025816181555166,6
2020-10-12-170626,170626,0,0,1,38,1.5,18.824155290314568,0
2020-10-13-170626,170626,0,0,0,38,1.0,21.12782461474549,1
2020-10-14-170626,170626,0,0,1,38,2.5,24.098491471732032,2
2020-10-15-170626,170626,0,0,0,38,0.0,29.259362046517918,3
2020-10-16-170626,170626,0,0,0,38,4.5,31.46357647327659,4
2020-10-17-170626,170626,0,0,0,38,2.0,32.318287875878625,5
2020-10-18-170626,170626,0,0,0,38,0.0,31.4493418774455,6
2020-10-19-170626,170626,0,0,0,38,4.5,23.246207890315752,0
2020-10-20-170626,170626,1,0,4,39,1.5,28.392652919596568,1
2020-10-21-170626,170626,0,0,0,39,2.5,31.421022663459762,2
2020-10-22-170626,170626,0,0,0,39,1.5,32.07985650290447,3
2020-10-23-170626,170626,0,0,3,39,5.0,28.167201219763367,4
2020-10-24-170626,170626,0,0,2,39,0.0,32.51385017924469,5
2020-10-25-170626,170626,0,0,0,39,0.0,32.51916401388556,6
2020-10-26-170626,170626,1,1,0,40,6.0,25.062193195021663,0
2020-10-27-170626,170626,0,0,0,40,4.5,35.26546093118734,1
2020-10-28-170626,170626,1,0,0,41,6.5,36.101180213011645,2
2020-10-29-170626,170626,0,0,0,41,2.0,49.63359587301897,3
2020-10-30-170626,170626,0,1,2,41,2.5,49.653867847248115,4
2020-10-31-170626,170626,0,0,0,41,7.0,58.36637721651989,5
2020-11-01-170626,170626,0,0,0,41,5.5,36.25401020289947,6
2020-11-02-170626,170626,0,1,0,41,2.0,34.44480826779971,0
2020-11-03-170626,170626,4,0,0,45,4.5,32.957469449296894,1
2020-11-04-170626,170626,0,0,0,45,7.0,52.67067627569996,2
2020-11-05-170626,170626,0,0,0,45,3.5,58.46964404279652,3
2020-11-06-170626,170626,3,0,0,48,7.0,57.04250413157497,4
2020-11-07-170626,170626,2,0,0,50,1.5,62.916573824421846,5
2020-11-08-170626,170626,0,0,0,50,4.5,62.49524422550006,6
2020-11-09-170626,170626,0,0,0,50,6.0,62.90186545138312,0
2020-11-10-170626,170626,0,0,0,50,1.5,32.4152432146671,1
2020-11-11-170626,170626,0,0,0,50,2.5,35.361157663738624,2
2020-11-12-170626,170626,0,0,0,50,4.0,34.00082903859207,3
2020-11-13-170626,170626,2,0,0,52,7.0,41.43340967404593,4
2020-03-01-170627,170627,0,0,6,0,0.0,0.0,6
2020-03-02-170627,170627,0,0,13,0,0.0,96.05599432510937,0
2020-03-03-170627,170627,2,1,21,2,0.16666666666666666,443.74743850075043,1
2020-03-04-170627,170627,0,0,18,2,0.16666666666666666,484.6167622425746,2
2020-03-05-170627,170627,0,1,14,2,0.0,503.9847399120471,3
2020-03-06-170627,170627,0,0,20,2,0.0,436.37639876912635,4
2020-03-07-170627,170627,0,0,10,2,0.0,464.53422931451274,5
2020-03-08-170627,170627,0,0,10,2,0.0,441.78366206581603,6
2020-03-09-170627,170627,0,0,30,2,0.6666666666666666,438.43502494127137,0
2020-03-10-170627,170627,1,0,19,3,0.6666666666666666,713.5025675180106,1
2020-03-11-170627,170627,0,0,30,3,0.6666666666666666,533.8188104071796,2
2020-03-12-170627,170627,2,0,17,5,1.0,412.6994253474484,3
2020-03-13-170627,170627,3,0,17,8,2.5,277.5946555973485,4
2020-03-14-170627,170627,7,0,8,15,3.333333333333333,269.16208005788656,5
2020-03-15-170627,170627,6,0,5,21,6.5,253.31688639711598,6
2020-03-16-170627,170627,13,0,29,34,13.5,187.37129224249094,0
2020-03-17-170627,170627,21,0,18,55,14.166666666666664,314.73314968486784,1
2020-03-18-170627,170627,18,0,9,73,17.166666666666668,437.2103077741814,2
2020-03-19-170627,170627,14,0,9,87,14.833333333333336,522.6752967743594,3
2020-03-20-170627,170627,20,0,10,107,17.833333333333332,573.2835346174312,4
2020-03-21-170627,170627,10,0,2,117,6.833333333333332,639.8782260247167,5
2020-03-22-170627,170627,10,0,2,127,6.333333333333332,620.240207143814,6
2020-03-23-170627,170627,30,0,15,157,28.33333333333333,576.7872680913781,0
2020-03-24-170627,170627,19,0,4,176,23.0,664.1015923648404,1
2020-03-25-170627,170627,30,0,2,206,23.5,712.3301333852351,2
2020-03-26-170627,170627,17,1,3,223,22.0,764.0912181400652,3
2020-03-27-170627,170627,17,0,4,240,18.83333333333333,900.8463965251838,4
2020-03-28-170627,170627,8,0,5,248,5.666666666666668,915.1368568872948,5
2020-03-29-170627,170627,5,0,1,253,6.166666666666668,896.7745619984032,6
2020-03-30-170627,170627,29,0,10,282,18.83333333333333,691.1520674064404,0
2020-03-31-170627,170627,18,0,1,300,12.0,668.3524164874134,1
2020-04-01-170627,170627,9,0,5,309,11.666666666666664,92.07045590183256,2
2020-04-02-170627,170627,9,0,1,318,8.5,281.73055630181454,3
2020-04-03-170627,170627,10,0,1,328,9.833333333333334,162.41319149190957,4
2020-04-04-170627,170627,2,0,2,330,3.0,221.32506731402964,5
2020-04-05-170627,170627,2,0,0,332,4.5,227.1893624548758,6
2020-04-06-170627,170627,15,0,6,347,14.833333333333336,242.32682438037875,0
2020-04-07-170627,170627,4,0,4,351,7.5,284.226282235108,1
2020-04-08-170627,170627,2,0,5,353,6.5,312.9962726679141,2
2020-04-09-170627,170627,3,0,1,356,4.166666666666667,329.61341320290126,3
2020-04-10-170627,170627,4,0,2,360,4.5,92.17402562715966,4
2020-04-11-170627,170627,5,0,0,365,2.833333333333333,122.85804152133821,5
2020-04-12-170627,170627,1,0,2,366,2.6666666666666665,138.17135470446073,6
2020-04-13-170627,170627,10,0,6,376,11.5,154.7949052982022,0
2020-04-14-170627,170627,1,0,4,377,6.833333333333332,216.77853157184305,1
2020-04-15-170627,170627,5,0,3,382,6.333333333333332,265.1673192442303,2
2020-04-16-170627,170627,1,0,3,383,9.5,299.87796711072525,3
2020-04-17-170627,170627,1,0,0,384,8.5,274.3922595931059,4
2020-04-18-170627,170627,2,0,1,386,4.333333333333333,291.66843608509475,5
2020-04-19-170627,170627,0,0,2,386,1.1666666666666667,299.567294654345,6
2020-04-20-170627,170627,6,0,4,392,5.0,277.7476339620301,0
2020-04-21-170627,170627,4,0,1,396,5.0,272.10170797801146,1
2020-04-22-170627,170627,5,0,2,401,7.5,281.9369824470525,2
2020-04-23-170627,170627,1,0,1,402,1.8333333333333333,276.4089997741528,3
2020-04-24-170627,170627,2,0,5,404,3.5,238.03778051870438,4
2020-04-25-170627,170627,0,0,3,404,2.333333333333333,235.1350604064949,5
2020-04-26-170627,170627,2,0,1,406,2.833333333333333,242.93159390722565,6
2020-04-27-170627,170627,6,0,4,412,8.5,203.05385728491942,0
2020-04-28-170627,170627,4,0,2,416,3.1666666666666665,201.97697048137366,1
2020-04-29-170627,170627,3,0,5,419,5.5,179.60727280797028,2
2020-04-30-170627,170627,3,0,2,422,3.1666666666666665,230.36714774709444,3
2020-05-01-170627,170627,0,0,6,422,2.6666666666666665,304.7631521408242,4
2020-05-02-170627,170627,1,0,1,423,0.8333333333333334,128.72730372080395,5
2020-05-03-170627,170627,2,0,0,425,0.8333333333333334,80.04880308057596,6
2020-05-04-170627,170627,4,0,0,429,6.0,71.04479979911446,0
2020-05-05-170627,170627,1,0,3,430,5.833333333333332,103.01888131775412,1
2020-05-06-170627,170627,2,0,0,432,3.6666666666666665,118.06808114737204,2
2020-05-07-170627,170627,1,0,3,433,3.1666666666666665,141.22541854604694,3
2020-05-08-170627,170627,5,0,3,438,5.333333333333333,155.05625846049287,4
2020-05-09-170627,170627,3,0,0,441,1.0,205.13721295274425,5
2020-05-10-170627,170627,1,0,0,442,0.16666666666666666,333.0049183184809,6
2020-05-11-170627,170627,4,0,1,446,7.166666666666668,309.15698894948315,0
2020-05-12-170627,170627,2,0,1,448,14.166666666666664,325.11751347889674,1
2020-05-13-170627,170627,5,0,1,453,3.6666666666666665,285.23700701591974,2
2020-05-14-170627,170627,2,0,3,455,3.6666666666666665,256.82569992421594,3
2020-05-15-170627,170627,6,0,2,461,3.5,223.96670133542807,4
2020-05-16-170627,170627,1,0,0,462,0.5,224.53765271889716,5
2020-05-17-170627,170627,0,0,0,462,0.16666666666666666,209.00930183230093,6
2020-05-18-170627,170627,0,0,2,462,3.0,209.61918475122195,0
2020-05-19-170627,170627,3,1,0,465,4.0,187.42676262226394,1
2020-05-20-170627,170627,0,0,2,465,2.5,132.48203438829975,2
2020-05-21-170627,170627,3,0,0,468,2.5,130.2440926709603,3
2020-05-22-170627,170627,3,0,2,471,2.833333333333333,113.68168284507057,4
2020-05-23-170627,170627,0,0,0,471,0.3333333333333333,132.44998397972947,5
2020-05-24-170627,170627,0,0,0,471,0.16666666666666666,134.00972833475743,6
2020-05-25-170627,170627,1,0,3,472,0.6666666666666666,111.7757683855672,0
2020-05-26-170627,170627,1,0,3,473,1.8333333333333333,102.06277865629062,1
2020-05-27-170627,170627,1,0,1,474,2.6666666666666665,103.52354528103804,2
2020-05-28-170627,170627,3,0,3,477,2.833333333333333,100.24833587641803,3
2020-05-29-170627,170627,2,0,0,479,4.0,98.61042637176996,4
2020-05-30-170627,170627,0,0,0,479,0.16666666666666666,108.13537007914954,5
2020-05-31-170627,170627,0,1,0,479,0.16666666666666666,108.97393500719514,6
2020-06-01-170627,170627,2,0,4,481,2.5,254.06056618993887,0
2020-06-02-170627,170627,0,0,2,481,0.8333333333333334,69.25999157346757,1
2020-06-03-170627,170627,2,0,3,483,1.3333333333333333,50.29001598669659,2
2020-06-04-170627,170627,0,0,4,483,3.1666666666666665,51.47350090070514,3
2020-06-05-170627,170627,2,1,1,485,3.0,67.19499038749666,4
2020-06-06-170627,170627,0,13,0,485,0.16666666666666666,78.52908868501635,5
2020-06-07-170627,170627,0,0,0,485,0.16666666666666666,78.92086403132888,6
2020-06-08-170627,170627,3,0,1,488,1.1666666666666667,80.65528720480367,0
2020-06-09-170627,170627,3,1,2,491,1.8333333333333333,85.45925438447816,1
2020-06-10-170627,170627,1,0,3,492,1.8333333333333333,290.2383213181362,2
2020-06-11-170627,170627,3,0,3,495,2.6666666666666665,249.14430327201745,3
2020-06-12-170627,170627,0,0,2,495,0.6666666666666666,233.26390823284055,4
2020-06-13-170627,170627,0,0,0,495,0.16666666666666666,177.4088723352967,5
2020-06-14-170627,170627,0,1,0,495,0.0,130.87637398253747,6
2020-06-15-170627,170627,4,0,3,499,1.6666666666666667,77.71438398987195,0
2020-06-16-170627,170627,2,0,0,501,1.5,78.7503658513713,1
2020-06-17-170627,170627,3,0,0,504,1.3333333333333333,64.0573599967027,2
2020-06-18-170627,170627,4,0,3,508,2.0,62.72254057735738,3
2020-06-19-170627,170627,1,0,0,509,2.333333333333333,58.62233523093465,4
2020-06-20-170627,170627,0,0,0,509,0.0,88.6681962155412,5
2020-06-21-170627,170627,0,0,0,509,0.16666666666666666,89.10225380023257,6
2020-06-22-170627,170627,1,0,1,510,2.0,77.22952622305056,0
2020-06-23-170627,170627,2,0,1,512,2.5,79.54419655830431,1
2020-06-24-170627,170627,3,0,0,515,0.6666666666666666,82.00776871705924,2
2020-06-25-170627,170627,3,3,1,518,1.1666666666666667,71.6586121952913,3
2020-06-26-170627,170627,2,0,0,520,1.1666666666666667,61.74050528868119,4
2020-06-27-170627,170627,0,0,0,520,0.0,60.818249346598726,5
2020-06-28-170627,170627,0,0,0,520,0.0,61.62668208798794,6
2020-06-29-170627,170627,3,0,0,523,0.8333333333333334,60.91964263401461,0
2020-06-30-170627,170627,0,0,3,523,1.6666666666666667,56.59045470364977,1
2020-07-01-170627,170627,0,0,0,523,1.8333333333333333,91.08158596891393,2
2020-07-02-170627,170627,3,0,1,526,0.5,32.16355641446447,3
2020-07-03-170627,170627,0,0,2,526,1.0,49.78564104213779,4
2020-07-04-170627,170627,0,0,0,526,0.0,71.67001484679804,5
2020-07-05-170627,170627,0,0,0,526,0.0,68.76721179592325,6
2020-07-06-170627,170627,1,0,0,527,0.6666666666666666,57.69942278652867,0
2020-07-07-170627,170627,1,0,2,528,1.1666666666666667,55.20153753797711,1
2020-07-08-170627,170627,0,0,0,528,0.3333333333333333,51.1501846879585,2
2020-07-09-170627,170627,1,0,2,529,1.0,46.43546491029429,3
2020-07-10-170627,170627,0,0,0,529,1.0,96.39836918814427,4
2020-07-11-170627,170627,0,0,0,529,0.16666666666666666,75.00193155389455,5
2020-07-12-170627,170627,0,0,0,529,0.16666666666666666,49.64741529117939,6
2020-07-13-170627,170627,0,0,0,529,0.8333333333333334,50.4807568428585,0
2020-07-14-170627,170627,3,0,0,532,0.6666666666666666,54.635481216554524,1
2020-07-15-170627,170627,0,0,0,532,0.5,48.01088722990647,2
2020-07-16-170627,170627,1,0,1,533,1.1666666666666667,37.22778441512253,3
2020-07-17-170627,170627,2,0,2,535,0.5,32.123720059595584,4
2020-07-18-170627,170627,0,0,0,535,0.0,32.80323236580107,5
2020-07-19-170627,170627,0,0,0,535,0.0,32.75645993705935,6
2020-07-20-170627,170627,0,0,3,535,0.6666666666666666,28.581263306538744,0
2020-07-21-170627,170627,2,0,3,537,3.0,29.545851273815103,1
2020-07-22-170627,170627,0,0,4,537,0.6666666666666666,49.23172731453442,2
2020-07-23-170627,170627,2,0,4,539,1.0,46.45383336675783,3
2020-07-24-170627,170627,0,0,5,539,0.5,50.305260212868845,4
2020-07-25-170627,170627,0,0,0,539,0.3333333333333333,55.39936563532103,5
2020-07-26-170627,170627,0,0,0,539,0.8333333333333334,55.78653493104823,6
2020-07-27-170627,170627,0,0,3,539,0.8333333333333334,54.78065146495755,0
2020-07-28-170627,170627,0,0,0,539,1.0,56.32524881995523,1
2020-07-29-170627,170627,0,0,3,539,1.5,40.127503997743176,2
2020-07-30-170627,170627,1,0,4,540,1.1666666666666667,42.00744534688834,3
2020-07-31-170627,170627,2,0,9,542,3.8333333333333335,49.31104547793329,4
2020-08-01-170627,170627,0,0,2,542,1.0,33.944857645824314,5
2020-08-02-170627,170627,0,0,2,542,1.5,236.9810085758213,6
2020-08-03-170627,170627,3,0,9,545,1.5,352.3091952605914,0
2020-08-04-170627,170627,3,0,6,548,2.0,326.18834751730327,1
2020-08-05-170627,170627,4,0,6,552,3.8333333333333335,270.16331104100084,2
2020-08-06-170627,170627,4,0,9,556,3.0,260.51565165398205,3
2020-08-07-170627,170627,5,0,2,561,5.333333333333333,213.6369242790047,4
2020-08-08-170627,170627,0,0,1,561,1.5,228.31811671382258,5
2020-08-09-170627,170627,0,0,3,561,0.3333333333333333,226.75510766805758,6
2020-08-10-170627,170627,3,0,7,564,2.333333333333333,25.500197811998266,0
2020-08-11-170627,170627,0,0,8,564,2.6666666666666665,51.42502779493732,1
2020-08-12-170627,170627,3,0,9,567,4.833333333333333,75.46319688743026,2
2020-08-13-170627,170627,4,0,8,571,5.333333333333333,106.92054561581261,3
2020-08-14-170627,170627,9,0,3,580,3.6666666666666665,144.3995795642752,4
2020-08-15-170627,170627,2,0,5,582,1.3333333333333333,174.42825075904022,5
2020-08-16-170627,170627,2,0,2,584,1.8333333333333333,182.655862108617,6
2020-08-17-170627,170627,9,0,8,593,7.666666666666668,190.95018274609475,0
2020-08-18-170627,170627,6,0,3,599,4.0,212.9842051667239,1
2020-08-19-170627,170627,6,0,5,605,6.5,219.56268370077711,2
2020-08-20-170627,170627,9,0,8,614,8.166666666666666,195.36868776866805,3
2020-08-21-170627,170627,2,0,6,616,5.5,214.60930291957692,4
2020-08-22-170627,170627,1,0,3,617,0.6666666666666666,239.93759001026385,5
2020-08-23-170627,170627,3,0,0,620,1.1666666666666667,235.83819684101445,6
2020-08-24-170627,170627,7,0,10,627,7.5,201.3406945832107,0
2020-08-25-170627,170627,8,0,0,635,5.166666666666667,234.8861150090281,1
2020-08-26-170627,170627,9,0,8,644,9.833333333333334,247.1739797165802,2
2020-08-27-170627,170627,8,0,4,652,5.0,309.05592045346873,3
2020-08-28-170627,170627,3,0,8,655,8.833333333333334,299.1281141019983,4
2020-08-29-170627,170627,5,0,1,660,3.0,328.90503776926437,5
2020-08-30-170627,170627,2,0,1,662,1.6666666666666667,350.07519082150486,6
2020-08-31-170627,170627,8,0,10,670,10.0,302.0009449189828,0
2020-09-01-170627,170627,3,0,3,673,7.166666666666668,219.59060982733266,1
2020-09-02-170627,170627,5,0,3,678,7.0,329.45160487496025,2
2020-09-03-170627,170627,8,0,6,686,6.333333333333332,328.48800186130853,3
2020-09-04-170627,170627,6,1,5,692,9.833333333333334,320.20494185941595,4
2020-09-05-170627,170627,3,0,2,695,5.5,346.7985950232064,5
2020-09-06-170627,170627,0,0,4,695,2.6666666666666665,359.81793801366354,6
2020-09-07-170627,170627,10,0,13,705,8.5,362.91347524688786,0
2020-09-08-170627,170627,0,0,4,705,3.0,389.94033044893274,1
2020-09-09-170627,170627,8,0,3,713,5.166666666666667,349.1327450962283,2
2020-09-10-170627,170627,4,0,7,717,5.0,196.3543980407455,3
2020-09-11-170627,170627,8,0,4,725,8.666666666666666,229.36045458356878,4
2020-09-12-170627,170627,1,0,0,726,2.333333333333333,285.86794460982276,5
2020-09-13-170627,170627,1,1,1,727,1.6666666666666667,287.8711082518648,6
2020-09-14-170627,170627,10,0,3,737,13.833333333333336,266.6870840349428,0
2020-09-15-170627,170627,3,0,3,740,6.333333333333332,347.9361445909372,1
2020-09-16-170627,170627,3,0,6,743,6.0,404.65468587225337,2
2020-09-17-170627,170627,6,0,2,749,5.833333333333332,396.66896598825906,3
2020-09-18-170627,170627,5,0,6,754,7.833333333333332,394.40986042761483,4
2020-09-19-170627,170627,2,0,4,756,1.1666666666666667,370.728113302607,5
2020-09-20-170627,170627,4,0,3,760,2.6666666666666665,392.8017399083275,6
2020-09-21-170627,170627,13,0,9,773,11.0,320.2537259583082,0
2020-09-22-170627,170627,4,0,7,777,9.0,359.548507024807,1
2020-09-23-170627,170627,3,1,11,780,7.166666666666668,394.4291324847351,2
2020-09-24-170627,170627,7,0,5,787,9.0,407.0337750968252,3
2020-09-25-170627,170627,4,0,7,791,7.5,400.2915171726785,4
2020-09-26-170627,170627,0,0,0,791,2.1666666666666665,437.05668015941234,5
2020-09-27-170627,170627,1,0,2,792,1.3333333333333333,419.2129004274167,6
2020-09-28-170627,170627,3,1,1,795,4.5,417.2160186931888,0
2020-09-29-170627,170627,3,0,9,798,7.333333333333332,387.85636063261654,1
2020-09-30-170627,170627,6,0,7,804,5.333333333333333,372.0345778831916,2
2020-10-01-170627,170627,2,0,5,806,6.0,0.0,3
2020-10-02-170627,170627,6,0,8,812,4.166666666666667,814.927463783042,4
2020-10-03-170627,170627,4,0,0,816,1.0,969.7823539645941,5
2020-10-04-170627,170627,3,0,2,819,2.5,866.0331222060321,6
2020-10-05-170627,170627,9,1,7,828,6.166666666666668,720.7747064102206,0
2020-10-06-170627,170627,7,0,5,835,7.833333333333332,653.7603203511583,1
2020-10-07-170627,170627,11,0,3,846,5.5,567.3063699734179,2
2020-10-08-170627,170627,5,0,7,851,7.166666666666668,549.8823315009884,3
2020-10-09-170627,170627,7,0,11,858,9.5,622.5690096455792,4
2020-10-10-170627,170627,0,0,0,858,2.333333333333333,48.25436138110601,5
2020-10-11-170627,170627,2,0,1,860,4.166666666666667,96.92740893457325,6
2020-10-12-170627,170627,1,0,9,861,4.166666666666667,150.61833597081446,0
2020-10-13-170627,170627,9,0,10,870,10.333333333333334,190.82580525246527,1
2020-10-14-170627,170627,7,0,5,877,10.666666666666666,318.5531371398383,2
2020-10-15-170627,170627,5,0,6,882,14.0,430.9684769086567,3
2020-10-16-170627,170627,8,0,10,890,15.833333333333336,563.7870473452933,4
2020-10-17-170627,170627,0,0,3,890,2.0,684.6984215318628,5
2020-10-18-170627,170627,2,0,4,892,5.333333333333333,672.3582731854005,6
2020-10-19-170627,170627,7,0,0,899,19.33333333333333,677.4012964807505,0
2020-10-20-170627,170627,5,0,11,904,16.5,742.8586285318618,1
2020-10-21-170627,170627,3,0,6,907,17.5,785.514433697047,2
2020-10-22-170627,170627,7,0,8,914,15.5,824.2947176633083,3
2020-10-23-170627,170627,11,1,8,925,16.833333333333332,839.3851918990499,4
2020-10-24-170627,170627,0,0,2,925,3.333333333333333,977.9659717597278,5
2020-10-25-170627,170627,1,0,4,926,4.166666666666667,956.9818611680547,6
2020-10-26-170627,170627,9,1,5,935,15.833333333333336,878.0418683164013,0
2020-10-27-170627,170627,10,0,4,945,14.0,999.752727997394,1
2020-10-28-170627,170627,5,2,8,950,14.166666666666664,1017.9019046639547,2
2020-10-29-170627,170627,6,0,22,956,9.833333333333334,1007.3881066622848,3
2020-10-30-170627,170627,10,0,16,966,15.5,788.1953763049426,4
2020-10-31-170627,170627,3,0,0,969,4.166666666666667,896.7615862754942,5
2020-11-01-170627,170627,4,1,0,973,4.166666666666667,554.6014118206658,6
2020-11-02-170627,170627,0,0,0,973,3.0,326.12148529721566,0
2020-11-03-170627,170627,11,0,0,984,16.666666666666668,307.749345562955,1
2020-11-04-170627,170627,6,1,0,990,14.0,424.5248985601533,2
2020-11-05-170627,170627,8,0,0,998,11.0,515.034361983609,3
2020-11-06-170627,170627,8,1,0,1006,9.666666666666666,563.7301465324933,4
2020-11-07-170627,170627,2,0,0,1008,3.5,617.1213296368712,5
2020-11-08-170627,170627,4,0,0,1012,2.833333333333333,586.9213710462874,6
2020-11-09-170627,170627,5,0,0,1017,14.0,590.9186634592663,0
2020-11-10-170627,170627,4,0,0,1021,9.666666666666666,552.0278235212185,1
2020-11-11-170627,170627,8,1,0,1029,7.0,606.3686426406754,2
2020-11-12-170627,170627,22,0,0,1051,7.333333333333332,582.8304608197047,3
2020-11-13-170627,170627,16,1,0,1067,6.0,586.5798007170195,4
2020-03-01-170628,170628,0,0,8,0,0.25,0.0,6
2020-03-02-170628,170628,0,0,16,0,0.0,181.1476725562516,0
2020-03-03-170628,170628,0,0,12,0,0.375,842.4569267207611,1
2020-03-04-170628,170628,1,0,16,1,0.0,939.0175239076218,2
2020-03-05-170628,170628,0,4,12,1,0.0,987.0221356011468,3
2020-03-06-170628,170628,0,0,14,1,0.125,854.0539811802652,4
2020-03-07-170628,170628,0,0,11,1,0.0,923.5245962139485,5
2020-03-08-170628,170628,0,0,13,1,0.125,909.3250413126001,6
2020-03-09-170628,170628,1,0,36,2,0.25,905.6194355412091,0
2020-03-10-170628,170628,1,0,32,3,0.5,1323.1432615077536,1
2020-03-11-170628,170628,2,0,31,5,0.25,1004.9768531610698,2
2020-03-12-170628,170628,0,0,13,5,1.25,764.3649574226658,3
2020-03-13-170628,170628,2,0,20,7,2.125,510.2394967988347,4
2020-03-14-170628,170628,5,0,8,12,3.125,491.8912362226659,5
2020-03-15-170628,170628,8,0,8,20,7.125,451.70801479267334,6
2020-03-16-170628,170628,16,1,16,36,15.875,331.51017297863166,0
2020-03-17-170628,170628,12,0,15,48,15.375,591.7060932851759,1
2020-03-18-170628,170628,16,0,20,64,17.25,834.214799923867,2
2020-03-19-170628,170628,12,0,11,76,16.75,1019.1544185712,3
2020-03-20-170628,170628,14,0,22,90,20.125,1139.30772836311,4
2020-03-21-170628,170628,11,0,2,101,9.375,1268.8104415504768,5
2020-03-22-170628,170628,13,0,15,114,9.875,1225.7131204796756,6
2020-03-23-170628,170628,36,0,15,150,33.125,1131.5291790404506,0
2020-03-24-170628,170628,32,0,18,182,25.0,1332.0588122826878,1
2020-03-25-170628,170628,31,0,12,213,26.5,1444.6512203490151,2
2020-03-26-170628,170628,13,0,6,226,21.625,1561.3442269732059,3
2020-03-27-170628,170628,20,0,3,246,24.875,1847.0504209981905,4
2020-03-28-170628,170628,8,0,7,254,4.75,1901.6247009961173,5
2020-03-29-170628,170628,8,0,4,262,5.75,1863.706403597735,6
2020-03-30-170628,170628,16,0,30,278,27.375,1432.6636078185918,0
2020-03-31-170628,170628,15,0,12,293,17.0,1416.2382182825359,1
2020-04-01-170628,170628,20,0,17,313,16.0,200.6404036859862,2
2020-04-02-170628,170628,11,0,12,324,8.75,617.079826101261,3
2020-04-03-170628,170628,22,0,6,346,10.875,359.45159780611436,4
2020-04-04-170628,170628,2,0,5,348,4.0,483.48481768685,5
2020-04-05-170628,170628,15,0,1,363,3.625,490.29758411673333,6
2020-04-06-170628,170628,15,0,11,378,18.0,521.9512829888304,0
2020-04-07-170628,170628,18,0,2,396,10.5,608.7205667293053,1
2020-04-08-170628,170628,12,0,9,408,9.75,677.2557631289814,2
2020-04-09-170628,170628,6,0,0,414,4.0,717.5089992884941,3
2020-04-10-170628,170628,3,0,5,417,6.0,195.5369851912215,4
2020-04-11-170628,170628,7,0,5,424,3.625,257.60559930372386,5
2020-04-12-170628,170628,4,0,2,428,4.125,294.1328794085215,6
2020-04-13-170628,170628,30,0,9,458,9.25,335.8319985151699,0
2020-04-14-170628,170628,12,0,7,470,11.625,468.6961417267513,1
2020-04-15-170628,170628,17,0,5,487,6.625,592.9958239390887,2
2020-04-16-170628,170628,12,0,5,499,4.625,675.6237624149014,3
2020-04-17-170628,170628,6,0,2,505,7.125,603.2598694436597,4
2020-04-18-170628,170628,5,0,0,510,4.375,641.3734083864322,5
2020-04-19-170628,170628,1,0,1,511,2.25,661.3980662439669,6
2020-04-20-170628,170628,11,0,4,522,6.625,611.3311645571109,0
2020-04-21-170628,170628,2,0,9,524,9.25,586.3690845732006,1
2020-04-22-170628,170628,9,0,3,533,9.25,598.3802176933116,2
2020-04-23-170628,170628,0,0,3,533,2.375,607.569323032631,3
2020-04-24-170628,170628,5,0,9,538,4.75,526.3054947767633,4
2020-04-25-170628,170628,5,0,3,543,2.25,520.8039516691495,5
2020-04-26-170628,170628,2,0,0,545,2.25,534.3350353554545,6
2020-04-27-170628,170628,9,0,8,554,7.75,450.06602721099165,0
2020-04-28-170628,170628,7,0,9,561,4.75,446.87246502612595,1
2020-04-29-170628,170628,5,0,5,566,6.5,399.496080575164,2
2020-04-30-170628,170628,5,0,5,571,3.625,502.4034848380528,3
2020-05-01-170628,170628,2,0,5,573,3.75,674.1036827269481,4
2020-05-02-170628,170628,0,0,0,573,2.5,278.8266535058365,5
2020-05-03-170628,170628,1,0,0,574,1.0,169.3309396875045,6
2020-05-04-170628,170628,4,0,5,578,9.75,144.88271080973357,0
2020-05-05-170628,170628,9,1,5,587,4.375,221.72382277289273,1
2020-05-06-170628,170628,3,0,1,590,9.375,251.74615338311838,2
2020-05-07-170628,170628,3,0,1,593,6.25,310.401861198941,3
2020-05-08-170628,170628,9,0,3,602,6.875,350.7514257237522,4
2020-05-09-170628,170628,3,0,1,605,1.375,450.12037014157784,5
2020-05-10-170628,170628,0,0,0,605,0.625,720.2793618342762,6
2020-05-11-170628,170628,8,1,0,613,6.75,673.86764131927,0
2020-05-12-170628,170628,9,0,1,622,13.0,697.7526144323083,1
2020-05-13-170628,170628,5,0,3,627,5.75,614.9343470110016,2
2020-05-14-170628,170628,5,0,5,632,3.25,541.7156126276511,3
2020-05-15-170628,170628,5,0,3,637,5.0,465.4601743580549,4
2020-05-16-170628,170628,0,0,0,637,0.5,472.1619748455695,5
2020-05-17-170628,170628,0,0,1,637,0.25,431.2066252862487,6
2020-05-18-170628,170628,5,0,1,642,3.125,435.1129490163517,0
2020-05-19-170628,170628,5,0,0,647,3.5,395.2739319010433,1
2020-05-20-170628,170628,1,0,3,648,2.75,277.97694610814784,2
2020-05-21-170628,170628,1,0,3,649,2.25,269.86838033679857,3
2020-05-22-170628,170628,3,0,1,652,3.625,232.16606115116173,4
2020-05-23-170628,170628,1,0,0,653,0.25,272.1134156292842,5
2020-05-24-170628,170628,0,0,0,653,0.375,276.7506750034729,6
2020-05-25-170628,170628,0,0,0,653,2.5,230.23107161637128,0
2020-05-26-170628,170628,1,0,2,654,1.875,213.2315318771447,1
2020-05-27-170628,170628,3,0,0,657,2.0,213.96962904863432,2
2020-05-28-170628,170628,5,1,4,662,2.125,209.87475608923504,3
2020-05-29-170628,170628,3,0,3,665,2.0,215.76003709546984,4
2020-05-30-170628,170628,0,0,0,665,0.0,233.12122218827602,5
2020-05-31-170628,170628,1,1,0,666,0.0,235.37304622288966,6
2020-06-01-170628,170628,1,0,1,667,3.875,596.2316795869431,0
2020-06-02-170628,170628,0,0,1,667,1.875,146.5195295070334,1
2020-06-03-170628,170628,3,0,1,670,2.125,104.5940030290756,2
2020-06-04-170628,170628,3,0,2,673,2.125,109.90912489780995,3
2020-06-05-170628,170628,1,0,5,674,2.625,140.76483401138677,4
2020-06-06-170628,170628,0,0,0,674,0.375,166.77809509338664,5
2020-06-07-170628,170628,0,0,1,674,0.125,168.82859626897363,6
2020-06-08-170628,170628,0,0,3,674,1.625,170.98679119648622,0
2020-06-09-170628,170628,2,0,3,676,1.5,184.50459468206444,1
2020-06-10-170628,170628,0,0,2,676,1.25,678.8000423288375,2
2020-06-11-170628,170628,4,0,3,680,1.375,577.5336624517354,3
2020-06-12-170628,170628,3,0,1,683,0.125,544.8993342231288,4
2020-06-13-170628,170628,0,0,0,683,0.0,413.14636643864594,5
2020-06-14-170628,170628,0,2,0,683,0.0,300.36942963099693,6
2020-06-15-170628,170628,1,0,0,684,1.5,176.23201398460196,0
2020-06-16-170628,170628,1,0,2,685,1.5,174.76256615013136,1
2020-06-17-170628,170628,1,0,0,686,1.125,139.99431199831082,2
2020-06-18-170628,170628,2,0,2,688,2.0,137.36752530623565,3
2020-06-19-170628,170628,5,0,1,693,2.0,131.88853111028808,4
2020-06-20-170628,170628,0,0,0,693,0.0,200.27615477755955,5
2020-06-21-170628,170628,1,0,0,694,0.0,200.73350118464649,6
2020-06-22-170628,170628,3,0,0,697,1.5,177.804681204901,0
2020-06-23-170628,170628,3,0,4,700,1.5,184.23153306307287,1
2020-06-24-170628,170628,2,0,0,702,0.75,193.21536120402288,2
2020-06-25-170628,170628,3,1,2,705,0.875,171.41809707657816,3
2020-06-26-170628,170628,1,1,0,706,1.375,148.17294690828112,4
2020-06-27-170628,170628,0,0,0,706,0.125,138.18508910312647,5
2020-06-28-170628,170628,0,0,0,706,0.0,140.49519617929164,6
2020-06-29-170628,170628,0,0,0,706,1.25,138.9072449211759,0
2020-06-30-170628,170628,2,0,2,708,0.375,130.72727158256288,1
2020-07-01-170628,170628,0,0,1,708,0.5,209.3063730977968,2
2020-07-02-170628,170628,2,0,2,710,0.625,71.67800125862938,3
2020-07-03-170628,170628,1,0,2,711,0.875,105.81003033094137,4
2020-07-04-170628,170628,0,0,0,711,0.0,156.31867885580237,5
2020-07-05-170628,170628,0,0,0,711,0.0,153.57615646106456,6
2020-07-06-170628,170628,0,0,2,711,0.625,128.65214656256714,0
2020-07-07-170628,170628,4,0,0,715,0.25,122.40515721499008,1
2020-07-08-170628,170628,0,0,1,715,0.125,114.50214122217889,2
2020-07-09-170628,170628,2,0,0,717,0.625,105.18314463668109,3
2020-07-10-170628,170628,0,0,1,717,0.875,221.15242927905405,4
2020-07-11-170628,170628,0,0,2,717,0.0,173.06682146519836,5
2020-07-12-170628,170628,0,0,1,717,0.125,115.04538796234388,6
2020-07-13-170628,170628,0,0,2,717,0.25,114.70038157372015,0
2020-07-14-170628,170628,2,0,3,719,0.625,123.19479929263287,1
2020-07-15-170628,170628,1,0,2,720,0.625,107.639676482424,2
2020-07-16-170628,170628,2,0,1,722,0.625,80.0393203073182,3
2020-07-17-170628,170628,2,0,1,724,0.25,70.00745757354531,4
2020-07-18-170628,170628,0,0,1,724,0.125,72.39739453683121,5
2020-07-19-170628,170628,0,0,5,724,0.0,72.71688715533472,6
2020-07-20-170628,170628,2,0,1,726,0.375,66.79265139217901,0
2020-07-21-170628,170628,0,0,1,726,0.75,66.57552654092211,1
2020-07-22-170628,170628,1,0,6,727,1.125,110.30796288609906,2
2020-07-23-170628,170628,0,0,4,727,0.375,105.84277341523173,3
2020-07-24-170628,170628,1,1,5,728,0.25,111.41292056392709,4
2020-07-25-170628,170628,2,0,1,730,0.0,123.03488280765153,5
2020-07-26-170628,170628,1,0,0,731,0.125,124.4219808351381,6
2020-07-27-170628,170628,2,0,4,733,0.375,119.86670611952601,0
2020-07-28-170628,170628,3,0,2,736,0.5,126.74033635463461,1
2020-07-29-170628,170628,2,0,2,738,0.125,92.6498629654693,2
2020-07-30-170628,170628,1,0,11,739,0.875,96.81056396813167,3
2020-07-31-170628,170628,1,1,2,740,2.125,114.51870022180557,4
2020-08-01-170628,170628,1,0,2,741,0.875,85.09711782525427,5
2020-08-02-170628,170628,5,0,1,746,1.125,580.1414268340359,6
2020-08-03-170628,170628,1,0,7,747,1.875,874.4691131223451,0
2020-08-04-170628,170628,1,0,4,748,2.125,817.5756918303737,1
2020-08-05-170628,170628,6,0,4,754,3.5,684.0743460733806,2
2020-08-06-170628,170628,4,0,5,758,1.875,660.4175245805036,3
2020-08-07-170628,170628,5,0,2,763,3.5,536.6740407579766,4
2020-08-08-170628,170628,1,0,1,764,1.375,561.097921449817,5
2020-08-09-170628,170628,0,0,1,764,0.875,555.6212281397172,6
2020-08-10-170628,170628,4,0,6,768,1.625,65.90766871750404,0
2020-08-11-170628,170628,2,0,9,770,1.625,119.64237749822014,1
2020-08-12-170628,170628,2,0,10,772,3.375,172.6091953551517,2
2020-08-13-170628,170628,11,0,3,783,5.375,247.78330397703215,3
2020-08-14-170628,170628,2,0,9,785,4.5,343.3308995548065,4
2020-08-15-170628,170628,2,0,4,787,1.5,419.39004675598756,5
2020-08-16-170628,170628,1,0,2,788,2.25,428.5305330234498,6
2020-08-17-170628,170628,7,0,8,795,4.75,451.6723980471796,0
2020-08-18-170628,170628,4,0,11,799,4.375,505.4147929309945,1
2020-08-19-170628,170628,4,0,10,803,5.0,525.596451873939,2
2020-08-20-170628,170628,5,0,8,808,6.875,460.3905664460343,3
2020-08-21-170628,170628,2,0,4,810,6.25,498.4697493123715,4
2020-08-22-170628,170628,1,0,7,811,0.875,556.6556398668429,5
2020-08-23-170628,170628,1,0,3,812,3.75,549.2319163158879,6
2020-08-24-170628,170628,6,0,6,818,7.375,484.6628987803887,0
2020-08-25-170628,170628,9,0,2,827,6.75,555.6931343265671,1
2020-08-26-170628,170628,10,0,5,837,8.625,587.6463075527156,2
2020-08-27-170628,170628,3,0,8,840,5.875,721.7748186918873,3
2020-08-28-170628,170628,9,0,5,849,7.5,711.9053483035976,4
2020-08-29-170628,170628,4,1,1,853,3.0,783.7093321987533,5
2020-08-30-170628,170628,2,0,2,855,2.625,823.4524478331512,6
2020-08-31-170628,170628,8,0,12,863,9.5,716.1172192099586,0
2020-09-01-170628,170628,11,0,5,874,6.5,513.5832893367406,1
2020-09-02-170628,170628,10,0,4,884,5.5,844.5622526834404,2
2020-09-03-170628,170628,8,2,3,892,7.125,786.3136811195963,3
2020-09-04-170628,170628,4,0,4,896,11.25,762.6323327679253,4
2020-09-05-170628,170628,7,0,0,903,5.375,821.2070002758728,5
2020-09-06-170628,170628,3,0,6,906,4.5,858.8639889849039,6
2020-09-07-170628,170628,6,0,13,912,11.25,878.9631646440554,0
2020-09-08-170628,170628,2,0,13,914,2.375,932.1607852010675,1
2020-09-09-170628,170628,5,0,7,919,4.625,857.3736863605014,2
2020-09-10-170628,170628,8,1,5,927,6.125,454.9283394002876,3
2020-09-11-170628,170628,5,0,7,932,12.875,531.9662148925429,4
2020-09-12-170628,170628,1,0,2,933,4.75,658.4997166437811,5
2020-09-13-170628,170628,2,0,1,935,3.625,676.2561538832297,6
2020-09-14-170628,170628,12,0,9,947,13.75,644.2113945527349,0
2020-09-15-170628,170628,5,0,4,952,8.25,833.1618900869441,1
2020-09-16-170628,170628,4,0,7,956,5.25,966.5074336382979,2
2020-09-17-170628,170628,3,0,8,959,7.125,962.6978140234457,3
2020-09-18-170628,170628,4,0,3,963,15.875,951.758126245169,4
2020-09-19-170628,170628,0,0,1,963,6.25,897.584240454052,5
2020-09-20-170628,170628,6,1,3,969,5.125,948.9102834711242,6
2020-09-21-170628,170628,13,0,6,982,11.75,788.8792208555933,0
2020-09-22-170628,170628,13,0,5,995,7.125,859.3238205975349,1
2020-09-23-170628,170628,7,1,4,1002,7.125,915.1323781179212,2
2020-09-24-170628,170628,5,1,8,1007,8.625,948.8573248360668,3
2020-09-25-170628,170628,7,0,14,1014,7.5,938.0061312299865,4
2020-09-26-170628,170628,2,0,6,1016,3.125,1004.5253708399775,5
2020-09-27-170628,170628,1,0,11,1017,1.875,952.126122688871,6
2020-09-28-170628,170628,9,0,5,1026,5.875,930.0660680132789,0
2020-09-29-170628,170628,4,0,8,1030,5.625,866.5774722313552,1
2020-09-30-170628,170628,7,0,5,1037,7.0,816.5371552887749,2
2020-10-01-170628,170628,8,0,34,1045,4.125,0.0,3
2020-10-02-170628,170628,3,0,11,1048,5.875,1595.5534897979492,4
2020-10-03-170628,170628,1,0,4,1049,2.0,1843.055452553975,5
2020-10-04-170628,170628,3,2,9,1052,2.375,1681.1091810765092,6
2020-10-05-170628,170628,6,1,28,1058,13.375,1414.5909511929055,0
2020-10-06-170628,170628,5,0,30,1063,7.5,1328.1342779944985,1
2020-10-07-170628,170628,4,1,15,1067,8.625,1172.7248582134112,2
2020-10-08-170628,170628,8,1,8,1075,6.0,1130.5768692683055,3
2020-10-09-170628,170628,14,1,19,1089,7.75,1269.7438293523478,4
2020-10-10-170628,170628,6,0,2,1095,2.5,97.77674014334994,5
2020-10-11-170628,170628,11,0,12,1106,3.625,184.50222647142823,6
2020-10-12-170628,170628,5,0,15,1111,3.625,293.89889092864377,0
2020-10-13-170628,170628,8,0,11,1119,7.0,371.0000012638132,1
2020-10-14-170628,170628,5,0,10,1124,8.5,611.0984215421572,2
2020-10-15-170628,170628,34,0,6,1158,6.25,814.6774271806075,3
2020-10-16-170628,170628,11,0,17,1169,12.75,1091.1005327765163,4
2020-10-17-170628,170628,4,0,4,1173,2.375,1315.7310614113628,5
2020-10-18-170628,170628,9,0,7,1182,3.5,1272.9403973944773,6
2020-10-19-170628,170628,28,1,7,1210,13.0,1247.6012796220339,0
2020-10-20-170628,170628,30,1,12,1240,7.875,1380.6575632209808,1
2020-10-21-170628,170628,15,0,17,1255,12.625,1435.7172859198981,2
2020-10-22-170628,170628,8,0,8,1263,12.125,1456.2990888550135,3
2020-10-23-170628,170628,19,2,6,1282,14.75,1458.107719068676,4
2020-10-24-170628,170628,2,2,3,1284,3.0,1692.2212796646877,5
2020-10-25-170628,170628,12,0,2,1296,5.125,1683.9885055282416,6
2020-10-26-170628,170628,15,0,7,1311,10.25,1539.7029017121215,0
2020-10-27-170628,170628,11,0,11,1322,11.5,1758.7114966758613,1
2020-10-28-170628,170628,10,1,9,1332,9.5,1821.9056283067498,2
2020-10-29-170628,170628,6,1,10,1338,9.375,1836.4747249235331,3
2020-10-30-170628,170628,17,1,8,1355,12.25,1461.5608479271955,4
2020-10-31-170628,170628,4,2,0,1359,2.75,1667.7532630276185,5
2020-11-01-170628,170628,7,1,0,1366,3.75,1142.1192187878778,6
2020-11-02-170628,170628,7,0,0,1373,3.0,735.7198380621107,0
2020-11-03-170628,170628,12,1,0,1385,13.875,697.1358769819959,1
2020-11-04-170628,170628,17,1,0,1402,10.875,938.3159160024557,2
2020-11-05-170628,170628,8,1,0,1410,10.875,1103.6937185607103,3
2020-11-06-170628,170628,6,1,0,1416,10.125,1194.8264656007134,4
2020-11-07-170628,170628,3,0,0,1419,3.0,1297.3076988944022,5
2020-11-08-170628,170628,2,1,0,1421,5.0,1211.9434963177803,6
2020-11-09-170628,170628,7,0,0,1428,14.375,1216.8132382047202,0
2020-11-10-170628,170628,11,0,0,1439,7.0,1143.014792848034,1
2020-11-11-170628,170628,9,5,0,1448,8.0,1234.373009063121,2
2020-11-12-170628,170628,10,0,0,1458,9.0,1138.8174006176619,3
2020-11-13-170628,170628,8,0,0,1466,10.375,1137.5997756856154,4
2020-03-01-170629,170629,0,0,3,0,0.0,0.0,6
2020-03-02-170629,170629,0,0,8,0,0.0,32.688125555956,0
2020-03-03-170629,170629,0,0,5,0,0.5,141.50256184656195,1
2020-03-04-170629,170629,0,0,15,0,0.0,154.37339521046087,2
2020-03-05-170629,170629,0,0,8,0,0.0,158.97106570270614,3
2020-03-06-170629,170629,0,0,9,0,0.0,137.35009196032135,4
2020-03-07-170629,170629,0,0,8,0,0.0,147.6212202464276,5
2020-03-08-170629,170629,0,0,2,0,0.0,142.19229649605293,6
2020-03-09-170629,170629,1,0,13,1,0.75,141.29478324843473,0
2020-03-10-170629,170629,0,0,8,1,0.5,230.5188454287933,1
2020-03-11-170629,170629,0,0,11,1,1.25,171.73388528440444,2
2020-03-12-170629,170629,0,0,18,1,2.25,133.63764724501075,3
2020-03-13-170629,170629,1,0,11,2,4.0,88.90366131624205,4
2020-03-14-170629,170629,1,0,2,3,3.25,85.20347815098572,5
2020-03-15-170629,170629,3,0,5,6,5.25,77.77868225520581,6
2020-03-16-170629,170629,8,0,5,14,13.5,56.6788088721905,0
2020-03-17-170629,170629,5,0,11,19,18.25,94.21115020753092,1
2020-03-18-170629,170629,15,0,4,34,23.5,127.77159434238199,2
2020-03-19-170629,170629,8,0,8,42,17.25,149.18980929670104,3
2020-03-20-170629,170629,9,0,4,51,21.75,158.3130071827054,4
2020-03-21-170629,170629,8,0,0,59,7.25,172.86319848651885,5
2020-03-22-170629,170629,2,0,2,61,9.25,165.9815017114001,6
2020-03-23-170629,170629,13,0,5,74,29.0,153.31114510058188,0
2020-03-24-170629,170629,8,0,5,82,24.75,174.5105341633509,1
2020-03-25-170629,170629,11,0,4,93,27.5,188.32936674948797,2
2020-03-26-170629,170629,18,0,1,111,24.0,201.5233405413082,3
2020-03-27-170629,170629,11,0,2,122,18.0,239.23725271977756,4
2020-03-28-170629,170629,2,0,1,124,7.25,242.93022831237244,5
2020-03-29-170629,170629,5,0,1,129,5.0,237.92406700529057,6
2020-03-30-170629,170629,5,1,3,134,22.0,184.9727925536644,0
2020-03-31-170629,170629,11,0,0,145,14.5,176.91992336882527,1
2020-04-01-170629,170629,4,0,1,149,12.0,25.284505659845294,2
2020-04-02-170629,170629,8,0,1,157,7.0,75.41435871851112,3
2020-04-03-170629,170629,4,0,11,161,7.75,42.85153624406901,4
2020-04-04-170629,170629,0,0,2,161,4.0,58.74541486701342,5
2020-04-05-170629,170629,2,0,1,163,2.75,60.465093470045495,6
2020-04-06-170629,170629,5,0,4,168,18.75,64.65426404435917,0
2020-04-07-170629,170629,5,0,1,173,6.75,76.49923134255252,1
2020-04-08-170629,170629,4,0,3,177,5.5,85.70360416714118,2
2020-04-09-170629,170629,1,0,2,178,2.75,91.37372285172532,3
2020-04-10-170629,170629,2,0,2,180,5.25,24.76139159088564,4
2020-04-11-170629,170629,1,0,0,181,4.0,33.55261937493846,5
2020-04-12-170629,170629,1,0,1,182,3.25,37.939575634502624,6
2020-04-13-170629,170629,3,0,1,185,9.5,43.03885441800591,0
2020-04-14-170629,170629,0,0,0,185,7.0,59.92769797468935,1
2020-04-15-170629,170629,1,0,1,186,3.75,73.68160870696823,2
2020-04-16-170629,170629,1,1,4,187,6.75,82.94093214366194,3
2020-04-17-170629,170629,11,0,1,198,5.75,75.35980857059423,4
2020-04-18-170629,170629,2,0,0,200,2.0,79.268153431689,5
2020-04-19-170629,170629,1,0,1,201,0.5,81.29729953336208,6
2020-04-20-170629,170629,4,0,2,205,4.25,75.05059140425487,0
2020-04-21-170629,170629,1,0,4,206,4.75,74.00245307150962,1
2020-04-22-170629,170629,3,0,0,209,6.25,77.02583340047227,2
2020-04-23-170629,170629,2,0,0,211,0.5,75.5319725925392,3
2020-04-24-170629,170629,2,0,2,213,4.0,65.22765181700501,4
2020-04-25-170629,170629,0,0,1,213,1.25,64.5226869000638,5
2020-04-26-170629,170629,1,0,0,214,1.25,65.98922267934051,6
2020-04-27-170629,170629,1,0,3,215,8.0,54.77089429879719,0
2020-04-28-170629,170629,0,0,5,215,3.5,53.55329055069683,1
2020-04-29-170629,170629,1,0,3,216,6.25,47.15426833699287,2
2020-04-30-170629,170629,4,0,4,220,3.0,60.995736320958365,3
2020-05-01-170629,170629,1,0,0,221,1.25,84.79950935624545,4
2020-05-02-170629,170629,0,0,0,221,1.5,34.959752288094336,5
2020-05-03-170629,170629,1,0,0,222,1.5,22.00876289636639,6
2020-05-04-170629,170629,2,0,3,224,5.0,19.334680649177475,0
2020-05-05-170629,170629,4,0,3,228,6.5,27.024304546045364,1
2020-05-06-170629,170629,0,0,1,228,5.25,30.529156493439988,2
2020-05-07-170629,170629,0,0,5,228,3.5,36.675625852051596,3
2020-05-08-170629,170629,2,0,0,230,5.75,40.6015805323686,4
2020-05-09-170629,170629,1,0,0,231,1.0,54.171198908355876,5
2020-05-10-170629,170629,0,0,0,231,0.75,93.94117109290458,6
2020-05-11-170629,170629,3,3,1,234,6.5,86.81678512188212,0
2020-05-12-170629,170629,5,5,0,239,18.75,90.23324795388059,1
2020-05-13-170629,170629,3,3,2,242,3.75,79.69857805373339,2
2020-05-14-170629,170629,4,0,4,246,2.75,71.34178346368599,3
2020-05-15-170629,170629,0,0,4,246,7.0,61.26419283506547,4
2020-05-16-170629,170629,0,0,0,246,1.25,61.87362684221715,5
2020-05-17-170629,170629,0,0,0,246,0.0,58.35802083259475,6
2020-05-18-170629,170629,3,1,1,249,0.5,58.63383873661785,0
2020-05-19-170629,170629,3,0,1,252,2.25,53.43505060659354,1
2020-05-20-170629,170629,1,1,1,253,2.0,37.545365892852075,2
2020-05-21-170629,170629,5,0,5,258,2.0,36.93827671266357,3
2020-05-22-170629,170629,0,0,0,258,4.25,32.468951598428404,4
2020-05-23-170629,170629,0,0,0,258,0.0,38.34200622127992,5
2020-05-24-170629,170629,0,0,0,258,0.0,38.73729876412839,6
2020-05-25-170629,170629,1,0,1,259,1.25,32.57640353941878,0
2020-05-26-170629,170629,0,0,1,259,2.0,30.896239297473457,1
2020-05-27-170629,170629,2,0,2,261,2.5,30.993709982815943,2
2020-05-28-170629,170629,4,2,1,265,1.5,30.694984062218573,3
2020-05-29-170629,170629,4,0,1,269,2.25,29.809762345625785,4
2020-05-30-170629,170629,0,1,1,269,1.0,31.856566121200498,5
2020-05-31-170629,170629,0,0,0,269,0.0,32.39863420978083,6
2020-06-01-170629,170629,1,0,3,270,2.5,71.26859697303613,0
2020-06-02-170629,170629,1,0,0,271,1.0,19.998725124816104,1
2020-06-03-170629,170629,1,0,1,272,2.25,14.076948527275704,2
2020-06-04-170629,170629,5,0,2,277,2.25,15.191494558565074,3
2020-06-05-170629,170629,0,0,0,277,1.5,20.488683830651524,4
2020-06-06-170629,170629,0,0,0,277,0.25,23.520193104099476,5
2020-06-07-170629,170629,0,0,0,277,0.25,23.72423841929789,6
2020-06-08-170629,170629,1,0,1,278,1.75,24.196826281124917,0
2020-06-09-170629,170629,1,0,2,279,2.75,25.918199148839584,1
2020-06-10-170629,170629,2,0,1,281,1.5,83.9119462021209,2
2020-06-11-170629,170629,1,0,0,282,1.75,73.41076622775878,3
2020-06-12-170629,170629,1,0,1,283,0.0,69.39996965124446,4
2020-06-13-170629,170629,1,1,0,284,0.25,53.282896880845215,5
2020-06-14-170629,170629,0,0,0,284,0.0,39.80033866630859,6
2020-06-15-170629,170629,3,0,0,287,2.5,23.798088026711376,0
2020-06-16-170629,170629,0,0,3,287,1.75,24.527032509940682,1
2020-06-17-170629,170629,1,0,1,288,1.75,19.50326075509589,2
2020-06-18-170629,170629,2,0,0,290,1.75,18.775803119949128,3
2020-06-19-170629,170629,0,0,1,290,2.0,17.625762213098376,4
2020-06-20-170629,170629,0,0,0,290,0.0,27.622641564237348,5
2020-06-21-170629,170629,0,0,0,290,0.0,27.8312749943265,6
2020-06-22-170629,170629,1,0,1,291,1.5,24.035349104708484,0
2020-06-23-170629,170629,2,0,0,293,1.5,25.158390042169145,1
2020-06-24-170629,170629,1,0,1,294,1.5,25.804165018904044,2
2020-06-25-170629,170629,0,1,0,294,1.5,22.81015435449006,3
2020-06-26-170629,170629,1,1,0,295,2.25,19.65272090914071,4
2020-06-27-170629,170629,0,1,1,295,0.0,18.620561913781014,5
2020-06-28-170629,170629,0,0,0,295,0.0,18.960306353919666,6
2020-06-29-170629,170629,0,0,0,295,1.0,18.7747712986882,0
2020-06-30-170629,170629,3,0,0,298,0.5,18.329067887790302,1
2020-07-01-170629,170629,1,0,0,299,1.0,29.345047566370546,2
2020-07-02-170629,170629,0,0,0,299,1.25,9.837717401276405,3
2020-07-03-170629,170629,1,0,0,300,1.0,16.978377831914106,4
2020-07-04-170629,170629,0,0,0,300,0.0,23.13142962896254,5
2020-07-05-170629,170629,0,0,0,300,0.0,22.21686381377533,6
2020-07-06-170629,170629,1,0,1,301,0.5,18.53237272522509,0
2020-07-07-170629,170629,0,0,0,301,1.0,17.539855252341887,1
2020-07-08-170629,170629,1,0,0,302,0.25,16.00241291185383,2
2020-07-09-170629,170629,0,0,1,302,1.25,14.553516136740186,3
2020-07-10-170629,170629,0,0,0,302,1.25,30.32328810812934,4
2020-07-11-170629,170629,1,0,0,303,0.0,23.194235473943156,5
2020-07-12-170629,170629,0,0,0,303,0.25,15.81351415872837,6
2020-07-13-170629,170629,0,0,0,303,0.75,16.016865881156264,0
2020-07-14-170629,170629,0,0,1,303,1.0,17.34923303954939,1
2020-07-15-170629,170629,0,0,2,303,0.5,14.877152406756995,2
2020-07-16-170629,170629,0,0,0,303,0.75,11.08382792256791,3
2020-07-17-170629,170629,0,0,4,303,0.75,9.625636069216496,4
2020-07-18-170629,170629,0,0,0,303,0.0,9.759957460948788,5
2020-07-19-170629,170629,0,0,0,303,0.0,9.688345134787852,6
2020-07-20-170629,170629,1,0,0,304,0.5,8.512040616539332,0
2020-07-21-170629,170629,0,0,1,304,1.0,8.98467021855933,1
2020-07-22-170629,170629,0,0,3,304,1.0,14.524302125440446,2
2020-07-23-170629,170629,1,0,3,305,0.75,13.766394058077267,3
2020-07-24-170629,170629,0,0,4,305,0.5,15.316678729866647,4
2020-07-25-170629,170629,0,0,0,305,0.0,17.667791879999825,5
2020-07-26-170629,170629,0,0,0,305,0.75,17.895566691087293,6
2020-07-27-170629,170629,0,0,0,305,0.25,17.784753580787203,0
2020-07-28-170629,170629,1,0,5,306,0.75,18.771657277811123,1
2020-07-29-170629,170629,2,0,2,308,0.25,14.239339790196453,2
2020-07-30-170629,170629,0,0,6,308,1.25,14.97185536276512,3
2020-07-31-170629,170629,4,0,5,312,2.25,17.221592606613285,4
2020-08-01-170629,170629,0,0,1,312,0.5,11.352972232420175,5
2020-08-02-170629,170629,0,0,0,312,0.5,80.70333564937792,6
2020-08-03-170629,170629,0,0,6,312,3.75,121.90385549352713,0
2020-08-04-170629,170629,1,0,2,313,1.5,112.63634066468968,1
2020-08-05-170629,170629,3,0,0,316,3.0,93.01626855589278,2
2020-08-06-170629,170629,3,0,0,319,3.0,88.49796732668948,3
2020-08-07-170629,170629,4,0,1,323,5.0,70.3589349312586,4
2020-08-08-170629,170629,0,0,0,323,0.75,74.87689970713393,5
2020-08-09-170629,170629,0,0,0,323,0.5,73.3536942283711,6
2020-08-10-170629,170629,0,0,2,323,2.75,8.216279888564706,0
2020-08-11-170629,170629,5,0,2,328,2.75,16.080986649442476,1
2020-08-12-170629,170629,2,0,2,330,3.0,23.62542410197439,2
2020-08-13-170629,170629,6,0,2,336,3.0,33.336404202164815,3
2020-08-14-170629,170629,5,0,6,341,5.0,45.446784008960805,4
2020-08-15-170629,170629,1,0,1,342,1.5,55.2416160646557,5
2020-08-16-170629,170629,0,0,0,342,2.0,58.204950390788724,6
2020-08-17-170629,170629,6,0,9,348,7.75,60.912064818755994,0
2020-08-18-170629,170629,2,0,6,350,3.75,68.52647560643172,1
2020-08-19-170629,170629,0,0,7,350,7.75,70.46139490363703,2
2020-08-20-170629,170629,0,0,4,350,8.5,62.763942992838196,3
2020-08-21-170629,170629,1,0,3,351,5.25,67.97427696249788,4
2020-08-22-170629,170629,0,0,0,351,1.25,75.62140678241423,5
2020-08-23-170629,170629,0,0,0,351,1.25,74.62396168432433,6
2020-08-24-170629,170629,2,0,0,353,6.5,63.84898426186795,0
2020-08-25-170629,170629,2,0,2,355,5.5,74.59610555130959,1
2020-08-26-170629,170629,2,0,3,357,8.0,79.24720667489473,2
2020-08-27-170629,170629,2,0,4,359,7.0,98.53752480755702,3
2020-08-28-170629,170629,6,0,7,365,7.5,97.5342119898202,4
2020-08-29-170629,170629,1,0,1,366,2.75,108.45547817472084,5
2020-08-30-170629,170629,0,0,0,366,2.5,114.58190796519439,6
2020-08-31-170629,170629,9,0,9,375,7.25,99.85314946343765,0
2020-09-01-170629,170629,6,0,11,381,4.75,69.20284939523046,1
2020-09-02-170629,170629,7,0,6,388,3.25,105.515174777777,2
2020-09-03-170629,170629,4,0,3,392,6.5,105.16567201206354,3
2020-09-04-170629,170629,3,0,8,395,8.5,101.60226138326983,4
2020-09-05-170629,170629,0,0,0,395,3.0,111.34844012065128,5
2020-09-06-170629,170629,0,0,1,395,3.75,115.63264794888622,6
2020-09-07-170629,170629,0,0,4,395,9.75,116.05562642520196,0
2020-09-08-170629,170629,2,0,9,397,1.75,123.79945111331146,1
2020-09-09-170629,170629,3,0,3,400,6.0,110.94348796860278,2
2020-09-10-170629,170629,4,0,10,404,3.5,62.57975215394153,3
2020-09-11-170629,170629,7,0,4,411,9.25,73.69036269885659,4
2020-09-12-170629,170629,1,0,0,412,2.25,92.46251416411003,5
2020-09-13-170629,170629,0,0,3,412,2.75,93.03623531714732,6
2020-09-14-170629,170629,9,0,2,421,7.75,87.65123610792776,0
2020-09-15-170629,170629,11,0,5,432,3.25,113.3986539381072,1
2020-09-16-170629,170629,6,0,5,438,3.5,132.0572853040957,2
2020-09-17-170629,170629,3,0,6,441,3.75,128.83737435165511,3
2020-09-18-170629,170629,8,0,4,449,5.5,127.30167029348405,4
2020-09-19-170629,170629,0,0,0,449,2.5,118.57326016924037,5
2020-09-20-170629,170629,1,1,3,450,2.75,123.71344620161916,6
2020-09-21-170629,170629,4,0,9,454,7.25,100.7704776773999,0
2020-09-22-170629,170629,9,1,5,463,4.0,112.5222559279295,1
2020-09-23-170629,170629,3,0,2,466,4.25,123.83250925499122,2
2020-09-24-170629,170629,10,0,3,476,6.25,128.47772808588394,3
2020-09-25-170629,170629,4,0,9,480,4.0,127.2949110285569,4
2020-09-26-170629,170629,0,0,1,480,0.75,139.25207717654934,5
2020-09-27-170629,170629,3,0,3,483,0.5,133.72285630085213,6
2020-09-28-170629,170629,2,0,0,485,3.25,133.32322549110643,0
2020-09-29-170629,170629,5,0,9,490,4.0,124.96541451290813,1
2020-09-30-170629,170629,5,0,8,495,3.75,119.38462914972315,2
2020-10-01-170629,170629,6,0,17,501,3.0,0.0,3
2020-10-02-170629,170629,4,0,12,505,3.0,254.99374456643721,4
2020-10-03-170629,170629,0,0,1,505,2.0,308.1582858860337,5
2020-10-04-170629,170629,3,0,2,508,2.0,277.86815958922114,6
2020-10-05-170629,170629,9,1,13,517,5.75,231.98231068905596,0
2020-10-06-170629,170629,5,1,6,522,9.75,210.5058505694289,1
2020-10-07-170629,170629,2,0,8,524,7.75,180.8329159210927,2
2020-10-08-170629,170629,3,0,14,527,7.0,174.67895468968015,3
2020-10-09-170629,170629,9,0,14,536,8.5,198.47772749518634,4
2020-10-10-170629,170629,1,0,1,537,1.75,15.467330608521737,5
2020-10-11-170629,170629,3,0,1,540,2.0,31.498026063272913,6
2020-10-12-170629,170629,0,0,11,540,4.0,48.52129924860105,0
2020-10-13-170629,170629,9,0,10,549,9.75,61.1117879672047,1
2020-10-14-170629,170629,8,0,12,557,11.0,101.7282861093808,2
2020-10-15-170629,170629,17,0,10,574,6.25,136.21130820064832,3
2020-10-16-170629,170629,12,0,13,586,14.0,176.244238005767,4
2020-10-17-170629,170629,1,0,0,587,2.0,213.63264834719556,5
2020-10-18-170629,170629,2,0,1,589,4.0,207.19212716593546,6
2020-10-19-170629,170629,13,0,0,602,18.0,206.89442193675822,0
2020-10-20-170629,170629,6,0,18,608,15.5,225.48449043476734,1
2020-10-21-170629,170629,8,0,10,616,17.25,235.3459125952788,2
2020-10-22-170629,170629,14,0,7,630,17.5,246.27872252856167,3
2020-10-23-170629,170629,14,0,8,644,17.5,248.251543578838,4
2020-10-24-170629,170629,1,0,1,645,3.0,289.9264079407378,5
2020-10-25-170629,170629,1,0,1,646,3.5,282.2140739863209,6
2020-10-26-170629,170629,11,0,7,657,20.25,256.09925228849767,0
2020-10-27-170629,170629,10,0,9,667,15.0,294.62905436755904,1
2020-10-28-170629,170629,12,0,7,679,13.25,303.8733645211048,2
2020-10-29-170629,170629,10,0,4,689,11.25,304.3241648713513,3
2020-10-30-170629,170629,13,0,3,702,18.75,238.79750675593903,4
2020-10-31-170629,170629,0,0,0,702,6.0,272.3857975658956,5
2020-11-01-170629,170629,1,0,0,703,6.25,166.49945973099994,6
2020-11-02-170629,170629,0,0,0,703,2.75,98.89485596586363,0
2020-11-03-170629,170629,18,1,0,721,19.0,91.94543242951707,1
2020-11-04-170629,170629,10,1,0,731,11.75,128.78368026364438,2
2020-11-05-170629,170629,7,0,0,738,10.25,156.6757487160612,3
2020-11-06-170629,170629,8,0,0,746,10.5,171.6374675319376,4
2020-11-07-170629,170629,1,0,0,747,4.25,188.36428316134965,5
2020-11-08-170629,170629,1,0,0,748,4.5,179.2236461149822,6
2020-11-09-170629,170629,7,0,0,755,13.25,179.69272401681505,0
2020-11-10-170629,170629,9,0,0,764,8.5,163.08660689720094,1
2020-11-11-170629,170629,7,0,0,771,7.25,178.33828010363408,2
2020-11-12-170629,170629,4,1,0,775,10.5,170.98319984016305,3
2020-11-13-170629,170629,3,0,0,778,8.25,171.5288529667048,4
2020-03-01-170630,170630,0,0,1,0,0.0,0.0,6
2020-03-02-170630,170630,0,0,1,0,0.16666666666666666,19.453981582469012,0
2020-03-03-170630,170630,0,0,1,0,0.0,101.23106820645529,1
2020-03-04-170630,170630,0,0,1,0,0.0,101.63292376780753,2
2020-03-05-170630,170630,1,0,0,1,0.0,94.66819263990891,3
2020-03-06-170630,170630,1,0,0,2,0.0,79.6737317887717,4
2020-03-07-170630,170630,0,0,0,2,0.0,87.79349057119319,5
2020-03-08-170630,170630,0,0,0,2,0.0,81.2973976586421,6
2020-03-09-170630,170630,0,0,0,2,0.0,81.03241606055595,0
2020-03-10-170630,170630,0,0,1,2,0.0,157.70410846126157,1
2020-03-11-170630,170630,1,0,2,3,0.0,112.65057879181451,2
2020-03-12-170630,170630,0,0,3,3,0.16666666666666666,94.88972072511359,3
2020-03-13-170630,170630,0,0,0,3,0.16666666666666666,63.71510798963482,4
2020-03-14-170630,170630,2,0,0,5,0.5,53.806183807011124,5
2020-03-15-170630,170630,1,0,0,6,0.8333333333333334,50.74736449935431,6
2020-03-16-170630,170630,1,0,1,7,4.0,36.800662698703746,0
2020-03-17-170630,170630,1,1,1,8,2.6666666666666665,57.003538411355535,1
2020-03-18-170630,170630,1,0,2,9,3.0,76.5199161179595,2
2020-03-19-170630,170630,0,0,4,9,3.1666666666666665,96.64356124733207,3
2020-03-20-170630,170630,0,0,2,9,5.0,108.15854215282114,4
2020-03-21-170630,170630,0,0,1,9,1.1666666666666667,128.3747050412941,5
2020-03-22-170630,170630,0,0,0,9,1.6666666666666667,119.91665758990369,6
2020-03-23-170630,170630,0,0,2,9,6.5,118.23130104088015,0
2020-03-24-170630,170630,1,0,2,10,5.666666666666668,146.54590096074008,1
2020-03-25-170630,170630,2,0,0,12,5.833333333333332,154.68610324598922,2
2020-03-26-170630,170630,3,0,0,15,5.0,169.06856716630224,3
2020-03-27-170630,170630,0,0,0,15,4.0,209.70331570303637,4
2020-03-28-170630,170630,0,0,0,15,2.0,211.73414131357453,5
2020-03-29-170630,170630,0,0,0,15,1.8333333333333333,213.1838839928565,6
2020-03-30-170630,170630,1,0,7,16,3.0,164.98383861247743,0
2020-03-31-170630,170630,1,0,3,17,2.833333333333333,151.94944395960988,1
2020-04-01-170630,170630,2,0,1,19,1.8333333333333333,22.532262512631895,2
2020-04-02-170630,170630,4,0,0,23,5.5,70.48678797029937,3
2020-04-03-170630,170630,2,0,0,25,3.333333333333333,39.54735675905519,4
2020-04-04-170630,170630,1,0,0,26,1.3333333333333333,52.9764306875364,5
2020-04-05-170630,170630,0,0,0,26,2.0,57.813470962183274,6
2020-04-06-170630,170630,2,0,0,28,2.6666666666666665,62.54700739787296,0
2020-04-07-170630,170630,2,0,0,30,3.333333333333333,72.7920700193669,1
2020-04-08-170630,170630,0,0,0,30,2.0,75.91680669269721,2
2020-04-09-170630,170630,0,2,0,30,0.5,83.9359982971973,3
2020-04-10-170630,170630,0,0,0,30,1.3333333333333333,19.47018436617119,4
2020-04-11-170630,170630,0,0,0,30,1.6666666666666667,29.797665739247154,5
2020-04-12-170630,170630,0,0,0,30,1.0,31.417813836813274,6
2020-04-13-170630,170630,7,0,0,37,3.5,32.98783594228293,0
2020-04-14-170630,170630,3,0,0,40,0.6666666666666666,53.47989713218621,1
2020-04-15-170630,170630,1,1,0,41,2.333333333333333,67.46877347246956,2
2020-04-16-170630,170630,0,0,1,41,0.6666666666666666,79.78699603169358,3
2020-04-17-170630,170630,0,0,0,41,0.8333333333333334,74.02862770653793,4
2020-04-18-170630,170630,0,0,2,41,1.5,73.62429603076671,5
2020-04-19-170630,170630,0,0,0,41,0.8333333333333334,78.99354738672073,6
2020-04-20-170630,170630,0,1,0,41,4.333333333333333,87.99617600114084,0
2020-04-21-170630,170630,0,0,1,41,1.1666666666666667,91.20467788547968,1
2020-04-22-170630,170630,0,0,1,41,1.0,89.9993482921639,2
2020-04-23-170630,170630,0,0,0,41,1.0,91.67032013193314,3
2020-04-24-170630,170630,0,0,0,41,1.0,85.35495103763367,4
2020-04-25-170630,170630,0,0,0,41,0.5,83.06175453925789,5
2020-04-26-170630,170630,0,0,0,41,0.3333333333333333,84.23302285366137,6
2020-04-27-170630,170630,0,0,0,41,1.1666666666666667,55.17435034894322,0
2020-04-28-170630,170630,0,0,0,41,1.5,45.877411229760106,1
2020-04-29-170630,170630,0,1,0,41,0.5,47.511316777246556,2
2020-04-30-170630,170630,1,0,0,42,0.6666666666666666,56.45983098298109,3
2020-05-01-170630,170630,0,0,0,42,0.5,87.76335734251961,4
2020-05-02-170630,170630,2,0,0,44,0.3333333333333333,26.47564706510662,5
2020-05-03-170630,170630,0,0,0,44,0.5,34.79649948265586,6
2020-05-04-170630,170630,0,0,0,44,2.5,33.65765968161824,0
2020-05-05-170630,170630,1,0,0,45,1.8333333333333333,47.72349849894556,1
2020-05-06-170630,170630,1,0,0,46,1.5,53.088877841581436,2
2020-05-07-170630,170630,0,0,0,46,1.6666666666666667,86.79724069929023,3
2020-05-08-170630,170630,0,0,0,46,0.5,105.66797490262172,4
2020-05-09-170630,170630,0,0,0,46,1.5,114.41234202679462,5
2020-05-10-170630,170630,0,1,1,46,0.3333333333333333,97.65989215264133,6
2020-05-11-170630,170630,0,1,0,46,1.1666666666666667,86.00238304851936,0
2020-05-12-170630,170630,0,1,0,46,0.8333333333333334,86.48672128483713,1
2020-05-13-170630,170630,0,0,0,46,1.0,67.72224207526227,2
2020-05-14-170630,170630,0,0,0,46,0.0,58.45375738898227,3
2020-05-15-170630,170630,0,0,0,46,0.3333333333333333,48.909839135485015,4
2020-05-16-170630,170630,0,0,0,46,0.16666666666666666,42.06073306080505,5
2020-05-17-170630,170630,0,0,0,46,0.16666666666666666,38.66702161487035,6
2020-05-18-170630,170630,0,0,0,46,2.833333333333333,38.89671553155885,0
2020-05-19-170630,170630,0,0,0,46,0.3333333333333333,35.09965748160775,1
2020-05-20-170630,170630,0,0,0,46,0.3333333333333333,27.827164921148512,2
2020-05-21-170630,170630,0,0,1,46,0.6666666666666666,26.59064892363258,3
2020-05-22-170630,170630,0,0,0,46,0.8333333333333334,28.507834855430367,4
2020-05-23-170630,170630,0,0,0,46,0.16666666666666666,35.1471552814982,5
2020-05-24-170630,170630,1,0,0,47,0.16666666666666666,36.37157108513662,6
2020-05-25-170630,170630,0,0,0,47,0.8333333333333334,31.69722757682192,0
2020-05-26-170630,170630,0,0,0,47,0.16666666666666666,33.684758394825856,1
2020-05-27-170630,170630,0,0,0,47,0.3333333333333333,30.782657006848986,2
2020-05-28-170630,170630,0,0,1,47,0.8333333333333334,36.914090430974056,3
2020-05-29-170630,170630,0,0,0,47,1.0,42.42892107748457,4
2020-05-30-170630,170630,0,0,0,47,0.16666666666666666,55.837973037630405,5
2020-05-31-170630,170630,0,0,0,47,0.0,54.061974579311894,6
2020-06-01-170630,170630,0,0,1,47,0.3333333333333333,146.6821449626347,0
2020-06-02-170630,170630,0,0,0,47,0.5,23.176474105662955,1
2020-06-03-170630,170630,0,0,0,47,0.3333333333333333,13.768163974255376,2
2020-06-04-170630,170630,1,0,0,48,1.3333333333333333,19.82942117317176,3
2020-06-05-170630,170630,0,0,1,48,0.5,29.886818654637317,4
2020-06-06-170630,170630,0,0,0,48,0.0,38.02564874610474,5
2020-06-07-170630,170630,0,0,0,48,0.16666666666666666,37.70511070977313,6
2020-06-08-170630,170630,0,0,0,48,0.16666666666666666,38.34344671853698,0
2020-06-09-170630,170630,0,1,1,48,0.16666666666666666,36.99018399533102,1
2020-06-10-170630,170630,0,0,0,48,0.0,150.38234908871155,2
2020-06-11-170630,170630,1,0,0,49,1.0,132.89782153863942,3
2020-06-12-170630,170630,0,0,0,49,0.0,126.5790580673673,4
2020-06-13-170630,170630,0,0,0,49,0.16666666666666666,76.67512872586686,5
2020-06-14-170630,170630,0,0,0,49,0.0,40.55603555851154,6
2020-06-15-170630,170630,1,0,0,50,0.16666666666666666,27.04277835920181,0
2020-06-16-170630,170630,0,0,0,50,0.0,26.030101042074556,1
2020-06-17-170630,170630,0,0,0,50,0.16666666666666666,21.605073068173386,2
2020-06-18-170630,170630,0,0,0,50,0.3333333333333333,20.93495522355407,3
2020-06-19-170630,170630,1,0,0,51,0.5,19.05787591479706,4
2020-06-20-170630,170630,0,0,0,51,0.0,28.490698382899744,5
2020-06-21-170630,170630,0,0,0,51,0.0,28.490150140019892,6
2020-06-22-170630,170630,0,0,0,51,0.6666666666666666,25.107608832316394,0
2020-06-23-170630,170630,1,0,0,52,0.3333333333333333,39.42144419968137,1
2020-06-24-170630,170630,0,0,0,52,0.0,41.96135210182218,2
2020-06-25-170630,170630,0,2,0,52,0.16666666666666666,35.96482272998127,3
2020-06-26-170630,170630,0,0,0,52,0.16666666666666666,31.039399498649693,4
2020-06-27-170630,170630,0,0,0,52,0.0,27.029279181018158,5
2020-06-28-170630,170630,0,0,0,52,0.3333333333333333,27.692706777805448,6
2020-06-29-170630,170630,0,0,0,52,0.3333333333333333,28.172045723752095,0
2020-06-30-170630,170630,0,0,0,52,0.16666666666666666,19.453980755781068,1
2020-07-01-170630,170630,0,0,0,52,0.16666666666666666,38.62484458162208,2
2020-07-02-170630,170630,0,0,0,52,0.16666666666666666,14.468655122729214,3
2020-07-03-170630,170630,0,0,0,52,0.16666666666666666,23.0629715443692,4
2020-07-04-170630,170630,0,0,0,52,0.16666666666666666,25.803008759951098,5
2020-07-05-170630,170630,0,0,0,52,0.16666666666666666,24.70384190273475,6
2020-07-06-170630,170630,0,0,0,52,0.5,24.70148064887823,0
2020-07-07-170630,170630,0,0,0,52,0.16666666666666666,25.75355340408112,1
2020-07-08-170630,170630,0,0,0,52,0.0,19.18297795798845,2
2020-07-09-170630,170630,0,0,0,52,0.0,17.197107451167067,3
2020-07-10-170630,170630,0,0,0,52,0.0,38.07627496429748,4
2020-07-11-170630,170630,0,0,0,52,0.0,23.595698728775098,5
2020-07-12-170630,170630,0,1,0,52,0.3333333333333333,13.56586888973668,6
2020-07-13-170630,170630,0,0,0,52,0.3333333333333333,19.064958653605046,0
2020-07-14-170630,170630,0,0,0,52,0.5,19.958743488562746,1
2020-07-15-170630,170630,0,0,0,52,0.16666666666666666,26.29561989067078,2
2020-07-16-170630,170630,0,0,0,52,0.5,19.401499934991314,3
2020-07-17-170630,170630,0,0,0,52,0.0,21.462572620046622,4
2020-07-18-170630,170630,0,0,3,52,0.0,22.202680043272,5
2020-07-19-170630,170630,0,1,0,52,0.0,21.978560518997035,6
2020-07-20-170630,170630,0,0,0,52,0.16666666666666666,14.70321334312744,0
2020-07-21-170630,170630,0,0,1,52,0.3333333333333333,8.084855182744187,1
2020-07-22-170630,170630,0,0,0,52,0.16666666666666666,14.685247362178334,2
2020-07-23-170630,170630,0,0,0,52,1.0,16.854227041555063,3
2020-07-24-170630,170630,0,0,1,52,0.3333333333333333,25.25787578066609,4
2020-07-25-170630,170630,0,0,0,52,0.16666666666666666,27.015561971607774,5
2020-07-26-170630,170630,0,0,0,52,0.16666666666666666,27.423345315508502,6
2020-07-27-170630,170630,0,0,1,52,0.0,28.194671702132915,0
2020-07-28-170630,170630,0,0,0,52,0.3333333333333333,26.90462061970493,1
2020-07-29-170630,170630,0,0,0,52,0.3333333333333333,23.89442259192792,2
2020-07-30-170630,170630,0,0,0,52,0.5,19.346151027660483,3
2020-07-31-170630,170630,0,0,0,52,0.3333333333333333,23.60402348628555,4
2020-08-01-170630,170630,3,0,0,55,0.3333333333333333,13.407725542634738,5
2020-08-02-170630,170630,0,0,0,55,0.16666666666666666,107.4714964671912,6
2020-08-03-170630,170630,0,0,1,55,0.5,116.3154638549435,0
2020-08-04-170630,170630,1,0,0,56,0.16666666666666666,101.82991099886398,1
2020-08-05-170630,170630,0,0,0,56,0.3333333333333333,96.9695784061062,2
2020-08-06-170630,170630,0,0,0,56,0.16666666666666666,80.14414272471868,3
2020-08-07-170630,170630,1,1,0,57,1.0,74.70355038475738,4
2020-08-08-170630,170630,0,0,0,57,0.3333333333333333,71.9600679527316,5
2020-08-09-170630,170630,0,0,0,57,0.0,72.91244729477239,6
2020-08-10-170630,170630,1,0,0,58,1.0,22.251957614236314,0
2020-08-11-170630,170630,0,0,0,58,2.6666666666666665,36.20718470378758,1
2020-08-12-170630,170630,0,0,0,58,0.5,56.10610230446862,2
2020-08-13-170630,170630,0,0,1,58,1.1666666666666667,61.37746220102782,3
2020-08-14-170630,170630,0,1,0,58,1.8333333333333333,84.73934541083585,4
2020-08-15-170630,170630,0,0,0,58,1.0,97.02831133147629,5
2020-08-16-170630,170630,0,0,0,58,0.3333333333333333,107.85178046375144,6
2020-08-17-170630,170630,1,0,0,59,0.8333333333333334,102.37932974982613,0
2020-08-18-170630,170630,0,0,3,59,1.6666666666666667,106.47362356977902,1
2020-08-19-170630,170630,0,0,0,59,1.5,102.23462882749044,2
2020-08-20-170630,170630,0,0,0,59,2.0,97.12821601468646,3
2020-08-21-170630,170630,0,0,0,59,1.8333333333333333,110.763653827902,4
2020-08-22-170630,170630,0,0,0,59,0.5,127.71456613843368,5
2020-08-23-170630,170630,0,0,0,59,0.16666666666666666,122.09810504868312,6
2020-08-24-170630,170630,0,0,0,59,1.8333333333333333,104.73855250517131,0
2020-08-25-170630,170630,0,0,1,59,1.0,109.42037553514018,1
2020-08-26-170630,170630,0,0,1,59,1.1666666666666667,109.74210405915736,2
2020-08-27-170630,170630,1,0,1,60,2.0,118.70875092317543,3
2020-08-28-170630,170630,0,0,0,60,0.6666666666666666,117.27084417997818,4
2020-08-29-170630,170630,0,0,0,60,0.6666666666666666,101.30845241003698,5
2020-08-30-170630,170630,0,0,0,60,1.0,118.95299085504396,6
2020-08-31-170630,170630,0,0,0,60,0.5,105.42679478976008,0
2020-09-01-170630,170630,3,0,0,63,1.1666666666666667,59.821196445321384,1
2020-09-02-170630,170630,0,0,0,63,0.8333333333333334,169.05230751923776,2
2020-09-03-170630,170630,0,0,0,63,1.3333333333333333,228.23989459727028,3
2020-09-04-170630,170630,0,0,0,63,2.0,187.68834085385083,4
2020-09-05-170630,170630,0,0,0,63,0.0,174.07356636302853,5
2020-09-06-170630,170630,0,0,0,63,0.16666666666666666,136.69076962437668,6
2020-09-07-170630,170630,0,0,0,63,0.8333333333333334,138.10247863866783,0
2020-09-08-170630,170630,1,0,0,64,1.0,140.67602199614475,1
2020-09-09-170630,170630,1,0,1,65,0.6666666666666666,126.50375636064746,2
2020-09-10-170630,170630,1,0,0,66,2.833333333333333,70.27743056350971,3
2020-09-11-170630,170630,0,0,1,66,1.0,95.13653805474168,4
2020-09-12-170630,170630,0,0,0,66,0.16666666666666666,112.35017838457073,5
2020-09-13-170630,170630,0,0,0,66,0.8333333333333334,113.38833976829888,6
2020-09-14-170630,170630,0,0,0,66,2.6666666666666665,106.57717020767572,0
2020-09-15-170630,170630,0,0,0,66,0.6666666666666666,125.75399011364176,1
2020-09-16-170630,170630,0,0,0,66,0.8333333333333334,135.36428113809615,2
2020-09-17-170630,170630,0,0,1,66,1.8333333333333333,120.14300883856768,3
2020-09-18-170630,170630,0,0,1,66,5.833333333333332,112.19866982759216,4
2020-09-19-170630,170630,0,0,0,66,0.8333333333333334,141.53011756467083,5
2020-09-20-170630,170630,0,0,2,66,0.8333333333333334,152.72532047567847,6
2020-09-21-170630,170630,0,0,1,66,4.833333333333333,135.71278935406403,0
2020-09-22-170630,170630,0,0,2,66,3.0,167.46044510977345,1
2020-09-23-170630,170630,1,0,5,67,0.5,201.61856005405036,2
2020-09-24-170630,170630,0,0,0,67,3.1666666666666665,203.2623226389332,3
2020-09-25-170630,170630,1,0,1,68,5.833333333333332,200.97577934830463,4
2020-09-26-170630,170630,0,0,0,68,5.166666666666667,215.51794705692345,5
2020-09-27-170630,170630,0,0,0,68,0.5,238.03897277864672,6
2020-09-28-170630,170630,0,0,0,68,0.6666666666666666,239.8000725039901,0
2020-09-29-170630,170630,0,0,0,68,1.6666666666666667,215.8338416764908,1
2020-09-30-170630,170630,0,0,0,68,1.1666666666666667,190.38656784328097,2
2020-10-01-170630,170630,1,0,0,69,2.0,0.0,3
2020-10-02-170630,170630,1,0,2,70,0.8333333333333334,196.46704081267814,4
2020-10-03-170630,170630,0,0,1,70,0.6666666666666666,233.5950184520639,5
2020-10-04-170630,170630,2,0,1,72,0.5,214.70967563629992,6
2020-10-05-170630,170630,1,0,1,73,1.0,199.5713535210702,0
2020-10-06-170630,170630,2,0,0,75,1.3333333333333333,186.0492907795146,1
2020-10-07-170630,170630,5,0,0,80,1.3333333333333333,175.68558307003792,2
2020-10-08-170630,170630,0,1,1,80,0.5,161.20416006310222,3
2020-10-09-170630,170630,1,1,3,81,2.0,173.57040412271482,4
2020-10-10-170630,170630,0,0,0,81,0.5,27.211691667458826,5
2020-10-11-170630,170630,0,0,1,81,0.6666666666666666,41.22375107808941,6
2020-10-12-170630,170630,0,0,0,81,0.6666666666666666,58.79931855254591,0
2020-10-13-170630,170630,0,0,2,81,1.1666666666666667,71.89560194734665,1
2020-10-14-170630,170630,0,0,0,81,2.1666666666666665,101.2629522775758,2
2020-10-15-170630,170630,0,0,0,81,0.3333333333333333,129.83571645988914,3
2020-10-16-170630,170630,2,0,1,83,3.333333333333333,154.7867858025906,4
2020-10-17-170630,170630,1,0,0,84,0.8333333333333334,170.31696321436687,5
2020-10-18-170630,170630,1,0,0,85,0.5,164.4269900206531,6
2020-10-19-170630,170630,1,0,1,86,3.333333333333333,152.47840082635463,0
2020-10-20-170630,170630,0,0,1,86,2.1666666666666665,181.18995192018394,1
2020-10-21-170630,170630,0,0,2,86,1.5,199.51760223883247,2
2020-10-22-170630,170630,1,0,2,87,1.6666666666666667,205.07572518290235,3
2020-10-23-170630,170630,3,0,2,90,2.6666666666666665,202.65691541481527,4
2020-10-24-170630,170630,0,0,0,90,0.5,219.6853806776277,5
2020-10-25-170630,170630,1,0,0,91,0.5,221.11112059776954,6
2020-10-26-170630,170630,0,0,1,91,3.8333333333333335,192.85520226723725,0
2020-10-27-170630,170630,2,0,4,93,2.5,207.5907706122072,1
2020-10-28-170630,170630,0,0,4,93,2.5,199.90064973588045,2
2020-10-29-170630,170630,0,0,0,93,3.0,204.82047108396324,3
2020-10-30-170630,170630,1,0,0,94,3.0,180.25844300609828,4
2020-10-31-170630,170630,0,1,0,94,2.0,212.1173395308786,5
2020-11-01-170630,170630,0,1,0,94,1.5,157.06587171337608,6
2020-11-02-170630,170630,1,0,0,95,1.5,81.23982033592962,0
2020-11-03-170630,170630,1,0,0,96,1.6666666666666667,92.66060811651619,1
2020-11-04-170630,170630,2,0,0,98,3.8333333333333335,118.32861485894449,2
2020-11-05-170630,170630,2,0,0,100,1.3333333333333333,154.8038075153975,3
2020-11-06-170630,170630,2,0,0,102,3.5,162.004211866622,4
2020-11-07-170630,170630,0,0,0,102,0.8333333333333334,183.04008687525385,5
2020-11-08-170630,170630,0,1,0,102,1.6666666666666667,175.26330812321925,6
2020-11-09-170630,170630,1,0,0,103,2.6666666666666665,146.5876959063458,0
2020-11-10-170630,170630,4,0,0,107,0.8333333333333334,148.01905237022953,1
2020-11-11-170630,170630,4,0,0,111,1.5,152.73806790334973,2
2020-11-12-170630,170630,0,0,0,111,1.5,162.92463993325552,3
2020-11-13-170630,170630,0,0,0,111,2.5,163.37923056398034,4
2020-03-01-170631,170631,0,0,6,0,0.0,0.0,6
2020-03-02-170631,170631,0,1,13,0,0.2,217.8359619876623,0
2020-03-03-170631,170631,0,0,18,0,0.8,1006.6874912311679,1
2020-03-04-170631,170631,0,0,8,0,0.0,1099.8884826962192,2
2020-03-05-170631,170631,0,0,13,0,0.2,1143.405427749624,3
2020-03-06-170631,170631,0,0,23,0,0.2,989.5955727586338,4
2020-03-07-170631,170631,0,0,5,0,0.0,1053.2859512900993,5
2020-03-08-170631,170631,0,0,3,0,0.2,1001.3397970464567,6
2020-03-09-170631,170631,0,0,27,0,0.4,993.730753361171,0
2020-03-10-170631,170631,0,0,18,0,0.8,1620.348662543691,1
2020-03-11-170631,170631,1,0,13,1,1.0,1211.4079365722291,2
2020-03-12-170631,170631,0,0,22,1,1.0,937.162070271607,3
2020-03-13-170631,170631,1,0,24,2,3.0,630.0514866219605,4
2020-03-14-170631,170631,4,0,9,6,4.6,610.9589351951544,5
2020-03-15-170631,170631,6,0,9,12,9.6,574.40873773977,6
2020-03-16-170631,170631,13,0,25,25,13.0,424.5679257393547,0
2020-03-17-170631,170631,18,1,9,43,17.4,711.3078416310908,1
2020-03-18-170631,170631,8,0,10,51,16.0,986.6137241334865,2
2020-03-19-170631,170631,13,0,11,64,20.6,1177.0095869188235,3
2020-03-20-170631,170631,23,0,14,87,21.0,1288.358555197738,4
2020-03-21-170631,170631,5,0,2,92,8.4,1436.8651213794806,5
2020-03-22-170631,170631,3,0,5,95,9.8,1391.8007820443618,6
2020-03-23-170631,170631,27,0,8,122,37.2,1294.5833694893854,0
2020-03-24-170631,170631,18,0,3,140,26.2,1489.6607679677347,1
2020-03-25-170631,170631,13,0,2,153,29.0,1597.894050338471,2
2020-03-26-170631,170631,22,0,5,175,27.0,1714.5674116886908,3
2020-03-27-170631,170631,24,0,4,199,24.2,2022.3147165747491,4
2020-03-28-170631,170631,9,0,0,208,6.6,2054.5984185548227,5
2020-03-29-170631,170631,9,0,1,217,7.4,2013.9211889718217,6
2020-03-30-170631,170631,25,0,6,242,23.2,1553.0195985196626,0
2020-03-31-170631,170631,9,0,0,251,16.8,1501.2974242347077,1
2020-04-01-170631,170631,10,0,5,261,17.4,206.66212900303913,2
2020-04-02-170631,170631,11,0,19,272,8.2,630.4311700054258,3
2020-04-03-170631,170631,14,0,13,286,12.4,362.9203971391633,4
2020-04-04-170631,170631,2,0,2,288,3.4,495.4757347724971,5
2020-04-05-170631,170631,5,0,0,293,2.2,509.0363463990161,6
2020-04-06-170631,170631,8,1,4,301,15.8,542.9992459226058,0
2020-04-07-170631,170631,3,0,6,304,13.2,637.4387825826815,1
2020-04-08-170631,170631,2,0,5,306,8.8,701.9084876613575,2
2020-04-09-170631,170631,5,0,3,311,5.8,739.6182499010399,3
2020-04-10-170631,170631,4,0,1,315,7.6,206.8771935505752,4
2020-04-11-170631,170631,0,0,1,315,3.4,276.2460500919758,5
2020-04-12-170631,170631,1,0,0,316,6.0,310.4380167430719,6
2020-04-13-170631,170631,6,0,4,322,9.8,347.82157746477213,0
2020-04-14-170631,170631,0,0,3,322,13.8,486.47342022954945,1
2020-04-15-170631,170631,5,0,6,327,5.4,594.7565844677285,2
2020-04-16-170631,170631,19,0,4,346,8.0,672.4547189933531,3
2020-04-17-170631,170631,13,0,0,359,6.6,615.3772927792443,4
2020-04-18-170631,170631,2,0,1,361,5.4,653.6573889129775,5
2020-04-19-170631,170631,0,0,0,361,1.2,671.4388406014433,6
2020-04-20-170631,170631,4,0,3,365,8.8,622.7851456993202,0
2020-04-21-170631,170631,6,0,1,371,10.8,611.5412349896085,1
2020-04-22-170631,170631,5,0,1,376,11.2,633.668796186615,2
2020-04-23-170631,170631,3,0,2,379,2.2,620.4120486249849,3
2020-04-24-170631,170631,1,1,5,380,5.2,533.8935880045218,4
2020-04-25-170631,170631,1,0,1,381,2.2,527.7613903463352,5
2020-04-26-170631,170631,0,0,0,381,3.0,545.0297153008032,6
2020-04-27-170631,170631,4,0,4,385,8.8,455.06814370164307,0
2020-04-28-170631,170631,3,0,5,388,4.2,451.57298738346003,1
2020-04-29-170631,170631,6,0,3,394,5.8,401.37771177262505,2
2020-04-30-170631,170631,4,0,4,398,5.4,516.0037104861209,3
2020-05-01-170631,170631,0,0,1,398,4.2,684.0482773739902,4
2020-05-02-170631,170631,1,0,0,399,1.8,288.6529862577538,5
2020-05-03-170631,170631,0,0,1,399,1.0,179.76564343085045,6
2020-05-04-170631,170631,3,0,1,402,9.0,159.410956005272,0
2020-05-05-170631,170631,1,0,7,403,5.0,230.70423792764797,1
2020-05-06-170631,170631,1,0,2,404,5.0,264.2424939506092,2
2020-05-07-170631,170631,2,0,4,406,4.2,316.7768320758038,3
2020-05-08-170631,170631,5,0,1,411,8.4,347.45383150529733,4
2020-05-09-170631,170631,1,0,0,412,1.8,460.0745326665898,5
2020-05-10-170631,170631,0,2,1,412,0.8,747.6425802373242,6
2020-05-11-170631,170631,4,0,0,416,9.0,693.9632801262267,0
2020-05-12-170631,170631,5,0,2,421,10.6,729.9452556540407,1
2020-05-13-170631,170631,3,0,0,424,6.6,639.6950981295589,2
2020-05-14-170631,170631,4,1,2,428,2.2,576.2008708113524,3
2020-05-15-170631,170631,1,0,6,429,6.4,502.32871494849167,4
2020-05-16-170631,170631,0,0,0,429,1.0,503.67585515771776,5
2020-05-17-170631,170631,1,0,0,430,0.0,469.33124908938635,6
2020-05-18-170631,170631,1,0,1,431,3.4,470.68551090796734,0
2020-05-19-170631,170631,7,0,0,438,2.8,421.0480208422811,1
2020-05-20-170631,170631,2,0,2,440,3.0,297.9946178386914,2
2020-05-21-170631,170631,4,0,1,444,2.8,293.29248966237725,3
2020-05-22-170631,170631,1,0,1,445,4.0,256.1555947082005,4
2020-05-23-170631,170631,0,0,0,445,0.2,298.6503405791919,5
2020-05-24-170631,170631,1,0,0,446,0.0,302.11170732600806,6
2020-05-25-170631,170631,0,0,1,446,3.2,252.08857933113808,0
2020-05-26-170631,170631,2,0,3,448,2.0,230.83908941297892,1
2020-05-27-170631,170631,0,0,2,448,2.4,234.09240476425933,2
2020-05-28-170631,170631,2,2,7,450,2.0,226.64263056762866,3
2020-05-29-170631,170631,6,0,0,456,3.6,222.41944516671288,4
2020-05-30-170631,170631,0,0,0,456,0.2,243.50206993631974,5
2020-05-31-170631,170631,0,0,0,456,0.0,245.5085834329538,6
2020-06-01-170631,170631,1,0,2,457,3.8,570.8608281057435,0
2020-06-02-170631,170631,0,0,3,457,0.6,155.83233014351663,1
2020-06-03-170631,170631,2,0,3,459,1.2,113.18379597398831,2
2020-06-04-170631,170631,1,0,4,460,2.0,116.06688750125683,3
2020-06-05-170631,170631,1,0,1,461,3.6,151.63289830328162,4
2020-06-06-170631,170631,0,1,0,461,0.0,176.86164046179684,5
2020-06-07-170631,170631,0,0,0,461,0.2,177.75788257056365,6
2020-06-08-170631,170631,1,0,2,462,1.4,181.63784922033594,0
2020-06-09-170631,170631,3,0,2,465,1.6,192.48064748406728,1
2020-06-10-170631,170631,2,0,0,467,1.8,652.9103250913577,2
2020-06-11-170631,170631,7,0,1,474,2.6,560.9184706568358,3
2020-06-12-170631,170631,0,0,1,474,0.2,525.509100762948,4
2020-06-13-170631,170631,0,0,0,474,0.0,399.3407085254188,5
2020-06-14-170631,170631,0,0,0,474,0.0,295.0678887381463,6
2020-06-15-170631,170631,2,0,3,476,1.4,175.2490853804076,0
2020-06-16-170631,170631,3,0,2,479,2.0,177.60052751284405,1
2020-06-17-170631,170631,3,0,6,482,1.6,144.49627418908807,2
2020-06-18-170631,170631,4,0,1,486,1.8,141.39492742559003,3
2020-06-19-170631,170631,1,0,1,487,2.0,132.0302336317919,4
2020-06-20-170631,170631,0,2,0,487,0.0,200.16856857276946,5
2020-06-21-170631,170631,0,0,0,487,0.0,201.16774945678878,6
2020-06-22-170631,170631,2,0,1,489,1.8,174.395384723645,0
2020-06-23-170631,170631,2,0,0,491,2.2,179.6456961781114,1
2020-06-24-170631,170631,0,0,1,491,0.8,185.06411445884245,2
2020-06-25-170631,170631,1,1,1,492,0.8,161.8430123051695,3
2020-06-26-170631,170631,1,0,1,493,2.2,139.45724846579395,4
2020-06-27-170631,170631,0,0,0,493,0.2,137.11500106140636,5
2020-06-28-170631,170631,0,0,0,493,0.0,138.96140728909342,6
2020-06-29-170631,170631,3,0,1,496,1.6,137.41541006657695,0
2020-06-30-170631,170631,2,0,0,498,0.4,128.0600187875458,1
2020-07-01-170631,170631,6,0,0,504,0.8,205.4627839078479,2
2020-07-02-170631,170631,1,0,3,505,0.6,72.46479480759602,3
2020-07-03-170631,170631,1,0,1,506,0.8,113.01667074888607,4
2020-07-04-170631,170631,0,1,0,506,0.0,162.06884438352466,5
2020-07-05-170631,170631,0,0,0,506,0.0,155.50664970894115,6
2020-07-06-170631,170631,1,0,1,507,0.4,130.4308188115847,0
2020-07-07-170631,170631,0,0,16,507,0.8,124.68647019215223,1
2020-07-08-170631,170631,1,0,0,508,0.0,115.3534586930259,2
2020-07-09-170631,170631,1,0,3,509,0.4,104.69066125382612,3
2020-07-10-170631,170631,1,0,0,510,0.4,217.36447761989467,4
2020-07-11-170631,170631,0,0,0,510,0.0,169.02454888054496,5
2020-07-12-170631,170631,0,0,0,510,0.2,112.08861516360584,6
2020-07-13-170631,170631,1,0,3,511,0.8,113.96854919839956,0
2020-07-14-170631,170631,0,0,0,511,0.8,123.43473685107651,1
2020-07-15-170631,170631,0,0,3,511,0.4,108.30039801907382,2
2020-07-16-170631,170631,3,0,2,514,0.8,83.81636926929258,3
2020-07-17-170631,170631,1,0,5,515,0.4,72.32568127862444,4
2020-07-18-170631,170631,0,0,0,515,0.0,73.82955848367205,5
2020-07-19-170631,170631,0,0,1,515,0.0,73.71323043826835,6
2020-07-20-170631,170631,1,0,1,516,0.6,64.2454044251344,0
2020-07-21-170631,170631,16,0,5,532,0.6,66.59239840988317,1
2020-07-22-170631,170631,0,0,5,532,1.0,110.97492021903439,2
2020-07-23-170631,170631,3,0,3,535,1.0,104.65228957138437,3
2020-07-24-170631,170631,0,0,6,535,0.2,113.6108848064448,4
2020-07-25-170631,170631,0,0,3,535,0.0,125.40143160923913,5
2020-07-26-170631,170631,0,0,1,535,0.8,126.27632294235997,6
2020-07-27-170631,170631,3,0,5,538,0.2,124.07274094701765,0
2020-07-28-170631,170631,0,0,1,538,0.6,127.64194927700302,1
2020-07-29-170631,170631,3,0,7,541,0.4,91.12303397114079,2
2020-07-30-170631,170631,2,0,3,543,0.6,95.39279083871673,3
2020-07-31-170631,170631,5,0,4,548,3.0,111.89687137551655,4
2020-08-01-170631,170631,0,0,1,548,1.0,76.48098965750063,5
2020-08-02-170631,170631,1,0,2,549,1.0,536.182475034903,6
2020-08-03-170631,170631,1,0,12,550,3.0,798.1115834778202,0
2020-08-04-170631,170631,5,0,3,555,2.6,738.9090707869074,1
2020-08-05-170631,170631,5,0,9,560,3.8,611.9250501736094,2
2020-08-06-170631,170631,3,0,13,563,2.8,589.482249280122,3
2020-08-07-170631,170631,6,0,7,569,4.4,482.61231199407723,4
2020-08-08-170631,170631,3,0,0,572,2.0,515.6324641141825,5
2020-08-09-170631,170631,1,0,0,573,0.2,511.75814632059445,6
2020-08-10-170631,170631,5,0,19,578,3.6,57.30817604298583,0
2020-08-11-170631,170631,1,1,8,579,1.8,116.09823352702978,1
2020-08-12-170631,170631,7,1,25,586,5.4,170.40256204828057,2
2020-08-13-170631,170631,3,0,6,589,3.6,241.35670913535472,3
2020-08-14-170631,170631,4,0,10,593,3.8,325.6674319905745,4
2020-08-15-170631,170631,1,0,2,594,1.8,393.67954975107995,5
2020-08-16-170631,170631,2,0,1,596,1.8,412.4504637555556,6
2020-08-17-170631,170631,12,0,16,608,5.8,431.1826757553276,0
2020-08-18-170631,170631,3,0,3,611,5.2,480.7917920797264,1
2020-08-19-170631,170631,9,0,5,620,4.2,495.3690691938639,2
2020-08-20-170631,170631,13,0,3,633,6.6,441.13517817238505,3
2020-08-21-170631,170631,7,0,17,640,4.4,484.16172847537814,4
2020-08-22-170631,170631,0,0,9,640,0.8,540.8540585126295,5
2020-08-23-170631,170631,0,0,1,640,4.2,531.8204523293724,6
2020-08-24-170631,170631,19,0,5,659,7.8,453.78642631115235,0
2020-08-25-170631,170631,8,0,0,667,5.8,529.5976240439004,1
2020-08-26-170631,170631,25,0,3,692,8.2,557.5955854673028,2
2020-08-27-170631,170631,6,0,6,698,6.4,697.5089323775624,3
2020-08-28-170631,170631,10,0,10,708,7.2,675.7418805226671,4
2020-08-29-170631,170631,2,0,2,710,3.2,743.7911647097292,5
2020-08-30-170631,170631,1,0,0,711,2.0,791.5672436875466,6
2020-08-31-170631,170631,16,0,19,727,8.8,683.3869469810638,0
2020-09-01-170631,170631,3,0,2,730,5.6,495.1590918766789,1
2020-09-02-170631,170631,5,0,10,735,5.2,744.0832571857882,2
2020-09-03-170631,170631,3,0,8,738,8.4,742.0030938919815,3
2020-09-04-170631,170631,17,0,11,755,11.2,722.6130635533455,4
2020-09-05-170631,170631,9,0,0,764,4.6,782.6155624749446,5
2020-09-06-170631,170631,1,0,0,765,1.6,812.0484234798215,6
2020-09-07-170631,170631,5,0,8,770,10.8,818.7612653431144,0
2020-09-08-170631,170631,0,0,17,770,2.8,879.3138406236164,1
2020-09-09-170631,170631,3,0,11,773,6.0,787.2532021263604,2
2020-09-10-170631,170631,6,0,10,779,4.4,442.84089281509796,3
2020-09-11-170631,170631,10,0,9,789,10.2,517.6176065317089,4
2020-09-12-170631,170631,2,0,0,791,2.2,645.9075735087251,5
2020-09-13-170631,170631,0,0,0,791,0.8,650.3168473134829,6
2020-09-14-170631,170631,19,0,5,810,13.6,602.9185940524231,0
2020-09-15-170631,170631,2,0,8,812,6.6,785.7220426603325,1
2020-09-16-170631,170631,10,0,8,822,5.0,914.2648218313628,2
2020-09-17-170631,170631,8,0,5,830,7.6,896.7855736731619,3
2020-09-18-170631,170631,11,0,4,841,9.6,891.9864558099182,4
2020-09-19-170631,170631,0,1,0,841,2.4,838.4396064061926,5
2020-09-20-170631,170631,0,0,2,841,3.6,887.8904919752316,6
2020-09-21-170631,170631,8,0,8,849,12.6,724.5437756792271,0
2020-09-22-170631,170631,17,0,8,866,9.8,812.5519676883396,1
2020-09-23-170631,170631,11,0,9,877,8.8,891.6464262398956,2
2020-09-24-170631,170631,10,0,11,887,9.6,920.0879239707999,3
2020-09-25-170631,170631,9,0,16,896,9.0,904.7263897869166,4
2020-09-26-170631,170631,0,0,1,896,3.4,987.9027048753189,5
2020-09-27-170631,170631,0,0,1,896,2.0,947.8648047669583,6
2020-09-28-170631,170631,5,1,2,901,5.2,943.7428998312535,0
2020-09-29-170631,170631,8,0,17,909,6.4,878.3269039594206,1
2020-09-30-170631,170631,8,0,12,917,6.4,841.8174792142428,2
2020-10-01-170631,170631,5,0,11,922,6.0,0.0,3
2020-10-02-170631,170631,4,0,13,926,6.6,1848.091283603284,4
2020-10-03-170631,170631,0,0,0,926,2.8,2201.9829323149556,5
2020-10-04-170631,170631,2,0,1,928,3.2,1966.0212330410945,6
2020-10-05-170631,170631,8,0,12,936,18.0,1636.5251573369137,0
2020-10-06-170631,170631,8,0,9,944,9.2,1482.7829302751413,1
2020-10-07-170631,170631,9,0,10,953,11.4,1286.4280956073908,2
2020-10-08-170631,170631,11,0,10,964,9.4,1247.2285037295571,3
2020-10-09-170631,170631,16,0,14,980,10.6,1411.7279755053269,4
2020-10-10-170631,170631,1,0,0,981,4.2,109.83264910823065,5
2020-10-11-170631,170631,1,0,3,982,5.8,221.0621086129505,6
2020-10-12-170631,170631,2,0,13,984,5.0,342.5006326925138,0
2020-10-13-170631,170631,17,0,15,1001,13.0,433.68307837629027,1
2020-10-14-170631,170631,12,0,15,1013,12.2,723.6979695427594,2
2020-10-15-170631,170631,11,0,9,1024,11.6,978.9957636464037,3
2020-10-16-170631,170631,13,0,12,1037,20.6,1278.8387897843168,4
2020-10-17-170631,170631,0,0,3,1037,4.2,1553.3407677190576,5
2020-10-18-170631,170631,1,0,4,1038,11.2,1524.6575672168653,6
2020-10-19-170631,170631,12,1,3,1050,17.8,1537.2421452511426,0
2020-10-20-170631,170631,9,0,13,1059,21.0,1685.0202483064472,1
2020-10-21-170631,170631,10,0,14,1069,23.0,1781.2058402011407,2
2020-10-22-170631,170631,10,0,11,1079,23.4,1869.9274633889027,3
2020-10-23-170631,170631,14,0,14,1093,26.4,1903.8716455293552,4
2020-10-24-170631,170631,0,1,1,1093,6.6,2218.012073359726,5
2020-10-25-170631,170631,3,0,2,1096,12.6,2169.7438491192493,6
2020-10-26-170631,170631,13,0,12,1109,20.0,1990.976158628691,0
2020-10-27-170631,170631,15,0,10,1124,21.8,2268.154189197608,1
2020-10-28-170631,170631,15,0,5,1139,17.6,2310.1353349542355,2
2020-10-29-170631,170631,9,0,5,1148,13.2,2286.647098678608,3
2020-10-30-170631,170631,12,0,4,1160,21.6,1788.2771339407643,4
2020-10-31-170631,170631,3,0,0,1163,6.8,2034.3856243887167,5
2020-11-01-170631,170631,4,3,0,1167,6.0,1255.5354998910234,6
2020-11-02-170631,170631,3,0,0,1170,2.8,735.6124383554989,0
2020-11-03-170631,170631,13,0,0,1183,18.0,693.6222796887159,1
2020-11-04-170631,170631,14,0,0,1197,14.6,958.5223536097449,2
2020-11-05-170631,170631,11,0,0,1208,13.0,1163.7727441457002,3
2020-11-06-170631,170631,14,1,0,1222,10.2,1274.6337048267244,4
2020-11-07-170631,170631,1,0,0,1223,3.2,1395.8791605296287,5
2020-11-08-170631,170631,2,0,0,1225,5.2,1328.151580947065,6
2020-11-09-170631,170631,12,0,0,1237,16.4,1337.794541237059,0
2020-11-10-170631,170631,10,1,0,1247,8.0,1250.5659585767012,1
2020-11-11-170631,170631,5,1,0,1252,12.6,1373.3306262442088,2
2020-11-12-170631,170631,5,0,0,1257,13.2,1321.1272147303819,3
2020-11-13-170631,170631,4,0,0,1261,10.2,1330.030737910326,4
2020-03-01-170633,170633,0,0,0,0,0.2,0.0,6
2020-03-02-170633,170633,0,0,5,0,0.0,22.667500383362345,0
2020-03-03-170633,170633,0,0,2,0,0.0,114.82271142291188,1
2020-03-04-170633,170633,0,0,3,0,0.2,128.7950405807556,2
2020-03-05-170633,170633,0,4,1,0,0.0,139.24204292587393,3
2020-03-06-170633,170633,0,0,7,0,0.0,121.73922129277662,4
2020-03-07-170633,170633,0,0,1,0,0.0,131.3010131651632,5
2020-03-08-170633,170633,0,0,0,0,0.2,131.24290526514113,6
2020-03-09-170633,170633,0,0,23,0,0.2,131.13788875739823,0
2020-03-10-170633,170633,0,0,6,0,0.2,195.71628467993474,1
2020-03-11-170633,170633,0,0,3,0,0.6,149.2121234822589,2
2020-03-12-170633,170633,0,0,7,0,0.2,110.38443850996525,3
2020-03-13-170633,170633,1,0,15,1,0.6,72.83350916823447,4
2020-03-14-170633,170633,0,0,4,1,2.0,69.45760803280754,5
2020-03-15-170633,170633,0,0,2,1,4.4,61.621628868696334,6
2020-03-16-170633,170633,5,0,31,6,8.2,37.5039190263832,0
2020-03-17-170633,170633,2,0,3,8,8.2,71.43266115599147,1
2020-03-18-170633,170633,3,0,4,11,5.8,102.0551594121917,2
2020-03-19-170633,170633,1,0,5,12,8.2,123.9915694777491,3
2020-03-20-170633,170633,7,0,2,19,9.2,141.41709154939662,4
2020-03-21-170633,170633,1,0,1,20,4.2,165.21175672374127,5
2020-03-22-170633,170633,0,0,1,20,5.8,159.26128182599257,6
2020-03-23-170633,170633,23,1,2,43,20.2,145.5118401655741,0
2020-03-24-170633,170633,6,1,2,49,15.2,187.428979703101,1
2020-03-25-170633,170633,3,0,2,52,16.8,209.37069750948268,2
2020-03-26-170633,170633,7,0,1,59,10.6,235.88426319152347,3
2020-03-27-170633,170633,15,0,5,74,13.8,276.2695643227373,4
2020-03-28-170633,170633,4,0,0,78,3.2,293.29964545695583,5
2020-03-29-170633,170633,2,0,1,80,4.0,293.5847930560433,6
2020-03-30-170633,170633,31,0,1,111,11.2,219.9724516187594,0
2020-03-31-170633,170633,3,0,0,114,11.0,230.9519548927649,1
2020-04-01-170633,170633,4,0,1,118,13.2,32.342652491959115,2
2020-04-02-170633,170633,5,0,3,123,5.6,110.68774438500083,3
2020-04-03-170633,170633,2,0,3,125,11.2,61.96991759213816,4
2020-04-04-170633,170633,1,0,0,126,1.8,82.30259101948624,5
2020-04-05-170633,170633,1,1,0,127,4.4,82.99007507237928,6
2020-04-06-170633,170633,2,0,1,129,12.6,89.5492485196126,0
2020-04-07-170633,170633,2,0,0,131,14.0,110.10943394618026,1
2020-04-08-170633,170633,2,0,0,133,7.8,124.6702268103778,2
2020-04-09-170633,170633,1,0,0,134,2.6,132.35715093797705,3
2020-04-10-170633,170633,5,0,2,139,4.2,33.50137606639312,4
2020-04-11-170633,170633,0,0,0,139,3.6,47.09174783136523,5
2020-04-12-170633,170633,1,0,1,140,4.8,54.46108069125593,6
2020-04-13-170633,170633,1,1,3,141,10.8,61.71279993895932,0
2020-04-14-170633,170633,0,0,2,141,12.2,86.2331106762503,1
2020-04-15-170633,170633,1,0,1,142,6.8,109.12901124232947,2
2020-04-16-170633,170633,3,0,0,145,5.2,127.87964450774766,3
2020-04-17-170633,170633,3,0,1,148,5.8,114.01141011183002,4
2020-04-18-170633,170633,0,0,0,148,3.0,118.27381294889244,5
2020-04-19-170633,170633,0,0,0,148,0.8,118.29209829377729,6
2020-04-20-170633,170633,1,0,2,149,5.2,108.14038394954265,0
2020-04-21-170633,170633,0,0,0,149,9.4,99.6231276388296,1
2020-04-22-170633,170633,0,0,0,149,7.8,102.79077204205912,2
2020-04-23-170633,170633,0,0,1,149,1.2,104.42560833004654,3
2020-04-24-170633,170633,2,0,1,151,4.6,89.16021649249511,4
2020-04-25-170633,170633,0,0,0,151,2.2,93.44898363715279,5
2020-04-26-170633,170633,1,0,0,152,0.8,96.04644980274685,6
2020-04-27-170633,170633,3,0,2,155,3.8,80.23384901409935,0
2020-04-28-170633,170633,2,0,1,157,4.0,80.17657314651191,1
2020-04-29-170633,170633,1,0,2,158,4.4,68.66003438694227,2
2020-04-30-170633,170633,0,0,2,158,4.0,89.02923687577243,3
2020-05-01-170633,170633,1,0,2,159,2.8,120.73110417664145,4
2020-05-02-170633,170633,0,0,0,159,0.4,40.90738961009595,5
2020-05-03-170633,170633,0,0,0,159,0.6,27.324307662715917,6
2020-05-04-170633,170633,2,0,2,161,3.4,20.405774852897572,0
2020-05-05-170633,170633,0,0,0,161,3.0,34.12485736893584,1
2020-05-06-170633,170633,0,0,2,161,1.4,39.31656548125953,2
2020-05-07-170633,170633,1,0,0,162,4.6,52.327152038036765,3
2020-05-08-170633,170633,1,0,0,163,5.0,68.87150792420397,4
2020-05-09-170633,170633,0,0,0,163,1.6,86.30202091753851,5
2020-05-10-170633,170633,0,0,0,163,0.4,130.50783555212428,6
2020-05-11-170633,170633,2,0,0,165,4.2,124.24803606834949,0
2020-05-12-170633,170633,1,1,1,166,6.8,125.98805189194653,1
2020-05-13-170633,170633,2,0,0,168,4.2,102.2731207178836,2
2020-05-14-170633,170633,2,0,1,170,1.4,83.84458562366419,3
2020-05-15-170633,170633,2,0,1,172,4.0,67.53921070927785,4
2020-05-16-170633,170633,0,1,0,172,0.2,67.90275082204306,5
2020-05-17-170633,170633,0,0,0,172,0.0,60.72057204672652,6
2020-05-18-170633,170633,2,0,0,174,2.0,60.0155362228201,0
2020-05-19-170633,170633,0,0,2,174,2.2,55.977522561954544,1
2020-05-20-170633,170633,2,0,2,176,1.0,40.14595742532596,2
2020-05-21-170633,170633,0,0,0,176,1.4,39.88793124993168,3
2020-05-22-170633,170633,0,0,0,176,2.2,33.113943184152525,4
2020-05-23-170633,170633,0,0,0,176,0.4,40.96202134514041,5
2020-05-24-170633,170633,0,0,0,176,0.0,42.47845974571679,6
2020-05-25-170633,170633,0,0,0,176,2.8,34.16266772310586,0
2020-05-26-170633,170633,1,0,1,177,0.6,37.44155332618126,1
2020-05-27-170633,170633,0,2,0,177,1.2,37.439021572663165,2
2020-05-28-170633,170633,1,1,0,178,2.0,36.29157317195839,3
2020-05-29-170633,170633,1,1,0,179,1.6,40.124652975397204,4
2020-05-30-170633,170633,0,0,0,179,0.0,39.005378038328885,5
2020-05-31-170633,170633,0,0,0,179,0.2,40.08796919575201,6
2020-06-01-170633,170633,0,2,0,179,1.4,112.44297280927879,0
2020-06-02-170633,170633,2,0,0,181,0.4,24.373866085723026,1
2020-06-03-170633,170633,2,0,0,183,1.2,17.77529999222894,2
2020-06-04-170633,170633,0,0,0,183,1.4,18.880716335708698,3
2020-06-05-170633,170633,0,0,0,183,0.8,22.723922408179742,4
2020-06-06-170633,170633,0,0,0,183,0.0,27.66907941029031,5
2020-06-07-170633,170633,0,0,0,183,0.0,28.005476509092095,6
2020-06-08-170633,170633,0,0,0,183,0.6,27.133245103237392,0
2020-06-09-170633,170633,1,0,0,184,1.0,28.810253809772448,1
2020-06-10-170633,170633,0,0,0,184,0.4,118.41574492911292,2
2020-06-11-170633,170633,0,0,0,184,1.8,98.89810229239478,3
2020-06-12-170633,170633,0,0,0,184,1.0,90.4107966169373,4
2020-06-13-170633,170633,0,0,0,184,0.0,67.23185992958085,5
2020-06-14-170633,170633,0,0,0,184,0.0,42.14223902973241,6
2020-06-15-170633,170633,0,1,0,184,0.2,23.224294252269804,0
2020-06-16-170633,170633,0,0,0,184,1.0,20.33772388885621,1
2020-06-17-170633,170633,0,0,0,184,0.4,17.88840958075209,2
2020-06-18-170633,170633,0,0,0,184,1.2,17.992715008617623,3
2020-06-19-170633,170633,0,1,0,184,2.2,19.893939328451996,4
2020-06-20-170633,170633,0,0,0,184,0.0,31.80690044904413,5
2020-06-21-170633,170633,0,0,0,184,0.2,32.148416128295956,6
2020-06-22-170633,170633,0,0,0,184,1.0,30.537719652696957,0
2020-06-23-170633,170633,0,0,0,184,1.2,31.269063647511718,1
2020-06-24-170633,170633,0,0,0,184,0.6,34.27844921124311,2
2020-06-25-170633,170633,0,1,0,184,0.8,30.99087986784903,3
2020-06-26-170633,170633,0,0,0,184,1.0,25.876337345060126,4
2020-06-27-170633,170633,0,0,0,184,0.2,21.769920722994303,5
2020-06-28-170633,170633,0,0,0,184,0.2,22.439816187053566,6
2020-06-29-170633,170633,0,0,0,184,0.4,23.22021954619595,0
2020-06-30-170633,170633,0,0,0,184,0.6,21.45848725678378,1
2020-07-01-170633,170633,0,0,0,184,0.2,30.864382732546275,2
2020-07-02-170633,170633,0,0,0,184,0.4,11.327445222615799,3
2020-07-03-170633,170633,0,0,0,184,0.8,12.94228436885778,4
2020-07-04-170633,170633,0,0,0,184,0.0,22.92900206836422,5
2020-07-05-170633,170633,0,0,0,184,0.2,23.13487774156257,6
2020-07-06-170633,170633,0,0,0,184,0.0,20.579946293005708,0
2020-07-07-170633,170633,0,0,1,184,0.8,19.287620518688122,1
2020-07-08-170633,170633,0,0,0,184,0.2,19.024794452390807,2
2020-07-09-170633,170633,0,0,0,184,0.6,18.3753964723323,3
2020-07-10-170633,170633,0,0,0,184,0.0,30.84929070795775,4
2020-07-11-170633,170633,0,0,0,184,0.0,24.101179173963523,5
2020-07-12-170633,170633,0,0,0,184,0.0,15.347724198311042,6
2020-07-13-170633,170633,0,0,1,184,0.0,15.0220664281923,0
2020-07-14-170633,170633,0,0,0,184,0.4,16.75906471456389,1
2020-07-15-170633,170633,0,0,0,184,0.2,14.852593647251076,2
2020-07-16-170633,170633,0,0,0,184,0.8,9.761167628760276,3
2020-07-17-170633,170633,0,0,0,184,0.4,10.920854815025988,4
2020-07-18-170633,170633,0,0,0,184,0.0,11.444190469361274,5
2020-07-19-170633,170633,0,0,0,184,0.0,11.440205611934626,6
2020-07-20-170633,170633,0,0,1,184,0.8,10.687159485520123,0
2020-07-21-170633,170633,1,0,0,185,0.0,10.845874781962571,1
2020-07-22-170633,170633,0,0,0,185,1.0,14.297483326095914,2
2020-07-23-170633,170633,0,0,0,185,0.0,13.064091466108861,3
2020-07-24-170633,170633,0,0,0,185,0.2,13.165890502662922,4
2020-07-25-170633,170633,0,0,0,185,0.4,14.386790491309748,5
2020-07-26-170633,170633,0,0,0,185,0.2,14.146943406063983,6
2020-07-27-170633,170633,1,0,0,186,0.6,13.713798169954964,0
2020-07-28-170633,170633,0,0,0,186,0.8,14.783483384061102,1
2020-07-29-170633,170633,0,0,0,186,0.4,12.376809043360941,2
2020-07-30-170633,170633,0,0,0,186,0.4,13.027232598730738,3
2020-07-31-170633,170633,0,0,0,186,0.6,17.84297520142606,4
2020-08-01-170633,170633,0,0,0,186,0.6,14.217145492373236,5
2020-08-02-170633,170633,0,0,0,186,1.4,88.46846506593462,6
2020-08-03-170633,170633,1,0,1,187,1.8,157.2149731850195,0
2020-08-04-170633,170633,0,0,0,187,1.0,157.78716870109318,1
2020-08-05-170633,170633,0,0,0,187,2.4,134.93283283405853,2
2020-08-06-170633,170633,0,0,1,187,1.6,120.25977350007102,3
2020-08-07-170633,170633,0,0,0,187,2.0,98.1731124185401,4
2020-08-08-170633,170633,0,0,0,187,0.8,98.9052280574033,5
2020-08-09-170633,170633,0,0,1,187,0.0,95.04104866208681,6
2020-08-10-170633,170633,0,0,0,187,1.8,11.215599456106442,0
2020-08-11-170633,170633,0,0,1,187,0.8,20.02939799697973,1
2020-08-12-170633,170633,0,1,0,187,1.4,28.127930756763085,2
2020-08-13-170633,170633,0,0,0,187,4.0,39.11608173342856,3
2020-08-14-170633,170633,0,0,0,187,2.8,54.45235875605072,4
2020-08-15-170633,170633,0,0,0,187,1.0,70.27452662284688,5
2020-08-16-170633,170633,0,0,2,187,1.6,71.66388549163636,6
2020-08-17-170633,170633,1,0,3,188,2.2,79.24662669183891,0
2020-08-18-170633,170633,0,0,3,188,2.2,82.31408914810592,1
2020-08-19-170633,170633,0,0,0,188,2.0,85.00980553317896,2
2020-08-20-170633,170633,1,0,2,189,3.0,73.59791196292878,3
2020-08-21-170633,170633,0,0,0,189,1.8,75.09022209559693,4
2020-08-22-170633,170633,0,0,3,189,0.8,83.55135370233869,5
2020-08-23-170633,170633,1,0,1,190,3.0,79.46614170365899,6
2020-08-24-170633,170633,0,0,1,190,6.2,74.06890472532321,0
2020-08-25-170633,170633,1,0,1,191,5.4,86.39528144598302,1
2020-08-26-170633,170633,0,0,0,191,7.2,97.28759798414558,2
2020-08-27-170633,170633,0,0,0,191,5.0,120.46943829713882,3
2020-08-28-170633,170633,0,0,4,191,5.4,126.96320770986324,4
2020-08-29-170633,170633,0,0,2,191,1.8,141.97986173365717,5
2020-08-30-170633,170633,2,0,0,193,2.4,147.47675826945442,6
2020-08-31-170633,170633,3,0,0,196,5.2,133.5090920111516,0
2020-09-01-170633,170633,3,0,15,199,5.0,80.81852636295301,1
2020-09-02-170633,170633,0,0,5,199,4.0,184.84071066486547,2
2020-09-03-170633,170633,2,1,2,201,5.2,133.50470515104766,3
2020-09-04-170633,170633,0,0,0,201,7.4,131.73396191893974,4
2020-09-05-170633,170633,3,0,0,204,3.6,134.77436009848873,5
2020-09-06-170633,170633,1,0,1,205,2.6,142.99345156754543,6
2020-09-07-170633,170633,1,0,0,206,5.2,152.50853688178532,0
2020-09-08-170633,170633,1,0,1,207,1.0,159.38344862535652,1
2020-09-09-170633,170633,0,0,2,207,2.2,151.19254709701704,2
2020-09-10-170633,170633,0,0,1,207,4.2,66.98731011175599,3
2020-09-11-170633,170633,4,0,0,211,7.4,79.9893839298218,4
2020-09-12-170633,170633,2,0,0,213,2.8,105.56102721078034,5
2020-09-13-170633,170633,0,0,0,213,3.2,112.71252076468036,6
2020-09-14-170633,170633,0,0,1,213,7.4,115.52730242739347,0
2020-09-15-170633,170633,15,0,0,228,4.2,141.60485508815032,1
2020-09-16-170633,170633,5,0,0,233,2.4,169.08040045376575,2
2020-09-17-170633,170633,2,0,1,235,4.2,172.2542203663526,3
2020-09-18-170633,170633,0,0,0,235,17.8,173.27273468278668,4
2020-09-19-170633,170633,0,0,1,235,6.6,165.41901296232263,5
2020-09-20-170633,170633,1,0,1,236,5.4,175.55316312882545,6
2020-09-21-170633,170633,0,2,0,236,6.6,165.41506418212316,0
2020-09-22-170633,170633,1,0,0,237,8.4,166.71446202814855,1
2020-09-23-170633,170633,2,1,1,239,7.4,161.40745954690232,2
2020-09-24-170633,170633,1,0,1,240,5.2,166.6823624187948,3
2020-09-25-170633,170633,0,0,3,240,5.4,162.6168257878029,4
2020-09-26-170633,170633,0,0,0,240,1.6,156.86080480787618,5
2020-09-27-170633,170633,0,0,0,240,1.6,150.66871834324996,6
2020-09-28-170633,170633,1,0,1,241,5.6,138.83481422428002,0
2020-09-29-170633,170633,0,0,3,241,2.2,130.3512601516083,1
2020-09-30-170633,170633,0,0,0,241,7.4,119.21456869903332,2
2020-10-01-170633,170633,1,0,0,242,4.2,0.0,3
2020-10-02-170633,170633,0,0,4,242,3.4,233.22954347802482,4
2020-10-03-170633,170633,1,1,0,243,1.2,254.39945370420676,5
2020-10-04-170633,170633,1,0,0,244,2.6,238.1823380746658,6
2020-10-05-170633,170633,0,0,0,244,14.0,202.22167469154724,0
2020-10-06-170633,170633,0,0,1,244,3.2,193.00780293982038,1
2020-10-07-170633,170633,1,0,4,245,7.0,174.35672463700416,2
2020-10-08-170633,170633,1,0,1,246,6.4,172.71768014127198,3
2020-10-09-170633,170633,3,0,3,249,7.0,189.22153407009228,4
2020-10-10-170633,170633,0,0,0,249,2.6,16.487804348923923,5
2020-10-11-170633,170633,0,0,1,249,3.8,30.537174146628278,6
2020-10-12-170633,170633,1,0,0,250,2.2,44.71336890786382,0
2020-10-13-170633,170633,3,0,3,253,4.8,57.14776338689643,1
2020-10-14-170633,170633,0,0,0,253,4.0,90.28932134499057,2
2020-10-15-170633,170633,0,0,0,253,12.2,112.07649597799481,3
2020-10-16-170633,170633,4,0,1,257,9.8,155.34976303353127,4
2020-10-17-170633,170633,0,0,2,257,2.8,189.4804206929292,5
2020-10-18-170633,170633,0,0,1,257,5.2,189.17831772481102,6
2020-10-19-170633,170633,0,0,0,257,12.8,189.88269492015445,0
2020-10-20-170633,170633,1,1,5,258,9.6,212.7636617400325,1
2020-10-21-170633,170633,4,0,0,262,10.2,228.7409622239427,2
2020-10-22-170633,170633,1,0,5,263,9.2,234.09909771695143,3
2020-10-23-170633,170633,3,0,1,266,13.4,234.32559005246145,4
2020-10-24-170633,170633,0,0,0,266,3.2,265.9204498335462,5
2020-10-25-170633,170633,1,0,1,267,4.6,261.2772843487131,6
2020-10-26-170633,170633,0,0,2,267,10.6,234.93286819767857,0
2020-10-27-170633,170633,3,0,1,270,8.8,264.681730968432,1
2020-10-28-170633,170633,0,0,2,270,7.8,269.44895407544954,2
2020-10-29-170633,170633,0,0,2,270,8.2,257.60534300138073,3
2020-10-30-170633,170633,1,0,1,271,12.2,205.67799022677394,4
2020-10-31-170633,170633,2,1,0,273,3.4,234.90896177669737,5
2020-11-01-170633,170633,1,0,0,274,3.8,174.39751087162512,6
2020-11-02-170633,170633,0,0,0,274,4.0,136.05671592359897,0
2020-11-03-170633,170633,5,0,0,279,10.2,125.21375037070581,1
2020-11-04-170633,170633,0,0,0,279,10.2,155.9819019531153,2
2020-11-05-170633,170633,5,0,0,284,7.6,179.30905540503625,3
2020-11-06-170633,170633,1,1,0,285,6.6,192.01637701141922,4
2020-11-07-170633,170633,0,0,0,285,1.6,202.9031460554777,5
2020-11-08-170633,170633,1,0,0,286,3.0,185.73451944066025,6
2020-11-09-170633,170633,2,0,0,288,9.2,182.26632043431673,0
2020-11-10-170633,170633,1,0,0,289,6.2,163.2727098776604,1
2020-11-11-170633,170633,2,0,0,291,7.0,176.62338827009282,2
2020-11-12-170633,170633,2,0,0,293,6.2,166.63073967628782,3
2020-11-13-170633,170633,1,0,0,294,7.0,173.56175596384134,4
2020-03-01-170634,170634,0,0,1,0,0.0,0.0,6
2020-03-02-170634,170634,0,0,1,0,0.0,9.56721370274035,0
2020-03-03-170634,170634,0,0,4,0,0.0,38.16282704457541,1
2020-03-04-170634,170634,0,0,8,0,0.0,51.13709881909999,2
2020-03-05-170634,170634,0,0,4,0,0.0,58.26662311535429,3
2020-03-06-170634,170634,0,0,0,0,0.0,57.33925858997079,4
2020-03-07-170634,170634,0,0,0,0,0.0,63.38714859448066,5
2020-03-08-170634,170634,0,0,0,0,0.0,62.23134139146969,6
2020-03-09-170634,170634,0,0,2,0,0.0,66.04056904197623,0
2020-03-10-170634,170634,0,0,1,0,0.0,139.36883417766234,1
2020-03-11-170634,170634,0,0,0,0,0.0,115.77477517893058,2
2020-03-12-170634,170634,1,0,0,1,0.0,86.26411578828137,3
2020-03-13-170634,170634,2,0,1,3,0.16666666666666666,49.94766769537989,4
2020-03-14-170634,170634,0,0,2,3,0.0,51.74408165679607,5
2020-03-15-170634,170634,1,0,1,4,0.16666666666666666,39.38668017051248,6
2020-03-16-170634,170634,1,0,5,5,0.16666666666666666,23.679368338792194,0
2020-03-17-170634,170634,4,0,3,9,1.0,35.09631701117271,1
2020-03-18-170634,170634,8,0,1,17,1.0,60.77630017397584,2
2020-03-19-170634,170634,4,0,0,21,1.0,87.54882461449068,3
2020-03-20-170634,170634,0,0,4,21,0.5,95.39503728418539,4
2020-03-21-170634,170634,0,0,0,21,0.3333333333333333,94.64666653158945,5
2020-03-22-170634,170634,0,0,1,21,0.0,88.22795928698586,6
2020-03-23-170634,170634,2,0,3,23,1.6666666666666667,83.42131533953668,0
2020-03-24-170634,170634,1,0,2,24,1.0,86.41703046653109,1
2020-03-25-170634,170634,0,0,0,24,1.6666666666666667,76.25452189503707,2
2020-03-26-170634,170634,0,0,1,24,1.8333333333333333,81.01891355471356,3
2020-03-27-170634,170634,1,0,2,25,1.3333333333333333,92.24142612841976,4
2020-03-28-170634,170634,2,0,0,27,0.0,97.90155742024126,5
2020-03-29-170634,170634,1,0,1,28,0.6666666666666666,95.69865291690141,6
2020-03-30-170634,170634,5,0,0,33,1.1666666666666667,74.99445673062048,0
2020-03-31-170634,170634,3,0,2,36,0.5,77.1450753159051,1
2020-04-01-170634,170634,1,0,2,37,1.0,10.106242344509944,2
2020-04-02-170634,170634,0,0,1,37,4.833333333333333,33.28836833333937,3
2020-04-03-170634,170634,4,0,0,41,1.3333333333333333,26.95698591201711,4
2020-04-04-170634,170634,0,0,0,41,0.6666666666666666,32.56588678437137,5
2020-04-05-170634,170634,1,0,0,42,0.5,35.737544932222676,6
2020-04-06-170634,170634,3,1,3,45,0.3333333333333333,40.82971178764291,0
2020-04-07-170634,170634,2,2,0,47,0.3333333333333333,43.93161577271023,1
2020-04-08-170634,170634,0,0,0,47,0.3333333333333333,41.73337076602626,2
2020-04-09-170634,170634,1,3,1,48,0.16666666666666666,38.191486655600855,3
2020-04-10-170634,170634,2,0,0,50,0.3333333333333333,8.261945276674169,4
2020-04-11-170634,170634,0,0,0,50,0.16666666666666666,12.210697475071663,5
2020-04-12-170634,170634,1,0,0,51,0.0,13.150832852004315,6
2020-04-13-170634,170634,0,0,0,51,0.6666666666666666,14.897545215937368,0
2020-04-14-170634,170634,2,0,4,53,0.16666666666666666,22.587385399175805,1
2020-04-15-170634,170634,2,0,3,55,0.3333333333333333,28.676387713567326,2
2020-04-16-170634,170634,1,0,0,56,1.5,36.32779973910973,3
2020-04-17-170634,170634,0,0,0,56,0.0,37.41149592239154,4
2020-04-18-170634,170634,0,0,1,56,0.3333333333333333,36.22646380470751,5
2020-04-19-170634,170634,0,0,0,56,0.3333333333333333,37.886096113398274,6
2020-04-20-170634,170634,3,0,1,59,4.0,52.96191901913798,0
2020-04-21-170634,170634,0,1,0,59,0.3333333333333333,65.60672034659243,1
2020-04-22-170634,170634,0,0,1,59,0.0,65.11222677115248,2
2020-04-23-170634,170634,1,0,1,60,0.16666666666666666,59.851512407127956,3
2020-04-24-170634,170634,0,0,0,60,0.8333333333333334,60.40918284800281,4
2020-04-25-170634,170634,0,0,0,60,0.16666666666666666,60.56665477187536,5
2020-04-26-170634,170634,0,0,0,60,0.0,59.7522893797712,6
2020-04-27-170634,170634,0,0,0,60,0.5,37.34204946914784,0
2020-04-28-170634,170634,4,0,1,64,0.8333333333333334,21.347989882651323,1
2020-04-29-170634,170634,3,0,2,67,0.16666666666666666,27.42995654532868,2
2020-04-30-170634,170634,0,0,1,67,0.0,40.80928905686345,3
2020-05-01-170634,170634,0,0,0,67,0.16666666666666666,39.116508378164525,4
2020-05-02-170634,170634,1,0,0,68,0.3333333333333333,14.98935697996302,5
2020-05-03-170634,170634,0,0,0,68,0.16666666666666666,11.676760012485541,6
2020-05-04-170634,170634,1,0,0,69,0.5,10.795822759046938,0
2020-05-05-170634,170634,0,0,0,69,2.0,18.2868417448691,1
2020-05-06-170634,170634,1,0,1,70,0.8333333333333334,21.378850333804785,2
2020-05-07-170634,170634,1,0,0,71,0.16666666666666666,61.500567753043995,3
2020-05-08-170634,170634,0,0,0,71,1.1666666666666667,65.029255226657,4
2020-05-09-170634,170634,0,1,0,71,0.16666666666666666,70.23902786533316,5
2020-05-10-170634,170634,0,0,0,71,0.0,41.647386076469274,6
2020-05-11-170634,170634,0,1,0,71,0.3333333333333333,39.02832812451934,0
2020-05-12-170634,170634,1,1,0,72,0.5,36.009962365310486,1
2020-05-13-170634,170634,2,0,2,74,0.3333333333333333,31.295567377076004,2
2020-05-14-170634,170634,1,0,0,75,0.0,27.541974374706427,3
2020-05-15-170634,170634,0,0,1,75,0.0,25.301646861451317,4
2020-05-16-170634,170634,0,0,0,75,0.0,21.943761796908213,5
2020-05-17-170634,170634,0,0,0,75,0.0,21.124684965085414,6
2020-05-18-170634,170634,0,0,0,75,0.3333333333333333,21.005664333174202,0
2020-05-19-170634,170634,0,0,0,75,0.3333333333333333,20.354533846208202,1
2020-05-20-170634,170634,1,0,1,76,0.16666666666666666,17.796682376191278,2
2020-05-21-170634,170634,0,0,0,76,0.16666666666666666,18.96510779219015,3
2020-05-22-170634,170634,0,0,0,76,0.0,20.44226751139405,4
2020-05-23-170634,170634,0,0,0,76,0.0,21.92126012991403,5
2020-05-24-170634,170634,0,0,0,76,0.0,22.32981637806889,6
2020-05-25-170634,170634,0,0,0,76,0.0,19.046000575189534,0
2020-05-26-170634,170634,0,0,0,76,0.0,15.901337920968025,1
2020-05-27-170634,170634,2,4,0,78,0.0,13.126122964700054,2
2020-05-28-170634,170634,0,0,0,78,0.0,15.66875461372775,3
2020-05-29-170634,170634,1,0,0,79,0.0,13.947854317556837,4
2020-05-30-170634,170634,0,0,0,79,0.0,18.07941757267345,5
2020-05-31-170634,170634,0,0,0,79,0.0,18.656190757827574,6
2020-06-01-170634,170634,0,0,0,79,0.0,100.28420200800284,0
2020-06-02-170634,170634,0,0,0,79,0.3333333333333333,8.558465758085756,1
2020-06-03-170634,170634,1,0,0,80,0.5,10.848296567034591,2
2020-06-04-170634,170634,0,0,0,80,0.16666666666666666,17.41572833565229,3
2020-06-05-170634,170634,0,0,0,80,0.5,18.062064814562348,4
2020-06-06-170634,170634,0,6,0,80,0.0,25.896543110229178,5
2020-06-07-170634,170634,0,0,0,80,0.16666666666666666,25.87274587869838,6
2020-06-08-170634,170634,0,0,1,80,0.0,27.159018982761953,0
2020-06-09-170634,170634,0,0,0,80,0.0,25.025393344340774,1
2020-06-10-170634,170634,0,0,0,80,0.16666666666666666,105.86504118965433,2
2020-06-11-170634,170634,0,0,1,80,0.0,95.4186116500187,3
2020-06-12-170634,170634,0,0,0,80,0.16666666666666666,85.24972786298139,4
2020-06-13-170634,170634,0,0,0,80,0.0,32.217239609972,5
2020-06-14-170634,170634,0,0,0,80,0.0,22.14107728751042,6
2020-06-15-170634,170634,0,0,0,80,0.16666666666666666,14.32251044301524,0
2020-06-16-170634,170634,0,0,0,80,0.0,12.226114623989455,1
2020-06-17-170634,170634,0,1,0,80,0.16666666666666666,8.731888012649828,2
2020-06-18-170634,170634,0,0,0,80,0.3333333333333333,8.887788280398683,3
2020-06-19-170634,170634,0,0,0,80,0.0,9.746135786652685,4
2020-06-20-170634,170634,0,0,0,80,0.16666666666666666,12.1535903173161,5
2020-06-21-170634,170634,0,0,0,80,0.0,12.89986937115247,6
2020-06-22-170634,170634,1,0,0,81,0.0,11.962859049671211,0
2020-06-23-170634,170634,0,0,0,81,0.16666666666666666,14.845849704474086,1
2020-06-24-170634,170634,0,0,0,81,0.16666666666666666,15.459225667352621,2
2020-06-25-170634,170634,1,1,0,82,0.0,14.101668789944105,3
2020-06-26-170634,170634,0,0,0,82,0.0,15.416630915504582,4
2020-06-27-170634,170634,0,0,0,82,0.0,13.102539495050985,5
2020-06-28-170634,170634,0,0,0,82,0.0,12.625366095739958,6
2020-06-29-170634,170634,0,1,0,82,0.3333333333333333,13.06909889276312,0
2020-06-30-170634,170634,0,0,0,82,0.0,20.74657975909094,1
2020-07-01-170634,170634,0,0,0,82,0.0,18.77155738549647,2
2020-07-02-170634,170634,0,0,1,82,0.16666666666666666,10.733764989013183,3
2020-07-03-170634,170634,0,0,0,82,0.16666666666666666,8.62236920590917,4
2020-07-04-170634,170634,0,0,0,82,0.0,12.240460133134448,5
2020-07-05-170634,170634,0,0,0,82,0.0,12.09269718355546,6
2020-07-06-170634,170634,0,0,0,82,0.0,12.080805164133402,0
2020-07-07-170634,170634,0,0,0,82,0.0,10.595614783871472,1
2020-07-08-170634,170634,0,0,0,82,0.0,7.759191672916078,2
2020-07-09-170634,170634,0,0,0,82,0.0,6.006444154935435,3
2020-07-10-170634,170634,0,0,0,82,0.0,20.128343639991314,4
2020-07-11-170634,170634,0,0,0,82,0.0,16.16480646775174,5
2020-07-12-170634,170634,0,0,0,82,0.16666666666666666,5.98107362808551,6
2020-07-13-170634,170634,0,0,0,82,0.16666666666666666,7.593563646086876,0
2020-07-14-170634,170634,0,0,0,82,0.16666666666666666,9.063459473265292,1
2020-07-15-170634,170634,0,0,1,82,0.0,9.763274363190977,2
2020-07-16-170634,170634,1,0,0,83,0.3333333333333333,8.546669960348895,3
2020-07-17-170634,170634,0,0,0,83,0.0,12.763957130150565,4
2020-07-18-170634,170634,0,0,0,83,0.0,12.592358045628027,5
2020-07-19-170634,170634,0,0,0,83,0.0,12.845430133193279,6
2020-07-20-170634,170634,0,0,0,83,0.0,9.236424014066117,0
2020-07-21-170634,170634,0,0,0,83,0.0,7.526743499547059,1
2020-07-22-170634,170634,0,0,0,83,0.0,9.07103805156428,2
2020-07-23-170634,170634,0,0,1,83,0.0,4.763621786673189,3
2020-07-24-170634,170634,0,0,1,83,0.0,6.001251571367201,4
2020-07-25-170634,170634,0,0,1,83,0.0,6.634692492587954,5
2020-07-26-170634,170634,0,0,1,83,0.0,6.614871010259517,6
2020-07-27-170634,170634,0,0,0,83,0.0,5.6100172570350155,0
2020-07-28-170634,170634,0,0,0,83,0.16666666666666666,5.760178244741896,1
2020-07-29-170634,170634,1,0,1,84,0.0,6.142473210691899,2
2020-07-30-170634,170634,0,0,4,84,0.0,9.367988341629973,3
2020-07-31-170634,170634,0,0,2,84,0.3333333333333333,10.244137822839189,4
2020-08-01-170634,170634,0,0,0,84,0.16666666666666666,4.743198947245315,5
2020-08-02-170634,170634,0,0,1,84,0.0,112.50998023234715,6
2020-08-03-170634,170634,0,0,3,84,0.0,182.7093926522404,0
2020-08-04-170634,170634,0,0,2,84,0.16666666666666666,163.1920234687468,1
2020-08-05-170634,170634,0,0,0,84,0.0,133.97154819899353,2
2020-08-06-170634,170634,1,0,0,85,0.16666666666666666,123.68702488056063,3
2020-08-07-170634,170634,1,0,2,86,1.0,91.59812563436725,4
2020-08-08-170634,170634,1,0,0,87,0.16666666666666666,70.38510485995752,5
2020-08-09-170634,170634,1,0,3,88,0.3333333333333333,74.99707102567311,6
2020-08-10-170634,170634,0,0,2,88,2.333333333333333,5.51608191514787,0
2020-08-11-170634,170634,0,0,4,88,0.6666666666666666,38.19635289596715,1
2020-08-12-170634,170634,1,0,1,89,0.3333333333333333,49.47380463912008,2
2020-08-13-170634,170634,4,0,1,93,0.0,60.18951200860099,3
2020-08-14-170634,170634,2,0,0,95,0.16666666666666666,77.80053333487342,4
2020-08-15-170634,170634,0,0,1,95,0.3333333333333333,88.97330741425682,5
2020-08-16-170634,170634,1,0,0,96,0.8333333333333334,94.12241876411954,6
2020-08-17-170634,170634,3,0,3,99,1.0,106.75423598255034,0
2020-08-18-170634,170634,2,0,4,101,1.6666666666666667,103.28764197869029,1
2020-08-19-170634,170634,0,0,2,101,0.3333333333333333,119.09704727296466,2
2020-08-20-170634,170634,0,0,2,101,0.8333333333333334,102.12535691079921,3
2020-08-21-170634,170634,2,0,0,103,0.6666666666666666,107.25346745812618,4
2020-08-22-170634,170634,0,0,0,103,0.5,118.88772072801378,5
2020-08-23-170634,170634,3,0,0,106,0.3333333333333333,112.14883154278601,6
2020-08-24-170634,170634,2,0,0,108,1.3333333333333333,90.13293231878042,0
2020-08-25-170634,170634,4,0,0,112,0.8333333333333334,88.00507975825172,1
2020-08-26-170634,170634,1,0,0,113,0.8333333333333334,104.7837959985848,2
2020-08-27-170634,170634,1,0,1,114,0.3333333333333333,137.79855043599423,3
2020-08-28-170634,170634,0,0,1,114,1.3333333333333333,129.966705676696,4
2020-08-29-170634,170634,1,0,0,115,2.333333333333333,150.04457438619477,5
2020-08-30-170634,170634,0,0,0,115,0.3333333333333333,173.2809756410834,6
2020-08-31-170634,170634,3,0,1,118,1.1666666666666667,150.9955332913416,0
2020-09-01-170634,170634,4,0,0,122,2.1666666666666665,74.02241127047625,1
2020-09-02-170634,170634,2,0,0,124,2.1666666666666665,83.30913826338693,2
2020-09-03-170634,170634,2,0,0,126,2.333333333333333,149.35844423620216,3
2020-09-04-170634,170634,0,0,1,126,0.16666666666666666,142.98170141440994,4
2020-09-05-170634,170634,0,0,0,126,1.6666666666666667,121.56475587057665,5
2020-09-06-170634,170634,0,0,0,126,0.8333333333333334,120.17146304476971,6
2020-09-07-170634,170634,0,0,2,126,3.333333333333333,124.5900770999106,0
2020-09-08-170634,170634,0,0,0,126,1.0,152.10210423112235,1
2020-09-09-170634,170634,0,0,0,126,0.3333333333333333,139.62546488382839,2
2020-09-10-170634,170634,1,0,0,127,0.6666666666666666,75.31376818541102,3
2020-09-11-170634,170634,1,0,1,128,0.8333333333333334,84.4433026966876,4
2020-09-12-170634,170634,0,0,0,128,0.8333333333333334,92.04555136768245,5
2020-09-13-170634,170634,0,0,1,128,1.5,95.29144786080252,6
2020-09-14-170634,170634,1,0,0,129,0.5,90.46958905110478,0
2020-09-15-170634,170634,0,0,3,129,0.16666666666666666,102.5524481929435,1
2020-09-16-170634,170634,0,0,4,129,0.16666666666666666,101.53016590901116,2
2020-09-17-170634,170634,0,0,4,129,0.8333333333333334,69.04067679833665,3
2020-09-18-170634,170634,1,0,3,130,1.1666666666666667,71.4034670176912,4
2020-09-19-170634,170634,0,1,0,130,1.1666666666666667,74.76609431953383,5
2020-09-20-170634,170634,0,0,1,130,1.1666666666666667,99.32307242462002,6
2020-09-21-170634,170634,2,1,1,132,1.1666666666666667,93.80508054660554,0
2020-09-22-170634,170634,0,0,0,132,1.8333333333333333,106.62873203430706,1
2020-09-23-170634,170634,0,0,1,132,2.333333333333333,128.77056450256282,2
2020-09-24-170634,170634,0,0,0,132,2.6666666666666665,136.21620144203703,3
2020-09-25-170634,170634,1,0,3,133,2.5,150.63813948694104,4
2020-09-26-170634,170634,0,0,0,133,0.8333333333333334,167.3897772207352,5
2020-09-27-170634,170634,1,0,0,134,0.5,141.54181775078382,6
2020-09-28-170634,170634,0,0,0,134,1.1666666666666667,137.36036846792774,0
2020-09-29-170634,170634,3,0,1,137,1.3333333333333333,130.8118951279714,1
2020-09-30-170634,170634,4,0,1,141,1.0,133.4597382585962,2
2020-10-01-170634,170634,4,0,2,145,1.8333333333333333,0.0,3
2020-10-02-170634,170634,3,1,2,148,0.5,155.43518722187048,4
2020-10-03-170634,170634,0,0,1,148,0.6666666666666666,251.1795566932082,5
2020-10-04-170634,170634,1,1,0,149,0.3333333333333333,205.1854258693218,6
2020-10-05-170634,170634,1,0,3,150,1.5,170.61680489496834,0
2020-10-06-170634,170634,0,0,0,150,2.1666666666666665,150.14639422880057,1
2020-10-07-170634,170634,1,0,1,151,1.0,128.79523769498178,2
2020-10-08-170634,170634,0,0,0,151,0.5,112.58266332264212,3
2020-10-09-170634,170634,3,0,1,154,0.8333333333333334,113.7619090193246,4
2020-10-10-170634,170634,0,0,2,154,0.3333333333333333,27.521035222553827,5
2020-10-11-170634,170634,0,0,0,154,0.16666666666666666,35.64943848250026,6
2020-10-12-170634,170634,0,0,0,154,0.5,41.687849566550696,0
2020-10-13-170634,170634,1,0,1,155,1.3333333333333333,47.84953275231821,1
2020-10-14-170634,170634,1,0,1,156,1.3333333333333333,76.28511391892462,2
2020-10-15-170634,170634,2,0,2,158,0.5,98.89289395138775,3
2020-10-16-170634,170634,2,0,2,160,1.1666666666666667,119.03795069857385,4
2020-10-17-170634,170634,1,0,0,161,0.16666666666666666,116.15257296416715,5
2020-10-18-170634,170634,0,0,0,161,1.0,111.37142071032183,6
2020-10-19-170634,170634,3,1,0,164,2.5,116.96822797328687,0
2020-10-20-170634,170634,0,0,1,164,2.333333333333333,127.7239031085696,1
2020-10-21-170634,170634,1,0,1,165,0.5,137.09878179577197,2
2020-10-22-170634,170634,0,0,1,165,2.5,140.90358847661196,3
2020-10-23-170634,170634,1,0,3,166,1.5,154.78198256861128,4
2020-10-24-170634,170634,2,1,0,168,0.3333333333333333,197.6140371387657,5
2020-10-25-170634,170634,0,0,1,168,2.0,193.80209111929645,6
2020-10-26-170634,170634,0,0,0,168,3.1666666666666665,185.7390958785016,0
2020-10-27-170634,170634,1,1,0,169,2.333333333333333,214.66671025388737,1
2020-10-28-170634,170634,1,0,0,170,3.333333333333333,218.6205018005843,2
2020-10-29-170634,170634,2,0,0,172,3.333333333333333,227.64313146841266,3
2020-10-30-170634,170634,2,0,0,174,1.8333333333333333,185.48000882135318,4
2020-10-31-170634,170634,0,0,0,174,0.6666666666666666,206.73297019636362,5
2020-11-01-170634,170634,0,1,0,174,0.16666666666666666,108.6453211555648,6
2020-11-02-170634,170634,0,1,0,174,0.3333333333333333,84.1603703629261,0
2020-11-03-170634,170634,1,0,0,175,0.6666666666666666,85.05241964947605,1
2020-11-04-170634,170634,1,0,0,176,1.8333333333333333,97.00698758642642,2
2020-11-05-170634,170634,1,0,0,177,1.8333333333333333,105.82824566282,3
2020-11-06-170634,170634,3,0,0,180,3.333333333333333,120.4192076882236,4
2020-11-07-170634,170634,0,0,0,180,0.3333333333333333,132.30403013877077,5
2020-11-08-170634,170634,1,0,0,181,0.6666666666666666,118.46235228151389,6
2020-11-09-170634,170634,0,0,0,181,1.3333333333333333,112.09036255460805,0
2020-11-10-170634,170634,0,1,0,181,0.3333333333333333,89.18866178176498,1
2020-11-11-170634,170634,0,3,0,181,2.5,94.70407516546298,2
2020-11-12-170634,170634,0,0,0,181,0.5,95.63454890910945,3
2020-11-13-170634,170634,0,0,0,181,1.6666666666666667,91.70451141705979,4
2020-03-01-170635,170635,0,0,5,0,0.0,0.0,6
2020-03-02-170635,170635,0,0,5,0,0.16666666666666666,171.90207722595366,0
2020-03-03-170635,170635,0,0,8,0,0.5,733.3592796581158,1
2020-03-04-170635,170635,0,0,14,0,0.0,809.8957413533806,2
2020-03-05-170635,170635,0,2,13,0,0.16666666666666666,836.1784454801148,3
2020-03-06-170635,170635,0,0,8,0,0.16666666666666666,722.0033374189907,4
2020-03-07-170635,170635,0,0,3,0,0.0,778.1715453879715,5
2020-03-08-170635,170635,0,1,7,0,0.0,759.1418406480293,6
2020-03-09-170635,170635,2,1,11,2,0.3333333333333333,755.73917390573,0
2020-03-10-170635,170635,1,0,18,3,0.16666666666666666,1265.6093139052205,1
2020-03-11-170635,170635,0,0,14,3,1.6666666666666667,939.6684881644619,2
2020-03-12-170635,170635,1,0,27,4,1.6666666666666667,737.0427113095875,3
2020-03-13-170635,170635,2,0,13,6,3.5,487.1088229151223,4
2020-03-14-170635,170635,2,0,4,8,3.6666666666666665,462.40363171346047,5
2020-03-15-170635,170635,5,0,2,13,6.166666666666668,404.905734478213,6
2020-03-16-170635,170635,5,0,11,18,14.333333333333336,286.45191135785626,0
2020-03-17-170635,170635,8,1,11,26,17.666666666666668,449.70639335235546,1
2020-03-18-170635,170635,14,0,12,40,21.0,576.0676695170011,2
2020-03-19-170635,170635,13,0,5,53,17.833333333333332,620.4288638473447,3
2020-03-20-170635,170635,8,0,3,61,23.83333333333333,591.9611536625888,4
2020-03-21-170635,170635,3,0,3,64,9.166666666666666,601.9795571184435,5
2020-03-22-170635,170635,7,0,1,71,8.333333333333334,564.4250686394843,6
2020-03-23-170635,170635,11,0,5,82,33.666666666666664,518.5543909926231,0
2020-03-24-170635,170635,18,0,7,100,22.83333333333333,574.8469669842116,1
2020-03-25-170635,170635,14,0,4,114,25.33333333333333,614.8116420582706,2
2020-03-26-170635,170635,27,0,4,141,23.66666666666667,657.7476378594879,3
2020-03-27-170635,170635,13,0,7,154,21.33333333333333,790.6363827998969,4
2020-03-28-170635,170635,4,0,3,158,8.0,802.5168343952686,5
2020-03-29-170635,170635,2,0,3,160,7.5,787.3665687424942,6
2020-03-30-170635,170635,11,0,7,171,22.0,619.386671785589,0
2020-03-31-170635,170635,11,0,8,182,14.166666666666664,595.5218735402401,1
2020-04-01-170635,170635,12,0,1,194,11.5,83.56098301364918,2
2020-04-02-170635,170635,5,0,19,199,8.5,229.86167770796456,3
2020-04-03-170635,170635,3,0,3,202,10.833333333333336,127.0033684612981,4
2020-04-04-170635,170635,3,0,2,205,3.1666666666666665,178.7401262746107,5
2020-04-05-170635,170635,1,0,1,206,3.333333333333333,188.35336672356058,6
2020-04-06-170635,170635,5,0,1,211,17.0,200.85186331880877,0
2020-04-07-170635,170635,7,0,5,218,5.5,239.62265883441285,1
2020-04-08-170635,170635,4,0,9,222,5.666666666666668,266.2945528216028,2
2020-04-09-170635,170635,4,0,0,226,3.6666666666666665,285.614252858034,3
2020-04-10-170635,170635,7,0,5,233,5.0,78.88772674452218,4
2020-04-11-170635,170635,3,0,1,236,2.6666666666666665,109.49543025809751,5
2020-04-12-170635,170635,3,0,1,239,2.833333333333333,122.15544691311933,6
2020-04-13-170635,170635,7,0,8,246,8.333333333333334,138.31308985746193,0
2020-04-14-170635,170635,8,0,4,254,4.666666666666667,188.32810016721928,1
2020-04-15-170635,170635,1,0,6,255,4.333333333333333,229.16153803641384,2
2020-04-16-170635,170635,19,0,5,274,6.0,254.18535828744186,3
2020-04-17-170635,170635,3,0,0,277,8.666666666666666,236.75752966268175,4
2020-04-18-170635,170635,2,0,0,279,2.0,248.80260465211057,5
2020-04-19-170635,170635,1,0,0,280,0.5,255.84173557176194,6
2020-04-20-170635,170635,1,0,2,281,7.333333333333332,240.110115526007,0
2020-04-21-170635,170635,5,1,7,286,4.166666666666667,245.5046938902488,1
2020-04-22-170635,170635,9,0,12,295,4.5,255.400736611599,2
2020-04-23-170635,170635,0,0,4,295,1.3333333333333333,244.39021614671438,3
2020-04-24-170635,170635,5,0,6,300,3.0,207.68727150621768,4
2020-04-25-170635,170635,1,0,0,301,1.0,209.7874792567067,5
2020-04-26-170635,170635,1,0,0,302,0.8333333333333334,212.5552975710723,6
2020-04-27-170635,170635,8,0,4,310,5.833333333333332,171.12524152968513,0
2020-04-28-170635,170635,4,0,8,314,2.833333333333333,163.18898359151132,1
2020-04-29-170635,170635,6,0,2,320,4.666666666666667,143.0990911785002,2
2020-04-30-170635,170635,5,0,0,325,3.6666666666666665,193.1189160003716,3
2020-05-01-170635,170635,0,0,5,325,1.0,276.772650667799,4
2020-05-02-170635,170635,0,0,2,325,1.8333333333333333,112.95673448145003,5
2020-05-03-170635,170635,0,0,0,325,1.1666666666666667,73.50385530971461,6
2020-05-04-170635,170635,2,0,0,327,6.0,64.50757848046015,0
2020-05-05-170635,170635,7,0,1,334,5.166666666666667,88.0534987208697,1
2020-05-06-170635,170635,12,0,0,346,2.833333333333333,99.94498328658626,2
2020-05-07-170635,170635,4,0,2,350,2.6666666666666665,125.4784882760402,3
2020-05-08-170635,170635,6,0,5,356,6.5,136.37872149457672,4
2020-05-09-170635,170635,0,0,0,356,1.3333333333333333,187.3689717621833,5
2020-05-10-170635,170635,0,0,0,356,0.6666666666666666,317.4088771062869,6
2020-05-11-170635,170635,4,0,1,360,6.666666666666668,293.0977340828359,0
2020-05-12-170635,170635,8,1,1,368,14.833333333333336,308.714658980291,1
2020-05-13-170635,170635,2,0,4,370,4.0,267.3434404406345,2
2020-05-14-170635,170635,0,0,1,370,3.8333333333333335,243.9365796252412,3
2020-05-15-170635,170635,5,0,4,375,4.833333333333333,210.5900149949174,4
2020-05-16-170635,170635,2,0,1,377,0.6666666666666666,212.04151044438527,5
2020-05-17-170635,170635,0,0,0,377,0.16666666666666666,203.4298121315312,6
2020-05-18-170635,170635,0,0,2,377,2.0,204.5978325666153,0
2020-05-19-170635,170635,1,0,1,378,3.1666666666666665,186.80094408458837,1
2020-05-20-170635,170635,0,0,0,378,3.1666666666666665,134.42993614611294,2
2020-05-21-170635,170635,2,0,2,380,3.1666666666666665,135.25610356343154,3
2020-05-22-170635,170635,5,0,2,385,3.0,121.53819431562634,4
2020-05-23-170635,170635,0,0,0,385,0.0,145.42660133388262,5
2020-05-24-170635,170635,0,0,0,385,0.16666666666666666,147.74697380973558,6
2020-05-25-170635,170635,1,0,0,386,1.5,125.67446194484933,0
2020-05-26-170635,170635,1,0,1,387,2.0,123.10543399851974,1
2020-05-27-170635,170635,4,0,3,391,1.6666666666666667,125.15111963674795,2
2020-05-28-170635,170635,1,1,2,392,2.0,124.47498373389053,3
2020-05-29-170635,170635,4,0,0,396,3.1666666666666665,118.5281705313014,4
2020-05-30-170635,170635,1,0,0,397,0.5,126.05263107509981,5
2020-05-31-170635,170635,0,0,0,397,0.0,130.38486056834716,6
2020-06-01-170635,170635,2,0,1,399,2.1666666666666665,277.6777083256642,0
2020-06-02-170635,170635,1,0,2,400,0.8333333333333334,81.10367089182166,1
2020-06-03-170635,170635,0,0,0,400,2.5,57.093109747048615,2
2020-06-04-170635,170635,2,0,1,402,2.5,63.36324868821428,3
2020-06-05-170635,170635,2,0,1,404,1.1666666666666667,86.06899566639211,4
2020-06-06-170635,170635,0,1,0,404,0.16666666666666666,96.52073662827422,5
2020-06-07-170635,170635,0,0,0,404,0.16666666666666666,98.08577987882649,6
2020-06-08-170635,170635,0,0,0,404,1.5,100.60635028078485,0
2020-06-09-170635,170635,1,0,2,405,2.5,108.15038074244092,1
2020-06-10-170635,170635,3,0,0,408,1.5,349.08307203559923,2
2020-06-11-170635,170635,2,0,0,410,2.5,310.12032510604143,3
2020-06-12-170635,170635,0,0,2,410,0.16666666666666666,295.85930626293896,4
2020-06-13-170635,170635,0,0,0,410,0.3333333333333333,220.54680969310454,5
2020-06-14-170635,170635,0,0,0,410,0.0,170.1780177304857,6
2020-06-15-170635,170635,1,0,0,411,2.5,101.9585525687878,0
2020-06-16-170635,170635,2,0,0,413,1.5,105.79744026767652,1
2020-06-17-170635,170635,0,0,1,413,2.1666666666666665,85.2038896282737,2
2020-06-18-170635,170635,1,0,0,414,2.1666666666666665,81.57828218615789,3
2020-06-19-170635,170635,1,1,0,415,1.8333333333333333,76.00875100383995,4
2020-06-20-170635,170635,0,0,0,415,0.0,124.09062850891907,5
2020-06-21-170635,170635,0,0,0,415,0.0,125.21024313823034,6
2020-06-22-170635,170635,0,0,0,415,2.1666666666666665,108.11992277121136,0
2020-06-23-170635,170635,2,0,3,417,1.6666666666666667,112.76894117954805,1
2020-06-24-170635,170635,0,0,0,417,1.3333333333333333,114.54160885990473,2
2020-06-25-170635,170635,0,2,0,417,1.1666666666666667,101.75204050808534,3
2020-06-26-170635,170635,2,0,0,419,2.0,88.42393645794071,4
2020-06-27-170635,170635,0,0,0,419,0.0,83.3949266571141,5
2020-06-28-170635,170635,0,0,1,419,0.0,85.99769793953102,6
2020-06-29-170635,170635,0,0,2,419,1.5,86.17227325839737,0
2020-06-30-170635,170635,0,0,0,419,1.1666666666666667,88.26415266867886,1
2020-07-01-170635,170635,1,0,1,420,1.8333333333333333,133.16249125947027,2
2020-07-02-170635,170635,0,0,2,420,1.0,45.26018733111698,3
2020-07-03-170635,170635,0,0,0,420,1.1666666666666667,83.197138750886,4
2020-07-04-170635,170635,0,0,0,420,0.0,109.0854717427236,5
2020-07-05-170635,170635,0,0,0,420,0.0,104.55410629237618,6
2020-07-06-170635,170635,0,0,0,420,0.6666666666666666,86.53141645579576,0
2020-07-07-170635,170635,3,0,0,423,0.16666666666666666,81.59062992454906,1
2020-07-08-170635,170635,0,0,0,423,0.5,72.91562041633375,2
2020-07-09-170635,170635,0,2,1,423,1.0,66.29747692942027,3
2020-07-10-170635,170635,0,0,1,423,1.1666666666666667,137.21164583628143,4
2020-07-11-170635,170635,0,0,0,423,0.16666666666666666,104.90756905866084,5
2020-07-12-170635,170635,1,0,3,424,0.0,73.89896966722677,6
2020-07-13-170635,170635,2,0,0,426,0.5,74.85378084093551,0
2020-07-14-170635,170635,0,0,0,426,0.6666666666666666,82.16587868688421,1
2020-07-15-170635,170635,1,0,1,427,0.3333333333333333,69.41149115583215,2
2020-07-16-170635,170635,2,0,0,429,0.8333333333333334,51.61024879797344,3
2020-07-17-170635,170635,0,0,3,429,0.6666666666666666,44.25370308834305,4
2020-07-18-170635,170635,0,0,0,429,0.0,44.18017903298962,5
2020-07-19-170635,170635,0,0,0,429,0.0,43.62265291293144,6
2020-07-20-170635,170635,0,0,3,429,0.8333333333333334,37.938521218492674,0
2020-07-21-170635,170635,0,0,0,429,3.5,41.3749349467775,1
2020-07-22-170635,170635,0,0,1,429,0.6666666666666666,68.76770718564613,2
2020-07-23-170635,170635,1,0,3,430,1.1666666666666667,64.17454062165643,3
2020-07-24-170635,170635,1,0,7,431,0.16666666666666666,73.16006236466703,4
2020-07-25-170635,170635,0,0,2,431,0.0,84.90074894133917,5
2020-07-26-170635,170635,3,0,1,434,0.0,85.51586508545427,6
2020-07-27-170635,170635,0,0,2,434,0.6666666666666666,84.51312539010796,0
2020-07-28-170635,170635,0,0,3,434,1.0,88.68528599396848,1
2020-07-29-170635,170635,1,0,6,435,0.8333333333333334,66.08254480311622,2
2020-07-30-170635,170635,0,0,6,435,1.1666666666666667,69.44721788183435,3
2020-07-31-170635,170635,3,0,3,438,2.833333333333333,79.65198065282472,4
2020-08-01-170635,170635,0,0,2,438,0.3333333333333333,49.42790387398999,5
2020-08-02-170635,170635,0,0,1,438,0.6666666666666666,370.61793108734946,6
2020-08-03-170635,170635,3,0,5,441,2.5,563.3024565156394,0
2020-08-04-170635,170635,0,0,4,441,2.6666666666666665,522.5540094533519,1
2020-08-05-170635,170635,1,1,5,442,4.0,430.7414387681865,2
2020-08-06-170635,170635,3,0,5,445,2.833333333333333,407.1330083244061,3
2020-08-07-170635,170635,7,0,9,452,4.5,319.79110120894455,4
2020-08-08-170635,170635,2,0,0,454,1.0,339.3091496044861,5
2020-08-09-170635,170635,1,0,1,455,0.3333333333333333,331.6993579827598,6
2020-08-10-170635,170635,2,0,4,457,3.6666666666666665,34.74148531956756,0
2020-08-11-170635,170635,3,0,6,460,2.6666666666666665,73.1178443466967,1
2020-08-12-170635,170635,6,1,7,466,3.1666666666666665,108.37457184806344,2
2020-08-13-170635,170635,6,0,11,472,2.6666666666666665,152.89710266090322,3
2020-08-14-170635,170635,3,0,13,475,4.666666666666667,206.93622007253546,4
2020-08-15-170635,170635,2,0,2,477,1.5,254.28306924518185,5
2020-08-16-170635,170635,1,0,2,478,1.5,270.0523761609343,6
2020-08-17-170635,170635,5,0,8,483,8.666666666666666,283.9760022355849,0
2020-08-18-170635,170635,4,0,8,487,3.0,318.0408681289077,1
2020-08-19-170635,170635,5,0,3,492,6.333333333333332,325.3875804505102,2
2020-08-20-170635,170635,5,0,7,497,7.833333333333332,293.9210555447229,3
2020-08-21-170635,170635,9,0,6,506,3.6666666666666665,315.31855680053417,4
2020-08-22-170635,170635,0,0,3,506,0.8333333333333334,349.1293874897291,5
2020-08-23-170635,170635,1,0,2,507,0.6666666666666666,346.68423364812656,6
2020-08-24-170635,170635,4,0,11,511,8.833333333333334,292.26300145692943,0
2020-08-25-170635,170635,6,0,1,517,5.166666666666667,344.25148307119207,1
2020-08-26-170635,170635,7,0,5,524,10.166666666666666,363.86961256679854,2
2020-08-27-170635,170635,11,1,4,535,4.5,453.98135735531304,3
2020-08-28-170635,170635,13,0,5,548,7.333333333333332,449.32061240275493,4
2020-08-29-170635,170635,2,0,2,550,2.333333333333333,502.3866818938077,5
2020-08-30-170635,170635,2,0,1,552,1.8333333333333333,531.0366058159501,6
2020-08-31-170635,170635,8,0,9,560,10.166666666666666,465.5788019866557,0
2020-09-01-170635,170635,8,0,3,568,4.0,313.73827670692225,1
2020-09-02-170635,170635,3,0,2,571,3.8333333333333335,482.9107694326771,2
2020-09-03-170635,170635,7,0,3,578,5.166666666666667,480.90235674639564,3
2020-09-04-170635,170635,6,1,3,584,9.5,459.2762444081767,4
2020-09-05-170635,170635,3,0,0,587,3.333333333333333,504.31976771487837,5
2020-09-06-170635,170635,2,0,1,589,2.5,523.8672349384627,6
2020-09-07-170635,170635,11,0,6,600,6.333333333333332,524.8521124508393,0
2020-09-08-170635,170635,1,0,4,601,2.0,560.6914270526529,1
2020-09-09-170635,170635,5,0,8,606,5.0,499.41820919680026,2
2020-09-10-170635,170635,4,0,4,610,4.5,282.215195474096,3
2020-09-11-170635,170635,5,0,4,615,10.333333333333334,335.10836640715803,4
2020-09-12-170635,170635,2,0,1,617,1.6666666666666667,426.35093514475045,5
2020-09-13-170635,170635,1,0,0,618,1.6666666666666667,428.91774941734224,6
2020-09-14-170635,170635,9,0,4,627,9.5,407.19710752901614,0
2020-09-15-170635,170635,3,0,4,630,4.5,521.041430720009,1
2020-09-16-170635,170635,2,0,4,632,5.5,611.996470695595,2
2020-09-17-170635,170635,3,0,5,635,4.333333333333333,607.3129349219009,3
2020-09-18-170635,170635,3,0,1,638,8.166666666666666,604.2133627978834,4
2020-09-19-170635,170635,0,0,1,638,2.1666666666666665,565.4403542477723,5
2020-09-20-170635,170635,1,1,1,639,2.6666666666666665,587.5707938868438,6
2020-09-21-170635,170635,6,0,3,645,6.833333333333332,480.9903764970299,0
2020-09-22-170635,170635,4,0,5,649,8.166666666666666,533.2535688748317,1
2020-09-23-170635,170635,8,0,4,657,4.5,589.4623333855243,2
2020-09-24-170635,170635,4,0,8,661,8.333333333333334,606.7151271524523,3
2020-09-25-170635,170635,4,0,11,665,4.666666666666667,602.804295931447,4
2020-09-26-170635,170635,1,0,4,666,0.8333333333333334,661.0697059210379,5
2020-09-27-170635,170635,0,0,4,666,1.6666666666666667,640.4825095287817,6
2020-09-28-170635,170635,4,0,5,670,3.0,645.8133919656804,0
2020-09-29-170635,170635,4,0,16,674,5.166666666666667,614.506193726093,1
2020-09-30-170635,170635,4,0,13,678,5.0,585.9031097445906,2
2020-10-01-170635,170635,5,0,11,683,4.5,0.0,3
2020-10-02-170635,170635,1,0,31,684,4.5,1309.048940649454,4
2020-10-03-170635,170635,1,0,1,685,1.5,1604.9313451179978,5
2020-10-04-170635,170635,1,0,11,686,3.0,1444.203831692799,6
2020-10-05-170635,170635,3,1,19,689,8.5,1205.4845610724647,0
2020-10-06-170635,170635,5,3,25,694,10.833333333333336,1067.2002577150552,1
2020-10-07-170635,170635,4,0,34,698,9.333333333333334,917.3038562136285,2
2020-10-08-170635,170635,8,0,28,706,8.166666666666666,894.7282209743356,3
2020-10-09-170635,170635,11,1,31,717,11.5,1015.419126260357,4
2020-10-10-170635,170635,4,0,8,721,3.1666666666666665,83.14225830150795,5
2020-10-11-170635,170635,4,0,4,725,3.1666666666666665,172.0940861436417,6
2020-10-12-170635,170635,5,0,34,730,3.6666666666666665,257.73872831378947,0
2020-10-13-170635,170635,16,0,24,746,12.5,323.25884026071583,1
2020-10-14-170635,170635,13,0,30,759,11.5,538.5256941947135,2
2020-10-15-170635,170635,11,0,17,770,10.833333333333336,728.8422763753147,3
2020-10-16-170635,170635,31,0,27,801,13.0,923.7861503495878,4
2020-10-17-170635,170635,1,0,16,802,3.333333333333333,1122.8874372379196,5
2020-10-18-170635,170635,11,0,7,813,6.0,1077.9176592362328,6
2020-10-19-170635,170635,19,1,2,832,20.0,1081.503529951383,0
2020-10-20-170635,170635,25,0,21,857,17.5,1173.259180879445,1
2020-10-21-170635,170635,34,0,22,891,14.833333333333336,1217.3108251314004,2
2020-10-22-170635,170635,28,0,16,919,18.33333333333333,1277.0344237670574,3
2020-10-23-170635,170635,31,1,17,950,20.166666666666668,1278.9760846564236,4
2020-10-24-170635,170635,8,0,3,958,2.5,1481.842735439219,5
2020-10-25-170635,170635,4,1,5,962,9.833333333333334,1430.9521533998286,6
2020-10-26-170635,170635,34,1,21,996,17.166666666666668,1296.4630299200226,0
2020-10-27-170635,170635,24,0,14,1020,18.0,1497.2333559250512,1
2020-10-28-170635,170635,30,0,12,1050,12.0,1548.018596924353,2
2020-10-29-170635,170635,17,0,12,1067,11.0,1545.7091578673567,3
2020-10-30-170635,170635,27,0,8,1094,18.0,1202.5485130522145,4
2020-10-31-170635,170635,16,0,0,1110,3.5,1366.540974674563,5
2020-11-01-170635,170635,7,1,0,1117,5.166666666666667,815.8760762435888,6
2020-11-02-170635,170635,2,0,0,1119,2.6666666666666665,465.20185940364917,0
2020-11-03-170635,170635,21,0,0,1140,17.333333333333332,426.66782964457576,1
2020-11-04-170635,170635,22,0,0,1162,12.166666666666664,610.3920887921117,2
2020-11-05-170635,170635,16,0,0,1178,9.666666666666666,748.3163400005285,3
2020-11-06-170635,170635,17,0,0,1195,9.666666666666666,834.4516904719949,4
2020-11-07-170635,170635,3,0,0,1198,3.1666666666666665,912.8883254885736,5
2020-11-08-170635,170635,5,0,0,1203,3.6666666666666665,865.5353066012415,6
2020-11-09-170635,170635,21,2,0,1224,11.833333333333336,877.8515112267822,0
2020-11-10-170635,170635,14,1,0,1238,8.333333333333334,815.1948349925119,1
2020-11-11-170635,170635,12,1,0,1250,8.5,888.7218762963518,2
2020-11-12-170635,170635,12,1,0,1262,9.0,861.6734934848962,3
2020-11-13-170635,170635,8,1,0,1270,7.166666666666668,863.408909090216,4
2020-03-01-170636,170636,0,0,4,0,0.14285714285714285,0.0,6
2020-03-02-170636,170636,0,0,12,0,0.2857142857142857,37.562667614834254,0
2020-03-03-170636,170636,0,1,21,0,0.14285714285714285,168.72045891557315,1
2020-03-04-170636,170636,0,0,28,0,0.0,182.88014515183195,2
2020-03-05-170636,170636,0,0,18,0,0.14285714285714285,186.90107847465708,3
2020-03-06-170636,170636,0,0,25,0,0.5714285714285714,159.89102673668475,4
2020-03-07-170636,170636,0,0,9,0,0.0,172.22608956115576,5
2020-03-08-170636,170636,0,0,11,0,0.0,164.87807554184465,6
2020-03-09-170636,170636,1,0,31,1,0.8571428571428571,164.41573928907076,0
2020-03-10-170636,170636,0,0,28,1,0.5714285714285714,272.2288592385461,1
2020-03-11-170636,170636,4,0,26,5,1.4285714285714286,202.0433564902571,2
2020-03-12-170636,170636,1,0,28,6,1.5714285714285714,158.9947890182496,3
2020-03-13-170636,170636,6,0,17,12,3.571428571428572,106.4934423201428,4
2020-03-14-170636,170636,1,0,11,13,3.2857142857142856,104.35942151629482,5
2020-03-15-170636,170636,4,0,7,17,9.285714285714286,94.39558595194407,6
2020-03-16-170636,170636,12,0,21,29,16.857142857142858,70.0735700656727,0
2020-03-17-170636,170636,21,1,12,50,17.428571428571427,113.41238450850682,1
2020-03-18-170636,170636,28,0,15,78,23.857142857142854,154.000179508396,2
2020-03-19-170636,170636,18,0,6,96,20.142857142857142,180.16218124526625,3
2020-03-20-170636,170636,25,0,10,121,23.285714285714285,189.91363062316898,4
2020-03-21-170636,170636,9,0,3,130,11.142857142857142,206.25262264031,5
2020-03-22-170636,170636,11,0,5,141,10.857142857142858,197.10172035340065,6
2020-03-23-170636,170636,31,0,11,172,32.142857142857146,183.91767343485776,0
2020-03-24-170636,170636,28,0,7,200,29.714285714285715,206.83768077899913,1
2020-03-25-170636,170636,26,0,7,226,31.142857142857146,225.94156780425405,2
2020-03-26-170636,170636,28,0,2,254,28.285714285714285,243.7613129313811,3
2020-03-27-170636,170636,17,0,4,271,26.57142857142857,292.68026339983203,4
2020-03-28-170636,170636,11,0,2,282,6.0,296.5697372206928,5
2020-03-29-170636,170636,7,0,3,289,7.428571428571429,287.6883056011911,6
2020-03-30-170636,170636,21,0,6,310,20.428571428571427,226.43522707218307,0
2020-03-31-170636,170636,12,0,6,322,16.857142857142858,210.58391768517305,1
2020-04-01-170636,170636,15,0,1,337,14.285714285714285,30.20902383242112,2
2020-04-02-170636,170636,6,0,4,343,9.857142857142858,85.50417266683289,3
2020-04-03-170636,170636,10,0,6,353,11.0,47.755188625003356,4
2020-04-04-170636,170636,3,0,1,356,5.0,67.64749537183208,5
2020-04-05-170636,170636,5,0,0,361,4.0,71.11438075298337,6
2020-04-06-170636,170636,11,0,5,372,18.571428571428573,75.82887735169702,0
2020-04-07-170636,170636,7,0,4,379,7.857142857142858,91.47665941519193,1
2020-04-08-170636,170636,7,0,4,386,11.0,103.2283804416135,2
2020-04-09-170636,170636,2,0,0,388,5.285714285714286,113.73698985421007,3
2020-04-10-170636,170636,4,0,5,392,8.285714285714286,29.88256053628385,4
2020-04-11-170636,170636,2,0,2,394,3.0,42.16815425578965,5
2020-04-12-170636,170636,3,0,0,397,3.8571428571428568,47.18649650328409,6
2020-04-13-170636,170636,6,0,4,403,10.285714285714286,53.87825816619739,0
2020-04-14-170636,170636,6,0,2,409,8.714285714285714,72.94262569858839,1
2020-04-15-170636,170636,1,0,6,410,5.142857142857143,90.44669121013357,2
2020-04-16-170636,170636,4,0,4,414,7.428571428571429,100.47972790326891,3
2020-04-17-170636,170636,6,0,2,420,8.0,88.80235303442774,4
2020-04-18-170636,170636,1,0,4,421,3.2857142857142856,91.27164208320714,5
2020-04-19-170636,170636,0,0,2,421,2.142857142857143,93.6691968617996,6
2020-04-20-170636,170636,5,1,3,426,10.857142857142858,86.86403791596322,0
2020-04-21-170636,170636,4,0,10,430,6.857142857142858,89.46159527997227,1
2020-04-22-170636,170636,4,0,2,434,5.857142857142858,94.24695734402086,2
2020-04-23-170636,170636,0,0,2,434,1.8571428571428568,93.04529628605485,3
2020-04-24-170636,170636,5,0,4,439,4.285714285714286,81.35887409217386,4
2020-04-25-170636,170636,2,0,0,441,2.0,80.63234227186075,5
2020-04-26-170636,170636,0,0,1,441,1.1428571428571428,82.26458546462271,6
2020-04-27-170636,170636,4,0,10,445,8.285714285714286,68.1372057956999,0
2020-04-28-170636,170636,2,0,14,447,3.8571428571428568,62.461782431293116,1
2020-04-29-170636,170636,6,0,4,453,5.7142857142857135,52.95803563882648,2
2020-04-30-170636,170636,4,0,4,457,4.142857142857143,70.85895608941422,3
2020-05-01-170636,170636,2,0,11,459,1.4285714285714286,106.69980770682622,4
2020-05-02-170636,170636,4,0,1,463,3.0,41.3302317015873,5
2020-05-03-170636,170636,2,0,0,465,0.7142857142857143,27.302801487290942,6
2020-05-04-170636,170636,3,0,1,468,6.142857142857142,22.977034556595125,0
2020-05-05-170636,170636,10,0,0,478,5.857142857142858,29.978634900853073,1
2020-05-06-170636,170636,2,0,2,480,6.571428571428571,32.512795104447214,2
2020-05-07-170636,170636,2,0,0,482,5.0,41.34153417789373,3
2020-05-08-170636,170636,4,0,2,486,8.0,46.474573642565844,4
2020-05-09-170636,170636,0,1,0,486,1.1428571428571428,62.98000265775445,5
2020-05-10-170636,170636,1,0,0,487,0.2857142857142857,120.64944541636932,6
2020-05-11-170636,170636,10,0,2,497,6.571428571428571,111.11624733773719,0
2020-05-12-170636,170636,14,2,2,511,15.428571428571427,115.63502601834054,1
2020-05-13-170636,170636,4,0,1,515,5.142857142857143,100.01756230053319,2
2020-05-14-170636,170636,4,0,0,519,4.285714285714286,89.15499240997313,3
2020-05-15-170636,170636,11,0,0,530,4.857142857142857,74.10142756778937,4
2020-05-16-170636,170636,1,0,3,531,0.8571428571428571,76.07570333686957,5
2020-05-17-170636,170636,0,0,0,531,0.14285714285714285,72.45134627305711,6
2020-05-18-170636,170636,1,0,2,532,3.7142857142857135,72.44024104466946,0
2020-05-19-170636,170636,0,0,1,532,3.0,67.66392853093285,1
2020-05-20-170636,170636,2,0,5,534,4.0,47.97107467204884,2
2020-05-21-170636,170636,0,0,3,534,4.571428571428571,48.762881864527245,3
2020-05-22-170636,170636,2,0,0,536,4.571428571428571,42.77054472048164,4
2020-05-23-170636,170636,0,0,0,536,0.14285714285714285,51.16983133540792,5
2020-05-24-170636,170636,0,0,1,536,0.14285714285714285,51.87742465199402,6
2020-05-25-170636,170636,2,0,1,538,3.0,43.496550915494886,0
2020-05-26-170636,170636,2,0,4,540,2.8571428571428568,44.417526134593935,1
2020-05-27-170636,170636,1,0,0,541,3.4285714285714284,43.52280107285449,2
2020-05-28-170636,170636,0,0,1,541,2.0,42.73744743983223,3
2020-05-29-170636,170636,0,0,0,541,3.2857142857142856,39.762780132654335,4
2020-05-30-170636,170636,3,0,1,544,0.2857142857142857,39.516175815486974,5
2020-05-31-170636,170636,0,0,0,544,0.0,40.51261772884715,6
2020-06-01-170636,170636,2,0,3,546,4.428571428571429,83.02427101990608,0
2020-06-02-170636,170636,1,0,2,547,3.1428571428571432,23.506721985118876,1
2020-06-03-170636,170636,5,0,4,552,3.0,15.999824645253291,2
2020-06-04-170636,170636,3,0,1,555,4.0,18.60567480633454,3
2020-06-05-170636,170636,0,0,2,555,2.4285714285714284,26.34966410042389,4
2020-06-06-170636,170636,0,0,0,555,0.14285714285714285,29.718617658763286,5
2020-06-07-170636,170636,1,0,0,556,0.0,29.797670029224328,6
2020-06-08-170636,170636,1,0,1,557,1.8571428571428568,30.175597091921073,0
2020-06-09-170636,170636,4,0,0,561,2.142857142857143,32.302284958554395,1
2020-06-10-170636,170636,0,0,2,561,2.571428571428572,98.6551292610661,2
2020-06-11-170636,170636,1,0,1,562,1.5714285714285714,87.16073794996603,3
2020-06-12-170636,170636,0,0,3,562,0.2857142857142857,82.34919827123657,4
2020-06-13-170636,170636,1,0,0,563,0.14285714285714285,62.88867445102288,5
2020-06-14-170636,170636,0,1,0,563,0.0,47.685747969414564,6
2020-06-15-170636,170636,3,0,0,566,2.142857142857143,28.677280860981718,0
2020-06-16-170636,170636,2,0,1,568,1.0,29.53444711930772,1
2020-06-17-170636,170636,4,0,1,572,1.2857142857142858,22.519432000184494,2
2020-06-18-170636,170636,1,0,2,573,2.0,21.45962529457192,3
2020-06-19-170636,170636,2,0,1,575,2.2857142857142856,20.176635035520917,4
2020-06-20-170636,170636,0,0,0,575,0.0,34.02268262270383,5
2020-06-21-170636,170636,0,0,0,575,0.0,34.12347375283064,6
2020-06-22-170636,170636,1,0,0,576,2.571428571428572,29.597716024125624,0
2020-06-23-170636,170636,0,0,0,576,1.4285714285714286,31.34218046771614,1
2020-06-24-170636,170636,2,0,1,578,0.7142857142857143,31.07858036531235,2
2020-06-25-170636,170636,1,1,2,579,0.5714285714285714,28.032285954927083,3
2020-06-26-170636,170636,3,0,1,582,1.8571428571428568,23.92962824646669,4
2020-06-27-170636,170636,0,0,0,582,0.0,20.986044242524635,5
2020-06-28-170636,170636,0,0,0,582,0.0,21.322110306692913,6
2020-06-29-170636,170636,0,0,0,582,1.1428571428571428,21.321914119549056,0
2020-06-30-170636,170636,1,0,0,583,0.5714285714285714,22.46648342734408,1
2020-07-01-170636,170636,1,0,0,584,1.0,36.23248992534638,2
2020-07-02-170636,170636,2,0,0,586,0.14285714285714285,10.534064905436967,3
2020-07-03-170636,170636,1,0,1,587,1.1428571428571428,22.285090229495523,4
2020-07-04-170636,170636,0,0,0,587,0.0,28.393773485294368,5
2020-07-05-170636,170636,0,0,0,587,0.0,27.5234827918663,6
2020-07-06-170636,170636,0,0,2,587,0.5714285714285714,22.95477232519424,0
2020-07-07-170636,170636,0,0,0,587,0.8571428571428571,21.18283374794986,1
2020-07-08-170636,170636,1,0,2,588,0.14285714285714285,18.972243397741124,2
2020-07-09-170636,170636,2,0,0,590,0.42857142857142855,16.87863199262361,3
2020-07-10-170636,170636,1,0,0,591,1.0,36.487970242013375,4
2020-07-11-170636,170636,0,0,0,591,0.14285714285714285,27.077767112809827,5
2020-07-12-170636,170636,0,0,0,591,0.14285714285714285,18.63962831801574,6
2020-07-13-170636,170636,0,0,1,591,0.7142857142857143,18.804816380273046,0
2020-07-14-170636,170636,0,0,1,591,0.2857142857142857,20.416744569146548,1
2020-07-15-170636,170636,0,0,0,591,1.0,16.607234837250868,2
2020-07-16-170636,170636,0,0,2,591,1.0,11.331656633684789,3
2020-07-17-170636,170636,1,0,1,592,0.14285714285714285,10.3062454042616,4
2020-07-18-170636,170636,0,0,0,592,0.0,10.302124968292029,5
2020-07-19-170636,170636,0,0,1,592,0.0,10.225777604983318,6
2020-07-20-170636,170636,2,0,7,594,0.8571428571428571,8.768041852027295,0
2020-07-21-170636,170636,0,0,2,594,1.0,10.021627928939381,1
2020-07-22-170636,170636,2,0,3,596,0.5714285714285714,14.421786388995603,2
2020-07-23-170636,170636,0,0,3,596,1.1428571428571428,13.917613255781422,3
2020-07-24-170636,170636,0,0,4,596,1.5714285714285714,16.388974773457218,4
2020-07-25-170636,170636,0,0,1,596,0.0,20.38365729398966,5
2020-07-26-170636,170636,0,0,1,596,0.42857142857142855,20.59446390171326,6
2020-07-27-170636,170636,1,0,6,597,0.8571428571428571,20.55468164947412,0
2020-07-28-170636,170636,1,0,7,598,1.1428571428571428,21.71635024406912,1
2020-07-29-170636,170636,0,0,2,598,1.1428571428571428,18.596628511984328,2
2020-07-30-170636,170636,2,0,0,600,0.8571428571428571,19.20981278189794,3
2020-07-31-170636,170636,1,0,3,601,3.4285714285714284,21.29054993761138,4
2020-08-01-170636,170636,0,0,0,601,0.5714285714285714,11.874011669587624,5
2020-08-02-170636,170636,1,0,1,602,1.0,90.82155905441337,6
2020-08-03-170636,170636,7,0,6,609,1.8571428571428568,144.98720840316878,0
2020-08-04-170636,170636,2,0,3,611,1.2857142857142858,132.63884725525247,1
2020-08-05-170636,170636,3,0,4,614,4.571428571428571,110.227550462562,2
2020-08-06-170636,170636,3,0,3,617,3.0,103.25557396154201,3
2020-08-07-170636,170636,4,0,3,621,5.571428571428571,79.52305419198252,4
2020-08-08-170636,170636,1,0,2,622,1.1428571428571428,84.8064151115882,5
2020-08-09-170636,170636,1,0,0,623,1.1428571428571428,82.30710502543602,6
2020-08-10-170636,170636,6,0,6,629,2.8571428571428568,8.829867724406828,0
2020-08-11-170636,170636,7,0,5,636,3.571428571428572,18.30491332375865,1
2020-08-12-170636,170636,2,0,7,638,4.0,27.6204609385344,2
2020-08-13-170636,170636,0,0,7,638,6.571428571428571,38.90707464340119,3
2020-08-14-170636,170636,3,0,4,641,4.142857142857143,52.088435280402,4
2020-08-15-170636,170636,0,0,0,641,3.0,64.1560036612299,5
2020-08-16-170636,170636,1,0,2,642,1.5714285714285714,68.54661458515132,6
2020-08-17-170636,170636,6,0,4,648,6.7142857142857135,71.6330502179087,0
2020-08-18-170636,170636,3,0,4,651,3.1428571428571432,79.31346591079392,1
2020-08-19-170636,170636,4,0,2,655,6.0,80.04313782716747,2
2020-08-20-170636,170636,3,0,5,658,6.7142857142857135,71.96413328814745,3
2020-08-21-170636,170636,3,0,9,661,6.142857142857142,76.25017495988165,4
2020-08-22-170636,170636,2,0,5,663,0.5714285714285714,83.868794291407,5
2020-08-23-170636,170636,0,0,8,663,1.2857142857142858,83.34812522095375,6
2020-08-24-170636,170636,6,0,11,669,6.857142857142858,72.15802028244666,0
2020-08-25-170636,170636,5,0,2,674,8.428571428571429,84.41661608604363,1
2020-08-26-170636,170636,7,0,5,681,8.0,92.02322622299526,2
2020-08-27-170636,170636,7,0,3,688,6.0,113.94912097826503,3
2020-08-28-170636,170636,4,0,14,692,13.142857142857142,116.55295700393758,4
2020-08-29-170636,170636,0,0,0,692,3.0,132.76105419864103,5
2020-08-30-170636,170636,2,0,4,694,2.0,138.81157330200566,6
2020-08-31-170636,170636,4,0,6,698,11.857142857142858,123.92777169481256,0
2020-09-01-170636,170636,4,0,6,702,6.428571428571429,78.50602309118378,1
2020-09-02-170636,170636,2,0,8,704,4.714285714285714,127.84389269078768,2
2020-09-03-170636,170636,5,0,3,709,5.7142857142857135,127.82510046067692,3
2020-09-04-170636,170636,9,0,8,718,10.857142857142858,120.85197701324665,4
2020-09-05-170636,170636,5,0,2,723,3.0,132.6059405420096,5
2020-09-06-170636,170636,8,0,5,731,2.571428571428572,137.38821183586344,6
2020-09-07-170636,170636,11,0,4,742,8.428571428571429,136.36992144942002,0
2020-09-08-170636,170636,2,0,3,744,4.0,142.19325769503558,1
2020-09-09-170636,170636,5,0,4,749,4.571428571428571,127.74073143936099,2
2020-09-10-170636,170636,3,0,7,752,6.428571428571429,70.60741372764599,3
2020-09-11-170636,170636,14,0,3,766,12.857142857142858,85.22837167673329,4
2020-09-12-170636,170636,0,0,0,766,3.2857142857142856,109.87398645678348,5
2020-09-13-170636,170636,4,0,1,770,3.4285714285714284,110.85941181350957,6
2020-09-14-170636,170636,6,0,3,776,12.142857142857142,106.54853234246288,0
2020-09-15-170636,170636,6,0,3,782,7.857142857142858,134.68082698154674,1
2020-09-16-170636,170636,8,0,3,790,6.428571428571429,158.43249142893458,2
2020-09-17-170636,170636,3,0,2,793,5.857142857142858,155.57521653470317,3
2020-09-18-170636,170636,8,0,2,801,8.285714285714286,153.68277189675732,4
2020-09-19-170636,170636,2,0,3,803,2.2857142857142856,142.9230887562243,5
2020-09-20-170636,170636,5,0,0,808,3.1428571428571432,146.83058068141605,6
2020-09-21-170636,170636,4,0,6,812,11.428571428571427,122.57415943681532,0
2020-09-22-170636,170636,3,0,13,815,9.142857142857142,134.15912237374746,1
2020-09-23-170636,170636,4,1,8,819,6.7142857142857135,148.33169780628353,2
2020-09-24-170636,170636,7,0,8,826,8.857142857142858,154.87074686947872,3
2020-09-25-170636,170636,3,0,12,829,6.857142857142858,152.34680304142938,4
2020-09-26-170636,170636,0,0,2,829,2.0,166.3505536708473,5
2020-09-27-170636,170636,1,0,1,830,2.4285714285714284,160.01648998412463,6
2020-09-28-170636,170636,3,1,4,833,5.142857142857143,160.29231871722112,0
2020-09-29-170636,170636,3,0,11,836,7.7142857142857135,152.08645324168168,1
2020-09-30-170636,170636,3,0,13,839,6.0,142.47887838308682,2
2020-10-01-170636,170636,2,0,5,841,5.428571428571429,0.0,3
2020-10-02-170636,170636,2,0,7,843,5.7142857142857135,290.5490086723916,4
2020-10-03-170636,170636,3,0,7,846,2.142857142857143,361.01604934201214,5
2020-10-04-170636,170636,0,0,1,846,3.571428571428572,324.5910133394689,6
2020-10-05-170636,170636,6,0,9,852,8.857142857142858,272.0312909023556,0
2020-10-06-170636,170636,13,0,15,865,9.428571428571429,247.59367834979292,1
2020-10-07-170636,170636,8,0,15,873,8.571428571428571,211.94043494277747,2
2020-10-08-170636,170636,8,1,21,881,7.7142857142857135,205.9814866680796,3
2020-10-09-170636,170636,12,1,12,893,11.142857142857142,232.52927867407988,4
2020-10-10-170636,170636,2,0,3,895,5.571428571428571,18.864274207873244,5
2020-10-11-170636,170636,1,0,9,896,5.285714285714286,39.655512055803655,6
2020-10-12-170636,170636,4,0,29,900,4.428571428571429,59.237333839908786,0
2020-10-13-170636,170636,11,0,9,911,14.285714285714285,73.75781001968717,1
2020-10-14-170636,170636,13,0,9,924,11.0,119.88118766380134,2
2020-10-15-170636,170636,5,0,11,929,11.571428571428573,159.08586450081071,3
2020-10-16-170636,170636,7,0,22,936,19.142857142857142,202.10682217719707,4
2020-10-17-170636,170636,7,0,3,943,3.7142857142857135,247.72022663702518,5
2020-10-18-170636,170636,1,0,11,944,8.142857142857142,240.37237826147526,6
2020-10-19-170636,170636,9,0,6,953,20.571428571428573,243.39992000989923,0
2020-10-20-170636,170636,15,0,24,968,19.0,267.0007923312956,1
2020-10-21-170636,170636,15,1,8,983,19.142857142857142,281.22026484623495,2
2020-10-22-170636,170636,21,1,5,1004,20.285714285714285,298.3200684998515,3
2020-10-23-170636,170636,12,1,10,1016,25.57142857142857,302.58091446994695,4
2020-10-24-170636,170636,3,1,4,1019,3.8571428571428568,353.85096350121853,5
2020-10-25-170636,170636,9,1,5,1028,10.285714285714286,343.8339045182199,6
2020-10-26-170636,170636,29,0,7,1057,20.142857142857142,313.83930354741915,0
2020-10-27-170636,170636,9,0,6,1066,20.142857142857142,359.6839109234513,1
2020-10-28-170636,170636,9,1,3,1075,17.428571428571427,371.71665772041246,2
2020-10-29-170636,170636,11,1,6,1086,14.0,372.4866386018751,3
2020-10-30-170636,170636,22,1,2,1108,20.0,291.49735689914064,4
2020-10-31-170636,170636,3,1,0,1111,4.571428571428571,331.4119973148387,5
2020-11-01-170636,170636,11,3,0,1122,4.142857142857143,197.58450283299112,6
2020-11-02-170636,170636,6,0,0,1128,2.4285714285714284,109.39009227464288,0
2020-11-03-170636,170636,24,0,0,1152,17.571428571428573,100.26593845901795,1
2020-11-04-170636,170636,8,0,0,1160,16.714285714285715,145.9130225613217,2
2020-11-05-170636,170636,5,0,0,1165,12.142857142857142,179.27909041595944,3
2020-11-06-170636,170636,10,1,0,1175,13.285714285714285,195.9062536471559,4
2020-11-07-170636,170636,4,0,0,1179,3.1428571428571432,217.049521972759,5
2020-11-08-170636,170636,5,0,0,1184,4.0,209.4932837121341,6
2020-11-09-170636,170636,7,0,0,1191,15.428571428571427,212.90474628565727,0
2020-11-10-170636,170636,6,0,0,1197,10.285714285714286,197.2311769308419,1
2020-11-11-170636,170636,3,2,0,1200,10.428571428571429,213.9076122018223,2
2020-11-12-170636,170636,6,0,0,1206,8.142857142857142,203.7351339852622,3
2020-11-13-170636,170636,2,2,0,1208,8.285714285714286,204.62968563072252,4
2020-03-01-170637,170637,0,0,9,0,0.0,0.0,6
2020-03-02-170637,170637,1,0,6,1,0.2,82.8903984682153,0
2020-03-03-170637,170637,0,2,15,1,0.2,395.2684202558862,1
2020-03-04-170637,170637,0,0,10,1,0.0,433.3129910025876,2
2020-03-05-170637,170637,0,0,6,1,0.2,444.77342403899866,3
2020-03-06-170637,170637,2,0,11,3,0.2,379.699176302914,4
2020-03-07-170637,170637,0,0,3,3,0.0,402.513328518673,5
2020-03-08-170637,170637,0,0,8,3,0.2,376.5810552265815,6
2020-03-09-170637,170637,1,0,19,4,0.2,374.2156436598896,0
2020-03-10-170637,170637,1,0,17,5,0.2,637.8950879726408,1
2020-03-11-170637,170637,2,0,48,7,2.6,468.86825130446755,2
2020-03-12-170637,170637,0,0,11,7,1.6,369.1702434226126,3
2020-03-13-170637,170637,3,0,28,10,3.8,246.88481144877517,4
2020-03-14-170637,170637,3,0,6,13,2.8,243.09916546083937,5
2020-03-15-170637,170637,9,0,6,22,9.4,225.8228601292001,6
2020-03-16-170637,170637,6,0,5,28,15.4,167.07107931739563,0
2020-03-17-170637,170637,15,0,7,43,19.6,265.00615530509947,1
2020-03-18-170637,170637,10,0,10,53,19.0,360.31602114396475,2
2020-03-19-170637,170637,6,0,5,59,22.2,417.0907473566484,3
2020-03-20-170637,170637,11,0,5,70,28.0,443.42749299551883,4
2020-03-21-170637,170637,3,0,3,73,9.8,491.1416473435091,5
2020-03-22-170637,170637,8,0,3,81,11.0,468.4100246848128,6
2020-03-23-170637,170637,19,0,8,100,36.8,440.1338299661686,0
2020-03-24-170637,170637,17,0,6,117,33.2,498.24012848041025,1
2020-03-25-170637,170637,48,0,7,165,29.2,538.4535324593319,2
2020-03-26-170637,170637,11,1,4,176,32.6,584.5623092058113,3
2020-03-27-170637,170637,28,0,6,204,28.4,698.2126242524095,4
2020-03-28-170637,170637,6,0,1,210,9.6,710.4011486312022,5
2020-03-29-170637,170637,6,0,3,216,9.8,697.8377385731133,6
2020-03-30-170637,170637,5,0,6,221,23.2,548.3757630967036,0
2020-03-31-170637,170637,7,0,6,228,18.2,518.4095476918624,1
2020-04-01-170637,170637,10,0,4,238,20.8,70.60837302116369,2
2020-04-02-170637,170637,5,0,5,243,10.6,195.43391984449875,3
2020-04-03-170637,170637,5,0,5,248,17.6,107.46350256981106,4
2020-04-04-170637,170637,3,0,4,251,5.2,156.87403470570297,5
2020-04-05-170637,170637,3,0,1,254,4.2,165.96071131269775,6
2020-04-06-170637,170637,8,0,2,262,19.2,177.46636995893124,0
2020-04-07-170637,170637,6,1,6,268,16.6,214.89262554838652,1
2020-04-08-170637,170637,7,0,5,275,11.4,237.3543435595933,2
2020-04-09-170637,170637,4,1,0,279,5.8,257.6089027334747,3
2020-04-10-170637,170637,6,0,8,285,8.4,71.2648348367704,4
2020-04-11-170637,170637,1,0,4,286,2.8,101.05014243531404,5
2020-04-12-170637,170637,3,0,0,289,7.0,111.15935779092064,6
2020-04-13-170637,170637,6,0,5,295,10.6,125.1296079684513,0
2020-04-14-170637,170637,6,0,5,301,14.6,167.93336191965454,1
2020-04-15-170637,170637,4,0,10,305,6.2,203.4324443174573,2
2020-04-16-170637,170637,5,0,1,310,7.4,228.22622881918673,3
2020-04-17-170637,170637,5,0,3,315,10.2,205.8038403443067,4
2020-04-18-170637,170637,4,0,0,319,4.2,212.2562459088184,5
2020-04-19-170637,170637,1,0,1,320,0.8,218.75714406409566,6
2020-04-20-170637,170637,2,1,2,322,13.6,205.06981524560655,0
2020-04-21-170637,170637,6,0,3,328,11.8,217.0771496213102,1
2020-04-22-170637,170637,5,0,10,333,8.4,226.33935452713797,2
2020-04-23-170637,170637,0,0,1,333,1.8,215.43801282165003,3
2020-04-24-170637,170637,8,0,1,341,5.2,183.4584740332466,4
2020-04-25-170637,170637,4,0,2,345,2.2,184.00495298557252,5
2020-04-26-170637,170637,0,0,0,345,1.0,187.8026079977034,6
2020-04-27-170637,170637,5,0,6,350,7.4,152.8736737157019,0
2020-04-28-170637,170637,5,0,4,355,3.6,137.99481353451807,1
2020-04-29-170637,170637,10,0,3,365,5.2,118.87336053461783,2
2020-04-30-170637,170637,1,0,3,366,6.0,165.0264512775562,3
2020-05-01-170637,170637,3,0,3,369,3.6,239.18668353026075,4
2020-05-02-170637,170637,0,0,0,369,4.0,95.8701446746907,5
2020-05-03-170637,170637,1,0,0,370,0.8,63.10344434431126,6
2020-05-04-170637,170637,2,0,2,372,7.0,53.637252612076026,0
2020-05-05-170637,170637,3,0,2,375,5.6,71.54682356302088,1
2020-05-06-170637,170637,10,0,1,385,4.6,78.96154739719654,2
2020-05-07-170637,170637,1,0,6,386,4.8,102.78725834470077,3
2020-05-08-170637,170637,1,0,1,387,8.4,110.42690985226783,4
2020-05-09-170637,170637,2,0,0,389,1.6,149.98570287874523,5
2020-05-10-170637,170637,0,0,0,389,0.8,263.68727247651225,6
2020-05-11-170637,170637,6,0,1,395,9.2,243.04433126673456,0
2020-05-12-170637,170637,4,0,2,399,13.6,256.43686747565323,1
2020-05-13-170637,170637,3,0,0,402,7.2,217.12359471787278,2
2020-05-14-170637,170637,3,0,3,405,4.0,196.6019197396924,3
2020-05-15-170637,170637,3,0,2,408,8.4,167.15196368706813,4
2020-05-16-170637,170637,0,0,0,408,0.8,169.56376356199002,5
2020-05-17-170637,170637,0,0,0,408,0.0,162.87492242498075,6
2020-05-18-170637,170637,2,0,3,410,3.4,162.727813726129,0
2020-05-19-170637,170637,2,0,5,412,2.0,149.05024155828593,1
2020-05-20-170637,170637,1,0,3,413,4.6,109.00294163080787,2
2020-05-21-170637,170637,6,0,0,419,3.0,111.30573665567121,3
2020-05-22-170637,170637,1,0,2,420,4.6,98.23520458601232,4
2020-05-23-170637,170637,0,0,0,420,0.0,116.6782290742832,5
2020-05-24-170637,170637,0,0,0,420,0.0,117.47148856721563,6
2020-05-25-170637,170637,1,0,2,421,4.8,98.61036391230664,0
2020-05-26-170637,170637,2,0,0,423,3.4,99.00443310155651,1
2020-05-27-170637,170637,0,0,2,423,3.0,98.4488292983069,2
2020-05-28-170637,170637,3,0,1,426,1.2,94.61104356343117,3
2020-05-29-170637,170637,2,1,0,428,2.8,86.63031467387836,4
2020-05-30-170637,170637,0,0,0,428,1.0,88.18555538531173,5
2020-05-31-170637,170637,0,0,0,428,0.2,89.87882439023193,6
2020-06-01-170637,170637,3,0,1,431,4.0,190.57501888473575,0
2020-06-02-170637,170637,5,0,0,436,2.4,53.67933223195709,1
2020-06-03-170637,170637,3,0,2,439,2.6,38.67173402635118,2
2020-06-04-170637,170637,0,0,2,439,3.4,42.73228539526806,3
2020-06-05-170637,170637,2,0,1,441,2.0,58.04456901541181,4
2020-06-06-170637,170637,0,0,0,441,0.0,64.24649409792933,5
2020-06-07-170637,170637,0,0,0,441,0.2,64.41062676302272,6
2020-06-08-170637,170637,2,0,0,443,2.2,65.22712281156724,0
2020-06-09-170637,170637,0,0,1,443,2.8,69.21287689690737,1
2020-06-10-170637,170637,2,0,0,445,1.4,221.90260506428956,2
2020-06-11-170637,170637,1,0,1,446,3.0,194.99326681952016,3
2020-06-12-170637,170637,0,0,2,446,0.4,185.66619776017677,4
2020-06-13-170637,170637,0,0,0,446,0.2,138.94346065207833,5
2020-06-14-170637,170637,0,0,0,446,0.0,106.75181774951969,6
2020-06-15-170637,170637,1,0,0,447,1.4,63.88643558213267,0
2020-06-16-170637,170637,0,0,0,447,3.8,64.81028173566587,1
2020-06-17-170637,170637,2,0,1,449,2.6,51.8441154492488,2
2020-06-18-170637,170637,2,0,0,451,1.2,49.774733436813534,3
2020-06-19-170637,170637,1,0,2,452,2.6,45.48269631545239,4
2020-06-20-170637,170637,0,0,0,452,0.0,74.76320511769799,5
2020-06-21-170637,170637,0,0,0,452,0.0,75.19559289472807,6
2020-06-22-170637,170637,0,0,0,452,2.8,65.58004080501644,0
2020-06-23-170637,170637,1,0,0,453,1.4,68.25161506114281,1
2020-06-24-170637,170637,0,1,0,453,0.8,68.0433619813729,2
2020-06-25-170637,170637,1,1,0,454,0.6,61.15773714812192,3
2020-06-26-170637,170637,2,0,0,456,2.8,52.42419587740574,4
2020-06-27-170637,170637,0,0,0,456,0.2,47.549363486774425,5
2020-06-28-170637,170637,0,0,0,456,0.0,48.18565494892988,6
2020-06-29-170637,170637,0,0,0,456,2.0,48.10090317876584,0
2020-06-30-170637,170637,0,0,0,456,0.2,49.49855784172541,1
2020-07-01-170637,170637,1,0,0,457,1.2,75.015222832188,2
2020-07-02-170637,170637,0,0,1,457,0.4,23.95317910796944,3
2020-07-03-170637,170637,2,0,0,459,1.4,47.95823825177755,4
2020-07-04-170637,170637,0,0,0,459,0.0,61.94006194356038,5
2020-07-05-170637,170637,0,0,0,459,0.0,59.71610561434009,6
2020-07-06-170637,170637,0,0,1,459,0.0,49.805244568308005,0
2020-07-07-170637,170637,0,0,2,459,0.8,46.24392555643064,1
2020-07-08-170637,170637,0,0,0,459,0.2,41.04250693757514,2
2020-07-09-170637,170637,0,0,2,459,0.8,36.6798270574534,3
2020-07-10-170637,170637,0,0,2,459,0.4,77.79291052052247,4
2020-07-11-170637,170637,0,0,0,459,0.0,58.80529435716761,5
2020-07-12-170637,170637,0,0,0,459,0.0,40.5881221223894,6
2020-07-13-170637,170637,0,0,0,459,0.4,41.16741866582622,0
2020-07-14-170637,170637,0,0,0,459,0.4,45.23879316462319,1
2020-07-15-170637,170637,0,0,2,459,0.6,37.461975947337244,2
2020-07-16-170637,170637,1,0,1,460,0.8,26.575182879533315,3
2020-07-17-170637,170637,0,0,2,460,0.4,23.51769873453605,4
2020-07-18-170637,170637,0,0,0,460,0.0,23.732061824177606,5
2020-07-19-170637,170637,0,0,3,460,0.0,23.640488791497347,6
2020-07-20-170637,170637,1,0,2,461,1.8,19.79467935248106,0
2020-07-21-170637,170637,2,1,0,463,0.8,22.64993303574514,1
2020-07-22-170637,170637,0,0,0,463,1.6,35.76026756568272,2
2020-07-23-170637,170637,2,0,1,465,0.8,33.590267000248616,3
2020-07-24-170637,170637,2,0,3,467,1.2,39.57664283307523,4
2020-07-25-170637,170637,0,0,0,467,0.2,47.485059507255,5
2020-07-26-170637,170637,0,0,0,467,0.0,47.821275371711586,6
2020-07-27-170637,170637,0,0,3,467,1.4,47.763865910559566,0
2020-07-28-170637,170637,0,0,5,467,1.2,49.87375796197869,1
2020-07-29-170637,170637,2,0,4,469,0.6,39.529067120704404,2
2020-07-30-170637,170637,1,0,3,470,1.4,41.046931764304944,3
2020-07-31-170637,170637,2,0,2,472,3.4,46.69157225547786,4
2020-08-01-170637,170637,0,0,1,472,1.0,25.37216809288268,5
2020-08-02-170637,170637,3,0,2,475,0.8,201.57572475837532,6
2020-08-03-170637,170637,2,0,0,477,3.6,316.29052015002463,0
2020-08-04-170637,170637,0,0,2,477,1.8,290.95224597022514,1
2020-08-05-170637,170637,0,0,3,477,4.8,241.02110714091614,2
2020-08-06-170637,170637,1,0,6,478,3.4,225.68722476721672,3
2020-08-07-170637,170637,3,0,2,481,3.4,175.73163674879973,4
2020-08-08-170637,170637,0,0,0,481,2.0,186.6827993273217,5
2020-08-09-170637,170637,0,0,0,481,1.4,181.52385543003155,6
2020-08-10-170637,170637,3,0,4,484,5.2,18.02328081584838,0
2020-08-11-170637,170637,5,0,9,489,3.2,41.66473589945734,1
2020-08-12-170637,170637,4,0,3,493,4.2,62.13177505974542,2
2020-08-13-170637,170637,3,0,3,496,3.8,87.18447077993784,3
2020-08-14-170637,170637,2,0,5,498,4.0,114.2220192014588,4
2020-08-15-170637,170637,1,0,4,499,2.8,141.02365914747762,5
2020-08-16-170637,170637,2,0,4,501,1.6,150.01750498047173,6
2020-08-17-170637,170637,0,0,6,501,5.8,156.43574967368852,0
2020-08-18-170637,170637,2,0,2,503,4.0,171.98819920196058,1
2020-08-19-170637,170637,3,0,2,506,5.6,173.6057618744194,2
2020-08-20-170637,170637,6,0,1,512,6.2,157.55627378490033,3
2020-08-21-170637,170637,2,0,4,514,2.4,168.20033801644433,4
2020-08-22-170637,170637,0,0,2,514,1.6,183.3608317229813,5
2020-08-23-170637,170637,0,0,3,514,3.2,182.39304283845306,6
2020-08-24-170637,170637,4,0,2,518,8.4,154.86438313164587,0
2020-08-25-170637,170637,9,0,3,527,7.6,182.32405311156703,1
2020-08-26-170637,170637,3,0,1,530,9.0,197.14327332459496,2
2020-08-27-170637,170637,3,0,3,533,7.2,248.80970810723346,3
2020-08-28-170637,170637,5,1,4,538,9.4,250.15206354721002,4
2020-08-29-170637,170637,4,0,1,542,1.8,284.79591304101035,5
2020-08-30-170637,170637,4,0,1,546,2.6,300.9435133367562,6
2020-08-31-170637,170637,6,0,6,552,7.0,267.0501662028073,0
2020-09-01-170637,170637,2,0,12,554,4.4,172.1787964404212,1
2020-09-02-170637,170637,2,0,12,556,2.6,276.2898637643746,2
2020-09-03-170637,170637,1,0,9,557,7.0,277.0526954246693,3
2020-09-04-170637,170637,4,0,10,561,12.4,262.1075136202703,4
2020-09-05-170637,170637,2,0,4,563,3.0,283.81216755291086,5
2020-09-06-170637,170637,3,0,3,566,2.0,294.40633440427274,6
2020-09-07-170637,170637,2,0,16,568,7.4,293.01007943258196,0
2020-09-08-170637,170637,3,0,9,571,4.2,307.71928106846553,1
2020-09-09-170637,170637,1,0,14,572,6.4,276.1028962047764,2
2020-09-10-170637,170637,3,0,4,575,5.6,154.2617367128522,3
2020-09-11-170637,170637,4,0,8,579,13.2,184.991275582806,4
2020-09-12-170637,170637,1,0,1,580,2.4,239.75902609335492,5
2020-09-13-170637,170637,1,0,0,581,3.0,240.79123680153089,6
2020-09-14-170637,170637,6,0,0,587,13.2,228.76343165939906,0
2020-09-15-170637,170637,12,0,8,599,7.4,287.714077850875,1
2020-09-16-170637,170637,12,0,4,611,6.8,339.7626481091158,2
2020-09-17-170637,170637,9,0,6,620,7.8,337.80898148544304,3
2020-09-18-170637,170637,10,0,2,630,14.4,337.9453831518096,4
2020-09-19-170637,170637,4,0,10,634,3.4,316.90901862734313,5
2020-09-20-170637,170637,3,0,3,637,3.8,329.7963627792835,6
2020-09-21-170637,170637,16,1,3,653,12.4,277.4134205553247,0
2020-09-22-170637,170637,9,0,2,662,16.6,301.31726134504595,1
2020-09-23-170637,170637,14,0,8,676,12.0,332.9104241822823,2
2020-09-24-170637,170637,4,0,3,680,12.6,344.8494100795184,3
2020-09-25-170637,170637,8,0,6,688,10.8,336.11573726356147,4
2020-09-26-170637,170637,1,0,4,689,3.2,366.97925813598704,5
2020-09-27-170637,170637,0,0,4,689,3.2,354.3020741685648,6
2020-09-28-170637,170637,0,0,2,689,7.6,356.20739853365575,0
2020-09-29-170637,170637,8,0,9,697,5.4,340.52769084825854,1
2020-09-30-170637,170637,4,0,4,701,7.8,317.88487667697126,2
2020-10-01-170637,170637,6,0,4,707,6.8,0.0,3
2020-10-02-170637,170637,2,0,10,709,8.6,714.2324783025977,4
2020-10-03-170637,170637,10,0,1,719,1.8,882.0776685556905,5
2020-10-04-170637,170637,3,0,0,722,3.2,782.1978796402555,6
2020-10-05-170637,170637,3,1,7,725,19.8,654.5514826914797,0
2020-10-06-170637,170637,2,0,10,727,9.2,583.6790675302851,1
2020-10-07-170637,170637,8,0,11,735,12.2,503.1732309076026,2
2020-10-08-170637,170637,3,0,12,738,11.0,489.6952717871654,3
2020-10-09-170637,170637,6,0,16,744,12.6,549.8684164810111,4
2020-10-10-170637,170637,4,0,1,748,5.8,46.67135538400277,5
2020-10-11-170637,170637,4,0,1,752,5.4,98.70671065450708,6
2020-10-12-170637,170637,2,0,15,754,4.4,143.10271088030657,0
2020-10-13-170637,170637,9,0,5,763,13.2,178.48479238617105,1
2020-10-14-170637,170637,4,0,11,767,11.6,292.8866403835032,2
2020-10-15-170637,170637,4,0,10,771,11.6,393.1261437723025,3
2020-10-16-170637,170637,10,0,10,781,15.6,496.0834030176819,4
2020-10-17-170637,170637,1,0,1,782,5.6,607.3120744588362,5
2020-10-18-170637,170637,0,0,1,782,12.0,592.8400601085706,6
2020-10-19-170637,170637,7,0,0,789,18.6,610.9662254960949,0
2020-10-20-170637,170637,10,0,10,799,20.0,665.0142696556916,1
2020-10-21-170637,170637,11,1,9,810,19.4,702.2373372293353,2
2020-10-22-170637,170637,12,0,8,822,20.8,747.9157159302047,3
2020-10-23-170637,170637,16,0,6,838,24.0,762.673643053038,4
2020-10-24-170637,170637,1,0,0,839,5.2,888.6803678500497,5
2020-10-25-170637,170637,1,0,0,840,13.0,864.3012188907367,6
2020-10-26-170637,170637,15,0,2,855,21.8,798.0246901392675,0
2020-10-27-170637,170637,5,0,3,860,21.0,916.7920427872865,1
2020-10-28-170637,170637,11,1,1,871,13.8,939.9315496229983,2
2020-10-29-170637,170637,10,1,2,881,13.4,934.5486657761295,3
2020-10-30-170637,170637,10,0,3,891,23.2,723.9550555828447,4
2020-10-31-170637,170637,1,1,0,892,3.6,821.6589490075537,5
2020-11-01-170637,170637,1,0,0,893,6.2,481.39900985480296,6
2020-11-02-170637,170637,0,0,0,893,3.8,252.56847606632897,0
2020-11-03-170637,170637,10,0,0,903,18.8,233.3499018150471,1
2020-11-04-170637,170637,9,0,0,912,16.4,341.1097993187285,2
2020-11-05-170637,170637,8,0,0,920,8.6,423.51301928869805,3
2020-11-06-170637,170637,6,1,0,926,11.8,468.84740649297925,4
2020-11-07-170637,170637,0,0,0,926,4.2,521.074679272195,5
2020-11-08-170637,170637,0,0,0,926,4.8,504.45037139104977,6
2020-11-09-170637,170637,2,0,0,928,16.4,513.8810062094324,0
2020-11-10-170637,170637,3,0,0,931,8.0,487.35664969406395,1
2020-11-11-170637,170637,1,0,0,932,12.2,531.1027442630907,2
2020-11-12-170637,170637,2,0,0,934,9.0,518.6034495837241,3
2020-11-13-170637,170637,3,1,0,937,6.4,525.9476030041217,4
2020-03-01-170701,170701,0,0,1,0,0.0,0.0,6
2020-03-02-170701,170701,0,1,3,0,0.0,33.22427435325234,0
2020-03-03-170701,170701,1,0,4,1,0.0,129.0145188847207,1
2020-03-04-170701,170701,0,0,8,1,0.0,142.0315023859269,2
2020-03-05-170701,170701,0,0,12,1,0.0,148.79779971760794,3
2020-03-06-170701,170701,0,0,10,1,0.16666666666666666,144.38267215414044,4
2020-03-07-170701,170701,1,0,5,2,0.16666666666666666,138.1762574102138,5
2020-03-08-170701,170701,0,1,14,2,0.0,135.2030871282856,6
2020-03-09-170701,170701,0,0,22,2,0.16666666666666666,137.12671898678585,0
2020-03-10-170701,170701,0,0,22,2,0.0,174.93880744384387,1
2020-03-11-170701,170701,0,0,11,2,0.3333333333333333,144.61806315257064,2
2020-03-12-170701,170701,0,0,9,2,0.8333333333333334,112.07415460720472,3
2020-03-13-170701,170701,0,0,18,2,0.8333333333333334,79.59992249722748,4
2020-03-14-170701,170701,1,0,5,3,1.1666666666666667,64.20132593629485,5
2020-03-15-170701,170701,1,0,0,4,1.1666666666666667,51.32504230280524,6
2020-03-16-170701,170701,3,0,11,7,6.166666666666668,23.196778142668926,0
2020-03-17-170701,170701,4,0,8,11,5.333333333333333,51.67927305164685,1
2020-03-18-170701,170701,8,0,19,19,10.666666666666666,77.43171592411608,2
2020-03-19-170701,170701,12,0,6,31,13.0,144.63006608122413,3
2020-03-20-170701,170701,10,0,7,41,7.5,202.1026012729471,4
2020-03-21-170701,170701,5,0,0,46,5.0,227.03496660749957,5
2020-03-22-170701,170701,14,0,4,60,8.5,244.25949279667043,6
2020-03-23-170701,170701,22,0,3,82,12.5,262.4363578246446,0
2020-03-24-170701,170701,22,0,1,104,9.833333333333334,299.71201971467946,1
2020-03-25-170701,170701,11,0,9,115,12.166666666666664,297.09909850568687,2
2020-03-26-170701,170701,9,2,4,124,10.666666666666666,279.44992991965637,3
2020-03-27-170701,170701,18,0,2,142,13.666666666666664,323.782473625876,4
2020-03-28-170701,170701,5,0,1,147,5.833333333333332,326.5067636395372,5
2020-03-29-170701,170701,0,0,0,147,4.5,326.4841620287564,6
2020-03-30-170701,170701,11,0,3,158,11.833333333333336,240.1577931538755,0
2020-03-31-170701,170701,8,0,3,166,8.0,224.017632665196,1
2020-04-01-170701,170701,19,0,3,185,8.333333333333334,37.50525925270456,2
2020-04-02-170701,170701,6,0,2,191,12.166666666666664,145.0530872598285,3
2020-04-03-170701,170701,7,0,4,198,5.666666666666668,118.84547351716716,4
2020-04-04-170701,170701,0,0,14,198,7.666666666666668,121.9430769603107,5
2020-04-05-170701,170701,4,0,2,202,3.6666666666666665,137.17944101648558,6
2020-04-06-170701,170701,3,0,3,205,8.833333333333334,145.13987263193025,0
2020-04-07-170701,170701,1,1,7,206,7.5,120.51990905217738,1
2020-04-08-170701,170701,9,0,1,215,3.5,132.094169730153,2
2020-04-09-170701,170701,4,0,3,219,4.333333333333333,136.25586317406976,3
2020-04-10-170701,170701,2,0,3,221,2.833333333333333,43.42817438330945,4
2020-04-11-170701,170701,1,0,2,222,1.5,50.94964060166919,5
2020-04-12-170701,170701,0,0,1,222,2.6666666666666665,55.23561942705565,6
2020-04-13-170701,170701,3,0,2,225,9.666666666666666,61.76454640974519,0
2020-04-14-170701,170701,3,0,4,228,5.0,104.36607726534547,1
2020-04-15-170701,170701,3,0,3,231,5.833333333333332,119.13517158319632,2
2020-04-16-170701,170701,2,0,3,233,2.6666666666666665,137.10925084987485,3
2020-04-17-170701,170701,4,0,1,237,1.8333333333333333,111.81917878503617,4
2020-04-18-170701,170701,14,0,0,251,7.833333333333332,122.32090596019077,5
2020-04-19-170701,170701,2,0,0,253,4.666666666666667,155.68361884901353,6
2020-04-20-170701,170701,3,1,0,256,2.833333333333333,152.00141908500197,0
2020-04-21-170701,170701,7,0,0,263,6.833333333333332,150.675270127356,1
2020-04-22-170701,170701,1,0,0,264,6.166666666666668,154.6009575370694,2
2020-04-23-170701,170701,3,0,2,267,1.8333333333333333,158.59288480319725,3
2020-04-24-170701,170701,3,0,3,270,4.5,150.0959292457089,4
2020-04-25-170701,170701,2,0,0,272,1.0,133.1806851587522,5
2020-04-26-170701,170701,1,0,1,273,1.0,125.06632211100342,6
2020-04-27-170701,170701,2,0,2,275,9.666666666666666,95.8532222853562,0
2020-04-28-170701,170701,4,0,5,279,3.8333333333333335,135.18241564805658,1
2020-04-29-170701,170701,3,0,1,282,4.333333333333333,127.42283317511833,2
2020-04-30-170701,170701,3,0,5,285,5.0,133.83531329974613,3
2020-05-01-170701,170701,1,0,5,286,1.1666666666666667,142.15589454673574,4
2020-05-02-170701,170701,0,0,0,286,0.16666666666666666,86.39656977391935,5
2020-05-03-170701,170701,0,0,0,286,0.16666666666666666,80.7343672154714,6
2020-05-04-170701,170701,0,0,6,286,1.6666666666666667,52.804500890626635,0
2020-05-05-170701,170701,0,0,4,286,3.0,45.74884069513882,1
2020-05-06-170701,170701,0,0,4,286,1.6666666666666667,28.591548183983477,2
2020-05-07-170701,170701,2,0,2,288,3.6666666666666665,27.684065901087667,3
2020-05-08-170701,170701,3,0,2,291,3.0,32.77442245638896,4
2020-05-09-170701,170701,0,0,3,291,2.0,45.92159785416208,5
2020-05-10-170701,170701,1,0,3,292,0.8333333333333334,149.5113185032091,6
2020-05-11-170701,170701,2,1,5,294,3.8333333333333335,129.4114144716769,0
2020-05-12-170701,170701,5,0,3,299,3.0,121.38734839734343,1
2020-05-13-170701,170701,1,0,5,300,3.1666666666666665,104.55796648291908,2
2020-05-14-170701,170701,5,0,1,305,3.6666666666666665,97.47043555538829,3
2020-05-15-170701,170701,5,0,1,310,4.5,96.25326159492569,4
2020-05-16-170701,170701,0,0,0,310,1.8333333333333333,91.59296825529086,5
2020-05-17-170701,170701,0,0,0,310,2.0,94.3823478183957,6
2020-05-18-170701,170701,6,0,1,316,4.0,96.57545874748482,0
2020-05-19-170701,170701,4,0,2,320,4.0,99.91267843120936,1
2020-05-20-170701,170701,4,0,1,324,4.166666666666667,91.76772005536439,2
2020-05-21-170701,170701,2,0,0,326,3.1666666666666665,87.84687558488166,3
2020-05-22-170701,170701,2,0,1,328,5.0,86.58431463557662,4
2020-05-23-170701,170701,3,0,0,331,1.1666666666666667,96.82411440202107,5
2020-05-24-170701,170701,3,0,1,334,1.6666666666666667,100.08051255788381,6
2020-05-25-170701,170701,5,0,3,339,4.333333333333333,96.45286549444256,0
2020-05-26-170701,170701,3,0,0,342,3.5,97.90068049339558,1
2020-05-27-170701,170701,5,2,0,347,5.166666666666667,117.52366160268211,2
2020-05-28-170701,170701,1,0,0,348,2.0,131.50924117586334,3
2020-05-29-170701,170701,1,0,2,349,1.5,125.05100035769549,4
2020-05-30-170701,170701,0,0,0,349,0.0,104.46931745977973,5
2020-05-31-170701,170701,0,1,0,349,0.16666666666666666,95.32320263462425,6
2020-06-01-170701,170701,1,0,0,350,1.3333333333333333,67.32807185444747,0
2020-06-02-170701,170701,2,1,0,352,1.6666666666666667,59.226665804799254,1
2020-06-03-170701,170701,1,0,0,353,1.6666666666666667,41.63028531621977,2
2020-06-04-170701,170701,0,0,1,353,1.5,38.655322708078586,3
2020-06-05-170701,170701,1,0,2,354,1.0,41.19668751829367,4
2020-06-06-170701,170701,0,0,0,354,0.3333333333333333,39.08437071835306,5
2020-06-07-170701,170701,1,0,0,355,0.6666666666666666,40.185001859355225,6
2020-06-08-170701,170701,3,0,0,358,1.8333333333333333,41.6017017320368,0
2020-06-09-170701,170701,0,0,0,358,1.5,44.68405515419957,1
2020-06-10-170701,170701,0,0,0,358,0.8333333333333334,72.35893461999314,2
2020-06-11-170701,170701,0,0,0,358,0.8333333333333334,67.8009765234074,3
2020-06-12-170701,170701,2,0,0,360,1.3333333333333333,62.489646266264856,4
2020-06-13-170701,170701,0,0,1,360,0.5,62.135361337205744,5
2020-06-14-170701,170701,0,0,0,360,0.3333333333333333,49.48575896036066,6
2020-06-15-170701,170701,0,3,1,360,1.1666666666666667,37.13414686586833,0
2020-06-16-170701,170701,0,0,2,360,1.8333333333333333,34.57634824273745,1
2020-06-17-170701,170701,0,0,0,360,1.5,36.84090272992884,2
2020-06-18-170701,170701,1,0,0,361,2.0,41.75406340788262,3
2020-06-19-170701,170701,2,0,0,363,2.833333333333333,44.998143193115204,4
2020-06-20-170701,170701,0,0,1,363,0.3333333333333333,68.91375814476048,5
2020-06-21-170701,170701,0,0,0,363,0.16666666666666666,68.06470950044086,6
2020-06-22-170701,170701,0,0,3,363,1.0,62.78661166748326,0
2020-06-23-170701,170701,0,0,1,363,1.8333333333333333,58.66379837042603,1
2020-06-24-170701,170701,0,0,0,363,0.5,67.15473172776812,2
2020-06-25-170701,170701,0,0,0,363,1.5,63.82987373260069,3
2020-06-26-170701,170701,0,0,0,363,1.1666666666666667,45.70140514108586,4
2020-06-27-170701,170701,1,0,0,364,0.16666666666666666,44.624587036551155,5
2020-06-28-170701,170701,0,0,0,364,0.3333333333333333,48.23413216920788,6
2020-06-29-170701,170701,1,0,0,365,0.3333333333333333,51.56766875831021,0
2020-06-30-170701,170701,2,0,0,367,0.5,46.30199548935025,1
2020-07-01-170701,170701,0,0,1,367,0.5,58.86964763705357,2
2020-07-02-170701,170701,0,0,1,367,0.8333333333333334,48.734763761008224,3
2020-07-03-170701,170701,0,0,1,367,1.3333333333333333,58.39744079946689,4
2020-07-04-170701,170701,1,0,2,368,0.16666666666666666,81.81431036898653,5
2020-07-05-170701,170701,0,0,0,368,0.0,81.54210519567799,6
2020-07-06-170701,170701,3,0,1,371,0.5,79.89037052063485,0
2020-07-07-170701,170701,1,0,0,372,0.3333333333333333,75.18934228569637,1
2020-07-08-170701,170701,0,1,2,372,0.8333333333333334,64.19808879980056,2
2020-07-09-170701,170701,0,0,2,372,1.1666666666666667,55.85799006418783,3
2020-07-10-170701,170701,0,1,0,372,1.1666666666666667,51.01146236537723,4
2020-07-11-170701,170701,0,0,1,372,0.5,51.66431844990035,5
2020-07-12-170701,170701,0,0,0,372,0.3333333333333333,48.173055874218775,6
2020-07-13-170701,170701,0,0,0,372,0.5,47.73759963284246,0
2020-07-14-170701,170701,0,0,2,372,0.6666666666666666,45.484051184159426,1
2020-07-15-170701,170701,1,0,2,373,2.0,42.190779197909016,2
2020-07-16-170701,170701,1,0,9,374,2.333333333333333,45.115752948745055,3
2020-07-17-170701,170701,1,1,1,375,1.0,50.88275273846766,4
2020-07-18-170701,170701,2,0,2,377,0.3333333333333333,45.898447302658894,5
2020-07-19-170701,170701,0,0,0,377,0.3333333333333333,51.03566872464571,6
2020-07-20-170701,170701,1,0,2,378,1.1666666666666667,48.10282419023743,0
2020-07-21-170701,170701,0,0,0,378,0.6666666666666666,51.89120210660108,1
2020-07-22-170701,170701,2,0,1,380,2.1666666666666665,44.623092825712675,2
2020-07-23-170701,170701,2,0,0,382,0.8333333333333334,50.24879582147079,3
2020-07-24-170701,170701,0,0,4,382,1.8333333333333333,47.36506443073523,4
2020-07-25-170701,170701,1,0,6,383,0.3333333333333333,64.49030418860114,5
2020-07-26-170701,170701,0,0,4,383,0.0,64.94186919967773,6
2020-07-27-170701,170701,0,0,3,383,0.8333333333333334,61.8815040569457,0
2020-07-28-170701,170701,2,0,8,385,1.3333333333333333,54.22049844817285,1
2020-07-29-170701,170701,2,0,2,387,1.1666666666666667,61.310340323101116,2
2020-07-30-170701,170701,9,0,6,396,1.5,67.5650393798777,3
2020-07-31-170701,170701,1,0,22,397,1.1666666666666667,72.40710829801266,4
2020-08-01-170701,170701,2,0,5,399,0.6666666666666666,31.512856653942713,5
2020-08-02-170701,170701,0,0,3,399,0.6666666666666666,354.86214883541413,6
2020-08-03-170701,170701,2,0,21,401,0.3333333333333333,171.95819710737536,0
2020-08-04-170701,170701,0,0,30,401,0.5,147.86734889396604,1
2020-08-05-170701,170701,1,0,10,402,1.6666666666666667,117.55821189741204,2
2020-08-06-170701,170701,0,0,7,402,1.3333333333333333,111.79632803573926,3
2020-08-07-170701,170701,4,0,6,406,0.8333333333333334,111.34093795584505,4
2020-08-08-170701,170701,6,0,1,412,0.3333333333333333,91.98957691249166,5
2020-08-09-170701,170701,4,0,0,416,1.1666666666666667,102.2554907457079,6
2020-08-10-170701,170701,3,0,8,419,1.6666666666666667,30.433861556588994,0
2020-08-11-170701,170701,8,0,2,427,1.5,64.04959830497152,1
2020-08-12-170701,170701,2,0,1,429,3.0,97.69077517971229,2
2020-08-13-170701,170701,6,0,2,435,3.8333333333333335,137.81207001147502,3
2020-08-14-170701,170701,22,0,3,457,2.0,194.30863284339236,4
2020-08-15-170701,170701,5,0,0,462,1.3333333333333333,262.70198191738314,5
2020-08-16-170701,170701,3,0,0,465,1.5,285.0892359189728,6
2020-08-17-170701,170701,21,0,2,486,3.6666666666666665,308.8532416742694,0
2020-08-18-170701,170701,30,0,7,516,3.0,335.1667657506828,1
2020-08-19-170701,170701,10,0,1,526,4.333333333333333,388.15509122008325,2
2020-08-20-170701,170701,7,1,1,533,1.8333333333333333,363.8958656590301,3
2020-08-21-170701,170701,6,0,14,539,3.1666666666666665,311.33834544721526,4
2020-08-22-170701,170701,1,0,2,540,1.1666666666666667,313.3851242272496,5
2020-08-23-170701,170701,0,0,2,540,0.8333333333333334,300.16785845550373,6
2020-08-24-170701,170701,8,0,3,548,2.6666666666666665,239.75401932390298,0
2020-08-25-170701,170701,2,0,6,550,3.0,211.26116634960266,1
2020-08-26-170701,170701,1,1,0,551,2.333333333333333,159.63569483716873,2
2020-08-27-170701,170701,2,0,3,553,4.833333333333333,184.7562609302144,3
2020-08-28-170701,170701,3,0,6,556,1.6666666666666667,182.2917150976224,4
2020-08-29-170701,170701,0,1,0,556,1.6666666666666667,162.95168395654932,5
2020-08-30-170701,170701,0,0,0,556,1.1666666666666667,174.8225208250189,6
2020-08-31-170701,170701,2,0,8,558,2.6666666666666665,152.58419887301577,0
2020-09-01-170701,170701,7,0,2,565,2.833333333333333,76.96551254317173,1
2020-09-02-170701,170701,1,0,8,566,1.5,163.47833509804445,2
2020-09-03-170701,170701,1,0,10,567,3.5,157.39650818499607,3
2020-09-04-170701,170701,14,0,7,581,2.5,166.3283794680898,4
2020-09-05-170701,170701,2,0,3,583,1.6666666666666667,150.7108404961157,5
2020-09-06-170701,170701,2,0,1,585,0.8333333333333334,146.49494103794223,6
2020-09-07-170701,170701,3,0,16,588,2.6666666666666665,150.17074872946392,0
2020-09-08-170701,170701,6,0,5,594,4.0,151.56214098327888,1
2020-09-09-170701,170701,0,0,10,594,2.6666666666666665,174.74431375050796,2
2020-09-10-170701,170701,3,0,2,597,3.5,72.39705433028863,3
2020-09-11-170701,170701,6,0,11,603,3.5,93.19440012028545,4
2020-09-12-170701,170701,0,0,0,603,1.3333333333333333,110.41835117332448,5
2020-09-13-170701,170701,0,0,1,603,0.6666666666666666,115.12723484539154,6
2020-09-14-170701,170701,8,0,4,611,5.166666666666667,117.49094183070886,0
2020-09-15-170701,170701,2,0,3,613,1.8333333333333333,146.21869837734403,1
2020-09-16-170701,170701,8,0,4,621,3.1666666666666665,155.47286129728232,2
2020-09-17-170701,170701,10,0,1,631,3.0,162.93993920556477,3
2020-09-18-170701,170701,7,0,3,638,3.333333333333333,166.53361222086696,4
2020-09-19-170701,170701,3,0,0,641,1.3333333333333333,160.61134911963381,5
2020-09-20-170701,170701,1,0,3,642,2.6666666666666665,146.45817419289392,6
2020-09-21-170701,170701,16,0,2,658,4.333333333333333,115.62323088034043,0
2020-09-22-170701,170701,5,1,4,663,5.0,115.81978403869293,1
2020-09-23-170701,170701,10,2,0,673,4.166666666666667,119.11946900733305,2
2020-09-24-170701,170701,2,0,7,675,3.5,120.46506400498872,3
2020-09-25-170701,170701,11,1,5,686,6.0,112.10938715160339,4
2020-09-26-170701,170701,0,0,2,686,1.5,143.11999895230747,5
2020-09-27-170701,170701,1,0,0,687,1.3333333333333333,151.7359231058191,6
2020-09-28-170701,170701,4,0,6,691,3.1666666666666665,153.7861113136944,0
2020-09-29-170701,170701,3,1,5,694,2.333333333333333,155.82724772745053,1
2020-09-30-170701,170701,4,0,0,698,2.1666666666666665,146.69770662972076,2
2020-10-01-170701,170701,1,0,1,699,2.0,0.0,3
2020-10-02-170701,170701,3,0,1,702,3.6666666666666665,158.0211573308709,4
2020-10-03-170701,170701,0,0,3,702,1.1666666666666667,226.51576502314475,5
2020-10-04-170701,170701,3,1,2,705,1.5,219.156056153802,6
2020-10-05-170701,170701,2,0,3,707,2.6666666666666665,208.45349539470516,0
2020-10-06-170701,170701,4,0,1,711,3.333333333333333,204.4702535435856,1
2020-10-07-170701,170701,0,1,1,711,2.1666666666666665,193.00001519256574,2
2020-10-08-170701,170701,7,0,3,718,2.833333333333333,152.07085245274638,3
2020-10-09-170701,170701,5,0,2,723,3.1666666666666665,175.8922006874217,4
2020-10-10-170701,170701,2,0,0,725,1.6666666666666667,15.714784353911439,5
2020-10-11-170701,170701,0,0,2,725,2.1666666666666665,32.3477633626551,6
2020-10-12-170701,170701,6,0,4,731,1.1666666666666667,55.31619083778375,0
2020-10-13-170701,170701,5,0,1,736,2.5,72.13889970101988,1
2020-10-14-170701,170701,0,0,5,736,3.1666666666666665,92.33443544696786,2
2020-10-15-170701,170701,1,0,8,737,3.6666666666666665,109.70221085513225,3
2020-10-16-170701,170701,1,0,3,738,5.166666666666667,131.74626816763742,4
2020-10-17-170701,170701,3,0,0,741,1.8333333333333333,142.8062727361328,5
2020-10-18-170701,170701,2,0,0,743,2.6666666666666665,148.3899604390598,6
2020-10-19-170701,170701,3,0,0,746,2.6666666666666665,143.3036462202673,0
2020-10-20-170701,170701,1,0,10,747,3.1666666666666665,150.95564248681222,1
2020-10-21-170701,170701,1,0,6,748,3.333333333333333,153.12551954788412,2
2020-10-22-170701,170701,3,0,7,751,6.0,159.55095995332704,3
2020-10-23-170701,170701,2,0,10,753,3.8333333333333335,171.3426571315425,4
2020-10-24-170701,170701,0,1,0,753,2.833333333333333,170.28716156176367,5
2020-10-25-170701,170701,2,0,2,755,2.5,185.06690879389242,6
2020-10-26-170701,170701,4,0,7,759,2.833333333333333,178.3190912682671,0
2020-10-27-170701,170701,1,0,7,760,3.6666666666666665,173.84521425827955,1
2020-10-28-170701,170701,5,0,1,765,4.0,173.14472405085192,2
2020-10-29-170701,170701,8,0,1,773,4.833333333333333,178.02967606099224,3
2020-10-30-170701,170701,3,0,3,776,6.666666666666668,182.83706706145034,4
2020-10-31-170701,170701,0,0,0,776,4.5,169.8568643807525,5
2020-11-01-170701,170701,0,0,0,776,1.1666666666666667,159.1997355004735,6
2020-11-02-170701,170701,0,0,0,776,2.833333333333333,100.37161318166508,0
2020-11-03-170701,170701,10,0,0,786,3.333333333333333,98.18221775793822,1
2020-11-04-170701,170701,6,1,0,792,3.1666666666666665,123.98491185350059,2
2020-11-05-170701,170701,7,1,0,799,3.8333333333333335,129.37647004279967,3
2020-11-06-170701,170701,10,0,0,809,4.833333333333333,146.960100430127,4
2020-11-07-170701,170701,0,0,0,809,1.5,163.3955008204212,5
2020-11-08-170701,170701,2,0,0,811,1.0,159.8854270045697,6
2020-11-09-170701,170701,7,0,0,818,3.333333333333333,148.90920535975062,0
2020-11-10-170701,170701,7,0,0,825,2.0,126.29113277218342,1
2020-11-11-170701,170701,1,0,0,826,3.8333333333333335,129.92141627351396,2
2020-11-12-170701,170701,1,0,0,827,2.333333333333333,143.0719591631295,3
2020-11-13-170701,170701,3,0,0,830,3.5,128.2829478584668,4
2020-03-01-170702,170702,0,0,3,0,0.0,0.0,6
2020-03-02-170702,170702,0,0,14,0,0.0,48.20099916160376,0
2020-03-03-170702,170702,0,0,5,0,0.16666666666666666,201.34163361021953,1
2020-03-04-170702,170702,0,0,14,0,0.0,245.62354075058175,2
2020-03-05-170702,170702,0,1,29,0,0.16666666666666666,266.7337966043331,3
2020-03-06-170702,170702,0,0,13,0,0.16666666666666666,247.28521167485988,4
2020-03-07-170702,170702,0,0,14,0,0.3333333333333333,245.56266218794894,5
2020-03-08-170702,170702,0,0,16,0,0.0,242.32198077535685,6
2020-03-09-170702,170702,0,0,16,0,0.16666666666666666,254.3345989186188,0
2020-03-10-170702,170702,0,0,11,0,0.0,242.07115221474788,1
2020-03-11-170702,170702,0,0,23,0,0.3333333333333333,195.59792153754125,2
2020-03-12-170702,170702,1,0,11,1,0.6666666666666666,140.52729455076934,3
2020-03-13-170702,170702,2,0,18,3,0.5,85.57126480675853,4
2020-03-14-170702,170702,4,0,16,7,0.6666666666666666,74.53412532102047,5
2020-03-15-170702,170702,3,0,7,10,1.0,73.75040273954521,6
2020-03-16-170702,170702,14,0,22,24,5.833333333333332,47.71551129197054,0
2020-03-17-170702,170702,5,1,16,29,8.166666666666666,103.81212885916452,1
2020-03-18-170702,170702,14,1,9,43,9.833333333333334,145.56520685414077,2
2020-03-19-170702,170702,29,0,6,72,10.5,224.15353946737832,3
2020-03-20-170702,170702,13,0,9,85,10.5,304.3313924007188,4
2020-03-21-170702,170702,14,0,11,99,4.0,338.53467372409,5
2020-03-22-170702,170702,16,0,5,115,10.0,361.9053612266433,6
2020-03-23-170702,170702,16,0,5,131,19.33333333333333,373.15484771245815,0
2020-03-24-170702,170702,11,0,24,142,13.5,422.4841844921144,1
2020-03-25-170702,170702,23,0,3,165,13.833333333333336,410.8394290510579,2
2020-03-26-170702,170702,11,0,17,176,13.5,400.30535484965145,3
2020-03-27-170702,170702,18,0,0,194,18.666666666666668,464.4896526635214,4
2020-03-28-170702,170702,16,0,3,210,5.166666666666667,482.70911221964303,5
2020-03-29-170702,170702,7,0,5,217,4.333333333333333,479.72560584617486,6
2020-03-30-170702,170702,22,0,6,239,11.333333333333336,359.4925183611387,0
2020-03-31-170702,170702,16,0,6,255,7.5,374.88281975445744,1
2020-04-01-170702,170702,9,0,5,264,12.5,56.526826826489824,2
2020-04-02-170702,170702,6,0,4,270,13.666666666666664,217.30056236993897,3
2020-04-03-170702,170702,9,0,4,279,7.166666666666668,179.57222227098862,4
2020-04-04-170702,170702,11,0,3,290,6.333333333333332,209.6798450990234,5
2020-04-05-170702,170702,5,2,1,295,5.333333333333333,243.61022907609424,6
2020-04-06-170702,170702,5,0,5,300,10.5,262.3891404629463,0
2020-04-07-170702,170702,24,0,19,324,4.833333333333333,234.99627982598673,1
2020-04-08-170702,170702,3,0,1,327,6.166666666666668,267.0087174875923,2
2020-04-09-170702,170702,17,0,2,344,3.5,266.23794764180604,3
2020-04-10-170702,170702,0,0,4,344,4.0,56.9149514546394,4
2020-04-11-170702,170702,3,0,3,347,1.8333333333333333,66.02246380866916,5
2020-04-12-170702,170702,5,0,0,352,2.6666666666666665,76.61033905733763,6
2020-04-13-170702,170702,6,1,25,358,9.5,93.88855707555344,0
2020-04-14-170702,170702,6,0,9,364,5.5,149.652803103959,1
2020-04-15-170702,170702,5,0,7,369,6.666666666666668,174.93908412991243,2
2020-04-16-170702,170702,4,0,9,373,3.6666666666666665,202.8299265918171,3
2020-04-17-170702,170702,4,0,1,377,3.8333333333333335,178.67123637706857,4
2020-04-18-170702,170702,3,0,0,380,9.5,195.94569776535496,5
2020-04-19-170702,170702,1,0,1,381,5.0,237.05386473408578,6
2020-04-20-170702,170702,5,0,3,386,7.5,250.8231791176294,0
2020-04-21-170702,170702,19,0,4,405,5.5,251.4750613987688,1
2020-04-22-170702,170702,1,0,2,406,7.0,265.2153319318627,2
2020-04-23-170702,170702,2,0,7,408,2.0,280.92737345215454,3
2020-04-24-170702,170702,4,0,5,412,5.166666666666667,274.4380348744321,4
2020-04-25-170702,170702,3,0,3,415,1.3333333333333333,264.0947204334496,5
2020-04-26-170702,170702,0,0,0,415,0.6666666666666666,259.22166700212085,6
2020-04-27-170702,170702,25,0,7,440,3.1666666666666665,189.73243912564695,0
2020-04-28-170702,170702,9,0,3,449,4.666666666666667,247.8877796233993,1
2020-04-29-170702,170702,7,0,5,456,4.833333333333333,234.5720291048332,2
2020-04-30-170702,170702,9,0,7,465,4.5,262.5690954281083,3
2020-05-01-170702,170702,1,0,10,466,1.5,299.53582552631997,4
2020-05-02-170702,170702,0,0,2,466,1.1666666666666667,148.79749233304005,5
2020-05-03-170702,170702,1,0,3,467,1.1666666666666667,110.96408834295511,6
2020-05-04-170702,170702,3,0,7,470,3.0,72.69843198963123,0
2020-05-05-170702,170702,4,0,6,474,4.166666666666667,55.32765714248188,1
2020-05-06-170702,170702,2,0,9,476,2.833333333333333,43.24726846688672,2
2020-05-07-170702,170702,7,0,4,483,4.666666666666667,47.05419024208007,3
2020-05-08-170702,170702,5,0,12,488,3.8333333333333335,66.31449577103758,4
2020-05-09-170702,170702,3,0,1,491,1.5,94.14334461292893,5
2020-05-10-170702,170702,0,0,2,491,1.1666666666666667,273.9259826020482,6
2020-05-11-170702,170702,7,2,9,498,4.166666666666667,228.34901626991655,0
2020-05-12-170702,170702,3,3,3,501,4.333333333333333,263.3329025519283,1
2020-05-13-170702,170702,5,0,14,506,2.833333333333333,230.67540208306085,2
2020-05-14-170702,170702,7,0,3,513,4.833333333333333,192.12358810046396,3
2020-05-15-170702,170702,10,0,3,523,4.166666666666667,196.04977375916735,4
2020-05-16-170702,170702,2,0,0,525,2.333333333333333,187.1299540563002,5
2020-05-17-170702,170702,3,0,0,528,2.0,194.68597577308284,6
2020-05-18-170702,170702,7,0,4,535,5.666666666666668,204.60416197755842,0
2020-05-19-170702,170702,6,0,3,541,5.0,200.9706838765881,1
2020-05-20-170702,170702,9,0,4,550,5.333333333333333,178.6822746720061,2
2020-05-21-170702,170702,4,0,6,554,5.166666666666667,178.17174464244047,3
2020-05-22-170702,170702,12,0,4,566,4.166666666666667,164.50921483301698,4
2020-05-23-170702,170702,1,0,0,567,2.5,191.01265757746722,5
2020-05-24-170702,170702,2,0,2,569,2.0,187.03990613880438,6
2020-05-25-170702,170702,9,0,4,578,5.666666666666668,164.09426119160906,0
2020-05-26-170702,170702,3,0,3,581,4.333333333333333,175.01671221986962,1
2020-05-27-170702,170702,14,1,3,595,4.833333333333333,209.08626350925897,2
2020-05-28-170702,170702,3,0,0,598,2.1666666666666665,222.31625530796424,3
2020-05-29-170702,170702,3,0,1,601,1.5,211.3383961127201,4
2020-05-30-170702,170702,0,0,3,601,0.16666666666666666,175.66277750492526,5
2020-05-31-170702,170702,0,0,1,601,0.16666666666666666,164.03676828975193,6
2020-06-01-170702,170702,4,0,0,605,1.6666666666666667,139.87220373677155,0
2020-06-02-170702,170702,3,0,4,608,1.5,94.58641379944265,1
2020-06-03-170702,170702,4,0,2,612,1.5,56.261535250670974,2
2020-06-04-170702,170702,6,0,5,618,0.16666666666666666,52.21036105666066,3
2020-06-05-170702,170702,4,0,6,622,1.1666666666666667,52.06175066689224,4
2020-06-06-170702,170702,0,0,0,622,0.16666666666666666,53.37447255901635,5
2020-06-07-170702,170702,2,0,0,624,0.6666666666666666,52.58686845398663,6
2020-06-08-170702,170702,4,0,2,628,2.1666666666666665,56.8809341607654,0
2020-06-09-170702,170702,3,1,3,631,1.8333333333333333,67.84637247455836,1
2020-06-10-170702,170702,3,0,1,634,0.6666666666666666,140.46863291194813,2
2020-06-11-170702,170702,0,0,4,634,1.3333333333333333,133.21959804313025,3
2020-06-12-170702,170702,1,0,2,635,1.5,112.53013894766258,4
2020-06-13-170702,170702,3,0,0,638,0.0,108.52546695351666,5
2020-06-14-170702,170702,1,0,1,639,0.0,84.99853488252984,6
2020-06-15-170702,170702,0,0,1,639,1.0,62.247463203877714,0
2020-06-16-170702,170702,4,0,0,643,1.5,58.09735945383102,1
2020-06-17-170702,170702,2,0,1,645,1.6666666666666667,60.10114123564071,2
2020-06-18-170702,170702,5,1,2,650,1.1666666666666667,64.98874546439956,3
2020-06-19-170702,170702,6,0,3,656,2.0,75.23753465691168,4
2020-06-20-170702,170702,0,0,0,656,0.3333333333333333,101.94438683536303,5
2020-06-21-170702,170702,0,0,0,656,0.5,101.98053617225868,6
2020-06-22-170702,170702,2,0,1,658,1.0,95.72878642140103,0
2020-06-23-170702,170702,3,0,1,661,0.8333333333333334,89.7192499248194,1
2020-06-24-170702,170702,1,0,4,662,1.0,96.541149950927,2
2020-06-25-170702,170702,4,0,3,666,1.5,88.96185467407079,3
2020-06-26-170702,170702,2,0,1,668,1.0,75.40205490771852,4
2020-06-27-170702,170702,0,0,2,668,0.5,72.02583094030145,5
2020-06-28-170702,170702,1,0,0,669,0.0,76.97308828658984,6
2020-06-29-170702,170702,1,0,2,670,0.8333333333333334,78.92156017479356,0
2020-06-30-170702,170702,0,0,1,670,0.5,73.6990368937883,1
2020-07-01-170702,170702,1,0,3,671,0.3333333333333333,96.73630723719722,2
2020-07-02-170702,170702,2,0,8,673,0.8333333333333334,82.94109414011942,3
2020-07-03-170702,170702,3,0,1,676,1.1666666666666667,78.39227629726616,4
2020-07-04-170702,170702,0,0,0,676,0.5,88.62344095278418,5
2020-07-05-170702,170702,0,0,0,676,0.0,86.84579646939669,6
2020-07-06-170702,170702,1,0,4,677,1.5,76.81198183853449,0
2020-07-07-170702,170702,1,0,1,678,0.6666666666666666,70.13251863031884,1
2020-07-08-170702,170702,4,0,5,682,0.6666666666666666,59.0745395264995,2
2020-07-09-170702,170702,3,0,0,685,1.1666666666666667,56.6575685392308,3
2020-07-10-170702,170702,1,0,3,686,0.5,85.74207225973532,4
2020-07-11-170702,170702,2,0,0,688,0.16666666666666666,76.75809822590463,5
2020-07-12-170702,170702,0,0,0,688,0.16666666666666666,70.56241166881028,6
2020-07-13-170702,170702,2,0,2,690,0.3333333333333333,70.66239661304303,0
2020-07-14-170702,170702,1,0,1,691,0.3333333333333333,70.3203798341831,1
2020-07-15-170702,170702,3,0,4,694,1.6666666666666667,56.4981234660638,2
2020-07-16-170702,170702,8,0,1,702,1.3333333333333333,54.48788660805106,3
2020-07-17-170702,170702,1,0,1,703,0.8333333333333334,77.15911956684617,4
2020-07-18-170702,170702,0,0,1,703,0.5,78.74253350572896,5
2020-07-19-170702,170702,0,0,0,703,0.5,77.1302140985423,6
2020-07-20-170702,170702,4,1,0,707,0.3333333333333333,79.39279707580364,0
2020-07-21-170702,170702,1,0,1,708,0.6666666666666666,88.71101510473801,1
2020-07-22-170702,170702,5,0,1,713,1.6666666666666667,78.43899951148546,2
2020-07-23-170702,170702,0,0,1,713,1.5,77.91697371526074,3
2020-07-24-170702,170702,3,0,1,716,1.0,73.62867227344978,4
2020-07-25-170702,170702,0,0,0,716,0.8333333333333334,89.19475337373382,5
2020-07-26-170702,170702,0,0,0,716,0.16666666666666666,87.53476514978917,6
2020-07-27-170702,170702,2,0,2,718,0.8333333333333334,78.12106985935844,0
2020-07-28-170702,170702,1,0,1,719,2.1666666666666665,72.7379009131943,1
2020-07-29-170702,170702,4,0,1,723,1.1666666666666667,79.4471660365646,2
2020-07-30-170702,170702,1,0,5,724,2.833333333333333,76.31925366698533,3
2020-07-31-170702,170702,1,0,2,725,1.1666666666666667,77.484314915649,4
2020-08-01-170702,170702,1,0,1,726,0.6666666666666666,46.04015656014644,5
2020-08-02-170702,170702,0,0,1,726,0.8333333333333334,222.05049519709968,6
2020-08-03-170702,170702,0,0,5,726,2.0,132.60033372591803,0
2020-08-04-170702,170702,1,0,1,727,0.6666666666666666,116.0629591310375,1
2020-08-05-170702,170702,1,0,6,728,1.8333333333333333,96.07302324441252,2
2020-08-06-170702,170702,1,0,3,729,2.0,84.71561565294809,3
2020-08-07-170702,170702,1,0,9,730,2.1666666666666665,85.10683303112519,4
2020-08-08-170702,170702,0,1,0,730,1.1666666666666667,81.78909272669841,5
2020-08-09-170702,170702,0,0,0,730,1.8333333333333333,82.91624859811674,6
2020-08-10-170702,170702,2,0,3,732,1.5,49.72714232032348,0
2020-08-11-170702,170702,1,0,2,733,3.0,74.63534017220721,1
2020-08-12-170702,170702,1,0,3,734,2.833333333333333,98.7948121107037,2
2020-08-13-170702,170702,5,0,7,739,3.1666666666666665,116.547063103602,3
2020-08-14-170702,170702,2,0,2,741,5.166666666666667,152.98810947982508,4
2020-08-15-170702,170702,1,0,1,742,1.6666666666666667,181.46233039366646,5
2020-08-16-170702,170702,1,1,0,743,1.1666666666666667,181.5590711275638,6
2020-08-17-170702,170702,5,1,0,748,6.333333333333332,186.8889084320521,0
2020-08-18-170702,170702,1,0,9,749,6.666666666666668,210.48864445167294,1
2020-08-19-170702,170702,6,0,5,755,4.666666666666667,230.45499120962327,2
2020-08-20-170702,170702,3,0,5,758,2.6666666666666665,216.97859339370973,3
2020-08-21-170702,170702,9,0,6,767,4.833333333333333,193.0124361638134,4
2020-08-22-170702,170702,0,0,5,767,2.333333333333333,231.45452641354362,5
2020-08-23-170702,170702,0,0,3,767,1.5,237.0172618811949,6
2020-08-24-170702,170702,3,0,2,770,3.5,188.0489179967051,0
2020-08-25-170702,170702,2,0,9,772,4.166666666666667,174.9673377092771,1
2020-08-26-170702,170702,3,0,6,775,2.0,150.66292338122062,2
2020-08-27-170702,170702,7,0,8,782,3.6666666666666665,169.9064510603775,3
2020-08-28-170702,170702,2,0,7,784,2.6666666666666665,181.19391499952064,4
2020-08-29-170702,170702,1,0,0,785,1.0,141.66175034331053,5
2020-08-30-170702,170702,0,0,1,785,0.6666666666666666,142.64980520123515,6
2020-08-31-170702,170702,0,0,6,785,3.5,121.5523224090174,0
2020-09-01-170702,170702,9,0,5,794,2.6666666666666665,81.69015630149475,1
2020-09-02-170702,170702,5,0,4,799,5.333333333333333,181.90994245580794,2
2020-09-03-170702,170702,5,0,2,804,4.5,213.38297770243025,3
2020-09-04-170702,170702,6,0,6,810,6.833333333333332,208.06264308762871,4
2020-09-05-170702,170702,5,0,2,815,3.1666666666666665,190.73136070651702,5
2020-09-06-170702,170702,3,0,0,818,3.6666666666666665,191.57293818078546,6
2020-09-07-170702,170702,2,0,4,820,5.333333333333333,201.59572713073396,0
2020-09-08-170702,170702,9,0,10,829,8.166666666666666,195.19265237864693,1
2020-09-09-170702,170702,6,0,11,835,4.666666666666667,215.21180211417308,2
2020-09-10-170702,170702,8,0,3,843,4.0,82.74386528319693,3
2020-09-11-170702,170702,7,0,9,850,8.0,107.96118598252279,4
2020-09-12-170702,170702,0,0,4,850,2.5,118.72387414980741,5
2020-09-13-170702,170702,1,0,2,851,1.8333333333333333,116.11211732364296,6
2020-09-14-170702,170702,6,0,4,857,6.166666666666668,111.09253468380324,0
2020-09-15-170702,170702,5,0,7,862,4.5,151.23560668486647,1
2020-09-16-170702,170702,4,0,5,866,5.333333333333333,162.94841220482087,2
2020-09-17-170702,170702,2,0,3,868,6.0,165.1781764598,3
2020-09-18-170702,170702,6,0,8,874,5.833333333333332,166.74481677389028,4
2020-09-19-170702,170702,2,0,1,876,3.1666666666666665,172.39452366574403,5
2020-09-20-170702,170702,0,0,5,876,4.333333333333333,191.78978879363808,6
2020-09-21-170702,170702,4,1,4,880,9.333333333333334,155.12351989017645,0
2020-09-22-170702,170702,10,1,5,890,5.333333333333333,165.98442824610572,1
2020-09-23-170702,170702,11,0,2,901,6.333333333333332,167.72470151066634,2
2020-09-24-170702,170702,3,1,4,904,4.833333333333333,175.54907355662655,3
2020-09-25-170702,170702,9,0,5,913,7.833333333333332,162.48936356783014,4
2020-09-26-170702,170702,4,0,3,917,3.333333333333333,190.83303878529895,5
2020-09-27-170702,170702,2,0,2,919,2.0,188.65420290772698,6
2020-09-28-170702,170702,4,0,1,923,3.6666666666666665,190.5504012287006,0
2020-09-29-170702,170702,7,0,5,930,4.0,181.68599030204103,1
2020-09-30-170702,170702,5,0,10,935,2.833333333333333,181.49705731860232,2
2020-10-01-170702,170702,3,0,8,938,1.8333333333333333,0.0,3
2020-10-02-170702,170702,8,0,17,946,4.5,232.28026460643656,4
2020-10-03-170702,170702,1,0,5,947,1.1666666666666667,280.8115038399712,5
2020-10-04-170702,170702,5,1,10,952,1.3333333333333333,264.1068720828461,6
2020-10-05-170702,170702,4,2,7,956,2.1666666666666665,242.9761320673899,0
2020-10-06-170702,170702,5,0,12,961,4.333333333333333,233.42506400773766,1
2020-10-07-170702,170702,2,0,8,963,2.5,218.88562332509014,2
2020-10-08-170702,170702,4,1,8,967,8.166666666666666,185.66340130631966,3
2020-10-09-170702,170702,5,2,12,972,4.666666666666667,203.7586800009081,4
2020-10-10-170702,170702,3,0,2,975,3.0,17.01919701503327,5
2020-10-11-170702,170702,2,0,1,977,1.6666666666666667,36.14769701319321,6
2020-10-12-170702,170702,1,0,14,978,2.833333333333333,57.67211957994958,0
2020-10-13-170702,170702,5,0,8,983,4.5,69.60220441084589,1
2020-10-14-170702,170702,10,0,9,993,2.333333333333333,94.02793159215821,2
2020-10-15-170702,170702,8,0,8,1001,4.166666666666667,121.3546201742812,3
2020-10-16-170702,170702,17,0,18,1018,4.166666666666667,160.88731833824426,4
2020-10-17-170702,170702,5,1,4,1023,1.3333333333333333,195.00021130573467,5
2020-10-18-170702,170702,10,0,1,1033,3.0,198.40492316370035,6
2020-10-19-170702,170702,7,0,7,1040,3.333333333333333,212.22211712352754,0
2020-10-20-170702,170702,12,0,5,1052,3.6666666666666665,249.23003146709138,1
2020-10-21-170702,170702,8,1,7,1060,3.6666666666666665,259.0647755978981,2
2020-10-22-170702,170702,8,0,9,1068,6.166666666666668,259.6461073664172,3
2020-10-23-170702,170702,12,0,10,1080,5.166666666666667,253.3097223403001,4
2020-10-24-170702,170702,2,1,2,1082,3.333333333333333,279.64770121443365,5
2020-10-25-170702,170702,1,1,2,1083,2.1666666666666665,273.5306079070551,6
2020-10-26-170702,170702,14,1,3,1097,2.6666666666666665,260.35909218409546,0
2020-10-27-170702,170702,8,0,5,1105,4.0,261.28035738032247,1
2020-10-28-170702,170702,9,1,4,1114,4.166666666666667,259.66802412827485,2
2020-10-29-170702,170702,8,1,5,1122,5.333333333333333,270.07092369404324,3
2020-10-30-170702,170702,18,0,3,1140,4.5,230.7538628739894,4
2020-10-31-170702,170702,4,1,0,1144,2.6666666666666665,251.6628454507607,5
2020-11-01-170702,170702,1,0,0,1145,2.333333333333333,175.59450123034404,6
2020-11-02-170702,170702,7,1,0,1152,2.333333333333333,165.45358165370584,0
2020-11-03-170702,170702,5,0,0,1157,6.166666666666668,169.4823791303749,1
2020-11-04-170702,170702,7,1,0,1164,3.6666666666666665,195.8831282538855,2
2020-11-05-170702,170702,9,0,0,1173,8.166666666666666,207.50391259453497,3
2020-11-06-170702,170702,10,1,0,1183,6.166666666666668,228.43472186207526,4
2020-11-07-170702,170702,2,1,0,1185,1.1666666666666667,254.93131076680348,5
2020-11-08-170702,170702,2,0,0,1187,1.0,243.99317139369705,6
2020-11-09-170702,170702,3,1,0,1190,5.166666666666667,216.39230506142843,0
2020-11-10-170702,170702,5,0,0,1195,8.0,156.35570985258005,1
2020-11-11-170702,170702,4,0,0,1199,4.833333333333333,172.6532730841298,2
2020-11-12-170702,170702,5,0,0,1204,4.166666666666667,185.86373464442804,3
2020-11-13-170702,170702,3,0,0,1207,6.5,176.64574138934972,4
2020-03-01-170703,170703,0,0,0,0,0.0,0.0,6
2020-03-02-170703,170703,0,0,12,0,0.0,37.37404877988067,0
2020-03-03-170703,170703,0,0,14,0,0.0,160.14111904053163,1
2020-03-04-170703,170703,0,0,16,0,0.0,163.62049353403722,2
2020-03-05-170703,170703,0,0,9,0,0.3333333333333333,182.0442494970228,3
2020-03-06-170703,170703,0,0,24,0,0.0,155.5747291597036,4
2020-03-07-170703,170703,0,0,7,0,0.0,162.5840618942114,5
2020-03-08-170703,170703,0,0,3,0,0.0,141.22120657973784,6
2020-03-09-170703,170703,0,0,23,0,0.16666666666666666,142.30954677401837,0
2020-03-10-170703,170703,0,0,12,0,0.16666666666666666,400.79334555950715,1
2020-03-11-170703,170703,0,0,14,0,0.16666666666666666,348.04062997210724,2
2020-03-12-170703,170703,0,0,9,0,0.16666666666666666,197.93133931572277,3
2020-03-13-170703,170703,0,0,18,0,0.6666666666666666,119.79469318756823,4
2020-03-14-170703,170703,0,0,3,0,0.6666666666666666,84.16194928875767,5
2020-03-15-170703,170703,0,0,7,0,1.0,67.60482485828484,6
2020-03-16-170703,170703,12,0,7,12,3.0,10.287605710947695,0
2020-03-17-170703,170703,14,0,10,26,4.333333333333333,70.68725552146152,1
2020-03-18-170703,170703,16,1,17,42,5.333333333333333,131.00752166010065,2
2020-03-19-170703,170703,9,0,5,51,8.333333333333334,193.93959415462612,3
2020-03-20-170703,170703,24,0,3,75,6.166666666666668,224.75772976079202,4
2020-03-21-170703,170703,7,0,0,82,4.0,298.0174893613507,5
2020-03-22-170703,170703,3,0,11,85,8.5,310.4819278397213,6
2020-03-23-170703,170703,23,0,10,108,12.333333333333336,277.8417708473164,0
2020-03-24-170703,170703,12,0,7,120,8.5,311.4713965917359,1
2020-03-25-170703,170703,14,0,5,134,9.5,299.93958508974976,2
2020-03-26-170703,170703,9,0,4,143,8.333333333333334,311.32348724722016,3
2020-03-27-170703,170703,18,0,6,161,11.833333333333336,342.34237585101397,4
2020-03-28-170703,170703,3,0,0,164,6.166666666666668,323.52235423526594,5
2020-03-29-170703,170703,7,1,2,171,2.833333333333333,312.0775625482476,6
2020-03-30-170703,170703,7,0,9,178,8.5,235.30513161009475,0
2020-03-31-170703,170703,10,0,5,188,6.833333333333332,222.13664636482207,1
2020-04-01-170703,170703,17,0,6,205,6.0,36.74094160132098,2
2020-04-02-170703,170703,5,0,7,210,5.333333333333333,128.6522648186265,3
2020-04-03-170703,170703,3,0,5,213,5.333333333333333,112.14734961480653,4
2020-04-04-170703,170703,0,1,2,213,4.166666666666667,98.99106869190082,5
2020-04-05-170703,170703,11,0,2,224,3.333333333333333,103.23794758791894,6
2020-04-06-170703,170703,10,1,0,234,4.166666666666667,132.68929003776944,0
2020-04-07-170703,170703,7,0,4,241,6.666666666666668,151.4620035641665,1
2020-04-08-170703,170703,5,0,4,246,4.333333333333333,156.32567746840766,2
2020-04-09-170703,170703,4,0,3,250,5.333333333333333,157.9951596860026,3
2020-04-10-170703,170703,6,0,8,256,0.8333333333333334,56.910074369406296,4
2020-04-11-170703,170703,0,0,0,256,3.6666666666666665,73.04751231010148,5
2020-04-12-170703,170703,2,0,1,258,3.1666666666666665,76.06353080724183,6
2020-04-13-170703,170703,9,0,4,267,3.6666666666666665,83.81352729581798,0
2020-04-14-170703,170703,5,0,8,272,2.833333333333333,118.52339464420955,1
2020-04-15-170703,170703,6,0,7,278,3.333333333333333,138.30311401655598,2
2020-04-16-170703,170703,7,0,2,285,2.833333333333333,160.72067419061094,3
2020-04-17-170703,170703,5,0,3,290,3.5,135.28859142910662,4
2020-04-18-170703,170703,2,0,2,292,1.1666666666666667,138.67666874096005,5
2020-04-19-170703,170703,2,0,4,294,0.5,145.86936744306604,6
2020-04-20-170703,170703,0,0,8,294,7.666666666666668,134.01688872472076,0
2020-04-21-170703,170703,4,0,7,298,4.833333333333333,117.32472091487399,1
2020-04-22-170703,170703,4,0,9,302,2.0,114.65375685723993,2
2020-04-23-170703,170703,3,0,8,305,1.0,107.01732337884229,3
2020-04-24-170703,170703,8,0,4,313,3.0,96.1057861460724,4
2020-04-25-170703,170703,0,0,1,313,1.3333333333333333,114.26600876385416,5
2020-04-26-170703,170703,1,0,1,314,2.5,106.8667401656129,6
2020-04-27-170703,170703,4,0,3,318,6.0,92.24631644854726,0
2020-04-28-170703,170703,8,0,4,326,3.8333333333333335,105.39042309854845,1
2020-04-29-170703,170703,7,0,5,333,2.5,112.05295462143376,2
2020-04-30-170703,170703,2,0,5,335,3.0,126.72530094443484,3
2020-05-01-170703,170703,3,0,1,338,0.5,178.5257506664778,4
2020-05-02-170703,170703,2,0,3,340,1.3333333333333333,106.17662923795217,5
2020-05-03-170703,170703,4,0,4,344,0.6666666666666666,78.14633691455717,6
2020-05-04-170703,170703,8,0,5,352,3.0,57.920338773251096,0
2020-05-05-170703,170703,7,0,10,359,2.333333333333333,80.4961947685018,1
2020-05-06-170703,170703,9,0,11,368,2.5,91.20850868707674,2
2020-05-07-170703,170703,8,0,8,376,3.1666666666666665,115.46493613268544,3
2020-05-08-170703,170703,4,0,2,380,2.5,143.9969158622774,4
2020-05-09-170703,170703,1,0,1,381,0.5,160.4885544310993,5
2020-05-10-170703,170703,1,1,1,382,0.0,201.86663066885336,6
2020-05-11-170703,170703,3,0,7,385,3.6666666666666665,199.46434751072724,0
2020-05-12-170703,170703,4,0,2,389,1.6666666666666667,170.931720638611,1
2020-05-13-170703,170703,5,1,5,394,1.6666666666666667,142.82298801358536,2
2020-05-14-170703,170703,5,0,2,399,3.1666666666666665,125.35371912727896,3
2020-05-15-170703,170703,1,0,1,400,2.1666666666666665,117.62122553476846,4
2020-05-16-170703,170703,3,0,1,403,1.1666666666666667,102.2591862124358,5
2020-05-17-170703,170703,4,0,0,407,0.5,99.96729254854118,6
2020-05-18-170703,170703,5,0,2,412,3.0,104.66688324184229,0
2020-05-19-170703,170703,10,0,1,422,1.5,107.92980378171404,1
2020-05-20-170703,170703,11,0,1,433,3.0,117.43598132676921,2
2020-05-21-170703,170703,8,0,0,441,2.0,138.79237195128428,3
2020-05-22-170703,170703,2,0,3,443,3.6666666666666665,171.3422842818807,4
2020-05-23-170703,170703,1,0,0,444,1.3333333333333333,176.57045168619334,5
2020-05-24-170703,170703,1,0,2,445,0.6666666666666666,177.2483977486698,6
2020-05-25-170703,170703,7,0,2,452,3.1666666666666665,161.380608563214,0
2020-05-26-170703,170703,2,0,2,454,2.0,156.09372047726498,1
2020-05-27-170703,170703,5,0,1,459,4.5,160.2552887279524,2
2020-05-28-170703,170703,2,0,4,461,1.5,139.86999291787205,3
2020-05-29-170703,170703,1,0,1,462,1.3333333333333333,112.33396721160736,4
2020-05-30-170703,170703,1,1,0,463,0.0,115.80114942699045,5
2020-05-31-170703,170703,0,0,0,463,0.5,117.19451705357022,6
2020-06-01-170703,170703,2,0,0,465,2.5,196.2222074409082,0
2020-06-02-170703,170703,1,0,2,466,1.3333333333333333,42.64443584873591,1
2020-06-03-170703,170703,1,0,2,467,1.3333333333333333,51.910372895953685,2
2020-06-04-170703,170703,0,0,0,467,1.5,38.48078710978098,3
2020-06-05-170703,170703,3,0,3,470,1.3333333333333333,30.018371884324196,4
2020-06-06-170703,170703,0,0,0,470,0.0,42.71172417015905,5
2020-06-07-170703,170703,2,0,2,472,0.5,43.014498197713124,6
2020-06-08-170703,170703,2,0,1,474,1.6666666666666667,52.706228859231494,0
2020-06-09-170703,170703,2,0,1,476,1.6666666666666667,50.30999107921784,1
2020-06-10-170703,170703,1,0,3,477,1.0,215.8311383286265,2
2020-06-11-170703,170703,4,0,2,481,1.5,178.21880500091737,3
2020-06-12-170703,170703,1,0,1,482,0.3333333333333333,151.7792313927032,4
2020-06-13-170703,170703,0,0,0,482,0.5,110.47922974383151,5
2020-06-14-170703,170703,0,0,0,482,0.16666666666666666,68.70059271620389,6
2020-06-15-170703,170703,0,0,3,482,1.3333333333333333,45.12439666779153,0
2020-06-16-170703,170703,2,0,0,484,1.5,47.09878661718757,1
2020-06-17-170703,170703,2,0,1,486,0.8333333333333334,42.481207322695454,2
2020-06-18-170703,170703,0,0,1,486,1.3333333333333333,47.527969106188294,3
2020-06-19-170703,170703,3,0,5,489,2.6666666666666665,33.776257864788775,4
2020-06-20-170703,170703,0,0,0,489,0.16666666666666666,53.959402313511454,5
2020-06-21-170703,170703,2,0,0,491,0.0,54.0943724545543,6
2020-06-22-170703,170703,1,0,3,492,1.0,56.07953535932687,0
2020-06-23-170703,170703,1,3,2,493,0.8333333333333334,54.53238798998824,1
2020-06-24-170703,170703,3,1,4,496,1.0,51.152983823999065,2
2020-06-25-170703,170703,2,0,1,498,1.3333333333333333,65.18433587228586,3
2020-06-26-170703,170703,1,0,0,499,1.0,58.89641472664991,4
2020-06-27-170703,170703,0,0,0,499,0.16666666666666666,53.977264163564364,5
2020-06-28-170703,170703,0,0,0,499,0.16666666666666666,54.43746116633535,6
2020-06-29-170703,170703,3,0,0,502,0.6666666666666666,50.38587748582306,0
2020-06-30-170703,170703,0,0,1,502,0.5,59.8995349611406,1
2020-07-01-170703,170703,1,0,1,503,0.8333333333333334,57.40450723980445,2
2020-07-02-170703,170703,1,0,0,504,0.8333333333333334,18.337685647794288,3
2020-07-03-170703,170703,5,0,0,509,1.1666666666666667,78.82574346280242,4
2020-07-04-170703,170703,0,0,0,509,0.3333333333333333,89.95451515567132,5
2020-07-05-170703,170703,0,0,1,509,0.0,90.97487734748536,6
2020-07-06-170703,170703,3,0,0,512,0.8333333333333334,81.51821303234402,0
2020-07-07-170703,170703,2,0,1,514,0.3333333333333333,93.02501882084415,1
2020-07-08-170703,170703,4,1,2,518,1.1666666666666667,85.19591040131051,2
2020-07-09-170703,170703,1,0,3,519,0.8333333333333334,71.78837146239306,3
2020-07-10-170703,170703,0,1,2,519,0.5,64.79771147398513,4
2020-07-11-170703,170703,0,0,2,519,0.3333333333333333,62.84507184710788,5
2020-07-12-170703,170703,0,0,0,519,0.0,44.93305956605325,6
2020-07-13-170703,170703,0,0,1,519,0.5,44.36812274156863,0
2020-07-14-170703,170703,1,0,1,520,0.5,35.320541894856646,1
2020-07-15-170703,170703,1,0,3,521,1.1666666666666667,27.1052096693958,2
2020-07-16-170703,170703,0,0,3,521,3.333333333333333,20.389712641376526,3
2020-07-17-170703,170703,0,1,2,521,0.8333333333333334,18.403757475076166,4
2020-07-18-170703,170703,0,0,0,521,0.0,18.626868233988873,5
2020-07-19-170703,170703,1,0,2,522,0.3333333333333333,18.358690999411422,6
2020-07-20-170703,170703,0,0,5,522,1.3333333333333333,25.1328691182437,0
2020-07-21-170703,170703,1,0,2,523,1.1666666666666667,21.56223271982154,1
2020-07-22-170703,170703,2,0,3,525,1.0,26.22916369833883,2
2020-07-23-170703,170703,3,0,5,528,0.16666666666666666,34.94381644848812,3
2020-07-24-170703,170703,2,0,5,530,1.8333333333333333,48.859437839985326,4
2020-07-25-170703,170703,2,0,1,532,0.16666666666666666,67.89680214702592,5
2020-07-26-170703,170703,0,1,2,532,0.5,77.10699206868944,6
2020-07-27-170703,170703,1,0,3,533,2.1666666666666665,70.04984794120682,0
2020-07-28-170703,170703,1,0,4,534,3.333333333333333,77.97363468158653,1
2020-07-29-170703,170703,3,0,6,537,2.1666666666666665,76.16363421791982,2
2020-07-30-170703,170703,3,0,4,540,2.5,92.43210105475862,3
2020-07-31-170703,170703,2,0,2,542,2.1666666666666665,100.39032012262405,4
2020-08-01-170703,170703,0,0,2,542,0.8333333333333334,51.56198887868947,5
2020-08-02-170703,170703,2,0,1,544,0.0,113.80591594116623,6
2020-08-03-170703,170703,5,0,1,549,1.8333333333333333,168.75306051680795,0
2020-08-04-170703,170703,2,0,1,551,2.1666666666666665,154.40279683405168,1
2020-08-05-170703,170703,3,0,3,554,2.333333333333333,134.72943243555858,2
2020-08-06-170703,170703,5,0,1,559,1.5,139.71846201187708,3
2020-08-07-170703,170703,5,0,10,564,1.6666666666666667,138.981121484726,4
2020-08-08-170703,170703,1,0,0,565,0.8333333333333334,143.45389866084886,5
2020-08-09-170703,170703,2,0,2,567,1.1666666666666667,123.31783256223471,6
2020-08-10-170703,170703,3,0,3,570,0.8333333333333334,48.44834022931259,0
2020-08-11-170703,170703,4,0,3,574,1.6666666666666667,67.13242658095284,1
2020-08-12-170703,170703,6,0,5,580,1.1666666666666667,92.52672913789958,2
2020-08-13-170703,170703,4,0,1,584,2.333333333333333,104.56690163330452,3
2020-08-14-170703,170703,2,0,3,586,1.8333333333333333,116.59062264082263,4
2020-08-15-170703,170703,2,0,1,588,1.1666666666666667,122.72094012172519,5
2020-08-16-170703,170703,1,0,0,589,1.0,127.72516995252673,6
2020-08-17-170703,170703,1,0,1,590,1.8333333333333333,134.35159835330012,0
2020-08-18-170703,170703,1,0,0,591,1.8333333333333333,127.15109655048681,1
2020-08-19-170703,170703,3,0,2,594,3.333333333333333,115.3049829338473,2
2020-08-20-170703,170703,1,0,9,595,4.333333333333333,91.43647508202065,3
2020-08-21-170703,170703,10,0,5,605,4.166666666666667,90.98199350084836,4
2020-08-22-170703,170703,0,0,3,605,1.1666666666666667,131.26926452912582,5
2020-08-23-170703,170703,2,0,9,607,1.0,131.3866242211016,6
2020-08-24-170703,170703,3,0,7,610,2.1666666666666665,129.99779628935073,0
2020-08-25-170703,170703,3,0,17,613,3.6666666666666665,141.77041407394847,1
2020-08-26-170703,170703,5,1,12,618,4.666666666666667,145.63555069699328,2
2020-08-27-170703,170703,1,0,7,619,3.333333333333333,176.52707368110202,3
2020-08-28-170703,170703,3,1,10,622,4.666666666666667,174.1041745432312,4
2020-08-29-170703,170703,1,1,6,623,2.0,147.1215096215804,5
2020-08-30-170703,170703,0,0,7,623,1.3333333333333333,172.4381947908049,6
2020-08-31-170703,170703,1,1,5,624,4.166666666666667,152.00973922309026,0
2020-09-01-170703,170703,0,0,8,624,3.5,126.13908261704952,1
2020-09-02-170703,170703,2,0,4,626,7.5,239.8333074042739,2
2020-09-03-170703,170703,9,0,9,635,4.333333333333333,366.2443810039897,3
2020-09-04-170703,170703,5,0,5,640,6.0,318.79380425440723,4
2020-09-05-170703,170703,3,0,5,643,4.666666666666667,280.03640240038675,5
2020-09-06-170703,170703,9,0,3,652,5.666666666666668,236.61638475157483,6
2020-09-07-170703,170703,7,0,15,659,5.0,248.01656230841428,0
2020-09-08-170703,170703,17,0,13,676,8.666666666666666,276.69748862168274,1
2020-09-09-170703,170703,12,0,14,688,7.166666666666668,317.6775149471549,2
2020-09-10-170703,170703,7,0,6,695,6.833333333333332,109.37376048796686,3
2020-09-11-170703,170703,10,0,11,705,10.333333333333334,143.71739624078074,4
2020-09-12-170703,170703,6,0,12,711,3.333333333333333,193.08433640101666,5
2020-09-13-170703,170703,7,0,7,718,1.8333333333333333,209.06273484779445,6
2020-09-14-170703,170703,5,1,2,723,6.333333333333332,215.39866173544848,0
2020-09-15-170703,170703,8,0,9,731,11.166666666666664,244.4030316660852,1
2020-09-16-170703,170703,4,0,7,735,7.666666666666668,277.9502431530333,2
2020-09-17-170703,170703,9,0,2,744,6.833333333333332,296.0857691565975,3
2020-09-18-170703,170703,5,0,10,749,5.166666666666667,302.19943751358505,4
2020-09-19-170703,170703,5,0,2,754,4.0,259.16406885367553,5
2020-09-20-170703,170703,3,0,2,757,2.5,234.56789845631306,6
2020-09-21-170703,170703,15,0,1,772,7.5,214.9058924565142,0
2020-09-22-170703,170703,13,0,4,785,9.333333333333334,237.42551401339713,1
2020-09-23-170703,170703,14,0,5,799,9.5,270.76114861525366,2
2020-09-24-170703,170703,6,0,29,805,6.833333333333332,294.8261301702983,3
2020-09-25-170703,170703,11,1,5,816,7.5,310.74376722590546,4
2020-09-26-170703,170703,12,0,1,828,6.5,346.87662643802236,5
2020-09-27-170703,170703,7,0,1,835,1.1666666666666667,394.8409004080596,6
2020-09-28-170703,170703,2,0,0,837,4.5,426.0175122963011,0
2020-09-29-170703,170703,9,0,8,846,6.333333333333332,374.6053737061127,1
2020-09-30-170703,170703,7,0,3,853,2.833333333333333,329.75466812258423,2
2020-10-01-170703,170703,2,1,3,855,4.666666666666667,0.0,3
2020-10-02-170703,170703,10,0,7,865,6.666666666666668,270.206411809992,4
2020-10-03-170703,170703,2,0,1,867,1.6666666666666667,384.8274290295975,5
2020-10-04-170703,170703,2,1,7,869,3.0,293.65197755776944,6
2020-10-05-170703,170703,1,0,8,870,2.333333333333333,262.5244220744912,0
2020-10-06-170703,170703,4,1,8,874,6.833333333333332,229.7997656243059,1
2020-10-07-170703,170703,5,1,13,879,4.166666666666667,200.80821761413787,2
2020-10-08-170703,170703,29,0,11,908,4.333333333333333,193.0279707250726,3
2020-10-09-170703,170703,5,2,14,913,4.666666666666667,329.0500372526765,4
2020-10-10-170703,170703,1,0,15,914,3.0,16.130980946706735,5
2020-10-11-170703,170703,1,0,3,915,2.5,36.52519021177913,6
2020-10-12-170703,170703,0,0,4,915,2.333333333333333,49.123733566927726,0
2020-10-13-170703,170703,8,0,8,923,4.833333333333333,51.8987830598533,1
2020-10-14-170703,170703,3,0,8,926,4.833333333333333,96.59609085221643,2
2020-10-15-170703,170703,3,0,8,929,5.166666666666667,124.07107366248036,3
2020-10-16-170703,170703,7,0,6,936,7.833333333333332,158.28610975794544,4
2020-10-17-170703,170703,1,0,2,937,3.0,197.41564662070223,5
2020-10-18-170703,170703,7,0,6,944,4.166666666666667,189.49171984535604,6
2020-10-19-170703,170703,8,0,9,952,5.833333333333332,216.29544105257372,0
2020-10-20-170703,170703,8,0,10,960,7.333333333333332,292.4278077622283,1
2020-10-21-170703,170703,13,0,6,973,5.166666666666667,318.2529057899339,2
2020-10-22-170703,170703,11,0,24,984,5.0,363.7444088266527,3
2020-10-23-170703,170703,14,0,8,998,6.5,377.96375121670195,4
2020-10-24-170703,170703,15,0,5,1013,2.833333333333333,446.3207432918399,5
2020-10-25-170703,170703,3,1,1,1016,2.6666666666666665,487.3718043056407,6
2020-10-26-170703,170703,4,0,9,1020,9.0,442.6932817814301,0
2020-10-27-170703,170703,8,0,29,1028,7.666666666666668,426.0020434489983,1
2020-10-28-170703,170703,8,0,14,1036,8.5,430.8693038971139,2
2020-10-29-170703,170703,8,0,12,1044,6.333333333333332,413.95899962499254,3
2020-10-30-170703,170703,6,1,12,1050,9.0,332.077016839716,4
2020-10-31-170703,170703,2,0,0,1052,6.0,301.8912877181131,5
2020-11-01-170703,170703,6,1,0,1058,1.8333333333333333,322.657613038782,6
2020-11-02-170703,170703,9,0,0,1067,4.0,486.44572963340005,0
2020-11-03-170703,170703,10,0,0,1077,4.5,408.84863169248223,1
2020-11-04-170703,170703,6,0,0,1083,8.333333333333334,446.24171762080726,2
2020-11-05-170703,170703,24,0,0,1107,7.5,450.15728590101264,3
2020-11-06-170703,170703,8,1,0,1115,8.333333333333334,530.9696713561368,4
2020-11-07-170703,170703,5,0,0,1120,3.1666666666666665,467.0570793795053,5
2020-11-08-170703,170703,1,0,0,1121,4.5,449.49925494782724,6
2020-11-09-170703,170703,9,0,0,1130,5.833333333333332,410.5803134850222,0
2020-11-10-170703,170703,29,2,0,1159,6.666666666666668,337.58502343021587,1
2020-11-11-170703,170703,14,2,0,1173,5.0,466.6006929598179,2
2020-11-12-170703,170703,12,0,0,1185,5.0,525.4530781064767,3
2020-11-13-170703,170703,12,0,0,1197,8.0,540.548225884326,4
2020-03-01-170704,170704,0,0,0,0,0.0,0.0,6
2020-03-02-170704,170704,0,0,0,0,0.0,0.0007048761812846215,0
2020-03-03-170704,170704,0,0,0,0,0.2,0.004723677414402004,1
2020-03-04-170704,170704,0,0,4,0,0.0,0.004940102743402308,2
2020-03-05-170704,170704,0,0,1,0,0.0,0.005438855987660791,3
2020-03-06-170704,170704,0,0,0,0,0.0,5.930036775821457,4
2020-03-07-170704,170704,0,0,0,0,0.2,4.5864446971224835,5
2020-03-08-170704,170704,0,0,0,0,0.0,3.682619014478608,6
2020-03-09-170704,170704,0,0,1,0,0.2,3.650744920377491,0
2020-03-10-170704,170704,0,0,2,0,0.2,5.230873520973181,1
2020-03-11-170704,170704,1,0,0,1,0.0,4.396210327299693,2
2020-03-12-170704,170704,0,0,0,1,0.2,3.183329258616456,3
2020-03-13-170704,170704,0,0,17,1,0.4,0.004922776877996348,4
2020-03-14-170704,170704,0,0,3,1,1.0,0.0036055969295230497,5
2020-03-15-170704,170704,0,0,2,1,0.8,0.0023595226985928088,6
2020-03-16-170704,170704,0,0,3,1,6.0,0.0006538069647057262,0
2020-03-17-170704,170704,0,0,1,1,4.8,0.0016828386824506146,1
2020-03-18-170704,170704,4,1,1,5,8.4,0.0024411304504028336,2
2020-03-19-170704,170704,1,0,0,6,10.0,0.003425103474635278,3
2020-03-20-170704,170704,0,0,0,6,10.6,0.0036696298482808663,4
2020-03-21-170704,170704,0,0,1,6,5.6,0.004709504212556226,5
2020-03-22-170704,170704,0,0,0,6,7.8,0.004519534862863701,6
2020-03-23-170704,170704,1,0,2,7,15.2,0.0044375927694394034,0
2020-03-24-170704,170704,2,0,1,9,11.2,0.0057756423282336045,1
2020-03-25-170704,170704,0,0,1,9,10.6,0.006272162259043939,2
2020-03-26-170704,170704,0,0,1,9,8.0,0.0066647487256671235,3
2020-03-27-170704,170704,17,0,0,26,12.8,0.007823422526596778,4
2020-03-28-170704,170704,3,0,0,29,6.2,0.007768544827635457,5
2020-03-29-170704,170704,2,0,0,31,3.6,0.00787824817137705,6
2020-03-30-170704,170704,3,0,0,34,9.8,0.005622670488240126,0
2020-03-31-170704,170704,1,1,0,35,7.6,0.0051979937412752215,1
2020-04-01-170704,170704,1,0,1,36,10.6,0.0008174848716444871,2
2020-04-02-170704,170704,0,0,0,36,5.0,0.0029340032844157055,3
2020-04-03-170704,170704,0,0,0,36,4.8,0.002484258644764533,4
2020-04-04-170704,170704,1,0,0,37,3.2,0.002674463857928679,5
2020-04-05-170704,170704,0,0,0,37,5.8,0.0028430363249157442,6
2020-04-06-170704,170704,2,0,0,39,4.4,0.0027537665962423553,0
2020-04-07-170704,170704,1,0,0,40,8.0,0.0029976570670293013,1
2020-04-08-170704,170704,1,0,0,41,4.2,0.003517444238011159,2
2020-04-09-170704,170704,1,0,0,42,6.4,0.003997940182749193,3
2020-04-10-170704,170704,0,0,0,42,1.8,0.0011031923084544445,4
2020-04-11-170704,170704,0,0,1,42,1.4,0.0012712047986783302,5
2020-04-12-170704,170704,0,0,0,42,1.4,0.0016304390122899859,6
2020-04-13-170704,170704,0,1,0,42,4.4,0.0019413995046823366,0
2020-04-14-170704,170704,0,0,2,42,3.4,0.002864398072071325,1
2020-04-15-170704,170704,1,0,1,43,4.2,0.0034858081242024747,2
2020-04-16-170704,170704,0,0,0,43,3.2,0.004223542706274322,3
2020-04-17-170704,170704,0,0,0,43,2.8,0.004159903979437296,4
2020-04-18-170704,170704,0,0,0,43,3.8,0.004491552690175668,5
2020-04-19-170704,170704,0,0,0,43,1.0,0.004135611142566022,6
2020-04-20-170704,170704,0,1,1,43,2.0,0.0038311991313584063,0
2020-04-21-170704,170704,0,0,1,43,8.8,0.003646761871075933,1
2020-04-22-170704,170704,0,0,0,43,2.6,0.003237262095194787,2
2020-04-23-170704,170704,0,0,0,43,2.0,0.0032293453618355253,3
2020-04-24-170704,170704,0,0,0,43,4.4,0.00291555375183665,4
2020-04-25-170704,170704,1,0,0,44,1.0,0.003685863153301526,5
2020-04-26-170704,170704,0,0,0,44,3.2,0.0036976554517998703,6
2020-04-27-170704,170704,0,0,0,44,6.8,0.003925266868699788,0
2020-04-28-170704,170704,2,1,0,46,4.8,0.003769834007608887,1
2020-04-29-170704,170704,1,0,0,47,3.8,0.0036938512783101884,2
2020-04-30-170704,170704,0,0,1,47,2.8,0.004282188234222666,3
2020-05-01-170704,170704,0,0,0,47,1.0,3.9168796787099427,4
2020-05-02-170704,170704,0,0,0,47,0.4,4.555591611899598,5
2020-05-03-170704,170704,0,0,0,47,1.0,4.066271922781015,6
2020-05-04-170704,170704,1,0,1,48,2.6,2.84684301338001,0
2020-05-05-170704,170704,1,0,0,49,2.6,4.5126081101353845,1
2020-05-06-170704,170704,0,0,0,49,2.4,3.1209421089160276,2
2020-05-07-170704,170704,0,0,0,49,3.8,3.063525883709663,3
2020-05-08-170704,170704,0,0,2,49,3.0,2.6298251135030766,4
2020-05-09-170704,170704,0,1,0,49,0.8,2.0248382643740035,5
2020-05-10-170704,170704,0,0,0,49,0.4,5.0869487176644865,6
2020-05-11-170704,170704,0,0,1,49,2.6,4.363625801137429,0
2020-05-12-170704,170704,0,3,1,49,2.6,0.005300879226577169,1
2020-05-13-170704,170704,0,0,1,49,2.2,0.004525898502014272,2
2020-05-14-170704,170704,1,0,1,50,3.6,0.0036556779827815033,3
2020-05-15-170704,170704,0,0,0,50,3.4,0.002967342354662104,4
2020-05-16-170704,170704,0,0,0,50,1.0,0.0021181185877648485,5
2020-05-17-170704,170704,0,0,1,50,1.4,0.002100750278302799,6
2020-05-18-170704,170704,1,0,0,51,3.6,0.002181032617815256,0
2020-05-19-170704,170704,0,0,0,51,4.2,0.0020244630810987304,1
2020-05-20-170704,170704,0,0,0,51,5.2,0.0020764944014711566,2
2020-05-21-170704,170704,0,0,0,51,2.8,0.0022752452787303426,3
2020-05-22-170704,170704,2,0,0,53,3.2,0.0025337744954245746,4
2020-05-23-170704,170704,0,0,0,53,1.0,0.002760085100122118,5
2020-05-24-170704,170704,0,1,0,53,1.2,0.002811196147463592,6
2020-05-25-170704,170704,1,0,0,54,4.2,0.002388314401286149,0
2020-05-26-170704,170704,1,0,0,55,1.8,0.002409314461685085,1
2020-05-27-170704,170704,1,0,0,56,4.8,0.002600461550521121,2
2020-05-28-170704,170704,1,0,0,57,1.2,0.0023478631085704703,3
2020-05-29-170704,170704,0,0,0,57,1.0,0.0020831392537556488,4
2020-05-30-170704,170704,0,0,0,57,0.2,0.0021773227968647085,5
2020-05-31-170704,170704,1,0,0,58,0.0,0.0023186689963468304,6
2020-06-01-170704,170704,0,0,0,58,1.4,0.0048445161888017035,0
2020-06-02-170704,170704,0,0,0,58,1.6,0.0014121185668653055,1
2020-06-03-170704,170704,0,0,0,58,1.2,0.0012368094546536367,2
2020-06-04-170704,170704,0,0,0,58,1.2,0.001118254051482268,3
2020-06-05-170704,170704,0,0,0,58,1.6,0.0010374801446305965,4
2020-06-06-170704,170704,0,2,0,58,0.0,0.0010795908678491418,5
2020-06-07-170704,170704,0,0,0,58,1.0,0.001078548876550538,6
2020-06-08-170704,170704,0,0,0,58,1.8,0.0011410427252499815,0
2020-06-09-170704,170704,0,0,0,58,1.0,0.00129419692025567,1
2020-06-10-170704,170704,0,0,0,58,0.8,0.0049976901548500095,2
2020-06-11-170704,170704,0,0,0,58,0.8,0.004229288115414455,3
2020-06-12-170704,170704,0,0,0,58,0.8,0.0037212754208205945,4
2020-06-13-170704,170704,0,0,0,58,0.6,0.0028517717280169023,5
2020-06-14-170704,170704,0,0,0,58,0.2,0.002043446174936738,6
2020-06-15-170704,170704,0,0,0,58,0.0,0.0012384103316177186,0
2020-06-16-170704,170704,0,0,0,58,1.4,0.00146923022844297,1
2020-06-17-170704,170704,0,0,0,58,0.8,0.0014612463973604866,2
2020-06-18-170704,170704,0,0,0,58,1.8,0.001442451318451682,3
2020-06-19-170704,170704,0,0,0,58,2.4,0.00123151570676607,4
2020-06-20-170704,170704,0,0,0,58,0.0,0.0018570933091143435,5
2020-06-21-170704,170704,0,0,0,58,0.4,0.0018933224445575093,6
2020-06-22-170704,170704,0,0,0,58,0.6,0.0017060939293275252,0
2020-06-23-170704,170704,0,1,0,58,0.8,0.0014614635559671448,1
2020-06-24-170704,170704,0,0,0,58,0.8,0.001475364015661874,2
2020-06-25-170704,170704,0,2,0,58,1.2,0.0016155256998572271,3
2020-06-26-170704,170704,0,0,0,58,0.6,0.001477470450168255,4
2020-06-27-170704,170704,0,0,0,58,0.2,0.001385701334071721,5
2020-06-28-170704,170704,0,0,0,58,0.2,0.0014358718272127714,6
2020-06-29-170704,170704,0,0,0,58,1.0,0.0014338956338188387,0
2020-06-30-170704,170704,0,0,0,58,0.4,0.0015979443549183601,1
2020-07-01-170704,170704,0,0,0,58,0.4,0.0016777022987864826,2
2020-07-02-170704,170704,0,0,0,58,0.8,0.0007249921834441807,3
2020-07-03-170704,170704,0,0,0,58,1.6,0.0015943701118501183,4
2020-07-04-170704,170704,0,0,0,58,0.2,0.001960126198802673,5
2020-07-05-170704,170704,0,0,0,58,0.0,0.001930031322369867,6
2020-07-06-170704,170704,0,0,0,58,1.4,0.001688553424403268,0
2020-07-07-170704,170704,0,0,0,58,0.8,0.001790700149850815,1
2020-07-08-170704,170704,0,0,0,58,1.6,0.001719952601086462,2
2020-07-09-170704,170704,0,0,0,58,0.8,0.0015848793189501243,3
2020-07-10-170704,170704,0,0,0,58,0.2,0.0017950236338466572,4
2020-07-11-170704,170704,0,0,0,58,0.4,0.001731600305631754,5
2020-07-12-170704,170704,0,0,0,58,0.0,0.001428730899920959,6
2020-07-13-170704,170704,0,0,0,58,0.4,0.0013970678206220572,0
2020-07-14-170704,170704,0,0,0,58,0.6,0.0013291181884502483,1
2020-07-15-170704,170704,0,0,0,58,1.4,0.0008700982398670125,2
2020-07-16-170704,170704,0,0,0,58,2.4,0.000686428873461341,3
2020-07-17-170704,170704,0,0,0,58,0.4,0.0006686339226784771,4
2020-07-18-170704,170704,0,0,1,58,0.4,0.0007149127239128932,5
2020-07-19-170704,170704,0,0,0,58,0.2,0.0006707551348235619,6
2020-07-20-170704,170704,0,0,0,58,1.0,0.0010028045481999535,0
2020-07-21-170704,170704,0,0,0,58,0.4,0.0010845777986248667,1
2020-07-22-170704,170704,0,0,0,58,1.8,0.001246244511770254,2
2020-07-23-170704,170704,0,0,0,58,1.0,0.0013533279166996046,3
2020-07-24-170704,170704,0,0,0,58,1.0,0.0014280760950827233,4
2020-07-25-170704,170704,0,0,0,58,0.8,0.0017585443916872997,5
2020-07-26-170704,170704,0,0,2,58,0.0,0.0017627715904403117,6
2020-07-27-170704,170704,0,0,0,58,0.6,0.0015166912649276824,0
2020-07-28-170704,170704,0,0,0,58,0.8,0.0016131579152326276,1
2020-07-29-170704,170704,0,0,0,58,1.8,0.0015631467865187408,2
2020-07-30-170704,170704,0,0,1,58,2.6,0.0018225674566295248,3
2020-07-31-170704,170704,0,0,0,58,0.8,0.001944238240755198,4
2020-08-01-170704,170704,1,0,0,59,0.6,0.0010840749626935767,5
2020-08-02-170704,170704,0,0,0,59,0.4,0.005031824548172312,6
2020-08-03-170704,170704,0,0,0,59,1.4,0.011029219294118407,0
2020-08-04-170704,170704,0,0,1,59,0.6,0.010975234342081676,1
2020-08-05-170704,170704,0,1,0,59,1.0,0.00927629029782287,2
2020-08-06-170704,170704,0,0,1,59,1.2,0.008223714639760432,3
2020-08-07-170704,170704,0,0,0,59,2.0,0.006478067488507753,4
2020-08-08-170704,170704,0,0,0,59,1.8,0.005351429138602317,5
2020-08-09-170704,170704,2,0,1,61,1.4,0.005527207073561276,6
2020-08-10-170704,170704,0,0,0,61,1.8,0.0010174600472312731,0
2020-08-11-170704,170704,0,0,0,61,3.2,0.0015848481850537911,1
2020-08-12-170704,170704,0,0,0,61,2.4,0.002353457462632795,2
2020-08-13-170704,170704,1,0,1,62,3.8,0.002773108383596279,3
2020-08-14-170704,170704,0,0,1,62,5.8,0.003367260843805999,4
2020-08-15-170704,170704,0,0,1,62,2.4,0.004033267077707954,5
2020-08-16-170704,170704,0,0,0,62,2.0,0.004534140851769142,6
2020-08-17-170704,170704,0,0,4,62,5.4,0.0051544427029270295,0
2020-08-18-170704,170704,1,0,0,63,7.2,0.0050561569109030275,1
2020-08-19-170704,170704,0,0,0,63,5.2,0.005024539270520335,2
2020-08-20-170704,170704,1,0,0,64,4.0,0.004615144942132037,3
2020-08-21-170704,170704,0,0,0,64,6.0,0.005492296506830655,4
2020-08-22-170704,170704,0,0,0,64,0.2,0.006799308361521967,5
2020-08-23-170704,170704,1,0,0,65,0.8,0.006579096634711116,6
2020-08-24-170704,170704,0,0,0,65,3.2,0.0063304982889029505,0
2020-08-25-170704,170704,0,0,0,65,2.8,0.006768937224833987,1
2020-08-26-170704,170704,0,0,0,65,3.0,0.007406068108216249,2
2020-08-27-170704,170704,1,0,2,66,3.2,0.009393267100878164,3
2020-08-28-170704,170704,1,0,1,67,3.4,0.009321772029944296,4
2020-08-29-170704,170704,1,0,0,68,2.0,0.009366098555028478,5
2020-08-30-170704,170704,0,0,0,68,0.6,0.009870275750457975,6
2020-08-31-170704,170704,4,0,0,72,2.6,0.009153463013492341,0
2020-09-01-170704,170704,0,0,0,72,3.4,0.004530808817451201,1
2020-09-02-170704,170704,0,0,1,72,2.2,0.012136462183570526,2
2020-09-03-170704,170704,0,0,0,72,3.2,0.009943000292470083,3
2020-09-04-170704,170704,0,0,0,72,6.6,0.008662442478569059,4
2020-09-05-170704,170704,0,0,0,72,3.2,0.007729138072349441,5
2020-09-06-170704,170704,0,0,1,72,3.4,0.007583925996020592,6
2020-09-07-170704,170704,0,0,0,72,2.4,0.008571805692236274,0
2020-09-08-170704,170704,0,0,2,72,8.8,0.008950125672102913,1
2020-09-09-170704,170704,0,0,0,72,7.0,0.010419475881533854,2
2020-09-10-170704,170704,2,0,1,74,5.4,0.003070017574851619,3
2020-09-11-170704,170704,1,0,0,75,7.8,0.005511627362681284,4
2020-09-12-170704,170704,0,0,0,75,2.2,0.00810420485822228,5
2020-09-13-170704,170704,0,0,0,75,1.8,0.008915997110201922,6
2020-09-14-170704,170704,0,0,0,75,4.6,0.008948756406314349,0
2020-09-15-170704,170704,0,0,2,75,5.6,0.009799750310105618,1
2020-09-16-170704,170704,1,0,0,76,5.0,0.012544848396187538,2
2020-09-17-170704,170704,0,0,0,76,5.2,0.013540516380153182,3
2020-09-18-170704,170704,0,0,1,76,4.4,0.01291234812450778,4
2020-09-19-170704,170704,0,0,0,76,3.0,0.01121326195425021,5
2020-09-20-170704,170704,1,0,0,77,1.4,0.011357751421387306,6
2020-09-21-170704,170704,0,0,1,77,8.6,0.010337854619233878,0
2020-09-22-170704,170704,2,0,2,79,7.8,0.009513907216045801,1
2020-09-23-170704,170704,0,0,0,79,9.2,0.009232577851462666,2
2020-09-24-170704,170704,1,0,0,80,3.6,0.008897074203092322,3
2020-09-25-170704,170704,0,0,2,80,7.4,0.008819334308658906,4
2020-09-26-170704,170704,0,0,2,80,3.2,0.008909231336437878,5
2020-09-27-170704,170704,0,0,0,80,2.2,0.00994891541108822,6
2020-09-28-170704,170704,0,0,0,80,3.0,0.010267146862640754,0
2020-09-29-170704,170704,2,0,1,82,4.6,0.009439096891487751,1
2020-09-30-170704,170704,0,0,0,82,3.4,0.008807531912991351,2
2020-10-01-170704,170704,0,0,0,82,2.2,0.0,3
2020-10-02-170704,170704,1,0,0,83,4.8,0.010426389071241163,4
2020-10-03-170704,170704,0,0,0,83,0.6,0.01697695160171573,5
2020-10-04-170704,170704,0,0,0,83,2.0,0.015803116577578942,6
2020-10-05-170704,170704,1,0,0,84,2.4,0.013357593016096077,0
2020-10-06-170704,170704,2,1,1,86,2.8,0.011780836422512398,1
2020-10-07-170704,170704,0,0,0,86,2.6,0.010226748320762105,2
2020-10-08-170704,170704,0,0,0,86,8.4,0.00946606536047918,3
2020-10-09-170704,170704,2,0,0,88,4.6,0.011833396506782607,4
2020-10-10-170704,170704,2,0,0,90,1.4,0.0012105734495365214,5
2020-10-11-170704,170704,0,0,0,90,1.4,0.0019042465443794847,6
2020-10-12-170704,170704,0,0,0,90,1.4,0.002537829681532445,0
2020-10-13-170704,170704,1,0,0,91,4.6,0.002851651135451776,1
2020-10-14-170704,170704,0,0,0,91,3.4,0.0043430455898760935,2
2020-10-15-170704,170704,0,0,1,91,3.2,0.0059585610394070985,3
2020-10-16-170704,170704,0,0,0,91,6.4,0.007914520044397442,4
2020-10-17-170704,170704,0,0,0,91,2.0,0.008167342327926652,5
2020-10-18-170704,170704,0,0,0,91,4.4,0.008032351518716082,6
2020-10-19-170704,170704,0,0,0,91,4.4,0.008478730080272511,0
2020-10-20-170704,170704,1,0,0,92,5.6,0.009943538431918763,1
2020-10-21-170704,170704,0,0,0,92,6.4,0.010520369984975382,2
2020-10-22-170704,170704,0,0,1,92,4.6,0.010845612571421548,3
2020-10-23-170704,170704,0,0,0,92,8.6,0.011102949444220593,4
2020-10-24-170704,170704,0,0,0,92,4.0,0.013216589268376806,5
2020-10-25-170704,170704,0,0,0,92,1.4,0.013984887334966022,6
2020-10-26-170704,170704,0,0,0,92,5.4,0.01257967871350894,0
2020-10-27-170704,170704,0,0,0,92,5.0,0.013643533736089968,1
2020-10-28-170704,170704,0,0,0,92,6.0,0.014418868496519847,2
2020-10-29-170704,170704,1,0,2,93,5.2,0.015204104202679529,3
2020-10-30-170704,170704,0,0,0,93,8.2,0.013383259515356622,4
2020-10-31-170704,170704,0,0,0,93,1.8,0.014743852424249203,5
2020-11-01-170704,170704,0,0,0,93,1.4,0.011231458778699311,6
2020-11-02-170704,170704,0,0,0,93,3.2,0.014447295952090947,0
2020-11-03-170704,170704,0,0,0,93,5.6,0.01306000639865363,1
2020-11-04-170704,170704,0,0,0,93,4.8,0.015024701070051712,2
2020-11-05-170704,170704,1,0,0,94,9.2,0.016313579060697508,3
2020-11-06-170704,170704,0,0,0,94,7.0,0.01803553844536887,4
2020-11-07-170704,170704,0,0,0,94,2.0,0.017772768187708725,5
2020-11-08-170704,170704,0,0,0,94,1.6,0.01694842256809918,6
2020-11-09-170704,170704,0,0,0,94,4.2,0.01675362685162065,0
2020-11-10-170704,170704,0,0,0,94,8.6,0.010573766620021184,1
2020-11-11-170704,170704,0,0,0,94,5.4,0.013161021391257475,2
2020-11-12-170704,170704,2,0,0,96,4.6,0.014052250001747608,3
2020-11-13-170704,170704,0,0,0,96,6.8,0.014506049406893377,4
2020-03-01-170705,170705,0,0,0,0,0.0,0.0,6
2020-03-02-170705,170705,0,0,0,0,0.0,28.47790202002121,0
2020-03-03-170705,170705,0,1,3,0,0.25,106.38040579223151,1
2020-03-04-170705,170705,0,0,19,0,0.0,116.48196827404729,2
2020-03-05-170705,170705,0,0,6,0,0.0,120.02203187567389,3
2020-03-06-170705,170705,0,0,6,0,0.25,110.67627450314347,4
2020-03-07-170705,170705,0,0,4,0,0.5,107.76000683305384,5
2020-03-08-170705,170705,0,0,3,0,0.0,105.9670563418137,6
2020-03-09-170705,170705,0,0,3,0,0.25,106.30210399764341,0
2020-03-10-170705,170705,0,0,0,0,0.0,135.25734280892905,1
2020-03-11-170705,170705,0,0,3,0,0.25,112.88304814208091,2
2020-03-12-170705,170705,0,2,6,0,1.0,87.92652861943219,3
2020-03-13-170705,170705,0,0,2,0,0.75,64.91039526444382,4
2020-03-14-170705,170705,0,0,3,0,1.25,51.83953135378896,5
2020-03-15-170705,170705,0,0,3,0,1.5,42.579796320623956,6
2020-03-16-170705,170705,0,0,3,0,7.0,19.70288029968824,0
2020-03-17-170705,170705,3,0,6,3,7.25,42.91914036834439,1
2020-03-18-170705,170705,19,0,7,22,9.0,65.01181162182453,2
2020-03-19-170705,170705,6,0,3,28,13.75,124.8044409515952,3
2020-03-20-170705,170705,6,0,0,34,9.25,171.64166425957654,4
2020-03-21-170705,170705,4,0,2,38,4.25,195.2645167476021,5
2020-03-22-170705,170705,3,0,4,41,11.75,206.3592168325065,6
2020-03-23-170705,170705,3,0,1,44,20.0,218.4987986860009,0
2020-03-24-170705,170705,0,0,0,44,17.0,249.13144612247154,1
2020-03-25-170705,170705,3,0,2,47,14.25,239.38711072529395,2
2020-03-26-170705,170705,6,0,2,53,13.25,224.98888675443294,3
2020-03-27-170705,170705,2,0,1,55,16.25,261.6934748446114,4
2020-03-28-170705,170705,3,0,0,58,3.75,263.13671178330924,5
2020-03-29-170705,170705,3,0,0,61,3.25,261.43263508956153,6
2020-03-30-170705,170705,3,0,10,64,12.75,195.56289302881194,0
2020-03-31-170705,170705,6,1,1,70,7.75,184.62822831378617,1
2020-04-01-170705,170705,7,0,1,77,13.75,31.386821662772842,2
2020-04-02-170705,170705,3,0,0,80,17.0,123.9868216935018,3
2020-04-03-170705,170705,0,0,1,80,7.75,103.48253555031437,4
2020-04-04-170705,170705,2,0,2,82,7.75,104.60794649787042,5
2020-04-05-170705,170705,4,0,3,86,3.75,121.27640228401759,6
2020-04-06-170705,170705,1,1,0,87,11.75,127.46352245679873,0
2020-04-07-170705,170705,0,0,0,87,4.5,101.29305874224761,1
2020-04-08-170705,170705,2,0,0,89,6.0,111.16805292424311,2
2020-04-09-170705,170705,2,0,4,91,2.5,114.32451738958764,3
2020-04-10-170705,170705,1,1,3,92,4.75,36.26612436320403,4
2020-04-11-170705,170705,0,0,0,92,1.5,43.539042872748794,5
2020-04-12-170705,170705,0,0,1,92,3.25,45.82546791042431,6
2020-04-13-170705,170705,10,0,21,102,11.25,51.45770833377847,0
2020-04-14-170705,170705,1,0,1,103,6.75,86.90863386668325,1
2020-04-15-170705,170705,1,0,1,104,8.0,97.58169146520459,2
2020-04-16-170705,170705,0,0,0,104,3.25,110.19604415850048,3
2020-04-17-170705,170705,1,0,2,105,3.5,89.70818264547111,4
2020-04-18-170705,170705,2,0,1,107,14.25,99.41429028676146,5
2020-04-19-170705,170705,3,0,0,110,6.5,125.71124570292227,6
2020-04-20-170705,170705,0,0,0,110,4.5,122.88390471047188,0
2020-04-21-170705,170705,0,0,0,110,4.75,121.76789348205821,1
2020-04-22-170705,170705,0,0,1,110,9.0,123.8043495934612,2
2020-04-23-170705,170705,4,0,0,114,2.25,128.04068529310146,3
2020-04-24-170705,170705,3,0,0,117,6.0,122.461980008468,4
2020-04-25-170705,170705,0,0,0,117,1.0,109.62544242222388,5
2020-04-26-170705,170705,1,0,0,118,1.5,102.19808163435216,6
2020-04-27-170705,170705,21,0,0,139,3.75,78.46733707594234,0
2020-04-28-170705,170705,1,0,1,140,3.5,116.37109765376921,1
2020-04-29-170705,170705,1,0,1,141,5.0,110.96467109779567,2
2020-04-30-170705,170705,0,0,1,141,6.25,115.38797105217745,3
2020-05-01-170705,170705,2,0,0,143,1.25,116.3878176503328,4
2020-05-02-170705,170705,1,0,1,144,0.25,70.67696880822274,5
2020-05-03-170705,170705,0,0,0,144,0.0,68.44185754280863,6
2020-05-04-170705,170705,0,0,0,144,2.25,43.16908903518345,0
2020-05-05-170705,170705,0,0,1,144,3.5,36.299636106329665,1
2020-05-06-170705,170705,1,0,0,145,1.75,23.49571051842878,2
2020-05-07-170705,170705,0,0,1,145,4.5,23.3737088606033,3
2020-05-08-170705,170705,0,0,0,145,4.25,27.413814569305902,4
2020-05-09-170705,170705,0,1,0,145,2.25,38.654811921838935,5
2020-05-10-170705,170705,0,0,0,145,1.75,118.2407331015489,6
2020-05-11-170705,170705,0,0,0,145,4.25,102.86065404120427,0
2020-05-12-170705,170705,1,0,1,146,4.75,97.88106021142397,1
2020-05-13-170705,170705,1,0,1,147,3.5,83.84985343405447,2
2020-05-14-170705,170705,1,0,0,148,4.75,78.96489782051036,3
2020-05-15-170705,170705,0,0,1,148,5.25,77.93757625503765,4
2020-05-16-170705,170705,1,0,0,149,2.25,74.26410609766313,5
2020-05-17-170705,170705,0,0,0,149,2.25,77.11906446210853,6
2020-05-18-170705,170705,0,0,0,149,5.75,78.4423030513687,0
2020-05-19-170705,170705,1,0,1,150,5.75,81.14816055331684,1
2020-05-20-170705,170705,0,1,1,150,5.75,75.31908027138455,2
2020-05-21-170705,170705,1,0,0,151,4.25,73.86102793103933,3
2020-05-22-170705,170705,0,0,0,151,4.75,74.47031981665378,4
2020-05-23-170705,170705,0,0,0,151,3.25,81.80859043017956,5
2020-05-24-170705,170705,0,0,1,151,3.0,85.23473144202175,6
2020-05-25-170705,170705,0,0,0,151,5.5,82.17536293314043,0
2020-05-26-170705,170705,1,0,0,152,5.25,83.28955105329973,1
2020-05-27-170705,170705,1,0,0,153,5.25,98.7364804050411,2
2020-05-28-170705,170705,0,1,0,153,2.25,108.85275361493728,3
2020-05-29-170705,170705,1,3,1,154,1.75,104.00165582875253,4
2020-05-30-170705,170705,0,0,0,154,0.0,87.85576159949204,5
2020-05-31-170705,170705,0,0,1,154,0.0,80.02133009812594,6
2020-06-01-170705,170705,0,0,1,154,1.5,59.72144551086829,0
2020-06-02-170705,170705,1,0,0,155,2.0,52.15942214810454,1
2020-06-03-170705,170705,1,0,0,156,1.5,37.40848066725037,2
2020-06-04-170705,170705,0,0,1,156,0.75,33.73156320494931,3
2020-06-05-170705,170705,0,0,7,156,0.75,34.99942110676213,4
2020-06-06-170705,170705,0,0,0,156,0.5,33.02824562198823,5
2020-06-07-170705,170705,1,0,0,157,0.5,34.331914127113876,6
2020-06-08-170705,170705,0,0,0,157,2.5,35.13357452023311,0
2020-06-09-170705,170705,0,0,3,157,2.0,37.499006103990865,1
2020-06-10-170705,170705,0,0,0,157,0.5,63.96749602047765,2
2020-06-11-170705,170705,0,0,1,157,1.75,58.861440715986184,3
2020-06-12-170705,170705,1,0,0,158,2.25,54.81190613807226,4
2020-06-13-170705,170705,0,0,0,158,0.0,53.7880897946496,5
2020-06-14-170705,170705,1,0,1,159,0.0,41.91672822426504,6
2020-06-15-170705,170705,1,0,0,160,1.5,32.1694333161682,0
2020-06-16-170705,170705,0,0,0,160,1.75,30.657444962114624,1
2020-06-17-170705,170705,0,0,0,160,1.75,32.26536634708,2
2020-06-18-170705,170705,1,0,0,161,1.0,36.306029773868715,3
2020-06-19-170705,170705,7,0,0,168,1.25,38.753937471032984,4
2020-06-20-170705,170705,0,0,0,168,0.5,60.69867285529024,5
2020-06-21-170705,170705,0,0,0,168,0.25,59.83884502577631,6
2020-06-22-170705,170705,0,0,0,168,1.0,55.32807601185333,0
2020-06-23-170705,170705,3,0,0,171,1.25,51.26221835474954,1
2020-06-24-170705,170705,0,0,0,171,0.75,59.6274888133083,2
2020-06-25-170705,170705,1,7,0,172,1.0,57.41056642549796,3
2020-06-26-170705,170705,0,0,1,172,1.25,39.961936651238005,4
2020-06-27-170705,170705,0,0,0,172,0.5,39.150292886605165,5
2020-06-28-170705,170705,1,0,0,173,0.0,42.243107122347155,6
2020-06-29-170705,170705,0,0,0,173,0.75,45.93110842363116,0
2020-06-30-170705,170705,0,0,1,173,1.5,40.83858803881714,1
2020-07-01-170705,170705,0,0,0,173,0.5,48.3181705708326,2
2020-07-02-170705,170705,0,0,1,173,0.75,41.91471970514678,3
2020-07-03-170705,170705,0,0,1,173,1.75,52.0421854066321,4
2020-07-04-170705,170705,0,0,1,173,0.75,69.80990132597185,5
2020-07-05-170705,170705,0,0,0,173,0.0,71.96444472924587,6
2020-07-06-170705,170705,0,0,2,173,1.25,70.58557511475922,0
2020-07-07-170705,170705,0,0,0,173,0.5,66.06150012774887,1
2020-07-08-170705,170705,0,0,1,173,0.25,56.33357078099328,2
2020-07-09-170705,170705,0,0,0,173,1.0,48.83156184882162,3
2020-07-10-170705,170705,1,0,6,174,1.25,43.41450566772627,4
2020-07-11-170705,170705,0,0,0,174,0.25,45.312163568265156,5
2020-07-12-170705,170705,0,0,0,174,0.5,42.55161757439374,6
2020-07-13-170705,170705,0,0,0,174,0.5,42.09723124449118,0
2020-07-14-170705,170705,1,1,2,175,0.5,40.710275214057006,1
2020-07-15-170705,170705,0,0,1,175,3.0,38.77366461183496,2
2020-07-16-170705,170705,1,0,5,176,1.75,40.69158308329133,3
2020-07-17-170705,170705,1,0,0,177,1.25,45.272227861721476,4
2020-07-18-170705,170705,1,0,1,178,0.75,40.66631947267436,5
2020-07-19-170705,170705,0,0,1,178,0.75,45.7480043014135,6
2020-07-20-170705,170705,2,0,0,180,0.5,42.59647757245841,0
2020-07-21-170705,170705,0,0,0,180,0.75,45.85394722006302,1
2020-07-22-170705,170705,1,1,2,181,2.25,40.07902850461831,2
2020-07-23-170705,170705,0,0,1,181,1.75,45.244090700453725,3
2020-07-24-170705,170705,6,0,0,187,0.5,42.460061102212805,4
2020-07-25-170705,170705,0,0,1,187,0.5,60.74212771705961,5
2020-07-26-170705,170705,0,0,2,187,0.0,61.18034400387708,6
2020-07-27-170705,170705,0,0,4,187,0.75,59.12553528773144,0
2020-07-28-170705,170705,2,0,1,189,1.75,51.22398272530492,1
2020-07-29-170705,170705,1,0,4,190,1.25,58.35722333048864,2
2020-07-30-170705,170705,5,0,5,195,3.0,66.63479502866858,3
2020-07-31-170705,170705,0,0,2,195,2.0,69.92590297599571,4
2020-08-01-170705,170705,1,0,1,196,0.75,27.720819692439576,5
2020-08-02-170705,170705,1,0,2,197,1.0,335.48824866992453,6
2020-08-03-170705,170705,0,0,3,197,1.25,187.21087781560766,0
2020-08-04-170705,170705,0,0,5,197,0.5,166.6784751132531,1
2020-08-05-170705,170705,2,0,5,199,2.0,137.10660641525055,2
2020-08-06-170705,170705,1,0,0,200,1.75,129.15727491549268,3
2020-08-07-170705,170705,0,0,1,200,2.0,127.38761037503711,4
2020-08-08-170705,170705,1,0,0,201,1.75,99.08234267219112,5
2020-08-09-170705,170705,2,0,0,203,1.5,107.20882572466022,6
2020-08-10-170705,170705,4,0,4,207,1.5,26.49715265262764,0
2020-08-11-170705,170705,1,0,0,208,3.75,62.94325671665855,1
2020-08-12-170705,170705,4,0,1,212,4.0,94.90247892334861,2
2020-08-13-170705,170705,5,0,0,217,5.75,139.049369964052,3
2020-08-14-170705,170705,2,0,2,219,10.5,195.42061908951504,4
2020-08-15-170705,170705,1,0,4,220,2.25,260.9408584601994,5
2020-08-16-170705,170705,2,0,1,222,2.25,285.13851794099264,6
2020-08-17-170705,170705,3,0,0,225,8.75,306.0168161855352,0
2020-08-18-170705,170705,5,0,0,230,9.75,322.5956248004245,1
2020-08-19-170705,170705,5,0,0,235,5.0,365.85779277750544,2
2020-08-20-170705,170705,0,0,4,235,3.75,334.9080466690883,3
2020-08-21-170705,170705,1,0,0,236,3.25,284.68017600589565,4
2020-08-22-170705,170705,0,0,1,236,2.75,283.1774933974668,5
2020-08-23-170705,170705,0,0,1,236,2.0,273.2224875620972,6
2020-08-24-170705,170705,4,0,1,240,4.25,224.1305745814352,0
2020-08-25-170705,170705,0,0,2,240,6.75,202.66075920321614,1
2020-08-26-170705,170705,1,0,1,241,3.0,162.07491658525248,2
2020-08-27-170705,170705,0,0,2,241,7.25,187.4507909995526,3
2020-08-28-170705,170705,2,0,0,243,2.75,188.6707285921048,4
2020-08-29-170705,170705,4,0,0,247,4.25,178.4498023497203,5
2020-08-30-170705,170705,1,0,1,248,5.0,195.02266386711563,6
2020-08-31-170705,170705,0,0,1,248,3.75,178.28550823675943,0
2020-09-01-170705,170705,0,0,1,248,4.75,78.23079949989815,1
2020-09-02-170705,170705,0,0,1,248,1.75,168.41347176150464,2
2020-09-03-170705,170705,4,0,2,252,4.0,153.57160197215697,3
2020-09-04-170705,170705,0,0,1,252,7.5,162.51370268317518,4
2020-09-05-170705,170705,1,0,0,253,1.25,143.31384655425285,5
2020-09-06-170705,170705,1,0,1,254,1.25,137.52658932499253,6
2020-09-07-170705,170705,1,0,4,255,4.25,141.40025824813628,0
2020-09-08-170705,170705,2,1,3,257,7.25,140.38715997287744,1
2020-09-09-170705,170705,1,0,1,258,2.75,164.13768017963173,2
2020-09-10-170705,170705,2,0,2,260,3.75,68.80015507245,3
2020-09-11-170705,170705,0,0,1,260,6.0,88.5282886464895,4
2020-09-12-170705,170705,0,1,0,260,2.25,103.73771656753374,5
2020-09-13-170705,170705,1,0,0,261,1.5,105.22653725628642,6
2020-09-14-170705,170705,1,0,0,262,9.25,111.5661003997535,0
2020-09-15-170705,170705,1,0,0,263,4.0,137.4374297230173,1
2020-09-16-170705,170705,1,0,1,264,7.5,148.52677396847426,2
2020-09-17-170705,170705,2,0,0,266,8.0,154.87947792360475,3
2020-09-18-170705,170705,1,0,0,267,6.75,157.07275205871682,4
2020-09-19-170705,170705,0,1,1,267,2.75,148.70266371154446,5
2020-09-20-170705,170705,1,0,0,268,4.25,134.49433410292443,6
2020-09-21-170705,170705,4,0,0,272,9.0,107.21582137490522,0
2020-09-22-170705,170705,3,0,0,275,5.25,105.32434400000596,1
2020-09-23-170705,170705,1,0,0,276,7.0,107.10809443615864,2
2020-09-24-170705,170705,2,0,0,278,4.75,105.25795574059063,3
2020-09-25-170705,170705,1,0,2,279,12.0,101.23196704712143,4
2020-09-26-170705,170705,0,0,0,279,1.25,132.63078913960942,5
2020-09-27-170705,170705,0,0,5,279,1.75,138.9817140110827,6
2020-09-28-170705,170705,0,0,1,279,6.0,139.15078708564894,0
2020-09-29-170705,170705,0,0,0,279,2.25,140.1949673222494,1
2020-09-30-170705,170705,1,0,2,280,4.0,132.1496391764446,2
2020-10-01-170705,170705,0,0,2,280,5.0,0.0,3
2020-10-02-170705,170705,0,0,1,280,9.25,148.89839199742744,4
2020-10-03-170705,170705,1,0,1,281,4.0,203.20297894148604,5
2020-10-04-170705,170705,0,0,1,281,4.5,200.7656602875208,6
2020-10-05-170705,170705,0,0,1,281,5.0,191.5554423304551,0
2020-10-06-170705,170705,0,0,1,281,5.25,192.21920703757417,1
2020-10-07-170705,170705,0,0,4,281,3.25,182.9995489548676,2
2020-10-08-170705,170705,0,1,1,281,10.0,146.1954325661581,3
2020-10-09-170705,170705,2,0,3,283,5.5,170.52933430712403,4
2020-10-10-170705,170705,0,0,11,283,2.5,16.202222435838195,5
2020-10-11-170705,170705,5,0,6,288,3.0,31.096543315440943,6
2020-10-12-170705,170705,1,0,2,289,4.0,56.93361074150306,0
2020-10-13-170705,170705,0,0,2,289,6.0,73.24216047350765,1
2020-10-14-170705,170705,2,0,5,291,3.0,95.52618486095831,2
2020-10-15-170705,170705,2,0,5,293,4.75,113.6614401622729,3
2020-10-16-170705,170705,1,0,6,294,6.25,134.86091211322218,4
2020-10-17-170705,170705,1,0,13,295,2.75,144.9967896755826,5
2020-10-18-170705,170705,1,0,1,296,2.75,149.34937490682813,6
2020-10-19-170705,170705,1,0,5,297,3.75,140.04298769941926,0
2020-10-20-170705,170705,1,0,3,298,2.0,147.1676912576545,1
2020-10-21-170705,170705,4,0,2,302,2.25,145.76283337726088,2
2020-10-22-170705,170705,1,0,4,303,8.0,150.59324071866752,3
2020-10-23-170705,170705,3,0,2,306,2.5,156.53382829649306,4
2020-10-24-170705,170705,11,0,3,317,1.0,155.60991726712592,5
2020-10-25-170705,170705,6,0,1,323,2.25,171.49342442615563,6
2020-10-26-170705,170705,2,0,5,325,2.5,164.3831669737685,0
2020-10-27-170705,170705,2,0,1,327,4.0,157.14789133963484,1
2020-10-28-170705,170705,5,0,3,332,4.25,161.42394956345908,2
2020-10-29-170705,170705,5,0,1,337,6.75,164.64465281032702,3
2020-10-30-170705,170705,6,0,0,343,5.0,174.81881281104666,4
2020-10-31-170705,170705,13,0,0,356,3.0,159.3239314753883,5
2020-11-01-170705,170705,1,0,0,357,1.75,162.1949931921149,6
2020-11-02-170705,170705,5,0,0,362,1.5,85.61320985192633,0
2020-11-03-170705,170705,3,0,0,365,6.25,85.71740868301669,1
2020-11-04-170705,170705,2,0,0,367,4.5,107.15126448383879,2
2020-11-05-170705,170705,4,1,0,371,4.75,109.13859217547711,3
2020-11-06-170705,170705,2,0,0,373,7.5,123.94010013183085,4
2020-11-07-170705,170705,3,0,0,376,1.0,138.3383417138921,5
2020-11-08-170705,170705,1,0,0,377,1.5,135.11700523465612,6
2020-11-09-170705,170705,5,0,0,382,5.0,124.77318144506886,0
2020-11-10-170705,170705,1,0,0,383,4.25,116.94593657365553,1
2020-11-11-170705,170705,3,0,0,386,3.25,117.32788130182128,2
2020-11-12-170705,170705,1,0,0,387,1.75,125.81179920520822,3
2020-11-13-170705,170705,0,0,0,387,4.5,113.66477816233794,4
2020-03-01-170706,170706,0,0,1,0,0.16666666666666666,0.0,6
2020-03-02-170706,170706,0,0,0,0,0.3333333333333333,23.20163419719607,0
2020-03-03-170706,170706,0,0,8,0,0.0,151.8060978580093,1
2020-03-04-170706,170706,0,0,7,0,0.0,168.24107729393552,2
2020-03-05-170706,170706,1,0,8,1,0.16666666666666666,170.67053958599823,3
2020-03-06-170706,170706,0,0,5,1,0.16666666666666666,151.46923349171476,4
2020-03-07-170706,170706,0,0,3,1,0.16666666666666666,137.95446205261095,5
2020-03-08-170706,170706,0,0,16,1,0.0,125.72397505748826,6
2020-03-09-170706,170706,0,0,19,1,0.16666666666666666,126.2835504629513,0
2020-03-10-170706,170706,0,0,7,1,0.16666666666666666,193.11251534876507,1
2020-03-11-170706,170706,0,0,13,1,0.16666666666666666,168.00367634865748,2
2020-03-12-170706,170706,0,0,20,1,0.8333333333333334,115.50711327932038,3
2020-03-13-170706,170706,1,0,16,2,0.8333333333333334,70.68924835183444,4
2020-03-14-170706,170706,0,0,11,2,1.1666666666666667,58.69665908085765,5
2020-03-15-170706,170706,1,0,3,3,1.8333333333333333,49.275140121603116,6
2020-03-16-170706,170706,0,0,5,3,8.5,27.92847603154957,0
2020-03-17-170706,170706,8,0,3,11,8.833333333333334,51.088249500425135,1
2020-03-18-170706,170706,7,0,8,18,9.833333333333334,87.73859198542203,2
2020-03-19-170706,170706,8,0,9,26,16.5,129.1050266692454,3
2020-03-20-170706,170706,5,0,8,31,12.5,172.51755446916218,4
2020-03-21-170706,170706,3,0,5,34,6.0,194.01595361823985,5
2020-03-22-170706,170706,16,0,5,50,9.5,198.12758477958448,6
2020-03-23-170706,170706,19,0,6,69,20.33333333333333,226.10598735767707,0
2020-03-24-170706,170706,7,0,2,76,13.0,265.8727075415752,1
2020-03-25-170706,170706,13,0,8,89,17.5,274.01686810749175,2
2020-03-26-170706,170706,20,0,6,109,13.666666666666664,281.60876018472084,3
2020-03-27-170706,170706,16,0,1,125,15.5,348.1871884980291,4
2020-03-28-170706,170706,11,1,4,136,7.0,371.2603497630396,5
2020-03-29-170706,170706,3,0,3,139,6.833333333333332,388.8057468837975,6
2020-03-30-170706,170706,5,0,8,144,14.833333333333336,290.77724153593704,0
2020-03-31-170706,170706,3,0,2,147,10.666666666666666,287.2154150899066,1
2020-04-01-170706,170706,8,0,3,155,10.833333333333336,31.09831535659059,2
2020-04-02-170706,170706,9,0,2,164,14.833333333333336,154.96265054825267,3
2020-04-03-170706,170706,8,0,10,172,7.166666666666668,83.71837312152621,4
2020-04-04-170706,170706,5,0,2,177,9.166666666666666,107.7981858103338,5
2020-04-05-170706,170706,5,0,2,182,5.166666666666667,125.82725296490156,6
2020-04-06-170706,170706,6,1,30,188,16.833333333333332,138.2905117306185,0
2020-04-07-170706,170706,2,0,1,190,9.5,157.70665701285296,1
2020-04-08-170706,170706,8,0,2,198,5.333333333333333,170.44716599663406,2
2020-04-09-170706,170706,6,1,1,204,6.0,181.8758496963129,3
2020-04-10-170706,170706,1,0,1,205,6.0,37.6197697644228,4
2020-04-11-170706,170706,4,0,3,209,2.6666666666666665,50.99640880425949,5
2020-04-12-170706,170706,3,1,0,212,3.5,64.60142889060876,6
2020-04-13-170706,170706,8,0,1,220,10.5,78.29753343138178,0
2020-04-14-170706,170706,2,1,3,222,7.833333333333332,114.73591766840804,1
2020-04-15-170706,170706,3,0,2,225,8.166666666666666,132.47502353158237,2
2020-04-16-170706,170706,2,0,1,227,5.0,158.56269823231423,3
2020-04-17-170706,170706,10,0,1,237,4.0,145.33710022677695,4
2020-04-18-170706,170706,2,0,5,239,8.666666666666666,164.1048859424534,5
2020-04-19-170706,170706,2,0,3,241,4.833333333333333,172.76916459639142,6
2020-04-20-170706,170706,30,1,3,271,5.833333333333332,190.3216111826202,0
2020-04-21-170706,170706,1,0,4,272,6.166666666666668,243.69804473495978,1
2020-04-22-170706,170706,2,0,1,274,9.0,236.46723027506005,2
2020-04-23-170706,170706,1,0,3,275,2.5,250.56978224214913,3
2020-04-24-170706,170706,1,0,4,276,6.333333333333332,227.61420770727733,4
2020-04-25-170706,170706,3,0,0,279,1.3333333333333333,223.2631505271551,5
2020-04-26-170706,170706,0,0,0,279,0.8333333333333334,225.12893856007253,6
2020-04-27-170706,170706,1,1,4,280,9.5,172.30451595307682,0
2020-04-28-170706,170706,3,0,3,283,5.666666666666668,115.68565511779045,1
2020-04-29-170706,170706,2,1,0,285,6.833333333333332,117.45081462305899,2
2020-04-30-170706,170706,1,0,7,286,6.333333333333332,136.54058255755356,3
2020-05-01-170706,170706,1,1,2,287,1.5,203.2766837169143,4
2020-05-02-170706,170706,5,2,4,292,0.8333333333333334,107.92437443968319,5
2020-05-03-170706,170706,3,0,0,295,0.8333333333333334,103.5857160630916,6
2020-05-04-170706,170706,3,0,6,298,5.0,68.31982373048609,0
2020-05-05-170706,170706,4,0,1,302,4.666666666666667,64.25661913819319,1
2020-05-06-170706,170706,1,0,1,303,4.833333333333333,56.349899867592,2
2020-05-07-170706,170706,3,0,7,306,6.833333333333332,59.44792859156382,3
2020-05-08-170706,170706,4,0,4,310,4.5,74.06561806692771,4
2020-05-09-170706,170706,0,2,7,310,2.1666666666666665,96.01440337646834,5
2020-05-10-170706,170706,0,1,2,310,1.3333333333333333,208.63096470742096,6
2020-05-11-170706,170706,4,0,6,314,5.166666666666667,172.24536856829616,0
2020-05-12-170706,170706,3,0,5,317,4.333333333333333,178.28871574423658,1
2020-05-13-170706,170706,0,0,7,317,4.333333333333333,144.76412230955694,2
2020-05-14-170706,170706,7,0,2,324,5.0,131.04850429395478,3
2020-05-15-170706,170706,2,0,2,326,4.666666666666667,125.30140499951892,4
2020-05-16-170706,170706,4,0,0,330,2.5,110.45507384627842,5
2020-05-17-170706,170706,0,0,0,330,2.6666666666666665,119.8492533317114,6
2020-05-18-170706,170706,6,0,3,336,6.333333333333332,121.10502314620766,0
2020-05-19-170706,170706,1,0,1,337,5.666666666666668,127.77484098794446,1
2020-05-20-170706,170706,1,0,2,338,6.833333333333332,128.29601717103685,2
2020-05-21-170706,170706,7,0,0,345,5.0,114.14499822396596,3
2020-05-22-170706,170706,4,0,1,349,5.666666666666668,125.332669409823,4
2020-05-23-170706,170706,7,0,0,356,1.3333333333333333,133.77878615149194,5
2020-05-24-170706,170706,2,0,0,358,1.6666666666666667,151.86656499299488,6
2020-05-25-170706,170706,6,0,1,364,5.833333333333332,128.03390291245415,0
2020-05-26-170706,170706,5,0,3,369,3.8333333333333335,141.26975521692077,1
2020-05-27-170706,170706,7,1,1,376,6.5,147.94396978556955,2
2020-05-28-170706,170706,2,0,0,378,2.833333333333333,167.2281954004951,3
2020-05-29-170706,170706,2,2,0,380,1.6666666666666667,154.51944525279092,4
2020-05-30-170706,170706,0,0,0,380,0.16666666666666666,129.0281813826134,5
2020-05-31-170706,170706,0,0,0,380,0.0,120.49273988298646,6
2020-06-01-170706,170706,3,0,0,383,2.5,118.90930101184776,0
2020-06-02-170706,170706,1,0,1,384,2.6666666666666665,51.614097174857626,1
2020-06-03-170706,170706,2,1,2,386,2.333333333333333,48.029941249077524,2
2020-06-04-170706,170706,0,0,0,386,1.8333333333333333,47.2007655652265,3
2020-06-05-170706,170706,1,3,3,387,2.1666666666666665,42.07819531249052,4
2020-06-06-170706,170706,0,0,0,387,0.3333333333333333,41.131218471509584,5
2020-06-07-170706,170706,0,0,0,387,1.0,35.87050189727967,6
2020-06-08-170706,170706,1,0,1,388,2.5,35.370142542302894,0
2020-06-09-170706,170706,3,0,0,391,2.0,41.00989672896645,1
2020-06-10-170706,170706,1,0,2,392,1.5,127.87647015435209,2
2020-06-11-170706,170706,0,0,3,392,3.0,116.35004940988516,3
2020-06-12-170706,170706,0,0,1,392,1.5,97.1785252738475,4
2020-06-13-170706,170706,0,1,1,392,0.6666666666666666,87.78771632505544,5
2020-06-14-170706,170706,0,0,0,392,0.16666666666666666,65.31686854776527,6
2020-06-15-170706,170706,0,1,1,392,2.1666666666666665,41.94549241039351,0
2020-06-16-170706,170706,1,0,0,393,2.6666666666666665,43.09707810163762,1
2020-06-17-170706,170706,2,0,0,395,1.8333333333333333,40.522255261094344,2
2020-06-18-170706,170706,0,0,1,395,1.8333333333333333,43.28582942971032,3
2020-06-19-170706,170706,3,0,0,398,3.333333333333333,42.0020289427958,4
2020-06-20-170706,170706,0,0,1,398,0.6666666666666666,62.889638447057806,5
2020-06-21-170706,170706,0,0,0,398,0.8333333333333334,65.10434180469414,6
2020-06-22-170706,170706,1,0,1,399,1.5,61.120066393795206,0
2020-06-23-170706,170706,0,0,0,399,1.6666666666666667,57.74644877627438,1
2020-06-24-170706,170706,2,0,0,401,1.5,53.405976854445186,2
2020-06-25-170706,170706,3,2,2,404,1.8333333333333333,60.541552805541144,3
2020-06-26-170706,170706,1,0,0,405,1.8333333333333333,57.96474714635967,4
2020-06-27-170706,170706,1,0,0,406,0.3333333333333333,54.626643945504625,5
2020-06-28-170706,170706,0,1,0,406,0.5,62.41818841369757,6
2020-06-29-170706,170706,1,0,1,407,0.8333333333333334,63.065996726370905,0
2020-06-30-170706,170706,0,0,0,407,0.5,67.75665994119254,1
2020-07-01-170706,170706,0,0,0,407,1.5,53.4784754104333,2
2020-07-02-170706,170706,1,0,2,408,1.1666666666666667,35.3163800389724,3
2020-07-03-170706,170706,0,0,0,408,1.8333333333333333,59.08451159316017,4
2020-07-04-170706,170706,1,0,0,409,0.3333333333333333,66.26808287020378,5
2020-07-05-170706,170706,0,0,0,409,0.0,63.11422148330038,6
2020-07-06-170706,170706,1,0,0,410,1.5,54.82778859291956,0
2020-07-07-170706,170706,0,0,0,410,1.0,40.9375182820547,1
2020-07-08-170706,170706,0,0,0,410,1.5,36.75747777190499,2
2020-07-09-170706,170706,2,0,0,412,1.6666666666666667,38.22840091446801,3
2020-07-10-170706,170706,0,0,2,412,0.6666666666666666,56.44705515320467,4
2020-07-11-170706,170706,0,0,0,412,0.5,51.30459134202822,5
2020-07-12-170706,170706,0,0,1,412,0.16666666666666666,43.8851418204003,6
2020-07-13-170706,170706,1,0,1,413,0.5,43.11116928054827,0
2020-07-14-170706,170706,0,0,5,413,0.6666666666666666,47.106892053371496,1
2020-07-15-170706,170706,0,0,1,413,2.0,39.863109885878586,2
2020-07-16-170706,170706,2,0,2,415,3.0,27.66563734678878,3
2020-07-17-170706,170706,0,0,1,415,1.1666666666666667,32.376706811058014,4
2020-07-18-170706,170706,0,0,0,415,0.3333333333333333,34.68488427104036,5
2020-07-19-170706,170706,0,0,0,415,0.5,34.17561586161648,6
2020-07-20-170706,170706,0,0,3,415,1.1666666666666667,36.294499203718416,0
2020-07-21-170706,170706,0,0,0,415,1.5,36.07098757456306,1
2020-07-22-170706,170706,0,0,0,415,2.1666666666666665,33.77534310868637,2
2020-07-23-170706,170706,0,0,1,415,1.8333333333333333,32.18477303402108,3
2020-07-24-170706,170706,2,0,0,417,2.333333333333333,31.76288513294577,4
2020-07-25-170706,170706,0,0,0,417,0.6666666666666666,38.42079352979193,5
2020-07-26-170706,170706,1,0,1,418,0.16666666666666666,38.21161459507171,6
2020-07-27-170706,170706,1,0,1,419,2.6666666666666665,34.49128264532011,0
2020-07-28-170706,170706,5,0,1,424,3.5,38.63155609806735,1
2020-07-29-170706,170706,1,0,1,425,2.833333333333333,55.54575779474365,2
2020-07-30-170706,170706,2,0,0,427,3.333333333333333,53.449657422014056,3
2020-07-31-170706,170706,1,0,3,428,3.0,58.85473220216916,4
2020-08-01-170706,170706,0,0,0,428,0.5,35.09560874943211,5
2020-08-02-170706,170706,0,0,0,428,1.0,128.40060127226184,6
2020-08-03-170706,170706,3,0,4,431,2.833333333333333,153.35536387624137,0
2020-08-04-170706,170706,0,0,1,431,2.333333333333333,120.28788377163241,1
2020-08-05-170706,170706,0,0,6,431,3.5,103.81868752570935,2
2020-08-06-170706,170706,1,0,1,432,3.333333333333333,94.29081573035414,3
2020-08-07-170706,170706,0,0,6,432,3.0,77.98849247244144,4
2020-08-08-170706,170706,0,0,7,432,0.5,73.08165045946743,5
2020-08-09-170706,170706,1,0,2,433,1.0,60.65596742302501,6
2020-08-10-170706,170706,1,0,3,434,1.5,29.8458999845965,0
2020-08-11-170706,170706,1,0,6,435,2.5,33.513165053366635,1
2020-08-12-170706,170706,1,0,2,436,3.333333333333333,47.92390144797149,2
2020-08-13-170706,170706,0,0,2,436,3.0,53.402772454450265,3
2020-08-14-170706,170706,3,0,4,439,2.0,64.22850576045349,4
2020-08-15-170706,170706,0,0,1,439,2.333333333333333,79.55555034609742,5
2020-08-16-170706,170706,0,0,1,439,0.6666666666666666,78.51298010936851,6
2020-08-17-170706,170706,4,0,4,443,3.8333333333333335,78.81422245375184,0
2020-08-18-170706,170706,1,0,6,444,3.1666666666666665,102.49511086196797,1
2020-08-19-170706,170706,6,0,25,450,4.166666666666667,109.78983766604813,2
2020-08-20-170706,170706,1,1,9,451,4.0,127.36694701116276,3
2020-08-21-170706,170706,6,0,18,457,7.5,123.8567148602511,4
2020-08-22-170706,170706,7,0,11,464,1.6666666666666667,168.36586284449533,5
2020-08-23-170706,170706,2,0,10,466,1.6666666666666667,199.01395545265297,6
2020-08-24-170706,170706,3,0,13,469,3.6666666666666665,182.12334400437777,0
2020-08-25-170706,170706,6,1,16,475,4.833333333333333,186.47579469236814,1
2020-08-26-170706,170706,2,0,9,477,4.666666666666667,184.17027170329874,2
2020-08-27-170706,170706,2,0,5,479,4.166666666666667,193.68204810882213,3
2020-08-28-170706,170706,4,0,25,483,3.333333333333333,191.73153712938532,4
2020-08-29-170706,170706,1,0,4,484,1.5,161.86293041671695,5
2020-08-30-170706,170706,1,0,4,485,1.1666666666666667,148.80697938310934,6
2020-08-31-170706,170706,4,0,4,489,2.333333333333333,127.30334260770044,0
2020-09-01-170706,170706,6,0,14,495,3.6666666666666665,59.34555082389937,1
2020-09-02-170706,170706,25,0,11,520,4.166666666666667,231.89944302320248,2
2020-09-03-170706,170706,9,0,5,529,5.333333333333333,202.56828230403872,3
2020-09-04-170706,170706,18,0,12,547,3.1666666666666665,181.5239515583425,4
2020-09-05-170706,170706,11,0,5,558,2.6666666666666665,213.2538714681383,5
2020-09-06-170706,170706,10,0,8,568,2.1666666666666665,207.82338805227786,6
2020-09-07-170706,170706,13,0,9,581,5.5,237.49193620231193,0
2020-09-08-170706,170706,16,0,4,597,8.333333333333334,275.26136545295617,1
2020-09-09-170706,170706,9,0,3,606,5.666666666666668,310.2359549385474,2
2020-09-10-170706,170706,5,0,6,611,6.166666666666668,61.26224981125878,3
2020-09-11-170706,170706,25,0,4,636,7.0,78.64248253293549,4
2020-09-12-170706,170706,4,0,6,640,3.333333333333333,106.2598406900894,5
2020-09-13-170706,170706,4,0,0,644,2.333333333333333,115.82144978013449,6
2020-09-14-170706,170706,4,0,2,648,9.166666666666666,122.5027927122155,0
2020-09-15-170706,170706,14,0,5,662,6.166666666666668,155.53056634445278,1
2020-09-16-170706,170706,11,1,0,673,6.333333333333332,189.84308717349165,2
2020-09-17-170706,170706,5,0,1,678,8.166666666666666,196.07848468301438,3
2020-09-18-170706,170706,12,0,1,690,5.5,207.15004986918728,4
2020-09-19-170706,170706,5,2,1,695,5.833333333333332,219.50534213871816,5
2020-09-20-170706,170706,8,0,0,703,3.5,277.0129799979626,6
2020-09-21-170706,170706,9,0,0,712,8.666666666666666,263.6512995300176,0
2020-09-22-170706,170706,4,0,6,716,8.166666666666666,262.71822571697123,1
2020-09-23-170706,170706,3,0,1,719,11.666666666666664,260.9725067153055,2
2020-09-24-170706,170706,6,0,5,725,7.833333333333332,261.73489195509484,3
2020-09-25-170706,170706,4,1,6,729,11.5,250.82541222756228,4
2020-09-26-170706,170706,6,0,11,735,6.666666666666668,255.58808188699072,5
2020-09-27-170706,170706,0,0,3,735,2.833333333333333,222.01812102177445,6
2020-09-28-170706,170706,2,0,7,737,5.666666666666668,204.6614518929349,0
2020-09-29-170706,170706,5,1,4,742,5.666666666666668,188.97056744698546,1
2020-09-30-170706,170706,0,0,5,742,6.166666666666668,187.5465037734392,2
2020-10-01-170706,170706,1,1,10,743,6.666666666666668,0.0,3
2020-10-02-170706,170706,1,0,4,744,9.333333333333334,190.53946569557618,4
2020-10-03-170706,170706,1,0,3,745,3.333333333333333,285.0199653027129,5
2020-10-04-170706,170706,0,1,5,745,4.5,284.1582576173928,6
2020-10-05-170706,170706,0,1,2,745,4.166666666666667,252.00636664305034,0
2020-10-06-170706,170706,6,1,8,751,9.0,222.4826414792012,1
2020-10-07-170706,170706,1,1,2,752,4.333333333333333,213.94826175184073,2
2020-10-08-170706,170706,5,1,2,757,8.5,195.81721363931956,3
2020-10-09-170706,170706,6,1,7,763,4.5,215.27830843177486,4
2020-10-10-170706,170706,11,0,1,774,2.1666666666666665,22.095238285825616,5
2020-10-11-170706,170706,3,0,1,777,2.6666666666666665,56.91535514109651,6
2020-10-12-170706,170706,7,0,7,784,1.5,74.87715441865856,0
2020-10-13-170706,170706,4,0,3,788,5.166666666666667,94.79032293621006,1
2020-10-14-170706,170706,5,0,3,793,4.666666666666667,117.40053649876985,2
2020-10-15-170706,170706,10,0,4,803,4.5,142.33648252588716,3
2020-10-16-170706,170706,4,0,2,807,11.0,173.03627687564602,4
2020-10-17-170706,170706,3,0,7,810,5.166666666666667,174.4181678909594,5
2020-10-18-170706,170706,5,0,4,815,4.666666666666667,164.8985969717536,6
2020-10-19-170706,170706,2,0,1,817,7.5,169.9507286871367,0
2020-10-20-170706,170706,8,0,6,825,8.833333333333334,177.82935608077292,1
2020-10-21-170706,170706,2,0,2,827,5.833333333333332,195.93687724088363,2
2020-10-22-170706,170706,2,0,8,829,9.333333333333334,187.56299838058675,3
2020-10-23-170706,170706,7,0,3,836,7.5,191.373251647725,4
2020-10-24-170706,170706,1,0,1,837,10.666666666666666,209.32664285374216,5
2020-10-25-170706,170706,1,0,3,838,4.833333333333333,217.0507515106556,6
2020-10-26-170706,170706,7,0,4,845,7.166666666666668,211.15313930093185,0
2020-10-27-170706,170706,3,0,7,848,10.833333333333336,227.91853232783387,1
2020-10-28-170706,170706,3,0,2,851,12.0,232.14035530283482,2
2020-10-29-170706,170706,4,0,4,855,9.833333333333334,257.9209260106646,3
2020-10-30-170706,170706,2,2,9,857,11.833333333333336,255.3630782542046,4
2020-10-31-170706,170706,7,0,0,864,7.5,264.8151954301303,5
2020-11-01-170706,170706,4,0,0,868,4.833333333333333,213.99521836365113,6
2020-11-02-170706,170706,1,0,0,869,5.833333333333332,248.84926088448248,0
2020-11-03-170706,170706,6,0,0,875,7.833333333333332,201.46987672724046,1
2020-11-04-170706,170706,2,0,0,877,7.0,218.04244166722768,2
2020-11-05-170706,170706,8,1,0,885,11.5,220.40417370309393,3
2020-11-06-170706,170706,3,1,0,888,13.333333333333336,217.89434596768118,4
2020-11-07-170706,170706,1,0,0,889,5.5,232.44611958083874,5
2020-11-08-170706,170706,3,0,0,892,2.1666666666666665,231.45965436853433,6
2020-11-09-170706,170706,4,0,0,896,7.0,228.49054368830613,0
2020-11-10-170706,170706,7,0,0,903,10.0,206.0198816269442,1
2020-11-11-170706,170706,2,0,0,905,7.166666666666668,236.17082963274845,2
2020-11-12-170706,170706,4,0,0,909,5.833333333333332,248.67815410119147,3
2020-11-13-170706,170706,9,0,0,918,9.333333333333334,229.2924500801357,4
2020-03-01-170707,170707,0,0,1,0,0.0,0.0,6
2020-03-02-170707,170707,0,0,2,0,0.0,23.484517666946847,0
2020-03-03-170707,170707,0,0,1,0,0.0,83.32156070751536,1
2020-03-04-170707,170707,0,0,2,0,0.0,81.29142811195135,2
2020-03-05-170707,170707,0,1,1,0,0.0,77.3577962912579,3
2020-03-06-170707,170707,0,0,1,0,0.0,66.8766853946385,4
2020-03-07-170707,170707,0,0,0,0,0.0,61.35162797497546,5
2020-03-08-170707,170707,0,0,1,0,0.0,58.61269108939517,6
2020-03-09-170707,170707,0,0,3,0,0.0,57.87726574254084,0
2020-03-10-170707,170707,0,0,3,0,0.0,138.20412020961658,1
2020-03-11-170707,170707,0,0,2,0,0.25,114.66999393819601,2
2020-03-12-170707,170707,0,0,3,0,0.25,94.36122946381786,3
2020-03-13-170707,170707,0,0,3,0,0.25,70.33404442830201,4
2020-03-14-170707,170707,1,0,0,1,1.25,52.62738363050791,5
2020-03-15-170707,170707,1,0,0,2,1.5,38.80378007284182,6
2020-03-16-170707,170707,2,0,0,4,2.5,18.248042524732906,0
2020-03-17-170707,170707,1,0,0,5,4.0,36.80653470972527,1
2020-03-18-170707,170707,2,0,5,7,9.5,53.94894190507945,2
2020-03-19-170707,170707,1,0,1,8,8.25,105.12057430913748,3
2020-03-20-170707,170707,1,0,0,9,4.75,140.89946069609013,4
2020-03-21-170707,170707,0,0,3,9,3.5,156.4342338993477,5
2020-03-22-170707,170707,1,0,0,10,4.5,161.1025922375159,6
2020-03-23-170707,170707,3,0,0,13,10.25,163.64368620437403,0
2020-03-24-170707,170707,3,0,0,16,6.75,184.41256970939858,1
2020-03-25-170707,170707,2,0,0,18,6.5,173.5969563334376,2
2020-03-26-170707,170707,3,0,0,21,5.25,156.23637861604215,3
2020-03-27-170707,170707,3,0,2,24,4.5,184.27448322893704,4
2020-03-28-170707,170707,0,0,0,24,3.25,184.49859660092596,5
2020-03-29-170707,170707,0,0,2,24,2.5,185.58957543277,6
2020-03-30-170707,170707,0,0,0,24,4.0,137.6505138913169,0
2020-03-31-170707,170707,0,0,1,24,5.25,115.15016715502671,1
2020-04-01-170707,170707,5,0,2,29,6.5,19.985936960526033,2
2020-04-02-170707,170707,1,0,0,30,2.75,89.63463472041232,3
2020-04-03-170707,170707,0,0,4,30,1.5,71.87690164881587,4
2020-04-04-170707,170707,3,0,1,33,1.25,61.3317688989732,5
2020-04-05-170707,170707,0,0,0,33,1.5,72.11281939324799,6
2020-04-06-170707,170707,0,0,3,33,2.25,73.14263072874263,0
2020-04-07-170707,170707,0,0,2,33,2.25,51.86617713054397,1
2020-04-08-170707,170707,0,0,0,33,2.25,55.71770695907044,2
2020-04-09-170707,170707,0,0,2,33,1.25,59.18289921365803,3
2020-04-10-170707,170707,2,0,1,35,1.75,31.119898615487074,4
2020-04-11-170707,170707,0,0,0,35,0.75,40.767900048711454,5
2020-04-12-170707,170707,2,0,0,37,1.5,41.82150489894673,6
2020-04-13-170707,170707,0,0,1,37,5.5,48.754204328555964,0
2020-04-14-170707,170707,1,0,0,38,2.25,72.93936145713263,1
2020-04-15-170707,170707,2,0,0,40,0.75,82.12410742797783,2
2020-04-16-170707,170707,0,0,1,40,1.25,90.48382358995764,3
2020-04-17-170707,170707,4,0,0,44,5.5,65.90738902587407,4
2020-04-18-170707,170707,1,0,1,45,1.25,77.04312118470304,5
2020-04-19-170707,170707,0,0,0,45,1.25,90.65982546687646,6
2020-04-20-170707,170707,3,0,3,48,1.75,77.28173796561502,0
2020-04-21-170707,170707,2,0,1,50,0.75,82.63972379901708,1
2020-04-22-170707,170707,0,0,0,50,0.25,84.16509579784139,2
2020-04-23-170707,170707,2,0,2,52,1.25,84.70930893772578,3
2020-04-24-170707,170707,1,0,2,53,2.25,75.85794554535325,4
2020-04-25-170707,170707,0,0,0,53,0.0,71.32018848666135,5
2020-04-26-170707,170707,0,0,1,53,1.75,66.87315994561664,6
2020-04-27-170707,170707,1,0,0,54,6.0,58.21780330078716,0
2020-04-28-170707,170707,0,0,1,54,1.5,80.83209455546063,1
2020-04-29-170707,170707,0,0,0,54,1.75,74.20385662016236,2
2020-04-30-170707,170707,1,0,1,55,0.5,72.96060235877701,3
2020-05-01-170707,170707,0,0,0,55,1.5,64.30031603514539,4
2020-05-02-170707,170707,1,0,1,56,0.25,46.0782115982658,5
2020-05-03-170707,170707,0,0,0,56,0.25,55.39878098804026,6
2020-05-04-170707,170707,3,0,1,59,1.75,33.18650964449057,0
2020-05-05-170707,170707,1,0,3,60,0.0,32.9063466981771,1
2020-05-06-170707,170707,0,0,3,60,0.75,22.439160656360592,2
2020-05-07-170707,170707,2,0,1,62,0.5,24.318700169745945,3
2020-05-08-170707,170707,2,0,1,64,0.25,27.195806079971824,4
2020-05-09-170707,170707,0,0,4,64,0.25,36.04723300654262,5
2020-05-10-170707,170707,1,0,1,65,0.0,72.76744653233008,6
2020-05-11-170707,170707,0,1,1,65,0.5,62.09962213017213,0
2020-05-12-170707,170707,1,0,2,66,0.25,53.00581745944763,1
2020-05-13-170707,170707,0,0,1,66,2.0,47.73631705724172,2
2020-05-14-170707,170707,1,0,0,67,1.25,47.72305087068682,3
2020-05-15-170707,170707,0,0,1,67,0.25,47.55494600034619,4
2020-05-16-170707,170707,1,0,0,68,0.5,42.42597995395248,5
2020-05-17-170707,170707,0,1,0,68,0.25,44.62343398390762,6
2020-05-18-170707,170707,1,0,1,69,1.5,42.44023360444683,0
2020-05-19-170707,170707,3,0,0,72,1.5,47.557673473859694,1
2020-05-20-170707,170707,3,0,0,75,1.5,50.91988822226211,2
2020-05-21-170707,170707,1,0,0,76,0.75,51.5124980575946,3
2020-05-22-170707,170707,1,0,0,77,0.25,57.042122701915076,4
2020-05-23-170707,170707,4,0,0,81,0.5,57.559042638542515,5
2020-05-24-170707,170707,1,0,0,82,0.5,68.13429879987841,6
2020-05-25-170707,170707,1,0,0,83,1.0,70.01660542139462,0
2020-05-26-170707,170707,2,0,2,85,1.0,65.12085756268368,1
2020-05-27-170707,170707,1,3,0,86,1.25,76.6775190944532,2
2020-05-28-170707,170707,0,0,2,86,0.25,81.16303997773996,3
2020-05-29-170707,170707,1,0,1,87,0.75,77.14977460015452,4
2020-05-30-170707,170707,0,0,0,87,0.0,63.85958838860529,5
2020-05-31-170707,170707,0,0,0,87,0.25,56.57199170301335,6
2020-06-01-170707,170707,1,0,0,88,0.5,48.86746408572825,0
2020-06-02-170707,170707,0,0,0,88,1.0,31.974625013583513,1
2020-06-03-170707,170707,0,0,0,88,1.0,31.702794977809127,2
2020-06-04-170707,170707,0,0,0,88,0.75,29.298495592418718,3
2020-06-05-170707,170707,0,2,0,88,0.0,32.0011072886535,4
2020-06-06-170707,170707,0,0,0,88,0.25,30.2517956462089,5
2020-06-07-170707,170707,0,0,0,88,0.25,32.15633212251738,6
2020-06-08-170707,170707,0,0,0,88,0.0,32.188495012500006,0
2020-06-09-170707,170707,2,0,0,90,0.0,27.091370563330443,1
2020-06-10-170707,170707,0,0,1,90,0.0,52.25531406985066,2
2020-06-11-170707,170707,2,0,0,92,0.5,38.250602221537875,3
2020-06-12-170707,170707,1,0,0,93,0.25,43.78012987485991,4
2020-06-13-170707,170707,0,0,0,93,0.0,40.858060452903274,5
2020-06-14-170707,170707,0,0,0,93,0.5,30.91687561518437,6
2020-06-15-170707,170707,0,6,1,93,0.25,24.77214864183263,0
2020-06-16-170707,170707,0,0,1,93,0.25,23.550063534784407,1
2020-06-17-170707,170707,0,0,0,93,0.25,21.804138531850526,2
2020-06-18-170707,170707,0,0,0,93,0.25,24.14594776706918,3
2020-06-19-170707,170707,0,1,2,93,2.5,19.081378143724194,4
2020-06-20-170707,170707,0,0,1,93,0.0,36.2808069232739,5
2020-06-21-170707,170707,0,0,0,93,0.0,34.854930148359344,6
2020-06-22-170707,170707,0,0,0,93,0.5,32.7684267205228,0
2020-06-23-170707,170707,0,0,0,93,1.5,30.712473161930415,1
2020-06-24-170707,170707,1,0,0,94,0.25,37.32123497719174,2
2020-06-25-170707,170707,0,2,0,94,0.25,39.33223850051836,3
2020-06-26-170707,170707,0,0,0,94,0.25,26.732683940053896,4
2020-06-27-170707,170707,0,0,0,94,0.0,26.25219235164279,5
2020-06-28-170707,170707,0,0,0,94,0.25,28.91640086333014,6
2020-06-29-170707,170707,1,0,1,95,0.5,33.39011813990885,0
2020-06-30-170707,170707,1,0,0,96,0.5,34.72884871985832,1
2020-07-01-170707,170707,0,0,3,96,0.75,38.10633293337743,2
2020-07-02-170707,170707,0,0,1,96,0.75,28.27369684561377,3
2020-07-03-170707,170707,2,0,0,98,1.25,42.99890079497208,4
2020-07-04-170707,170707,1,0,0,99,0.0,65.75110687079449,5
2020-07-05-170707,170707,0,0,1,99,0.0,68.26698805317965,6
2020-07-06-170707,170707,0,0,0,99,0.0,66.20000325423683,0
2020-07-07-170707,170707,0,0,0,99,0.0,61.429229887057375,1
2020-07-08-170707,170707,0,0,0,99,0.25,50.25413316026451,2
2020-07-09-170707,170707,0,0,0,99,0.0,39.67074254994509,3
2020-07-10-170707,170707,0,0,0,99,1.0,26.523499118163684,4
2020-07-11-170707,170707,0,0,0,99,0.0,29.736272464722855,5
2020-07-12-170707,170707,0,0,0,99,0.25,28.707229513817303,6
2020-07-13-170707,170707,1,0,0,100,0.0,28.357860761095495,0
2020-07-14-170707,170707,0,0,0,100,0.75,30.300713822840216,1
2020-07-15-170707,170707,3,0,1,103,0.5,33.59813424148287,2
2020-07-16-170707,170707,1,0,0,104,0.5,33.10394416430269,3
2020-07-17-170707,170707,0,1,1,104,0.25,32.43792283750495,4
2020-07-18-170707,170707,0,0,0,104,0.25,26.11552055087725,5
2020-07-19-170707,170707,1,0,1,105,0.0,30.402738799443355,6
2020-07-20-170707,170707,0,0,1,105,0.75,24.048831900944244,0
2020-07-21-170707,170707,0,0,0,105,0.25,25.69474056413955,1
2020-07-22-170707,170707,0,0,0,105,0.5,23.144282522297498,2
2020-07-23-170707,170707,0,0,1,105,1.0,27.214412723623656,3
2020-07-24-170707,170707,0,0,0,105,1.75,26.709686136114215,4
2020-07-25-170707,170707,0,0,0,105,0.75,40.702878847599436,5
2020-07-26-170707,170707,0,0,0,105,0.25,41.90753033495904,6
2020-07-27-170707,170707,0,0,0,105,0.0,42.09718030567553,0
2020-07-28-170707,170707,0,0,1,105,0.75,35.74506867413348,1
2020-07-29-170707,170707,1,0,3,106,0.75,39.342084437145814,2
2020-07-30-170707,170707,0,0,7,106,1.75,56.95231458313467,3
2020-07-31-170707,170707,1,0,13,107,2.0,60.57015782685121,4
2020-08-01-170707,170707,0,0,0,107,1.5,23.91005737012378,5
2020-08-02-170707,170707,1,0,2,108,0.25,348.3206316928155,6
2020-08-03-170707,170707,1,0,0,109,1.5,299.8854423554178,0
2020-08-04-170707,170707,0,0,1,109,1.5,299.3249851197735,1
2020-08-05-170707,170707,0,0,0,109,3.5,270.9378363988717,2
2020-08-06-170707,170707,1,0,1,110,4.0,240.66049791912366,3
2020-08-07-170707,170707,0,0,0,110,2.5,233.72552512697882,4
2020-08-08-170707,170707,0,0,3,110,2.5,173.74717284115553,5
2020-08-09-170707,170707,0,0,4,110,4.25,169.83648801552326,6
2020-08-10-170707,170707,0,0,1,110,8.25,20.635424444523,0
2020-08-11-170707,170707,1,0,10,111,5.25,54.88161056390689,1
2020-08-12-170707,170707,3,0,1,114,4.5,89.32775572947091,2
2020-08-13-170707,170707,7,0,9,121,5.0,129.92276514280059,3
2020-08-14-170707,170707,13,0,4,134,3.75,193.09939718228367,4
2020-08-15-170707,170707,0,0,13,134,3.75,277.1869158765553,5
2020-08-16-170707,170707,2,0,14,136,1.5,306.322832031644,6
2020-08-17-170707,170707,0,0,1,136,10.0,329.8680719128773,0
2020-08-18-170707,170707,1,0,4,137,5.0,338.3745407457052,1
2020-08-19-170707,170707,0,0,2,137,5.75,360.09759135732304,2
2020-08-20-170707,170707,1,0,3,138,2.75,314.9585664349011,3
2020-08-21-170707,170707,0,0,7,138,2.75,255.78782832847472,4
2020-08-22-170707,170707,3,0,0,141,0.5,247.05827662513045,5
2020-08-23-170707,170707,4,0,2,145,1.0,237.95498839166612,6
2020-08-24-170707,170707,1,0,1,146,2.75,209.4251740943143,0
2020-08-25-170707,170707,10,0,10,156,1.5,196.37212448928796,1
2020-08-26-170707,170707,1,0,2,157,3.5,201.7877577286191,2
2020-08-27-170707,170707,9,0,3,166,3.0,229.86743864724107,3
2020-08-28-170707,170707,4,0,5,170,1.5,258.00233542412985,4
2020-08-29-170707,170707,13,1,1,183,1.5,270.7429960355459,5
2020-08-30-170707,170707,14,0,4,197,1.25,317.48711250374345,6
2020-08-31-170707,170707,1,0,6,198,1.0,354.2447923512418,0
2020-09-01-170707,170707,4,0,9,202,1.25,105.23664000676631,1
2020-09-02-170707,170707,2,0,11,204,0.25,262.2738966601905,2
2020-09-03-170707,170707,3,0,8,207,2.75,203.7346100853475,3
2020-09-04-170707,170707,7,0,8,214,2.0,206.9099515172586,4
2020-09-05-170707,170707,0,0,3,214,0.75,172.88173183127668,5
2020-09-06-170707,170707,2,0,4,216,0.5,160.20723262687324,6
2020-09-07-170707,170707,1,0,3,217,1.75,165.8721869010822,0
2020-09-08-170707,170707,10,0,3,227,2.0,148.60046261842598,1
2020-09-09-170707,170707,2,0,8,229,1.25,188.02238229204497,2
2020-09-10-170707,170707,3,0,4,232,6.0,100.27297594620293,3
2020-09-11-170707,170707,5,0,14,237,6.25,123.67288066123544,4
2020-09-12-170707,170707,1,0,0,238,1.25,146.51153055022283,5
2020-09-13-170707,170707,4,0,0,242,2.75,142.1290533533089,6
2020-09-14-170707,170707,6,0,6,248,1.75,161.74103040350647,0
2020-09-15-170707,170707,9,0,1,257,2.75,193.26218994103664,1
2020-09-16-170707,170707,11,0,5,268,1.5,229.20944876222873,2
2020-09-17-170707,170707,8,0,10,276,2.0,245.6631687011146,3
2020-09-18-170707,170707,8,0,21,284,2.25,250.13143132415473,4
2020-09-19-170707,170707,3,0,11,287,1.5,233.9382629151162,5
2020-09-20-170707,170707,4,0,11,291,2.5,210.6093867499364,6
2020-09-21-170707,170707,3,0,7,294,3.25,183.23758783387441,0
2020-09-22-170707,170707,3,0,4,297,3.25,155.88029038866733,1
2020-09-23-170707,170707,8,0,3,305,1.0,139.09230251844932,2
2020-09-24-170707,170707,4,0,20,309,1.75,127.6946371166296,3
2020-09-25-170707,170707,14,0,7,323,2.75,130.91882588209194,4
2020-09-26-170707,170707,0,0,3,323,1.5,180.65582207139283,5
2020-09-27-170707,170707,0,0,7,323,1.0,182.2644925050639,6
2020-09-28-170707,170707,6,1,5,329,1.25,171.6950398369453,0
2020-09-29-170707,170707,1,0,12,330,0.25,192.89751674539076,1
2020-09-30-170707,170707,5,0,5,335,1.0,175.57048066080597,2
2020-10-01-170707,170707,10,0,6,345,1.25,0.0,3
2020-10-02-170707,170707,21,1,11,366,0.75,237.0271766447242,4
2020-10-03-170707,170707,11,0,3,377,0.75,210.26594967763845,5
2020-10-04-170707,170707,11,0,4,388,1.5,237.63534493753474,6
2020-10-05-170707,170707,7,1,4,395,0.75,244.9905534297367,0
2020-10-06-170707,170707,4,0,2,399,1.25,255.04128153031644,1
2020-10-07-170707,170707,3,0,1,402,1.25,254.98198135460086,2
2020-10-08-170707,170707,20,1,2,422,3.75,214.56906667107057,3
2020-10-09-170707,170707,7,0,3,429,2.0,278.9034976605204,4
2020-10-10-170707,170707,3,0,1,432,2.25,34.327207848804754,5
2020-10-11-170707,170707,7,0,0,439,3.0,57.33701351740539,6
2020-10-12-170707,170707,5,0,5,444,2.0,99.06570966798888,0
2020-10-13-170707,170707,12,0,4,456,1.25,128.81156483123158,1
2020-10-14-170707,170707,5,0,2,461,1.25,185.59631682570026,2
2020-10-15-170707,170707,6,0,5,467,1.5,215.30398838711568,3
2020-10-16-170707,170707,11,0,2,478,1.75,247.14119367265758,4
2020-10-17-170707,170707,3,1,2,481,1.25,261.8513737959437,5
2020-10-18-170707,170707,4,0,2,485,3.0,263.39534538632313,6
2020-10-19-170707,170707,4,1,1,489,2.75,243.60695667249587,0
2020-10-20-170707,170707,2,1,3,491,1.0,252.4046105755168,1
2020-10-21-170707,170707,1,0,2,492,3.75,239.7232092142101,2
2020-10-22-170707,170707,2,0,3,494,3.75,248.5984551135306,3
2020-10-23-170707,170707,3,0,5,497,3.5,223.9420457030134,4
2020-10-24-170707,170707,1,0,0,498,3.25,214.18073607221046,5
2020-10-25-170707,170707,0,1,1,498,2.5,211.65007897174658,6
2020-10-26-170707,170707,5,0,1,503,2.5,197.82721144044166,0
2020-10-27-170707,170707,4,0,4,507,1.5,164.67730107619388,1
2020-10-28-170707,170707,2,0,0,509,4.5,171.5536606937784,2
2020-10-29-170707,170707,5,0,0,514,5.0,170.9313206323235,3
2020-10-30-170707,170707,2,1,1,516,6.75,218.8804668204811,4
2020-10-31-170707,170707,2,0,0,518,5.0,210.3489226365369,5
2020-11-01-170707,170707,2,0,0,520,1.75,286.4467105794887,6
2020-11-02-170707,170707,1,0,0,521,6.25,98.18351457810039,0
2020-11-03-170707,170707,3,2,0,524,5.75,99.546455357498,1
2020-11-04-170707,170707,2,0,0,526,3.5,126.74569775529429,2
2020-11-05-170707,170707,3,1,0,529,3.0,127.94709542725363,3
2020-11-06-170707,170707,5,0,0,534,5.5,132.50899409310023,4
2020-11-07-170707,170707,0,2,0,534,5.0,146.5088323681319,5
2020-11-08-170707,170707,1,0,0,535,2.75,146.68568773452125,6
2020-11-09-170707,170707,1,0,0,536,5.25,138.65515700873723,0
2020-11-10-170707,170707,4,1,0,540,1.25,234.9190794430445,1
2020-11-11-170707,170707,0,0,0,540,4.5,215.7204180276736,2
2020-11-12-170707,170707,0,2,0,540,5.25,206.08704717672913,3
2020-11-13-170707,170707,1,0,0,541,1.75,192.0153195134733,4
2020-03-01-170708,170708,0,0,3,0,0.0,0.0,6
2020-03-02-170708,170708,2,0,37,2,0.3333333333333333,41.09566463995911,0
2020-03-03-170708,170708,1,0,36,3,0.3333333333333333,203.07976833498304,1
2020-03-04-170708,170708,0,0,43,3,1.0,227.10812110314603,2
2020-03-05-170708,170708,1,0,49,4,0.0,240.68189530443266,3
2020-03-06-170708,170708,0,0,45,4,0.3333333333333333,210.7342666134465,4
2020-03-07-170708,170708,0,0,39,4,0.6666666666666666,229.82893629891672,5
2020-03-08-170708,170708,0,0,19,4,0.0,223.47787428150667,6
2020-03-09-170708,170708,0,0,66,4,1.3333333333333333,226.46932558500689,0
2020-03-10-170708,170708,2,0,67,6,2.6666666666666665,152.90286595516307,1
2020-03-11-170708,170708,2,0,45,8,2.0,127.4639243989013,2
2020-03-12-170708,170708,1,0,53,9,3.0,98.6208486863454,3
2020-03-13-170708,170708,3,0,30,12,5.0,69.2209285521075,4
2020-03-14-170708,170708,2,0,15,14,4.333333333333333,72.53278138748149,5
2020-03-15-170708,170708,3,0,15,17,3.333333333333333,78.0162255876545,6
2020-03-16-170708,170708,37,0,58,54,23.33333333333333,54.697160992495085,0
2020-03-17-170708,170708,36,0,32,90,21.33333333333333,111.02083779594969,1
2020-03-18-170708,170708,43,0,25,133,26.0,150.45578022698788,2
2020-03-19-170708,170708,49,0,26,182,35.0,190.8262041880758,3
2020-03-20-170708,170708,45,1,17,227,38.0,219.69815789114406,4
2020-03-21-170708,170708,39,0,9,266,14.333333333333336,242.96091393213783,5
2020-03-22-170708,170708,19,0,12,285,20.666666666666668,244.1137452659118,6
2020-03-23-170708,170708,66,0,25,351,51.66666666666666,241.48807395081442,0
2020-03-24-170708,170708,67,0,9,418,49.33333333333334,279.3885790184813,1
2020-03-25-170708,170708,45,1,31,463,41.66666666666666,297.50699355409097,2
2020-03-26-170708,170708,53,0,18,516,43.0,308.7811131454286,3
2020-03-27-170708,170708,30,0,22,546,39.333333333333336,360.17970373561985,4
2020-03-28-170708,170708,15,0,0,561,11.666666666666664,365.91043455395146,5
2020-03-29-170708,170708,15,0,8,576,13.0,359.43892539754825,6
2020-03-30-170708,170708,58,0,25,634,34.0,266.6507942836897,0
2020-03-31-170708,170708,32,0,7,666,23.66666666666667,259.6829847869408,1
2020-04-01-170708,170708,25,0,11,691,27.0,37.172281673269374,2
2020-04-02-170708,170708,26,0,8,717,33.333333333333336,175.1492352773607,3
2020-04-03-170708,170708,17,0,10,734,23.0,81.37936386551104,4
2020-04-04-170708,170708,9,0,2,743,14.333333333333336,110.59577026232841,5
2020-04-05-170708,170708,12,0,3,755,6.0,135.5576996936469,6
2020-04-06-170708,170708,25,0,4,780,28.0,144.78461307714696,0
2020-04-07-170708,170708,9,0,9,789,19.33333333333333,178.2647069270739,1
2020-04-08-170708,170708,31,0,9,820,12.666666666666664,187.1472493840766,2
2020-04-09-170708,170708,18,0,6,838,6.333333333333332,187.82322278821783,3
2020-04-10-170708,170708,22,0,4,860,10.0,42.155714751624956,4
2020-04-11-170708,170708,0,0,4,860,4.666666666666667,56.30255214548477,5
2020-04-12-170708,170708,8,0,3,868,8.666666666666666,63.38016038619595,6
2020-04-13-170708,170708,25,0,11,893,17.333333333333332,76.45091781092194,0
2020-04-14-170708,170708,7,0,15,900,15.333333333333336,113.49661392751392,1
2020-04-15-170708,170708,11,0,12,911,16.666666666666668,139.6267543837106,2
2020-04-16-170708,170708,8,0,5,919,9.0,164.77253178625605,3
2020-04-17-170708,170708,10,0,5,929,5.333333333333333,144.43790050844825,4
2020-04-18-170708,170708,2,0,1,931,17.333333333333332,141.87721523851695,5
2020-04-19-170708,170708,3,0,6,934,9.0,173.7969390788474,6
2020-04-20-170708,170708,4,1,13,938,8.0,205.29686090901149,0
2020-04-21-170708,170708,9,0,19,947,7.333333333333332,191.86569746975087,1
2020-04-22-170708,170708,9,0,12,956,15.666666666666664,175.9508464136262,2
2020-04-23-170708,170708,6,0,15,962,3.6666666666666665,197.77461392604727,3
2020-04-24-170708,170708,4,0,12,966,11.333333333333336,185.27815222899198,4
2020-04-25-170708,170708,4,0,4,970,3.6666666666666665,171.40943391958987,5
2020-04-26-170708,170708,3,0,2,973,2.333333333333333,153.56764290562222,6
2020-04-27-170708,170708,11,0,12,984,7.666666666666668,94.98924744517511,0
2020-04-28-170708,170708,15,0,11,999,12.0,94.86351296317261,1
2020-04-29-170708,170708,12,0,16,1011,11.0,99.68880349949654,2
2020-04-30-170708,170708,5,0,12,1016,14.666666666666664,113.41416061646935,3
2020-05-01-170708,170708,5,0,12,1021,2.0,177.19245635590048,4
2020-05-02-170708,170708,1,0,5,1022,3.6666666666666665,111.94405786425018,5
2020-05-03-170708,170708,6,0,5,1028,0.6666666666666666,93.2149967171272,6
2020-05-04-170708,170708,13,0,11,1041,8.0,63.6067778702628,0
2020-05-05-170708,170708,19,0,11,1060,13.0,53.83259242513132,1
2020-05-06-170708,170708,12,0,17,1072,7.0,55.72222471674192,2
2020-05-07-170708,170708,15,0,16,1087,10.666666666666666,57.12055588860255,3
2020-05-08-170708,170708,12,0,12,1099,13.0,69.5122967708745,4
2020-05-09-170708,170708,4,0,9,1103,5.333333333333333,92.79589427484488,5
2020-05-10-170708,170708,2,0,4,1105,13.333333333333336,182.31968438680292,6
2020-05-11-170708,170708,12,1,9,1117,16.333333333333332,157.60808752846322,0
2020-05-12-170708,170708,11,0,14,1128,12.333333333333336,170.91319713100825,1
2020-05-13-170708,170708,16,0,11,1144,11.666666666666664,132.94544377275975,2
2020-05-14-170708,170708,12,0,16,1156,12.0,125.1988422659668,3
2020-05-15-170708,170708,12,1,6,1168,12.666666666666664,119.97040549199029,4
2020-05-16-170708,170708,5,0,0,1173,5.0,134.20465963538078,5
2020-05-17-170708,170708,5,0,0,1178,8.0,141.6820236964835,6
2020-05-18-170708,170708,11,0,3,1189,10.666666666666666,143.72767947383232,0
2020-05-19-170708,170708,11,0,6,1200,13.333333333333336,141.1230203078619,1
2020-05-20-170708,170708,17,0,5,1217,18.0,126.53857131269851,2
2020-05-21-170708,170708,16,0,2,1233,13.333333333333336,137.62240008079928,3
2020-05-22-170708,170708,12,0,5,1245,11.333333333333336,138.43211364158196,4
2020-05-23-170708,170708,9,0,2,1254,7.0,155.0108695193694,5
2020-05-24-170708,170708,4,0,1,1258,3.6666666666666665,152.66476374573864,6
2020-05-25-170708,170708,9,0,8,1267,11.0,134.32018040729935,0
2020-05-26-170708,170708,14,0,8,1281,12.333333333333336,140.94599620605615,1
2020-05-27-170708,170708,11,0,1,1292,15.333333333333336,169.75670121338214,2
2020-05-28-170708,170708,16,0,7,1308,5.666666666666668,167.36620832385373,3
2020-05-29-170708,170708,6,1,5,1314,6.333333333333332,158.4348335195935,4
2020-05-30-170708,170708,0,0,0,1314,1.0,133.92402937195462,5
2020-05-31-170708,170708,0,0,1,1314,0.3333333333333333,126.97866555367052,6
2020-06-01-170708,170708,3,0,3,1317,7.666666666666668,136.94772523642894,0
2020-06-02-170708,170708,6,0,6,1323,6.666666666666668,59.68018078693265,1
2020-06-03-170708,170708,5,0,7,1328,3.333333333333333,41.8612767731015,2
2020-06-04-170708,170708,2,0,6,1330,3.0,37.02875798431409,3
2020-06-05-170708,170708,5,2,8,1335,3.0,32.61247164301983,4
2020-06-06-170708,170708,2,0,1,1337,0.6666666666666666,28.050193364334287,5
2020-06-07-170708,170708,1,0,0,1338,2.0,28.446964424744834,6
2020-06-08-170708,170708,8,0,5,1346,5.666666666666668,31.93757518703085,0
2020-06-09-170708,170708,8,1,10,1354,5.0,47.217286363405684,1
2020-06-10-170708,170708,1,0,2,1355,4.0,158.70085089810854,2
2020-06-11-170708,170708,7,0,5,1362,3.333333333333333,152.23028515880674,3
2020-06-12-170708,170708,5,0,10,1367,6.333333333333332,127.97479463803228,4
2020-06-13-170708,170708,0,0,0,1367,1.0,123.46367634458589,5
2020-06-14-170708,170708,1,2,0,1368,1.0,93.16332966700806,6
2020-06-15-170708,170708,3,0,0,1371,5.666666666666668,65.13358608975217,0
2020-06-16-170708,170708,6,0,2,1377,5.666666666666668,63.89036953040015,1
2020-06-17-170708,170708,7,0,0,1384,6.0,65.2782274857993,2
2020-06-18-170708,170708,6,1,6,1390,2.6666666666666665,73.11860789298672,3
2020-06-19-170708,170708,8,0,2,1398,3.333333333333333,70.78376654915972,4
2020-06-20-170708,170708,1,0,2,1399,0.6666666666666666,81.81912023494598,5
2020-06-21-170708,170708,0,0,1,1399,0.6666666666666666,84.05881510509731,6
2020-06-22-170708,170708,5,0,5,1404,4.0,72.307651808083,0
2020-06-23-170708,170708,10,0,4,1414,5.333333333333333,66.22285355126036,1
2020-06-24-170708,170708,2,2,4,1416,4.0,64.42462685479681,2
2020-06-25-170708,170708,5,1,4,1421,3.333333333333333,66.77532158623029,3
2020-06-26-170708,170708,10,0,4,1431,3.6666666666666665,67.39750116139714,4
2020-06-27-170708,170708,0,0,0,1431,1.0,62.45437741113578,5
2020-06-28-170708,170708,0,0,3,1431,0.0,61.42639233362029,6
2020-06-29-170708,170708,0,0,6,1431,1.0,59.100290104669,0
2020-06-30-170708,170708,2,0,2,1433,1.6666666666666667,47.195415738048176,1
2020-07-01-170708,170708,0,0,6,1433,1.6666666666666667,55.288132714345615,2
2020-07-02-170708,170708,6,0,2,1439,2.333333333333333,46.94333660857768,3
2020-07-03-170708,170708,2,0,2,1441,2.6666666666666665,41.84178253264118,4
2020-07-04-170708,170708,2,0,0,1443,1.3333333333333333,39.29661051156199,5
2020-07-05-170708,170708,1,0,1,1444,0.3333333333333333,41.44250873477829,6
2020-07-06-170708,170708,5,0,1,1449,3.333333333333333,35.63405735801305,0
2020-07-07-170708,170708,4,0,7,1453,0.6666666666666666,33.36425035910318,1
2020-07-08-170708,170708,4,1,1,1457,1.0,30.469729422616787,2
2020-07-09-170708,170708,4,0,2,1461,3.0,27.058111433594416,3
2020-07-10-170708,170708,4,0,0,1465,3.0,55.57528037480975,4
2020-07-11-170708,170708,0,0,2,1465,2.0,57.15842074761253,5
2020-07-12-170708,170708,3,0,1,1468,0.3333333333333333,55.39111018252669,6
2020-07-13-170708,170708,6,0,0,1474,1.3333333333333333,54.27817983716779,0
2020-07-14-170708,170708,2,0,1,1476,0.6666666666666666,56.50704161854639,1
2020-07-15-170708,170708,6,0,1,1482,4.0,40.45275832974227,2
2020-07-16-170708,170708,2,0,1,1484,5.0,38.23670131018514,3
2020-07-17-170708,170708,2,0,4,1486,3.333333333333333,46.55685000291456,4
2020-07-18-170708,170708,0,0,0,1486,0.3333333333333333,48.195748840731724,5
2020-07-19-170708,170708,1,0,3,1487,1.0,47.28580007885931,6
2020-07-20-170708,170708,1,0,1,1488,1.3333333333333333,51.3871173510695,0
2020-07-21-170708,170708,7,0,3,1495,3.333333333333333,54.48564852446347,1
2020-07-22-170708,170708,1,0,1,1496,3.6666666666666665,49.044427929126044,2
2020-07-23-170708,170708,2,0,3,1498,2.0,50.614096553639094,3
2020-07-24-170708,170708,0,0,2,1498,2.333333333333333,50.4535969774859,4
2020-07-25-170708,170708,2,0,2,1500,1.0,54.89538049328854,5
2020-07-26-170708,170708,1,0,2,1501,0.6666666666666666,53.722954011115476,6
2020-07-27-170708,170708,0,0,1,1501,2.333333333333333,47.14993310752803,0
2020-07-28-170708,170708,1,0,2,1502,1.6666666666666667,48.80598630234053,1
2020-07-29-170708,170708,1,0,4,1503,2.0,50.77481774717788,2
2020-07-30-170708,170708,1,0,5,1504,2.6666666666666665,39.92710937623922,3
2020-07-31-170708,170708,4,0,6,1508,2.6666666666666665,39.3542147354122,4
2020-08-01-170708,170708,0,0,1,1508,0.6666666666666666,29.566957839112817,5
2020-08-02-170708,170708,3,0,1,1511,1.3333333333333333,89.16104459707611,6
2020-08-03-170708,170708,1,0,2,1512,4.0,104.71030005031925,0
2020-08-04-170708,170708,3,0,4,1515,1.3333333333333333,93.41804399755384,1
2020-08-05-170708,170708,1,0,11,1516,4.333333333333333,81.89785183970538,2
2020-08-06-170708,170708,3,0,13,1519,2.333333333333333,76.90542967579363,3
2020-08-07-170708,170708,2,0,6,1521,4.333333333333333,77.84274163534707,4
2020-08-08-170708,170708,2,0,4,1523,0.6666666666666666,78.91150986601548,5
2020-08-09-170708,170708,2,0,1,1525,1.6666666666666667,74.49238508939484,6
2020-08-10-170708,170708,1,0,6,1526,2.6666666666666665,28.126231473683596,0
2020-08-11-170708,170708,2,0,8,1528,4.0,32.27690712094626,1
2020-08-12-170708,170708,4,0,2,1532,6.666666666666668,46.019846737662945,2
2020-08-13-170708,170708,5,0,3,1537,4.0,49.999262187557164,3
2020-08-14-170708,170708,6,0,9,1543,2.333333333333333,67.07544018106992,4
2020-08-15-170708,170708,1,0,3,1544,1.3333333333333333,74.42770953814022,5
2020-08-16-170708,170708,1,0,1,1545,1.0,68.86582750997398,6
2020-08-17-170708,170708,2,0,2,1547,7.666666666666668,69.91595262598395,0
2020-08-18-170708,170708,4,0,8,1551,5.666666666666668,85.97864787407353,1
2020-08-19-170708,170708,11,0,11,1562,3.0,83.95320669713625,2
2020-08-20-170708,170708,13,0,7,1575,6.666666666666668,73.90714428640729,3
2020-08-21-170708,170708,6,0,9,1581,8.0,76.77426552060169,4
2020-08-22-170708,170708,4,0,9,1585,5.333333333333333,91.8703484042852,5
2020-08-23-170708,170708,1,0,2,1586,2.0,105.4604682127844,6
2020-08-24-170708,170708,6,0,8,1592,7.333333333333332,84.71652782185697,0
2020-08-25-170708,170708,8,0,8,1600,9.333333333333334,91.47432922141681,1
2020-08-26-170708,170708,2,0,7,1602,5.0,103.35389985854438,2
2020-08-27-170708,170708,3,0,6,1605,7.0,111.22398778767054,3
2020-08-28-170708,170708,9,0,8,1614,5.0,117.61289625483575,4
2020-08-29-170708,170708,3,0,6,1617,6.333333333333332,108.94324420688591,5
2020-08-30-170708,170708,1,0,2,1618,1.6666666666666667,105.61721419528786,6
2020-08-31-170708,170708,2,0,20,1620,7.0,93.94548881096944,0
2020-09-01-170708,170708,8,0,15,1628,2.0,74.62823341002255,1
2020-09-02-170708,170708,11,0,12,1639,5.0,137.43176108526924,2
2020-09-03-170708,170708,7,0,19,1646,6.0,152.31852251827212,3
2020-09-04-170708,170708,9,0,5,1655,7.666666666666668,145.8080414501138,4
2020-09-05-170708,170708,9,0,9,1664,1.3333333333333333,119.92362391637121,5
2020-09-06-170708,170708,2,0,4,1666,2.0,118.3413105936161,6
2020-09-07-170708,170708,8,0,10,1674,8.0,114.22553479386059,0
2020-09-08-170708,170708,8,0,10,1682,8.666666666666666,106.3234068878786,1
2020-09-09-170708,170708,7,0,10,1689,8.0,124.00336840742004,2
2020-09-10-170708,170708,6,0,9,1695,6.666666666666668,63.50477089132815,3
2020-09-11-170708,170708,8,0,23,1703,5.333333333333333,75.25562523528384,4
2020-09-12-170708,170708,6,0,1,1709,5.333333333333333,73.84714715740287,5
2020-09-13-170708,170708,2,0,0,1711,0.3333333333333333,77.94395138020917,6
2020-09-14-170708,170708,20,0,3,1731,15.0,67.69955152730385,0
2020-09-15-170708,170708,15,0,8,1746,7.0,112.60067927752652,1
2020-09-16-170708,170708,12,0,6,1758,9.0,122.36609846602784,2
2020-09-17-170708,170708,19,0,3,1777,10.0,128.3145639076616,3
2020-09-18-170708,170708,5,0,4,1782,10.666666666666666,144.4998087770284,4
2020-09-19-170708,170708,9,1,2,1791,4.666666666666667,153.65800042303817,5
2020-09-20-170708,170708,4,2,6,1795,7.333333333333332,157.0002507878046,6
2020-09-21-170708,170708,10,0,4,1805,16.666666666666668,124.26500668110458,0
2020-09-22-170708,170708,10,2,5,1815,7.666666666666668,140.9675879365721,1
2020-09-23-170708,170708,10,0,3,1825,9.0,144.10423756852464,2
2020-09-24-170708,170708,9,0,4,1834,11.333333333333336,138.39395964572762,3
2020-09-25-170708,170708,23,1,6,1857,13.333333333333336,139.5477297260445,4
2020-09-26-170708,170708,1,0,1,1858,2.0,173.27436959935102,5
2020-09-27-170708,170708,0,0,3,1858,2.0,173.13549296556778,6
2020-09-28-170708,170708,3,0,0,1861,11.333333333333336,169.79359369610654,0
2020-09-29-170708,170708,8,0,5,1869,4.666666666666667,173.89792915107472,1
2020-09-30-170708,170708,6,0,2,1875,6.666666666666668,166.87258202535682,2
2020-10-01-170708,170708,3,0,7,1878,9.0,0.0,3
2020-10-02-170708,170708,4,0,10,1882,8.333333333333334,170.18931519863702,4
2020-10-03-170708,170708,2,0,6,1884,4.0,151.7046176036157,5
2020-10-04-170708,170708,6,0,9,1890,1.0,148.72361896864942,6
2020-10-05-170708,170708,4,0,6,1894,7.333333333333332,145.08334590048105,0
2020-10-06-170708,170708,5,0,5,1899,5.0,124.49720447761595,1
2020-10-07-170708,170708,3,1,12,1902,9.333333333333334,123.64709835511029,2
2020-10-08-170708,170708,4,1,6,1906,5.333333333333333,118.72184874381142,3
2020-10-09-170708,170708,6,1,9,1912,8.0,126.9804711193804,4
2020-10-10-170708,170708,1,0,0,1913,3.6666666666666665,15.540696094832956,5
2020-10-11-170708,170708,3,0,5,1916,3.6666666666666665,23.85692759390777,6
2020-10-12-170708,170708,0,0,3,1916,3.0,38.01419688883226,0
2020-10-13-170708,170708,5,0,8,1921,7.333333333333332,46.06294470524983,1
2020-10-14-170708,170708,2,0,13,1923,8.0,65.34788323278407,2
2020-10-15-170708,170708,7,0,9,1930,12.666666666666664,83.61334637190637,3
2020-10-16-170708,170708,10,0,2,1940,11.0,115.38947508390996,4
2020-10-17-170708,170708,6,0,6,1946,9.0,137.65700374257148,5
2020-10-18-170708,170708,9,0,5,1955,3.6666666666666665,143.5619872329078,6
2020-10-19-170708,170708,6,0,7,1961,10.666666666666666,142.37233883544278,0
2020-10-20-170708,170708,5,0,11,1966,5.333333333333333,172.09825647625382,1
2020-10-21-170708,170708,12,0,10,1978,8.0,168.97593319098985,2
2020-10-22-170708,170708,6,0,8,1984,16.0,158.33229035678383,3
2020-10-23-170708,170708,9,0,3,1993,13.333333333333336,173.3967319840852,4
2020-10-24-170708,170708,0,0,2,1993,4.333333333333333,185.29275946561467,5
2020-10-25-170708,170708,5,0,1,1998,3.6666666666666665,180.0948090261662,6
2020-10-26-170708,170708,3,1,6,2001,1.6666666666666667,166.71057206328908,0
2020-10-27-170708,170708,8,0,7,2009,13.0,139.88186444742868,1
2020-10-28-170708,170708,13,1,3,2022,7.666666666666668,154.17219286513267,2
2020-10-29-170708,170708,9,0,4,2031,10.333333333333334,152.09828052827316,3
2020-10-30-170708,170708,2,0,7,2033,11.333333333333336,115.43487002656515,4
2020-10-31-170708,170708,6,1,0,2039,5.0,122.56629848346924,5
2020-11-01-170708,170708,5,1,0,2044,4.0,105.07998113063482,6
2020-11-02-170708,170708,7,0,0,2051,7.333333333333332,137.36785374398346,0
2020-11-03-170708,170708,11,0,0,2062,8.666666666666666,116.22508993671475,1
2020-11-04-170708,170708,10,0,0,2072,7.666666666666668,124.70908425020511,2
2020-11-05-170708,170708,8,2,0,2080,11.0,124.46179798642498,3
2020-11-06-170708,170708,3,2,0,2083,11.666666666666664,135.40726159142775,4
2020-11-07-170708,170708,2,0,0,2085,2.333333333333333,148.4969380176463,5
2020-11-08-170708,170708,1,0,0,2086,1.6666666666666667,127.59365676853412,6
2020-11-09-170708,170708,6,0,0,2092,10.0,116.23471782926941,0
2020-11-10-170708,170708,7,1,0,2099,4.333333333333333,100.36109233784894,1
2020-11-11-170708,170708,3,1,0,2102,7.0,104.06774382098638,2
2020-11-12-170708,170708,4,1,0,2106,10.666666666666666,107.54389612694962,3
2020-11-13-170708,170708,7,1,0,2113,12.333333333333336,99.14005411270048,4
2020-03-01-170709,170709,0,0,6,0,0.0,0.0,6
2020-03-02-170709,170709,0,1,39,0,1.0,89.987709366714,0
2020-03-03-170709,170709,1,1,29,1,0.3333333333333333,445.57669548844433,1
2020-03-04-170709,170709,2,0,33,3,0.3333333333333333,507.40722610889696,2
2020-03-05-170709,170709,0,0,39,3,0.3333333333333333,539.2864006492501,3
2020-03-06-170709,170709,0,1,51,3,0.3333333333333333,475.623631056676,4
2020-03-07-170709,170709,1,0,24,4,0.3333333333333333,521.7326229826652,5
2020-03-08-170709,170709,0,0,13,4,0.0,504.27516190932636,6
2020-03-09-170709,170709,3,0,59,7,0.3333333333333333,506.2699850318009,0
2020-03-10-170709,170709,7,0,71,14,1.0,329.6210723411611,1
2020-03-11-170709,170709,4,0,49,18,1.3333333333333333,271.26160923346697,2
2020-03-12-170709,170709,1,0,52,19,3.0,207.51555466970137,3
2020-03-13-170709,170709,11,0,41,30,2.333333333333333,144.92484462493383,4
2020-03-14-170709,170709,9,0,14,39,2.0,151.28810834828874,5
2020-03-15-170709,170709,6,0,17,45,2.333333333333333,165.36348825285103,6
2020-03-16-170709,170709,39,0,23,84,22.66666666666667,120.19905872417127,0
2020-03-17-170709,170709,29,0,27,113,23.66666666666667,241.69963331736096,1
2020-03-18-170709,170709,33,0,25,146,29.33333333333333,335.3813706578313,2
2020-03-19-170709,170709,39,0,15,185,38.333333333333336,432.2575389632247,3
2020-03-20-170709,170709,51,2,22,236,36.0,497.15719170527484,4
2020-03-21-170709,170709,24,0,12,260,19.33333333333333,562.4897311999341,5
2020-03-22-170709,170709,13,0,2,273,22.66666666666667,574.6055491059398,6
2020-03-23-170709,170709,59,0,30,332,54.0,569.7602864166176,0
2020-03-24-170709,170709,71,0,25,403,48.0,674.816946541433,1
2020-03-25-170709,170709,49,0,11,452,40.333333333333336,715.3140628852793,2
2020-03-26-170709,170709,52,0,6,504,43.33333333333334,743.187263560748,3
2020-03-27-170709,170709,41,0,9,545,35.666666666666664,880.3065146733954,4
2020-03-28-170709,170709,14,0,3,559,12.0,896.1312200424089,5
2020-03-29-170709,170709,17,0,8,576,12.333333333333336,868.8186060381884,6
2020-03-30-170709,170709,23,0,8,599,45.66666666666666,649.1709203357157,0
2020-03-31-170709,170709,27,0,10,626,25.33333333333333,640.7364189812162,1
2020-04-01-170709,170709,25,0,11,651,27.0,91.28037171108973,2
2020-04-02-170709,170709,15,0,9,666,37.0,449.12912550484356,3
2020-04-03-170709,170709,22,0,7,688,21.33333333333333,212.74532915370742,4
2020-04-04-170709,170709,12,0,4,700,13.333333333333336,279.11189441170916,5
2020-04-05-170709,170709,2,0,2,702,9.333333333333334,345.0488930553976,6
2020-04-06-170709,170709,30,0,6,732,26.33333333333333,366.1673868842884,0
2020-04-07-170709,170709,25,0,9,757,14.0,445.5357192843032,1
2020-04-08-170709,170709,11,0,8,768,19.33333333333333,460.17635212573737,2
2020-04-09-170709,170709,6,0,5,774,10.333333333333334,456.74903336141597,3
2020-04-10-170709,170709,9,0,7,783,14.333333333333336,101.70384704359047,4
2020-04-11-170709,170709,3,0,6,786,3.6666666666666665,136.263483824511,5
2020-04-12-170709,170709,8,0,1,794,8.666666666666666,154.2345007097539,6
2020-04-13-170709,170709,8,0,5,802,23.0,185.6923355958035,0
2020-04-14-170709,170709,10,0,9,812,14.333333333333336,276.6662020932011,1
2020-04-15-170709,170709,11,0,5,823,16.666666666666668,342.25135444880647,2
2020-04-16-170709,170709,9,0,14,832,8.666666666666666,406.2753168648841,3
2020-04-17-170709,170709,7,0,1,839,6.333333333333332,356.4818970907623,4
2020-04-18-170709,170709,4,0,3,843,16.666666666666668,355.5397246616947,5
2020-04-19-170709,170709,2,0,1,845,9.333333333333334,434.832932068167,6
2020-04-20-170709,170709,6,0,9,851,7.333333333333332,515.2889345155323,0
2020-04-21-170709,170709,9,0,12,860,7.333333333333332,487.3054808101822,1
2020-04-22-170709,170709,8,0,6,868,16.0,445.7013020835298,2
2020-04-23-170709,170709,5,0,8,873,4.0,505.9447233143371,3
2020-04-24-170709,170709,7,0,13,880,10.333333333333334,482.49935095045623,4
2020-04-25-170709,170709,6,0,5,886,3.0,442.7607903481951,5
2020-04-26-170709,170709,1,0,8,887,3.0,394.00397853112014,6
2020-04-27-170709,170709,5,0,12,892,9.666666666666666,245.8168065400005,0
2020-04-28-170709,170709,9,0,16,901,14.0,247.92390193145292,1
2020-04-29-170709,170709,5,0,14,906,13.333333333333336,257.45131968525646,2
2020-04-30-170709,170709,14,0,15,920,11.666666666666664,290.19304257793823,3
2020-05-01-170709,170709,1,0,11,921,3.333333333333333,439.56930209189443,4
2020-05-02-170709,170709,3,0,4,924,3.0,271.2490731399227,5
2020-05-03-170709,170709,1,0,15,925,2.333333333333333,221.44856923579252,6
2020-05-04-170709,170709,9,0,5,934,9.333333333333334,148.93019636785226,0
2020-05-05-170709,170709,12,0,12,946,15.333333333333336,123.87585188934341,1
2020-05-06-170709,170709,6,0,21,952,9.0,130.12605688142835,2
2020-05-07-170709,170709,8,0,14,960,13.0,133.85623718133394,3
2020-05-08-170709,170709,13,0,8,973,12.666666666666664,165.5743656960595,4
2020-05-09-170709,170709,5,5,9,978,5.0,221.3102547420276,5
2020-05-10-170709,170709,8,0,3,986,11.333333333333336,447.8208159440935,6
2020-05-11-170709,170709,12,0,12,998,16.333333333333332,379.50499233399086,0
2020-05-12-170709,170709,16,0,13,1014,10.666666666666666,405.381441620519,1
2020-05-13-170709,170709,14,0,21,1028,12.333333333333336,308.9364752285912,2
2020-05-14-170709,170709,15,1,3,1043,11.0,291.50416372898417,3
2020-05-15-170709,170709,11,0,8,1054,13.0,279.07931436021823,4
2020-05-16-170709,170709,4,0,1,1058,5.333333333333333,309.2507637631283,5
2020-05-17-170709,170709,15,0,0,1073,4.666666666666667,327.3056472847344,6
2020-05-18-170709,170709,5,0,8,1078,12.666666666666664,335.4767537428856,0
2020-05-19-170709,170709,12,0,8,1090,13.0,334.477339117618,1
2020-05-20-170709,170709,21,0,3,1111,16.666666666666668,294.6059737043097,2
2020-05-21-170709,170709,14,1,4,1125,14.0,319.10862930914993,3
2020-05-22-170709,170709,8,0,6,1133,12.666666666666664,319.81754794249457,4
2020-05-23-170709,170709,9,0,0,1142,7.0,359.174960821428,5
2020-05-24-170709,170709,3,0,3,1145,4.0,351.4656780966675,6
2020-05-25-170709,170709,12,0,4,1157,10.0,310.3661078716092,0
2020-05-26-170709,170709,13,0,1,1170,12.666666666666664,321.26907580276963,1
2020-05-27-170709,170709,21,0,5,1191,12.0,388.101485826999,2
2020-05-28-170709,170709,3,2,3,1194,10.0,379.0779576250185,3
2020-05-29-170709,170709,8,0,8,1202,5.666666666666668,352.91531849527547,4
2020-05-30-170709,170709,1,0,0,1203,0.6666666666666666,294.52062288551355,5
2020-05-31-170709,170709,0,0,1,1203,0.3333333333333333,277.63030685747515,6
2020-06-01-170709,170709,8,0,9,1211,6.0,301.87680995197803,0
2020-06-02-170709,170709,8,0,3,1219,6.0,133.71599871301527,1
2020-06-03-170709,170709,3,0,4,1222,4.0,94.14327520161996,2
2020-06-04-170709,170709,4,0,3,1226,2.333333333333333,84.69504634489144,3
2020-06-05-170709,170709,6,1,6,1232,2.6666666666666665,73.18876482115917,4
2020-06-06-170709,170709,0,0,0,1232,1.3333333333333333,62.20312001001274,5
2020-06-07-170709,170709,3,0,1,1235,1.3333333333333333,63.57703431049627,6
2020-06-08-170709,170709,4,0,2,1239,7.0,69.6067973345391,0
2020-06-09-170709,170709,1,0,7,1240,7.333333333333332,102.42039671512165,1
2020-06-10-170709,170709,5,0,3,1245,2.6666666666666665,338.91727976986317,2
2020-06-11-170709,170709,3,0,3,1248,4.666666666666667,320.9301092343042,3
2020-06-12-170709,170709,8,0,3,1256,5.333333333333333,267.66501923722296,4
2020-06-13-170709,170709,0,0,0,1256,1.0,258.51949064603855,5
2020-06-14-170709,170709,1,0,0,1257,1.0,192.17550391907878,6
2020-06-15-170709,170709,9,0,2,1266,3.6666666666666665,135.95015059482537,0
2020-06-16-170709,170709,3,0,0,1269,6.666666666666668,133.72151088651066,1
2020-06-17-170709,170709,4,0,3,1273,7.0,139.13359303109544,2
2020-06-18-170709,170709,3,0,3,1276,3.6666666666666665,158.66645023622317,3
2020-06-19-170709,170709,6,0,3,1282,4.0,153.77234172185672,4
2020-06-20-170709,170709,0,0,3,1282,1.0,176.79169811792164,5
2020-06-21-170709,170709,1,0,0,1283,0.3333333333333333,181.58670824741324,6
2020-06-22-170709,170709,2,0,7,1285,5.0,156.92816259422878,0
2020-06-23-170709,170709,7,1,1,1292,6.333333333333332,142.92650527021206,1
2020-06-24-170709,170709,3,0,2,1295,3.6666666666666665,137.23810472721706,2
2020-06-25-170709,170709,3,0,1,1298,4.0,140.54509536484042,3
2020-06-26-170709,170709,3,0,4,1301,6.0,142.40102446495973,4
2020-06-27-170709,170709,0,0,3,1301,1.0,133.50217056279223,5
2020-06-28-170709,170709,0,0,0,1301,0.0,131.52364859136912,6
2020-06-29-170709,170709,2,0,3,1303,0.3333333333333333,127.3072866636817,0
2020-06-30-170709,170709,0,0,0,1303,2.333333333333333,103.74675113938936,1
2020-07-01-170709,170709,3,0,2,1306,0.6666666666666666,116.2268170474789,2
2020-07-02-170709,170709,3,0,5,1309,3.333333333333333,96.81027710525173,3
2020-07-03-170709,170709,3,0,4,1312,2.333333333333333,85.6549256714334,4
2020-07-04-170709,170709,3,0,0,1315,1.0,76.62181848583238,5
2020-07-05-170709,170709,0,0,1,1315,0.6666666666666666,77.94284850774096,6
2020-07-06-170709,170709,7,0,1,1322,2.6666666666666665,65.1822735035529,0
2020-07-07-170709,170709,1,0,2,1323,1.6666666666666667,58.52269621797296,1
2020-07-08-170709,170709,2,0,2,1325,1.6666666666666667,52.40142070526608,2
2020-07-09-170709,170709,1,0,2,1326,4.0,46.27201176516019,3
2020-07-10-170709,170709,4,0,3,1330,3.0,92.6653214152582,4
2020-07-11-170709,170709,3,0,1,1333,1.0,93.00524905537893,5
2020-07-12-170709,170709,0,0,1,1333,1.3333333333333333,89.19145866962327,6
2020-07-13-170709,170709,3,0,3,1336,2.333333333333333,85.99181147432317,0
2020-07-14-170709,170709,0,0,0,1336,1.3333333333333333,88.65431278985972,1
2020-07-15-170709,170709,2,0,4,1338,5.333333333333333,62.73458318373878,2
2020-07-16-170709,170709,5,0,2,1343,4.0,58.83051851691697,3
2020-07-17-170709,170709,4,0,2,1347,2.6666666666666665,71.49178217657867,4
2020-07-18-170709,170709,0,0,1,1347,0.3333333333333333,73.17366749151894,5
2020-07-19-170709,170709,1,0,1,1348,1.0,72.51792982430595,6
2020-07-20-170709,170709,1,0,4,1349,1.3333333333333333,79.6624053309693,0
2020-07-21-170709,170709,2,1,1,1351,5.0,85.20330288961424,1
2020-07-22-170709,170709,2,0,3,1353,3.333333333333333,77.50006675819903,2
2020-07-23-170709,170709,2,0,1,1355,2.0,78.40727002775608,3
2020-07-24-170709,170709,3,0,6,1358,1.3333333333333333,79.63810241704226,4
2020-07-25-170709,170709,1,0,1,1359,1.3333333333333333,86.93493981713654,5
2020-07-26-170709,170709,1,0,1,1360,0.6666666666666666,85.30789721579639,6
2020-07-27-170709,170709,3,0,5,1363,1.3333333333333333,74.96666710727952,0
2020-07-28-170709,170709,0,0,0,1363,2.0,76.52817572923794,1
2020-07-29-170709,170709,4,0,7,1367,1.0,80.06308098944751,2
2020-07-30-170709,170709,2,0,2,1369,2.333333333333333,63.07471700631976,3
2020-07-31-170709,170709,2,1,2,1371,3.333333333333333,62.01194089723774,4
2020-08-01-170709,170709,1,0,3,1372,0.3333333333333333,46.82430602502696,5
2020-08-02-170709,170709,1,0,1,1373,2.0,143.83209813320474,6
2020-08-03-170709,170709,4,0,4,1377,3.0,164.33238127009525,0
2020-08-04-170709,170709,1,0,5,1378,2.0,144.9308497748596,1
2020-08-05-170709,170709,3,0,5,1381,3.6666666666666665,126.82654439305296,2
2020-08-06-170709,170709,1,0,14,1382,3.0,121.98814970156276,3
2020-08-07-170709,170709,6,0,10,1388,3.0,121.78104623434326,4
2020-08-08-170709,170709,1,0,6,1389,1.0,124.30518568203235,5
2020-08-09-170709,170709,1,0,0,1390,2.0,117.87057705207796,6
2020-08-10-170709,170709,5,0,5,1395,1.3333333333333333,43.711743538805074,0
2020-08-11-170709,170709,0,0,6,1395,4.666666666666667,49.97907455002677,1
2020-08-12-170709,170709,7,0,6,1402,5.666666666666668,71.69510345208795,2
2020-08-13-170709,170709,2,0,3,1404,5.0,76.85340000224195,3
2020-08-14-170709,170709,2,0,5,1406,3.6666666666666665,103.72683313058226,4
2020-08-15-170709,170709,3,0,10,1409,0.6666666666666666,116.34132324081837,5
2020-08-16-170709,170709,1,0,1,1410,1.0,108.34192516903276,6
2020-08-17-170709,170709,4,0,3,1414,7.0,110.73261602458204,0
2020-08-18-170709,170709,5,0,2,1419,5.333333333333333,135.57926371031976,1
2020-08-19-170709,170709,5,0,6,1424,5.0,130.70378677275852,2
2020-08-20-170709,170709,14,0,5,1438,6.333333333333332,115.07983922483142,3
2020-08-21-170709,170709,10,0,7,1448,6.666666666666668,118.03096693078106,4
2020-08-22-170709,170709,6,0,2,1454,4.666666666666667,137.4419470805688,5
2020-08-23-170709,170709,0,0,2,1454,2.333333333333333,160.00272868844718,6
2020-08-24-170709,170709,5,0,3,1459,7.666666666666668,129.94435215182187,0
2020-08-25-170709,170709,6,0,10,1465,10.0,138.86665598109593,1
2020-08-26-170709,170709,6,0,4,1471,3.6666666666666665,157.494913083963,2
2020-08-27-170709,170709,3,0,11,1474,7.0,171.80896037934653,3
2020-08-28-170709,170709,5,0,3,1479,6.333333333333332,179.46281485348004,4
2020-08-29-170709,170709,10,0,8,1489,4.0,169.2648670824288,5
2020-08-30-170709,170709,1,0,1,1490,1.6666666666666667,159.39200147129014,6
2020-08-31-170709,170709,3,0,10,1493,6.666666666666668,140.53979991972443,0
2020-09-01-170709,170709,2,0,6,1495,4.0,121.39067833563485,1
2020-09-02-170709,170709,6,0,7,1501,6.666666666666668,213.97247677311879,2
2020-09-03-170709,170709,5,1,6,1506,6.666666666666668,245.7516125625986,3
2020-09-04-170709,170709,7,0,9,1513,8.333333333333334,244.6244560782075,4
2020-09-05-170709,170709,2,0,4,1515,3.6666666666666665,201.74802519709294,5
2020-09-06-170709,170709,2,0,3,1517,2.0,200.90354614496005,6
2020-09-07-170709,170709,3,0,11,1520,9.666666666666666,194.54566300628764,0
2020-09-08-170709,170709,10,0,6,1530,8.0,180.19430439524382,1
2020-09-09-170709,170709,4,0,11,1534,9.0,204.5055771897956,2
2020-09-10-170709,170709,11,0,11,1545,5.0,109.92963657041714,3
2020-09-11-170709,170709,3,0,12,1548,7.0,125.84215298743436,4
2020-09-12-170709,170709,8,0,2,1556,4.666666666666667,123.63265747239225,5
2020-09-13-170709,170709,1,0,1,1557,0.6666666666666666,131.06460962680404,6
2020-09-14-170709,170709,10,0,13,1567,18.33333333333333,116.28158833354345,0
2020-09-15-170709,170709,6,0,4,1573,10.0,187.65506966302365,1
2020-09-16-170709,170709,7,0,6,1580,10.666666666666666,202.42424346465424,2
2020-09-17-170709,170709,6,0,7,1586,14.333333333333336,206.86378476335003,3
2020-09-18-170709,170709,9,1,9,1595,9.333333333333334,232.44344066825823,4
2020-09-19-170709,170709,4,0,6,1599,6.333333333333332,247.62815296512775,5
2020-09-20-170709,170709,3,0,0,1602,7.666666666666668,252.69375197887246,6
2020-09-21-170709,170709,11,0,5,1613,16.333333333333332,199.17366862741667,0
2020-09-22-170709,170709,6,1,2,1619,9.0,223.83672777608342,1
2020-09-23-170709,170709,11,1,4,1630,8.666666666666666,230.5510547962037,2
2020-09-24-170709,170709,11,0,4,1641,10.666666666666666,223.41698786517458,3
2020-09-25-170709,170709,12,0,7,1653,17.0,229.9247285620389,4
2020-09-26-170709,170709,2,0,6,1655,1.6666666666666667,287.89708124664287,5
2020-09-27-170709,170709,1,0,5,1656,1.6666666666666667,289.55661734814,6
2020-09-28-170709,170709,13,0,5,1669,8.0,283.3611336745665,0
2020-09-29-170709,170709,4,0,9,1673,6.0,288.2327114250776,1
2020-09-30-170709,170709,6,0,11,1679,6.666666666666668,278.592177627084,2
2020-10-01-170709,170709,7,0,8,1686,7.666666666666668,0.0,3
2020-10-02-170709,170709,9,0,8,1695,6.666666666666668,277.0171363450478,4
2020-10-03-170709,170709,6,0,12,1701,2.6666666666666665,250.19274549572714,5
2020-10-04-170709,170709,0,0,4,1701,3.0,245.92709270496172,6
2020-10-05-170709,170709,5,1,11,1706,7.0,243.91267733923337,0
2020-10-06-170709,170709,2,0,5,1708,6.0,214.64974586820938,1
2020-10-07-170709,170709,4,0,5,1712,9.0,214.0117089082811,2
2020-10-08-170709,170709,4,2,9,1716,5.333333333333333,206.8845003711054,3
2020-10-09-170709,170709,7,1,20,1723,7.666666666666668,226.15655020186682,4
2020-10-10-170709,170709,6,0,8,1729,2.0,26.789575366021836,5
2020-10-11-170709,170709,5,0,0,1734,3.0,39.11320041521522,6
2020-10-12-170709,170709,5,0,1,1739,1.3333333333333333,62.52900882085649,0
2020-10-13-170709,170709,9,0,7,1748,6.0,75.22835308762353,1
2020-10-14-170709,170709,11,0,8,1759,5.0,107.13387671177597,2
2020-10-15-170709,170709,8,0,9,1767,12.333333333333336,135.95377089188332,3
2020-10-16-170709,170709,8,0,6,1775,11.666666666666664,188.2066334708521,4
2020-10-17-170709,170709,12,0,8,1787,7.0,230.10384275448536,5
2020-10-18-170709,170709,4,1,4,1791,5.333333333333333,238.80024916393864,6
2020-10-19-170709,170709,11,0,10,1802,9.0,239.64681277652357,0
2020-10-20-170709,170709,5,0,6,1807,5.333333333333333,288.0246468381153,1
2020-10-21-170709,170709,5,0,7,1812,10.333333333333334,284.9563483994392,2
2020-10-22-170709,170709,9,0,8,1821,15.0,269.27050157566777,3
2020-10-23-170709,170709,20,0,15,1841,9.666666666666666,295.4025819637229,4
2020-10-24-170709,170709,8,1,5,1849,1.6666666666666667,318.8894412396577,5
2020-10-25-170709,170709,0,1,3,1849,5.333333333333333,312.63857209545,6
2020-10-26-170709,170709,1,1,9,1850,2.333333333333333,292.85450957676557,0
2020-10-27-170709,170709,7,0,3,1857,13.333333333333336,252.8321902752601,1
2020-10-28-170709,170709,8,0,10,1865,9.333333333333334,279.30858525015736,2
2020-10-29-170709,170709,9,0,11,1874,10.333333333333334,275.7851004690812,3
2020-10-30-170709,170709,6,0,14,1880,10.0,209.94244207520902,4
2020-10-31-170709,170709,8,1,0,1888,4.333333333333333,219.34208378701572,5
2020-11-01-170709,170709,4,0,0,1892,4.333333333333333,189.48142901940065,6
2020-11-02-170709,170709,10,0,0,1902,6.333333333333332,244.76462495232371,0
2020-11-03-170709,170709,6,0,0,1908,10.333333333333334,205.20822875628818,1
2020-11-04-170709,170709,7,0,0,1915,8.666666666666666,223.82123425749523,2
2020-11-05-170709,170709,8,0,0,1923,11.0,223.40440978429604,3
2020-11-06-170709,170709,15,0,0,1938,7.666666666666668,247.12642331731905,4
2020-11-07-170709,170709,5,1,0,1943,1.3333333333333333,275.30013841096604,5
2020-11-08-170709,170709,3,0,0,1946,1.0,238.03755079492902,6
2020-11-09-170709,170709,9,0,0,1955,9.0,218.31580415495824,0
2020-11-10-170709,170709,3,0,0,1958,5.666666666666668,190.40950331027804,1
2020-11-11-170709,170709,10,0,0,1968,4.666666666666667,194.02318318856283,2
2020-11-12-170709,170709,11,0,0,1979,8.333333333333334,199.5916496762939,3
2020-11-13-170709,170709,14,0,0,1993,10.0,179.87336238060084,4
2020-03-01-170710,170710,0,0,0,0,0.0,0.0,6
2020-03-02-170710,170710,1,0,11,1,0.6666666666666666,77.88830221994485,0
2020-03-03-170710,170710,0,0,12,1,0.6666666666666666,356.46818852946916,1
2020-03-04-170710,170710,1,0,22,2,0.6666666666666666,395.00114956681455,2
2020-03-05-170710,170710,0,0,33,2,0.3333333333333333,415.33360366421755,3
2020-03-06-170710,170710,0,0,39,2,0.3333333333333333,367.90130765497963,4
2020-03-07-170710,170710,0,0,10,2,0.6666666666666666,405.21289977954063,5
2020-03-08-170710,170710,0,1,22,2,0.0,396.6322185425455,6
2020-03-09-170710,170710,0,0,45,2,1.3333333333333333,397.31180696580316,0
2020-03-10-170710,170710,1,0,42,3,3.0,270.6921033013248,1
2020-03-11-170710,170710,1,1,34,4,2.333333333333333,224.11738845959297,2
2020-03-12-170710,170710,4,0,40,8,2.0,173.49426045375577,3
2020-03-13-170710,170710,2,0,35,10,5.333333333333333,120.67101834507403,4
2020-03-14-170710,170710,1,0,15,11,4.666666666666667,124.45242005341066,5
2020-03-15-170710,170710,0,0,10,11,4.333333333333333,131.52242982968477,6
2020-03-16-170710,170710,11,0,40,22,32.0,92.69805865968473,0
2020-03-17-170710,170710,12,0,23,34,29.33333333333333,189.8997813621093,1
2020-03-18-170710,170710,22,0,28,56,33.0,257.8022753574173,2
2020-03-19-170710,170710,33,0,26,89,40.333333333333336,327.3961737630193,3
2020-03-20-170710,170710,39,0,23,128,40.0,374.2156194323495,4
2020-03-21-170710,170710,10,0,3,138,24.0,411.04190005835903,5
2020-03-22-170710,170710,22,0,6,160,19.666666666666668,420.16429160310685,6
2020-03-23-170710,170710,45,0,13,205,58.66666666666666,411.92327080365783,0
2020-03-24-170710,170710,42,0,18,247,57.66666666666666,483.10787424886576,1
2020-03-25-170710,170710,34,0,13,281,45.33333333333334,518.7889103216162,2
2020-03-26-170710,170710,40,0,7,321,47.33333333333334,536.8696489579858,3
2020-03-27-170710,170710,35,0,7,356,37.66666666666666,625.1582869217679,4
2020-03-28-170710,170710,15,0,6,371,11.666666666666664,640.3744434384042,5
2020-03-29-170710,170710,10,0,7,381,14.666666666666664,622.4800017260579,6
2020-03-30-170710,170710,40,0,7,421,40.0,464.6622503987526,0
2020-03-31-170710,170710,23,0,13,444,26.66666666666667,453.9702955835877,1
2020-04-01-170710,170710,28,0,13,472,26.0,65.01963809595719,2
2020-04-02-170710,170710,26,0,8,498,33.333333333333336,311.04393226158516,3
2020-04-03-170710,170710,23,0,5,521,21.0,144.1261824918024,4
2020-04-04-170710,170710,3,0,9,524,16.333333333333332,192.63702595874076,5
2020-04-05-170710,170710,6,0,1,530,8.0,237.17348550161637,6
2020-04-06-170710,170710,13,0,6,543,32.0,255.30558254422948,0
2020-04-07-170710,170710,18,0,4,561,16.333333333333332,314.4992187365665,1
2020-04-08-170710,170710,13,0,5,574,18.666666666666668,327.4397386580645,2
2020-04-09-170710,170710,7,0,2,581,10.0,327.7752816710593,3
2020-04-10-170710,170710,7,0,8,588,15.0,73.60425898625732,4
2020-04-11-170710,170710,6,0,3,594,2.6666666666666665,99.66280463838402,5
2020-04-12-170710,170710,7,0,4,601,9.0,112.69876797543037,6
2020-04-13-170710,170710,7,0,6,608,23.33333333333333,135.1214922668717,0
2020-04-14-170710,170710,13,0,17,621,13.333333333333336,199.69839164073161,1
2020-04-15-170710,170710,13,0,12,634,16.0,246.46751912457677,2
2020-04-16-170710,170710,8,0,9,642,9.0,290.88125349446585,3
2020-04-17-170710,170710,5,0,1,647,7.0,253.53041237418984,4
2020-04-18-170710,170710,9,0,8,656,15.0,250.64176625634707,5
2020-04-19-170710,170710,1,0,1,657,9.666666666666666,305.14631293413635,6
2020-04-20-170710,170710,6,1,9,663,7.333333333333332,360.78791115049233,0
2020-04-21-170710,170710,4,0,14,667,9.0,340.67581333493996,1
2020-04-22-170710,170710,5,0,8,672,17.0,310.36033970251304,2
2020-04-23-170710,170710,2,0,10,674,5.0,350.9940599896544,3
2020-04-24-170710,170710,8,0,15,682,10.0,328.83520333582993,4
2020-04-25-170710,170710,3,0,3,685,4.0,301.4665327919024,5
2020-04-26-170710,170710,4,0,27,689,2.0,270.3153579960891,6
2020-04-27-170710,170710,6,0,22,695,9.333333333333334,166.08735826553982,0
2020-04-28-170710,170710,17,0,8,712,11.333333333333336,165.77401258536688,1
2020-04-29-170710,170710,12,0,10,724,11.0,173.90172345860776,2
2020-04-30-170710,170710,9,0,10,733,13.333333333333336,196.13939057758716,3
2020-05-01-170710,170710,1,0,11,734,3.333333333333333,310.4287847456645,4
2020-05-02-170710,170710,8,0,4,742,1.3333333333333333,193.29648929170418,5
2020-05-03-170710,170710,1,0,1,743,2.333333333333333,161.26235008741568,6
2020-05-04-170710,170710,9,0,11,752,9.333333333333334,110.3271879185881,0
2020-05-05-170710,170710,14,0,14,766,14.666666666666664,93.37119198555513,1
2020-05-06-170710,170710,8,0,17,774,8.333333333333334,97.58423425737162,2
2020-05-07-170710,170710,10,0,12,784,12.333333333333336,100.6905986182226,3
2020-05-08-170710,170710,15,0,11,799,12.0,123.46669029410481,4
2020-05-09-170710,170710,3,0,8,802,5.666666666666668,167.02586788135486,5
2020-05-10-170710,170710,27,1,2,829,5.0,332.8941649858379,6
2020-05-11-170710,170710,22,0,6,851,13.0,285.5115988891388,0
2020-05-12-170710,170710,8,0,9,859,13.333333333333336,307.69336921696373,1
2020-05-13-170710,170710,10,0,14,869,13.666666666666664,238.6346198380329,2
2020-05-14-170710,170710,10,0,7,879,12.666666666666664,226.37622853535464,3
2020-05-15-170710,170710,11,0,6,890,13.0,214.57829309048202,4
2020-05-16-170710,170710,4,0,2,894,5.333333333333333,236.2278050783356,5
2020-05-17-170710,170710,1,0,1,895,9.333333333333334,247.5389413464081,6
2020-05-18-170710,170710,11,0,11,906,10.666666666666666,252.0629681105299,0
2020-05-19-170710,170710,14,0,7,920,12.333333333333336,247.7208148053819,1
2020-05-20-170710,170710,17,0,2,937,18.0,219.73386230771825,2
2020-05-21-170710,170710,12,0,4,949,14.666666666666664,237.38586299768315,3
2020-05-22-170710,170710,11,0,1,960,11.666666666666664,241.56856157508042,4
2020-05-23-170710,170710,8,0,1,968,7.333333333333332,270.0361053274614,5
2020-05-24-170710,170710,2,0,2,970,4.333333333333333,268.1171775297587,6
2020-05-25-170710,170710,6,0,6,976,12.0,236.69188911688485,0
2020-05-26-170710,170710,9,0,8,985,14.0,247.3772686719148,1
2020-05-27-170710,170710,14,0,5,999,14.333333333333336,295.72368195178717,2
2020-05-28-170710,170710,7,0,3,1006,8.666666666666666,293.4993757118889,3
2020-05-29-170710,170710,6,1,5,1012,6.333333333333332,275.74837091838094,4
2020-05-30-170710,170710,2,0,3,1014,0.3333333333333333,233.89561979524922,5
2020-05-31-170710,170710,1,0,2,1015,0.0,220.23006025605713,6
2020-06-01-170710,170710,11,0,2,1026,5.0,238.64747386434567,0
2020-06-02-170710,170710,7,0,8,1033,6.333333333333332,104.83555133181558,1
2020-06-03-170710,170710,2,0,8,1035,4.333333333333333,73.59623984017712,2
2020-06-04-170710,170710,4,0,2,1039,2.333333333333333,65.4020283533531,3
2020-06-05-170710,170710,1,0,1,1040,4.333333333333333,56.91398126139504,4
2020-06-06-170710,170710,1,0,0,1041,1.0,49.11446559784203,5
2020-06-07-170710,170710,2,0,0,1043,1.6666666666666667,49.76889753248545,6
2020-06-08-170710,170710,6,0,6,1049,6.333333333333332,55.04734350787927,0
2020-06-09-170710,170710,8,0,5,1057,5.0,80.77757920917435,1
2020-06-10-170710,170710,5,0,8,1062,2.6666666666666665,269.98663654074585,2
2020-06-11-170710,170710,3,0,3,1065,4.666666666666667,258.58356937417693,3
2020-06-12-170710,170710,5,0,4,1070,6.333333333333332,218.66267482471758,4
2020-06-13-170710,170710,3,0,2,1073,0.0,210.8534401392131,5
2020-06-14-170710,170710,2,1,0,1075,0.6666666666666666,160.03945654292446,6
2020-06-15-170710,170710,2,0,1,1077,6.0,113.09619897888346,0
2020-06-16-170710,170710,8,0,4,1085,5.0,113.56881633586195,1
2020-06-17-170710,170710,8,0,1,1093,5.666666666666668,116.96450263564424,2
2020-06-18-170710,170710,2,0,1,1095,4.0,132.49726357178565,3
2020-06-19-170710,170710,1,0,3,1096,5.666666666666668,128.87459503733177,4
2020-06-20-170710,170710,0,0,0,1096,1.0,149.11402115410496,5
2020-06-21-170710,170710,0,0,1,1096,0.6666666666666666,153.76321956792304,6
2020-06-22-170710,170710,6,0,1,1102,3.6666666666666665,131.8505222240974,0
2020-06-23-170710,170710,5,0,0,1107,7.0,119.7928045472194,1
2020-06-24-170710,170710,8,0,1,1115,2.0,116.90853862856397,2
2020-06-25-170710,170710,3,1,4,1118,4.0,118.0973340118965,3
2020-06-26-170710,170710,4,0,2,1122,5.666666666666668,118.24603998330618,4
2020-06-27-170710,170710,2,0,2,1124,0.3333333333333333,111.61744298694036,5
2020-06-28-170710,170710,0,0,0,1124,0.0,110.50438733592287,6
2020-06-29-170710,170710,1,0,0,1125,0.6666666666666666,107.00804421055847,0
2020-06-30-170710,170710,4,0,1,1129,1.0,86.0968302733657,1
2020-07-01-170710,170710,1,0,3,1130,1.3333333333333333,102.84451518871774,2
2020-07-02-170710,170710,1,0,5,1131,4.0,89.56030269495542,3
2020-07-03-170710,170710,3,0,2,1134,2.333333333333333,80.0071391924923,4
2020-07-04-170710,170710,0,0,0,1134,2.0,74.544378811108,5
2020-07-05-170710,170710,1,0,0,1135,0.3333333333333333,78.57636136993024,6
2020-07-06-170710,170710,1,0,2,1136,4.666666666666667,67.27197879993199,0
2020-07-07-170710,170710,0,0,5,1136,2.0,63.06675031420885,1
2020-07-08-170710,170710,1,1,3,1137,2.0,57.867707579862234,2
2020-07-09-170710,170710,4,0,0,1141,3.0,51.479300359071836,3
2020-07-10-170710,170710,2,0,2,1143,3.6666666666666665,101.96131146558177,4
2020-07-11-170710,170710,2,0,1,1145,1.3333333333333333,106.06455205044918,5
2020-07-12-170710,170710,0,0,1,1145,1.3333333333333333,102.09924326393947,6
2020-07-13-170710,170710,0,0,1,1145,3.333333333333333,100.6370601567382,0
2020-07-14-170710,170710,1,0,0,1146,1.0,105.39379465757324,1
2020-07-15-170710,170710,3,0,1,1149,5.0,75.33975853263016,2
2020-07-16-170710,170710,5,0,3,1154,4.0,72.1138379083255,3
2020-07-17-170710,170710,2,0,3,1156,3.333333333333333,87.04516294772668,4
2020-07-18-170710,170710,0,0,0,1156,0.3333333333333333,89.64104404741533,5
2020-07-19-170710,170710,0,0,0,1156,1.3333333333333333,87.97200732909724,6
2020-07-20-170710,170710,2,0,6,1158,1.0,95.31703281478433,0
2020-07-21-170710,170710,5,0,1,1163,4.0,101.50640922166122,1
2020-07-22-170710,170710,3,0,3,1166,3.0,90.86842905382613,2
2020-07-23-170710,170710,0,0,0,1166,2.6666666666666665,94.43130863360142,3
2020-07-24-170710,170710,2,0,3,1168,1.6666666666666667,93.76729375484507,4
2020-07-25-170710,170710,1,0,1,1169,1.3333333333333333,101.99506824639431,5
2020-07-26-170710,170710,1,0,3,1170,0.6666666666666666,99.71423531231275,6
2020-07-27-170710,170710,1,0,2,1171,2.0,87.43747163505547,0
2020-07-28-170710,170710,0,0,8,1171,2.0,91.14564539771287,1
2020-07-29-170710,170710,1,0,7,1172,2.0,95.45008766379195,2
2020-07-30-170710,170710,3,0,4,1175,2.0,74.51283409796824,3
2020-07-31-170710,170710,3,0,2,1178,3.0,73.88744962284855,4
2020-08-01-170710,170710,0,0,0,1178,0.6666666666666666,57.12927179015939,5
2020-08-02-170710,170710,0,1,1,1178,2.333333333333333,168.6725512066954,6
2020-08-03-170710,170710,6,0,7,1184,2.333333333333333,195.59112503847936,0
2020-08-04-170710,170710,1,0,8,1185,2.0,174.3153240875992,1
2020-08-05-170710,170710,3,0,0,1188,3.6666666666666665,153.15545619097543,2
2020-08-06-170710,170710,0,0,0,1188,3.333333333333333,145.07686563123212,3
2020-08-07-170710,170710,3,0,9,1191,4.0,146.7372471242229,4
2020-08-08-170710,170710,1,0,4,1192,1.0,150.82738363875316,5
2020-08-09-170710,170710,3,0,2,1195,1.3333333333333333,141.42632793810478,6
2020-08-10-170710,170710,2,0,11,1197,2.333333333333333,55.0149147874567,0
2020-08-11-170710,170710,8,0,9,1205,2.0,62.549388470107985,1
2020-08-12-170710,170710,7,0,5,1212,5.666666666666668,87.65775985067167,2
2020-08-13-170710,170710,4,0,5,1216,4.333333333333333,95.37221446095543,3
2020-08-14-170710,170710,2,0,6,1218,3.6666666666666665,128.09786899287192,4
2020-08-15-170710,170710,0,0,6,1218,1.6666666666666667,140.45467273629217,5
2020-08-16-170710,170710,1,0,1,1219,1.0,130.87194523800372,6
2020-08-17-170710,170710,7,0,8,1226,6.0,131.9560274003615,0
2020-08-18-170710,170710,8,0,1,1234,4.333333333333333,163.5989158485359,1
2020-08-19-170710,170710,0,0,5,1234,6.666666666666668,158.48083800414395,2
2020-08-20-170710,170710,0,0,5,1234,11.0,137.1664523634701,3
2020-08-21-170710,170710,9,0,12,1243,7.0,144.3380158576953,4
2020-08-22-170710,170710,4,0,0,1247,5.333333333333333,173.47561163643562,5
2020-08-23-170710,170710,2,0,3,1249,1.6666666666666667,199.470154901753,6
2020-08-24-170710,170710,11,0,12,1260,5.666666666666668,161.0464270405987,0
2020-08-25-170710,170710,9,0,6,1269,9.0,175.91976432699343,1
2020-08-26-170710,170710,5,0,13,1274,4.0,197.5139771502598,2
2020-08-27-170710,170710,5,0,2,1279,6.333333333333332,213.28067192048914,3
2020-08-28-170710,170710,6,0,7,1285,6.0,221.46447678999834,4
2020-08-29-170710,170710,6,0,3,1291,5.333333333333333,206.04220547624917,5
2020-08-30-170710,170710,1,0,0,1292,1.6666666666666667,198.03350553145097,6
2020-08-31-170710,170710,8,0,16,1300,5.0,175.44177541404343,0
2020-09-01-170710,170710,1,0,12,1301,4.333333333333333,136.3082280635247,1
2020-09-02-170710,170710,5,0,14,1306,7.0,258.0795353041623,2
2020-09-03-170710,170710,5,0,12,1311,6.666666666666668,288.16161454712665,3
2020-09-04-170710,170710,12,0,13,1323,6.666666666666668,278.8710993492891,4
2020-09-05-170710,170710,0,0,5,1323,4.333333333333333,225.2603889878565,5
2020-09-06-170710,170710,3,0,8,1326,1.6666666666666667,223.2256010170348,6
2020-09-07-170710,170710,12,0,24,1338,6.666666666666668,216.3171517444518,0
2020-09-08-170710,170710,6,0,11,1344,9.333333333333334,200.74667839759024,1
2020-09-09-170710,170710,13,0,8,1357,6.0,231.4076200674822,2
2020-09-10-170710,170710,2,0,11,1359,8.0,117.2630176846556,3
2020-09-11-170710,170710,7,0,10,1366,5.666666666666668,139.14948907475045,4
2020-09-12-170710,170710,3,0,2,1369,6.333333333333332,140.34309806843902,5
2020-09-13-170710,170710,0,0,1,1369,1.0,148.84654145742027,6
2020-09-14-170710,170710,16,0,8,1385,16.333333333333332,131.23282059836885,0
2020-09-15-170710,170710,12,0,5,1397,8.0,215.97127889191242,1
2020-09-16-170710,170710,14,0,8,1411,8.333333333333334,235.11664508466242,2
2020-09-17-170710,170710,12,0,13,1423,12.333333333333336,244.13588535343348,3
2020-09-18-170710,170710,13,0,4,1436,8.0,273.98227930099506,4
2020-09-19-170710,170710,5,0,2,1441,6.0,290.8107110150876,5
2020-09-20-170710,170710,8,0,0,1449,6.0,298.15888095896304,6
2020-09-21-170710,170710,24,1,8,1473,12.0,235.34632021502404,0
2020-09-22-170710,170710,11,1,3,1484,7.333333333333332,264.14240435060935,1
2020-09-23-170710,170710,8,0,16,1492,9.666666666666666,269.91353028474373,2
2020-09-24-170710,170710,11,0,4,1503,10.666666666666666,256.8258916140255,3
2020-09-25-170710,170710,10,0,7,1513,17.666666666666668,256.8571264686238,4
2020-09-26-170710,170710,2,0,3,1515,1.6666666666666667,316.32971343278047,5
2020-09-27-170710,170710,1,0,1,1516,1.6666666666666667,313.96737136771014,6
2020-09-28-170710,170710,8,0,0,1524,9.666666666666666,306.7611621479466,0
2020-09-29-170710,170710,5,0,6,1529,5.666666666666668,312.60673934375336,1
2020-09-30-170710,170710,8,0,7,1537,6.0,306.1717591553787,2
2020-10-01-170710,170710,13,0,19,1550,5.666666666666668,0.0,3
2020-10-02-170710,170710,4,0,12,1554,8.333333333333334,318.3427010379792,4
2020-10-03-170710,170710,2,0,14,1556,4.0,287.333138275348,5
2020-10-04-170710,170710,0,0,3,1556,3.0,288.47739646751535,6
2020-10-05-170710,170710,8,0,14,1564,6.0,288.03183184914167,0
2020-10-06-170710,170710,3,0,7,1567,5.666666666666668,259.4032143648826,1
2020-10-07-170710,170710,16,1,14,1583,5.0,255.0507664861558,2
2020-10-08-170710,170710,4,1,18,1587,5.333333333333333,241.2140782326028,3
2020-10-09-170710,170710,7,1,15,1594,7.666666666666668,258.3059369767867,4
2020-10-10-170710,170710,3,0,2,1597,3.0,30.729739311649055,5
2020-10-11-170710,170710,1,0,5,1598,4.333333333333333,49.00432304202819,6
2020-10-12-170710,170710,0,0,3,1598,3.0,79.23495105451961,0
2020-10-13-170710,170710,6,0,21,1604,7.0,96.73899795929015,1
2020-10-14-170710,170710,7,0,6,1611,6.333333333333332,137.45780764061288,2
2020-10-15-170710,170710,19,0,12,1630,8.666666666666666,175.03056339325968,3
2020-10-16-170710,170710,12,0,13,1642,10.333333333333334,240.65461069692955,4
2020-10-17-170710,170710,14,0,0,1656,6.333333333333332,286.4966799313317,5
2020-10-18-170710,170710,3,0,4,1659,5.666666666666668,294.512748743721,6
2020-10-19-170710,170710,14,1,8,1673,8.0,291.2324114178002,0
2020-10-20-170710,170710,7,0,9,1680,4.666666666666667,346.0933947251458,1
2020-10-21-170710,170710,14,0,8,1694,7.333333333333332,339.6459213806862,2
2020-10-22-170710,170710,18,0,16,1712,12.0,319.5559653819415,3
2020-10-23-170710,170710,15,0,6,1727,11.333333333333336,348.04407654283364,4
2020-10-24-170710,170710,2,0,1,1729,3.6666666666666665,370.803262551417,5
2020-10-25-170710,170710,5,0,2,1734,3.6666666666666665,360.5335621826644,6
2020-10-26-170710,170710,3,0,10,1737,1.6666666666666667,333.36645990118734,0
2020-10-27-170710,170710,21,0,5,1758,8.666666666666666,280.0611266177684,1
2020-10-28-170710,170710,6,0,3,1764,10.0,312.5028023484893,2
2020-10-29-170710,170710,12,0,15,1776,9.333333333333334,315.7727474347638,3
2020-10-30-170710,170710,13,0,12,1789,7.666666666666668,245.1290093434058,4
2020-10-31-170710,170710,0,0,0,1789,7.0,263.10548448270936,5
2020-11-01-170710,170710,4,0,0,1793,4.333333333333333,230.5897382203047,6
2020-11-02-170710,170710,8,1,0,1801,7.0,308.4152418311711,0
2020-11-03-170710,170710,9,0,0,1810,9.333333333333334,263.98606916040376,1
2020-11-04-170710,170710,8,0,0,1818,8.333333333333334,288.83515575387685,2
2020-11-05-170710,170710,16,0,0,1834,8.333333333333334,290.9784316036326,3
2020-11-06-170710,170710,6,1,0,1840,10.666666666666666,317.1505209835608,4
2020-11-07-170710,170710,1,1,0,1841,2.6666666666666665,349.9647524839247,5
2020-11-08-170710,170710,2,0,0,1843,1.3333333333333333,302.1097940462067,6
2020-11-09-170710,170710,10,0,0,1853,8.666666666666666,272.5075461711425,0
2020-11-10-170710,170710,5,0,0,1858,5.0,228.0782481876012,1
2020-11-11-170710,170710,3,0,0,1861,7.0,233.2097777276619,2
2020-11-12-170710,170710,15,0,0,1876,7.0,240.54407910693317,3
2020-11-13-170710,170710,12,0,0,1888,10.666666666666666,220.95644683952992,4
2020-03-01-170711,170711,0,0,4,0,0.09090909090909093,0.0,6
2020-03-02-170711,170711,0,0,20,0,0.2727272727272727,715.2805741035297,0
2020-03-03-170711,170711,0,0,23,0,0.2727272727272727,3386.140401098445,1
2020-03-04-170711,170711,0,0,23,0,0.2727272727272727,3809.728272927508,2
2020-03-05-170711,170711,0,0,33,0,0.2727272727272727,4023.2332994498124,3
2020-03-06-170711,170711,1,0,24,1,0.0,3555.179648888136,4
2020-03-07-170711,170711,1,0,9,2,0.2727272727272727,3873.8635597640305,5
2020-03-08-170711,170711,0,1,27,2,0.0,3770.404989888707,6
2020-03-09-170711,170711,1,0,51,3,0.2727272727272727,3781.345235688739,0
2020-03-10-170711,170711,0,0,35,3,1.0,2562.409905617482,1
2020-03-11-170711,170711,1,0,42,4,0.7272727272727273,2128.0300876149267,2
2020-03-12-170711,170711,4,0,37,8,1.0,1624.471032833151,3
2020-03-13-170711,170711,2,0,42,10,2.4545454545454546,1131.6916770640037,4
2020-03-14-170711,170711,3,0,6,13,2.1818181818181817,1184.6977643378768,5
2020-03-15-170711,170711,4,0,12,17,2.272727272727273,1287.677804759235,6
2020-03-16-170711,170711,20,0,39,37,11.090909090909092,953.140498638598,0
2020-03-17-170711,170711,23,1,21,60,10.363636363636363,1915.453351320477,1
2020-03-18-170711,170711,23,0,28,83,16.09090909090909,2677.1105833608326,2
2020-03-19-170711,170711,33,0,59,116,18.90909090909091,3578.0137262411417,3
2020-03-20-170711,170711,24,0,24,140,18.181818181818183,4204.899011905696,4
2020-03-21-170711,170711,9,0,28,149,11.636363636363635,4768.298799095639,5
2020-03-22-170711,170711,27,0,10,176,11.545454545454545,4904.841664498132,6
2020-03-23-170711,170711,51,0,41,227,25.09090909090909,4903.142388977431,0
2020-03-24-170711,170711,35,0,15,262,24.54545454545455,5760.517867433031,1
2020-03-25-170711,170711,42,0,14,304,20.363636363636363,6073.830559291083,2
2020-03-26-170711,170711,37,0,6,341,22.181818181818183,6297.450042214199,3
2020-03-27-170711,170711,42,0,14,383,18.0,7411.243404844938,4
2020-03-28-170711,170711,6,0,5,389,10.363636363636363,7559.513700242897,5
2020-03-29-170711,170711,12,0,11,401,6.8181818181818175,7360.609856460868,6
2020-03-30-170711,170711,39,0,37,440,21.63636363636364,5463.066048794082,0
2020-03-31-170711,170711,21,0,23,461,13.454545454545455,5415.976641553784,1
2020-04-01-170711,170711,28,0,26,489,13.272727272727273,758.8208117651286,2
2020-04-02-170711,170711,59,0,10,548,10.0,3619.3835110721757,3
2020-04-03-170711,170711,24,0,4,572,9.818181818181818,1827.9005339927317,4
2020-04-04-170711,170711,28,0,39,600,5.0,2347.104431789358,5
2020-04-05-170711,170711,10,0,24,610,4.454545454545454,2868.04690336649,6
2020-04-06-170711,170711,41,0,12,651,9.545454545454543,3047.0106652951717,0
2020-04-07-170711,170711,15,0,9,666,8.090909090909092,3640.816333287714,1
2020-04-08-170711,170711,14,0,34,680,8.545454545454545,3811.41301996077,2
2020-04-09-170711,170711,6,0,4,686,7.1818181818181825,3748.7182148272004,3
2020-04-10-170711,170711,14,0,19,700,5.454545454545454,845.9431329338391,4
2020-04-11-170711,170711,5,0,2,705,3.5454545454545454,1121.1090977113724,5
2020-04-12-170711,170711,11,0,2,716,3.1818181818181817,1286.9830251955145,6
2020-04-13-170711,170711,37,0,12,753,7.727272727272727,1540.3246988131912,0
2020-04-14-170711,170711,23,0,10,776,5.545454545454546,2291.704659557578,1
2020-04-15-170711,170711,26,0,16,802,6.090909090909091,2799.481155279579,2
2020-04-16-170711,170711,10,0,21,812,4.181818181818182,3391.8475473837307,3
2020-04-17-170711,170711,4,0,4,816,4.727272727272728,3014.602015451517,4
2020-04-18-170711,170711,39,0,0,855,4.2727272727272725,3027.242991305131,5
2020-04-19-170711,170711,24,0,0,879,2.1818181818181817,3719.28470752183,6
2020-04-20-170711,170711,12,0,6,891,7.363636363636362,4458.504997769132,0
2020-04-21-170711,170711,9,0,13,900,5.636363636363638,4317.403230911682,1
2020-04-22-170711,170711,34,1,7,934,4.090909090909091,4008.2702463189626,2
2020-04-23-170711,170711,4,0,14,938,3.0,4521.89841257136,3
2020-04-24-170711,170711,19,0,11,957,4.727272727272728,4291.224966062985,4
2020-04-25-170711,170711,2,0,8,959,2.363636363636364,3964.0356619173454,5
2020-04-26-170711,170711,2,0,5,961,1.818181818181818,3530.5614049032074,6
2020-04-27-170711,170711,12,0,15,973,8.0,2229.2555812047012,0
2020-04-28-170711,170711,10,0,13,983,6.363636363636362,2250.280644622688,1
2020-04-29-170711,170711,16,0,11,999,8.272727272727273,2323.008638574092,2
2020-04-30-170711,170711,21,0,11,1020,4.2727272727272725,2628.7867383937773,3
2020-05-01-170711,170711,4,0,16,1024,1.2727272727272727,3835.8368311354616,4
2020-05-02-170711,170711,0,0,7,1024,2.0,2334.2766201920276,5
2020-05-03-170711,170711,0,0,8,1024,1.2727272727272727,1886.4284277296476,6
2020-05-04-170711,170711,6,0,16,1030,4.363636363636363,1267.4389364995748,0
2020-05-05-170711,170711,13,1,14,1043,6.090909090909091,1041.5551518177454,1
2020-05-06-170711,170711,7,0,16,1050,3.636363636363636,1071.1141979333852,2
2020-05-07-170711,170711,14,0,14,1064,5.0,1096.6178450859984,3
2020-05-08-170711,170711,11,0,15,1075,6.0,1355.7097169344634,4
2020-05-09-170711,170711,8,2,4,1083,1.5454545454545454,1825.4502776554573,5
2020-05-10-170711,170711,5,0,6,1088,3.636363636363636,3807.225855605042,6
2020-05-11-170711,170711,15,0,15,1103,6.454545454545454,3199.1854878930335,0
2020-05-12-170711,170711,13,0,15,1116,5.454545454545454,3424.5226331697427,1
2020-05-13-170711,170711,11,0,11,1127,5.363636363636363,2620.096396320097,2
2020-05-14-170711,170711,11,0,7,1138,6.363636363636362,2493.1850513254194,3
2020-05-15-170711,170711,16,0,5,1154,5.363636363636363,2395.223294018651,4
2020-05-16-170711,170711,7,0,0,1161,2.636363636363636,2623.8828060040864,5
2020-05-17-170711,170711,8,0,0,1169,2.636363636363636,2785.927810125582,6
2020-05-18-170711,170711,16,0,4,1185,5.0,2872.9641614828915,0
2020-05-19-170711,170711,14,1,5,1199,5.2727272727272725,2869.167418647416,1
2020-05-20-170711,170711,16,0,5,1215,7.0,2502.7076232992167,2
2020-05-21-170711,170711,14,0,1,1229,5.909090909090909,2663.6995014457007,3
2020-05-22-170711,170711,15,0,2,1244,5.363636363636363,2642.793037513509,4
2020-05-23-170711,170711,4,0,1,1248,4.0,2941.9497847796806,5
2020-05-24-170711,170711,6,0,1,1254,2.1818181818181817,2853.594551678979,6
2020-05-25-170711,170711,15,0,7,1269,4.727272727272728,2511.8734734450186,0
2020-05-26-170711,170711,15,0,6,1284,5.090909090909091,2583.649644425267,1
2020-05-27-170711,170711,11,1,2,1295,8.818181818181818,3123.403010887081,2
2020-05-28-170711,170711,7,0,4,1302,3.363636363636364,3062.0420196571863,3
2020-05-29-170711,170711,5,1,6,1307,3.1818181818181817,2859.4293510747602,4
2020-05-30-170711,170711,0,0,0,1307,0.5454545454545454,2403.9297472482194,5
2020-05-31-170711,170711,0,0,0,1307,0.4545454545454545,2276.1431742314744,6
2020-06-01-170711,170711,4,1,6,1311,3.0,2433.3845889064337,0
2020-06-02-170711,170711,5,0,6,1316,3.727272727272727,1123.920442987399,1
2020-06-03-170711,170711,5,0,6,1321,2.0,770.6377734849955,2
2020-06-04-170711,170711,1,0,3,1322,2.0,699.0574782488627,3
2020-06-05-170711,170711,2,0,3,1324,2.090909090909091,608.3420740253732,4
2020-06-06-170711,170711,1,0,2,1325,1.0,529.6393876439356,5
2020-06-07-170711,170711,1,0,1,1326,0.9090909090909092,538.5229056059773,6
2020-06-08-170711,170711,7,0,4,1333,2.727272727272727,588.9438675643822,0
2020-06-09-170711,170711,6,0,4,1339,2.363636363636364,858.9430353831232,1
2020-06-10-170711,170711,2,0,1,1341,1.818181818181818,2742.6023332624404,2
2020-06-11-170711,170711,4,0,4,1345,1.3636363636363635,2604.3305345562,3
2020-06-12-170711,170711,6,0,4,1351,2.727272727272727,2180.596502459458,4
2020-06-13-170711,170711,0,0,1,1351,0.7272727272727273,2114.240694172543,5
2020-06-14-170711,170711,0,1,0,1351,0.8181818181818182,1575.8646081543598,6
2020-06-15-170711,170711,6,0,0,1357,1.6363636363636365,1123.3402242912287,0
2020-06-16-170711,170711,6,0,1,1363,2.636363636363636,1102.6981049141905,1
2020-06-17-170711,170711,6,0,1,1369,2.5454545454545454,1142.5034477812635,2
2020-06-18-170711,170711,3,0,3,1372,1.7272727272727273,1292.805815646161,3
2020-06-19-170711,170711,3,0,2,1375,3.9090909090909087,1262.7338709588553,4
2020-06-20-170711,170711,2,0,1,1377,0.2727272727272727,1470.620897202638,5
2020-06-21-170711,170711,1,0,0,1378,0.2727272727272727,1510.3451428043506,6
2020-06-22-170711,170711,4,0,2,1382,1.5454545454545454,1306.3839784914478,0
2020-06-23-170711,170711,4,0,1,1386,2.8181818181818183,1185.79447110146,1
2020-06-24-170711,170711,1,1,0,1387,2.363636363636364,1145.702123165157,2
2020-06-25-170711,170711,4,0,4,1391,2.1818181818181817,1164.9941744407486,3
2020-06-26-170711,170711,4,0,3,1395,2.272727272727273,1156.1931664085605,4
2020-06-27-170711,170711,1,0,1,1396,0.5454545454545454,1075.8847004249487,5
2020-06-28-170711,170711,0,1,1,1396,0.3636363636363637,1056.4217665637482,6
2020-06-29-170711,170711,0,0,1,1396,0.7272727272727273,1021.0134709100878,0
2020-06-30-170711,170711,1,0,1,1397,1.0,849.360996073854,1
2020-07-01-170711,170711,1,0,7,1398,0.7272727272727273,976.5060488196632,2
2020-07-02-170711,170711,3,0,5,1401,1.2727272727272727,836.6569124527898,3
2020-07-03-170711,170711,2,0,4,1403,1.0909090909090908,772.0233906767596,4
2020-07-04-170711,170711,1,0,1,1404,0.8181818181818182,712.8276788876069,5
2020-07-05-170711,170711,0,0,2,1404,0.18181818181818185,737.4423892582945,6
2020-07-06-170711,170711,2,0,1,1406,1.9090909090909087,630.1550052074349,0
2020-07-07-170711,170711,1,0,3,1407,0.8181818181818182,570.5476903401564,1
2020-07-08-170711,170711,0,2,6,1407,1.0,517.7440136580949,2
2020-07-09-170711,170711,4,0,4,1411,1.5454545454545454,465.3565593828108,3
2020-07-10-170711,170711,3,1,2,1414,1.2727272727272727,903.4503546982137,4
2020-07-11-170711,170711,1,0,1,1415,0.7272727272727273,919.5855246619875,5
2020-07-12-170711,170711,1,0,0,1416,0.4545454545454545,878.1736042046373,6
2020-07-13-170711,170711,1,0,3,1417,1.0909090909090908,852.7474333617736,0
2020-07-14-170711,170711,1,1,5,1418,0.5454545454545454,886.2905517915644,1
2020-07-15-170711,170711,7,0,1,1425,1.6363636363636365,633.4118740438103,2
2020-07-16-170711,170711,5,0,3,1430,2.4545454545454546,598.8755641967996,3
2020-07-17-170711,170711,4,0,3,1434,1.0909090909090908,733.6230429103234,4
2020-07-18-170711,170711,1,0,1,1435,0.4545454545454545,753.3097747228164,5
2020-07-19-170711,170711,2,0,3,1437,0.2727272727272727,745.3537082827927,6
2020-07-20-170711,170711,1,0,2,1438,1.5454545454545454,813.1300244670997,0
2020-07-21-170711,170711,3,0,2,1441,1.4545454545454546,876.182705882601,1
2020-07-22-170711,170711,6,0,7,1447,1.3636363636363635,794.2204389882631,2
2020-07-23-170711,170711,4,0,6,1451,1.0,813.2117641809355,3
2020-07-24-170711,170711,2,0,4,1453,1.7272727272727273,819.5751444258208,4
2020-07-25-170711,170711,1,1,0,1454,0.7272727272727273,898.6429768517544,5
2020-07-26-170711,170711,0,1,1,1454,0.5454545454545454,880.9573258304625,6
2020-07-27-170711,170711,3,0,1,1457,0.7272727272727273,777.4919243256859,0
2020-07-28-170711,170711,5,1,4,1462,1.2727272727272727,788.9842206711928,1
2020-07-29-170711,170711,1,0,6,1463,1.818181818181818,832.2501936675653,2
2020-07-30-170711,170711,3,0,6,1466,2.636363636363636,661.5586671879593,3
2020-07-31-170711,170711,3,0,3,1469,1.9090909090909087,652.5031202134288,4
2020-08-01-170711,170711,1,0,1,1470,0.6363636363636364,476.3924807889707,5
2020-08-02-170711,170711,3,0,1,1473,0.8181818181818182,1539.6274477773916,6
2020-08-03-170711,170711,2,0,12,1475,1.9090909090909087,1668.4638889797293,0
2020-08-04-170711,170711,2,0,4,1477,0.7272727272727273,1468.3773842847083,1
2020-08-05-170711,170711,7,0,4,1484,1.818181818181818,1283.6810705251228,2
2020-08-06-170711,170711,6,0,6,1490,0.9090909090909092,1230.9392142612473,3
2020-08-07-170711,170711,4,0,5,1494,1.818181818181818,1239.951157078407,4
2020-08-08-170711,170711,0,0,6,1494,1.0909090909090908,1262.0878170022288,5
2020-08-09-170711,170711,1,0,4,1495,1.6363636363636365,1200.2056221172236,6
2020-08-10-170711,170711,1,0,6,1496,2.0,456.43310354384374,0
2020-08-11-170711,170711,4,0,13,1500,2.9090909090909087,541.7326201235766,1
2020-08-12-170711,170711,6,0,4,1506,2.9090909090909087,775.1992328678359,2
2020-08-13-170711,170711,6,0,13,1512,3.1818181818181817,851.5751148707138,3
2020-08-14-170711,170711,3,0,4,1515,4.2727272727272725,1136.6103648002086,4
2020-08-15-170711,170711,1,0,3,1516,2.1818181818181817,1282.6876294726508,5
2020-08-16-170711,170711,1,0,3,1517,1.0,1209.455141013369,6
2020-08-17-170711,170711,12,0,10,1529,4.727272727272728,1229.0252897955277,0
2020-08-18-170711,170711,4,0,3,1533,6.1818181818181825,1478.0702693626213,1
2020-08-19-170711,170711,4,0,4,1537,5.090909090909091,1440.5407555827787,2
2020-08-20-170711,170711,6,0,8,1543,4.636363636363637,1275.0945040546708,3
2020-08-21-170711,170711,5,0,4,1548,6.1818181818181825,1300.3020518871926,4
2020-08-22-170711,170711,6,0,2,1554,3.0909090909090913,1528.7339212509314,5
2020-08-23-170711,170711,4,0,1,1558,1.4545454545454546,1749.3974481995235,6
2020-08-24-170711,170711,6,0,9,1564,5.090909090909091,1420.417716308471,0
2020-08-25-170711,170711,13,0,10,1577,4.454545454545454,1508.876457539951,1
2020-08-26-170711,170711,4,0,7,1581,3.0909090909090913,1651.504676129583,2
2020-08-27-170711,170711,13,0,7,1594,2.636363636363636,1796.2172095375468,3
2020-08-28-170711,170711,4,1,6,1598,4.2727272727272725,1870.8477422252763,4
2020-08-29-170711,170711,3,0,5,1601,2.636363636363636,1728.0163054124769,5
2020-08-30-170711,170711,3,0,0,1604,0.5454545454545454,1631.9285575177428,6
2020-08-31-170711,170711,10,0,19,1614,2.272727272727273,1436.1742350859495,0
2020-09-01-170711,170711,3,1,3,1617,4.454545454545454,1162.9620267677308,1
2020-09-02-170711,170711,4,0,6,1621,6.454545454545454,2135.2270393638464,2
2020-09-03-170711,170711,8,0,12,1629,4.454545454545454,2366.3139375215064,3
2020-09-04-170711,170711,4,1,10,1633,7.272727272727272,2297.3706452141546,4
2020-09-05-170711,170711,2,0,5,1635,3.363636363636364,1913.4558994672273,5
2020-09-06-170711,170711,1,0,11,1636,2.636363636363636,1897.1066947851568,6
2020-09-07-170711,170711,9,0,15,1645,4.545454545454546,1848.4566873934134,0
2020-09-08-170711,170711,10,0,6,1655,5.8181818181818175,1727.7360951574208,1
2020-09-09-170711,170711,7,0,8,1662,4.363636363636363,1971.7765049092666,2
2020-09-10-170711,170711,7,1,12,1669,3.8181818181818175,1000.0685921985478,3
2020-09-11-170711,170711,6,1,18,1675,6.636363636363638,1179.0080639123478,4
2020-09-12-170711,170711,5,0,2,1680,2.636363636363636,1170.5455211502178,5
2020-09-13-170711,170711,0,0,4,1680,0.9090909090909092,1246.3932707071467,6
2020-09-14-170711,170711,19,0,13,1699,7.636363636363638,1111.632518221009,0
2020-09-15-170711,170711,3,0,5,1702,5.909090909090909,1794.7131746610194,1
2020-09-16-170711,170711,6,0,6,1708,6.0,1949.2921741020489,2
2020-09-17-170711,170711,12,0,7,1720,6.545454545454546,1998.7865186580852,3
2020-09-18-170711,170711,10,0,12,1730,6.363636363636362,2235.5195865223304,4
2020-09-19-170711,170711,5,1,4,1735,3.5454545454545454,2381.8656672642483,5
2020-09-20-170711,170711,11,1,3,1746,2.9090909090909087,2460.809881573231,6
2020-09-21-170711,170711,15,0,9,1761,7.8181818181818175,1941.5447201362972,0
2020-09-22-170711,170711,6,2,10,1767,5.181818181818182,2173.591188695019,1
2020-09-23-170711,170711,8,1,8,1775,6.8181818181818175,2229.340015190769,2
2020-09-24-170711,170711,12,0,8,1787,5.454545454545454,2130.126959765743,3
2020-09-25-170711,170711,18,0,10,1805,7.727272727272727,2095.3989607476447,4
2020-09-26-170711,170711,2,0,2,1807,2.363636363636364,2526.94782125011,5
2020-09-27-170711,170711,4,0,5,1811,0.9090909090909092,2462.528939498277,6
2020-09-28-170711,170711,13,1,4,1824,3.727272727272727,2384.275763272435,0
2020-09-29-170711,170711,5,1,7,1829,3.8181818181818175,2378.7689810354796,1
2020-09-30-170711,170711,6,0,6,1835,4.0,2268.639047522006,2
2020-10-01-170711,170711,7,2,11,1842,4.363636363636363,0.0,3
2020-10-02-170711,170711,12,0,13,1854,4.727272727272728,2349.7342514940497,4
2020-10-03-170711,170711,4,0,1,1858,1.7272727272727273,2170.7279295016824,5
2020-10-04-170711,170711,3,0,4,1861,2.272727272727273,2170.1574756046125,6
2020-10-05-170711,170711,9,1,7,1870,3.0,2131.3348824610844,0
2020-10-06-170711,170711,10,0,4,1880,3.5454545454545454,1907.6300111778164,1
2020-10-07-170711,170711,8,0,5,1888,2.636363636363636,1887.107412992635,2
2020-10-08-170711,170711,8,0,21,1896,3.5454545454545454,1777.1752358389283,3
2020-10-09-170711,170711,10,3,5,1906,4.818181818181818,1927.3864977513717,4
2020-10-10-170711,170711,2,0,3,1908,2.4545454545454546,220.39040108442015,5
2020-10-11-170711,170711,5,0,6,1913,2.090909090909091,351.92270079704076,6
2020-10-12-170711,170711,4,0,1,1917,1.818181818181818,565.112321030195,0
2020-10-13-170711,170711,7,0,11,1924,4.363636363636363,690.9920540187328,1
2020-10-14-170711,170711,6,0,9,1930,4.909090909090909,983.4279915319881,2
2020-10-15-170711,170711,11,0,10,1941,5.181818181818182,1264.3360855257083,3
2020-10-16-170711,170711,13,0,15,1954,7.1818181818181825,1716.174015831104,4
2020-10-17-170711,170711,1,0,7,1955,5.454545454545454,2046.7846410923917,5
2020-10-18-170711,170711,4,0,4,1959,3.8181818181818175,2108.7480387746964,6
2020-10-19-170711,170711,7,1,4,1966,6.0,2114.705584056427,0
2020-10-20-170711,170711,4,0,11,1970,5.090909090909091,2495.699219109434,1
2020-10-21-170711,170711,5,0,8,1975,5.363636363636363,2448.3010051848814,2
2020-10-22-170711,170711,21,0,9,1996,5.545454545454546,2313.844083113235,3
2020-10-23-170711,170711,5,0,14,2001,7.363636363636362,2514.03038680897,4
2020-10-24-170711,170711,3,0,1,2004,4.363636363636363,2692.4741697427526,5
2020-10-25-170711,170711,6,0,0,2010,3.0,2637.637547828658,6
2020-10-26-170711,170711,1,0,11,2011,4.636363636363637,2461.2191014740915,0
2020-10-27-170711,170711,11,1,5,2022,6.909090909090909,2143.2628923156353,1
2020-10-28-170711,170711,9,2,8,2031,7.545454545454546,2376.8237340296164,2
2020-10-29-170711,170711,10,0,6,2041,6.909090909090909,2427.2239036647106,3
2020-10-30-170711,170711,15,0,11,2056,7.545454545454546,1936.9730566758326,4
2020-10-31-170711,170711,7,1,0,2063,5.181818181818182,2081.0110361589623,5
2020-11-01-170711,170711,4,2,0,2067,2.9090909090909087,1807.1250346939378,6
2020-11-02-170711,170711,4,1,0,2071,4.181818181818182,2329.85784481767,0
2020-11-03-170711,170711,11,2,0,2082,6.727272727272728,2005.7907197624488,1
2020-11-04-170711,170711,8,1,0,2090,4.545454545454546,2201.7598665344167,2
2020-11-05-170711,170711,9,1,0,2099,7.0,2196.9614863019433,3
2020-11-06-170711,170711,14,2,0,2113,7.909090909090909,2398.6664734092574,4
2020-11-07-170711,170711,1,0,0,2114,2.4545454545454546,2666.792464000263,5
2020-11-08-170711,170711,0,0,0,2114,1.5454545454545454,2325.2885361879144,6
2020-11-09-170711,170711,11,1,0,2125,5.090909090909091,2123.3464287184333,0
2020-11-10-170711,170711,5,0,0,2130,4.454545454545454,1754.9126245087084,1
2020-11-11-170711,170711,8,2,0,2138,3.4545454545454546,1786.7113626271487,2
2020-11-12-170711,170711,6,1,0,2144,6.454545454545454,1825.0638587356807,3
2020-11-13-170711,170711,11,1,0,2155,6.2727272727272725,1668.3577123328823,4
2020-03-01-170712,170712,0,0,0,0,0.0,0.0,6
2020-03-02-170712,170712,0,0,3,0,0.0,29.017881961914107,0
2020-03-03-170712,170712,0,0,1,0,0.16666666666666666,102.83845700133493,1
2020-03-04-170712,170712,0,0,3,0,0.0,107.95107348799411,2
2020-03-05-170712,170712,0,0,9,0,0.0,108.24858724492952,3
2020-03-06-170712,170712,0,0,2,0,0.0,104.71944928294877,4
2020-03-07-170712,170712,0,1,3,0,0.16666666666666666,95.10936996159808,5
2020-03-08-170712,170712,0,0,5,0,0.0,92.69818633407598,6
2020-03-09-170712,170712,0,0,4,0,0.16666666666666666,93.21111888243529,0
2020-03-10-170712,170712,0,0,8,0,0.0,163.96247579107552,1
2020-03-11-170712,170712,0,1,2,0,0.16666666666666666,135.6473648657265,2
2020-03-12-170712,170712,0,0,4,0,0.16666666666666666,108.6688941312058,3
2020-03-13-170712,170712,1,0,2,1,0.0,81.99945963007472,4
2020-03-14-170712,170712,0,0,4,1,1.1666666666666667,62.2644545669759,5
2020-03-15-170712,170712,0,0,1,1,0.6666666666666666,44.226669726435105,6
2020-03-16-170712,170712,3,1,1,4,2.5,14.883968578623993,0
2020-03-17-170712,170712,1,1,2,5,2.833333333333333,34.11122567093014,1
2020-03-18-170712,170712,3,0,3,8,6.166666666666668,54.29738490970332,2
2020-03-19-170712,170712,9,0,2,17,5.333333333333333,119.99210170964093,3
2020-03-20-170712,170712,2,0,0,19,4.0,170.76232898702085,4
2020-03-21-170712,170712,3,1,0,22,1.8333333333333333,192.60505345051584,5
2020-03-22-170712,170712,5,0,1,27,3.6666666666666665,204.2584137289386,6
2020-03-23-170712,170712,4,0,3,31,9.0,222.35893863510768,0
2020-03-24-170712,170712,8,0,2,39,7.0,250.73846744264898,1
2020-03-25-170712,170712,2,0,1,41,6.5,244.92727585544128,2
2020-03-26-170712,170712,4,0,0,45,6.0,220.85822651724686,3
2020-03-27-170712,170712,2,0,1,47,6.0,257.46064837647714,4
2020-03-28-170712,170712,4,0,0,51,2.833333333333333,255.1766858978149,5
2020-03-29-170712,170712,1,0,0,52,1.5,260.91691908828165,6
2020-03-30-170712,170712,1,1,5,53,5.0,190.38485010087126,0
2020-03-31-170712,170712,2,0,0,55,4.666666666666667,161.0638331613779,1
2020-04-01-170712,170712,3,0,1,58,8.0,29.171411387425685,2
2020-04-02-170712,170712,2,0,1,60,2.6666666666666665,114.1908039855797,3
2020-04-03-170712,170712,0,0,2,60,2.0,98.33125477168818,4
2020-04-04-170712,170712,0,0,3,60,1.8333333333333333,87.05423248855561,5
2020-04-05-170712,170712,1,0,0,61,1.6666666666666667,95.63904484829324,6
2020-04-06-170712,170712,3,0,0,64,1.3333333333333333,99.71101245055188,0
2020-04-07-170712,170712,2,0,1,66,1.8333333333333333,71.12582546796136,1
2020-04-08-170712,170712,1,0,1,67,2.5,74.69959950110804,2
2020-04-09-170712,170712,0,1,0,67,1.5,81.86472068245786,3
2020-04-10-170712,170712,1,0,1,68,1.1666666666666667,37.92026411222518,4
2020-04-11-170712,170712,0,0,0,68,0.5,45.88081570097659,5
2020-04-12-170712,170712,0,0,3,68,0.6666666666666666,47.05508959248212,6
2020-04-13-170712,170712,5,0,0,73,3.0,50.3888366530811,0
2020-04-14-170712,170712,0,0,0,73,1.8333333333333333,88.15821629200701,1
2020-04-15-170712,170712,1,0,1,74,1.3333333333333333,97.64170168533933,2
2020-04-16-170712,170712,1,0,0,75,1.0,109.14763109087619,3
2020-04-17-170712,170712,2,0,0,77,4.666666666666667,82.46295597218088,4
2020-04-18-170712,170712,3,0,0,80,3.0,92.84086569112488,5
2020-04-19-170712,170712,0,0,0,80,1.1666666666666667,120.74653753778378,6
2020-04-20-170712,170712,0,0,0,80,2.1666666666666665,105.05240653609411,0
2020-04-21-170712,170712,1,0,0,81,3.6666666666666665,106.49197097161633,1
2020-04-22-170712,170712,1,0,0,82,0.5,108.5618574135321,2
2020-04-23-170712,170712,0,0,0,82,1.6666666666666667,108.47015116867215,3
2020-04-24-170712,170712,1,0,1,83,1.6666666666666667,101.2478488043738,4
2020-04-25-170712,170712,0,0,1,83,0.3333333333333333,86.49028976350519,5
2020-04-26-170712,170712,3,1,0,86,0.6666666666666666,80.27683258236571,6
2020-04-27-170712,170712,0,0,0,86,4.5,67.83252735955168,0
2020-04-28-170712,170712,0,0,0,86,1.3333333333333333,104.08830012255497,1
2020-04-29-170712,170712,1,0,2,87,1.3333333333333333,98.05837440930421,2
2020-04-30-170712,170712,0,0,2,87,0.8333333333333334,96.92337095985073,3
2020-05-01-170712,170712,0,0,0,87,0.6666666666666666,88.66955283584558,4
2020-05-02-170712,170712,0,0,1,87,0.3333333333333333,62.4895906107418,5
2020-05-03-170712,170712,0,0,1,87,0.0,69.20751693630689,6
2020-05-04-170712,170712,0,0,0,87,1.5,44.46337915048113,0
2020-05-05-170712,170712,0,0,2,87,0.16666666666666666,41.25533033158327,1
2020-05-06-170712,170712,0,0,0,87,0.5,21.79838613774957,2
2020-05-07-170712,170712,0,0,0,87,1.0,20.35703203139449,3
2020-05-08-170712,170712,1,0,1,88,1.1666666666666667,21.272055710996334,4
2020-05-09-170712,170712,1,1,2,89,0.0,31.026711674477923,5
2020-05-10-170712,170712,0,1,2,89,0.5,106.84053423870813,6
2020-05-11-170712,170712,0,0,1,89,0.6666666666666666,95.3597580748097,0
2020-05-12-170712,170712,0,5,1,89,1.3333333333333333,76.03151428053134,1
2020-05-13-170712,170712,2,0,4,91,1.0,66.36135363013972,2
2020-05-14-170712,170712,2,0,1,93,1.3333333333333333,67.09860495359091,3
2020-05-15-170712,170712,0,0,0,93,1.1666666666666667,66.18856018644315,4
2020-05-16-170712,170712,1,0,0,94,0.3333333333333333,59.12591593178695,5
2020-05-17-170712,170712,1,0,0,95,0.0,61.92920785127292,6
2020-05-18-170712,170712,0,0,0,95,2.1666666666666665,61.42574995759526,0
2020-05-19-170712,170712,2,0,1,97,1.8333333333333333,67.19922158399109,1
2020-05-20-170712,170712,0,0,0,97,1.8333333333333333,65.29811004405998,2
2020-05-21-170712,170712,0,0,2,97,1.3333333333333333,58.46141329278262,3
2020-05-22-170712,170712,1,0,0,98,0.5,61.2775577029641,4
2020-05-23-170712,170712,2,0,1,100,1.1666666666666667,64.29590566581585,5
2020-05-24-170712,170712,2,0,0,102,0.6666666666666666,72.42579249707495,6
2020-05-25-170712,170712,1,0,0,103,1.6666666666666667,75.96256216018855,0
2020-05-26-170712,170712,1,0,0,104,1.3333333333333333,72.21552227565061,1
2020-05-27-170712,170712,4,0,0,108,1.5,85.71827339316278,2
2020-05-28-170712,170712,1,2,1,109,0.6666666666666666,102.24078263506152,3
2020-05-29-170712,170712,0,0,0,109,0.8333333333333334,98.77031504346955,4
2020-05-30-170712,170712,0,1,0,109,0.0,83.36797798487399,5
2020-05-31-170712,170712,0,0,0,109,0.0,72.97303389418752,6
2020-06-01-170712,170712,0,0,0,109,0.5,41.88747288346149,0
2020-06-02-170712,170712,1,0,1,110,0.5,47.47131873275039,1
2020-06-03-170712,170712,0,0,1,110,0.8333333333333334,38.652493882413054,2
2020-06-04-170712,170712,2,0,0,112,0.16666666666666666,35.42562669059251,3
2020-06-05-170712,170712,0,0,0,112,0.16666666666666666,40.074737447650925,4
2020-06-06-170712,170712,1,0,0,113,0.0,36.97352748724884,5
2020-06-07-170712,170712,0,0,0,113,0.3333333333333333,39.29207486159734,6
2020-06-08-170712,170712,0,0,0,113,0.5,39.63974863392566,0
2020-06-09-170712,170712,0,0,1,113,0.3333333333333333,37.30258692811625,1
2020-06-10-170712,170712,0,0,1,113,0.0,46.926796600590784,2
2020-06-11-170712,170712,1,0,0,114,0.3333333333333333,40.01208221737116,3
2020-06-12-170712,170712,0,0,1,114,0.6666666666666666,42.77139449790354,4
2020-06-13-170712,170712,0,0,0,114,0.0,43.57707744177456,5
2020-06-14-170712,170712,0,0,0,114,0.16666666666666666,35.20350061560967,6
2020-06-15-170712,170712,0,0,1,114,0.16666666666666666,27.619344626875602,0
2020-06-16-170712,170712,1,0,2,115,0.0,26.162514874390446,1
2020-06-17-170712,170712,1,0,1,116,0.0,27.46791126356601,2
2020-06-18-170712,170712,0,0,0,116,0.8333333333333334,31.848911538963876,3
2020-06-19-170712,170712,0,0,3,116,2.333333333333333,31.7534754864989,4
2020-06-20-170712,170712,0,0,0,116,0.16666666666666666,55.3173011037169,5
2020-06-21-170712,170712,0,0,0,116,0.0,54.311099024995094,6
2020-06-22-170712,170712,0,0,0,116,0.3333333333333333,50.074109322092625,0
2020-06-23-170712,170712,1,0,0,117,0.6666666666666666,46.46509766715088,1
2020-06-24-170712,170712,1,1,1,118,0.3333333333333333,56.83867659104633,2
2020-06-25-170712,170712,0,0,0,118,0.16666666666666666,56.11445587543076,3
2020-06-26-170712,170712,1,0,2,119,0.16666666666666666,36.050979990616426,4
2020-06-27-170712,170712,0,0,0,119,0.16666666666666666,36.59121827773032,5
2020-06-28-170712,170712,0,0,1,119,0.16666666666666666,39.92935344636694,6
2020-06-29-170712,170712,1,0,0,120,0.5,45.06630237310915,0
2020-06-30-170712,170712,2,0,1,122,0.6666666666666666,41.11552168349851,1
2020-07-01-170712,170712,1,0,1,123,0.3333333333333333,50.578740617443216,2
2020-07-02-170712,170712,0,0,0,123,0.0,40.022436663196174,3
2020-07-03-170712,170712,3,0,0,126,0.3333333333333333,53.6170626017864,4
2020-07-04-170712,170712,0,0,0,126,0.3333333333333333,84.4194191556812,5
2020-07-05-170712,170712,0,0,0,126,0.0,86.03672550476769,6
2020-07-06-170712,170712,0,0,0,126,0.5,86.11284156778487,0
2020-07-07-170712,170712,0,0,0,126,0.16666666666666666,81.69631468175079,1
2020-07-08-170712,170712,1,0,1,127,0.0,68.92895357728355,2
2020-07-09-170712,170712,0,0,1,127,0.16666666666666666,57.017180830839614,3
2020-07-10-170712,170712,2,0,0,129,0.5,39.954699260961576,4
2020-07-11-170712,170712,0,0,0,129,0.16666666666666666,43.64809468158407,5
2020-07-12-170712,170712,1,0,0,130,0.0,41.74874764515201,6
2020-07-13-170712,170712,0,1,0,130,0.16666666666666666,41.26388341473099,0
2020-07-14-170712,170712,1,0,0,131,0.3333333333333333,39.06856660389127,1
2020-07-15-170712,170712,1,0,1,132,1.0,41.82914939809752,2
2020-07-16-170712,170712,0,0,0,132,0.6666666666666666,45.85232738929102,3
2020-07-17-170712,170712,0,0,3,132,0.3333333333333333,46.23856841648974,4
2020-07-18-170712,170712,0,0,0,132,0.5,38.06648168555441,5
2020-07-19-170712,170712,0,0,0,132,0.16666666666666666,45.15111765013054,6
2020-07-20-170712,170712,0,0,0,132,0.6666666666666666,39.110811687309415,0
2020-07-21-170712,170712,0,0,0,132,0.16666666666666666,40.928878901787655,1
2020-07-22-170712,170712,1,0,0,133,0.5,34.33327235713198,2
2020-07-23-170712,170712,1,0,0,134,0.3333333333333333,41.951450656492796,3
2020-07-24-170712,170712,0,0,0,134,1.1666666666666667,39.39284391707744,4
2020-07-25-170712,170712,0,0,1,134,0.5,59.44136217747381,5
2020-07-26-170712,170712,0,0,1,134,0.0,60.14499610337168,6
2020-07-27-170712,170712,0,0,2,134,0.0,59.20441862453976,0
2020-07-28-170712,170712,0,0,2,134,0.8333333333333334,49.63093926710107,1
2020-07-29-170712,170712,1,0,5,135,0.6666666666666666,57.016130599168875,2
2020-07-30-170712,170712,0,0,4,135,2.5,72.70580091486906,3
2020-07-31-170712,170712,3,0,4,138,0.6666666666666666,77.83872366965923,4
2020-08-01-170712,170712,0,0,3,138,1.1666666666666667,29.685396068922053,5
2020-08-02-170712,170712,0,0,3,138,0.3333333333333333,438.3594178167424,6
2020-08-03-170712,170712,0,0,2,138,1.6666666666666667,239.89379184688764,0
2020-08-04-170712,170712,0,0,4,138,1.1666666666666667,214.68805339798922,1
2020-08-05-170712,170712,0,0,6,138,2.6666666666666665,176.43072830259487,2
2020-08-06-170712,170712,0,0,1,138,3.1666666666666665,165.54137433080103,3
2020-08-07-170712,170712,0,1,2,138,2.5,162.75988512659296,4
2020-08-08-170712,170712,1,0,1,139,2.6666666666666665,123.1709296966593,5
2020-08-09-170712,170712,1,0,0,140,3.5,135.45184807193547,6
2020-08-10-170712,170712,2,0,2,142,5.833333333333332,26.61896978168971,0
2020-08-11-170712,170712,2,1,2,144,5.166666666666667,68.5007432372133,1
2020-08-12-170712,170712,5,0,6,149,4.166666666666667,108.06384056931391,2
2020-08-13-170712,170712,4,0,5,153,5.5,162.74822481849247,3
2020-08-14-170712,170712,4,0,0,157,8.0,234.57962071633605,4
2020-08-15-170712,170712,3,0,1,160,3.6666666666666665,322.96074896933555,5
2020-08-16-170712,170712,3,0,3,163,1.6666666666666667,355.35342538269117,6
2020-08-17-170712,170712,2,0,2,165,10.0,388.07092699745203,0
2020-08-18-170712,170712,4,0,5,169,9.0,415.34681843601436,1
2020-08-19-170712,170712,6,0,0,175,5.333333333333333,478.7231107361117,2
2020-08-20-170712,170712,1,0,4,176,3.8333333333333335,443.03883526607353,3
2020-08-21-170712,170712,2,0,5,178,3.1666666666666665,372.4633740412196,4
2020-08-22-170712,170712,1,0,1,179,0.8333333333333334,367.4538683102806,5
2020-08-23-170712,170712,0,0,0,179,1.5,348.2263422078625,6
2020-08-24-170712,170712,2,0,4,181,3.5,285.84687902867427,0
2020-08-25-170712,170712,2,0,3,183,3.0,254.1224509999263,1
2020-08-26-170712,170712,6,0,2,189,1.6666666666666667,196.32941957604274,2
2020-08-27-170712,170712,5,0,2,194,3.8333333333333335,230.26519693865833,3
2020-08-28-170712,170712,0,0,7,194,3.0,231.11602407208682,4
2020-08-29-170712,170712,1,0,3,195,3.333333333333333,220.81873891686547,5
2020-08-30-170712,170712,3,0,2,198,3.0,246.8259249160443,6
2020-08-31-170712,170712,2,0,4,200,1.0,230.8696900761278,0
2020-09-01-170712,170712,5,0,2,205,2.0,88.72003570655505,1
2020-09-02-170712,170712,0,0,5,205,0.8333333333333334,206.5867093148219,2
2020-09-03-170712,170712,4,1,2,209,4.333333333333333,175.69634808295348,3
2020-09-04-170712,170712,5,0,2,214,4.5,189.3663515774909,4
2020-09-05-170712,170712,1,0,0,215,0.8333333333333334,168.68509622315187,5
2020-09-06-170712,170712,0,0,1,215,3.6666666666666665,159.69944756917528,6
2020-09-07-170712,170712,4,0,2,219,1.1666666666666667,163.25896604281252,0
2020-09-08-170712,170712,3,0,7,222,3.6666666666666665,165.75862341570235,1
2020-09-09-170712,170712,2,0,2,224,1.3333333333333333,199.46996282870097,2
2020-09-10-170712,170712,2,0,1,226,4.833333333333333,82.55641839133486,3
2020-09-11-170712,170712,7,0,5,233,5.5,106.78780179331423,4
2020-09-12-170712,170712,3,0,3,236,0.8333333333333334,132.5335213197537,5
2020-09-13-170712,170712,2,0,2,238,2.1666666666666665,137.60347580273736,6
2020-09-14-170712,170712,4,0,1,242,3.1666666666666665,148.5420358983375,0
2020-09-15-170712,170712,2,0,0,244,4.333333333333333,176.3525912132081,1
2020-09-16-170712,170712,5,0,1,249,5.333333333333333,191.58500381058644,2
2020-09-17-170712,170712,2,0,2,251,4.5,203.3570287224004,3
2020-09-18-170712,170712,2,0,1,253,4.666666666666667,205.70796561865603,4
2020-09-19-170712,170712,0,0,1,253,2.333333333333333,190.00354750884378,5
2020-09-20-170712,170712,1,0,1,254,3.333333333333333,161.81030447767907,6
2020-09-21-170712,170712,2,1,2,256,5.666666666666668,130.25092315757047,0
2020-09-22-170712,170712,7,0,3,263,2.833333333333333,121.08919638179759,1
2020-09-23-170712,170712,2,0,2,265,4.0,121.54349653685827,2
2020-09-24-170712,170712,1,0,5,266,2.333333333333333,119.63240785314727,3
2020-09-25-170712,170712,5,0,0,271,6.666666666666668,115.5760115674575,4
2020-09-26-170712,170712,3,0,3,274,0.6666666666666666,156.94390398597386,5
2020-09-27-170712,170712,2,0,0,276,1.0,169.36383839760362,6
2020-09-28-170712,170712,1,0,1,277,2.5,169.073212069242,0
2020-09-29-170712,170712,0,0,0,277,3.333333333333333,175.03235631258866,1
2020-09-30-170712,170712,1,0,1,278,2.333333333333333,159.9117505701855,2
2020-10-01-170712,170712,2,0,1,280,2.6666666666666665,0.0,3
2020-10-02-170712,170712,1,0,0,281,4.833333333333333,170.04478775254347,4
2020-10-03-170712,170712,1,0,4,282,2.1666666666666665,237.04365204954087,5
2020-10-04-170712,170712,1,0,1,283,3.0,238.07188211841552,6
2020-10-05-170712,170712,2,0,1,285,1.5,232.11679583339458,0
2020-10-06-170712,170712,3,0,1,288,1.8333333333333333,235.44553165399122,1
2020-10-07-170712,170712,2,0,2,290,1.3333333333333333,228.57800202325888,2
2020-10-08-170712,170712,5,0,6,295,5.666666666666668,180.16786265569266,3
2020-10-09-170712,170712,0,0,0,295,2.833333333333333,216.98519269427763,4
2020-10-10-170712,170712,3,0,0,298,1.8333333333333333,21.822339947588166,5
2020-10-11-170712,170712,0,0,1,298,2.833333333333333,42.20306801263035,6
2020-10-12-170712,170712,1,0,0,299,3.5,74.20296894594532,0
2020-10-13-170712,170712,0,0,0,299,4.0,96.80918123853567,1
2020-10-14-170712,170712,1,0,1,300,2.833333333333333,125.46854996509877,2
2020-10-15-170712,170712,1,0,4,301,2.5,144.54387973346138,3
2020-10-16-170712,170712,0,0,0,301,3.5,167.1069363369458,4
2020-10-17-170712,170712,4,1,3,305,1.6666666666666667,171.5724853321351,5
2020-10-18-170712,170712,1,0,1,306,2.333333333333333,178.18660717686794,6
2020-10-19-170712,170712,1,0,1,307,3.5,162.87844313750466,0
2020-10-20-170712,170712,1,0,1,308,1.5,165.64530073589663,1
2020-10-21-170712,170712,2,0,2,310,4.0,162.13302146074176,2
2020-10-22-170712,170712,6,0,0,316,3.0,170.9276232996022,3
2020-10-23-170712,170712,0,0,1,316,3.5,180.2599008567464,4
2020-10-24-170712,170712,0,0,3,316,3.6666666666666665,170.89764911258214,5
2020-10-25-170712,170712,1,0,3,317,2.5,190.40398069568192,6
2020-10-26-170712,170712,0,0,1,317,3.8333333333333335,185.82337435176788,0
2020-10-27-170712,170712,0,0,1,317,2.5,175.35618979335993,1
2020-10-28-170712,170712,1,0,4,318,5.5,176.7319743430455,2
2020-10-29-170712,170712,4,0,0,322,5.5,179.28304899112393,3
2020-10-30-170712,170712,0,0,3,322,6.0,207.06738584063086,4
2020-10-31-170712,170712,3,0,0,325,3.6666666666666665,182.3045225978939,5
2020-11-01-170712,170712,1,0,0,326,2.333333333333333,205.58446382097705,6
2020-11-02-170712,170712,1,0,0,327,2.833333333333333,89.1672051371151,0
2020-11-03-170712,170712,1,0,0,328,7.833333333333332,87.00602730913982,1
2020-11-04-170712,170712,2,0,0,330,2.6666666666666665,115.42461348571558,2
2020-11-05-170712,170712,0,0,0,330,7.333333333333332,117.73672416387483,3
2020-11-06-170712,170712,1,0,0,331,7.666666666666668,135.43417265297379,4
2020-11-07-170712,170712,3,0,0,334,2.833333333333333,151.05695213892662,5
2020-11-08-170712,170712,3,0,0,337,2.5,154.40456958772074,6
2020-11-09-170712,170712,1,0,0,338,4.0,146.14435867101872,0
2020-11-10-170712,170712,1,0,0,339,4.166666666666667,155.38220856499643,1
2020-11-11-170712,170712,4,0,0,343,4.333333333333333,153.5225643179044,2
2020-11-12-170712,170712,0,0,0,343,4.333333333333333,164.82947644099767,3
2020-11-13-170712,170712,3,0,0,346,3.6666666666666665,146.26329178117425,4
2020-03-01-170713,170713,0,0,5,0,0.2,0.0,6
2020-03-02-170713,170713,0,0,5,0,0.0,40.65927041934444,0
2020-03-03-170713,170713,0,4,10,0,0.0,157.77091293365095,1
2020-03-04-170713,170713,0,0,10,0,0.2,173.87438403107345,2
2020-03-05-170713,170713,0,0,5,0,0.2,183.60363092216102,3
2020-03-06-170713,170713,0,0,11,0,0.2,162.4874918560915,4
2020-03-07-170713,170713,0,0,7,0,0.2,163.57061390414088,5
2020-03-08-170713,170713,0,0,5,0,0.0,158.63582957062204,6
2020-03-09-170713,170713,0,0,9,0,0.2,158.3132982939414,0
2020-03-10-170713,170713,0,0,6,0,0.8,139.50524986859898,1
2020-03-11-170713,170713,0,0,7,0,0.4,117.24250518126775,2
2020-03-12-170713,170713,3,0,6,3,0.8,77.99659989268321,3
2020-03-13-170713,170713,3,0,7,6,1.4,55.38398673808821,4
2020-03-14-170713,170713,4,0,4,10,1.6,58.997988686145945,5
2020-03-15-170713,170713,5,0,2,15,1.6,67.7890641117151,6
2020-03-16-170713,170713,5,0,4,20,6.2,62.38089183682604,0
2020-03-17-170713,170713,10,1,5,30,6.8,102.9001978723342,1
2020-03-18-170713,170713,10,0,1,40,8.2,150.60459776959155,2
2020-03-19-170713,170713,5,0,0,45,13.0,212.06491067510052,3
2020-03-20-170713,170713,11,0,1,56,8.2,236.92989998697692,4
2020-03-21-170713,170713,7,0,0,63,3.6,276.50873887935614,5
2020-03-22-170713,170713,5,0,0,68,7.6,286.53294235000607,6
2020-03-23-170713,170713,9,0,3,77,17.0,290.15310559894436,0
2020-03-24-170713,170713,6,0,0,83,12.6,321.3861749690033,1
2020-03-25-170713,170713,7,0,0,90,15.4,326.70884283412374,2
2020-03-26-170713,170713,6,0,1,96,15.0,351.1514231157439,3
2020-03-27-170713,170713,7,0,0,103,13.4,414.6202362422924,4
2020-03-28-170713,170713,4,0,2,107,7.4,414.45611295381605,5
2020-03-29-170713,170713,2,0,1,109,5.6,404.5333244398745,6
2020-03-30-170713,170713,4,0,0,113,14.6,302.351311647124,0
2020-03-31-170713,170713,5,0,2,118,10.6,296.03300250177665,1
2020-04-01-170713,170713,1,0,3,119,9.0,46.991508919082676,2
2020-04-02-170713,170713,0,0,0,119,18.2,167.26456211876308,3
2020-04-03-170713,170713,1,0,0,120,8.0,80.51522431647231,4
2020-04-04-170713,170713,0,0,0,120,7.4,103.9816433699848,5
2020-04-05-170713,170713,0,0,0,120,3.8,120.6950138789192,6
2020-04-06-170713,170713,3,0,0,123,12.4,127.20650703488886,0
2020-04-07-170713,170713,0,0,1,123,5.6,158.8882301036557,1
2020-04-08-170713,170713,0,0,0,123,5.4,161.22058916237305,2
2020-04-09-170713,170713,1,0,0,124,4.8,164.37207146013577,3
2020-04-10-170713,170713,0,0,0,124,6.4,31.988226484284965,4
2020-04-11-170713,170713,2,0,1,126,3.6,44.81994380507084,5
2020-04-12-170713,170713,1,0,1,127,4.4,56.22865294585462,6
2020-04-13-170713,170713,0,1,0,127,11.0,69.84751006363553,0
2020-04-14-170713,170713,2,0,2,129,11.8,100.50110404006014,1
2020-04-15-170713,170713,3,0,0,132,7.8,131.49615156121223,2
2020-04-16-170713,170713,0,0,1,132,4.8,166.10922005270393,3
2020-04-17-170713,170713,0,0,0,132,3.0,158.47241144901514,4
2020-04-18-170713,170713,0,0,0,132,9.8,175.35007299767994,5
2020-04-19-170713,170713,0,0,0,132,6.6,202.29559478666823,6
2020-04-20-170713,170713,0,0,1,132,7.4,240.18945356502084,0
2020-04-21-170713,170713,1,0,1,133,4.6,234.36439639400473,1
2020-04-22-170713,170713,0,0,0,133,10.2,214.1011210605019,2
2020-04-23-170713,170713,0,0,1,133,2.6,237.36897561428668,3
2020-04-24-170713,170713,0,0,0,133,7.4,223.93099942686143,4
2020-04-25-170713,170713,1,0,0,134,1.2,196.0362617009456,5
2020-04-26-170713,170713,1,0,0,135,1.4,178.68541503376318,6
2020-04-27-170713,170713,0,1,0,135,4.4,119.78533803421762,0
2020-04-28-170713,170713,2,0,0,137,3.2,111.52050475027103,1
2020-04-29-170713,170713,0,0,5,137,6.0,116.57093913427785,2
2020-04-30-170713,170713,1,0,2,138,5.6,129.65514707324343,3
2020-05-01-170713,170713,0,0,1,138,1.2,189.767129351226,4
2020-05-02-170713,170713,0,0,1,138,1.8,127.39341461641948,5
2020-05-03-170713,170713,0,0,0,138,0.6,93.69452412744617,6
2020-05-04-170713,170713,1,0,1,139,3.0,69.44509007235098,0
2020-05-05-170713,170713,1,0,1,140,3.6,59.44834289181328,1
2020-05-06-170713,170713,0,0,3,140,3.8,55.26194090297997,2
2020-05-07-170713,170713,1,0,0,141,4.4,59.46433929613738,3
2020-05-08-170713,170713,0,0,2,141,5.4,72.71953963140965,4
2020-05-09-170713,170713,0,0,0,141,2.2,95.62850899364051,5
2020-05-10-170713,170713,0,0,1,141,1.8,181.69400198669982,6
2020-05-11-170713,170713,0,0,0,141,5.6,156.63616447182812,0
2020-05-12-170713,170713,0,0,1,141,5.4,165.37033882239655,1
2020-05-13-170713,170713,5,0,1,146,3.4,126.14613987396527,2
2020-05-14-170713,170713,2,0,0,148,4.4,123.36612923228716,3
2020-05-15-170713,170713,1,0,0,149,4.4,127.6036389112322,4
2020-05-16-170713,170713,1,0,2,150,2.0,131.98404873015085,5
2020-05-17-170713,170713,0,0,1,150,2.2,140.53794680037623,6
2020-05-18-170713,170713,1,0,0,151,6.2,142.42208178079542,0
2020-05-19-170713,170713,1,0,2,152,3.8,142.8879188097706,1
2020-05-20-170713,170713,3,0,0,155,4.0,117.48637266039329,2
2020-05-21-170713,170713,0,0,2,155,4.2,120.60626639103346,3
2020-05-22-170713,170713,2,1,0,157,4.6,108.04401945341027,4
2020-05-23-170713,170713,0,0,0,157,2.4,123.53327712337823,5
2020-05-24-170713,170713,1,0,0,158,2.0,120.63869905834761,6
2020-05-25-170713,170713,0,0,0,158,3.6,104.82533144448948,0
2020-05-26-170713,170713,1,0,0,159,4.2,107.94679413468893,1
2020-05-27-170713,170713,1,0,0,160,5.6,127.2508229894303,2
2020-05-28-170713,170713,0,1,0,160,2.6,134.21899146998155,3
2020-05-29-170713,170713,0,0,2,160,2.2,141.12844797774642,4
2020-05-30-170713,170713,2,0,1,162,0.0,117.43781096219101,5
2020-05-31-170713,170713,1,0,3,163,0.0,115.04518818576808,6
2020-06-01-170713,170713,0,1,0,163,1.6,124.1031886300656,0
2020-06-02-170713,170713,2,0,0,165,3.4,62.624207118352004,1
2020-06-03-170713,170713,0,0,1,165,2.0,34.75024014453537,2
2020-06-04-170713,170713,2,0,0,167,1.4,32.76994080716963,3
2020-06-05-170713,170713,0,0,2,167,1.0,32.464633980275664,4
2020-06-06-170713,170713,0,0,1,167,1.4,29.143012308424616,5
2020-06-07-170713,170713,0,0,0,167,0.4,32.87874394282308,6
2020-06-08-170713,170713,0,0,0,167,2.0,34.50898104720282,0
2020-06-09-170713,170713,0,0,0,167,1.8,46.95153714094404,1
2020-06-10-170713,170713,0,0,0,167,1.0,133.8411185455131,2
2020-06-11-170713,170713,0,0,1,167,1.2,125.68302835898862,3
2020-06-12-170713,170713,2,0,0,169,2.4,102.49945256203958,4
2020-06-13-170713,170713,1,0,0,170,0.4,111.32889432520764,5
2020-06-14-170713,170713,3,0,0,173,0.0,84.3645100049744,6
2020-06-15-170713,170713,0,0,0,173,1.8,65.80990377683682,0
2020-06-16-170713,170713,0,0,0,173,2.0,64.38184427358864,1
2020-06-17-170713,170713,1,0,0,174,1.8,65.71746526727114,2
2020-06-18-170713,170713,0,1,1,174,0.6,73.68830388042822,3
2020-06-19-170713,170713,2,0,1,176,1.6,71.59246869202589,4
2020-06-20-170713,170713,1,0,1,177,0.6,76.99563406278247,5
2020-06-21-170713,170713,0,0,0,177,0.6,74.2953285703289,6
2020-06-22-170713,170713,0,0,1,177,1.2,66.82116920509284,0
2020-06-23-170713,170713,0,0,0,177,1.2,63.34366898422255,1
2020-06-24-170713,170713,0,0,0,177,0.8,62.329465053777014,2
2020-06-25-170713,170713,1,0,0,178,0.8,65.5211058382058,3
2020-06-26-170713,170713,0,0,0,178,1.4,62.98068240654071,4
2020-06-27-170713,170713,0,0,1,178,0.4,51.79069061986679,5
2020-06-28-170713,170713,0,0,0,178,0.6,50.94713471317324,6
2020-06-29-170713,170713,0,0,0,178,0.4,50.455529571265956,0
2020-06-30-170713,170713,0,0,1,178,0.4,45.68492148638731,1
2020-07-01-170713,170713,0,0,0,178,0.8,64.17813856001877,2
2020-07-02-170713,170713,1,0,0,179,0.8,59.0290027139568,3
2020-07-03-170713,170713,1,0,0,180,0.4,48.93287299662032,4
2020-07-04-170713,170713,1,0,2,181,0.4,49.903582996228465,5
2020-07-05-170713,170713,0,0,1,181,0.0,55.47072308281075,6
2020-07-06-170713,170713,1,0,4,182,0.8,49.975064515354745,0
2020-07-07-170713,170713,0,0,0,182,0.4,50.895896230937424,1
2020-07-08-170713,170713,0,0,0,182,0.2,42.53285676508497,2
2020-07-09-170713,170713,0,0,0,182,2.0,35.601695451272064,3
2020-07-10-170713,170713,0,1,1,182,2.0,62.00083598470598,4
2020-07-11-170713,170713,1,0,0,183,0.2,55.27662754256723,5
2020-07-12-170713,170713,0,0,0,183,0.2,56.3140706510482,6
2020-07-13-170713,170713,0,0,0,183,0.6,50.265320488569046,0
2020-07-14-170713,170713,1,0,0,184,0.2,53.63748726194227,1
2020-07-15-170713,170713,0,0,2,184,1.6,41.223823510429,2
2020-07-16-170713,170713,0,0,2,184,1.0,39.83266342589404,3
2020-07-17-170713,170713,0,0,1,184,1.0,46.361822933496626,4
2020-07-18-170713,170713,2,0,0,186,0.2,47.08088956487596,5
2020-07-19-170713,170713,1,0,0,187,0.4,48.41522875829464,6
2020-07-20-170713,170713,4,0,1,191,0.4,58.70708867170884,0
2020-07-21-170713,170713,0,0,1,191,1.0,71.18758869041781,1
2020-07-22-170713,170713,0,0,2,191,1.8,68.9731966949667,2
2020-07-23-170713,170713,0,0,1,191,1.0,63.834317219693645,3
2020-07-24-170713,170713,1,0,1,192,0.4,63.701945167850155,4
2020-07-25-170713,170713,0,0,1,192,0.4,65.91052337206304,5
2020-07-26-170713,170713,0,0,4,192,0.0,61.79264831222174,6
2020-07-27-170713,170713,0,0,1,192,0.6,52.12690392880182,0
2020-07-28-170713,170713,0,0,1,192,1.0,41.081680401182105,1
2020-07-29-170713,170713,2,0,1,194,0.6,44.938134759413195,2
2020-07-30-170713,170713,2,1,1,196,1.0,42.84962818381003,3
2020-07-31-170713,170713,1,0,1,197,2.0,40.959602022601324,4
2020-08-01-170713,170713,0,0,2,197,0.4,35.90071150756039,5
2020-08-02-170713,170713,0,0,1,197,1.2,115.9765323478531,6
2020-08-03-170713,170713,1,0,1,198,1.2,125.76930965234133,0
2020-08-04-170713,170713,1,0,2,199,0.4,106.18712923544268,1
2020-08-05-170713,170713,2,0,2,201,1.6,87.90758485433938,2
2020-08-06-170713,170713,1,0,2,202,1.6,85.57472452185556,3
2020-08-07-170713,170713,1,0,1,203,1.2,83.88503479742178,4
2020-08-08-170713,170713,1,0,4,204,1.0,84.01093991418286,5
2020-08-09-170713,170713,4,0,3,208,0.4,87.24322077245807,6
2020-08-10-170713,170713,1,0,1,209,0.6,31.02558541810145,0
2020-08-11-170713,170713,1,0,2,210,2.0,35.75910289049759,1
2020-08-12-170713,170713,1,0,2,211,2.0,51.95808727438821,2
2020-08-13-170713,170713,1,0,1,212,1.6,52.1968712150051,3
2020-08-14-170713,170713,1,0,1,213,1.6,72.493200210709,4
2020-08-15-170713,170713,2,0,0,215,2.2,84.01899853127398,5
2020-08-16-170713,170713,1,0,0,216,0.6,88.1902548314774,6
2020-08-17-170713,170713,1,0,2,217,3.0,95.37990026045686,0
2020-08-18-170713,170713,2,0,3,219,3.0,105.49114273839953,1
2020-08-19-170713,170713,2,0,3,221,2.8,106.17327753129045,2
2020-08-20-170713,170713,2,0,1,223,2.4,102.94609595776566,3
2020-08-21-170713,170713,1,0,2,224,5.0,101.04507497849926,4
2020-08-22-170713,170713,4,0,0,228,2.2,111.10070960432249,5
2020-08-23-170713,170713,3,1,1,231,1.8,129.36579402775433,6
2020-08-24-170713,170713,1,0,1,232,3.2,109.51831701720627,0
2020-08-25-170713,170713,2,0,1,234,5.0,112.03534019156076,1
2020-08-26-170713,170713,2,0,0,236,3.0,125.73755040947583,2
2020-08-27-170713,170713,1,0,0,237,3.6,135.17591374397156,3
2020-08-28-170713,170713,1,0,1,238,3.0,142.98309993929809,4
2020-08-29-170713,170713,0,0,4,238,1.8,137.14369198052998,5
2020-08-30-170713,170713,0,0,0,238,1.8,118.06271570070567,6
2020-08-31-170713,170713,2,0,3,240,4.2,102.7495801940949,0
2020-09-01-170713,170713,3,0,2,243,3.0,98.55889682959616,1
2020-09-02-170713,170713,3,0,0,246,3.0,147.68787906914895,2
2020-09-03-170713,170713,1,0,1,247,3.6,200.94787117395646,3
2020-09-04-170713,170713,2,0,1,249,2.2,202.80097687053689,4
2020-09-05-170713,170713,0,0,2,249,1.8,173.20328712076855,5
2020-09-06-170713,170713,1,0,0,250,1.6,175.42028569320598,6
2020-09-07-170713,170713,1,0,1,251,4.4,168.39609347712468,0
2020-09-08-170713,170713,1,0,1,252,4.2,154.42554193363497,1
2020-09-09-170713,170713,0,0,9,252,2.2,173.0907280844774,2
2020-09-10-170713,170713,0,0,2,252,2.2,87.66447463801993,3
2020-09-11-170713,170713,1,0,2,253,6.0,96.37169778655831,4
2020-09-12-170713,170713,4,0,5,257,1.2,97.90380210332336,5
2020-09-13-170713,170713,0,0,1,257,0.6,106.64485764781753,6
2020-09-14-170713,170713,3,0,3,260,8.0,100.62581401030657,0
2020-09-15-170713,170713,2,0,0,262,1.8,133.46487032075916,1
2020-09-16-170713,170713,0,0,9,262,3.6,137.20050931843258,2
2020-09-17-170713,170713,1,0,1,263,4.8,131.57025884565863,3
2020-09-18-170713,170713,1,0,0,264,6.0,145.76685613009676,4
2020-09-19-170713,170713,2,0,0,266,1.8,161.0699495132003,5
2020-09-20-170713,170713,0,0,1,266,2.8,151.75412478557612,6
2020-09-21-170713,170713,1,1,0,267,4.4,122.4492091578353,0
2020-09-22-170713,170713,1,0,3,268,4.4,136.7636598374521,1
2020-09-23-170713,170713,9,0,0,277,4.2,132.76208120292932,2
2020-09-24-170713,170713,2,0,2,279,4.4,124.69612785898262,3
2020-09-25-170713,170713,2,0,2,281,7.0,123.28630550271737,4
2020-09-26-170713,170713,5,0,0,286,1.8,138.22804824484695,5
2020-09-27-170713,170713,1,0,1,287,0.8,141.1614702852151,6
2020-09-28-170713,170713,3,0,0,290,4.6,134.30553366522562,0
2020-09-29-170713,170713,0,0,3,290,2.2,138.51541495237518,1
2020-09-30-170713,170713,9,0,0,299,2.8,124.05799843959916,2
2020-10-01-170713,170713,1,0,0,300,5.2,0.0,3
2020-10-02-170713,170713,0,0,1,300,6.4,128.80926302017772,4
2020-10-03-170713,170713,0,1,1,300,2.6,137.48157542052368,5
2020-10-04-170713,170713,1,0,4,301,2.2,131.06893057385014,6
2020-10-05-170713,170713,0,1,4,301,3.8,114.19756794587356,0
2020-10-06-170713,170713,3,0,1,304,4.6,101.88480414227902,1
2020-10-07-170713,170713,0,1,1,304,2.6,99.26872405897973,2
2020-10-08-170713,170713,2,0,0,306,2.2,84.87924052510006,3
2020-10-09-170713,170713,2,0,1,308,5.4,89.19337280454384,4
2020-10-10-170713,170713,0,0,1,308,1.2,13.99418920809938,5
2020-10-11-170713,170713,1,0,1,309,1.6,19.632532490267934,6
2020-10-12-170713,170713,0,0,4,309,1.8,29.2795280334714,0
2020-10-13-170713,170713,3,0,1,312,3.4,33.574072668707664,1
2020-10-14-170713,170713,0,0,2,312,4.4,52.021203570981044,2
2020-10-15-170713,170713,0,0,1,312,2.4,65.53799192900956,3
2020-10-16-170713,170713,1,0,0,313,6.0,76.91678321602686,4
2020-10-17-170713,170713,1,0,0,314,3.4,79.01214286297295,5
2020-10-18-170713,170713,4,1,1,318,1.8,83.35163790202738,6
2020-10-19-170713,170713,4,0,0,322,5.2,89.64156281634328,0
2020-10-20-170713,170713,1,0,2,323,3.8,105.11574265197164,1
2020-10-21-170713,170713,1,0,1,324,3.0,102.38364525260162,2
2020-10-22-170713,170713,0,0,6,324,8.4,104.49009659839494,3
2020-10-23-170713,170713,1,0,3,325,4.0,116.13491984202565,4
2020-10-24-170713,170713,1,0,0,326,6.0,122.67840707030162,5
2020-10-25-170713,170713,1,1,0,327,5.0,116.89190384725984,6
2020-10-26-170713,170713,4,0,1,331,2.4,107.42016281087699,0
2020-10-27-170713,170713,1,0,1,332,7.8,110.86027771044519,1
2020-10-28-170713,170713,2,0,3,334,8.6,120.57186863932355,2
2020-10-29-170713,170713,1,0,0,335,10.6,125.07364872153272,3
2020-10-30-170713,170713,0,1,3,335,9.8,113.79017004059894,4
2020-10-31-170713,170713,0,0,0,335,6.2,122.38343233971372,5
2020-11-01-170713,170713,1,0,0,336,3.4,92.73888364306801,6
2020-11-02-170713,170713,0,0,0,336,2.8,117.75735066468356,0
2020-11-03-170713,170713,2,0,0,338,7.4,95.67773376202521,1
2020-11-04-170713,170713,1,0,0,339,5.2,108.03051428007609,2
2020-11-05-170713,170713,6,0,0,345,6.0,107.48933675645574,3
2020-11-06-170713,170713,3,0,0,348,10.2,125.25437563585218,4
2020-11-07-170713,170713,0,0,0,348,3.0,140.30850230920834,5
2020-11-08-170713,170713,0,0,0,348,0.8,131.30975932108666,6
2020-11-09-170713,170713,1,0,0,349,3.8,123.76716711246254,0
2020-11-10-170713,170713,1,0,0,350,3.8,88.462527820618,1
2020-11-11-170713,170713,3,3,0,353,3.0,89.99746520052602,2
2020-11-12-170713,170713,0,0,0,353,6.8,95.95037652169691,3
2020-11-13-170713,170713,3,0,0,356,6.8,98.57726813909376,4
2020-03-01-170714,170714,0,0,0,0,0.0,0.0,6
2020-03-02-170714,170714,0,0,0,0,0.0,13.501012931358847,0
2020-03-03-170714,170714,0,1,0,0,0.0,155.59923905390215,1
2020-03-04-170714,170714,0,0,0,0,0.25,226.83685899309216,2
2020-03-05-170714,170714,0,0,2,0,0.0,228.9470301966637,3
2020-03-06-170714,170714,0,0,2,0,0.25,218.05234459006383,4
2020-03-07-170714,170714,0,0,2,0,0.5,182.62951569731172,5
2020-03-08-170714,170714,0,0,4,0,0.0,199.97940923455027,6
2020-03-09-170714,170714,0,0,1,0,0.25,200.78838919887974,0
2020-03-10-170714,170714,0,0,7,0,0.75,114.39164663411034,1
2020-03-11-170714,170714,0,0,9,0,0.5,106.96088108196409,2
2020-03-12-170714,170714,0,0,10,0,2.0,84.89713601030431,3
2020-03-13-170714,170714,0,0,7,0,2.75,57.82565695011814,4
2020-03-14-170714,170714,0,0,11,0,3.75,46.66255893322725,5
2020-03-15-170714,170714,0,0,0,0,3.75,52.79968905977182,6
2020-03-16-170714,170714,0,1,8,0,9.25,33.09902166008136,0
2020-03-17-170714,170714,0,0,11,0,11.5,49.46375242135022,1
2020-03-18-170714,170714,0,0,1,0,13.75,69.50649365685601,2
2020-03-19-170714,170714,2,0,4,2,13.75,92.5722141776837,3
2020-03-20-170714,170714,2,0,9,4,14.0,108.921727077979,4
2020-03-21-170714,170714,2,0,0,6,9.0,131.4654013917126,5
2020-03-22-170714,170714,4,0,5,10,10.5,155.98241807616458,6
2020-03-23-170714,170714,1,0,1,11,20.5,192.66299497082056,0
2020-03-24-170714,170714,7,0,3,18,17.25,205.17138316025927,1
2020-03-25-170714,170714,9,0,5,27,16.5,243.96045907078567,2
2020-03-26-170714,170714,10,0,6,37,16.5,292.8705949859821,3
2020-03-27-170714,170714,7,0,1,44,16.25,365.7827803681328,4
2020-03-28-170714,170714,11,0,3,55,4.25,395.76516359821034,5
2020-03-29-170714,170714,0,0,0,55,6.0,437.9080380758289,6
2020-03-30-170714,170714,8,0,6,63,24.0,361.14531334171653,0
2020-03-31-170714,170714,11,0,4,74,9.25,362.786079754535,1
2020-04-01-170714,170714,1,0,1,75,13.5,84.42161073157037,2
2020-04-02-170714,170714,4,0,3,79,16.25,165.32299738695147,3
2020-04-03-170714,170714,9,0,2,88,8.75,173.8781497721633,4
2020-04-04-170714,170714,0,0,1,88,9.0,165.69762578079744,5
2020-04-05-170714,170714,5,0,3,93,3.75,161.3003628167196,6
2020-04-06-170714,170714,1,1,3,94,14.0,174.06109188837684,0
2020-04-07-170714,170714,3,0,3,97,5.25,173.3316460582796,1
2020-04-08-170714,170714,5,0,3,102,5.5,174.96513851446778,2
2020-04-09-170714,170714,6,0,3,108,3.0,195.23323309609577,3
2020-04-10-170714,170714,1,0,10,109,5.0,12.82295692849476,4
2020-04-11-170714,170714,3,0,1,112,4.5,19.729855634166032,5
2020-04-12-170714,170714,0,2,3,112,3.0,39.684267068010904,6
2020-04-13-170714,170714,6,0,2,118,10.5,43.43008670395691,0
2020-04-14-170714,170714,4,0,3,122,7.25,79.63749846791059,1
2020-04-15-170714,170714,1,0,2,123,9.5,107.54708094792717,2
2020-04-16-170714,170714,3,1,2,126,3.75,125.42427546470456,3
2020-04-17-170714,170714,2,0,1,128,2.0,141.68075264335104,4
2020-04-18-170714,170714,1,0,1,129,10.25,155.04227854615948,5
2020-04-19-170714,170714,3,0,2,132,7.25,149.25227579054177,6
2020-04-20-170714,170714,3,3,0,135,5.75,172.49800073993697,0
2020-04-21-170714,170714,3,0,1,138,3.75,164.9248999294654,1
2020-04-22-170714,170714,3,0,4,141,9.75,178.86092967850607,2
2020-04-23-170714,170714,3,0,1,144,2.25,186.11726902843412,3
2020-04-24-170714,170714,10,0,7,154,6.75,189.60449594343592,4
2020-04-25-170714,170714,1,0,1,155,1.25,247.24355248371353,5
2020-04-26-170714,170714,3,0,0,158,1.75,223.15521937365122,6
2020-04-27-170714,170714,2,0,3,160,5.0,202.33528423548412,0
2020-04-28-170714,170714,3,0,5,163,4.75,188.38033884124366,1
2020-04-29-170714,170714,2,0,2,165,13.5,186.43841054871925,2
2020-04-30-170714,170714,2,0,6,167,5.5,212.04419382996105,3
2020-05-01-170714,170714,1,0,3,168,1.0,182.42778467868172,4
2020-05-02-170714,170714,1,0,1,169,0.5,149.36478187068266,5
2020-05-03-170714,170714,2,0,2,171,0.0,202.41049995082858,6
2020-05-04-170714,170714,0,0,1,171,2.75,155.8489953012666,0
2020-05-05-170714,170714,1,0,2,172,5.75,146.74307966940515,1
2020-05-06-170714,170714,4,0,2,176,2.0,86.15431569384154,2
2020-05-07-170714,170714,1,0,3,177,4.5,101.24706183428776,3
2020-05-08-170714,170714,7,0,5,184,3.0,79.500655007509,4
2020-05-09-170714,170714,1,0,5,185,2.0,122.64591061540332,5
2020-05-10-170714,170714,0,0,3,185,1.25,198.5632632541425,6
2020-05-11-170714,170714,3,0,3,188,5.25,196.02106849507794,0
2020-05-12-170714,170714,5,0,2,193,4.25,177.85080361423445,1
2020-05-13-170714,170714,2,0,9,195,4.75,191.5033201339572,2
2020-05-14-170714,170714,6,0,2,201,3.75,198.7019071436226,3
2020-05-15-170714,170714,3,0,4,204,5.25,211.3963542050239,4
2020-05-16-170714,170714,1,0,0,205,3.25,184.45252597274555,5
2020-05-17-170714,170714,2,0,0,207,2.75,186.58048135094472,6
2020-05-18-170714,170714,1,0,2,208,5.25,200.88504527096273,0
2020-05-19-170714,170714,2,0,1,210,4.75,187.0336021275345,1
2020-05-20-170714,170714,2,0,1,212,5.0,144.37849317332726,2
2020-05-21-170714,170714,3,0,1,215,4.25,113.4701646322529,3
2020-05-22-170714,170714,5,0,0,220,5.0,104.42209118798364,4
2020-05-23-170714,170714,5,0,5,225,1.0,141.68040559535902,5
2020-05-24-170714,170714,3,0,0,228,2.5,155.49587421636508,6
2020-05-25-170714,170714,3,0,1,231,4.25,162.00488141656098,0
2020-05-26-170714,170714,2,0,1,233,4.75,174.50457865627982,1
2020-05-27-170714,170714,9,0,1,242,5.0,194.77426040191392,2
2020-05-28-170714,170714,2,0,0,244,2.0,249.66639628562683,3
2020-05-29-170714,170714,4,0,2,248,2.5,250.0627664104366,4
2020-05-30-170714,170714,0,0,0,248,0.75,221.70213960347775,5
2020-05-31-170714,170714,0,0,0,248,1.0,209.40634281867662,6
2020-06-01-170714,170714,2,1,0,250,1.75,147.03963789934497,0
2020-06-02-170714,170714,1,0,0,251,2.75,29.80662376763366,1
2020-06-03-170714,170714,1,0,2,252,2.25,25.10613258448447,2
2020-06-04-170714,170714,1,0,0,253,1.5,32.94709535474814,3
2020-06-05-170714,170714,0,0,0,253,1.5,42.92808048372631,4
2020-06-06-170714,170714,5,0,0,258,0.75,33.53767404350237,5
2020-06-07-170714,170714,0,2,0,258,0.5,75.07901490029464,6
2020-06-08-170714,170714,1,0,0,259,2.25,73.8043059962272,0
2020-06-09-170714,170714,1,0,0,260,2.25,70.0331176164826,1
2020-06-10-170714,170714,1,0,0,261,1.0,156.67176445821838,2
2020-06-11-170714,170714,0,0,0,261,1.0,164.13014857618288,3
2020-06-12-170714,170714,2,0,1,263,3.0,146.70683641132842,4
2020-06-13-170714,170714,0,0,0,263,0.5,132.15737560815234,5
2020-06-14-170714,170714,0,0,0,263,0.75,119.83843499097162,6
2020-06-15-170714,170714,0,0,1,263,1.75,67.8381134757327,0
2020-06-16-170714,170714,0,0,0,263,2.5,57.150707479310526,1
2020-06-17-170714,170714,2,0,0,265,2.25,45.94929717184509,2
2020-06-18-170714,170714,0,0,0,265,1.0,48.964631604456905,3
2020-06-19-170714,170714,0,0,0,265,2.0,47.88661197538564,4
2020-06-20-170714,170714,0,0,0,265,0.75,44.477896460538815,5
2020-06-21-170714,170714,0,0,0,265,0.25,41.195141505566234,6
2020-06-22-170714,170714,0,0,1,265,1.5,39.57452038113073,0
2020-06-23-170714,170714,0,2,0,265,2.0,40.0194991436443,1
2020-06-24-170714,170714,0,0,0,265,2.0,27.096380799663294,2
2020-06-25-170714,170714,0,1,1,265,2.25,26.82822467095576,3
2020-06-26-170714,170714,1,2,0,266,1.5,25.49770553506798,4
2020-06-27-170714,170714,0,0,0,266,0.5,21.798762708928265,5
2020-06-28-170714,170714,0,0,0,266,0.0,20.08596865790496,6
2020-06-29-170714,170714,1,0,0,267,0.5,19.847722000329806,0
2020-06-30-170714,170714,0,0,0,267,0.75,34.639428683403374,1
2020-07-01-170714,170714,0,0,0,267,0.5,73.55114745383234,2
2020-07-02-170714,170714,0,0,0,267,1.0,18.943147961542316,3
2020-07-03-170714,170714,0,0,0,267,0.75,19.369997294461747,4
2020-07-04-170714,170714,0,0,0,267,0.5,44.62746256450532,5
2020-07-05-170714,170714,0,0,0,267,0.0,46.84950314927291,6
2020-07-06-170714,170714,1,0,0,268,0.75,44.63957335769593,0
2020-07-07-170714,170714,0,1,1,268,0.5,49.56877112074304,1
2020-07-08-170714,170714,0,0,0,268,0.25,44.361361423491886,2
2020-07-09-170714,170714,1,0,0,269,1.75,44.50280369463205,3
2020-07-10-170714,170714,0,0,0,269,2.5,60.90768803257698,4
2020-07-11-170714,170714,0,1,1,269,0.5,49.82750976245648,5
2020-07-12-170714,170714,0,0,0,269,0.75,52.9995896734083,6
2020-07-13-170714,170714,0,0,0,269,0.5,30.274044008022898,0
2020-07-14-170714,170714,0,0,0,269,0.5,30.854487927723035,1
2020-07-15-170714,170714,0,0,0,269,2.75,24.519072883318472,2
2020-07-16-170714,170714,0,0,1,269,2.0,16.770351692651232,3
2020-07-17-170714,170714,0,0,3,269,1.0,24.55493902546427,4
2020-07-18-170714,170714,0,0,0,269,0.75,25.19177066433364,5
2020-07-19-170714,170714,0,0,1,269,0.75,20.386451491746673,6
2020-07-20-170714,170714,0,0,1,269,2.0,22.280130557941767,0
2020-07-21-170714,170714,1,0,0,270,1.0,32.258283712026326,1
2020-07-22-170714,170714,0,0,0,270,2.25,37.41156586504384,2
2020-07-23-170714,170714,0,0,0,270,2.0,35.27947390323001,3
2020-07-24-170714,170714,0,0,1,270,1.25,31.96138499548341,4
2020-07-25-170714,170714,1,0,0,271,0.75,31.904418688325226,5
2020-07-26-170714,170714,0,0,0,271,0.5,36.758699614417374,6
2020-07-27-170714,170714,0,1,0,271,1.0,32.99693274085498,0
2020-07-28-170714,170714,0,0,1,271,2.0,26.522528482790726,1
2020-07-29-170714,170714,0,0,0,271,1.25,20.613329212412104,2
2020-07-30-170714,170714,1,0,1,272,1.75,20.817626531363604,3
2020-07-31-170714,170714,3,0,1,275,2.25,29.457300740368673,4
2020-08-01-170714,170714,0,0,1,275,0.5,35.819413736068235,5
2020-08-02-170714,170714,1,0,1,276,1.5,80.50610719902893,6
2020-08-03-170714,170714,1,0,0,277,0.75,60.00547496165909,0
2020-08-04-170714,170714,0,0,2,277,1.0,47.02120341543962,1
2020-08-05-170714,170714,0,0,0,277,4.0,38.95178380861452,2
2020-08-06-170714,170714,0,0,0,277,2.0,36.48991786848835,3
2020-08-07-170714,170714,1,0,0,278,1.5,30.773519937452413,4
2020-08-08-170714,170714,0,0,1,278,1.5,44.207128077024464,5
2020-08-09-170714,170714,0,0,0,278,1.5,40.03474734820736,6
2020-08-10-170714,170714,0,0,1,278,1.25,23.642482813552615,0
2020-08-11-170714,170714,1,0,3,279,3.0,24.658713383800553,1
2020-08-12-170714,170714,0,0,2,279,2.25,36.96501511048931,2
2020-08-13-170714,170714,1,0,1,280,3.0,27.8800134009641,3
2020-08-14-170714,170714,1,0,0,281,2.0,52.05266809739026,4
2020-08-15-170714,170714,1,0,0,282,1.25,55.406467759005025,5
2020-08-16-170714,170714,1,0,0,283,0.5,56.608683728617365,6
2020-08-17-170714,170714,0,0,1,283,3.75,59.268619430313656,0
2020-08-18-170714,170714,2,0,5,285,1.75,62.66004757363361,1
2020-08-19-170714,170714,0,0,3,285,2.5,65.82918770509573,2
2020-08-20-170714,170714,0,0,6,285,3.75,54.69271822787681,3
2020-08-21-170714,170714,0,0,3,285,2.0,49.92507254882719,4
2020-08-22-170714,170714,1,0,3,286,3.5,46.01234014759142,5
2020-08-23-170714,170714,0,0,0,286,2.75,50.42947065446074,6
2020-08-24-170714,170714,1,0,2,287,4.25,48.956989457108946,0
2020-08-25-170714,170714,3,0,1,290,4.75,44.91836872729432,1
2020-08-26-170714,170714,2,0,0,292,3.0,46.23843879633808,2
2020-08-27-170714,170714,1,0,1,293,4.75,52.280132623751186,3
2020-08-28-170714,170714,0,0,4,293,3.0,56.426526901700925,4
2020-08-29-170714,170714,0,0,1,293,0.75,61.14714252409837,5
2020-08-30-170714,170714,0,0,0,293,1.5,59.028485455026654,6
2020-08-31-170714,170714,1,0,3,294,5.25,48.9131041489607,0
2020-09-01-170714,170714,5,0,0,299,2.25,37.244601286124066,1
2020-09-02-170714,170714,3,0,1,302,4.75,90.5887470260627,2
2020-09-03-170714,170714,6,0,4,308,3.25,83.2697364125138,3
2020-09-04-170714,170714,3,0,1,311,3.75,118.16104063975317,4
2020-09-05-170714,170714,3,0,0,314,1.0,117.48218955298077,5
2020-09-06-170714,170714,0,0,0,314,2.75,127.5839234091919,6
2020-09-07-170714,170714,2,0,1,316,4.5,131.74805334955684,0
2020-09-08-170714,170714,1,0,0,317,4.25,133.71806232410856,1
2020-09-09-170714,170714,0,0,1,317,3.5,127.56011024719614,2
2020-09-10-170714,170714,1,0,0,318,2.5,61.30838298222526,3
2020-09-11-170714,170714,4,0,0,322,4.75,72.42892929470172,4
2020-09-12-170714,170714,1,0,0,323,3.0,73.57204863943169,5
2020-09-13-170714,170714,0,0,0,323,0.25,84.98253310207014,6
2020-09-14-170714,170714,3,0,1,326,10.5,73.73888941590202,0
2020-09-15-170714,170714,0,0,2,326,3.75,99.4067046044668,1
2020-09-16-170714,170714,1,0,1,327,3.75,96.55156054777426,2
2020-09-17-170714,170714,4,0,2,331,5.25,70.15466510554467,3
2020-09-18-170714,170714,1,0,8,332,7.75,81.65476195459317,4
2020-09-19-170714,170714,0,0,0,332,4.0,84.32255848376457,5
2020-09-20-170714,170714,0,0,0,332,3.75,85.52502723635416,6
2020-09-21-170714,170714,1,0,1,333,6.25,67.1311736989876,0
2020-09-22-170714,170714,0,0,0,333,4.5,83.49462976009086,1
2020-09-23-170714,170714,1,0,0,334,6.0,88.2198095757604,2
2020-09-24-170714,170714,0,0,1,334,5.75,80.83198236842276,3
2020-09-25-170714,170714,0,0,7,334,6.75,73.56871169470732,4
2020-09-26-170714,170714,0,0,0,334,1.75,88.28862079418913,5
2020-09-27-170714,170714,0,0,2,334,2.25,79.83888802274538,6
2020-09-28-170714,170714,1,0,0,335,4.75,75.44360073220471,0
2020-09-29-170714,170714,2,0,7,337,2.5,66.29208666447192,1
2020-09-30-170714,170714,1,0,8,338,4.75,94.60026817984208,2
2020-10-01-170714,170714,2,0,1,340,4.0,0.0,3
2020-10-02-170714,170714,8,0,4,348,4.5,193.21241753668482,4
2020-10-03-170714,170714,0,1,4,348,1.5,115.4873800032057,5
2020-10-04-170714,170714,0,0,2,348,1.75,136.93413873061812,6
2020-10-05-170714,170714,1,0,7,349,2.5,129.63343273208176,0
2020-10-06-170714,170714,0,0,0,349,4.25,106.44720944760945,1
2020-10-07-170714,170714,0,1,5,349,2.25,98.70538230747856,2
2020-10-08-170714,170714,1,0,2,350,4.5,92.11571890049866,3
2020-10-09-170714,170714,7,0,2,357,3.75,108.58099326142298,4
2020-10-10-170714,170714,0,0,1,357,0.5,55.247652383858494,5
2020-10-11-170714,170714,2,0,3,359,1.5,55.42724059003179,6
2020-10-12-170714,170714,0,0,2,359,1.25,69.07251732176016,0
2020-10-13-170714,170714,7,0,5,366,3.0,67.84190688827775,1
2020-10-14-170714,170714,8,0,1,374,3.5,106.19858950045248,2
2020-10-15-170714,170714,1,0,0,375,3.0,156.4551722109114,3
2020-10-16-170714,170714,4,0,1,379,6.5,166.40675506721385,4
2020-10-17-170714,170714,4,0,6,383,0.5,127.9579773389424,5
2020-10-18-170714,170714,2,0,0,385,2.0,153.97605409647014,6
2020-10-19-170714,170714,7,0,3,392,4.0,158.97716533041077,0
2020-10-20-170714,170714,0,0,10,392,2.0,183.2869410533588,1
2020-10-21-170714,170714,5,0,0,397,2.5,139.06420777291783,2
2020-10-22-170714,170714,2,0,1,399,6.75,146.05676089243767,3
2020-10-23-170714,170714,2,0,4,401,2.25,153.2318532802656,4
2020-10-24-170714,170714,1,1,2,402,1.25,143.89588125487944,5
2020-10-25-170714,170714,3,0,0,405,2.0,131.3111896752871,6
2020-10-26-170714,170714,2,1,3,407,2.25,105.799342233896,0
2020-10-27-170714,170714,5,0,2,412,4.5,109.77331170430264,1
2020-10-28-170714,170714,1,0,0,413,4.25,141.56975104058867,2
2020-10-29-170714,170714,0,0,21,413,4.5,130.42723841690255,3
2020-10-30-170714,170714,1,1,6,414,6.0,102.91901370408004,4
2020-10-31-170714,170714,6,0,0,420,2.75,119.90799272441508,5
2020-11-01-170714,170714,0,0,0,420,1.25,125.75860268681701,6
2020-11-02-170714,170714,3,0,0,423,1.75,164.05332192762143,0
2020-11-03-170714,170714,10,0,0,433,4.0,158.4140789482889,1
2020-11-04-170714,170714,0,0,0,433,2.75,171.09285550088927,2
2020-11-05-170714,170714,1,0,0,434,4.25,164.26682523702812,3
2020-11-06-170714,170714,4,0,0,438,6.25,157.23409665048845,4
2020-11-07-170714,170714,2,0,0,440,0.75,173.28887167966266,5
2020-11-08-170714,170714,0,0,0,440,0.5,176.7828699314676,6
2020-11-09-170714,170714,3,0,0,443,3.75,157.84335939378303,0
2020-11-10-170714,170714,2,0,0,445,2.25,95.10955332773895,1
2020-11-11-170714,170714,0,0,0,445,3.5,110.81598038167402,2
2020-11-12-170714,170714,21,0,0,466,2.25,107.21360190316524,3
2020-11-13-170714,170714,6,2,0,472,4.25,225.49057467615197,4
2020-03-01-170715,170715,0,0,4,0,0.0,0.0,6
2020-03-02-170715,170715,0,0,9,0,0.0,48.65480146883604,0
2020-03-03-170715,170715,0,0,5,0,0.0,216.9964103123656,1
2020-03-04-170715,170715,0,1,18,0,0.0,271.6736320477732,2
2020-03-05-170715,170715,0,0,9,0,0.0,295.7089086349481,3
2020-03-06-170715,170715,0,0,14,0,0.5,277.5389268188835,4
2020-03-07-170715,170715,1,0,17,1,0.5,311.03725659412623,5
2020-03-08-170715,170715,0,0,9,1,0.0,318.0276267256533,6
2020-03-09-170715,170715,0,0,19,1,0.5,320.95531836933117,0
2020-03-10-170715,170715,0,0,25,1,0.0,147.6275973508004,1
2020-03-11-170715,170715,1,0,14,2,0.5,128.46720254274385,2
2020-03-12-170715,170715,1,0,20,3,2.0,103.87033085576283,3
2020-03-13-170715,170715,4,0,14,7,1.0,78.79548651583572,4
2020-03-14-170715,170715,3,0,5,10,1.5,87.44299342387832,5
2020-03-15-170715,170715,4,0,7,14,2.0,91.35578886506468,6
2020-03-16-170715,170715,9,0,49,23,10.0,76.99456326113872,0
2020-03-17-170715,170715,5,1,8,28,11.5,138.30911004831924,1
2020-03-18-170715,170715,18,0,19,46,11.5,178.63129621623503,2
2020-03-19-170715,170715,9,0,2,55,17.5,247.53907296611453,3
2020-03-20-170715,170715,14,0,9,69,13.0,267.0049644077635,4
2020-03-21-170715,170715,17,0,7,86,5.5,301.07758700910125,5
2020-03-22-170715,170715,9,0,4,95,15.5,320.8085399785036,6
2020-03-23-170715,170715,19,0,10,114,26.0,317.4181208142084,0
2020-03-24-170715,170715,25,0,4,139,21.0,377.1882252870418,1
2020-03-25-170715,170715,14,0,7,153,25.5,405.40097165105533,2
2020-03-26-170715,170715,20,0,5,173,23.5,423.4774056504865,3
2020-03-27-170715,170715,14,0,6,187,24.5,512.3159897167744,4
2020-03-28-170715,170715,5,0,9,192,8.5,524.565146935216,5
2020-03-29-170715,170715,7,0,0,199,6.0,494.92053038717756,6
2020-03-30-170715,170715,49,0,4,248,23.5,386.1057749391671,0
2020-03-31-170715,170715,8,0,1,256,16.0,429.8129746409144,1
2020-04-01-170715,170715,19,0,8,275,14.5,47.00286563101745,2
2020-04-02-170715,170715,2,0,5,277,31.5,207.58523330472187,3
2020-04-03-170715,170715,9,0,3,286,16.5,195.47781365147455,4
2020-04-04-170715,170715,7,0,2,293,14.0,212.51345137966058,5
2020-04-05-170715,170715,4,0,5,297,7.5,248.05588276665915,6
2020-04-06-170715,170715,10,0,11,307,21.0,251.05239494787608,0
2020-04-07-170715,170715,4,0,5,311,9.0,276.30061166038433,1
2020-04-08-170715,170715,7,0,4,318,9.5,280.5053020984897,2
2020-04-09-170715,170715,5,0,3,323,6.0,222.15690059016697,3
2020-04-10-170715,170715,6,0,6,329,7.5,71.50326309293902,4
2020-04-11-170715,170715,9,0,1,338,4.0,89.77620471862181,5
2020-04-12-170715,170715,0,0,4,338,5.5,106.88576460645731,6
2020-04-13-170715,170715,4,0,8,342,21.5,116.28075690481353,0
2020-04-14-170715,170715,1,0,6,343,13.5,153.90780665406209,1
2020-04-15-170715,170715,8,0,38,351,13.5,178.43313009728294,2
2020-04-16-170715,170715,5,0,0,356,6.5,215.87396928068287,3
2020-04-17-170715,170715,3,0,0,359,3.0,175.62010342382428,4
2020-04-18-170715,170715,2,0,1,361,20.0,174.37221706977073,5
2020-04-19-170715,170715,5,0,0,366,13.5,190.11825831347784,6
2020-04-20-170715,170715,11,0,4,377,7.5,224.28164126101817,0
2020-04-21-170715,170715,5,0,9,382,6.0,230.59788289086825,1
2020-04-22-170715,170715,4,0,1,386,18.5,212.09801622304235,2
2020-04-23-170715,170715,3,0,3,389,3.5,239.67715047094424,3
2020-04-24-170715,170715,6,0,1,395,14.5,235.93055654136953,4
2020-04-25-170715,170715,1,0,0,396,1.5,220.8601171992782,5
2020-04-26-170715,170715,4,0,0,400,2.5,195.62226523850393,6
2020-04-27-170715,170715,8,0,6,408,7.0,143.41549071331465,0
2020-04-28-170715,170715,6,0,3,414,6.5,139.6334333473222,1
2020-04-29-170715,170715,38,0,2,452,9.0,141.79842876226687,2
2020-04-30-170715,170715,0,0,2,452,11.5,217.32132483842474,3
2020-05-01-170715,170715,0,0,3,452,2.5,192.62760449302417,4
2020-05-02-170715,170715,1,0,5,453,0.5,105.02056195365105,5
2020-05-03-170715,170715,0,0,3,453,1.0,89.08957729585772,6
2020-05-04-170715,170715,4,0,1,457,3.0,67.85354526288468,0
2020-05-05-170715,170715,9,0,4,466,7.0,57.11726080666184,1
2020-05-06-170715,170715,1,0,1,467,5.5,63.027652708901854,2
2020-05-07-170715,170715,3,0,3,470,7.5,64.34459831719201,3
2020-05-08-170715,170715,1,0,2,471,9.0,77.05529910244093,4
2020-05-09-170715,170715,0,1,0,471,4.5,100.02787749434485,5
2020-05-10-170715,170715,0,0,3,471,2.5,207.35207757383304,6
2020-05-11-170715,170715,6,0,2,477,9.0,169.93493558985898,0
2020-05-12-170715,170715,3,1,3,480,9.0,187.31248852218184,1
2020-05-13-170715,170715,2,0,7,482,6.5,141.71793976902552,2
2020-05-14-170715,170715,2,0,1,484,8.5,138.48878241043272,3
2020-05-15-170715,170715,3,0,4,487,9.5,124.13231904325981,4
2020-05-16-170715,170715,5,0,1,492,4.0,133.225288580207,5
2020-05-17-170715,170715,3,0,3,495,5.0,147.59606679880324,6
2020-05-18-170715,170715,1,0,1,496,8.5,158.59939477286568,0
2020-05-19-170715,170715,4,0,4,500,8.0,153.0635206233364,1
2020-05-20-170715,170715,1,0,2,501,9.0,141.68703589701718,2
2020-05-21-170715,170715,3,0,1,504,8.5,142.03405544951022,3
2020-05-22-170715,170715,2,0,3,506,10.0,141.29399644881033,4
2020-05-23-170715,170715,0,0,2,506,4.5,151.49783099845058,5
2020-05-24-170715,170715,3,0,0,509,4.5,141.77456809329766,6
2020-05-25-170715,170715,2,0,2,511,9.0,133.13542447480748,0
2020-05-26-170715,170715,3,0,2,514,8.5,135.18795224423292,1
2020-05-27-170715,170715,7,0,2,521,10.0,161.5206132583673,2
2020-05-28-170715,170715,1,0,0,522,4.5,182.61751326262015,3
2020-05-29-170715,170715,4,1,3,526,4.5,172.25066710606478,4
2020-05-30-170715,170715,1,0,0,527,0.0,149.76194527717425,5
2020-05-31-170715,170715,3,0,0,530,0.0,139.88330563726447,6
2020-06-01-170715,170715,1,0,1,531,3.0,153.8030935685356,0
2020-06-02-170715,170715,4,0,4,535,3.0,70.31320918104659,1
2020-06-03-170715,170715,2,0,2,537,3.0,74.65106887948986,2
2020-06-04-170715,170715,1,0,1,538,1.0,55.694568719707775,3
2020-06-05-170715,170715,3,0,3,541,1.0,42.7496931660471,4
2020-06-06-170715,170715,2,0,0,543,3.0,42.708979765990826,5
2020-06-07-170715,170715,0,0,0,543,0.5,46.15068503162577,6
2020-06-08-170715,170715,2,0,1,545,4.0,48.217259221006486,0
2020-06-09-170715,170715,2,0,3,547,3.5,57.03820436929573,1
2020-06-10-170715,170715,2,0,7,549,1.5,140.8115131833057,2
2020-06-11-170715,170715,0,0,4,549,2.0,133.79092591572973,3
2020-06-12-170715,170715,3,0,2,552,4.0,98.18651973159545,4
2020-06-13-170715,170715,0,0,1,552,0.0,98.28563487680513,5
2020-06-14-170715,170715,0,0,0,552,0.0,71.0375858801025,6
2020-06-15-170715,170715,1,0,1,553,3.0,53.95680556426546,0
2020-06-16-170715,170715,4,0,2,557,3.0,55.33184222582403,1
2020-06-17-170715,170715,2,1,1,559,4.0,64.74149297618638,2
2020-06-18-170715,170715,1,0,0,560,1.5,72.02103363379936,3
2020-06-19-170715,170715,3,0,0,563,1.5,75.93675183368907,4
2020-06-20-170715,170715,0,0,0,563,1.0,101.72899053148885,5
2020-06-21-170715,170715,0,0,0,563,0.5,108.80383101331869,6
2020-06-22-170715,170715,1,0,0,564,2.0,100.3236910924509,0
2020-06-23-170715,170715,3,1,1,567,2.0,90.49319859261193,1
2020-06-24-170715,170715,7,0,0,574,0.5,96.93184053623291,2
2020-06-25-170715,170715,4,1,0,578,2.0,118.45686587596587,3
2020-06-26-170715,170715,2,0,2,580,2.5,122.94620585867429,4
2020-06-27-170715,170715,1,0,0,581,0.5,111.6089089655924,5
2020-06-28-170715,170715,0,0,2,581,0.0,117.28152132930514,6
2020-06-29-170715,170715,1,0,0,582,0.5,116.74646658631589,0
2020-06-30-170715,170715,2,0,0,584,0.5,109.33712287831422,1
2020-07-01-170715,170715,1,0,3,585,0.5,91.23527715440886,2
2020-07-02-170715,170715,0,0,3,585,1.5,57.335267038928,3
2020-07-03-170715,170715,0,0,0,585,1.0,95.9781547994196,4
2020-07-04-170715,170715,0,0,0,585,0.5,76.8748887052075,5
2020-07-05-170715,170715,0,0,0,585,0.0,75.2349924084784,6
2020-07-06-170715,170715,0,0,2,585,1.5,66.28318364186273,0
2020-07-07-170715,170715,1,0,0,586,0.5,50.65663116017389,1
2020-07-08-170715,170715,0,0,1,586,0.0,45.970964400469654,2
2020-07-09-170715,170715,0,0,4,586,2.5,43.22287192757574,3
2020-07-10-170715,170715,2,0,2,588,1.5,88.14604392331876,4
2020-07-11-170715,170715,0,0,2,588,0.5,90.438872276252,5
2020-07-12-170715,170715,2,0,2,590,0.5,77.13134515921206,6
2020-07-13-170715,170715,0,0,1,590,0.5,67.36803054749478,0
2020-07-14-170715,170715,0,0,3,590,0.5,70.13013047748888,1
2020-07-15-170715,170715,3,0,2,593,3.5,48.89295370014244,2
2020-07-16-170715,170715,3,1,2,596,2.5,44.6894821569099,3
2020-07-17-170715,170715,0,0,4,596,2.0,60.15808092283801,4
2020-07-18-170715,170715,0,0,1,596,0.5,58.47338059503011,5
2020-07-19-170715,170715,0,0,2,596,1.0,58.69468404008464,6
2020-07-20-170715,170715,2,0,0,598,0.5,63.43450978997337,0
2020-07-21-170715,170715,0,0,1,598,2.0,65.96397471154026,1
2020-07-22-170715,170715,1,0,7,599,3.0,55.542377078581154,2
2020-07-23-170715,170715,4,0,1,603,2.0,49.34900809522401,3
2020-07-24-170715,170715,2,0,1,605,1.0,65.14933886027961,4
2020-07-25-170715,170715,2,0,0,607,1.0,75.72572321077844,5
2020-07-26-170715,170715,2,0,1,609,0.0,80.59670807421031,6
2020-07-27-170715,170715,1,0,3,610,1.5,78.6074482702849,0
2020-07-28-170715,170715,3,0,6,613,2.5,83.56482655186372,1
2020-07-29-170715,170715,2,0,2,615,0.5,96.98176064072183,2
2020-07-30-170715,170715,2,0,5,617,2.0,74.88746067252224,3
2020-07-31-170715,170715,4,0,4,621,3.0,70.96662238377331,4
2020-08-01-170715,170715,1,0,2,622,0.5,40.09829077597214,5
2020-08-02-170715,170715,2,0,0,624,2.0,121.68944212450359,6
2020-08-03-170715,170715,0,0,2,624,1.5,149.28097320326683,0
2020-08-04-170715,170715,1,0,1,625,1.0,124.48827163463713,1
2020-08-05-170715,170715,7,0,3,632,3.5,103.0130025116143,2
2020-08-06-170715,170715,1,0,6,633,3.0,120.2838520497083,3
2020-08-07-170715,170715,1,0,1,634,2.5,112.06560922270756,4
2020-08-08-170715,170715,0,0,4,634,0.0,120.32630974640134,5
2020-08-09-170715,170715,1,0,4,635,0.5,115.35689160467633,6
2020-08-10-170715,170715,3,0,8,638,0.5,31.261440872710807,0
2020-08-11-170715,170715,6,0,3,644,2.5,46.20323275718579,1
2020-08-12-170715,170715,2,1,4,646,3.0,75.11794230430075,2
2020-08-13-170715,170715,5,0,3,651,3.5,81.29572850941588,3
2020-08-14-170715,170715,4,0,6,655,2.0,99.89979318124767,4
2020-08-15-170715,170715,2,0,0,657,1.0,116.09102561530756,5
2020-08-16-170715,170715,0,0,0,657,1.0,117.32149946307727,6
2020-08-17-170715,170715,2,0,1,659,6.0,116.19676412478175,0
2020-08-18-170715,170715,1,0,2,660,3.0,124.05322194122132,1
2020-08-19-170715,170715,3,0,9,663,2.0,111.32317748563761,2
2020-08-20-170715,170715,6,0,3,669,3.0,109.47048721589726,3
2020-08-21-170715,170715,1,0,8,670,2.5,123.76518946877397,4
2020-08-22-170715,170715,4,0,1,674,3.5,134.08985809993644,5
2020-08-23-170715,170715,4,0,5,678,2.0,161.45061964063555,6
2020-08-24-170715,170715,8,1,1,686,3.5,150.53820370623663,0
2020-08-25-170715,170715,3,0,3,689,8.0,158.5884349808137,1
2020-08-26-170715,170715,4,1,6,693,3.0,159.48852296930136,2
2020-08-27-170715,170715,3,0,3,696,7.0,170.50728565727238,3
2020-08-28-170715,170715,6,0,4,702,2.0,157.85132743055271,4
2020-08-29-170715,170715,0,0,3,702,1.5,163.14031230394102,5
2020-08-30-170715,170715,0,0,0,702,1.5,128.95039061304433,6
2020-08-31-170715,170715,1,0,10,703,5.5,109.4787778221257,0
2020-09-01-170715,170715,2,0,7,705,4.0,103.18402271567308,1
2020-09-02-170715,170715,9,0,3,714,3.5,185.98324333813775,2
2020-09-03-170715,170715,3,0,6,717,7.0,168.24068161619286,3
2020-09-04-170715,170715,8,0,11,725,3.5,157.52696541710898,4
2020-09-05-170715,170715,1,0,7,726,2.5,133.08690336788908,5
2020-09-06-170715,170715,5,0,4,731,0.5,138.37314504285825,6
2020-09-07-170715,170715,1,0,5,732,5.5,140.25587729278305,0
2020-09-08-170715,170715,3,0,2,735,5.5,135.01743537607877,1
2020-09-09-170715,170715,6,0,5,741,3.5,139.69434165537297,2
2020-09-10-170715,170715,3,0,9,744,4.0,86.80565375077518,3
2020-09-11-170715,170715,4,0,4,748,5.0,98.63416200728211,4
2020-09-12-170715,170715,3,0,0,751,3.0,84.9262078115486,5
2020-09-13-170715,170715,0,0,4,751,0.0,93.68352845873544,6
2020-09-14-170715,170715,10,0,0,761,11.0,80.6840316955817,0
2020-09-15-170715,170715,7,0,5,768,1.5,143.2072592783983,1
2020-09-16-170715,170715,3,0,2,771,3.5,154.0962357886114,2
2020-09-17-170715,170715,6,1,5,777,8.0,155.05632036652474,3
2020-09-18-170715,170715,11,0,6,788,5.5,173.6393615377652,4
2020-09-19-170715,170715,7,0,1,795,2.5,182.23529767941577,5
2020-09-20-170715,170715,4,1,3,799,5.5,199.18167837321207,6
2020-09-21-170715,170715,5,0,1,804,8.0,151.19307909016322,0
2020-09-22-170715,170715,2,0,2,806,3.0,167.47170338136348,1
2020-09-23-170715,170715,5,0,0,811,4.5,167.35180792554337,2
2020-09-24-170715,170715,9,0,7,820,6.0,149.72077192411126,3
2020-09-25-170715,170715,4,0,2,824,9.0,143.9323553873767,4
2020-09-26-170715,170715,0,0,0,824,1.0,163.34882508048912,5
2020-09-27-170715,170715,4,0,0,828,2.0,144.15941864968866,6
2020-09-28-170715,170715,0,0,0,828,7.0,148.54686614709127,0
2020-09-29-170715,170715,5,0,2,833,3.5,141.46720340059156,1
2020-09-30-170715,170715,2,0,7,835,3.5,158.81081171648353,2
2020-10-01-170715,170715,5,0,1,840,4.5,0.0,3
2020-10-02-170715,170715,6,0,12,846,10.0,194.1261114686994,4
2020-10-03-170715,170715,1,0,0,847,2.0,138.20953373946287,5
2020-10-04-170715,170715,3,0,0,850,1.5,165.48992592341472,6
2020-10-05-170715,170715,1,0,5,851,5.0,157.63479638920452,0
2020-10-06-170715,170715,2,0,3,853,5.0,141.23977380776438,1
2020-10-07-170715,170715,0,0,3,853,4.0,135.11636279935698,2
2020-10-08-170715,170715,7,0,3,860,4.5,119.85688344315726,3
2020-10-09-170715,170715,2,1,3,862,8.5,128.5489235575212,4
2020-10-10-170715,170715,0,0,0,862,1.0,9.005271682293046,5
2020-10-11-170715,170715,0,0,0,862,3.5,14.64012025327646,6
2020-10-12-170715,170715,0,0,4,862,2.0,26.09989710544943,0
2020-10-13-170715,170715,2,0,3,864,7.0,33.62380928243888,1
2020-10-14-170715,170715,7,0,4,871,7.0,53.54917962821678,2
2020-10-15-170715,170715,1,0,2,872,6.0,100.24980639542343,3
2020-10-16-170715,170715,12,0,8,884,8.5,133.23973474692832,4
2020-10-17-170715,170715,0,0,2,884,2.5,165.28630863401276,5
2020-10-18-170715,170715,0,0,0,884,3.0,166.5277139785911,6
2020-10-19-170715,170715,5,0,1,889,7.0,160.20212200523417,0
2020-10-20-170715,170715,3,0,3,892,2.0,179.10253666890623,1
2020-10-21-170715,170715,3,0,1,895,5.0,155.45481131784183,2
2020-10-22-170715,170715,3,0,2,898,11.5,144.95775679676137,3
2020-10-23-170715,170715,3,0,6,901,3.5,147.84385368507475,4
2020-10-24-170715,170715,0,0,2,901,2.0,152.44229106079896,5
2020-10-25-170715,170715,0,0,2,901,4.5,151.37525924101635,6
2020-10-26-170715,170715,4,0,3,905,1.5,131.42700853720928,0
2020-10-27-170715,170715,3,0,1,908,8.0,125.3813093999153,1
2020-10-28-170715,170715,4,0,3,912,5.0,133.41202123372773,2
2020-10-29-170715,170715,2,0,3,914,5.0,136.1085296758385,3
2020-10-30-170715,170715,8,0,0,922,8.0,113.7456023397995,4
2020-10-31-170715,170715,2,0,0,924,6.5,132.47779401163478,5
2020-11-01-170715,170715,0,0,0,924,2.0,92.72770460883297,6
2020-11-02-170715,170715,1,0,0,925,3.5,112.31622669095836,0
2020-11-03-170715,170715,3,0,0,928,10.5,99.66138721023594,1
2020-11-04-170715,170715,1,0,0,929,4.0,103.52670029302323,2
2020-11-05-170715,170715,2,0,0,931,5.0,94.43660736759291,3
2020-11-06-170715,170715,6,0,0,937,9.0,100.02836035721978,4
2020-11-07-170715,170715,2,0,0,939,1.5,112.03830780033013,5
2020-11-08-170715,170715,2,0,0,941,0.0,98.74475976998394,6
2020-11-09-170715,170715,3,0,0,944,7.0,91.91036610871268,0
2020-11-10-170715,170715,1,0,0,945,3.5,70.05507933861593,1
2020-11-11-170715,170715,3,0,0,948,4.0,69.20932832008691,2
2020-11-12-170715,170715,3,0,0,951,13.5,74.09402605505193,3
2020-11-13-170715,170715,0,0,0,951,8.5,70.0955408809219,4
2020-03-01-170716,170716,0,0,0,0,0.0,0.0,6
2020-03-02-170716,170716,0,0,0,0,0.0,0.005318585881539842,0
2020-03-03-170716,170716,0,0,0,0,0.16666666666666666,0.025850990013868747,1
2020-03-04-170716,170716,0,0,1,0,0.0,0.02662150901986194,2
2020-03-05-170716,170716,0,0,0,0,0.0,0.02951759701868361,3
2020-03-06-170716,170716,0,0,0,0,0.0,7.378940786859607,4
2020-03-07-170716,170716,0,0,0,0,0.16666666666666666,5.712419955749538,5
2020-03-08-170716,170716,0,0,0,0,0.0,4.590646759887857,6
2020-03-09-170716,170716,0,0,0,0,0.3333333333333333,4.551072782790159,0
2020-03-10-170716,170716,0,1,3,0,0.16666666666666666,6.55097745068938,1
2020-03-11-170716,170716,0,0,3,0,0.16666666666666666,5.5059615445396535,2
2020-03-12-170716,170716,0,1,6,0,0.16666666666666666,3.985930543718365,3
2020-03-13-170716,170716,0,0,1,0,0.5,0.02938317742916764,4
2020-03-14-170716,170716,0,0,3,0,0.8333333333333334,0.021598657525557285,5
2020-03-15-170716,170716,0,0,2,0,1.0,0.01807278431171972,6
2020-03-16-170716,170716,0,2,3,0,4.333333333333333,0.008002731429771601,0
2020-03-17-170716,170716,0,0,2,0,1.8333333333333333,0.012754563595949061,1
2020-03-18-170716,170716,1,0,2,1,5.5,0.017970659559841083,2
2020-03-19-170716,170716,0,0,3,1,9.0,0.02632076687530224,3
2020-03-20-170716,170716,0,0,1,1,5.666666666666668,0.03239194376664578,4
2020-03-21-170716,170716,0,0,4,1,4.166666666666667,0.0345430674888231,5
2020-03-22-170716,170716,0,0,2,1,7.333333333333332,0.035843742063275126,6
2020-03-23-170716,170716,0,0,1,1,9.833333333333334,0.034927771418423695,0
2020-03-24-170716,170716,3,0,3,4,8.833333333333334,0.04511365938295751,1
2020-03-25-170716,170716,3,0,0,7,6.666666666666668,0.04751305643230738,2
2020-03-26-170716,170716,6,0,0,13,5.333333333333333,0.04904569150498735,3
2020-03-27-170716,170716,1,0,1,14,11.0,0.05676540111984146,4
2020-03-28-170716,170716,3,0,1,17,5.666666666666668,0.05890263621988413,5
2020-03-29-170716,170716,2,1,0,19,2.1666666666666665,0.05851387176407809,6
2020-03-30-170716,170716,3,0,0,22,7.5,0.042543022178113406,0
2020-03-31-170716,170716,2,0,0,24,5.0,0.03970545419806614,1
2020-04-01-170716,170716,2,0,1,26,6.5,0.007126162914455455,2
2020-04-02-170716,170716,3,0,1,29,3.333333333333333,0.026662785212724575,3
2020-04-03-170716,170716,1,0,0,30,3.333333333333333,0.009231833060185952,4
2020-04-04-170716,170716,4,0,0,34,2.1666666666666665,0.010697471725057164,5
2020-04-05-170716,170716,2,0,0,36,2.833333333333333,0.011775118755358251,6
2020-04-06-170716,170716,1,0,0,37,2.6666666666666665,0.011064344567164774,0
2020-04-07-170716,170716,3,1,12,40,5.833333333333332,0.012309103792027267,1
2020-04-08-170716,170716,0,0,1,40,3.0,0.015396252293376073,2
2020-04-09-170716,170716,0,0,1,40,5.0,0.017396861865901957,3
2020-04-10-170716,170716,1,0,0,41,0.5,0.006424171001315826,4
2020-04-11-170716,170716,1,0,0,42,1.0,0.007279041141761749,5
2020-04-12-170716,170716,0,0,0,42,1.0,0.008115185517042463,6
2020-04-13-170716,170716,0,0,0,42,3.0,0.009201958473612791,0
2020-04-14-170716,170716,0,0,1,42,2.0,0.013111233640866094,1
2020-04-15-170716,170716,1,0,0,43,2.6666666666666665,0.023882975549721467,2
2020-04-16-170716,170716,1,0,0,44,1.5,0.025732806797800316,3
2020-04-17-170716,170716,0,0,0,44,1.8333333333333333,0.02284977457547644,4
2020-04-18-170716,170716,0,0,0,44,3.5,0.030164837051816162,5
2020-04-19-170716,170716,0,0,0,44,0.5,0.029682122767205207,6
2020-04-20-170716,170716,0,0,0,44,1.8333333333333333,0.028883838204498004,0
2020-04-21-170716,170716,12,0,0,56,4.833333333333333,0.019977030250233292,1
2020-04-22-170716,170716,1,0,0,57,1.6666666666666667,0.018768740418730955,2
2020-04-23-170716,170716,1,0,1,58,1.0,0.018376141854003346,3
2020-04-24-170716,170716,0,0,1,58,2.6666666666666665,0.011558701129283889,4
2020-04-25-170716,170716,0,0,0,58,1.0,0.013636124541552577,5
2020-04-26-170716,170716,0,0,0,58,3.0,0.012659323020265697,6
2020-04-27-170716,170716,0,0,1,58,5.0,0.011237802051994672,0
2020-04-28-170716,170716,1,0,1,59,2.833333333333333,0.010669464676704977,1
2020-04-29-170716,170716,0,0,0,59,2.333333333333333,0.010541569148605398,2
2020-04-30-170716,170716,0,0,0,59,2.1666666666666665,0.015005931977704251,3
2020-05-01-170716,170716,0,0,1,59,0.5,4.873644442629537,4
2020-05-02-170716,170716,0,0,0,59,0.0,5.661235571492934,5
2020-05-03-170716,170716,0,0,0,59,0.16666666666666666,5.052173088263306,6
2020-05-04-170716,170716,0,0,0,59,1.1666666666666667,3.5373825644022237,0
2020-05-05-170716,170716,0,0,1,59,1.1666666666666667,5.60530551304393,1
2020-05-06-170716,170716,0,0,0,59,0.5,3.8786476650854205,2
2020-05-07-170716,170716,1,0,0,60,1.8333333333333333,3.8072705600388037,3
2020-05-08-170716,170716,1,0,0,61,2.0,3.2688084297977085,4
2020-05-09-170716,170716,0,0,0,61,0.6666666666666666,2.519947960467304,5
2020-05-10-170716,170716,0,1,0,61,0.3333333333333333,6.3266840871816665,6
2020-05-11-170716,170716,1,0,0,62,1.5,5.428241493489869,0
2020-05-12-170716,170716,1,0,0,63,1.3333333333333333,0.021582005730184487,1
2020-05-13-170716,170716,0,0,0,63,1.3333333333333333,0.017238533194609537,2
2020-05-14-170716,170716,0,0,0,63,2.6666666666666665,0.015204894843382609,3
2020-05-15-170716,170716,1,0,0,64,2.5,0.011680823523154225,4
2020-05-16-170716,170716,0,0,0,64,0.5,0.011027968050429025,5
2020-05-17-170716,170716,0,0,0,64,0.6666666666666666,0.010631268277816977,6
2020-05-18-170716,170716,0,0,0,64,2.5,0.01026203400682738,0
2020-05-19-170716,170716,1,0,0,65,2.0,0.01155377308715698,1
2020-05-20-170716,170716,0,0,0,65,2.5,0.009947191449558053,2
2020-05-21-170716,170716,0,0,0,65,1.3333333333333333,0.011462636232246462,3
2020-05-22-170716,170716,0,0,0,65,2.833333333333333,0.011292665795399077,4
2020-05-23-170716,170716,0,0,0,65,1.0,0.012411834644206395,5
2020-05-24-170716,170716,0,0,0,65,1.1666666666666667,0.012796656774558825,6
2020-05-25-170716,170716,0,0,0,65,2.833333333333333,0.009638950068189815,0
2020-05-26-170716,170716,0,0,0,65,1.5,0.010140420522776823,1
2020-05-27-170716,170716,0,2,0,65,4.333333333333333,0.012468636816942595,2
2020-05-28-170716,170716,0,0,0,65,1.5,0.01094529525261475,3
2020-05-29-170716,170716,0,0,0,65,0.6666666666666666,0.010613573118383568,4
2020-05-30-170716,170716,0,0,0,65,0.0,0.011583773671170807,5
2020-05-31-170716,170716,0,0,0,65,0.16666666666666666,0.01182378789831058,6
2020-06-01-170716,170716,0,0,0,65,0.8333333333333334,0.015884906549095128,0
2020-06-02-170716,170716,0,0,0,65,1.3333333333333333,0.0038184685678999217,1
2020-06-03-170716,170716,0,1,0,65,1.0,0.004116247287018632,2
2020-06-04-170716,170716,0,0,3,65,1.3333333333333333,0.005774579624750929,3
2020-06-05-170716,170716,0,1,1,65,0.8333333333333334,0.0057914382333286284,4
2020-06-06-170716,170716,0,0,0,65,0.16666666666666666,0.005676628517934998,5
2020-06-07-170716,170716,0,0,0,65,0.5,0.0058573566824312,6
2020-06-08-170716,170716,0,0,0,65,1.1666666666666667,0.005850790370140914,0
2020-06-09-170716,170716,0,0,0,65,0.5,0.006447015915798799,1
2020-06-10-170716,170716,0,0,0,65,0.5,0.01689405609667049,2
2020-06-11-170716,170716,0,0,0,65,0.16666666666666666,0.012930577722987998,3
2020-06-12-170716,170716,0,0,0,65,0.5,0.011723617908617433,4
2020-06-13-170716,170716,0,1,0,65,0.5,0.00936336340362436,5
2020-06-14-170716,170716,0,0,0,65,0.16666666666666666,0.007086530330844115,6
2020-06-15-170716,170716,0,0,0,65,0.0,0.003958385420517134,0
2020-06-16-170716,170716,0,0,0,65,1.0,0.003978718973256318,1
2020-06-17-170716,170716,0,0,0,65,0.5,0.0031386999213715025,2
2020-06-18-170716,170716,3,0,0,68,1.0,0.002853403237301522,3
2020-06-19-170716,170716,1,0,0,69,1.8333333333333333,0.00241479454612469,4
2020-06-20-170716,170716,0,0,0,69,0.16666666666666666,0.0073319775839493775,5
2020-06-21-170716,170716,0,0,0,69,0.0,0.007972520786516986,6
2020-06-22-170716,170716,0,0,0,69,0.5,0.00688470621778304,0
2020-06-23-170716,170716,0,0,0,69,0.6666666666666666,0.0073170921993563195,1
2020-06-24-170716,170716,0,0,0,69,0.5,0.008261052533665943,2
2020-06-25-170716,170716,0,0,0,69,0.6666666666666666,0.008815660607300557,3
2020-06-26-170716,170716,0,0,0,69,0.6666666666666666,0.007943212308869813,4
2020-06-27-170716,170716,0,0,0,69,0.16666666666666666,0.005234965695948089,5
2020-06-28-170716,170716,0,0,0,69,0.16666666666666666,0.004716561013466938,6
2020-06-29-170716,170716,0,0,0,69,0.5,0.004727509411576864,0
2020-06-30-170716,170716,0,0,0,69,0.8333333333333334,0.005414039788574368,1
2020-07-01-170716,170716,0,0,1,69,0.3333333333333333,0.00612351436232852,2
2020-07-02-170716,170716,0,0,0,69,0.5,0.0022597547516682477,3
2020-07-03-170716,170716,0,0,0,69,1.0,0.00937302690666275,4
2020-07-04-170716,170716,0,0,0,69,0.16666666666666666,0.016643520695230334,5
2020-07-05-170716,170716,0,0,0,69,0.0,0.016274487953752206,6
2020-07-06-170716,170716,0,0,0,69,0.6666666666666666,0.014710018807612019,0
2020-07-07-170716,170716,0,0,0,69,0.3333333333333333,0.012872387449389386,1
2020-07-08-170716,170716,0,2,0,69,0.8333333333333334,0.011904970674387314,2
2020-07-09-170716,170716,0,0,0,69,0.6666666666666666,0.011778450976788063,3
2020-07-10-170716,170716,0,0,0,69,0.6666666666666666,0.005423643030901478,4
2020-07-11-170716,170716,0,0,1,69,0.5,0.005563555974608895,5
2020-07-12-170716,170716,0,0,0,69,0.16666666666666666,0.004794278065999528,6
2020-07-13-170716,170716,0,0,0,69,0.3333333333333333,0.00468777132018715,0
2020-07-14-170716,170716,0,0,0,69,0.5,0.004880154680849784,1
2020-07-15-170716,170716,1,0,0,70,1.0,0.0037979907879956377,2
2020-07-16-170716,170716,0,0,0,70,2.0,0.0031535355407577258,3
2020-07-17-170716,170716,0,0,0,70,0.3333333333333333,0.002803605513402189,4
2020-07-18-170716,170716,0,0,0,70,0.3333333333333333,0.001915036119395341,5
2020-07-19-170716,170716,0,0,0,70,0.0,0.0021641897338627114,6
2020-07-20-170716,170716,0,0,0,70,0.8333333333333334,0.0025053569775287613,0
2020-07-21-170716,170716,0,0,0,70,0.3333333333333333,0.0029516290663296487,1
2020-07-22-170716,170716,0,0,0,70,1.3333333333333333,0.0038984701006242383,2
2020-07-23-170716,170716,0,0,0,70,0.5,0.003999737737028166,3
2020-07-24-170716,170716,0,0,0,70,0.5,0.004795813158752665,4
2020-07-25-170716,170716,1,0,0,71,0.16666666666666666,0.005183738690726464,5
2020-07-26-170716,170716,0,0,1,71,0.0,0.0055478832007800705,6
2020-07-27-170716,170716,0,0,1,71,0.3333333333333333,0.0060344216456198205,0
2020-07-28-170716,170716,0,0,1,71,0.5,0.0070745869771512955,1
2020-07-29-170716,170716,0,0,2,71,1.1666666666666667,0.008068201306224355,2
2020-07-30-170716,170716,0,0,2,71,1.6666666666666667,0.008755140692142855,3
2020-07-31-170716,170716,0,0,1,71,0.8333333333333334,0.013402238434364474,4
2020-08-01-170716,170716,0,0,2,71,0.8333333333333334,0.006951838839874706,5
2020-08-02-170716,170716,0,0,2,71,0.0,0.08559859593375947,6
2020-08-03-170716,170716,0,0,0,71,0.5,0.04184624361683848,0
2020-08-04-170716,170716,0,0,3,71,0.5,0.04711930791498872,1
2020-08-05-170716,170716,0,0,5,71,0.5,0.050914232037350036,2
2020-08-06-170716,170716,0,0,0,71,0.5,0.059185598960740035,3
2020-08-07-170716,170716,0,0,2,71,1.0,0.07459166203218835,4
2020-08-08-170716,170716,0,0,0,71,1.6666666666666667,0.08243020852849384,5
2020-08-09-170716,170716,1,0,0,72,1.1666666666666667,0.07568474045995355,6
2020-08-10-170716,170716,1,0,1,73,1.1666666666666667,0.005856737712759843,0
2020-08-11-170716,170716,1,0,1,74,2.5,0.026064011539260364,1
2020-08-12-170716,170716,2,0,0,76,2.333333333333333,0.04188489263696211,2
2020-08-13-170716,170716,2,0,3,78,3.333333333333333,0.048428835720937695,3
2020-08-14-170716,170716,1,0,1,79,5.166666666666667,0.05214421963674243,4
2020-08-15-170716,170716,2,0,0,81,2.5,0.06312806435177704,5
2020-08-16-170716,170716,2,0,0,83,1.6666666666666667,0.0680314251753149,6
2020-08-17-170716,170716,0,0,0,83,4.833333333333333,0.06805783143647569,0
2020-08-18-170716,170716,3,0,0,86,6.833333333333332,0.06850954361732521,1
2020-08-19-170716,170716,5,0,0,91,4.166666666666667,0.06526006279853114,2
2020-08-20-170716,170716,0,0,0,91,4.5,0.06167149815684655,3
2020-08-21-170716,170716,2,0,0,93,3.6666666666666665,0.06070929215444909,4
2020-08-22-170716,170716,0,0,1,93,0.3333333333333333,0.06323086415796364,5
2020-08-23-170716,170716,0,0,0,93,0.6666666666666666,0.06498706670593783,6
2020-08-24-170716,170716,1,0,0,94,2.6666666666666665,0.049250686838621764,0
2020-08-25-170716,170716,1,0,0,95,2.333333333333333,0.04186578571229141,1
2020-08-26-170716,170716,0,0,0,95,2.833333333333333,0.03754704518940812,2
2020-08-27-170716,170716,3,0,0,98,3.333333333333333,0.044062191787754404,3
2020-08-28-170716,170716,1,0,0,99,3.0,0.04030992459675067,4
2020-08-29-170716,170716,0,0,0,99,2.333333333333333,0.037899131950314496,5
2020-08-30-170716,170716,0,0,0,99,1.3333333333333333,0.046818483208077334,6
2020-08-31-170716,170716,0,0,1,99,3.333333333333333,0.044542908192189604,0
2020-09-01-170716,170716,0,0,0,99,3.8333333333333335,0.07965314578692909,1
2020-09-02-170716,170716,0,1,2,99,1.6666666666666667,0.04429637454771189,2
2020-09-03-170716,170716,0,0,0,99,4.333333333333333,0.033812031639122365,3
2020-09-04-170716,170716,0,0,1,99,6.0,0.03651240637864467,4
2020-09-05-170716,170716,1,0,1,100,2.1666666666666665,0.033544344227414806,5
2020-09-06-170716,170716,0,0,2,100,4.0,0.03286719361178363,6
2020-09-07-170716,170716,0,0,1,100,1.5,0.036666123133497174,0
2020-09-08-170716,170716,0,0,2,100,5.166666666666667,0.03619006264405385,1
2020-09-09-170716,170716,0,0,3,100,4.666666666666667,0.03620458888135688,2
2020-09-10-170716,170716,0,0,2,100,4.166666666666667,0.07496255347208544,3
2020-09-11-170716,170716,0,0,3,100,7.0,0.07918321219329431,4
2020-09-12-170716,170716,0,0,0,100,1.8333333333333333,0.07783979321509829,5
2020-09-13-170716,170716,0,0,0,100,0.6666666666666666,0.060325788831174974,6
2020-09-14-170716,170716,1,0,1,101,3.6666666666666665,0.051647613738474374,0
2020-09-15-170716,170716,0,0,0,101,4.666666666666667,0.04663494472667461,1
2020-09-16-170716,170716,2,0,0,103,5.833333333333332,0.04606356705036652,2
2020-09-17-170716,170716,0,0,0,103,3.6666666666666665,0.049893935895032854,3
2020-09-18-170716,170716,1,0,0,104,3.8333333333333335,0.044724804219885915,4
2020-09-19-170716,170716,1,0,0,105,1.8333333333333333,0.03679228091774201,5
2020-09-20-170716,170716,2,1,0,107,1.3333333333333333,0.03771109097154152,6
2020-09-21-170716,170716,1,0,0,108,5.333333333333333,0.03801844845494104,0
2020-09-22-170716,170716,2,0,0,110,5.833333333333332,0.03690941473233991,1
2020-09-23-170716,170716,3,0,1,113,5.333333333333333,0.037415996201924914,2
2020-09-24-170716,170716,2,0,0,115,2.0,0.034099457891523924,3
2020-09-25-170716,170716,3,0,0,118,6.0,0.03433723272596988,4
2020-09-26-170716,170716,0,0,0,118,1.5,0.036005435238487246,5
2020-09-27-170716,170716,0,0,1,118,1.5,0.036115134486562436,6
2020-09-28-170716,170716,1,0,0,119,2.6666666666666665,0.03361263663988172,0
2020-09-29-170716,170716,0,0,2,119,5.166666666666667,0.032300405571946536,1
2020-09-30-170716,170716,0,0,0,119,2.333333333333333,0.03507070520111787,2
2020-10-01-170716,170716,0,0,0,119,2.1666666666666665,0.0,3
2020-10-02-170716,170716,0,0,0,119,3.333333333333333,0.06073148961586857,4
2020-10-03-170716,170716,0,0,0,119,0.3333333333333333,0.07850796080833747,5
2020-10-04-170716,170716,0,0,0,119,1.5,0.07959342659953159,6
2020-10-05-170716,170716,0,0,0,119,2.333333333333333,0.0692406923178541,0
2020-10-06-170716,170716,0,0,0,119,2.833333333333333,0.06393232717332634,1
2020-10-07-170716,170716,1,1,1,120,1.8333333333333333,0.05468016187383524,2
2020-10-08-170716,170716,0,0,0,120,3.8333333333333335,0.05033741557545154,3
2020-10-09-170716,170716,0,0,3,120,3.6666666666666665,0.05590595334975993,4
2020-10-10-170716,170716,0,0,1,120,2.1666666666666665,0.005737739526377446,5
2020-10-11-170716,170716,1,0,1,121,0.8333333333333334,0.008910597424748735,6
2020-10-12-170716,170716,0,0,0,121,1.8333333333333333,0.012884945542027822,0
2020-10-13-170716,170716,2,0,1,123,2.333333333333333,0.01836986909746746,1
2020-10-14-170716,170716,0,0,0,123,3.8333333333333335,0.025677134499630872,2
2020-10-15-170716,170716,0,0,1,123,2.833333333333333,0.03542838376601519,3
2020-10-16-170716,170716,0,0,1,123,4.833333333333333,0.044797663112174084,4
2020-10-17-170716,170716,0,0,0,123,2.6666666666666665,0.04684464899376521,5
2020-10-18-170716,170716,0,0,0,123,2.833333333333333,0.045567629023399434,6
2020-10-19-170716,170716,0,0,0,123,3.1666666666666665,0.04816418133305388,0
2020-10-20-170716,170716,0,0,0,123,4.166666666666667,0.054326224023922925,1
2020-10-21-170716,170716,1,0,0,124,5.0,0.05302491557390038,2
2020-10-22-170716,170716,0,0,0,124,3.6666666666666665,0.05501862535052407,3
2020-10-23-170716,170716,3,0,2,127,5.166666666666667,0.055432243090764804,4
2020-10-24-170716,170716,1,0,0,128,2.0,0.06298374145294806,5
2020-10-25-170716,170716,1,0,0,129,1.1666666666666667,0.0611821070079261,6
2020-10-26-170716,170716,0,0,0,129,4.5,0.05259913768289047,0
2020-10-27-170716,170716,1,0,0,130,3.1666666666666665,0.05973964849685253,1
2020-10-28-170716,170716,0,0,4,130,5.666666666666668,0.061623430963012676,2
2020-10-29-170716,170716,1,0,0,131,4.166666666666667,0.0652908510618448,3
2020-10-30-170716,170716,1,0,4,132,7.166666666666668,0.06057536216379522,4
2020-10-31-170716,170716,0,0,0,132,2.333333333333333,0.0700162102899965,5
2020-11-01-170716,170716,0,0,0,132,1.3333333333333333,0.046431884733663914,6
2020-11-02-170716,170716,0,0,0,132,1.6666666666666667,0.05472417360128301,0
2020-11-03-170716,170716,0,0,0,132,5.5,0.04629105427435377,1
2020-11-04-170716,170716,0,0,0,132,4.0,0.05851053723372679,2
2020-11-05-170716,170716,0,0,0,132,7.5,0.06079524655082228,3
2020-11-06-170716,170716,2,0,0,134,6.0,0.06915225345876946,4
2020-11-07-170716,170716,0,0,0,134,2.833333333333333,0.07335316428016501,5
2020-11-08-170716,170716,0,0,0,134,3.0,0.07153967596283435,6
2020-11-09-170716,170716,0,0,0,134,2.5,0.07045246700130066,0
2020-11-10-170716,170716,0,0,0,134,4.166666666666667,0.0441901128211097,1
2020-11-11-170716,170716,4,0,0,138,3.5,0.04984105032434348,2
2020-11-12-170716,170716,0,0,0,138,3.1666666666666665,0.056561173781891246,3
2020-11-13-170716,170716,4,0,0,142,5.333333333333333,0.06177639323665045,4
2020-03-01-170801,170801,0,0,0,0,0.0,0.0,6
2020-03-02-170801,170801,0,0,0,0,0.0,5.158650843644227,0
2020-03-03-170801,170801,0,0,1,0,0.0,17.453611946133513,1
2020-03-04-170801,170801,0,0,0,0,0.0,19.404866534332193,2
2020-03-05-170801,170801,0,1,2,0,0.3333333333333333,20.77828557547621,3
2020-03-06-170801,170801,0,0,0,0,0.0,15.516554325500962,4
2020-03-07-170801,170801,0,0,1,0,0.3333333333333333,16.0272429861376,5
2020-03-08-170801,170801,0,0,0,0,0.0,17.3609128903723,6
2020-03-09-170801,170801,0,0,0,0,0.6666666666666666,16.89812862004711,0
2020-03-10-170801,170801,0,1,0,0,0.0,68.3786677597356,1
2020-03-11-170801,170801,0,0,2,0,0.6666666666666666,64.38901625617686,2
2020-03-12-170801,170801,0,0,0,0,1.0,51.04038797034302,3
2020-03-13-170801,170801,0,0,2,0,0.3333333333333333,50.708997064106015,4
2020-03-14-170801,170801,0,0,0,0,0.3333333333333333,36.94670319467688,5
2020-03-15-170801,170801,0,0,0,0,0.3333333333333333,23.636866177285704,6
2020-03-16-170801,170801,0,0,1,0,2.6666666666666665,10.319618276930852,0
2020-03-17-170801,170801,1,0,0,1,3.0,20.016913188299466,1
2020-03-18-170801,170801,0,0,0,1,4.0,23.64165602077881,2
2020-03-19-170801,170801,2,0,1,3,1.6666666666666667,33.0586634310245,3
2020-03-20-170801,170801,0,0,0,3,2.6666666666666665,30.56586784050137,4
2020-03-21-170801,170801,1,0,0,4,1.3333333333333333,36.45003498050675,5
2020-03-22-170801,170801,0,0,0,4,0.6666666666666666,38.16951054586238,6
2020-03-23-170801,170801,0,0,0,4,4.0,31.254905775818386,0
2020-03-24-170801,170801,0,0,0,4,4.333333333333333,36.23324137370601,1
2020-03-25-170801,170801,2,0,0,6,2.6666666666666665,33.615231077145424,2
2020-03-26-170801,170801,0,0,0,6,4.0,34.746691328864934,3
2020-03-27-170801,170801,2,0,0,8,5.333333333333333,41.28832962220025,4
2020-03-28-170801,170801,0,0,1,8,1.3333333333333333,44.446956704384704,5
2020-03-29-170801,170801,0,0,0,8,0.6666666666666666,43.423354046105956,6
2020-03-30-170801,170801,1,0,1,9,3.6666666666666665,33.86606948939703,0
2020-03-31-170801,170801,0,0,1,9,3.333333333333333,31.486671606454976,1
2020-04-01-170801,170801,0,0,1,9,9.333333333333334,5.937998779379377,2
2020-04-02-170801,170801,1,0,0,10,2.333333333333333,31.1157583898311,3
2020-04-03-170801,170801,0,0,0,10,1.0,15.454761861260522,4
2020-04-04-170801,170801,0,0,1,10,1.3333333333333333,15.237572329881854,5
2020-04-05-170801,170801,0,2,0,10,1.3333333333333333,16.487980061269624,6
2020-04-06-170801,170801,0,0,0,10,3.6666666666666665,17.127481195709436,0
2020-04-07-170801,170801,0,0,1,10,5.0,18.271125694970124,1
2020-04-08-170801,170801,0,1,2,10,3.333333333333333,24.806580419398017,2
2020-04-09-170801,170801,0,0,1,10,3.333333333333333,27.640218655780316,3
2020-04-10-170801,170801,0,0,0,10,1.0,10.503103508338665,4
2020-04-11-170801,170801,1,0,0,11,1.3333333333333333,12.553839694173186,5
2020-04-12-170801,170801,0,0,0,11,0.6666666666666666,14.74362786766998,6
2020-04-13-170801,170801,1,0,0,12,4.333333333333333,16.239558184988233,0
2020-04-14-170801,170801,1,0,1,13,6.333333333333332,21.603594807108195,1
2020-04-15-170801,170801,1,0,0,14,1.0,29.997086049511452,2
2020-04-16-170801,170801,0,0,0,14,7.333333333333332,33.50253682418933,3
2020-04-17-170801,170801,0,0,2,14,1.0,33.903738153353466,4
2020-04-18-170801,170801,1,0,1,15,3.6666666666666665,35.50433505793778,5
2020-04-19-170801,170801,0,0,0,15,0.6666666666666666,39.262410277594554,6
2020-04-20-170801,170801,0,0,1,15,13.666666666666664,38.52637452815997,0
2020-04-21-170801,170801,1,0,0,16,0.3333333333333333,49.97443936793866,1
2020-04-22-170801,170801,2,0,0,18,3.0,49.602492509623644,2
2020-04-23-170801,170801,1,0,0,19,0.0,45.10908723496656,3
2020-04-24-170801,170801,0,0,0,19,2.0,43.40601180197926,4
2020-04-25-170801,170801,0,0,1,19,1.0,42.66390241447019,5
2020-04-26-170801,170801,0,0,0,19,0.0,43.58154855183956,6
2020-04-27-170801,170801,0,0,0,19,2.333333333333333,40.47013568181176,0
2020-04-28-170801,170801,1,0,6,20,1.3333333333333333,23.77099364079741,1
2020-04-29-170801,170801,0,0,1,20,0.3333333333333333,24.684099155042887,2
2020-04-30-170801,170801,0,0,0,20,1.3333333333333333,24.065345074455287,3
2020-05-01-170801,170801,2,0,0,22,0.3333333333333333,46.75754089193808,4
2020-05-02-170801,170801,1,0,0,23,0.6666666666666666,16.973757641431668,5
2020-05-03-170801,170801,0,1,0,23,0.0,13.072445157462278,6
2020-05-04-170801,170801,1,0,1,24,3.333333333333333,11.48298878048241,0
2020-05-05-170801,170801,0,0,1,24,2.6666666666666665,13.656287858485445,1
2020-05-06-170801,170801,0,0,0,24,3.0,17.71812907688544,2
2020-05-07-170801,170801,0,0,1,24,2.0,17.972359386250435,3
2020-05-08-170801,170801,0,0,0,24,2.333333333333333,22.47575443615761,4
2020-05-09-170801,170801,1,0,0,25,0.0,27.410574814641194,5
2020-05-10-170801,170801,0,1,0,25,0.3333333333333333,46.9399470650199,6
2020-05-11-170801,170801,0,1,0,25,1.6666666666666667,41.47541512600683,0
2020-05-12-170801,170801,6,1,1,31,2.6666666666666665,40.15642602422233,1
2020-05-13-170801,170801,1,0,0,32,2.6666666666666665,37.924032462092654,2
2020-05-14-170801,170801,0,0,0,32,0.6666666666666666,30.713523986070136,3
2020-05-15-170801,170801,0,0,0,32,2.6666666666666665,25.782973816589216,4
2020-05-16-170801,170801,0,0,0,32,0.3333333333333333,20.73339716454044,5
2020-05-17-170801,170801,0,0,1,32,0.3333333333333333,18.951836126780385,6
2020-05-18-170801,170801,1,0,0,33,1.3333333333333333,18.525888193632525,0
2020-05-19-170801,170801,1,0,0,34,1.6666666666666667,18.28790323643443,1
2020-05-20-170801,170801,0,0,0,34,0.3333333333333333,13.500452103651877,2
2020-05-21-170801,170801,1,0,0,35,1.3333333333333333,13.533659357072635,3
2020-05-22-170801,170801,0,0,0,35,0.6666666666666666,13.228305371586652,4
2020-05-23-170801,170801,0,0,0,35,0.0,16.255597593404328,5
2020-05-24-170801,170801,0,0,0,35,1.3333333333333333,16.37466355639308,6
2020-05-25-170801,170801,0,0,0,35,1.6666666666666667,15.171006948975194,0
2020-05-26-170801,170801,1,0,0,36,2.0,14.61497854789881,1
2020-05-27-170801,170801,0,0,0,36,0.0,15.490586617337753,2
2020-05-28-170801,170801,0,0,0,36,2.0,14.35636595904516,3
2020-05-29-170801,170801,0,0,0,36,0.6666666666666666,16.96055418195129,4
2020-05-30-170801,170801,0,0,0,36,1.0,14.975134881129406,5
2020-05-31-170801,170801,1,0,0,37,0.0,15.262674047816535,6
2020-06-01-170801,170801,0,0,0,37,0.3333333333333333,27.940788486856484,0
2020-06-02-170801,170801,0,0,0,37,1.0,11.899709487953466,1
2020-06-03-170801,170801,0,0,0,37,0.6666666666666666,8.254898800599877,2
2020-06-04-170801,170801,0,0,0,37,0.3333333333333333,9.207872451148113,3
2020-06-05-170801,170801,0,0,0,37,0.3333333333333333,9.417058943005092,4
2020-06-06-170801,170801,0,1,0,37,0.3333333333333333,5.059613797327737,5
2020-06-07-170801,170801,0,0,0,37,0.6666666666666666,5.316291115933913,6
2020-06-08-170801,170801,0,0,0,37,1.0,5.345945418592007,0
2020-06-09-170801,170801,0,0,0,37,1.0,6.341665391912906,1
2020-06-10-170801,170801,0,0,0,37,1.3333333333333333,28.047969575642334,2
2020-06-11-170801,170801,0,0,0,37,0.3333333333333333,24.621669077350596,3
2020-06-12-170801,170801,0,0,0,37,0.6666666666666666,20.99134134667362,4
2020-06-13-170801,170801,0,0,0,37,1.6666666666666667,16.390298710709654,5
2020-06-14-170801,170801,0,0,0,37,0.3333333333333333,13.007616574411408,6
2020-06-15-170801,170801,0,0,0,37,0.3333333333333333,8.962391108106655,0
2020-06-16-170801,170801,0,0,0,37,1.0,10.84249488481167,1
2020-06-17-170801,170801,0,0,0,37,2.0,11.73920321058383,2
2020-06-18-170801,170801,0,0,0,37,0.3333333333333333,12.76471899072466,3
2020-06-19-170801,170801,0,0,1,37,0.6666666666666666,12.54794855555111,4
2020-06-20-170801,170801,0,1,0,37,0.0,11.875540344428705,5
2020-06-21-170801,170801,0,0,0,37,0.0,11.800533039216301,6
2020-06-22-170801,170801,0,0,0,37,0.3333333333333333,9.858519697834767,0
2020-06-23-170801,170801,0,0,0,37,0.3333333333333333,8.958672584443839,1
2020-06-24-170801,170801,0,0,0,37,0.0,5.5694281373311,2
2020-06-25-170801,170801,0,0,0,37,0.3333333333333333,4.85168976679231,3
2020-06-26-170801,170801,0,0,0,37,1.0,4.2431243655025845,4
2020-06-27-170801,170801,0,0,0,37,0.3333333333333333,9.113490550861854,5
2020-06-28-170801,170801,0,0,0,37,0.6666666666666666,9.716177149740574,6
2020-06-29-170801,170801,0,0,0,37,0.0,10.620068719255551,0
2020-06-30-170801,170801,0,0,0,37,0.0,10.791280110450483,1
2020-07-01-170801,170801,0,0,0,37,0.3333333333333333,9.979298538684723,2
2020-07-02-170801,170801,0,0,0,37,0.3333333333333333,6.9902339593164795,3
2020-07-03-170801,170801,1,0,0,38,0.0,16.31331128054035,4
2020-07-04-170801,170801,0,0,0,38,0.0,9.463376147319496,5
2020-07-05-170801,170801,0,0,0,38,0.0,8.361370180409152,6
2020-07-06-170801,170801,0,0,1,38,0.0,7.406084850580319,0
2020-07-07-170801,170801,0,0,0,38,0.3333333333333333,8.043136556224677,1
2020-07-08-170801,170801,0,0,0,38,1.0,6.662829690057682,2
2020-07-09-170801,170801,0,0,0,38,0.3333333333333333,7.101460363595215,3
2020-07-10-170801,170801,0,0,0,38,0.3333333333333333,10.771428083157305,4
2020-07-11-170801,170801,0,0,0,38,0.0,9.434065307307527,5
2020-07-12-170801,170801,0,0,0,38,0.0,8.027654941606343,6
2020-07-13-170801,170801,0,0,0,38,0.6666666666666666,7.402759864336893,0
2020-07-14-170801,170801,0,0,0,38,0.3333333333333333,7.561246432515527,1
2020-07-15-170801,170801,0,0,0,38,0.6666666666666666,7.061195814145899,2
2020-07-16-170801,170801,0,0,0,38,1.0,5.472077325581067,3
2020-07-17-170801,170801,0,0,0,38,0.0,6.881406069067756,4
2020-07-18-170801,170801,0,0,0,38,0.0,7.244746718029351,5
2020-07-19-170801,170801,0,0,0,38,0.0,7.774692436287003,6
2020-07-20-170801,170801,1,0,0,39,0.0,8.35581842578987,0
2020-07-21-170801,170801,0,0,0,39,0.6666666666666666,10.085832239368832,1
2020-07-22-170801,170801,0,0,0,39,0.3333333333333333,9.78182511039712,2
2020-07-23-170801,170801,0,0,0,39,0.6666666666666666,11.090529300593593,3
2020-07-24-170801,170801,0,0,0,39,0.3333333333333333,19.59371420248139,4
2020-07-25-170801,170801,0,0,0,39,0.3333333333333333,20.484867374498055,5
2020-07-26-170801,170801,0,0,0,39,0.3333333333333333,23.684394803943512,6
2020-07-27-170801,170801,0,0,0,39,0.3333333333333333,21.70081489058022,0
2020-07-28-170801,170801,0,0,0,39,0.0,20.509010983161343,1
2020-07-29-170801,170801,0,0,0,39,1.0,19.051019015698063,2
2020-07-30-170801,170801,0,0,6,39,0.6666666666666666,10.88350297807546,3
2020-07-31-170801,170801,0,0,10,39,1.0,10.415528719470911,4
2020-08-01-170801,170801,0,0,0,39,1.6666666666666667,7.788404357984902,5
2020-08-02-170801,170801,0,0,0,39,0.0,69.12086597760333,6
2020-08-03-170801,170801,0,0,0,39,0.6666666666666666,27.12816598003484,0
2020-08-04-170801,170801,0,0,2,39,1.3333333333333333,32.657884683565555,1
2020-08-05-170801,170801,0,0,1,39,4.333333333333333,32.84624741495554,2
2020-08-06-170801,170801,0,0,0,39,4.333333333333333,29.039768800692592,3
2020-08-07-170801,170801,0,1,1,39,1.0,36.52667664953257,4
2020-08-08-170801,170801,0,0,0,39,1.0,37.61608375168928,5
2020-08-09-170801,170801,0,0,0,39,0.6666666666666666,36.299516121537216,6
2020-08-10-170801,170801,0,0,0,39,0.6666666666666666,7.1182436043464214,0
2020-08-11-170801,170801,0,0,0,39,2.0,12.930828754251904,1
2020-08-12-170801,170801,0,0,0,39,1.6666666666666667,21.14678371070411,2
2020-08-13-170801,170801,6,0,1,45,0.0,33.77922636862277,3
2020-08-14-170801,170801,10,0,1,55,3.333333333333333,44.14107217292502,4
2020-08-15-170801,170801,0,0,1,55,0.3333333333333333,67.86080879110779,5
2020-08-16-170801,170801,0,0,1,55,1.3333333333333333,69.54971085535459,6
2020-08-17-170801,170801,0,0,2,55,0.3333333333333333,74.78606344939095,0
2020-08-18-170801,170801,2,0,0,57,2.6666666666666665,68.79602053306371,1
2020-08-19-170801,170801,1,0,1,58,2.0,73.60026357045092,2
2020-08-20-170801,170801,0,0,0,58,0.3333333333333333,57.31978063016646,3
2020-08-21-170801,170801,1,0,1,59,0.3333333333333333,33.1415236822009,4
2020-08-22-170801,170801,0,0,1,59,1.0,35.002703295072045,5
2020-08-23-170801,170801,0,0,0,59,0.6666666666666666,30.036826165568776,6
2020-08-24-170801,170801,0,0,0,59,1.3333333333333333,30.166581921113742,0
2020-08-25-170801,170801,0,0,0,59,0.6666666666666666,20.330730268172143,1
2020-08-26-170801,170801,0,0,1,59,1.6666666666666667,14.428471365792067,2
2020-08-27-170801,170801,1,0,1,60,2.333333333333333,16.769791095030673,3
2020-08-28-170801,170801,1,0,0,61,1.0,28.382015753264785,4
2020-08-29-170801,170801,1,0,0,62,0.0,28.532141708531114,5
2020-08-30-170801,170801,1,0,0,63,0.3333333333333333,28.68456584594975,6
2020-08-31-170801,170801,2,0,0,65,2.0,25.94899168919961,0
2020-09-01-170801,170801,0,0,0,65,1.6666666666666667,37.106847777103255,1
2020-09-02-170801,170801,1,0,0,66,0.3333333333333333,18.9982219893547,2
2020-09-03-170801,170801,0,0,0,66,1.3333333333333333,28.61030707097955,3
2020-09-04-170801,170801,1,0,0,67,2.333333333333333,28.654959984073574,4
2020-09-05-170801,170801,1,0,0,68,1.6666666666666667,29.267643224558757,5
2020-09-06-170801,170801,0,0,0,68,1.6666666666666667,25.509830380052954,6
2020-09-07-170801,170801,0,0,0,68,0.6666666666666666,29.013929498806206,0
2020-09-08-170801,170801,0,0,0,68,0.3333333333333333,28.330819685451708,1
2020-09-09-170801,170801,1,0,0,69,3.0,26.71567433495329,2
2020-09-10-170801,170801,1,0,0,70,1.0,29.91503714776606,3
2020-09-11-170801,170801,0,0,2,70,1.3333333333333333,32.824137425954866,4
2020-09-12-170801,170801,0,0,2,70,3.0,31.053889714570857,5
2020-09-13-170801,170801,0,0,0,70,0.0,28.9128644659917,6
2020-09-14-170801,170801,0,0,0,70,3.0,27.344806653161992,0
2020-09-15-170801,170801,0,0,0,70,0.3333333333333333,29.11036447907804,1
2020-09-16-170801,170801,0,0,0,70,1.6666666666666667,25.27158726602087,2
2020-09-17-170801,170801,0,0,0,70,0.3333333333333333,23.964581690023227,3
2020-09-18-170801,170801,0,0,1,70,1.6666666666666667,21.849557046947556,4
2020-09-19-170801,170801,0,0,0,70,0.0,20.940899131185937,5
2020-09-20-170801,170801,0,0,0,70,1.6666666666666667,17.134614207152808,6
2020-09-21-170801,170801,0,0,3,70,1.6666666666666667,16.15223675051044,0
2020-09-22-170801,170801,0,1,0,70,1.0,22.798380494062247,1
2020-09-23-170801,170801,0,1,1,70,2.6666666666666665,23.543400464141772,2
2020-09-24-170801,170801,0,0,1,70,2.333333333333333,25.782207461141894,3
2020-09-25-170801,170801,2,0,0,72,0.6666666666666666,27.090921937539008,4
2020-09-26-170801,170801,2,0,1,74,1.3333333333333333,30.803891513229118,5
2020-09-27-170801,170801,0,0,0,74,0.0,34.43509971924313,6
2020-09-28-170801,170801,0,0,0,74,0.6666666666666666,30.7327603556134,0
2020-09-29-170801,170801,0,0,0,74,0.0,24.94406220921348,1
2020-09-30-170801,170801,0,1,1,74,1.6666666666666667,20.974065367255395,2
2020-10-01-170801,170801,0,0,1,74,0.3333333333333333,0.0,3
2020-10-02-170801,170801,1,0,5,75,0.0,71.89052076792636,4
2020-10-03-170801,170801,0,0,4,75,0.0,56.212872351902305,5
2020-10-04-170801,170801,0,0,1,75,0.0,48.365620811920266,6
2020-10-05-170801,170801,3,0,1,78,0.6666666666666666,41.67338158074463,0
2020-10-06-170801,170801,0,0,0,78,1.3333333333333333,38.5177728046993,1
2020-10-07-170801,170801,1,0,0,79,0.6666666666666666,28.770179774486778,2
2020-10-08-170801,170801,1,2,3,80,1.0,25.028661051688367,3
2020-10-09-170801,170801,0,0,3,80,1.6666666666666667,29.69857381242681,4
2020-10-10-170801,170801,1,0,3,81,1.3333333333333333,1.010786156529054,5
2020-10-11-170801,170801,0,0,1,81,2.0,4.6104905275359584,6
2020-10-12-170801,170801,0,0,1,81,1.0,7.952755925409157,0
2020-10-13-170801,170801,0,0,1,81,3.6666666666666665,9.732953013632304,1
2020-10-14-170801,170801,1,0,5,82,1.0,18.90288395932603,2
2020-10-15-170801,170801,1,0,1,83,2.6666666666666665,22.0677123444502,3
2020-10-16-170801,170801,5,0,4,88,7.333333333333332,26.74684522913634,4
2020-10-17-170801,170801,4,0,1,92,14.666666666666664,47.01452731996825,5
2020-10-18-170801,170801,1,0,1,93,3.333333333333333,72.07181863148162,6
2020-10-19-170801,170801,1,0,1,94,2.0,75.2030885180754,0
2020-10-20-170801,170801,0,0,1,94,2.333333333333333,70.96694801477184,1
2020-10-21-170801,170801,0,0,0,94,5.333333333333333,72.31490627106588,2
2020-10-22-170801,170801,3,0,0,97,3.6666666666666665,77.45283124459829,3
2020-10-23-170801,170801,3,0,0,100,5.666666666666668,65.46584473912255,4
2020-10-24-170801,170801,3,0,2,103,2.333333333333333,46.67409519784562,5
2020-10-25-170801,170801,1,0,0,104,3.333333333333333,47.20454521875315,6
2020-10-26-170801,170801,1,0,2,105,3.0,48.90484404052332,0
2020-10-27-170801,170801,1,0,1,106,2.333333333333333,56.35970619901731,1
2020-10-28-170801,170801,5,0,0,111,4.0,58.79243038554928,2
2020-10-29-170801,170801,1,0,4,112,2.6666666666666665,67.11915196698283,3
2020-10-30-170801,170801,4,0,5,116,3.6666666666666665,54.14962421846568,4
2020-10-31-170801,170801,1,0,0,117,3.333333333333333,54.63211671548086,5
2020-11-01-170801,170801,1,0,0,118,1.6666666666666667,24.669308698857755,6
2020-11-02-170801,170801,1,0,0,119,3.333333333333333,85.9724310667915,0
2020-11-03-170801,170801,1,1,0,120,3.6666666666666665,75.83597389632475,1
2020-11-04-170801,170801,0,0,0,120,2.333333333333333,65.89666672064048,2
2020-11-05-170801,170801,0,0,0,120,5.333333333333333,65.91178711897695,3
2020-11-06-170801,170801,0,1,0,120,4.333333333333333,73.06621775377931,4
2020-11-07-170801,170801,2,1,0,122,5.333333333333333,63.93804253062956,5
2020-11-08-170801,170801,0,0,0,122,8.333333333333334,64.91143107905891,6
2020-11-09-170801,170801,2,0,0,124,6.0,68.75157653984189,0
2020-11-10-170801,170801,1,1,0,125,4.0,20.613364837599917,1
2020-11-11-170801,170801,0,1,0,125,6.0,30.553294656714108,2
2020-11-12-170801,170801,4,0,0,129,5.0,45.82330000790257,3
2020-11-13-170801,170801,5,0,0,134,2.0,58.86589326602357,4
2020-03-01-170802,170802,0,0,1,0,0.0,0.0,6
2020-03-02-170802,170802,0,0,7,0,0.0,37.69560609368495,0
2020-03-03-170802,170802,0,0,8,0,0.25,194.66205539550245,1
2020-03-04-170802,170802,0,0,5,0,0.0,198.8568736494911,2
2020-03-05-170802,170802,0,0,10,0,0.25,212.75985945843098,3
2020-03-06-170802,170802,0,0,16,0,0.0,198.51818422614937,4
2020-03-07-170802,170802,0,0,5,0,0.25,219.96782378443302,5
2020-03-08-170802,170802,0,0,7,0,0.0,218.4484489331304,6
2020-03-09-170802,170802,1,0,25,1,0.5,219.2949146472384,0
2020-03-10-170802,170802,0,1,21,1,0.0,230.2684259925577,1
2020-03-11-170802,170802,1,0,15,2,0.5,197.56539542487383,2
2020-03-12-170802,170802,2,0,11,4,0.25,146.67960774635873,3
2020-03-13-170802,170802,1,0,8,5,0.0,127.99609119377106,4
2020-03-14-170802,170802,3,0,2,8,0.0,92.86556429576595,5
2020-03-15-170802,170802,1,0,5,9,0.5,70.32980566238436,6
2020-03-16-170802,170802,7,0,20,16,2.0,58.612800194127225,0
2020-03-17-170802,170802,8,0,6,24,2.0,114.8046596331036,1
2020-03-18-170802,170802,5,0,16,29,3.0,164.95504295647385,2
2020-03-19-170802,170802,10,0,16,39,1.25,192.49277593878037,3
2020-03-20-170802,170802,16,0,8,55,2.25,224.69501092377828,4
2020-03-21-170802,170802,5,0,1,60,1.25,281.9035313165311,5
2020-03-22-170802,170802,7,1,3,67,0.5,291.55582971809514,6
2020-03-23-170802,170802,25,0,8,92,3.25,275.0423560587881,0
2020-03-24-170802,170802,21,0,2,113,2.75,351.3340800536618,1
2020-03-25-170802,170802,15,0,5,128,1.75,419.24833312185467,2
2020-03-26-170802,170802,11,0,6,139,3.75,448.4591037773303,3
2020-03-27-170802,170802,8,0,25,147,5.25,517.6132387133232,4
2020-03-28-170802,170802,2,0,1,149,1.25,504.30842525120397,5
2020-03-29-170802,170802,5,0,0,154,0.5,492.6884240814155,6
2020-03-30-170802,170802,20,0,5,174,3.25,355.8972639765732,0
2020-03-31-170802,170802,6,0,8,180,3.25,355.7240537452735,1
2020-04-01-170802,170802,16,0,16,196,8.0,48.456842020927894,2
2020-04-02-170802,170802,16,0,34,212,2.25,363.1352856695111,3
2020-04-03-170802,170802,8,0,5,220,1.0,85.20824892803032,4
2020-04-04-170802,170802,1,0,2,221,1.5,95.82471336371864,5
2020-04-05-170802,170802,3,0,0,224,1.25,102.22443803310922,6
2020-04-06-170802,170802,8,0,5,232,3.5,111.99943967168886,0
2020-04-07-170802,170802,2,0,2,234,3.0,152.81466698375095,1
2020-04-08-170802,170802,5,0,4,239,3.0,169.74574404130112,2
2020-04-09-170802,170802,6,0,0,245,3.75,184.56314067669535,3
2020-04-10-170802,170802,25,0,4,270,0.75,96.63524146912505,4
2020-04-11-170802,170802,1,0,1,271,2.75,198.9885865578823,5
2020-04-12-170802,170802,0,0,2,271,0.5,211.76464350149183,6
2020-04-13-170802,170802,5,0,2,276,3.5,218.98972862538517,0
2020-04-14-170802,170802,8,0,0,284,6.0,247.74681673040055,1
2020-04-15-170802,170802,16,0,2,300,1.25,309.03380909737086,2
2020-04-16-170802,170802,34,0,3,334,6.25,383.63082861441285,3
2020-04-17-170802,170802,5,0,2,339,0.75,454.4455446816042,4
2020-04-18-170802,170802,2,0,9,341,2.75,386.99678137923013,5
2020-04-19-170802,170802,0,0,4,341,0.5,392.65629851008623,6
2020-04-20-170802,170802,5,1,4,346,10.5,446.87460065172286,0
2020-04-21-170802,170802,2,0,9,348,0.25,440.2070812731904,1
2020-04-22-170802,170802,4,0,5,352,2.0,378.28893801863893,2
2020-04-23-170802,170802,0,0,1,352,0.5,233.71777366937113,3
2020-04-24-170802,170802,4,0,2,356,3.75,209.92382511919428,4
2020-04-25-170802,170802,1,0,2,357,1.0,239.7394873088349,5
2020-04-26-170802,170802,2,0,2,359,0.5,248.46303291586116,6
2020-04-27-170802,170802,2,0,6,361,1.75,161.70740313831112,0
2020-04-28-170802,170802,0,0,1,361,1.0,119.59141844868992,1
2020-04-29-170802,170802,2,0,3,363,0.5,109.71499706005939,2
2020-04-30-170802,170802,3,0,4,366,0.75,134.1309990354458,3
2020-05-01-170802,170802,2,0,3,368,0.5,201.83491862400527,4
2020-05-02-170802,170802,9,0,3,377,0.75,86.5198456202604,5
2020-05-03-170802,170802,4,0,0,381,0.0,96.77133516925188,6
2020-05-04-170802,170802,4,0,1,385,2.25,91.38579665265237,0
2020-05-05-170802,170802,9,0,1,394,2.0,77.2168350832128,1
2020-05-06-170802,170802,5,0,2,399,2.75,113.70002310299343,2
2020-05-07-170802,170802,1,0,1,400,2.0,129.2707979043734,3
2020-05-08-170802,170802,2,0,2,402,1.5,131.55921729163646,4
2020-05-09-170802,170802,2,0,2,404,0.25,140.71398429205283,5
2020-05-10-170802,170802,2,0,0,406,0.0,225.51344932798838,6
2020-05-11-170802,170802,6,0,3,412,1.25,216.65148853950052,0
2020-05-12-170802,170802,1,1,6,413,1.25,234.59178011942595,1
2020-05-13-170802,170802,3,0,1,416,2.75,183.1582337212726,2
2020-05-14-170802,170802,4,0,3,420,0.5,183.39675351709616,3
2020-05-15-170802,170802,3,0,2,423,1.5,168.9127051273635,4
2020-05-16-170802,170802,3,0,0,426,0.25,137.11484947367688,5
2020-05-17-170802,170802,0,0,0,426,0.0,137.9301630356162,6
2020-05-18-170802,170802,1,1,0,427,1.0,127.08051149871706,0
2020-05-19-170802,170802,1,0,1,428,1.5,99.042510159787,1
2020-05-20-170802,170802,2,0,0,430,0.25,137.1149202126549,2
2020-05-21-170802,170802,1,0,1,431,0.25,126.18479344223033,3
2020-05-22-170802,170802,2,0,0,433,0.5,113.90015839360639,4
2020-05-23-170802,170802,2,0,0,435,0.0,117.65885583213125,5
2020-05-24-170802,170802,0,0,1,435,1.0,132.27511499815597,6
2020-05-25-170802,170802,3,0,0,438,1.5,124.04448353395537,0
2020-05-26-170802,170802,6,0,1,444,1.5,140.11288410494444,1
2020-05-27-170802,170802,1,3,1,445,0.25,121.79261418279745,2
2020-05-28-170802,170802,3,0,1,448,2.25,118.26411215806047,3
2020-05-29-170802,170802,2,0,6,450,0.5,142.4186670400286,4
2020-05-30-170802,170802,0,0,0,450,0.75,151.36315983322203,5
2020-05-31-170802,170802,0,0,0,450,0.0,158.87374385272938,6
2020-06-01-170802,170802,0,0,1,450,0.75,192.16107915570805,0
2020-06-02-170802,170802,1,0,1,451,0.75,53.30484517698896,1
2020-06-03-170802,170802,0,0,2,451,0.75,37.364816685987066,2
2020-06-04-170802,170802,1,0,1,452,0.5,29.475178991910603,3
2020-06-05-170802,170802,0,0,1,452,0.25,33.05723030757173,4
2020-06-06-170802,170802,0,1,0,452,0.5,22.213524042114745,5
2020-06-07-170802,170802,1,0,3,453,0.5,23.65871708974263,6
2020-06-08-170802,170802,0,0,1,453,0.75,31.93287761851456,0
2020-06-09-170802,170802,1,0,2,454,1.0,33.53992110680815,1
2020-06-10-170802,170802,1,0,0,455,1.0,193.32345064454006,2
2020-06-11-170802,170802,1,0,1,456,0.25,175.56431817441182,3
2020-06-12-170802,170802,6,0,1,462,0.5,125.8251686579095,4
2020-06-13-170802,170802,0,0,0,462,0.25,112.53259476953794,5
2020-06-14-170802,170802,0,0,0,462,0.25,100.27729235146126,6
2020-06-15-170802,170802,1,0,0,463,0.0,76.82420740016187,0
2020-06-16-170802,170802,1,0,0,464,0.75,72.20685542011728,1
2020-06-17-170802,170802,2,0,1,466,1.75,74.75454247469727,2
2020-06-18-170802,170802,1,0,1,467,0.25,84.9682063087838,3
2020-06-19-170802,170802,1,0,0,468,0.75,81.3852876438441,4
2020-06-20-170802,170802,0,0,1,468,0.0,58.78243624230599,5
2020-06-21-170802,170802,3,0,0,471,0.0,58.420103812021,6
2020-06-22-170802,170802,1,0,0,472,0.25,72.41277039875538,0
2020-06-23-170802,170802,2,2,0,474,0.0,71.99725105307057,1
2020-06-24-170802,170802,0,2,1,474,0.0,67.89107891674746,2
2020-06-25-170802,170802,1,0,0,475,0.25,61.925011357462374,3
2020-06-26-170802,170802,1,0,0,476,0.75,61.85563731562078,4
2020-06-27-170802,170802,0,0,0,476,0.25,65.611091853472,5
2020-06-28-170802,170802,0,0,1,476,0.5,68.1177993523615,6
2020-06-29-170802,170802,0,0,0,476,0.0,48.177495817399524,0
2020-06-30-170802,170802,0,0,0,476,0.25,30.531828558377796,1
2020-07-01-170802,170802,1,0,0,477,0.25,52.32787054004186,2
2020-07-02-170802,170802,1,0,0,478,0.0,47.05061291186722,3
2020-07-03-170802,170802,0,0,1,478,0.25,85.7551914798461,4
2020-07-04-170802,170802,1,0,0,479,0.0,78.26123708670647,5
2020-07-05-170802,170802,0,0,0,479,0.0,67.00574143330118,6
2020-07-06-170802,170802,0,0,0,479,0.25,62.19312652604535,0
2020-07-07-170802,170802,0,0,0,479,0.5,65.52761287908456,1
2020-07-08-170802,170802,1,0,1,480,0.75,49.378124671375545,2
2020-07-09-170802,170802,0,0,1,480,0.0,60.22881608533268,3
2020-07-10-170802,170802,0,0,1,480,0.25,56.690468703069506,4
2020-07-11-170802,170802,0,0,0,480,0.0,44.534224826473825,5
2020-07-12-170802,170802,1,0,2,481,0.0,42.261840873224706,6
2020-07-13-170802,170802,0,0,0,481,1.75,45.99103562897844,0
2020-07-14-170802,170802,0,0,0,481,0.5,53.71007296728578,1
2020-07-15-170802,170802,0,0,3,481,0.5,55.138035056274816,2
2020-07-16-170802,170802,0,0,1,481,1.5,39.77563706203657,3
2020-07-17-170802,170802,1,0,0,482,0.5,37.97303550449354,4
2020-07-18-170802,170802,0,0,0,482,0.5,50.69659657632842,5
2020-07-19-170802,170802,0,0,1,482,0.0,56.02881426503447,6
2020-07-20-170802,170802,0,0,2,482,1.0,36.96144254656909,0
2020-07-21-170802,170802,0,0,0,482,0.75,46.29529763645618,1
2020-07-22-170802,170802,1,0,1,483,0.25,52.406896324278954,2
2020-07-23-170802,170802,1,0,0,484,1.25,58.385009759656285,3
2020-07-24-170802,170802,1,0,0,485,0.5,71.94361817703586,4
2020-07-25-170802,170802,0,0,3,485,0.0,78.30738637740762,5
2020-07-26-170802,170802,2,0,2,487,0.5,79.92520164714344,6
2020-07-27-170802,170802,0,0,0,487,0.75,89.66242657780472,0
2020-07-28-170802,170802,0,0,0,487,0.0,84.78004254032571,1
2020-07-29-170802,170802,3,0,0,490,0.75,75.00171188294073,2
2020-07-30-170802,170802,1,0,2,491,0.25,63.481946215911314,3
2020-07-31-170802,170802,0,0,0,491,0.75,60.30169802057304,4
2020-08-01-170802,170802,0,0,2,491,1.25,57.413925576421335,5
2020-08-02-170802,170802,1,0,0,492,0.0,126.483748492282,6
2020-08-03-170802,170802,2,0,0,494,0.25,133.187423085062,0
2020-08-04-170802,170802,0,0,0,494,1.5,128.0405564257177,1
2020-08-05-170802,170802,1,0,0,495,3.5,126.94876244011294,2
2020-08-06-170802,170802,0,0,0,495,2.75,124.85125857328171,3
2020-08-07-170802,170802,0,0,4,495,1.0,77.98709367820283,4
2020-08-08-170802,170802,3,0,0,498,1.75,86.91358358196615,5
2020-08-09-170802,170802,2,0,2,500,0.0,105.20745639766977,6
2020-08-10-170802,170802,0,0,2,500,1.25,35.02536237572013,0
2020-08-11-170802,170802,0,0,0,500,2.25,50.80275159931372,1
2020-08-12-170802,170802,0,0,0,500,1.25,66.77946348933088,2
2020-08-13-170802,170802,2,0,2,502,2.0,84.87730724019006,3
2020-08-14-170802,170802,0,0,1,502,1.25,94.82610491758038,4
2020-08-15-170802,170802,2,0,0,504,0.25,93.63856460794565,5
2020-08-16-170802,170802,0,0,1,504,0.5,109.1711567132306,6
2020-08-17-170802,170802,0,0,0,504,1.0,108.08823167103645,0
2020-08-18-170802,170802,0,0,0,504,3.25,91.14924780097269,1
2020-08-19-170802,170802,0,0,0,504,2.75,104.39449945498697,2
2020-08-20-170802,170802,0,1,0,504,0.25,108.81726013468071,3
2020-08-21-170802,170802,4,0,2,508,1.0,99.82444448085586,4
2020-08-22-170802,170802,0,0,0,508,1.5,116.19717241707451,5
2020-08-23-170802,170802,2,0,0,510,0.25,128.02099266538744,6
2020-08-24-170802,170802,2,0,1,512,1.25,137.41332610019643,0
2020-08-25-170802,170802,0,0,0,512,0.5,122.29514721655597,1
2020-08-26-170802,170802,0,0,1,512,1.5,85.80441613755544,2
2020-08-27-170802,170802,2,0,1,514,1.0,88.4536496740779,3
2020-08-28-170802,170802,1,1,3,515,1.25,106.46225810312143,4
2020-08-29-170802,170802,0,1,1,515,0.0,134.23829507198758,5
2020-08-30-170802,170802,1,0,2,516,0.25,120.72228256628829,6
2020-08-31-170802,170802,0,0,1,516,1.0,109.73589200908538,0
2020-09-01-170802,170802,0,0,8,516,1.5,108.92610729655814,1
2020-09-02-170802,170802,0,0,2,516,0.75,92.82863902950888,2
2020-09-03-170802,170802,0,0,4,516,1.0,166.93356219436097,3
2020-09-04-170802,170802,2,0,5,518,0.75,114.44268711948546,4
2020-09-05-170802,170802,0,0,0,518,0.25,88.15908072176788,5
2020-09-06-170802,170802,0,0,2,518,0.25,74.18024309120466,6
2020-09-07-170802,170802,1,0,8,519,1.75,74.77567633944543,0
2020-09-08-170802,170802,0,0,1,519,0.75,70.54990223135135,1
2020-09-09-170802,170802,1,0,3,520,1.25,75.08923461481167,2
2020-09-10-170802,170802,1,0,4,521,1.0,96.13845066601267,3
2020-09-11-170802,170802,3,0,2,524,0.5,98.94763653372874,4
2020-09-12-170802,170802,1,0,0,525,1.0,108.25338134287446,5
2020-09-13-170802,170802,2,0,0,527,0.0,109.67809798266151,6
2020-09-14-170802,170802,1,0,1,528,1.0,114.81829872952794,0
2020-09-15-170802,170802,8,0,0,536,0.25,97.75987272692296,1
2020-09-16-170802,170802,2,0,0,538,0.75,104.33815307565263,2
2020-09-17-170802,170802,4,0,0,542,0.0,97.45868104720373,3
2020-09-18-170802,170802,5,0,0,547,1.0,101.38224575260435,4
2020-09-19-170802,170802,0,0,0,547,0.0,97.16773055018582,5
2020-09-20-170802,170802,2,0,0,549,2.25,78.39254950778971,6
2020-09-21-170802,170802,8,0,1,557,1.5,93.88771548554962,0
2020-09-22-170802,170802,1,0,0,558,0.75,104.03328599056883,1
2020-09-23-170802,170802,3,1,3,561,1.75,113.10306962387014,2
2020-09-24-170802,170802,4,0,0,565,3.25,118.41551419856057,3
2020-09-25-170802,170802,2,0,0,567,6.75,143.03886589498478,4
2020-09-26-170802,170802,0,0,0,567,2.25,181.17184838599786,5
2020-09-27-170802,170802,0,0,0,567,0.25,193.31664393337684,6
2020-09-28-170802,170802,1,0,0,568,1.75,170.48387789502618,0
2020-09-29-170802,170802,0,0,0,568,0.25,158.94707018931962,1
2020-09-30-170802,170802,0,0,0,568,0.5,145.54527620511124,2
2020-10-01-170802,170802,0,0,0,568,1.25,0.0,3
2020-10-02-170802,170802,0,0,0,568,0.0,114.21168183738004,4
2020-10-03-170802,170802,0,0,0,568,0.0,114.27418939561116,5
2020-10-04-170802,170802,0,1,0,568,0.0,72.40267027202283,6
2020-10-05-170802,170802,1,0,0,569,0.75,59.48843419093322,0
2020-10-06-170802,170802,0,0,0,569,0.75,57.67906878424952,1
2020-10-07-170802,170802,3,0,1,572,0.25,43.22841443073065,2
2020-10-08-170802,170802,0,0,0,572,2.25,55.36051108967874,3
2020-10-09-170802,170802,0,0,1,572,0.75,73.70044356808816,4
2020-10-10-170802,170802,0,0,1,572,1.0,6.420465619402396,5
2020-10-11-170802,170802,0,0,1,572,0.5,11.395152611650824,6
2020-10-12-170802,170802,0,0,0,572,1.0,14.9201544218219,0
2020-10-13-170802,170802,0,0,0,572,1.0,18.864192125269856,1
2020-10-14-170802,170802,0,0,1,572,1.0,27.588804827395624,2
2020-10-15-170802,170802,0,0,0,572,2.0,35.004041223656,3
2020-10-16-170802,170802,0,0,0,572,7.25,44.62037359689713,4
2020-10-17-170802,170802,0,0,0,572,9.75,83.44462412733525,5
2020-10-18-170802,170802,0,0,0,572,0.25,111.13995635949762,6
2020-10-19-170802,170802,0,0,3,572,0.5,119.10508666117359,0
2020-10-20-170802,170802,0,0,1,572,0.25,114.07037756345566,1
2020-10-21-170802,170802,1,0,4,573,2.25,112.70110068133755,2
2020-10-22-170802,170802,0,0,6,573,2.25,118.47545569603962,3
2020-10-23-170802,170802,1,1,4,574,2.75,85.25777718499772,4
2020-10-24-170802,170802,1,0,6,575,2.25,67.64644404450385,5
2020-10-25-170802,170802,1,0,4,576,2.0,73.43352148693462,6
2020-10-26-170802,170802,0,1,2,576,2.0,92.21753928112754,0
2020-10-27-170802,170802,0,0,2,576,0.75,103.93240867436744,1
2020-10-28-170802,170802,1,0,0,577,2.25,110.07208975950087,2
2020-10-29-170802,170802,0,0,0,577,1.0,113.14082675474816,3
2020-10-30-170802,170802,0,0,0,577,1.75,94.12004942678504,4
2020-10-31-170802,170802,0,0,0,577,2.25,86.78489176264004,5
2020-11-01-170802,170802,0,2,0,577,0.75,63.973681792031215,6
2020-11-02-170802,170802,3,1,0,580,1.25,202.90999072323817,0
2020-11-03-170802,170802,1,1,0,581,2.25,237.91372948228081,1
2020-11-04-170802,170802,4,0,0,585,0.5,249.82197094040262,2
2020-11-05-170802,170802,6,0,0,591,2.25,249.8801329594396,3
2020-11-06-170802,170802,4,0,0,595,2.75,240.21790211311395,4
2020-11-07-170802,170802,6,0,0,601,0.75,243.75773601997304,5
2020-11-08-170802,170802,4,0,0,605,3.5,234.89244698179613,6
2020-11-09-170802,170802,2,0,0,607,1.25,231.2821297809768,0
2020-11-10-170802,170802,2,0,0,609,1.0,56.93091644195576,1
2020-11-11-170802,170802,0,0,0,609,1.75,74.25535859883409,2
2020-11-12-170802,170802,0,0,0,609,2.75,81.24310902760867,3
2020-11-13-170802,170802,0,0,0,609,1.25,97.64820822187426,4
2020-03-01-170803,170803,0,0,0,0,0.0,0.0,6
2020-03-02-170803,170803,0,0,0,0,0.0,6.057450406242914,0
2020-03-03-170803,170803,0,0,1,0,0.0,32.19650521287942,1
2020-03-04-170803,170803,0,0,1,0,0.0,37.84618772844111,2
2020-03-05-170803,170803,0,0,0,0,0.0,41.359212972545194,3
2020-03-06-170803,170803,0,0,0,0,0.0,35.789715004958225,4
2020-03-07-170803,170803,0,0,0,0,0.0,37.60509805084946,5
2020-03-08-170803,170803,0,0,0,0,0.0,37.649012104875695,6
2020-03-09-170803,170803,0,0,1,0,0.5,37.264085014222495,0
2020-03-10-170803,170803,0,0,0,0,0.0,45.45798106683323,1
2020-03-11-170803,170803,0,0,1,0,0.5,40.05391555650284,2
2020-03-12-170803,170803,0,0,1,0,1.0,30.09251960975351,3
2020-03-13-170803,170803,0,0,3,0,0.5,27.546392567837948,4
2020-03-14-170803,170803,0,0,1,0,1.5,21.400671569543356,5
2020-03-15-170803,170803,0,0,1,0,0.5,14.886464748515735,6
2020-03-16-170803,170803,0,0,1,0,4.5,10.387150814973248,0
2020-03-17-170803,170803,1,1,0,1,4.0,22.734065264485913,1
2020-03-18-170803,170803,1,0,0,2,3.5,30.58633292498211,2
2020-03-19-170803,170803,0,0,1,2,5.0,38.559035488151835,3
2020-03-20-170803,170803,0,0,1,2,8.5,41.13292056916049,4
2020-03-21-170803,170803,0,0,0,2,2.5,49.89465196992304,5
2020-03-22-170803,170803,0,1,1,2,3.5,50.26526859198013,6
2020-03-23-170803,170803,1,0,1,3,13.5,44.04204930058078,0
2020-03-24-170803,170803,0,0,0,3,10.5,55.24147561314788,1
2020-03-25-170803,170803,1,0,0,4,7.5,60.60361589901802,2
2020-03-26-170803,170803,1,0,6,5,7.0,64.60859767109774,3
2020-03-27-170803,170803,3,0,0,8,5.5,80.35811486920566,4
2020-03-28-170803,170803,1,0,7,9,1.5,84.66575699433886,5
2020-03-29-170803,170803,1,0,0,10,2.5,85.27620762282152,6
2020-03-30-170803,170803,1,0,0,11,11.0,63.67930447218394,0
2020-03-31-170803,170803,0,0,0,11,4.5,65.34454162472875,1
2020-04-01-170803,170803,0,0,2,11,9.5,11.318577595431861,2
2020-04-02-170803,170803,1,0,0,12,9.0,59.688470456678864,3
2020-04-03-170803,170803,1,0,0,13,4.0,25.463410632959267,4
2020-04-04-170803,170803,0,0,0,13,1.5,20.399134186052375,5
2020-04-05-170803,170803,1,0,0,14,1.5,22.88619978621543,6
2020-04-06-170803,170803,1,0,0,15,5.0,23.702030009626483,0
2020-04-07-170803,170803,0,0,0,15,2.0,30.852891498073078,1
2020-04-08-170803,170803,0,0,1,15,3.0,36.89570300768014,2
2020-04-09-170803,170803,6,0,0,21,3.5,41.51562230852655,3
2020-04-10-170803,170803,0,0,1,21,12.5,18.424830117609297,4
2020-04-11-170803,170803,7,0,0,28,0.5,30.113492522243185,5
2020-04-12-170803,170803,0,0,0,28,0.0,33.58947181519126,6
2020-04-13-170803,170803,0,0,1,28,2.5,33.19931721765671,0
2020-04-14-170803,170803,0,0,0,28,6.5,39.1685029303512,1
2020-04-15-170803,170803,2,0,1,30,8.0,52.0494860157179,2
2020-04-16-170803,170803,0,0,0,30,18.0,61.43178185907112,3
2020-04-17-170803,170803,0,0,0,30,2.5,69.74534986507746,4
2020-04-18-170803,170803,0,0,0,30,1.0,62.874177198537154,5
2020-04-19-170803,170803,0,0,0,30,0.0,63.47482260004017,6
2020-04-20-170803,170803,0,2,0,30,3.0,73.48818415311666,0
2020-04-21-170803,170803,0,0,1,30,1.0,73.20402699868053,1
2020-04-22-170803,170803,1,0,1,31,3.0,65.33712114648054,2
2020-04-23-170803,170803,0,0,0,31,1.0,46.21675600744939,3
2020-04-24-170803,170803,1,0,0,32,5.5,44.355576712445014,4
2020-04-25-170803,170803,0,0,0,32,1.0,54.96918756320093,5
2020-04-26-170803,170803,0,0,0,32,2.0,56.00759116415485,6
2020-04-27-170803,170803,1,0,0,33,1.0,44.69264856660934,0
2020-04-28-170803,170803,0,1,0,33,0.0,31.617171600056277,1
2020-04-29-170803,170803,1,0,2,34,1.0,31.25580142691496,2
2020-04-30-170803,170803,0,0,0,34,1.5,33.03815009367678,3
2020-05-01-170803,170803,0,0,0,34,1.0,46.11638502052394,4
2020-05-02-170803,170803,0,0,0,34,5.0,17.60088865909184,5
2020-05-03-170803,170803,0,0,0,34,2.0,17.664204554848844,6
2020-05-04-170803,170803,0,0,0,34,2.0,16.86366407514952,0
2020-05-05-170803,170803,1,0,0,35,4.5,16.55553527214003,1
2020-05-06-170803,170803,1,0,0,36,3.0,23.131353091734873,2
2020-05-07-170803,170803,0,0,0,36,1.0,26.24929092304628,3
2020-05-08-170803,170803,0,0,0,36,2.0,31.145745088167423,4
2020-05-09-170803,170803,0,0,0,36,1.5,35.82289127923489,5
2020-05-10-170803,170803,0,0,0,36,1.0,60.70024727313372,6
2020-05-11-170803,170803,0,0,0,36,3.0,52.63862928943976,0
2020-05-12-170803,170803,0,0,0,36,0.5,51.05183296210349,1
2020-05-13-170803,170803,2,1,1,38,1.5,39.284395842763374,2
2020-05-14-170803,170803,0,0,1,38,2.5,37.38923511134986,3
2020-05-15-170803,170803,0,0,0,38,1.5,32.622514514358045,4
2020-05-16-170803,170803,0,1,0,38,1.5,24.2588509177866,5
2020-05-17-170803,170803,0,0,0,38,0.0,23.208324416922927,6
2020-05-18-170803,170803,0,0,1,38,0.5,22.60976213966927,0
2020-05-19-170803,170803,0,0,0,38,0.5,20.388362809687287,1
2020-05-20-170803,170803,0,0,0,38,1.0,23.96605106461564,2
2020-05-21-170803,170803,0,0,0,38,0.5,20.977365275985843,3
2020-05-22-170803,170803,0,0,0,38,1.5,18.857503340175942,4
2020-05-23-170803,170803,0,0,1,38,1.0,21.950690233939643,5
2020-05-24-170803,170803,0,0,1,38,0.0,23.708288360990522,6
2020-05-25-170803,170803,0,0,0,38,1.5,22.159787336494624,0
2020-05-26-170803,170803,0,0,1,38,3.0,23.357252327081014,1
2020-05-27-170803,170803,1,0,0,39,0.5,21.034243113551423,2
2020-05-28-170803,170803,1,0,0,40,1.5,21.46237860018976,3
2020-05-29-170803,170803,0,0,0,40,1.0,27.283543889280388,4
2020-05-30-170803,170803,0,0,0,40,0.0,26.99052632188375,5
2020-05-31-170803,170803,0,0,0,40,0.0,28.46820595725493,6
2020-06-01-170803,170803,1,0,0,41,0.0,43.7752279729558,0
2020-06-02-170803,170803,0,0,0,41,0.5,11.07024132117482,1
2020-06-03-170803,170803,0,0,1,41,0.0,8.242155807928231,2
2020-06-04-170803,170803,0,0,0,41,1.0,8.686995255571393,3
2020-06-05-170803,170803,0,0,1,41,0.0,10.209365748559346,4
2020-06-06-170803,170803,1,0,0,42,0.0,7.081979506647375,5
2020-06-07-170803,170803,1,0,0,43,0.5,7.788020014781937,6
2020-06-08-170803,170803,0,0,0,43,0.0,9.18658404487435,0
2020-06-09-170803,170803,1,0,0,44,1.0,9.902089104060892,1
2020-06-10-170803,170803,0,0,0,44,0.5,43.529131805986665,2
2020-06-11-170803,170803,0,0,0,44,1.0,40.91469058562502,3
2020-06-12-170803,170803,0,0,2,44,3.0,34.56749683982582,4
2020-06-13-170803,170803,0,0,0,44,0.0,27.484688057848423,5
2020-06-14-170803,170803,0,0,0,44,0.0,22.17151228602946,6
2020-06-15-170803,170803,0,0,0,44,0.5,16.110944246633665,0
2020-06-16-170803,170803,0,0,1,44,0.5,14.918511402338622,1
2020-06-17-170803,170803,1,1,0,45,1.0,14.615086705374255,2
2020-06-18-170803,170803,0,0,0,45,0.5,16.32711384082306,3
2020-06-19-170803,170803,1,0,1,46,0.5,14.813251639847188,4
2020-06-20-170803,170803,0,0,0,46,0.0,12.239182112741318,5
2020-06-21-170803,170803,0,0,0,46,1.5,12.208258228912701,6
2020-06-22-170803,170803,0,0,1,46,0.5,13.38313547626975,0
2020-06-23-170803,170803,0,0,1,46,1.0,13.051023762296587,1
2020-06-24-170803,170803,0,0,2,46,0.0,10.77203908022149,2
2020-06-25-170803,170803,0,0,0,46,0.5,9.877754656140578,3
2020-06-26-170803,170803,2,2,0,48,0.5,9.811902727849299,4
2020-06-27-170803,170803,0,0,0,48,0.0,12.032087615909086,5
2020-06-28-170803,170803,0,0,0,48,0.0,12.53768474757442,6
2020-06-29-170803,170803,0,0,1,48,0.0,10.537044406554635,0
2020-06-30-170803,170803,1,0,1,49,0.0,9.068182395380719,1
2020-07-01-170803,170803,0,0,0,49,0.5,16.019000190823668,2
2020-07-02-170803,170803,0,0,3,49,0.5,15.936790977375017,3
2020-07-03-170803,170803,1,0,1,50,0.0,20.017163334666996,4
2020-07-04-170803,170803,0,0,2,50,0.5,21.733233282159716,5
2020-07-05-170803,170803,0,0,0,50,0.0,19.545027521067297,6
2020-07-06-170803,170803,1,0,4,51,0.0,17.874965984169208,0
2020-07-07-170803,170803,1,1,1,52,0.0,19.56286999421359,1
2020-07-08-170803,170803,2,0,1,54,0.5,18.735069360261,2
2020-07-09-170803,170803,0,0,3,54,0.0,21.41259302170143,3
2020-07-10-170803,170803,0,0,1,54,0.0,17.801625074915645,4
2020-07-11-170803,170803,0,0,0,54,0.0,14.224126085206043,5
2020-07-12-170803,170803,0,0,1,54,0.5,13.309493556893251,6
2020-07-13-170803,170803,1,0,3,55,0.0,12.817732312436302,0
2020-07-14-170803,170803,1,0,0,56,0.0,16.86312098904534,1
2020-07-15-170803,170803,0,0,1,56,0.0,17.357278154415816,2
2020-07-16-170803,170803,3,0,0,59,0.0,12.467807221824604,3
2020-07-17-170803,170803,1,0,1,60,0.5,13.721079533544152,4
2020-07-18-170803,170803,2,0,0,62,0.0,17.10020285875659,5
2020-07-19-170803,170803,0,0,0,62,0.0,19.402500530249487,6
2020-07-20-170803,170803,4,0,1,66,0.0,13.160236715554936,0
2020-07-21-170803,170803,1,0,2,67,0.0,17.398830185023996,1
2020-07-22-170803,170803,1,0,1,68,0.5,19.864615909292134,2
2020-07-23-170803,170803,3,0,1,71,0.5,20.415622835840427,3
2020-07-24-170803,170803,1,0,0,72,0.5,25.119485278953427,4
2020-07-25-170803,170803,0,0,1,72,0.0,25.970980198683353,5
2020-07-26-170803,170803,1,0,0,73,1.0,26.826354503631183,6
2020-07-27-170803,170803,3,0,0,76,0.0,29.34565490787389,0
2020-07-28-170803,170803,0,0,5,76,0.0,26.19151043925043,1
2020-07-29-170803,170803,1,0,3,77,1.5,22.50481593403976,2
2020-07-30-170803,170803,0,0,7,77,0.5,16.99493407882828,3
2020-07-31-170803,170803,1,0,0,78,0.0,15.721290202248388,4
2020-08-01-170803,170803,0,0,0,78,0.0,20.96556487433388,5
2020-08-02-170803,170803,0,0,0,78,0.5,55.64640953860798,6
2020-08-03-170803,170803,1,0,3,79,1.0,34.50190093535976,0
2020-08-04-170803,170803,2,0,4,81,0.0,37.21732050635066,1
2020-08-05-170803,170803,1,0,3,82,0.5,37.513013422463544,2
2020-08-06-170803,170803,1,0,0,83,0.0,37.88338749555287,3
2020-08-07-170803,170803,0,0,4,83,0.0,30.5376266662804,4
2020-08-08-170803,170803,1,0,1,84,2.0,34.265328485579616,5
2020-08-09-170803,170803,0,0,1,84,1.0,39.632194776139265,6
2020-08-10-170803,170803,0,0,2,84,0.5,11.98478026591949,0
2020-08-11-170803,170803,5,0,0,89,0.0,20.253212222914396,1
2020-08-12-170803,170803,3,0,1,92,0.0,28.892778403335342,2
2020-08-13-170803,170803,7,0,0,99,1.5,36.55775292238442,3
2020-08-14-170803,170803,0,0,4,99,0.0,40.98272197600352,4
2020-08-15-170803,170803,0,0,0,99,1.0,44.17217560161643,5
2020-08-16-170803,170803,0,0,0,99,0.0,48.17315669637047,6
2020-08-17-170803,170803,3,0,3,102,0.0,49.04104535613385,0
2020-08-18-170803,170803,4,0,0,106,1.0,42.47613698217994,1
2020-08-19-170803,170803,3,0,1,109,2.5,49.75916856874701,2
2020-08-20-170803,170803,0,0,2,109,0.0,55.19376164127979,3
2020-08-21-170803,170803,4,0,1,113,2.0,48.234023000151936,4
2020-08-22-170803,170803,1,0,0,114,0.5,51.821969115345546,5
2020-08-23-170803,170803,1,0,0,115,1.0,55.697537861009216,6
2020-08-24-170803,170803,2,0,6,117,1.0,56.30372608998645,0
2020-08-25-170803,170803,0,0,1,117,0.0,44.79414462189146,1
2020-08-26-170803,170803,1,0,3,118,0.0,24.746896924153845,2
2020-08-27-170803,170803,0,0,2,118,1.0,26.92911587501085,3
2020-08-28-170803,170803,4,0,2,122,0.5,32.293601475621394,4
2020-08-29-170803,170803,0,0,1,122,0.0,40.490082547372,5
2020-08-30-170803,170803,0,0,0,122,0.5,34.723978562788005,6
2020-08-31-170803,170803,3,0,0,125,0.0,30.97767933925597,0
2020-09-01-170803,170803,0,0,1,125,0.5,38.70454100852249,1
2020-09-02-170803,170803,1,0,1,126,0.5,22.084995036815968,2
2020-09-03-170803,170803,2,0,0,128,0.0,63.706706010353045,3
2020-09-04-170803,170803,1,0,1,129,1.0,48.94264832749931,4
2020-09-05-170803,170803,0,0,0,129,0.0,34.07925189893048,5
2020-09-06-170803,170803,0,0,2,129,0.0,27.615078099937634,6
2020-09-07-170803,170803,6,0,2,135,0.5,27.81532550740136,0
2020-09-08-170803,170803,1,0,2,136,0.0,26.505263972541712,1
2020-09-09-170803,170803,3,0,2,139,0.5,28.308034920704678,2
2020-09-10-170803,170803,2,0,8,141,0.5,32.04958648850187,3
2020-09-11-170803,170803,2,0,26,143,1.5,32.69354865571434,4
2020-09-12-170803,170803,1,0,5,144,0.5,32.91432520473592,5
2020-09-13-170803,170803,0,0,1,144,1.0,31.520797483810355,6
2020-09-14-170803,170803,0,0,5,144,0.5,30.896388693976842,0
2020-09-15-170803,170803,1,0,1,145,4.0,26.508788987511764,1
2020-09-16-170803,170803,1,0,2,146,1.0,27.406408243773235,2
2020-09-17-170803,170803,0,0,4,146,2.0,24.456993747991877,3
2020-09-18-170803,170803,1,0,0,147,2.5,23.387827109328764,4
2020-09-19-170803,170803,0,0,0,147,0.0,21.896760095632594,5
2020-09-20-170803,170803,2,0,0,149,1.0,19.64159880883286,6
2020-09-21-170803,170803,2,0,1,151,4.0,23.027735300068603,0
2020-09-22-170803,170803,2,0,1,153,0.5,27.317896362941223,1
2020-09-23-170803,170803,2,0,0,155,1.5,29.72960162470066,2
2020-09-24-170803,170803,8,0,8,163,2.0,31.15967521384829,3
2020-09-25-170803,170803,26,0,0,189,1.0,42.04967937985253,4
2020-09-26-170803,170803,5,0,1,194,0.0,57.758746912195186,5
2020-09-27-170803,170803,1,0,0,195,0.0,62.39927600547816,6
2020-09-28-170803,170803,5,0,1,200,0.5,58.13678137287805,0
2020-09-29-170803,170803,1,0,0,201,0.0,56.41103375638282,1
2020-09-30-170803,170803,2,0,2,203,0.0,55.09325478196284,2
2020-10-01-170803,170803,4,2,3,207,0.0,0.0,3
2020-10-02-170803,170803,0,0,11,207,0.0,53.49395830755792,4
2020-10-03-170803,170803,0,1,4,207,0.0,46.302719674956855,5
2020-10-04-170803,170803,0,0,0,207,0.0,31.948434438350574,6
2020-10-05-170803,170803,1,1,1,208,0.5,25.375206350866407,0
2020-10-06-170803,170803,1,1,0,209,0.0,22.90180860265104,1
2020-10-07-170803,170803,0,0,1,209,1.5,17.705768806999618,2
2020-10-08-170803,170803,8,0,2,217,0.0,17.61721704454255,3
2020-10-09-170803,170803,0,3,2,217,0.0,26.02710198970423,4
2020-10-10-170803,170803,1,0,2,218,0.0,2.906835765406528,5
2020-10-11-170803,170803,0,0,0,218,0.0,5.338088314077562,6
2020-10-12-170803,170803,1,0,0,219,0.0,7.1452204178082575,0
2020-10-13-170803,170803,0,0,0,219,0.0,8.975022055756972,1
2020-10-14-170803,170803,2,0,0,221,0.0,13.701439844432477,2
2020-10-15-170803,170803,3,0,1,224,0.0,17.161062945945158,3
2020-10-16-170803,170803,11,0,0,235,0.0,21.79774030155386,4
2020-10-17-170803,170803,4,0,0,239,0.0,40.41213534923375,5
2020-10-18-170803,170803,0,0,0,239,0.0,54.60337518309676,6
2020-10-19-170803,170803,1,0,0,240,0.0,57.36600723417114,0
2020-10-20-170803,170803,0,0,2,240,0.0,53.91133632087544,1
2020-10-21-170803,170803,1,0,0,241,0.5,52.68706924381709,2
2020-10-22-170803,170803,2,0,3,243,0.5,53.3469110822474,3
2020-10-23-170803,170803,2,0,0,245,0.5,38.22494295968679,4
2020-10-24-170803,170803,2,1,0,247,1.0,27.70376724381045,5
2020-10-25-170803,170803,0,0,0,247,2.0,28.789854640865105,6
2020-10-26-170803,170803,0,1,2,247,0.5,36.41354623489287,0
2020-10-27-170803,170803,0,0,0,247,0.5,41.03893667457466,1
2020-10-28-170803,170803,0,2,1,247,1.0,44.50453382975981,2
2020-10-29-170803,170803,1,1,3,248,0.0,47.3663006914107,3
2020-10-30-170803,170803,0,0,2,248,0.5,40.81986474577725,4
2020-10-31-170803,170803,0,0,0,248,0.0,38.673148763557776,5
2020-11-01-170803,170803,0,1,0,248,0.0,22.413349054560854,6
2020-11-02-170803,170803,0,0,0,248,3.0,68.6080944169814,0
2020-11-03-170803,170803,2,0,0,250,1.5,85.119237448443,1
2020-11-04-170803,170803,0,1,0,250,2.0,89.23198153651359,2
2020-11-05-170803,170803,3,0,0,253,3.0,86.42531659249138,3
2020-11-06-170803,170803,0,1,0,253,2.0,83.54787317483441,4
2020-11-07-170803,170803,0,0,0,253,3.0,80.79055448103162,5
2020-11-08-170803,170803,0,1,0,253,2.0,74.62721590992076,6
2020-11-09-170803,170803,2,0,0,255,1.0,68.88464173060005,0
2020-11-10-170803,170803,0,0,0,255,1.0,19.201208392477795,1
2020-11-11-170803,170803,1,0,0,256,0.0,23.784424994899545,2
2020-11-12-170803,170803,3,0,0,259,0.5,30.421562124703513,3
2020-11-13-170803,170803,2,0,0,261,0.0,38.0148695865235,4
2020-03-01-170804,170804,0,0,1,0,0.0,0.0,6
2020-03-02-170804,170804,0,0,1,0,0.0,6.307327690301523,0
2020-03-03-170804,170804,1,0,0,1,0.0,33.450510836102914,1
2020-03-04-170804,170804,0,0,1,1,0.0,38.12991553358533,2
2020-03-05-170804,170804,0,1,2,1,0.25,41.93878901077065,3
2020-03-06-170804,170804,0,0,3,1,0.0,36.19493474087457,4
2020-03-07-170804,170804,0,0,2,1,0.25,39.35662853802829,5
2020-03-08-170804,170804,0,0,0,1,0.0,39.38302258803516,6
2020-03-09-170804,170804,0,0,1,1,1.0,39.380524250468206,0
2020-03-10-170804,170804,0,0,1,1,0.0,45.55994017035255,1
2020-03-11-170804,170804,0,1,1,1,0.75,39.2666717507898,2
2020-03-12-170804,170804,0,0,2,1,1.0,30.147141240943796,3
2020-03-13-170804,170804,0,0,3,1,0.25,25.59443079153158,4
2020-03-14-170804,170804,0,0,0,1,0.75,19.52437719060365,5
2020-03-15-170804,170804,1,0,0,2,2.25,12.103815762624997,6
2020-03-16-170804,170804,1,0,0,3,4.5,9.329682294566858,0
2020-03-17-170804,170804,0,0,0,3,5.0,18.859766986235538,1
2020-03-18-170804,170804,1,0,2,4,6.5,26.281751142689977,2
2020-03-19-170804,170804,2,0,0,6,5.75,32.53192660849238,3
2020-03-20-170804,170804,3,0,0,9,8.5,37.088315198591914,4
2020-03-21-170804,170804,2,0,1,11,5.25,45.07587282729604,5
2020-03-22-170804,170804,0,2,1,11,4.5,45.438674536591165,6
2020-03-23-170804,170804,1,0,0,12,14.0,40.13880333492818,0
2020-03-24-170804,170804,1,0,0,13,11.0,47.94374988365007,1
2020-03-25-170804,170804,1,0,1,14,9.5,51.807628602028174,2
2020-03-26-170804,170804,2,0,0,16,6.25,54.12679584435453,3
2020-03-27-170804,170804,3,0,0,19,8.25,64.2048628238288,4
2020-03-28-170804,170804,0,0,0,19,2.5,65.65941177702408,5
2020-03-29-170804,170804,0,0,0,19,3.25,65.56660379502361,6
2020-03-30-170804,170804,0,0,1,19,11.75,50.30456283970964,0
2020-03-31-170804,170804,0,0,0,19,9.0,50.65145038913119,1
2020-04-01-170804,170804,2,0,0,21,12.75,9.292071179617905,2
2020-04-02-170804,170804,0,0,1,21,8.75,46.408593606844406,3
2020-04-03-170804,170804,0,0,1,21,8.0,15.155517168543572,4
2020-04-04-170804,170804,1,0,0,22,3.25,16.787754434148503,5
2020-04-05-170804,170804,1,1,0,23,4.0,18.433442099446207,6
2020-04-06-170804,170804,0,1,1,23,8.5,21.55292183673089,0
2020-04-07-170804,170804,0,0,0,23,5.75,27.63412296653221,1
2020-04-08-170804,170804,1,0,0,24,7.5,31.917059040487008,2
2020-04-09-170804,170804,0,0,0,24,4.25,37.799002615182765,3
2020-04-10-170804,170804,0,0,1,24,11.75,15.369721239798475,4
2020-04-11-170804,170804,0,0,0,24,2.5,24.244299682413562,5
2020-04-12-170804,170804,0,0,0,24,3.25,27.236664697716286,6
2020-04-13-170804,170804,1,0,0,25,5.5,28.17156804307554,0
2020-04-14-170804,170804,0,0,0,25,8.5,34.45396657961666,1
2020-04-15-170804,170804,0,0,0,25,5.25,44.0172452949423,2
2020-04-16-170804,170804,1,0,0,26,14.5,50.32780675942453,3
2020-04-17-170804,170804,1,0,1,27,2.25,55.04717392034649,4
2020-04-18-170804,170804,0,0,0,27,3.75,50.85659192800159,5
2020-04-19-170804,170804,0,0,0,27,0.75,52.93977604397148,6
2020-04-20-170804,170804,1,0,0,28,11.5,57.05009076455498,0
2020-04-21-170804,170804,0,0,0,28,1.5,59.739200535130905,1
2020-04-22-170804,170804,0,0,0,28,2.25,54.516401867408895,2
2020-04-23-170804,170804,0,0,2,28,0.5,38.388239648312926,3
2020-04-24-170804,170804,1,0,0,29,4.0,34.82914640975791,4
2020-04-25-170804,170804,0,0,0,29,1.5,37.933489051265525,5
2020-04-26-170804,170804,0,0,0,29,1.0,38.402296154341784,6
2020-04-27-170804,170804,0,0,0,29,3.0,28.93790643536702,0
2020-04-28-170804,170804,0,0,0,29,2.25,18.799413270722596,1
2020-04-29-170804,170804,0,0,1,29,1.5,18.59610192215846,2
2020-04-30-170804,170804,0,0,0,29,2.25,23.394321171989233,3
2020-05-01-170804,170804,1,0,1,30,1.75,40.9491756306882,4
2020-05-02-170804,170804,0,0,0,30,3.25,17.924957326853246,5
2020-05-03-170804,170804,0,0,0,30,2.75,17.829790669698564,6
2020-05-04-170804,170804,0,0,1,30,4.75,16.65792053070237,0
2020-05-05-170804,170804,0,0,1,30,4.5,16.375576687085946,1
2020-05-06-170804,170804,0,0,0,30,9.75,21.37934526560371,2
2020-05-07-170804,170804,2,0,0,32,2.25,25.296718968960032,3
2020-05-08-170804,170804,0,0,1,32,1.5,30.263983386409542,4
2020-05-09-170804,170804,0,0,0,32,0.75,32.66612384881592,5
2020-05-10-170804,170804,0,0,0,32,0.5,52.967252418663705,6
2020-05-11-170804,170804,0,0,1,32,3.75,47.72056916529574,0
2020-05-12-170804,170804,0,0,1,32,1.75,46.12444079982851,1
2020-05-13-170804,170804,1,1,0,33,3.25,35.91702676901458,2
2020-05-14-170804,170804,0,0,3,33,2.25,35.022918462905835,3
2020-05-15-170804,170804,1,1,0,34,2.0,28.369692029498175,4
2020-05-16-170804,170804,0,0,0,34,1.25,22.62721383232838,5
2020-05-17-170804,170804,0,0,0,34,0.0,21.3970472627732,6
2020-05-18-170804,170804,1,0,1,35,1.5,20.806035469901033,0
2020-05-19-170804,170804,1,0,0,36,2.5,19.46327932073514,1
2020-05-20-170804,170804,0,0,1,36,2.0,22.203295126136844,2
2020-05-21-170804,170804,0,0,0,36,0.75,20.62209754624063,3
2020-05-22-170804,170804,1,0,0,37,0.5,17.937253013408824,4
2020-05-23-170804,170804,0,0,0,37,0.5,19.670130299074643,5
2020-05-24-170804,170804,0,0,0,37,1.0,20.87645882353472,6
2020-05-25-170804,170804,1,0,0,38,2.0,18.64205210553811,0
2020-05-26-170804,170804,1,0,0,39,2.75,19.310412757522897,1
2020-05-27-170804,170804,0,2,0,39,0.5,19.109836949046272,2
2020-05-28-170804,170804,3,0,0,42,2.5,19.04650395879701,3
2020-05-29-170804,170804,0,1,0,42,1.0,25.964897001310746,4
2020-05-30-170804,170804,0,0,0,42,1.25,27.654357340048538,5
2020-05-31-170804,170804,0,0,0,42,0.25,29.61878176095142,6
2020-06-01-170804,170804,1,0,0,43,0.75,40.023223295711574,0
2020-06-02-170804,170804,0,0,0,43,2.0,9.652581803730179,1
2020-06-03-170804,170804,1,0,0,44,0.75,7.203098330547446,2
2020-06-04-170804,170804,0,0,0,44,0.5,8.22210676275564,3
2020-06-05-170804,170804,0,0,0,44,0.75,8.234877993298548,4
2020-06-06-170804,170804,0,0,0,44,0.25,7.187904217807222,5
2020-06-07-170804,170804,0,0,0,44,1.0,7.724601535992068,6
2020-06-08-170804,170804,0,0,0,44,1.0,8.737084999264534,0
2020-06-09-170804,170804,0,0,0,44,1.5,9.6591826259553,1
2020-06-10-170804,170804,0,1,0,44,1.75,42.30250272009169,2
2020-06-11-170804,170804,0,0,0,44,0.75,38.632164093818595,3
2020-06-12-170804,170804,0,0,0,44,2.5,32.74274174370696,4
2020-06-13-170804,170804,0,0,0,44,0.25,22.736506198737132,5
2020-06-14-170804,170804,0,0,0,44,0.5,16.93241104002027,6
2020-06-15-170804,170804,0,0,0,44,0.25,13.687663308280584,0
2020-06-16-170804,170804,0,0,0,44,1.25,13.525889072235838,1
2020-06-17-170804,170804,0,0,0,44,2.0,12.644878258855911,2
2020-06-18-170804,170804,0,2,0,44,0.5,14.101235465836197,3
2020-06-19-170804,170804,0,0,0,44,1.25,13.49119213483789,4
2020-06-20-170804,170804,0,0,0,44,0.25,12.780125697024447,5
2020-06-21-170804,170804,0,0,0,44,1.0,12.80056352261396,6
2020-06-22-170804,170804,0,0,0,44,0.75,14.357574105455601,0
2020-06-23-170804,170804,0,1,0,44,1.0,13.714023353550688,1
2020-06-24-170804,170804,0,0,0,44,0.25,11.755006597052,2
2020-06-25-170804,170804,0,0,0,44,1.0,10.875938175299494,3
2020-06-26-170804,170804,0,0,0,44,0.5,10.993232619455789,4
2020-06-27-170804,170804,0,0,0,44,0.25,10.326084165334658,5
2020-06-28-170804,170804,0,0,0,44,0.5,10.648515645215607,6
2020-06-29-170804,170804,0,0,4,44,0.0,9.390823934779814,0
2020-06-30-170804,170804,0,0,0,44,0.25,8.883884626190914,1
2020-07-01-170804,170804,0,0,0,44,0.75,12.797656002160554,2
2020-07-02-170804,170804,0,0,0,44,1.0,19.610243305425566,3
2020-07-03-170804,170804,0,0,1,44,0.75,17.534500229710865,4
2020-07-04-170804,170804,0,0,0,44,0.25,16.17072106180845,5
2020-07-05-170804,170804,0,0,0,44,0.0,14.348486583283393,6
2020-07-06-170804,170804,0,0,0,44,0.25,13.449981194180864,0
2020-07-07-170804,170804,0,0,1,44,0.25,14.870830418408916,1
2020-07-08-170804,170804,0,1,0,44,1.0,14.629452381704102,2
2020-07-09-170804,170804,0,0,1,44,0.0,16.36680708657747,3
2020-07-10-170804,170804,0,0,0,44,0.25,15.179956663914748,4
2020-07-11-170804,170804,0,0,0,44,0.0,13.16049073010294,5
2020-07-12-170804,170804,0,0,0,44,0.25,11.574148532703054,6
2020-07-13-170804,170804,4,0,0,48,1.25,11.213301619763524,0
2020-07-14-170804,170804,0,0,0,48,0.75,19.610629196007967,1
2020-07-15-170804,170804,0,0,0,48,1.0,19.631458534130083,2
2020-07-16-170804,170804,0,0,0,48,0.75,16.887264797783764,3
2020-07-17-170804,170804,1,0,0,49,0.5,18.366934291393115,4
2020-07-18-170804,170804,0,0,0,49,0.25,22.14258088952802,5
2020-07-19-170804,170804,0,0,0,49,0.25,23.387692621062833,6
2020-07-20-170804,170804,0,0,0,49,1.0,12.992868327765766,0
2020-07-21-170804,170804,1,0,0,50,1.0,16.28531863513046,1
2020-07-22-170804,170804,0,0,0,50,0.5,19.098059987068396,2
2020-07-23-170804,170804,1,0,0,51,1.5,18.668848885690444,3
2020-07-24-170804,170804,0,0,2,51,1.5,21.886201726123197,4
2020-07-25-170804,170804,0,0,2,51,1.0,23.880399829925366,5
2020-07-26-170804,170804,0,0,0,51,1.0,25.318297654153803,6
2020-07-27-170804,170804,0,0,3,51,0.0,28.01271234957362,0
2020-07-28-170804,170804,0,0,0,51,0.0,24.626709433430705,1
2020-07-29-170804,170804,0,0,0,51,1.75,19.841282278899875,2
2020-07-30-170804,170804,0,0,0,51,2.0,16.099186300329844,3
2020-07-31-170804,170804,0,0,0,51,1.25,15.04652090130341,4
2020-08-01-170804,170804,0,0,0,51,1.75,15.398166952227909,5
2020-08-02-170804,170804,0,0,0,51,0.25,34.57217705989876,6
2020-08-03-170804,170804,0,0,0,51,0.75,34.68639355558241,0
2020-08-04-170804,170804,0,0,0,51,1.25,35.32486348445384,1
2020-08-05-170804,170804,0,1,0,51,3.5,33.45552977696721,2
2020-08-06-170804,170804,0,0,0,51,2.5,35.53879430304759,3
2020-08-07-170804,170804,2,0,0,53,1.0,32.43859674829266,4
2020-08-08-170804,170804,2,0,1,55,1.5,38.134558404632344,5
2020-08-09-170804,170804,0,0,0,55,0.75,45.524493782924125,6
2020-08-10-170804,170804,3,0,0,58,0.75,13.6725153442577,0
2020-08-11-170804,170804,0,0,0,58,2.0,24.616559743692378,1
2020-08-12-170804,170804,0,2,1,58,1.75,33.048345781462785,2
2020-08-13-170804,170804,0,0,0,58,1.0,40.774776569448534,3
2020-08-14-170804,170804,0,0,0,58,2.25,41.291493943722784,4
2020-08-15-170804,170804,0,0,0,58,1.25,44.655791232221944,5
2020-08-16-170804,170804,0,0,0,58,0.75,48.79477899043394,6
2020-08-17-170804,170804,0,0,0,58,0.25,47.4565597864551,0
2020-08-18-170804,170804,0,0,0,58,1.75,37.8803951913484,1
2020-08-19-170804,170804,0,0,0,58,1.0,39.61328080148067,2
2020-08-20-170804,170804,0,0,1,58,0.75,35.92008476199588,3
2020-08-21-170804,170804,0,0,0,58,1.25,30.237413146317373,4
2020-08-22-170804,170804,1,0,1,59,1.0,32.91200907212631,5
2020-08-23-170804,170804,0,0,0,59,0.5,36.70417070260381,6
2020-08-24-170804,170804,0,0,0,59,1.75,36.39082148450528,0
2020-08-25-170804,170804,0,0,1,59,1.0,30.077925160866716,1
2020-08-26-170804,170804,1,0,1,60,2.25,22.611853897462204,2
2020-08-27-170804,170804,0,0,1,60,2.0,27.29136121159143,3
2020-08-28-170804,170804,0,0,0,60,2.0,32.303327326285626,4
2020-08-29-170804,170804,0,0,0,60,1.0,37.66837160788206,5
2020-08-30-170804,170804,0,0,0,60,1.0,33.91906678300275,6
2020-08-31-170804,170804,0,0,0,60,0.75,30.904211840079103,0
2020-09-01-170804,170804,0,0,0,60,4.25,40.71890583476609,1
2020-09-02-170804,170804,0,0,0,60,1.25,26.968847445203433,2
2020-09-03-170804,170804,1,0,0,61,3.0,56.67548234721519,3
2020-09-04-170804,170804,0,0,0,61,3.0,48.70766656741797,4
2020-09-05-170804,170804,1,0,0,62,0.5,39.917522623610935,5
2020-09-06-170804,170804,0,0,2,62,1.25,33.18067169477757,6
2020-09-07-170804,170804,0,0,3,62,1.25,33.59031940800932,0
2020-09-08-170804,170804,1,0,0,63,1.0,31.023534859921796,1
2020-09-09-170804,170804,1,0,0,64,0.75,33.89476887324365,2
2020-09-10-170804,170804,1,0,0,65,1.25,36.55758405805332,3
2020-09-11-170804,170804,0,0,0,65,2.25,37.26285090671686,4
2020-09-12-170804,170804,0,0,1,65,1.5,35.937836639770325,5
2020-09-13-170804,170804,0,0,0,65,1.5,34.514372185704275,6
2020-09-14-170804,170804,0,0,0,65,1.75,33.56920185191595,0
2020-09-15-170804,170804,0,0,0,65,3.75,29.596247979836846,1
2020-09-16-170804,170804,0,0,0,65,2.75,31.488477469636166,2
2020-09-17-170804,170804,0,0,0,65,1.5,28.271326715029517,3
2020-09-18-170804,170804,0,0,0,65,4.0,26.591065527360342,4
2020-09-19-170804,170804,0,0,0,65,0.75,26.423846871872392,5
2020-09-20-170804,170804,2,0,0,67,3.25,23.404316857101794,6
2020-09-21-170804,170804,3,0,0,70,3.5,28.661894797689595,0
2020-09-22-170804,170804,0,0,0,70,3.25,33.477775987405366,1
2020-09-23-170804,170804,0,0,0,70,4.25,33.10994408811287,2
2020-09-24-170804,170804,0,0,0,70,3.0,35.56421589156285,3
2020-09-25-170804,170804,0,0,0,70,1.5,41.1152630695028,4
2020-09-26-170804,170804,1,0,0,71,2.5,52.03618575480626,5
2020-09-27-170804,170804,0,0,0,71,0.5,57.71522191907398,6
2020-09-28-170804,170804,0,0,0,71,2.75,51.29232205754876,0
2020-09-29-170804,170804,0,0,0,71,0.0,48.50097031266283,1
2020-09-30-170804,170804,0,0,0,71,0.75,48.21433987532257,2
2020-10-01-170804,170804,0,0,0,71,0.5,0.0,3
2020-10-02-170804,170804,0,0,2,71,0.5,53.80113173158979,4
2020-10-03-170804,170804,0,0,0,71,0.0,39.07418076983688,5
2020-10-04-170804,170804,0,0,0,71,0.75,29.624787999293414,6
2020-10-05-170804,170804,0,1,0,71,1.25,23.593273843428456,0
2020-10-06-170804,170804,0,0,0,71,0.75,22.39957591668179,1
2020-10-07-170804,170804,0,0,0,71,2.0,17.730659776052583,2
2020-10-08-170804,170804,0,0,0,71,3.25,18.31029069714485,3
2020-10-09-170804,170804,0,0,0,71,2.5,25.60678727769284,4
2020-10-10-170804,170804,0,0,0,71,1.25,2.1279004378564714,5
2020-10-11-170804,170804,0,0,0,71,1.25,4.244281238919719,6
2020-10-12-170804,170804,0,0,0,71,0.75,5.9963753462797005,0
2020-10-13-170804,170804,0,0,1,71,2.0,7.734402963362953,1
2020-10-14-170804,170804,0,0,0,71,1.25,12.524576494876438,2
2020-10-15-170804,170804,0,0,0,71,1.25,15.88124694391324,3
2020-10-16-170804,170804,2,0,0,73,5.75,20.322094759521054,4
2020-10-17-170804,170804,0,0,0,73,9.0,37.319530885353174,5
2020-10-18-170804,170804,0,0,0,73,3.75,51.358361707615714,6
2020-10-19-170804,170804,0,0,0,73,0.5,58.35331609083272,0
2020-10-20-170804,170804,0,0,0,73,0.75,54.563428500070984,1
2020-10-21-170804,170804,0,0,0,73,2.75,53.42418352732948,2
2020-10-22-170804,170804,0,0,0,73,2.0,54.824971038019186,3
2020-10-23-170804,170804,0,0,0,73,6.0,40.013889738774814,4
2020-10-24-170804,170804,0,0,0,73,4.5,30.018188867493826,5
2020-10-25-170804,170804,0,1,0,73,2.0,27.39612478357733,6
2020-10-26-170804,170804,0,0,0,73,3.0,31.112639748256274,0
2020-10-27-170804,170804,1,1,0,74,0.75,36.494910753332114,1
2020-10-28-170804,170804,0,0,1,74,3.25,38.4948259735136,2
2020-10-29-170804,170804,0,0,1,74,1.0,40.46558696116206,3
2020-10-30-170804,170804,0,0,1,74,3.5,34.83877057086411,4
2020-10-31-170804,170804,0,0,0,74,2.5,32.41631436234109,5
2020-11-01-170804,170804,0,0,0,74,1.0,22.219783846990303,6
2020-11-02-170804,170804,0,0,0,74,3.75,58.22777788805907,0
2020-11-03-170804,170804,0,0,0,74,3.5,65.28822070866033,1
2020-11-04-170804,170804,0,0,0,74,4.25,68.19779595187413,2
2020-11-05-170804,170804,0,0,0,74,4.5,68.82981900455046,3
2020-11-06-170804,170804,0,0,0,74,5.0,63.34083317884073,4
2020-11-07-170804,170804,0,0,0,74,5.25,64.96936328409367,5
2020-11-08-170804,170804,0,0,0,74,5.75,59.58388305026335,6
2020-11-09-170804,170804,0,0,0,74,3.5,59.74740533669572,0
2020-11-10-170804,170804,0,0,0,74,1.75,19.10841542811022,1
2020-11-11-170804,170804,1,1,0,75,2.25,22.372310172321598,2
2020-11-12-170804,170804,1,0,0,76,2.0,28.175544729350513,3
2020-11-13-170804,170804,1,0,0,77,1.0,33.58540954222204,4
2020-03-01-170805,170805,0,0,1,0,0.0,0.0,6
2020-03-02-170805,170805,0,0,4,0,0.0,21.60608118678486,0
2020-03-03-170805,170805,0,0,2,0,0.25,126.30503001663887,1
2020-03-04-170805,170805,0,1,3,0,0.0,161.2037108934585,2
2020-03-05-170805,170805,0,0,2,0,0.25,191.89193733431446,3
2020-03-06-170805,170805,0,0,6,0,0.0,192.05296174149268,4
2020-03-07-170805,170805,0,0,7,0,0.25,209.9638183892135,5
2020-03-08-170805,170805,0,0,0,0,0.0,216.38336390156866,6
2020-03-09-170805,170805,1,0,13,1,0.5,219.42219459908975,0
2020-03-10-170805,170805,0,0,6,1,0.0,243.4459321942195,1
2020-03-11-170805,170805,0,0,15,1,0.5,200.48928632252483,2
2020-03-12-170805,170805,1,0,3,2,0.5,173.2835951873181,3
2020-03-13-170805,170805,0,0,9,2,0.0,141.0526880216333,4
2020-03-14-170805,170805,0,0,3,2,0.0,94.34107676186856,5
2020-03-15-170805,170805,1,0,4,3,2.25,58.43827704389646,6
2020-03-16-170805,170805,4,1,16,7,2.75,31.97458778319493,0
2020-03-17-170805,170805,2,0,18,9,3.0,64.49308689624924,1
2020-03-18-170805,170805,3,1,6,12,5.5,81.82075840330984,2
2020-03-19-170805,170805,2,0,9,14,4.75,117.06534933298096,3
2020-03-20-170805,170805,6,0,19,20,4.25,129.9556977345446,4
2020-03-21-170805,170805,7,0,8,27,3.0,162.94133829172512,5
2020-03-22-170805,170805,0,0,9,27,3.25,173.90775952447896,6
2020-03-23-170805,170805,13,0,13,40,5.0,160.29584602158553,0
2020-03-24-170805,170805,6,0,9,46,6.0,206.35720837836934,1
2020-03-25-170805,170805,15,0,13,61,3.25,212.05923618477587,2
2020-03-26-170805,170805,3,0,2,64,4.0,246.6723787461139,3
2020-03-27-170805,170805,9,0,15,73,4.75,264.8063811884298,4
2020-03-28-170805,170805,3,0,3,76,1.25,268.9998421999838,5
2020-03-29-170805,170805,4,0,6,80,1.25,255.95028502337726,6
2020-03-30-170805,170805,16,0,2,96,3.5,192.52532229668336,0
2020-03-31-170805,170805,18,0,5,114,3.0,203.8615240206114,1
2020-04-01-170805,170805,6,0,2,120,8.25,67.17274516192657,2
2020-04-02-170805,170805,9,0,1,129,3.0,87.38578626489252,3
2020-04-03-170805,170805,19,0,2,148,1.25,58.10972926781216,4
2020-04-04-170805,170805,8,0,2,156,1.25,105.53300419903377,5
2020-04-05-170805,170805,9,0,1,165,1.25,123.46543284584767,6
2020-04-06-170805,170805,13,0,0,178,3.25,151.0345337414956,0
2020-04-07-170805,170805,9,0,2,187,3.75,185.3537521380657,1
2020-04-08-170805,170805,13,0,0,200,3.5,212.29730763971443,2
2020-04-09-170805,170805,2,0,1,202,2.5,246.43675926569418,3
2020-04-10-170805,170805,15,0,3,217,2.5,36.35356913993985,4
2020-04-11-170805,170805,3,0,2,220,1.5,85.98235920638244,5
2020-04-12-170805,170805,6,0,1,226,1.75,97.57024952100221,6
2020-04-13-170805,170805,2,0,4,228,4.5,118.8918357434625,0
2020-04-14-170805,170805,5,0,2,233,5.25,135.32661047254814,1
2020-04-15-170805,170805,2,0,2,235,0.75,159.7055792257894,2
2020-04-16-170805,170805,1,0,1,236,6.0,173.49453244347316,3
2020-04-17-170805,170805,2,0,0,238,0.75,166.25153315948802,4
2020-04-18-170805,170805,2,0,2,240,2.75,128.4125762062848,5
2020-04-19-170805,170805,1,0,6,241,0.75,129.91201809988553,6
2020-04-20-170805,170805,0,0,4,241,10.5,132.06852860694931,0
2020-04-21-170805,170805,2,0,2,243,1.0,123.17631757930717,1
2020-04-22-170805,170805,0,0,25,243,1.75,123.00492238610452,2
2020-04-23-170805,170805,1,0,1,244,0.25,103.90215369197728,3
2020-04-24-170805,170805,3,0,0,247,3.0,87.9444074818805,4
2020-04-25-170805,170805,2,0,1,249,1.0,89.30254240703984,5
2020-04-26-170805,170805,1,0,0,250,0.25,91.1994843240161,6
2020-04-27-170805,170805,4,0,3,254,1.75,57.29168506844094,0
2020-04-28-170805,170805,2,0,1,256,1.75,57.79276843683036,1
2020-04-29-170805,170805,2,0,1,258,0.75,59.73563889425719,2
2020-04-30-170805,170805,1,0,3,259,1.25,131.91221574708476,3
2020-05-01-170805,170805,0,0,0,259,1.75,225.0385997265518,4
2020-05-02-170805,170805,2,0,1,261,0.5,49.8434193854271,5
2020-05-03-170805,170805,6,0,0,267,0.25,24.206436556719957,6
2020-05-04-170805,170805,4,0,1,271,2.75,46.86949252755713,0
2020-05-05-170805,170805,2,0,3,273,1.75,55.78879100307798,1
2020-05-06-170805,170805,25,0,3,298,2.5,62.17820832470798,2
2020-05-07-170805,170805,1,0,1,299,2.25,129.98659548071385,3
2020-05-08-170805,170805,0,1,0,299,1.0,154.20366186248185,4
2020-05-09-170805,170805,1,1,0,300,0.0,156.324374356596,5
2020-05-10-170805,170805,0,0,0,300,0.0,278.64020701859454,6
2020-05-11-170805,170805,3,0,0,303,1.5,240.33790559797262,0
2020-05-12-170805,170805,1,0,0,304,1.75,221.80758889906716,1
2020-05-13-170805,170805,1,0,1,305,2.75,168.30843098049064,2
2020-05-14-170805,170805,3,0,2,308,1.0,133.99154246444016,3
2020-05-15-170805,170805,0,0,0,308,2.0,89.94194972018632,4
2020-05-16-170805,170805,1,2,2,309,0.25,76.98233332792971,5
2020-05-17-170805,170805,0,0,0,309,0.0,72.30146563492373,6
2020-05-18-170805,170805,1,0,1,310,1.5,73.3812006943754,0
2020-05-19-170805,170805,3,0,2,313,1.75,66.0716185960041,1
2020-05-20-170805,170805,3,0,0,316,0.75,77.01791830751365,2
2020-05-21-170805,170805,1,0,0,317,0.25,73.5426374651247,3
2020-05-22-170805,170805,0,0,2,317,0.75,72.66596681487808,4
2020-05-23-170805,170805,0,0,0,317,0.0,69.09721850444382,5
2020-05-24-170805,170805,0,0,2,317,1.0,70.99096568537894,6
2020-05-25-170805,170805,0,0,1,317,1.5,63.05427142612007,0
2020-05-26-170805,170805,0,0,3,317,1.75,47.703039759213475,1
2020-05-27-170805,170805,1,2,2,318,1.0,40.87219512811996,2
2020-05-28-170805,170805,2,0,1,320,2.0,29.647624812353513,3
2020-05-29-170805,170805,0,0,2,320,0.5,40.53104179710248,4
2020-05-30-170805,170805,2,0,0,322,0.75,70.43657781012743,5
2020-05-31-170805,170805,0,0,0,322,0.25,81.7016412200793,6
2020-06-01-170805,170805,1,0,0,323,0.75,189.8808446879139,0
2020-06-02-170805,170805,2,0,1,325,1.75,17.75267115357878,1
2020-06-03-170805,170805,0,0,0,325,1.0,32.14318907761655,2
2020-06-04-170805,170805,0,0,0,325,0.25,28.945533615111145,3
2020-06-05-170805,170805,2,0,0,327,0.25,18.876828934772945,4
2020-06-06-170805,170805,0,0,1,327,0.25,27.171373607823742,5
2020-06-07-170805,170805,2,0,1,329,0.25,27.361195705783707,6
2020-06-08-170805,170805,1,0,0,330,0.75,31.66362924146327,0
2020-06-09-170805,170805,3,1,1,333,1.0,37.336254168350955,1
2020-06-10-170805,170805,2,0,1,335,1.0,182.0253610256142,2
2020-06-11-170805,170805,1,0,2,336,0.25,171.97827506736124,3
2020-06-12-170805,170805,2,0,0,338,0.5,169.9619877184474,4
2020-06-13-170805,170805,0,0,0,338,0.25,54.41126804623184,5
2020-06-14-170805,170805,0,0,0,338,0.5,39.97336579662664,6
2020-06-15-170805,170805,0,0,0,338,0.0,38.95383099555863,0
2020-06-16-170805,170805,1,0,1,339,1.0,38.911845425526124,1
2020-06-17-170805,170805,0,0,1,339,1.5,33.50839783377047,2
2020-06-18-170805,170805,0,0,0,339,0.5,26.977042297312174,3
2020-06-19-170805,170805,0,0,1,339,1.0,21.553176968404696,4
2020-06-20-170805,170805,1,0,0,340,0.0,36.9641900623827,5
2020-06-21-170805,170805,1,0,0,341,0.0,39.721408004742244,6
2020-06-22-170805,170805,0,0,1,341,0.5,45.53638725240312,0
2020-06-23-170805,170805,1,0,0,342,0.25,46.3177062511778,1
2020-06-24-170805,170805,1,0,2,343,0.0,49.9423748908018,2
2020-06-25-170805,170805,2,1,0,345,0.5,54.087641608689886,3
2020-06-26-170805,170805,0,1,0,345,0.25,60.34243734946628,4
2020-06-27-170805,170805,0,0,0,345,0.25,44.651542567905025,5
2020-06-28-170805,170805,0,0,0,345,0.5,41.17968882302079,6
2020-06-29-170805,170805,0,0,3,345,0.0,42.07118877944687,0
2020-06-30-170805,170805,1,0,2,346,0.0,35.80374781806118,1
2020-07-01-170805,170805,1,0,2,347,0.25,63.75350843600617,2
2020-07-02-170805,170805,0,0,0,347,0.75,68.00627816183933,3
2020-07-03-170805,170805,1,0,1,348,0.5,68.15216382979501,4
2020-07-04-170805,170805,0,0,1,348,0.0,62.7555132589538,5
2020-07-05-170805,170805,0,0,1,348,0.0,59.467828587287535,6
2020-07-06-170805,170805,1,0,4,349,0.25,57.92329964940169,0
2020-07-07-170805,170805,0,2,2,349,0.75,64.23069498841781,1
2020-07-08-170805,170805,2,0,1,351,0.25,59.5091642108536,2
2020-07-09-170805,170805,0,0,1,351,0.0,62.842658358206776,3
2020-07-10-170805,170805,0,1,4,351,0.25,66.7211968216107,4
2020-07-11-170805,170805,0,0,2,351,0.0,66.03868846234158,5
2020-07-12-170805,170805,0,0,0,351,0.0,51.50353610773327,6
2020-07-13-170805,170805,3,0,0,354,1.5,53.06139151670099,0
2020-07-14-170805,170805,2,0,0,356,0.25,67.20874862151543,1
2020-07-15-170805,170805,2,0,1,358,0.5,65.63380703253685,2
2020-07-16-170805,170805,0,0,5,358,1.0,55.5087934641009,3
2020-07-17-170805,170805,1,0,0,359,0.25,58.454153472401565,4
2020-07-18-170805,170805,1,0,0,360,0.0,60.338244670943396,5
2020-07-19-170805,170805,1,0,0,361,0.0,68.04999269806933,6
2020-07-20-170805,170805,4,0,1,365,0.0,50.66588265826837,0
2020-07-21-170805,170805,2,0,0,367,0.75,67.32797170315253,1
2020-07-22-170805,170805,1,0,0,368,0.0,71.18270053837229,2
2020-07-23-170805,170805,1,0,0,369,1.25,69.42363566240392,3
2020-07-24-170805,170805,4,0,2,373,0.5,78.73316561542175,4
2020-07-25-170805,170805,2,0,0,375,0.5,100.83101339823389,5
2020-07-26-170805,170805,0,0,1,375,0.5,112.10302362931249,6
2020-07-27-170805,170805,0,0,2,375,0.0,113.94823802702183,0
2020-07-28-170805,170805,0,0,4,375,0.0,89.17939174961396,1
2020-07-29-170805,170805,1,0,5,376,0.75,72.33590402125658,2
2020-07-30-170805,170805,5,0,2,381,0.75,76.37022930622217,3
2020-07-31-170805,170805,0,0,4,381,1.25,79.12212849959572,4
2020-08-01-170805,170805,0,0,1,381,1.75,39.95144019877582,5
2020-08-02-170805,170805,0,0,1,381,0.0,98.95142792047014,6
2020-08-03-170805,170805,1,0,0,382,0.0,150.4616834511524,0
2020-08-04-170805,170805,0,0,0,382,1.75,169.78320406846336,1
2020-08-05-170805,170805,0,0,0,382,3.25,152.48811954773973,2
2020-08-06-170805,170805,0,0,1,382,3.0,128.16388013992054,3
2020-08-07-170805,170805,2,0,1,384,1.0,111.51194868022249,4
2020-08-08-170805,170805,0,0,1,384,1.25,107.89646962739033,5
2020-08-09-170805,170805,1,0,0,385,1.5,108.86899608352078,6
2020-08-10-170805,170805,2,0,2,387,1.5,40.94544153213395,0
2020-08-11-170805,170805,4,0,1,391,1.5,65.71571515133222,1
2020-08-12-170805,170805,5,0,4,396,1.5,98.38512923000152,2
2020-08-13-170805,170805,2,0,2,398,0.5,135.64891891316336,3
2020-08-14-170805,170805,4,0,6,402,2.25,152.80810187720286,4
2020-08-15-170805,170805,1,0,3,403,0.5,180.0433369423609,5
2020-08-16-170805,170805,1,0,2,404,0.5,192.19692758848066,6
2020-08-17-170805,170805,0,0,1,404,0.25,183.84231653900554,0
2020-08-18-170805,170805,0,0,12,404,1.75,162.40617858543462,1
2020-08-19-170805,170805,0,0,4,404,1.0,141.29695783166318,2
2020-08-20-170805,170805,1,0,11,405,0.5,84.08625400048734,3
2020-08-21-170805,170805,1,0,8,406,0.0,56.67860507121354,4
2020-08-22-170805,170805,1,0,2,407,1.0,54.56545831618998,5
2020-08-23-170805,170805,0,0,4,407,0.0,66.27235738636654,6
2020-08-24-170805,170805,2,0,3,409,1.0,62.854949339236605,0
2020-08-25-170805,170805,1,0,3,410,1.5,63.51834811095919,1
2020-08-26-170805,170805,4,0,1,414,1.75,66.80468309541244,2
2020-08-27-170805,170805,2,0,3,416,1.25,96.67500152890841,3
2020-08-28-170805,170805,6,0,5,422,0.25,125.28609614420093,4
2020-08-29-170805,170805,3,0,1,425,0.25,146.66805980598764,5
2020-08-30-170805,170805,2,0,4,427,0.25,162.86229507394748,6
2020-08-31-170805,170805,1,0,2,428,0.5,165.11245562344013,0
2020-09-01-170805,170805,12,0,7,440,1.5,96.79596267851306,1
2020-09-02-170805,170805,4,0,7,444,0.75,195.66290714881592,2
2020-09-03-170805,170805,11,0,2,455,0.75,244.14468767968816,3
2020-09-04-170805,170805,8,0,8,463,0.75,259.8128680226155,4
2020-09-05-170805,170805,2,0,2,465,0.25,258.7765249735981,5
2020-09-06-170805,170805,4,0,6,469,0.25,234.5310501390971,6
2020-09-07-170805,170805,3,0,5,472,1.25,243.42267609617218,0
2020-09-08-170805,170805,3,0,10,475,1.25,218.52669657492552,1
2020-09-09-170805,170805,1,0,9,476,0.75,237.89207944633014,2
2020-09-10-170805,170805,3,0,3,479,1.0,143.80664307363895,3
2020-09-11-170805,170805,5,0,1,484,1.0,154.02960208703732,4
2020-09-12-170805,170805,1,0,6,485,1.5,176.28243441422413,5
2020-09-13-170805,170805,4,0,2,489,0.75,180.89164648278995,6
2020-09-14-170805,170805,2,0,5,491,1.25,188.79246329048726,0
2020-09-15-170805,170805,7,0,0,498,0.25,196.86796854233157,1
2020-09-16-170805,170805,7,0,2,505,0.75,202.90354930385018,2
2020-09-17-170805,170805,2,0,1,507,0.75,173.87009107777072,3
2020-09-18-170805,170805,8,0,1,515,1.5,165.59800561454136,4
2020-09-19-170805,170805,2,0,0,517,0.5,166.83537613542134,5
2020-09-20-170805,170805,6,0,2,523,1.75,163.25454511783403,6
2020-09-21-170805,170805,5,0,1,528,1.0,181.58599736668444,0
2020-09-22-170805,170805,10,0,0,538,0.75,182.48835659898424,1
2020-09-23-170805,170805,9,0,3,547,1.25,161.6173662156171,2
2020-09-24-170805,170805,3,1,4,550,1.25,188.07080769759276,3
2020-09-25-170805,170805,1,1,2,551,1.0,170.48315364680153,4
2020-09-26-170805,170805,6,0,0,557,2.25,211.27595935551508,5
2020-09-27-170805,170805,2,0,0,559,0.0,228.6560749418075,6
2020-09-28-170805,170805,5,0,0,564,1.25,207.34285057003876,0
2020-09-29-170805,170805,0,0,4,564,0.25,229.85855272799336,1
2020-09-30-170805,170805,2,0,3,566,1.0,231.42051794691457,2
2020-10-01-170805,170805,1,0,0,567,0.25,0.0,3
2020-10-02-170805,170805,1,0,5,568,0.25,301.1124987694884,4
2020-10-03-170805,170805,0,1,1,568,0.0,230.90386183043694,5
2020-10-04-170805,170805,2,0,10,570,0.25,170.356206890438,6
2020-10-05-170805,170805,1,0,1,571,0.75,139.0238362760354,0
2020-10-06-170805,170805,0,1,2,571,0.75,133.03992155884288,1
2020-10-07-170805,170805,3,0,0,574,0.75,111.45523593540068,2
2020-10-08-170805,170805,4,0,2,578,2.25,120.76436603390681,3
2020-10-09-170805,170805,2,1,8,580,2.0,159.68769189108122,4
2020-10-10-170805,170805,0,0,10,580,1.25,3.421110545088108,5
2020-10-11-170805,170805,0,0,2,580,1.5,9.984820021105953,6
2020-10-12-170805,170805,0,0,5,580,0.75,21.20755595140254,0
2020-10-13-170805,170805,4,0,2,584,1.5,26.176147922640716,1
2020-10-14-170805,170805,3,0,2,587,0.5,59.69417900235257,2
2020-10-15-170805,170805,0,0,1,587,1.5,82.5665752999059,3
2020-10-16-170805,170805,5,0,2,592,5.5,106.9850187525026,4
2020-10-17-170805,170805,1,0,0,593,9.25,154.25476052220864,5
2020-10-18-170805,170805,10,0,1,603,1.25,184.52651346101777,6
2020-10-19-170805,170805,1,0,0,604,0.25,298.5775468356096,0
2020-10-20-170805,170805,2,0,6,606,0.75,281.2692668142479,1
2020-10-21-170805,170805,0,0,3,606,3.0,267.1664595859434,2
2020-10-22-170805,170805,2,1,6,608,2.0,264.8270157115496,3
2020-10-23-170805,170805,8,0,3,616,4.25,242.31596139367673,4
2020-10-24-170805,170805,10,0,3,626,1.75,244.9970473077711,5
2020-10-25-170805,170805,2,0,1,628,1.5,166.337197567598,6
2020-10-26-170805,170805,5,0,3,633,2.5,177.7344573809842,0
2020-10-27-170805,170805,2,1,1,635,1.25,217.6779880876444,1
2020-10-28-170805,170805,2,1,3,637,3.5,224.91199106982646,2
2020-10-29-170805,170805,1,0,0,638,1.0,237.06827501541963,3
2020-10-30-170805,170805,2,0,1,640,3.75,191.24588067093615,4
2020-10-31-170805,170805,0,1,0,640,2.5,182.93368128489973,5
2020-11-01-170805,170805,1,1,0,641,0.75,140.52696612011783,6
2020-11-02-170805,170805,0,0,0,641,3.75,194.61066551170222,0
2020-11-03-170805,170805,6,0,0,647,2.0,176.16367000339585,1
2020-11-04-170805,170805,3,0,0,650,3.5,193.0247157470454,2
2020-11-05-170805,170805,6,0,0,656,2.0,220.57860443291014,3
2020-11-06-170805,170805,3,1,0,659,4.75,214.34204388263504,4
2020-11-07-170805,170805,3,0,0,662,4.0,229.6835059101274,5
2020-11-08-170805,170805,1,1,0,663,7.25,243.23971264766556,6
2020-11-09-170805,170805,3,0,0,666,2.5,233.7880748894699,0
2020-11-10-170805,170805,1,0,0,667,2.75,133.97594069301726,1
2020-11-11-170805,170805,3,0,0,670,3.0,135.04711902306326,2
2020-11-12-170805,170805,0,0,0,670,2.75,165.3559047362354,3
2020-11-13-170805,170805,1,2,0,671,1.5,170.72639278135742,4
2020-03-01-170806,170806,0,0,6,0,0.0,0.0,6
2020-03-02-170806,170806,0,0,2,0,0.0,18.896329017448625,0
2020-03-03-170806,170806,0,1,3,0,0.16666666666666666,69.5899762174718,1
2020-03-04-170806,170806,0,0,10,0,0.0,79.19564452202124,2
2020-03-05-170806,170806,0,0,8,0,0.0,92.22386897873676,3
2020-03-06-170806,170806,0,0,7,0,0.0,89.07280304906148,4
2020-03-07-170806,170806,0,0,6,0,0.0,92.76265882374719,5
2020-03-08-170806,170806,0,0,9,0,0.0,88.8853895032134,6
2020-03-09-170806,170806,0,0,9,0,0.16666666666666666,88.89368772279595,0
2020-03-10-170806,170806,0,0,7,0,0.0,219.67828312042099,1
2020-03-11-170806,170806,0,0,3,0,0.16666666666666666,176.80248027532187,2
2020-03-12-170806,170806,0,0,2,0,0.5,159.83321981246456,3
2020-03-13-170806,170806,0,0,4,0,0.0,126.56801457949715,4
2020-03-14-170806,170806,0,0,2,0,1.0,83.50132335780893,5
2020-03-15-170806,170806,6,0,3,6,0.6666666666666666,46.51337208482885,6
2020-03-16-170806,170806,2,0,1,8,2.5,32.41987137398453,0
2020-03-17-170806,170806,3,0,2,11,2.333333333333333,51.63089792731592,1
2020-03-18-170806,170806,10,0,2,21,2.5,64.10937813022673,2
2020-03-19-170806,170806,8,1,4,29,3.5,102.88893660196808,3
2020-03-20-170806,170806,7,0,2,36,2.6666666666666665,127.96122254355525,4
2020-03-21-170806,170806,6,0,1,42,1.8333333333333333,147.46262560250742,5
2020-03-22-170806,170806,9,0,1,51,0.6666666666666666,146.24120746354276,6
2020-03-23-170806,170806,9,0,2,60,7.333333333333332,154.29834525696077,0
2020-03-24-170806,170806,7,0,2,67,4.666666666666667,179.80121797960356,1
2020-03-25-170806,170806,3,0,2,70,6.666666666666668,175.57348530123036,2
2020-03-26-170806,170806,2,0,1,72,3.333333333333333,177.21565645949465,3
2020-03-27-170806,170806,4,0,4,76,4.333333333333333,191.344120248747,4
2020-03-28-170806,170806,2,0,2,78,1.3333333333333333,186.003690223598,5
2020-03-29-170806,170806,3,0,5,81,1.3333333333333333,169.31694386647627,6
2020-03-30-170806,170806,1,0,2,82,5.0,115.68174390088265,0
2020-03-31-170806,170806,2,0,2,84,4.833333333333333,106.49815376793525,1
2020-04-01-170806,170806,2,0,0,86,4.833333333333333,23.47291560343404,2
2020-04-02-170806,170806,4,0,1,90,2.333333333333333,46.50954252825354,3
2020-04-03-170806,170806,2,0,0,92,3.8333333333333335,36.88418866885647,4
2020-04-04-170806,170806,1,0,0,93,2.333333333333333,49.10007909064664,5
2020-04-05-170806,170806,1,0,0,94,1.6666666666666667,56.209676100138914,6
2020-04-06-170806,170806,2,0,1,96,2.6666666666666665,63.04635689055032,0
2020-04-07-170806,170806,2,0,1,98,2.833333333333333,73.89312494429474,1
2020-04-08-170806,170806,2,0,0,100,3.1666666666666665,82.13616425898512,2
2020-04-09-170806,170806,1,0,1,101,0.8333333333333334,94.90379818082619,3
2020-04-10-170806,170806,4,0,3,105,3.5,20.433508924971097,4
2020-04-11-170806,170806,2,1,0,107,0.6666666666666666,39.01030054822322,5
2020-04-12-170806,170806,5,0,1,112,1.5,45.243525119301275,6
2020-04-13-170806,170806,2,0,0,114,1.6666666666666667,59.406889293476894,0
2020-04-14-170806,170806,2,0,3,116,2.0,74.84735397702407,1
2020-04-15-170806,170806,0,0,1,116,0.8333333333333334,90.3901531978742,2
2020-04-16-170806,170806,1,0,2,117,0.8333333333333334,96.1677840591408,3
2020-04-17-170806,170806,0,0,4,117,4.333333333333333,93.41540060747644,4
2020-04-18-170806,170806,0,0,0,117,0.5,80.41986036063983,5
2020-04-19-170806,170806,0,0,1,117,0.6666666666666666,79.85005190322448,6
2020-04-20-170806,170806,1,0,2,118,1.6666666666666667,72.34999236119187,0
2020-04-21-170806,170806,1,0,0,119,1.1666666666666667,72.20744571225204,1
2020-04-22-170806,170806,0,0,0,119,0.3333333333333333,76.73306530320099,2
2020-04-23-170806,170806,1,0,2,120,0.5,67.19496091036824,3
2020-04-24-170806,170806,3,0,0,123,1.5,62.31843800003843,4
2020-04-25-170806,170806,0,0,0,123,0.5,67.64968524872023,5
2020-04-26-170806,170806,1,0,0,124,0.5,65.98298387765794,6
2020-04-27-170806,170806,0,2,1,124,1.5,48.190370228872055,0
2020-04-28-170806,170806,3,0,0,127,0.6666666666666666,36.661875695932565,1
2020-04-29-170806,170806,1,0,1,128,1.3333333333333333,39.72030695642151,2
2020-04-30-170806,170806,2,0,1,130,0.3333333333333333,63.18195508770199,3
2020-05-01-170806,170806,4,0,0,134,0.3333333333333333,91.02524273525039,4
2020-05-02-170806,170806,0,0,0,134,0.5,30.041870192143197,5
2020-05-03-170806,170806,1,0,0,135,1.0,13.929571987350549,6
2020-05-04-170806,170806,2,0,1,137,2.0,22.29151344134067,0
2020-05-05-170806,170806,0,0,1,137,0.5,29.604566635907116,1
2020-05-06-170806,170806,0,0,2,137,4.666666666666667,32.1368631692275,2
2020-05-07-170806,170806,2,0,0,139,0.8333333333333334,52.73219467377963,3
2020-05-08-170806,170806,0,0,0,139,0.3333333333333333,63.51909298276219,4
2020-05-09-170806,170806,0,0,0,139,0.16666666666666666,65.01007516481172,5
2020-05-10-170806,170806,0,0,0,139,0.16666666666666666,125.06553484751814,6
2020-05-11-170806,170806,1,1,0,140,0.6666666666666666,113.18973362701769,0
2020-05-12-170806,170806,0,0,0,140,0.6666666666666666,109.7859349164062,1
2020-05-13-170806,170806,1,1,0,141,1.1666666666666667,89.00816163779272,2
2020-05-14-170806,170806,1,0,0,142,1.1666666666666667,77.20014290824653,3
2020-05-15-170806,170806,0,0,0,142,0.6666666666666666,63.55504437248028,4
2020-05-16-170806,170806,0,0,0,142,0.3333333333333333,56.5716525402232,5
2020-05-17-170806,170806,0,0,1,142,0.0,43.25029330857308,6
2020-05-18-170806,170806,1,0,1,143,1.5,43.123521630685644,0
2020-05-19-170806,170806,1,0,2,144,1.5,42.88221069533637,1
2020-05-20-170806,170806,2,0,1,146,1.6666666666666667,42.683461568480645,2
2020-05-21-170806,170806,0,0,0,146,0.6666666666666666,43.513867339304966,3
2020-05-22-170806,170806,0,0,0,146,0.6666666666666666,40.26166017031964,4
2020-05-23-170806,170806,0,0,0,146,0.6666666666666666,41.39420446069113,5
2020-05-24-170806,170806,0,0,0,146,0.16666666666666666,43.49261777147182,6
2020-05-25-170806,170806,0,0,0,146,0.8333333333333334,37.053264342558094,0
2020-05-26-170806,170806,0,0,0,146,1.0,30.21252916287064,1
2020-05-27-170806,170806,0,4,0,146,1.0,31.133994741517384,2
2020-05-28-170806,170806,0,0,1,146,1.0,23.72812046223691,3
2020-05-29-170806,170806,0,2,0,146,0.5,27.81796088414981,4
2020-05-30-170806,170806,0,0,0,146,0.3333333333333333,40.67628745300574,5
2020-05-31-170806,170806,1,0,1,147,0.0,43.47788412668473,6
2020-06-01-170806,170806,1,0,0,148,0.6666666666666666,94.97253129138747,0
2020-06-02-170806,170806,2,0,0,150,0.6666666666666666,23.818128434492372,1
2020-06-03-170806,170806,1,0,0,151,0.5,17.598636386280948,2
2020-06-04-170806,170806,0,0,0,151,0.16666666666666666,18.277552275885903,3
2020-06-05-170806,170806,0,1,2,151,0.3333333333333333,14.135003602732574,4
2020-06-06-170806,170806,0,0,0,151,0.0,16.402758733478638,5
2020-06-07-170806,170806,0,0,0,151,0.3333333333333333,16.664421664286373,6
2020-06-08-170806,170806,0,0,1,151,0.16666666666666666,17.61213259924841,0
2020-06-09-170806,170806,0,0,1,151,1.1666666666666667,19.671428986858462,1
2020-06-10-170806,170806,0,0,0,151,0.3333333333333333,93.21427579044835,2
2020-06-11-170806,170806,1,0,0,152,0.5,77.86996622350391,3
2020-06-12-170806,170806,0,0,0,152,0.5,79.16097352211743,4
2020-06-13-170806,170806,0,0,0,152,0.0,39.344977118532306,5
2020-06-14-170806,170806,1,0,0,153,0.0,25.61096494951897,6
2020-06-15-170806,170806,0,0,0,153,0.0,27.198162582173918,0
2020-06-16-170806,170806,0,0,0,153,0.3333333333333333,27.195109434089368,1
2020-06-17-170806,170806,0,0,0,153,0.0,23.280517655408914,2
2020-06-18-170806,170806,0,1,3,153,0.16666666666666666,21.349267937978823,3
2020-06-19-170806,170806,2,0,2,155,0.16666666666666666,16.85247885762675,4
2020-06-20-170806,170806,0,0,0,155,0.16666666666666666,39.61473762929205,5
2020-06-21-170806,170806,0,0,0,155,0.16666666666666666,36.41071942391319,6
2020-06-22-170806,170806,1,0,0,156,0.16666666666666666,37.98948098558944,0
2020-06-23-170806,170806,1,0,0,157,0.3333333333333333,40.36466916174935,1
2020-06-24-170806,170806,0,0,0,157,0.3333333333333333,42.61882120892108,2
2020-06-25-170806,170806,0,0,0,157,0.5,43.913456461052874,3
2020-06-26-170806,170806,0,0,0,157,0.0,39.38324932784906,4
2020-06-27-170806,170806,0,0,0,157,0.0,24.752065951728845,5
2020-06-28-170806,170806,0,0,0,157,0.0,24.83978856742228,6
2020-06-29-170806,170806,0,0,0,157,0.3333333333333333,26.006016211747525,0
2020-06-30-170806,170806,0,0,0,157,0.3333333333333333,21.096209868663557,1
2020-07-01-170806,170806,0,0,0,157,0.5,28.048093772587574,2
2020-07-02-170806,170806,3,0,0,160,0.0,25.591126124682464,3
2020-07-03-170806,170806,2,0,0,162,0.5,54.98829840989684,4
2020-07-04-170806,170806,0,0,0,162,0.16666666666666666,59.16789785838024,5
2020-07-05-170806,170806,0,0,0,162,0.0,52.400270139200046,6
2020-07-06-170806,170806,0,0,0,162,0.3333333333333333,51.60175219521028,0
2020-07-07-170806,170806,0,0,1,162,0.3333333333333333,53.434380664216725,1
2020-07-08-170806,170806,0,0,0,162,0.3333333333333333,50.851184678718234,2
2020-07-09-170806,170806,0,0,3,162,0.0,44.33320387796172,3
2020-07-10-170806,170806,0,0,0,162,0.16666666666666666,27.250896347882723,4
2020-07-11-170806,170806,0,0,2,162,0.0,26.439565430873095,5
2020-07-12-170806,170806,0,0,1,162,0.0,21.48506963298487,6
2020-07-13-170806,170806,0,0,0,162,1.3333333333333333,21.01763918580392,0
2020-07-14-170806,170806,0,0,0,162,0.5,25.531699736580187,1
2020-07-15-170806,170806,0,0,1,162,1.0,24.570992381942258,2
2020-07-16-170806,170806,0,0,1,162,0.5,19.40769105227548,3
2020-07-17-170806,170806,0,0,3,162,0.3333333333333333,22.12638688137752,4
2020-07-18-170806,170806,0,0,2,162,0.16666666666666666,22.342316710637444,5
2020-07-19-170806,170806,0,0,0,162,0.3333333333333333,24.409190408235965,6
2020-07-20-170806,170806,0,0,0,162,0.8333333333333334,26.708496523964143,0
2020-07-21-170806,170806,1,0,1,163,0.5,31.417221578132022,1
2020-07-22-170806,170806,0,0,0,163,0.16666666666666666,35.857772262438246,2
2020-07-23-170806,170806,3,0,0,166,0.3333333333333333,32.923679578677984,3
2020-07-24-170806,170806,0,0,0,166,1.0,46.113880201087795,4
2020-07-25-170806,170806,2,0,0,168,0.5,54.08316603104326,5
2020-07-26-170806,170806,1,0,0,169,0.0,65.56892807775813,6
2020-07-27-170806,170806,0,0,0,169,0.0,62.94347819010853,0
2020-07-28-170806,170806,0,0,0,169,0.16666666666666666,57.742660184372696,1
2020-07-29-170806,170806,1,0,0,170,0.3333333333333333,49.91642468380162,2
2020-07-30-170806,170806,1,0,0,171,1.1666666666666667,53.87533967283227,3
2020-07-31-170806,170806,3,0,0,174,0.5,59.16892445011832,4
2020-08-01-170806,170806,2,0,1,176,0.5,31.40561846963998,5
2020-08-02-170806,170806,0,0,0,176,0.16666666666666666,90.59580492822718,6
2020-08-03-170806,170806,0,0,0,176,1.3333333333333333,100.51131020259284,0
2020-08-04-170806,170806,1,0,0,177,1.1666666666666667,99.13331029701138,1
2020-08-05-170806,170806,0,0,1,177,2.0,96.87174462303359,2
2020-08-06-170806,170806,0,2,1,177,3.0,93.25679652188413,3
2020-08-07-170806,170806,0,0,0,177,2.333333333333333,98.93126539601751,4
2020-08-08-170806,170806,0,0,0,177,1.6666666666666667,90.48228190632693,5
2020-08-09-170806,170806,0,0,0,177,3.6666666666666665,90.23163843171929,6
2020-08-10-170806,170806,0,0,0,177,5.666666666666668,26.742463912499026,0
2020-08-11-170806,170806,0,0,1,177,4.166666666666667,41.1743057865483,1
2020-08-12-170806,170806,0,0,1,177,3.5,61.28440565678944,2
2020-08-13-170806,170806,0,0,0,177,3.6666666666666665,78.06766756022648,3
2020-08-14-170806,170806,0,0,0,177,5.333333333333333,90.57492482458096,4
2020-08-15-170806,170806,1,0,1,178,1.8333333333333333,112.86433368552835,5
2020-08-16-170806,170806,0,0,0,178,0.6666666666666666,121.67418710234975,6
2020-08-17-170806,170806,0,0,1,178,5.833333333333332,114.96797898197799,0
2020-08-18-170806,170806,0,0,0,178,2.0,110.42594620677112,1
2020-08-19-170806,170806,1,0,0,179,2.0,100.16943671405244,2
2020-08-20-170806,170806,1,0,0,180,1.8333333333333333,71.21722992826224,3
2020-08-21-170806,170806,0,0,0,180,1.5,56.9806242661348,4
2020-08-22-170806,170806,0,0,0,180,1.1666666666666667,52.32241010150915,5
2020-08-23-170806,170806,0,0,0,180,1.3333333333333333,59.273386749872046,6
2020-08-24-170806,170806,0,0,0,180,1.5,50.98518174680194,0
2020-08-25-170806,170806,1,0,0,181,2.833333333333333,47.55551055120715,1
2020-08-26-170806,170806,1,0,0,182,2.1666666666666665,57.80524125029578,2
2020-08-27-170806,170806,0,0,0,182,3.333333333333333,76.62237271657901,3
2020-08-28-170806,170806,0,0,1,182,2.333333333333333,82.57448717437906,4
2020-08-29-170806,170806,1,0,1,183,2.6666666666666665,89.27194255055667,5
2020-08-30-170806,170806,0,0,0,183,2.833333333333333,99.57576017748889,6
2020-08-31-170806,170806,1,0,0,184,0.5,101.6712530530253,0
2020-09-01-170806,170806,0,0,0,184,2.833333333333333,82.355462257416,1
2020-09-02-170806,170806,0,0,0,184,1.5,99.2821034785396,2
2020-09-03-170806,170806,0,0,0,184,3.1666666666666665,119.50599300148924,3
2020-09-04-170806,170806,0,0,0,184,3.1666666666666665,130.4830532205837,4
2020-09-05-170806,170806,0,0,1,184,0.6666666666666666,123.8809001782964,5
2020-09-06-170806,170806,0,0,0,184,1.1666666666666667,109.6240035921166,6
2020-09-07-170806,170806,0,0,0,184,1.6666666666666667,116.96588549665816,0
2020-09-08-170806,170806,0,0,1,184,3.333333333333333,98.12747514387405,1
2020-09-09-170806,170806,0,0,0,184,1.5,105.00101973468372,2
2020-09-10-170806,170806,0,0,0,184,4.833333333333333,91.6943583431232,3
2020-09-11-170806,170806,1,0,2,185,5.166666666666667,86.07674345199352,4
2020-09-12-170806,170806,1,0,1,186,1.0,90.85374434353449,5
2020-09-13-170806,170806,0,0,0,186,3.1666666666666665,89.42873322873469,6
2020-09-14-170806,170806,0,0,3,186,1.8333333333333333,92.44840422065117,0
2020-09-15-170806,170806,0,0,0,186,4.333333333333333,98.0071840519529,1
2020-09-16-170806,170806,0,0,1,186,3.1666666666666665,99.97561891138264,2
2020-09-17-170806,170806,0,0,0,186,2.833333333333333,93.07164621119344,3
2020-09-18-170806,170806,0,0,1,186,4.166666666666667,92.91244370356257,4
2020-09-19-170806,170806,1,0,0,187,1.8333333333333333,92.24102335169455,5
2020-09-20-170806,170806,0,0,1,187,3.5,80.74546149998167,6
2020-09-21-170806,170806,0,0,1,187,3.1666666666666665,84.04145963423755,0
2020-09-22-170806,170806,1,0,1,188,2.6666666666666665,80.20850133714814,1
2020-09-23-170806,170806,0,0,1,188,3.0,74.26013189055048,2
2020-09-24-170806,170806,0,1,8,188,1.8333333333333333,80.95918585136289,3
2020-09-25-170806,170806,2,0,5,190,3.1666666666666665,72.76309129175179,4
2020-09-26-170806,170806,1,0,2,191,2.1666666666666665,91.8513143874601,5
2020-09-27-170806,170806,0,0,3,191,0.6666666666666666,102.15463802318476,6
2020-09-28-170806,170806,3,0,0,194,2.0,94.11288176747935,0
2020-09-29-170806,170806,0,0,0,194,0.5,114.05118579496092,1
2020-09-30-170806,170806,1,0,0,195,1.8333333333333333,110.247900928001,2
2020-10-01-170806,170806,0,0,0,195,2.333333333333333,0.0,3
2020-10-02-170806,170806,1,0,2,196,3.8333333333333335,159.14027189490216,4
2020-10-03-170806,170806,0,0,0,196,2.1666666666666665,150.85393678546302,5
2020-10-04-170806,170806,1,0,4,197,2.833333333333333,140.9383137883499,6
2020-10-05-170806,170806,1,0,0,198,1.3333333333333333,125.42690633985244,0
2020-10-06-170806,170806,1,0,0,199,1.3333333333333333,123.75024249987962,1
2020-10-07-170806,170806,1,0,2,200,1.5,104.98278292706789,2
2020-10-08-170806,170806,8,0,0,208,4.333333333333333,106.52961863199897,3
2020-10-09-170806,170806,5,0,6,213,1.6666666666666667,141.35659669065868,4
2020-10-10-170806,170806,2,0,1,215,1.1666666666666667,4.51241785714247,5
2020-10-11-170806,170806,3,0,0,218,2.1666666666666665,12.579175029099087,6
2020-10-12-170806,170806,0,0,0,218,2.0,27.50336584264732,0
2020-10-13-170806,170806,0,0,0,218,3.8333333333333335,34.0917147034635,1
2020-10-14-170806,170806,0,0,2,218,1.8333333333333333,54.55870033682155,2
2020-10-15-170806,170806,0,0,0,218,1.6666666666666667,67.74462613504184,3
2020-10-16-170806,170806,2,0,6,220,4.0,84.10992519523823,4
2020-10-17-170806,170806,0,0,1,220,1.0,114.68555750842873,5
2020-10-18-170806,170806,4,0,0,224,3.333333333333333,123.552551675868,6
2020-10-19-170806,170806,0,0,10,224,2.333333333333333,162.39463408976889,0
2020-10-20-170806,170806,0,0,2,224,1.3333333333333333,157.51157186288174,1
2020-10-21-170806,170806,2,0,8,226,2.1666666666666665,154.4928055648334,2
2020-10-22-170806,170806,0,0,0,226,2.5,162.26046870031553,3
2020-10-23-170806,170806,6,0,2,232,3.5,141.54772201755117,4
2020-10-24-170806,170806,1,0,9,233,2.0,154.9507665946348,5
2020-10-25-170806,170806,0,1,4,233,1.6666666666666667,118.75300919026978,6
2020-10-26-170806,170806,0,0,6,233,3.8333333333333335,119.76100494272177,0
2020-10-27-170806,170806,0,0,0,233,3.333333333333333,135.9569934742837,1
2020-10-28-170806,170806,2,0,1,235,3.1666666666666665,135.92592734592017,2
2020-10-29-170806,170806,0,0,2,235,3.333333333333333,139.6716848880826,3
2020-10-30-170806,170806,6,0,1,241,3.6666666666666665,109.74453567102472,4
2020-10-31-170806,170806,1,0,0,242,2.0,131.7288545818382,5
2020-11-01-170806,170806,0,1,0,242,2.333333333333333,117.00312297781957,6
2020-11-02-170806,170806,10,0,0,252,3.0,187.15738092715947,0
2020-11-03-170806,170806,2,0,0,254,5.0,184.4989067827866,1
2020-11-04-170806,170806,8,0,0,262,1.8333333333333333,185.76831456267735,2
2020-11-05-170806,170806,0,0,0,262,3.5,219.7230974145895,3
2020-11-06-170806,170806,2,0,0,264,5.166666666666667,198.553923710742,4
2020-11-07-170806,170806,9,0,0,273,2.0,199.7118951331093,5
2020-11-08-170806,170806,4,1,0,277,2.833333333333333,206.62140582078408,6
2020-11-09-170806,170806,6,0,0,283,2.5,192.36104251996832,0
2020-11-10-170806,170806,0,0,0,283,2.833333333333333,106.10149885610427,1
2020-11-11-170806,170806,1,0,0,284,3.5,115.54095532772064,2
2020-11-12-170806,170806,2,0,0,286,3.5,130.34125253390465,3
2020-11-13-170806,170806,1,0,0,287,1.6666666666666667,142.57994588921997,4
2020-03-01-170807,170807,0,0,0,0,0.0,0.0,6
2020-03-02-170807,170807,0,0,2,0,0.0,4.750637970579595,0
2020-03-03-170807,170807,0,3,0,0,0.0,25.130533974222537,1
2020-03-04-170807,170807,0,0,2,0,0.0,30.05049330424408,2
2020-03-05-170807,170807,0,0,0,0,0.25,32.73049055752173,3
2020-03-06-170807,170807,0,0,1,0,0.0,28.377972413609193,4
2020-03-07-170807,170807,0,0,0,0,0.25,29.25027419994659,5
2020-03-08-170807,170807,0,0,0,0,0.0,29.312124043112107,6
2020-03-09-170807,170807,0,0,2,0,0.75,28.841970300886878,0
2020-03-10-170807,170807,0,0,0,0,0.0,36.55182449969985,1
2020-03-11-170807,170807,0,0,0,0,0.75,32.567838172673426,2
2020-03-12-170807,170807,0,0,3,0,0.75,24.26771529936608,3
2020-03-13-170807,170807,0,0,3,0,0.25,23.038741146049343,4
2020-03-14-170807,170807,0,0,1,0,1.0,18.042741230401745,5
2020-03-15-170807,170807,0,0,0,0,0.5,13.089980324503038,6
2020-03-16-170807,170807,2,0,2,2,3.25,8.753549869114423,0
2020-03-17-170807,170807,0,0,3,2,4.5,19.817273792304345,1
2020-03-18-170807,170807,2,1,3,4,3.5,26.255944642753917,2
2020-03-19-170807,170807,0,0,2,4,3.75,33.400702930864455,3
2020-03-20-170807,170807,1,0,0,5,5.5,34.60275998084231,4
2020-03-21-170807,170807,0,1,2,5,2.0,41.88990503156092,5
2020-03-22-170807,170807,0,0,0,5,2.25,42.174697654004866,6
2020-03-23-170807,170807,2,0,2,7,9.0,36.83709360907074,0
2020-03-24-170807,170807,0,0,2,7,8.0,47.17813792719319,1
2020-03-25-170807,170807,0,0,1,7,6.0,52.0516954909736,2
2020-03-26-170807,170807,3,0,1,10,6.0,55.98979618587268,3
2020-03-27-170807,170807,3,0,0,13,6.5,70.91792669718366,4
2020-03-28-170807,170807,1,0,0,14,1.75,75.57180730276315,5
2020-03-29-170807,170807,0,0,0,14,2.0,76.31362583345306,6
2020-03-30-170807,170807,2,1,0,16,8.0,56.41456387773346,0
2020-03-31-170807,170807,3,0,5,19,4.0,58.2918552717603,1
2020-04-01-170807,170807,3,0,0,22,11.0,9.913063411182883,2
2020-04-02-170807,170807,2,0,2,24,5.75,53.18050612309954,3
2020-04-03-170807,170807,0,0,0,24,3.0,24.667786863297746,4
2020-04-04-170807,170807,2,0,0,26,1.0,17.825636820470308,5
2020-04-05-170807,170807,0,0,0,26,1.75,20.16581588595005,6
2020-04-06-170807,170807,2,2,1,28,5.0,19.845287416830217,0
2020-04-07-170807,170807,2,0,0,30,3.5,25.969588349403274,1
2020-04-08-170807,170807,1,0,2,31,3.75,31.54500796711366,2
2020-04-09-170807,170807,1,0,2,32,5.25,34.7321904037956,3
2020-04-10-170807,170807,0,1,7,32,7.0,15.99139655382685,4
2020-04-11-170807,170807,0,0,1,32,3.0,26.47235575365228,5
2020-04-12-170807,170807,0,0,2,32,0.5,29.45028152301336,6
2020-04-13-170807,170807,0,0,0,32,4.5,28.612139206857332,0
2020-04-14-170807,170807,5,0,0,37,6.75,33.304983573698586,1
2020-04-15-170807,170807,0,0,0,37,5.25,45.02218956044928,2
2020-04-16-170807,170807,2,1,0,39,14.0,53.77136268876632,3
2020-04-17-170807,170807,0,0,0,39,2.0,61.88663899340223,4
2020-04-18-170807,170807,0,0,1,39,3.25,55.26711382866662,5
2020-04-19-170807,170807,0,0,0,39,0.5,55.16714653015435,6
2020-04-20-170807,170807,1,0,0,40,11.25,65.54855782041085,0
2020-04-21-170807,170807,0,0,0,40,0.75,64.1376543169734,1
2020-04-22-170807,170807,2,0,1,42,3.5,56.787108765227856,2
2020-04-23-170807,170807,2,0,1,44,0.0,40.32385559537771,3
2020-04-24-170807,170807,7,0,2,51,2.75,39.52472150154233,4
2020-04-25-170807,170807,1,0,1,52,1.0,51.113696832225784,5
2020-04-26-170807,170807,2,0,0,54,0.5,52.17275643169266,6
2020-04-27-170807,170807,0,0,0,54,2.5,42.39859680077926,0
2020-04-28-170807,170807,0,1,0,54,1.0,30.63282398377697,1
2020-04-29-170807,170807,0,0,0,54,1.0,30.292570866230797,2
2020-04-30-170807,170807,0,0,1,54,1.5,30.453526111781855,3
2020-05-01-170807,170807,0,0,0,54,0.75,39.07732977570631,4
2020-05-02-170807,170807,1,0,0,55,2.75,13.9210276574962,5
2020-05-03-170807,170807,0,0,0,55,1.0,13.990045636803858,6
2020-05-04-170807,170807,0,0,0,55,3.5,13.511816064035832,0
2020-05-05-170807,170807,0,0,0,55,4.5,13.289124889639815,1
2020-05-06-170807,170807,1,0,0,56,3.75,19.183160209452176,2
2020-05-07-170807,170807,1,0,0,57,1.5,21.37222618333531,3
2020-05-08-170807,170807,2,0,1,59,2.25,25.255981689553934,4
2020-05-09-170807,170807,1,0,0,60,0.5,29.960693206204006,5
2020-05-10-170807,170807,0,0,0,60,0.75,51.7781701319568,6
2020-05-11-170807,170807,0,0,0,60,2.75,44.160161103136645,0
2020-05-12-170807,170807,0,0,0,60,2.25,42.88926994950674,1
2020-05-13-170807,170807,0,0,0,60,3.25,32.862510877091914,2
2020-05-14-170807,170807,1,0,0,61,1.5,30.884395276003158,3
2020-05-15-170807,170807,0,1,0,61,2.75,27.847161525842484,4
2020-05-16-170807,170807,0,0,0,61,1.0,20.077863100686784,5
2020-05-17-170807,170807,0,0,0,61,0.25,19.30219158925225,6
2020-05-18-170807,170807,0,0,0,61,1.25,18.835310008880313,0
2020-05-19-170807,170807,0,0,0,61,1.5,16.70852311056793,1
2020-05-20-170807,170807,0,0,0,61,0.75,19.855307490160104,2
2020-05-21-170807,170807,0,0,1,61,1.25,16.89612247808896,3
2020-05-22-170807,170807,1,0,0,62,0.75,15.436343489545544,4
2020-05-23-170807,170807,0,0,0,62,0.5,18.46859339824651,5
2020-05-24-170807,170807,0,0,0,62,1.0,20.090751401968465,6
2020-05-25-170807,170807,0,0,0,62,2.0,19.141969760138075,0
2020-05-26-170807,170807,0,0,1,62,3.0,20.311816951449426,1
2020-05-27-170807,170807,0,4,0,62,0.5,17.581475892625722,2
2020-05-28-170807,170807,0,0,1,62,2.25,18.124410810638235,3
2020-05-29-170807,170807,0,0,0,62,1.0,22.28131626061576,4
2020-05-30-170807,170807,0,0,0,62,0.75,21.231422612753246,5
2020-05-31-170807,170807,0,0,0,62,0.0,22.21234055473861,6
2020-06-01-170807,170807,0,0,0,62,0.5,36.62234219279163,0
2020-06-02-170807,170807,0,0,0,62,1.0,9.492686144256774,1
2020-06-03-170807,170807,0,0,0,62,0.5,7.031146882156178,2
2020-06-04-170807,170807,1,0,0,63,0.5,7.151894694156605,3
2020-06-05-170807,170807,0,0,0,63,0.25,8.998479550947055,4
2020-06-06-170807,170807,0,0,0,63,0.5,5.641154884401217,5
2020-06-07-170807,170807,0,0,0,63,1.0,6.2757507337352365,6
2020-06-08-170807,170807,0,0,0,63,0.75,7.538730076053456,0
2020-06-09-170807,170807,1,0,0,64,1.25,8.038619284992562,1
2020-06-10-170807,170807,0,0,0,64,1.25,35.38122146498746,2
2020-06-11-170807,170807,1,0,0,65,0.5,33.71330786279366,3
2020-06-12-170807,170807,0,0,0,65,2.0,28.454372902662442,4
2020-06-13-170807,170807,0,0,0,65,1.25,23.971287581823603,5
2020-06-14-170807,170807,0,0,0,65,0.25,19.91046355587875,6
2020-06-15-170807,170807,0,0,0,65,0.25,13.88766641066482,0
2020-06-16-170807,170807,0,0,0,65,1.0,12.504797200109053,1
2020-06-17-170807,170807,0,0,0,65,2.25,12.52112383158351,2
2020-06-18-170807,170807,0,0,0,65,0.5,13.987456811379431,3
2020-06-19-170807,170807,0,0,0,65,1.0,12.413476880866945,4
2020-06-20-170807,170807,0,0,0,65,0.0,9.648191592326377,5
2020-06-21-170807,170807,0,0,0,65,0.75,9.596040457577768,6
2020-06-22-170807,170807,0,0,0,65,0.5,10.366171963671215,0
2020-06-23-170807,170807,0,0,0,65,0.75,10.226031850246239,1
2020-06-24-170807,170807,0,0,0,65,0.0,8.253614748384265,2
2020-06-25-170807,170807,0,1,0,65,0.5,7.530189396086743,3
2020-06-26-170807,170807,0,0,0,65,1.0,7.37902277443342,4
2020-06-27-170807,170807,0,0,0,65,0.25,10.338450389210132,5
2020-06-28-170807,170807,0,0,0,65,0.5,10.82544503824724,6
2020-06-29-170807,170807,0,0,0,65,0.0,8.951495529667907,0
2020-06-30-170807,170807,0,0,0,65,0.25,7.381632619817545,1
2020-07-01-170807,170807,0,0,0,65,0.5,14.220395183051213,2
2020-07-02-170807,170807,0,0,0,65,0.25,11.17089973163013,3
2020-07-03-170807,170807,0,0,0,65,0.25,17.05146347015062,4
2020-07-04-170807,170807,0,0,0,65,0.25,19.704148109177325,5
2020-07-05-170807,170807,0,0,0,65,0.0,17.80142353745558,6
2020-07-06-170807,170807,0,0,0,65,0.25,16.151512436494755,0
2020-07-07-170807,170807,0,0,0,65,0.5,17.618569027091006,1
2020-07-08-170807,170807,0,0,0,65,1.5,16.70355057758919,2
2020-07-09-170807,170807,0,0,0,65,0.25,19.22198824935967,3
2020-07-10-170807,170807,0,0,0,65,0.25,15.39479925626927,4
2020-07-11-170807,170807,0,0,0,65,0.0,11.873493299806404,5
2020-07-12-170807,170807,0,0,0,65,0.25,11.395043185151346,6
2020-07-13-170807,170807,0,0,0,65,0.75,10.943152831398432,0
2020-07-14-170807,170807,0,0,0,65,0.5,12.30473070821399,1
2020-07-15-170807,170807,0,0,0,65,0.5,12.892014923273736,2
2020-07-16-170807,170807,0,0,0,65,1.5,8.092427123362228,3
2020-07-17-170807,170807,0,0,0,65,0.5,9.015710221805298,4
2020-07-18-170807,170807,0,0,0,65,0.5,11.516112438916467,5
2020-07-19-170807,170807,0,0,0,65,0.0,13.801407619487788,6
2020-07-20-170807,170807,0,0,0,65,1.0,10.610727342521717,0
2020-07-21-170807,170807,0,0,0,65,0.75,14.375001921983605,1
2020-07-22-170807,170807,0,0,0,65,0.5,16.161982463177413,2
2020-07-23-170807,170807,0,0,0,65,1.5,16.98012791697408,3
2020-07-24-170807,170807,0,0,0,65,0.75,21.384135103944136,4
2020-07-25-170807,170807,0,0,1,65,0.0,21.611802338299892,5
2020-07-26-170807,170807,0,0,0,65,1.0,22.065228173849412,6
2020-07-27-170807,170807,0,0,1,65,1.0,23.979280725670176,0
2020-07-28-170807,170807,0,0,0,65,0.0,21.566205298548816,1
2020-07-29-170807,170807,0,0,0,65,1.75,19.101909901528753,2
2020-07-30-170807,170807,0,0,1,65,0.75,13.990178858810701,3
2020-07-31-170807,170807,0,0,0,65,0.75,12.887497011337558,4
2020-08-01-170807,170807,0,0,0,65,1.25,19.070289540886364,5
2020-08-02-170807,170807,0,0,0,65,0.25,53.51659464956043,6
2020-08-03-170807,170807,0,0,0,65,1.0,27.62006377898344,0
2020-08-04-170807,170807,0,0,2,65,1.5,30.5979511482673,1
2020-08-05-170807,170807,0,0,5,65,3.75,31.766980838020096,2
2020-08-06-170807,170807,0,0,0,65,3.5,31.39879721646157,3
2020-08-07-170807,170807,0,0,0,65,0.75,23.93601445016619,4
2020-08-08-170807,170807,1,0,1,66,1.75,26.073210154984938,5
2020-08-09-170807,170807,0,0,0,66,1.0,29.466489156006205,6
2020-08-10-170807,170807,1,0,0,67,0.5,8.904648820789914,0
2020-08-11-170807,170807,0,0,0,67,2.5,14.338804601525311,1
2020-08-12-170807,170807,0,0,0,67,1.25,21.390970916275016,2
2020-08-13-170807,170807,1,0,0,68,2.25,27.544624181940062,3
2020-08-14-170807,170807,0,0,0,68,1.5,32.74886330733027,4
2020-08-15-170807,170807,0,0,0,68,0.75,35.36781926475706,5
2020-08-16-170807,170807,0,0,0,68,0.5,38.49728264884536,6
2020-08-17-170807,170807,0,0,0,68,1.0,40.0935484618049,0
2020-08-18-170807,170807,2,0,1,70,3.0,36.169961092852205,1
2020-08-19-170807,170807,5,0,1,75,2.25,44.285396672603426,2
2020-08-20-170807,170807,0,0,0,75,0.25,52.361563314511265,3
2020-08-21-170807,170807,0,0,0,75,2.25,46.181181563567,4
2020-08-22-170807,170807,1,0,0,76,1.0,49.378245992314326,5
2020-08-23-170807,170807,0,0,0,76,1.25,52.511747871042495,6
2020-08-24-170807,170807,0,0,0,76,2.0,53.36180394927873,0
2020-08-25-170807,170807,0,0,0,76,0.5,41.976740152911454,1
2020-08-26-170807,170807,0,0,0,76,1.25,20.758955764667146,2
2020-08-27-170807,170807,0,0,0,76,1.75,21.491012843751143,3
2020-08-28-170807,170807,0,0,0,76,2.0,25.937787421663426,4
2020-08-29-170807,170807,0,0,0,76,0.0,33.64667807472496,5
2020-08-30-170807,170807,0,0,0,76,0.5,28.18477320491411,6
2020-08-31-170807,170807,0,0,0,76,2.25,24.881288097942228,0
2020-09-01-170807,170807,1,0,0,77,1.25,30.28845492258398,1
2020-09-02-170807,170807,1,0,0,78,0.5,15.736611623634044,2
2020-09-03-170807,170807,0,0,0,78,1.5,53.80914490455734,3
2020-09-04-170807,170807,0,0,0,78,2.25,39.19313794248519,4
2020-09-05-170807,170807,0,0,0,78,1.0,24.85002196531441,5
2020-09-06-170807,170807,0,0,0,78,1.25,19.792305359179736,6
2020-09-07-170807,170807,0,0,0,78,2.25,19.889008435210314,0
2020-09-08-170807,170807,0,0,0,78,0.5,19.35396720210395,1
2020-09-09-170807,170807,0,1,0,78,3.25,20.349710855572788,2
2020-09-10-170807,170807,0,0,0,78,1.25,23.970031821069128,3
2020-09-11-170807,170807,0,0,0,78,2.0,24.43139344424503,4
2020-09-12-170807,170807,0,0,0,78,2.75,25.19664518668695,5
2020-09-13-170807,170807,0,0,0,78,0.5,24.016113563269812,6
2020-09-14-170807,170807,0,0,0,78,2.5,23.651574976291762,0
2020-09-15-170807,170807,0,0,0,78,2.5,20.01752804632492,1
2020-09-16-170807,170807,0,0,0,78,2.0,20.27217526208201,2
2020-09-17-170807,170807,0,1,0,78,1.0,18.00738101478719,3
2020-09-18-170807,170807,0,0,0,78,2.5,17.409842571957242,4
2020-09-19-170807,170807,0,0,0,78,0.0,15.67188266711518,5
2020-09-20-170807,170807,0,0,0,78,2.25,14.17277290340946,6
2020-09-21-170807,170807,0,1,0,78,3.0,16.06369625508831,0
2020-09-22-170807,170807,0,0,0,78,1.5,19.24648301329952,1
2020-09-23-170807,170807,0,0,0,78,3.25,22.31427273276375,2
2020-09-24-170807,170807,0,0,0,78,4.75,23.06168387759036,3
2020-09-25-170807,170807,0,0,0,78,7.5,33.93579997318284,4
2020-09-26-170807,170807,0,0,0,78,2.25,48.43315341157288,5
2020-09-27-170807,170807,0,0,0,78,0.25,51.71253701098588,6
2020-09-28-170807,170807,0,0,0,78,2.0,49.21716106090952,0
2020-09-29-170807,170807,0,0,0,78,0.25,48.35448655360084,1
2020-09-30-170807,170807,0,0,0,78,1.25,46.84597176929919,2
2020-10-01-170807,170807,0,0,0,78,1.25,0.0,3
2020-10-02-170807,170807,0,0,0,78,0.0,43.06348493611451,4
2020-10-03-170807,170807,0,0,0,78,0.0,40.397577859211225,5
2020-10-04-170807,170807,0,0,0,78,0.0,26.917906541631154,6
2020-10-05-170807,170807,0,0,0,78,1.0,21.356017311163807,0
2020-10-06-170807,170807,0,0,0,78,1.25,18.824485894706577,1
2020-10-07-170807,170807,0,0,0,78,1.25,14.369732041270325,2
2020-10-08-170807,170807,0,0,1,78,2.75,13.987350496416454,3
2020-10-09-170807,170807,0,0,0,78,1.25,21.168972312051743,4
2020-10-10-170807,170807,0,0,1,78,1.25,2.6421779480008216,5
2020-10-11-170807,170807,0,0,3,78,1.5,4.742550716554028,6
2020-10-12-170807,170807,0,0,1,78,1.0,6.254725261092297,0
2020-10-13-170807,170807,0,0,1,78,2.5,7.787686822649773,1
2020-10-14-170807,170807,0,0,1,78,1.25,11.619432216789537,2
2020-10-15-170807,170807,0,0,0,78,2.75,14.460500561419208,3
2020-10-16-170807,170807,0,0,1,78,7.5,18.311601088518454,4
2020-10-17-170807,170807,0,0,0,78,11.75,33.98344902760126,5
2020-10-18-170807,170807,0,0,0,78,2.5,45.65154129206754,6
2020-10-19-170807,170807,0,0,3,78,1.75,46.0592173497639,0
2020-10-20-170807,170807,0,0,2,78,1.75,43.31921267507509,1
2020-10-21-170807,170807,0,0,0,78,4.5,42.296029220748984,2
2020-10-22-170807,170807,1,0,0,79,3.25,42.53372462824695,3
2020-10-23-170807,170807,0,0,0,79,5.0,30.283253989972714,4
2020-10-24-170807,170807,1,0,0,80,2.5,21.50444501218622,5
2020-10-25-170807,170807,3,0,0,83,2.75,23.90065600986619,6
2020-10-26-170807,170807,1,0,0,84,2.25,31.62568090397494,0
2020-10-27-170807,170807,1,0,0,85,1.5,35.08072884143967,1
2020-10-28-170807,170807,1,1,0,86,3.0,38.45058454252256,2
2020-10-29-170807,170807,0,0,1,86,2.25,41.137165956618276,3
2020-10-30-170807,170807,1,0,0,87,2.75,35.43575508448619,4
2020-10-31-170807,170807,0,0,0,87,2.5,33.90398977939774,5
2020-11-01-170807,170807,0,0,0,87,1.25,18.209364352998257,6
2020-11-02-170807,170807,3,0,0,90,3.0,59.381131049747474,0
2020-11-03-170807,170807,2,1,0,92,3.5,76.50060339613918,1
2020-11-04-170807,170807,0,0,0,92,2.25,80.22334665330357,2
2020-11-05-170807,170807,0,0,0,92,6.0,76.59400160844652,3
2020-11-06-170807,170807,0,0,0,92,4.25,75.41854597742787,4
2020-11-07-170807,170807,0,0,0,92,5.25,71.40511004173922,5
2020-11-08-170807,170807,0,0,0,92,7.25,66.16973402352532,6
2020-11-09-170807,170807,0,0,0,92,5.5,59.178153457472064,0
2020-11-10-170807,170807,0,0,0,92,3.25,15.505562896865012,1
2020-11-11-170807,170807,0,0,0,92,3.75,19.738522187721685,2
2020-11-12-170807,170807,1,0,0,93,4.5,25.431023838822536,3
2020-11-13-170807,170807,0,0,0,93,2.0,32.4372878898809,4
2020-03-01-170808,170808,0,0,0,0,0.0,0.0,6
2020-03-02-170808,170808,0,1,1,0,0.0,3.9977989517085764,0
2020-03-03-170808,170808,0,0,2,0,0.0,17.45352802659496,1
2020-03-04-170808,170808,0,0,0,0,0.0,20.233269304280114,2
2020-03-05-170808,170808,0,0,2,0,0.3333333333333333,22.079755264123882,3
2020-03-06-170808,170808,0,0,1,0,0.0,17.538474499915424,4
2020-03-07-170808,170808,0,0,0,0,0.3333333333333333,17.96482761035897,5
2020-03-08-170808,170808,0,1,0,0,0.0,18.306646050742387,6
2020-03-09-170808,170808,0,0,1,0,0.6666666666666666,17.95975585770944,0
2020-03-10-170808,170808,0,0,1,0,0.0,56.89934497009443,1
2020-03-11-170808,170808,0,0,3,0,0.6666666666666666,53.42309092704449,2
2020-03-12-170808,170808,0,0,3,0,0.3333333333333333,41.73740476902255,3
2020-03-13-170808,170808,0,0,3,0,0.0,40.88372489223823,4
2020-03-14-170808,170808,1,0,1,1,0.0,29.43393111171414,5
2020-03-15-170808,170808,0,0,1,1,0.3333333333333333,19.73539109777772,6
2020-03-16-170808,170808,1,1,1,2,2.333333333333333,8.608486779926082,0
2020-03-17-170808,170808,2,0,0,4,2.6666666666666665,17.04423524531533,1
2020-03-18-170808,170808,0,0,1,4,3.333333333333333,20.32966676219347,2
2020-03-19-170808,170808,2,0,0,6,1.6666666666666667,26.55842920498863,3
2020-03-20-170808,170808,1,0,0,7,2.0,25.9657726593007,4
2020-03-21-170808,170808,0,0,0,7,1.3333333333333333,30.847150849920126,5
2020-03-22-170808,170808,0,0,0,7,0.6666666666666666,32.02608577486687,6
2020-03-23-170808,170808,1,0,0,8,3.6666666666666665,27.278077711388597,0
2020-03-24-170808,170808,1,1,2,9,3.333333333333333,32.827279765371756,1
2020-03-25-170808,170808,3,0,0,12,2.333333333333333,33.843638948062065,2
2020-03-26-170808,170808,3,0,1,15,4.0,35.22013497288037,3
2020-03-27-170808,170808,3,0,0,18,5.666666666666668,43.121201284265226,4
2020-03-28-170808,170808,1,0,0,19,1.3333333333333333,46.230764844678504,5
2020-03-29-170808,170808,1,0,0,20,0.3333333333333333,45.72932283285017,6
2020-03-30-170808,170808,1,0,0,21,4.333333333333333,34.96882479360691,0
2020-03-31-170808,170808,0,0,0,21,4.333333333333333,34.58912021614979,1
2020-04-01-170808,170808,1,0,0,22,10.0,5.683104652991596,2
2020-04-02-170808,170808,0,0,0,22,3.0,31.85807359554022,3
2020-04-03-170808,170808,0,0,1,22,1.0,14.894607301145454,4
2020-04-04-170808,170808,0,0,0,22,1.6666666666666667,13.071804614099346,5
2020-04-05-170808,170808,0,0,0,22,1.0,14.298469647177534,6
2020-04-06-170808,170808,0,0,0,22,4.333333333333333,14.471912762041201,0
2020-04-07-170808,170808,2,0,0,24,4.0,16.84539084264895,1
2020-04-08-170808,170808,0,0,4,24,3.6666666666666665,21.436339784616482,2
2020-04-09-170808,170808,1,1,0,25,3.0,23.622383162817567,3
2020-04-10-170808,170808,0,0,0,25,1.0,9.646523089832897,4
2020-04-11-170808,170808,0,0,0,25,1.6666666666666667,14.063295826086017,5
2020-04-12-170808,170808,0,0,0,25,0.6666666666666666,16.029778188694515,6
2020-04-13-170808,170808,0,0,1,25,4.666666666666667,16.69768660274279,0
2020-04-14-170808,170808,0,0,0,25,8.333333333333334,20.912988177216562,1
2020-04-15-170808,170808,0,0,0,25,1.3333333333333333,28.45821911435404,2
2020-04-16-170808,170808,0,0,0,25,8.0,33.334378518469336,3
2020-04-17-170808,170808,1,0,0,26,0.6666666666666666,36.06214442378577,4
2020-04-18-170808,170808,0,0,0,26,4.0,35.198283241268996,5
2020-04-19-170808,170808,0,0,0,26,0.6666666666666666,37.06279610947968,6
2020-04-20-170808,170808,0,4,1,26,13.666666666666664,39.49198944201392,0
2020-04-21-170808,170808,0,0,1,26,0.6666666666666666,44.41712644687807,1
2020-04-22-170808,170808,4,0,0,30,3.0,41.96121210211726,2
2020-04-23-170808,170808,0,0,0,30,1.0,35.47829523437413,3
2020-04-24-170808,170808,0,0,3,30,4.333333333333333,34.55141826172382,4
2020-04-25-170808,170808,0,0,0,30,1.3333333333333333,37.66100494166205,5
2020-04-26-170808,170808,0,0,1,30,0.6666666666666666,38.50736857057548,6
2020-04-27-170808,170808,1,0,0,31,2.0,34.01444800553995,0
2020-04-28-170808,170808,0,0,3,31,1.6666666666666667,22.254563375574524,1
2020-04-29-170808,170808,0,0,0,31,0.3333333333333333,22.52208788248855,2
2020-04-30-170808,170808,0,0,1,31,1.0,21.718538592374564,3
2020-05-01-170808,170808,0,0,3,31,1.0,35.80878061715454,4
2020-05-02-170808,170808,0,0,0,31,1.3333333333333333,13.123102014301129,5
2020-05-03-170808,170808,0,0,1,31,0.0,10.651701224527582,6
2020-05-04-170808,170808,1,0,1,32,3.333333333333333,9.812674391787134,0
2020-05-05-170808,170808,1,0,0,33,2.333333333333333,10.703146494838311,1
2020-05-06-170808,170808,0,0,0,33,3.333333333333333,14.4332473400939,2
2020-05-07-170808,170808,0,0,3,33,2.0,15.224265707126516,3
2020-05-08-170808,170808,3,0,1,36,2.0,18.540006463382436,4
2020-05-09-170808,170808,0,0,0,36,0.6666666666666666,22.826166450904132,5
2020-05-10-170808,170808,1,0,0,37,0.0,38.2645698497098,6
2020-05-11-170808,170808,0,0,0,37,1.6666666666666667,33.644966791549614,0
2020-05-12-170808,170808,3,0,1,40,3.6666666666666665,32.49828812280394,1
2020-05-13-170808,170808,0,0,0,40,3.0,29.01445427938735,2
2020-05-14-170808,170808,1,0,0,41,0.6666666666666666,24.91508048720827,3
2020-05-15-170808,170808,3,0,0,44,1.6666666666666667,21.630219036775124,4
2020-05-16-170808,170808,0,0,0,44,0.3333333333333333,17.161408476699783,5
2020-05-17-170808,170808,1,0,0,45,0.0,15.940265455384587,6
2020-05-18-170808,170808,1,0,0,46,1.3333333333333333,15.384288248229685,0
2020-05-19-170808,170808,0,0,0,46,2.0,14.661172912645249,1
2020-05-20-170808,170808,0,0,0,46,0.3333333333333333,13.083761953300574,2
2020-05-21-170808,170808,3,0,0,49,0.6666666666666666,12.338682071486776,3
2020-05-22-170808,170808,1,0,0,50,0.3333333333333333,12.14897842150051,4
2020-05-23-170808,170808,0,0,0,50,0.0,14.703648036709376,5
2020-05-24-170808,170808,0,0,1,50,1.3333333333333333,15.350781266553444,6
2020-05-25-170808,170808,0,0,0,50,1.6666666666666667,14.2900327800691,0
2020-05-26-170808,170808,1,0,1,51,2.0,14.430555871884016,1
2020-05-27-170808,170808,0,0,0,51,0.0,13.948544567058676,2
2020-05-28-170808,170808,0,0,1,51,1.6666666666666667,13.184661922903018,3
2020-05-29-170808,170808,0,0,0,51,0.6666666666666666,15.362092740403018,4
2020-05-30-170808,170808,0,0,4,51,1.0,13.729391740035442,5
2020-05-31-170808,170808,0,0,0,51,0.3333333333333333,14.146820403040932,6
2020-06-01-170808,170808,0,0,0,51,0.3333333333333333,24.75132393652752,0
2020-06-02-170808,170808,0,1,0,51,1.0,8.834426371665142,1
2020-06-03-170808,170808,0,0,0,51,0.6666666666666666,6.3285415875062005,2
2020-06-04-170808,170808,0,0,0,51,0.6666666666666666,6.672587698087254,3
2020-06-05-170808,170808,0,1,0,51,0.3333333333333333,7.213049936089008,4
2020-06-06-170808,170808,0,0,0,51,0.3333333333333333,3.960651170741272,5
2020-06-07-170808,170808,1,1,0,52,0.3333333333333333,4.2192324004256205,6
2020-06-08-170808,170808,0,0,0,52,1.0,4.745428206938753,0
2020-06-09-170808,170808,1,0,1,53,1.0,5.355285348233945,1
2020-06-10-170808,170808,0,0,0,53,1.3333333333333333,24.255239439749786,2
2020-06-11-170808,170808,1,0,0,54,0.3333333333333333,22.12558566936671,3
2020-06-12-170808,170808,0,0,0,54,0.6666666666666666,19.075436582647626,4
2020-06-13-170808,170808,4,0,0,58,0.3333333333333333,15.697532099789628,5
2020-06-14-170808,170808,0,0,0,58,0.3333333333333333,13.429596534980636,6
2020-06-15-170808,170808,0,0,0,58,0.0,9.253258190608042,0
2020-06-16-170808,170808,0,0,0,58,1.0,9.7808702796076,1
2020-06-17-170808,170808,0,0,0,58,2.0,10.202350665801536,2
2020-06-18-170808,170808,0,0,0,58,0.3333333333333333,11.165273576929426,3
2020-06-19-170808,170808,0,0,0,58,0.6666666666666666,10.39073736888729,4
2020-06-20-170808,170808,0,0,0,58,0.0,8.596736029501828,5
2020-06-21-170808,170808,0,0,0,58,0.0,8.573269036615796,6
2020-06-22-170808,170808,0,0,0,58,0.3333333333333333,7.86798891352565,0
2020-06-23-170808,170808,1,1,0,59,0.0,7.480220307979812,1
2020-06-24-170808,170808,0,1,2,59,0.0,5.269966499195237,2
2020-06-25-170808,170808,0,0,1,59,0.3333333333333333,4.72803622326376,3
2020-06-26-170808,170808,0,0,0,59,0.3333333333333333,4.420502503716266,4
2020-06-27-170808,170808,0,0,0,59,0.3333333333333333,8.040753840887625,5
2020-06-28-170808,170808,0,0,0,59,0.6666666666666666,8.511493259881213,6
2020-06-29-170808,170808,0,0,0,59,0.0,8.28169234238077,0
2020-06-30-170808,170808,0,0,0,59,0.0,7.863339981501474,1
2020-07-01-170808,170808,0,0,0,59,0.3333333333333333,9.7037877329863,2
2020-07-02-170808,170808,0,0,0,59,0.0,6.783204333629445,3
2020-07-03-170808,170808,0,0,0,59,0.3333333333333333,14.684664871326596,4
2020-07-04-170808,170808,0,0,0,59,0.0,11.64252285914726,5
2020-07-05-170808,170808,0,0,0,59,0.0,10.396652212338964,6
2020-07-06-170808,170808,0,0,0,59,0.0,9.235579456269281,0
2020-07-07-170808,170808,0,0,1,59,0.3333333333333333,10.054479360533662,1
2020-07-08-170808,170808,2,0,0,61,0.3333333333333333,8.751200102187855,2
2020-07-09-170808,170808,1,0,1,62,0.0,9.644175730383914,3
2020-07-10-170808,170808,0,0,0,62,0.3333333333333333,10.144039543708235,4
2020-07-11-170808,170808,0,0,0,62,0.0,8.524566158075094,5
2020-07-12-170808,170808,0,0,0,62,0.0,7.867533776944556,6
2020-07-13-170808,170808,0,0,1,62,0.6666666666666666,7.424812087475696,0
2020-07-14-170808,170808,0,0,0,62,0.3333333333333333,7.428004501432451,1
2020-07-15-170808,170808,0,0,1,62,0.6666666666666666,7.345449133481312,2
2020-07-16-170808,170808,0,0,1,62,1.0,4.857200156978937,3
2020-07-17-170808,170808,0,0,0,62,0.0,5.764153517350426,4
2020-07-18-170808,170808,0,0,0,62,0.0,6.737618515499326,5
2020-07-19-170808,170808,0,0,0,62,0.0,7.695882672676776,6
2020-07-20-170808,170808,0,0,1,62,0.3333333333333333,7.291191785024189,0
2020-07-21-170808,170808,1,0,0,63,0.3333333333333333,9.613629793999518,1
2020-07-22-170808,170808,0,0,0,63,0.0,10.144911163468674,2
2020-07-23-170808,170808,1,0,3,64,0.3333333333333333,11.217765074993919,3
2020-07-24-170808,170808,0,0,1,64,0.3333333333333333,17.177884115667837,4
2020-07-25-170808,170808,0,0,0,64,0.0,17.478871887863967,5
2020-07-26-170808,170808,0,0,2,64,0.3333333333333333,19.142264413720476,6
2020-07-27-170808,170808,1,0,1,65,0.0,18.73504186949132,0
2020-07-28-170808,170808,0,0,1,65,0.0,17.281890271126656,1
2020-07-29-170808,170808,1,0,0,66,0.6666666666666666,15.669149678672035,2
2020-07-30-170808,170808,1,0,0,67,0.3333333333333333,10.304316776080682,3
2020-07-31-170808,170808,0,0,1,67,0.6666666666666666,9.697247917997055,4
2020-08-01-170808,170808,0,0,0,67,1.6666666666666667,10.140956983539983,5
2020-08-02-170808,170808,0,0,0,67,0.0,56.18417663396997,6
2020-08-03-170808,170808,1,0,0,68,0.0,22.774511174460606,0
2020-08-04-170808,170808,0,0,1,68,1.3333333333333333,27.529620998854377,1
2020-08-05-170808,170808,0,0,3,68,4.333333333333333,27.92380714513434,2
2020-08-06-170808,170808,3,0,0,71,3.333333333333333,24.90778110736428,3
2020-08-07-170808,170808,1,0,1,72,0.6666666666666666,26.335074624857803,4
2020-08-08-170808,170808,0,0,0,72,1.3333333333333333,27.503371779934373,5
2020-08-09-170808,170808,2,0,2,74,0.0,27.728217623573016,6
2020-08-10-170808,170808,1,0,1,75,0.6666666666666666,6.397616907758023,0
2020-08-11-170808,170808,1,0,0,76,1.3333333333333333,10.944050765800274,1
2020-08-12-170808,170808,0,1,0,76,0.6666666666666666,17.092452858817662,2
2020-08-13-170808,170808,0,0,1,76,2.333333333333333,24.842906912026333,3
2020-08-14-170808,170808,1,0,2,77,5.0,33.133199834296775,4
2020-08-15-170808,170808,0,0,0,77,0.3333333333333333,46.65133650958929,5
2020-08-16-170808,170808,0,0,0,77,0.6666666666666666,48.04125354087,6
2020-08-17-170808,170808,0,0,5,77,0.3333333333333333,50.77905708691054,0
2020-08-18-170808,170808,1,0,0,78,3.6666666666666665,46.24065165526281,1
2020-08-19-170808,170808,3,0,0,81,3.0,50.88578343337636,2
2020-08-20-170808,170808,0,0,3,81,0.3333333333333333,45.10679744223363,3
2020-08-21-170808,170808,1,0,4,82,0.3333333333333333,29.998869926988853,4
2020-08-22-170808,170808,0,0,4,82,1.3333333333333333,32.436694223816616,5
2020-08-23-170808,170808,2,0,4,84,0.0,31.020097784167778,6
2020-08-24-170808,170808,1,0,1,85,1.0,31.931050583869123,0
2020-08-25-170808,170808,0,0,0,85,0.6666666666666666,23.514327703171563,1
2020-08-26-170808,170808,0,0,8,85,1.3333333333333333,13.560632973156167,2
2020-08-27-170808,170808,1,0,1,86,1.6666666666666667,14.712865083846966,3
2020-08-28-170808,170808,2,0,3,88,0.6666666666666666,22.316784740064797,4
2020-08-29-170808,170808,0,0,6,88,0.3333333333333333,24.385140529997088,5
2020-08-30-170808,170808,0,0,0,88,0.6666666666666666,23.093994985530024,6
2020-08-31-170808,170808,5,0,5,93,1.0,20.662246245945646,0
2020-09-01-170808,170808,0,0,1,93,2.0,28.429514059690828,1
2020-09-02-170808,170808,0,0,3,93,1.0,15.184377904504322,2
2020-09-03-170808,170808,3,0,0,96,0.3333333333333333,32.479307426824356,3
2020-09-04-170808,170808,4,0,1,100,1.0,28.426220378792245,4
2020-09-05-170808,170808,4,0,0,104,0.3333333333333333,24.698144277419324,5
2020-09-06-170808,170808,4,0,0,108,0.3333333333333333,21.35773586921276,6
2020-09-07-170808,170808,1,0,1,109,0.3333333333333333,23.976011408709226,0
2020-09-08-170808,170808,0,0,2,109,0.3333333333333333,23.51489108301036,1
2020-09-09-170808,170808,8,0,3,117,0.6666666666666666,22.650557787151833,2
2020-09-10-170808,170808,1,0,2,118,0.6666666666666666,22.22385783779928,3
2020-09-11-170808,170808,3,0,1,121,0.0,24.292666813419917,4
2020-09-12-170808,170808,6,0,1,127,1.0,24.467121792864425,5
2020-09-13-170808,170808,0,0,0,127,0.0,23.884992744805,6
2020-09-14-170808,170808,5,0,0,132,1.3333333333333333,22.93613331320921,0
2020-09-15-170808,170808,1,0,0,133,0.0,23.214649014448796,1
2020-09-16-170808,170808,3,0,3,136,0.6666666666666666,21.083857523668662,2
2020-09-17-170808,170808,0,0,0,136,0.0,20.114574941239443,3
2020-09-18-170808,170808,1,0,0,137,1.0,18.7253809602646,4
2020-09-19-170808,170808,0,0,0,137,0.0,17.232320226638393,5
2020-09-20-170808,170808,0,0,0,137,1.6666666666666667,14.121676662589092,6
2020-09-21-170808,170808,1,0,0,138,0.3333333333333333,13.538610665663033,0
2020-09-22-170808,170808,2,1,2,140,0.3333333333333333,18.503452390991576,1
2020-09-23-170808,170808,3,0,1,143,1.6666666666666667,20.047126241696553,2
2020-09-24-170808,170808,2,1,2,145,1.6666666666666667,21.823700815745028,3
2020-09-25-170808,170808,1,0,2,146,1.0,25.982924326527456,4
2020-09-26-170808,170808,1,0,1,147,1.6666666666666667,32.472487300419594,5
2020-09-27-170808,170808,0,0,4,147,0.0,35.567371059502484,6
2020-09-28-170808,170808,0,0,0,147,0.6666666666666666,32.84655660675321,0
2020-09-29-170808,170808,0,0,6,147,0.0,28.72701742981089,1
2020-09-30-170808,170808,3,0,1,150,0.0,25.811594549603043,2
2020-10-01-170808,170808,0,0,3,150,0.3333333333333333,0.0,3
2020-10-02-170808,170808,0,0,3,150,0.3333333333333333,54.55862026740636,4
2020-10-03-170808,170808,0,0,8,150,0.0,46.095022434590454,5
2020-10-04-170808,170808,0,0,9,150,0.0,36.64801821684094,6
2020-10-05-170808,170808,0,0,5,150,1.6666666666666667,31.42483939128394,0
2020-10-06-170808,170808,2,1,6,152,0.6666666666666666,28.688543974842823,1
2020-10-07-170808,170808,1,1,8,153,0.6666666666666666,21.770661415107067,2
2020-10-08-170808,170808,2,0,5,155,0.6666666666666666,19.13848626896937,3
2020-10-09-170808,170808,2,1,8,157,1.0,24.327792584629314,4
2020-10-10-170808,170808,1,0,1,158,1.3333333333333333,1.298948387213277,5
2020-10-11-170808,170808,4,0,5,162,0.6666666666666666,4.021113489511178,6
2020-10-12-170808,170808,0,0,2,162,1.0,6.497191701732364,0
2020-10-13-170808,170808,6,0,5,168,1.3333333333333333,7.631772680159322,1
2020-10-14-170808,170808,1,0,3,169,1.0,14.11439786693264,2
2020-10-15-170808,170808,3,0,5,172,2.0,16.81509663775858,3
2020-10-16-170808,170808,3,0,5,175,7.0,20.604280862017752,4
2020-10-17-170808,170808,8,0,1,183,13.0,36.627685739337814,5
2020-10-18-170808,170808,9,1,2,192,0.6666666666666666,53.61634400347868,6
2020-10-19-170808,170808,5,0,7,197,0.6666666666666666,56.274989045569576,0
2020-10-20-170808,170808,6,0,6,203,0.3333333333333333,54.81657085733416,1
2020-10-21-170808,170808,8,0,3,211,2.6666666666666665,55.414687070624744,2
2020-10-22-170808,170808,5,0,9,216,3.333333333333333,58.19964482868842,3
2020-10-23-170808,170808,8,0,2,224,4.0,48.08079652191776,4
2020-10-24-170808,170808,1,0,12,225,3.333333333333333,36.11689284839791,5
2020-10-25-170808,170808,5,0,11,230,3.0,36.89736380391577,6
2020-10-26-170808,170808,2,0,15,232,3.0,39.999670315274074,0
2020-10-27-170808,170808,5,0,7,237,1.0,45.41459784086707,1
2020-10-28-170808,170808,3,0,9,240,4.666666666666667,47.306664511259285,2
2020-10-29-170808,170808,5,0,9,245,1.3333333333333333,52.45883775055391,3
2020-10-30-170808,170808,5,0,4,250,3.6666666666666665,42.38177500815403,4
2020-10-31-170808,170808,1,0,0,251,3.333333333333333,41.836583507617185,5
2020-11-01-170808,170808,2,0,0,253,1.3333333333333333,19.64237726300501,6
2020-11-02-170808,170808,7,0,0,260,2.0,70.06416668635363,0
2020-11-03-170808,170808,6,0,0,266,2.6666666666666665,67.03766980213948,1
2020-11-04-170808,170808,3,0,0,269,0.6666666666666666,62.30023753243647,2
2020-11-05-170808,170808,9,0,0,278,2.0,61.64918056428469,3
2020-11-06-170808,170808,2,0,0,280,3.6666666666666665,66.39355732656952,4
2020-11-07-170808,170808,12,0,0,292,1.6666666666666667,58.4118009760159,5
2020-11-08-170808,170808,11,0,0,303,4.666666666666667,58.15617157587414,6
2020-11-09-170808,170808,15,1,0,318,1.6666666666666667,58.91998028204933,0
2020-11-10-170808,170808,7,0,0,325,1.6666666666666667,17.40867602907441,1
2020-11-11-170808,170808,9,1,0,334,1.6666666666666667,25.14113058041184,2
2020-11-12-170808,170808,9,0,0,343,3.6666666666666665,36.81031173964659,3
2020-11-13-170808,170808,4,0,0,347,2.333333333333333,47.85699663938985,4
2020-03-01-170809,170809,0,0,1,0,0.0,0.0,6
2020-03-02-170809,170809,0,0,15,0,0.0,8.385454001831016,0
2020-03-03-170809,170809,0,0,4,0,0.0,23.323583948285382,1
2020-03-04-170809,170809,0,0,20,0,0.0,26.11233617999404,2
2020-03-05-170809,170809,0,0,3,0,0.5,24.90848376719299,3
2020-03-06-170809,170809,0,0,7,0,0.0,21.05892963849251,4
2020-03-07-170809,170809,0,0,2,0,0.5,21.336670525082333,5
2020-03-08-170809,170809,0,1,3,0,0.0,22.055378528661024,6
2020-03-09-170809,170809,1,0,11,1,1.0,21.99218642518886,0
2020-03-10-170809,170809,1,0,6,2,0.0,36.69547316018357,1
2020-03-11-170809,170809,2,0,12,4,1.0,32.558159363809295,2
2020-03-12-170809,170809,0,0,15,4,0.5,26.78635355246039,3
2020-03-13-170809,170809,0,0,7,4,0.0,22.848870580844363,4
2020-03-14-170809,170809,0,0,4,4,0.0,19.28710424254858,5
2020-03-15-170809,170809,1,0,3,5,0.5,9.362184542805403,6
2020-03-16-170809,170809,15,0,4,20,2.5,6.753307107699733,0
2020-03-17-170809,170809,4,0,9,24,3.5,18.91118888214124,1
2020-03-18-170809,170809,20,1,4,44,5.0,22.79841832750528,2
2020-03-19-170809,170809,3,0,1,47,1.5,34.940410823190874,3
2020-03-20-170809,170809,7,0,0,54,4.0,34.791388345568734,4
2020-03-21-170809,170809,2,0,0,56,2.5,40.33024824207153,5
2020-03-22-170809,170809,3,0,0,59,1.0,38.938368686489106,6
2020-03-23-170809,170809,11,0,2,70,6.5,30.762416493042007,0
2020-03-24-170809,170809,6,0,5,76,5.5,35.525240247993416,1
2020-03-25-170809,170809,12,0,7,88,4.0,29.039797069942896,2
2020-03-26-170809,170809,15,0,16,103,6.0,31.956734191478994,3
2020-03-27-170809,170809,7,0,2,110,6.5,39.62501914211887,4
2020-03-28-170809,170809,4,0,1,114,2.0,39.65964449119084,5
2020-03-29-170809,170809,3,0,0,117,0.5,37.95319931071293,6
2020-03-30-170809,170809,4,1,4,121,7.0,29.23458886485049,0
2020-03-31-170809,170809,9,0,0,130,5.5,28.088858972779324,1
2020-04-01-170809,170809,4,0,5,134,14.5,6.6798698506287835,2
2020-04-02-170809,170809,1,0,0,135,3.5,27.698934585298993,3
2020-04-03-170809,170809,0,0,1,135,3.0,8.620257348573087,4
2020-04-04-170809,170809,0,0,13,135,2.0,8.477698084264583,5
2020-04-05-170809,170809,0,1,1,135,2.5,8.772955420706523,6
2020-04-06-170809,170809,2,0,19,137,6.0,9.568513292224024,0
2020-04-07-170809,170809,5,0,1,142,6.0,11.138211172632195,1
2020-04-08-170809,170809,7,0,0,149,5.0,14.62327912292124,2
2020-04-09-170809,170809,16,0,0,165,4.5,19.040045025757067,3
2020-04-10-170809,170809,2,1,2,167,4.0,8.896761416332346,4
2020-04-11-170809,170809,1,0,1,168,2.5,11.246908795422634,5
2020-04-12-170809,170809,0,0,0,168,1.5,12.604514458276894,6
2020-04-13-170809,170809,4,0,1,172,7.0,14.253396686366415,0
2020-04-14-170809,170809,0,0,1,172,9.5,20.229802492224117,1
2020-04-15-170809,170809,5,0,2,177,2.5,27.66824870225366,2
2020-04-16-170809,170809,0,0,0,177,12.0,33.13410118353245,3
2020-04-17-170809,170809,1,0,0,178,1.5,32.287047291689674,4
2020-04-18-170809,170809,13,0,2,191,5.5,31.256361247384326,5
2020-04-19-170809,170809,1,0,0,192,1.0,41.641544697256094,6
2020-04-20-170809,170809,19,0,1,211,20.5,38.57829739864803,0
2020-04-21-170809,170809,1,0,6,212,0.5,56.66209694478752,1
2020-04-22-170809,170809,0,0,1,212,2.5,54.74258830921406,2
2020-04-23-170809,170809,0,0,2,212,0.0,44.540708638797646,3
2020-04-24-170809,170809,2,0,3,214,3.0,39.5150448456159,4
2020-04-25-170809,170809,1,0,1,215,2.0,33.54863632300049,5
2020-04-26-170809,170809,0,0,0,215,0.0,32.03460404961403,6
2020-04-27-170809,170809,1,0,2,216,3.0,27.34741429484021,0
2020-04-28-170809,170809,1,0,3,217,2.0,9.3359728911196,1
2020-04-29-170809,170809,2,0,6,219,0.5,10.030995384674354,2
2020-04-30-170809,170809,0,0,0,219,1.5,10.788674451949714,3
2020-05-01-170809,170809,0,0,2,219,0.5,30.668031200509517,4
2020-05-02-170809,170809,2,0,0,221,1.0,11.658549650871631,5
2020-05-03-170809,170809,0,0,0,221,0.0,7.923288599075722,6
2020-05-04-170809,170809,1,0,1,222,5.0,6.407580914568808,0
2020-05-05-170809,170809,6,0,3,228,4.0,8.243952961994571,1
2020-05-06-170809,170809,1,0,3,229,5.0,12.2601335100256,2
2020-05-07-170809,170809,2,0,0,231,3.0,14.394881593175906,3
2020-05-08-170809,170809,3,0,0,234,2.0,17.451741654385348,4
2020-05-09-170809,170809,1,0,0,235,0.0,21.921909287403906,5
2020-05-10-170809,170809,0,0,0,235,0.0,40.03714894464997,6
2020-05-11-170809,170809,2,1,2,237,2.5,37.023851629566664,0
2020-05-12-170809,170809,3,0,0,240,2.5,38.91584810962055,1
2020-05-13-170809,170809,6,0,1,246,4.0,35.26589250167801,2
2020-05-14-170809,170809,0,0,0,246,0.5,33.41225886702186,3
2020-05-15-170809,170809,2,0,2,248,2.5,26.48987827240391,4
2020-05-16-170809,170809,0,0,0,248,0.5,17.291034405863407,5
2020-05-17-170809,170809,0,0,0,248,0.0,16.861138175069236,6
2020-05-18-170809,170809,1,0,2,249,1.5,17.30017618874155,0
2020-05-19-170809,170809,3,0,0,252,2.5,16.208018090977838,1
2020-05-20-170809,170809,3,0,1,255,1.0,12.540844254649041,2
2020-05-21-170809,170809,0,0,3,255,0.5,14.803989055646888,3
2020-05-22-170809,170809,0,0,3,255,0.0,11.888913574058131,4
2020-05-23-170809,170809,0,0,1,255,0.0,12.264374321795316,5
2020-05-24-170809,170809,0,0,0,255,2.0,12.28502573449322,6
2020-05-25-170809,170809,2,0,0,257,2.5,11.4538586123468,0
2020-05-26-170809,170809,0,0,1,257,2.5,11.198001125666519,1
2020-05-27-170809,170809,1,0,1,258,0.0,11.308605550755065,2
2020-05-28-170809,170809,0,2,0,258,2.5,9.855760884833593,3
2020-05-29-170809,170809,2,0,0,260,1.0,12.376186649377676,4
2020-05-30-170809,170809,0,0,0,260,1.5,14.294160473412106,5
2020-05-31-170809,170809,0,0,0,260,0.0,15.98969407279515,6
2020-06-01-170809,170809,2,0,0,262,0.5,30.9714120413768,0
2020-06-02-170809,170809,0,0,1,262,1.5,11.455468976735698,1
2020-06-03-170809,170809,1,0,0,263,1.0,5.2629600042474625,2
2020-06-04-170809,170809,3,0,1,266,0.5,7.230080647924683,3
2020-06-05-170809,170809,3,0,2,269,0.5,9.755576674458863,4
2020-06-06-170809,170809,1,0,1,270,0.5,10.487416449429713,5
2020-06-07-170809,170809,0,0,0,270,0.5,11.105155270469847,6
2020-06-08-170809,170809,0,0,2,270,1.5,10.337155193891336,0
2020-06-09-170809,170809,1,0,0,271,1.0,11.2248798821083,1
2020-06-10-170809,170809,1,0,0,272,2.0,34.28291922828423,2
2020-06-11-170809,170809,0,0,0,272,0.0,32.92434135871946,3
2020-06-12-170809,170809,0,0,1,272,1.0,23.891721144312303,4
2020-06-13-170809,170809,0,0,0,272,0.5,16.892238678128606,5
2020-06-14-170809,170809,0,0,0,272,0.5,12.169381992230706,6
2020-06-15-170809,170809,0,0,0,272,0.0,9.030547161800406,0
2020-06-16-170809,170809,1,0,0,273,1.5,8.775800831096376,1
2020-06-17-170809,170809,0,0,0,273,3.0,9.353586909529286,2
2020-06-18-170809,170809,1,0,0,274,0.5,9.208291070047625,3
2020-06-19-170809,170809,2,0,0,276,1.5,10.850463801309331,4
2020-06-20-170809,170809,1,0,0,277,0.0,14.653389713535633,5
2020-06-21-170809,170809,0,0,0,277,0.0,16.26025363332821,6
2020-06-22-170809,170809,2,0,0,279,0.5,16.753176237622554,0
2020-06-23-170809,170809,0,0,0,279,0.0,17.052479498490584,1
2020-06-24-170809,170809,0,0,0,279,0.0,13.493050454207673,2
2020-06-25-170809,170809,0,0,0,279,1.0,12.245327470188453,3
2020-06-26-170809,170809,1,0,0,280,0.5,9.429347862875463,4
2020-06-27-170809,170809,0,0,0,280,0.5,10.316198947751122,5
2020-06-28-170809,170809,0,0,2,280,1.0,10.3314687215763,6
2020-06-29-170809,170809,0,0,3,280,0.0,11.916266494048383,0
2020-06-30-170809,170809,0,0,0,280,0.0,11.551234561110073,1
2020-07-01-170809,170809,0,0,2,280,1.0,18.21015183351043,2
2020-07-02-170809,170809,0,0,1,280,0.5,13.276105807673805,3
2020-07-03-170809,170809,0,1,0,280,0.0,11.505915269238672,4
2020-07-04-170809,170809,0,0,0,280,0.0,7.587765803806397,5
2020-07-05-170809,170809,0,0,0,280,0.0,6.181444579000532,6
2020-07-06-170809,170809,0,0,1,280,0.0,6.052051593986002,0
2020-07-07-170809,170809,0,0,0,280,0.5,6.42006578439095,1
2020-07-08-170809,170809,0,0,0,280,0.5,5.868571277246206,2
2020-07-09-170809,170809,0,0,1,280,0.5,6.794619621350401,3
2020-07-10-170809,170809,0,0,1,280,0.5,17.505055647602212,4
2020-07-11-170809,170809,0,0,0,280,0.0,13.551861230717378,5
2020-07-12-170809,170809,2,0,0,282,0.0,9.779676148718178,6
2020-07-13-170809,170809,3,0,0,285,1.5,9.360805172834873,0
2020-07-14-170809,170809,0,0,0,285,0.5,13.88749993202957,1
2020-07-15-170809,170809,2,0,0,287,1.0,13.03177639276793,2
2020-07-16-170809,170809,1,0,0,288,1.5,11.804756310434417,3
2020-07-17-170809,170809,0,0,0,288,0.5,14.022210300264558,4
2020-07-18-170809,170809,0,0,0,288,0.0,14.721107230412585,5
2020-07-19-170809,170809,0,0,0,288,0.0,14.613959710091265,6
2020-07-20-170809,170809,1,0,0,289,0.0,9.316001553676454,0
2020-07-21-170809,170809,0,0,0,289,1.0,9.950520606235695,1
2020-07-22-170809,170809,0,0,1,289,0.0,8.525224440755093,2
2020-07-23-170809,170809,1,1,0,290,0.5,6.859998537350089,3
2020-07-24-170809,170809,1,0,0,291,1.0,11.206713674691002,4
2020-07-25-170809,170809,0,0,0,291,0.0,14.384998768060111,5
2020-07-26-170809,170809,0,0,0,291,1.5,16.17434048458705,6
2020-07-27-170809,170809,0,0,0,291,0.5,16.16500621826062,0
2020-07-28-170809,170809,0,0,0,291,0.5,14.771781074647011,1
2020-07-29-170809,170809,0,0,0,291,1.5,13.200256943259486,2
2020-07-30-170809,170809,0,0,0,291,0.5,9.747369577589705,3
2020-07-31-170809,170809,0,0,0,291,1.0,8.46568901275608,4
2020-08-01-170809,170809,0,0,0,291,2.5,6.40871503738826,5
2020-08-02-170809,170809,0,0,0,291,0.0,37.74378414077461,6
2020-08-03-170809,170809,0,0,0,291,0.0,31.29880240769227,0
2020-08-04-170809,170809,0,0,0,291,4.0,26.596513228179465,1
2020-08-05-170809,170809,1,0,1,292,7.5,26.959502102963054,2
2020-08-06-170809,170809,0,0,5,292,5.5,32.70390943060931,3
2020-08-07-170809,170809,0,0,0,292,1.0,40.18734398680118,4
2020-08-08-170809,170809,0,0,0,292,1.5,43.19756861256019,5
2020-08-09-170809,170809,0,0,1,292,0.0,45.74154272481105,6
2020-08-10-170809,170809,0,0,0,292,1.5,9.631948180023999,0
2020-08-11-170809,170809,0,0,0,292,2.5,14.545293528228385,1
2020-08-12-170809,170809,0,1,1,292,1.0,23.348235310275356,2
2020-08-13-170809,170809,0,0,0,292,0.5,31.475774375036686,3
2020-08-14-170809,170809,0,0,3,292,3.0,34.17696185601501,4
2020-08-15-170809,170809,0,0,0,292,1.0,46.93466090330484,5
2020-08-16-170809,170809,0,0,0,292,1.0,49.46236025033245,6
2020-08-17-170809,170809,0,0,0,292,1.5,48.05940916114093,0
2020-08-18-170809,170809,0,0,1,292,4.5,44.67324621234977,1
2020-08-19-170809,170809,1,0,0,293,3.5,46.80691464539126,2
2020-08-20-170809,170809,5,0,0,298,0.5,40.73251865686989,3
2020-08-21-170809,170809,0,0,1,298,1.5,33.753197996594686,4
2020-08-22-170809,170809,0,0,0,298,3.5,33.20351306178107,5
2020-08-23-170809,170809,1,0,0,299,0.5,32.72440475986022,6
2020-08-24-170809,170809,0,0,0,299,4.5,32.097263978752494,0
2020-08-25-170809,170809,0,0,0,299,1.5,27.017521067341907,1
2020-08-26-170809,170809,1,1,0,300,3.0,25.587833767805243,2
2020-08-27-170809,170809,0,0,0,300,3.0,29.95821357548322,3
2020-08-28-170809,170809,3,0,0,303,0.5,32.51594971076818,4
2020-08-29-170809,170809,0,0,0,303,0.0,35.73395075226872,5
2020-08-30-170809,170809,0,0,0,303,1.0,30.91267055678789,6
2020-08-31-170809,170809,0,1,0,303,0.5,26.2551019886277,0
2020-09-01-170809,170809,1,0,0,304,3.5,36.37403964645226,1
2020-09-02-170809,170809,0,0,0,304,1.0,18.769198257558394,2
2020-09-03-170809,170809,0,0,0,304,1.0,28.775058882258502,3
2020-09-04-170809,170809,1,0,0,305,1.0,23.17904751885387,4
2020-09-05-170809,170809,0,0,0,305,1.0,24.17422651094588,5
2020-09-06-170809,170809,0,0,0,305,0.5,19.342678988071313,6
2020-09-07-170809,170809,0,0,0,305,1.0,20.199078269049856,0
2020-09-08-170809,170809,0,0,0,305,0.5,17.404142332651784,1
2020-09-09-170809,170809,0,0,0,305,0.5,17.31474507569362,2
2020-09-10-170809,170809,0,0,2,305,0.5,36.45650557681961,3
2020-09-11-170809,170809,0,0,0,305,0.0,34.51420680598513,4
2020-09-12-170809,170809,0,0,3,305,2.0,26.293754595439637,5
2020-09-13-170809,170809,0,0,0,305,0.5,21.18666694126714,6
2020-09-14-170809,170809,0,0,3,305,3.5,20.911014756210257,0
2020-09-15-170809,170809,0,0,2,305,0.0,21.700921450725048,1
2020-09-16-170809,170809,0,0,0,305,3.5,20.51730334064075,2
2020-09-17-170809,170809,0,0,0,305,0.5,17.397731157638937,3
2020-09-18-170809,170809,0,1,0,305,1.5,17.25743414456807,4
2020-09-19-170809,170809,0,0,0,305,0.0,19.082249294045845,5
2020-09-20-170809,170809,0,1,1,305,2.5,15.271701256803473,6
2020-09-21-170809,170809,0,0,0,305,0.5,15.722266184672124,0
2020-09-22-170809,170809,0,0,0,305,1.5,17.966712092436072,1
2020-09-23-170809,170809,0,0,2,305,3.0,16.233049004866075,2
2020-09-24-170809,170809,2,0,1,307,4.0,17.671559864048167,3
2020-09-25-170809,170809,0,0,0,307,1.0,18.202637546679355,4
2020-09-26-170809,170809,3,0,1,310,2.0,18.911436741616512,5
2020-09-27-170809,170809,0,0,1,310,0.0,22.465975340468717,6
2020-09-28-170809,170809,3,0,0,313,2.0,19.79631379687639,0
2020-09-29-170809,170809,2,0,0,315,0.0,21.296379341803984,1
2020-09-30-170809,170809,0,0,0,315,0.0,20.895517609117036,2
2020-10-01-170809,170809,0,0,0,315,0.5,0.0,3
2020-10-02-170809,170809,0,0,0,315,0.5,50.87858853128792,4
2020-10-03-170809,170809,0,0,0,315,0.0,43.610060402314815,5
2020-10-04-170809,170809,1,0,0,316,0.0,41.82865789145341,6
2020-10-05-170809,170809,0,0,0,316,1.0,33.38576444090968,0
2020-10-06-170809,170809,0,0,0,316,1.0,30.754056518776512,1
2020-10-07-170809,170809,2,0,2,318,1.0,22.5361786327761,2
2020-10-08-170809,170809,1,0,0,319,1.5,20.228104701345796,3
2020-10-09-170809,170809,0,0,0,319,2.0,22.72050192639496,4
2020-10-10-170809,170809,1,0,0,320,2.0,0.7366038773387952,5
2020-10-11-170809,170809,1,0,2,321,1.0,4.203929610729668,6
2020-10-12-170809,170809,0,0,1,321,2.5,7.823002482332019,0
2020-10-13-170809,170809,0,0,1,321,3.0,11.448444597905619,1
2020-10-14-170809,170809,0,0,2,321,3.0,19.100727922221246,2
2020-10-15-170809,170809,0,0,2,321,4.5,22.300864435974034,3
2020-10-16-170809,170809,0,0,2,321,10.0,27.872204095266735,4
2020-10-17-170809,170809,0,0,0,321,17.5,45.13465415561737,5
2020-10-18-170809,170809,0,0,1,321,2.5,66.71626953068478,6
2020-10-19-170809,170809,0,0,1,321,1.0,61.19202323445873,0
2020-10-20-170809,170809,0,0,0,321,4.5,50.91449322930313,1
2020-10-21-170809,170809,2,0,1,323,7.0,51.21084878322882,2
2020-10-22-170809,170809,0,0,1,323,4.5,55.502867375420394,3
2020-10-23-170809,170809,0,0,1,323,5.0,47.549926111613516,4
2020-10-24-170809,170809,0,0,0,323,3.0,29.0839688903935,5
2020-10-25-170809,170809,2,0,0,325,4.5,29.821002437605884,6
2020-10-26-170809,170809,1,0,0,326,8.0,33.130371902939636,0
2020-10-27-170809,170809,1,0,0,327,0.5,42.56345433183483,1
2020-10-28-170809,170809,2,0,1,329,5.5,43.14198300517071,2
2020-10-29-170809,170809,2,0,0,331,6.5,46.5785362514071,3
2020-10-30-170809,170809,2,0,0,333,7.0,42.88143360602761,4
2020-10-31-170809,170809,0,0,0,333,7.0,42.28198561419814,5
2020-11-01-170809,170809,1,0,0,334,1.5,19.637006421476165,6
2020-11-02-170809,170809,1,0,0,335,1.5,39.02225514485555,0
2020-11-03-170809,170809,0,0,0,335,3.5,40.307268329208874,1
2020-11-04-170809,170809,1,0,0,336,3.5,36.4531830241246,2
2020-11-05-170809,170809,1,0,0,337,6.0,36.34569400420372,3
2020-11-06-170809,170809,1,2,0,338,8.0,38.79015785062896,4
2020-11-07-170809,170809,0,0,0,338,2.5,41.40981599807423,5
2020-11-08-170809,170809,0,0,0,338,13.0,36.91362106082574,6
2020-11-09-170809,170809,0,0,0,338,6.5,41.85498828944661,0
2020-11-10-170809,170809,0,1,0,338,7.0,14.442186113622943,1
2020-11-11-170809,170809,1,0,0,339,5.5,17.906816191356853,2
2020-11-12-170809,170809,0,0,0,339,8.5,23.562236626149968,3
2020-11-13-170809,170809,0,0,0,339,9.0,27.53726136318864,4
2020-03-01-170810,170810,0,0,1,0,0.0,0.0,6
2020-03-02-170810,170810,0,0,3,0,0.0,10.182521429073702,0
2020-03-03-170810,170810,0,0,2,0,0.0,38.25083429808527,1
2020-03-04-170810,170810,0,0,3,0,0.0,43.8830015322282,2
2020-03-05-170810,170810,0,0,6,0,0.16666666666666666,49.22982817274979,3
2020-03-06-170810,170810,0,0,2,0,0.0,46.067972572150005,4
2020-03-07-170810,170810,0,0,1,0,0.16666666666666666,48.70527893193113,5
2020-03-08-170810,170810,0,0,2,0,0.0,50.035655029617374,6
2020-03-09-170810,170810,0,0,1,0,0.5,50.06110726494609,0
2020-03-10-170810,170810,0,0,6,0,0.0,180.5340981965437,1
2020-03-11-170810,170810,0,0,4,0,0.3333333333333333,156.57388879050865,2
2020-03-12-170810,170810,1,0,3,1,0.6666666666666666,136.8500885947035,3
2020-03-13-170810,170810,0,0,0,1,0.3333333333333333,102.32115605825008,4
2020-03-14-170810,170810,0,0,0,1,0.0,83.11310679090546,5
2020-03-15-170810,170810,1,0,1,2,1.3333333333333333,37.14472701709593,6
2020-03-16-170810,170810,3,0,3,5,2.0,16.587223553004538,0
2020-03-17-170810,170810,2,1,0,7,2.1666666666666665,28.173809823450014,1
2020-03-18-170810,170810,3,1,2,10,4.166666666666667,35.46435122597826,2
2020-03-19-170810,170810,6,0,2,16,2.333333333333333,54.117465276166,3
2020-03-20-170810,170810,2,0,0,18,3.5,59.961790781489384,4
2020-03-21-170810,170810,1,0,0,19,3.1666666666666665,68.55870328639324,5
2020-03-22-170810,170810,2,0,0,21,2.1666666666666665,68.84577018567157,6
2020-03-23-170810,170810,1,0,0,22,6.5,68.25291048194062,0
2020-03-24-170810,170810,6,0,3,28,4.166666666666667,78.59140849646333,1
2020-03-25-170810,170810,4,0,1,32,4.5,77.29770250579573,2
2020-03-26-170810,170810,3,0,1,35,3.0,81.23757559483701,3
2020-03-27-170810,170810,0,0,3,35,4.666666666666667,90.19268733911898,4
2020-03-28-170810,170810,0,0,0,35,1.6666666666666667,89.84410687028549,5
2020-03-29-170810,170810,1,0,0,36,1.3333333333333333,83.10318602507809,6
2020-03-30-170810,170810,3,0,2,39,5.333333333333333,59.64185959183467,0
2020-03-31-170810,170810,0,0,0,39,5.833333333333332,58.61230863767297,1
2020-04-01-170810,170810,2,0,0,41,6.5,12.70400414808947,2
2020-04-02-170810,170810,2,0,0,43,3.6666666666666665,39.01115130229718,3
2020-04-03-170810,170810,0,0,0,43,4.5,18.942318993826568,4
2020-04-04-170810,170810,0,0,0,43,2.333333333333333,24.813319181488758,5
2020-04-05-170810,170810,0,0,1,43,2.5,26.937480756787686,6
2020-04-06-170810,170810,0,0,0,43,4.5,30.78915849125234,0
2020-04-07-170810,170810,3,1,2,46,3.8333333333333335,35.256536010303265,1
2020-04-08-170810,170810,1,0,2,47,4.333333333333333,40.75239319952054,2
2020-04-09-170810,170810,1,0,0,48,2.0,48.43063624946625,3
2020-04-10-170810,170810,3,6,2,51,4.666666666666667,14.151235062455601,4
2020-04-11-170810,170810,0,0,1,51,1.6666666666666667,24.861492505090997,5
2020-04-12-170810,170810,0,0,0,51,2.5,28.312956529490776,6
2020-04-13-170810,170810,2,0,1,53,3.0,34.10220653903999,0
2020-04-14-170810,170810,0,0,0,53,4.5,44.031739622387335,1
2020-04-15-170810,170810,0,0,1,53,1.3333333333333333,55.425247476770274,2
2020-04-16-170810,170810,0,0,0,53,5.5,60.095967087856195,3
2020-04-17-170810,170810,0,0,1,53,1.0,61.5170407762806,4
2020-04-18-170810,170810,0,0,0,53,2.1666666666666665,53.5620947653303,5
2020-04-19-170810,170810,1,0,0,54,0.5,56.214334008935175,6
2020-04-20-170810,170810,0,0,0,54,7.0,52.42536691796647,0
2020-04-21-170810,170810,2,0,0,56,0.8333333333333334,57.490320005367415,1
2020-04-22-170810,170810,2,0,1,58,1.0,57.14505345750951,2
2020-04-23-170810,170810,0,0,0,58,0.6666666666666666,46.79061656454035,3
2020-04-24-170810,170810,2,0,0,60,2.0,41.666403774677065,4
2020-04-25-170810,170810,1,0,0,61,1.1666666666666667,42.848283567366565,5
2020-04-26-170810,170810,0,1,0,61,0.3333333333333333,42.864576407055324,6
2020-04-27-170810,170810,1,0,0,62,1.6666666666666667,33.95464700401527,0
2020-04-28-170810,170810,0,0,2,62,1.6666666666666667,22.141731719299116,1
2020-04-29-170810,170810,1,0,1,63,1.0,22.981499935046728,2
2020-04-30-170810,170810,0,0,2,63,1.5,32.551922708461916,3
2020-05-01-170810,170810,1,0,2,64,1.0,54.73582902732702,4
2020-05-02-170810,170810,0,0,0,64,0.6666666666666666,18.47152249214799,5
2020-05-03-170810,170810,0,0,0,64,1.3333333333333333,13.165518388017048,6
2020-05-04-170810,170810,0,0,1,64,2.833333333333333,14.810945788180355,0
2020-05-05-170810,170810,0,0,0,64,1.6666666666666667,17.242666962644016,1
2020-05-06-170810,170810,1,0,0,65,6.0,19.183029600501424,2
2020-05-07-170810,170810,0,0,0,65,1.5,28.46019194166569,3
2020-05-08-170810,170810,0,0,2,65,0.6666666666666666,34.35947112019859,4
2020-05-09-170810,170810,0,0,0,65,0.16666666666666666,36.567568025241584,5
2020-05-10-170810,170810,0,2,0,65,0.0,66.18120003662293,6
2020-05-11-170810,170810,0,0,0,65,1.5,59.539150234797845,0
2020-05-12-170810,170810,2,0,1,67,1.0,56.20198726842555,1
2020-05-13-170810,170810,1,0,4,68,1.6666666666666667,47.69841815609906,2
2020-05-14-170810,170810,2,0,0,70,0.8333333333333334,40.416912473630404,3
2020-05-15-170810,170810,2,0,0,72,1.0,32.22413517373411,4
2020-05-16-170810,170810,0,0,0,72,0.3333333333333333,28.631362361849074,5
2020-05-17-170810,170810,0,0,0,72,0.0,23.999339852606532,6
2020-05-18-170810,170810,1,0,0,73,1.0,24.41014412782456,0
2020-05-19-170810,170810,0,0,2,73,1.5,24.771059133294088,1
2020-05-20-170810,170810,0,0,0,73,1.1666666666666667,22.212194320267926,2
2020-05-21-170810,170810,0,0,0,73,0.3333333333333333,21.857607118243966,3
2020-05-22-170810,170810,2,0,0,75,0.0,18.368066675068825,4
2020-05-23-170810,170810,0,0,0,75,0.0,19.801455792540978,5
2020-05-24-170810,170810,0,0,0,75,0.6666666666666666,20.290518022818237,6
2020-05-25-170810,170810,0,0,0,75,0.8333333333333334,17.20944127856743,0
2020-05-26-170810,170810,1,0,2,76,1.3333333333333333,15.841146190103547,1
2020-05-27-170810,170810,4,0,0,80,0.16666666666666666,18.362931554720213,2
2020-05-28-170810,170810,0,0,0,80,1.3333333333333333,17.83814592616976,3
2020-05-29-170810,170810,0,0,0,80,0.3333333333333333,20.92707193859927,4
2020-05-30-170810,170810,0,1,0,80,0.8333333333333334,25.349003288019166,5
2020-05-31-170810,170810,0,0,0,80,0.16666666666666666,27.467615073137694,6
2020-06-01-170810,170810,0,0,0,80,0.5,51.192234307609276,0
2020-06-02-170810,170810,2,0,1,82,1.1666666666666667,15.326744414715577,1
2020-06-03-170810,170810,0,0,0,82,0.5,9.756563646734275,2
2020-06-04-170810,170810,0,0,1,82,0.3333333333333333,10.838495681966055,3
2020-06-05-170810,170810,0,0,0,82,0.5,8.907317056560364,4
2020-06-06-170810,170810,0,0,0,82,0.16666666666666666,9.574621446909436,5
2020-06-07-170810,170810,0,0,0,82,0.5,9.9390219139158,6
2020-06-08-170810,170810,0,0,0,82,0.6666666666666666,9.967897925251862,0
2020-06-09-170810,170810,2,0,0,84,0.8333333333333334,11.590274131774336,1
2020-06-10-170810,170810,0,0,0,84,1.0,53.550248131248566,2
2020-06-11-170810,170810,0,0,1,84,0.3333333333333333,45.41267850074742,3
2020-06-12-170810,170810,0,0,0,84,0.8333333333333334,41.30388899176607,4
2020-06-13-170810,170810,0,1,0,84,0.16666666666666666,23.81991699124852,5
2020-06-14-170810,170810,0,0,0,84,0.3333333333333333,15.491386076790581,6
2020-06-15-170810,170810,0,0,0,84,0.0,13.830194288212986,0
2020-06-16-170810,170810,1,0,0,85,0.8333333333333334,13.877699983779662,1
2020-06-17-170810,170810,0,0,0,85,1.0,14.324209495121817,2
2020-06-18-170810,170810,1,0,0,86,0.16666666666666666,14.296862733427922,3
2020-06-19-170810,170810,0,0,0,86,0.8333333333333334,14.214699375597762,4
2020-06-20-170810,170810,0,0,0,86,0.16666666666666666,23.346450825563963,5
2020-06-21-170810,170810,0,0,0,86,0.16666666666666666,22.84298568125351,6
2020-06-22-170810,170810,0,0,1,86,0.3333333333333333,23.578974332028587,0
2020-06-23-170810,170810,0,0,2,86,0.3333333333333333,22.41352709952099,1
2020-06-24-170810,170810,0,0,0,86,0.16666666666666666,21.12930944390165,2
2020-06-25-170810,170810,1,0,0,87,0.6666666666666666,20.535352272742376,3
2020-06-26-170810,170810,0,0,0,87,0.16666666666666666,19.126925772148834,4
2020-06-27-170810,170810,0,0,0,87,0.16666666666666666,13.598431335716484,5
2020-06-28-170810,170810,0,0,0,87,0.3333333333333333,14.059268997450115,6
2020-06-29-170810,170810,0,0,0,87,0.0,15.406976213516305,0
2020-06-30-170810,170810,0,0,0,87,0.16666666666666666,14.436340210220004,1
2020-07-01-170810,170810,0,0,0,87,0.5,18.645470121683854,2
2020-07-02-170810,170810,0,0,1,87,0.6666666666666666,19.99446280926788,3
2020-07-03-170810,170810,0,0,0,87,0.5,30.21559487035268,4
2020-07-04-170810,170810,0,0,0,87,0.0,28.471040103298147,5
2020-07-05-170810,170810,0,0,0,87,0.0,22.992692602657705,6
2020-07-06-170810,170810,1,0,0,88,0.5,21.17116229495376,0
2020-07-07-170810,170810,2,0,0,90,0.16666666666666666,24.43241463291365,1
2020-07-08-170810,170810,0,0,0,90,0.6666666666666666,22.793445642484656,2
2020-07-09-170810,170810,0,0,0,90,0.16666666666666666,22.323013587805207,3
2020-07-10-170810,170810,0,0,1,90,0.16666666666666666,19.863334857492767,4
2020-07-11-170810,170810,0,0,0,90,0.0,17.146770855185608,5
2020-07-12-170810,170810,0,0,0,90,0.0,13.602588752324404,6
2020-07-13-170810,170810,0,0,0,90,1.0,13.10814018357437,0
2020-07-14-170810,170810,0,0,0,90,0.5,18.195469501666643,1
2020-07-15-170810,170810,0,0,0,90,0.6666666666666666,17.851948527034533,2
2020-07-16-170810,170810,1,0,1,91,0.6666666666666666,14.671864757206347,3
2020-07-17-170810,170810,0,0,0,91,0.3333333333333333,18.021451313855202,4
2020-07-18-170810,170810,0,0,0,91,0.16666666666666666,20.340739789590863,5
2020-07-19-170810,170810,0,0,0,91,0.16666666666666666,21.91342175553151,6
2020-07-20-170810,170810,0,0,0,91,0.6666666666666666,19.14970108789966,0
2020-07-21-170810,170810,0,0,2,91,0.8333333333333334,21.155831028087352,1
2020-07-22-170810,170810,0,0,0,91,0.3333333333333333,23.510744231115574,2
2020-07-23-170810,170810,0,0,2,91,0.8333333333333334,20.462694406302298,3
2020-07-24-170810,170810,1,0,0,92,1.0,24.475383155025018,4
2020-07-25-170810,170810,0,0,0,92,0.6666666666666666,30.861459715586673,5
2020-07-26-170810,170810,0,0,6,92,0.8333333333333334,34.331805446791215,6
2020-07-27-170810,170810,0,0,2,92,0.16666666666666666,35.59957614449278,0
2020-07-28-170810,170810,0,0,2,92,0.16666666666666666,35.25489050422206,1
2020-07-29-170810,170810,0,0,4,92,0.8333333333333334,30.269093057896683,2
2020-07-30-170810,170810,1,0,2,93,1.3333333333333333,31.23766967751448,3
2020-07-31-170810,170810,0,0,4,93,0.8333333333333334,31.43425311122504,4
2020-08-01-170810,170810,0,0,0,93,1.1666666666666667,21.21564132025048,5
2020-08-02-170810,170810,0,0,0,93,0.0,96.30838238430607,6
2020-08-03-170810,170810,0,0,0,93,0.16666666666666666,68.45680029221162,0
2020-08-04-170810,170810,2,0,0,95,1.5,54.67934702960457,1
2020-08-05-170810,170810,0,0,0,95,2.5,60.244124774209666,2
2020-08-06-170810,170810,2,0,0,97,1.8333333333333333,64.16375595657293,3
2020-08-07-170810,170810,0,0,0,97,0.6666666666666666,72.35584974185849,4
2020-08-08-170810,170810,0,0,0,97,0.8333333333333334,71.35046289712096,5
2020-08-09-170810,170810,6,0,0,103,0.3333333333333333,73.23873312051367,6
2020-08-10-170810,170810,2,0,1,105,1.3333333333333333,20.820284331497128,0
2020-08-11-170810,170810,2,0,3,107,1.6666666666666667,34.380272776158996,1
2020-08-12-170810,170810,4,0,1,111,1.6666666666666667,51.010044591628784,2
2020-08-13-170810,170810,2,0,1,113,1.1666666666666667,62.81206840202787,3
2020-08-14-170810,170810,4,0,0,117,3.0,77.17129568525877,4
2020-08-15-170810,170810,0,0,0,117,0.6666666666666666,99.73028515889627,5
2020-08-16-170810,170810,0,0,0,117,1.3333333333333333,104.00123340143844,6
2020-08-17-170810,170810,0,0,0,117,0.6666666666666666,104.08205396639455,0
2020-08-18-170810,170810,0,0,1,117,1.8333333333333333,97.56438176583262,1
2020-08-19-170810,170810,0,0,2,117,2.0,95.87639636591479,2
2020-08-20-170810,170810,0,0,1,117,1.1666666666666667,76.90959337592557,3
2020-08-21-170810,170810,0,0,1,117,1.3333333333333333,61.00915425973151,4
2020-08-22-170810,170810,0,0,0,117,2.6666666666666665,61.433829753932045,5
2020-08-23-170810,170810,0,0,0,117,0.16666666666666666,71.4709004686894,6
2020-08-24-170810,170810,1,0,4,118,2.0,64.4102107279429,0
2020-08-25-170810,170810,3,0,3,121,1.5,60.366682908482815,1
2020-08-26-170810,170810,1,0,1,122,2.0,60.43992984696598,2
2020-08-27-170810,170810,1,0,2,123,1.5,67.80401537166085,3
2020-08-28-170810,170810,0,0,3,123,1.1666666666666667,71.22814697723932,4
2020-08-29-170810,170810,0,0,2,123,1.0,70.0950159117257,5
2020-08-30-170810,170810,0,0,3,123,0.6666666666666666,61.60191537314989,6
2020-08-31-170810,170810,0,0,1,123,0.6666666666666666,56.539500684877865,0
2020-09-01-170810,170810,1,0,1,124,3.1666666666666665,65.06963102030606,1
2020-09-02-170810,170810,2,0,1,126,1.5,70.46388129773285,2
2020-09-03-170810,170810,1,0,3,127,3.333333333333333,69.57324118230773,3
2020-09-04-170810,170810,1,0,3,128,2.0,73.26575287089724,4
2020-09-05-170810,170810,0,0,1,128,1.0,71.71791161203694,5
2020-09-06-170810,170810,0,0,0,128,0.8333333333333334,61.35050274223494,6
2020-09-07-170810,170810,4,0,0,132,1.3333333333333333,64.96094971675439,0
2020-09-08-170810,170810,3,0,1,135,1.1666666666666667,62.48800243706275,1
2020-09-09-170810,170810,1,0,0,136,0.8333333333333334,67.15760535876278,2
2020-09-10-170810,170810,2,0,0,138,1.0,70.07785948519926,3
2020-09-11-170810,170810,3,0,1,141,1.3333333333333333,64.7787358420114,4
2020-09-12-170810,170810,2,0,4,143,1.1666666666666667,62.514728418813874,5
2020-09-13-170810,170810,3,0,0,146,1.0,59.6115084004764,6
2020-09-14-170810,170810,1,0,0,147,1.6666666666666667,63.91980178050779,0
2020-09-15-170810,170810,1,0,1,148,1.6666666666666667,66.14380579540068,1
2020-09-16-170810,170810,1,0,3,149,2.6666666666666665,66.36596309522733,2
2020-09-17-170810,170810,3,0,0,152,0.6666666666666666,67.31204569606949,3
2020-09-18-170810,170810,3,0,0,155,2.0,68.76347924506007,4
2020-09-19-170810,170810,1,0,0,156,0.5,68.09936674593732,5
2020-09-20-170810,170810,0,0,0,156,2.0,58.56855977963663,6
2020-09-21-170810,170810,0,1,0,156,1.3333333333333333,58.78576113584185,0
2020-09-22-170810,170810,1,0,0,157,2.333333333333333,58.65057965012589,1
2020-09-23-170810,170810,0,0,1,157,2.5,47.497973624456904,2
2020-09-24-170810,170810,0,1,0,157,2.0,48.54132710872867,3
2020-09-25-170810,170810,1,0,0,158,0.8333333333333334,48.74515239107223,4
2020-09-26-170810,170810,4,0,0,162,1.8333333333333333,56.938014822498154,5
2020-09-27-170810,170810,0,0,1,162,0.3333333333333333,61.8894081669348,6
2020-09-28-170810,170810,0,0,0,162,2.333333333333333,56.77814854987888,0
2020-09-29-170810,170810,1,0,2,163,0.16666666666666666,63.27562237828589,1
2020-09-30-170810,170810,3,1,0,166,0.6666666666666666,65.87996184867538,2
2020-10-01-170810,170810,0,0,1,166,0.3333333333333333,0.0,3
2020-10-02-170810,170810,0,0,2,166,0.5,128.67549337282566,4
2020-10-03-170810,170810,0,0,2,166,0.16666666666666666,161.99071956519418,5
2020-10-04-170810,170810,0,1,0,166,0.5,165.53363631276397,6
2020-10-05-170810,170810,0,0,0,166,0.6666666666666666,137.59753403050283,0
2020-10-06-170810,170810,0,0,2,166,1.0,133.84988715533083,1
2020-10-07-170810,170810,1,0,2,167,1.5,98.77739936091518,2
2020-10-08-170810,170810,0,0,2,167,2.6666666666666665,77.94039266618985,3
2020-10-09-170810,170810,0,0,2,167,2.0,92.51239173963324,4
2020-10-10-170810,170810,0,0,0,167,1.1666666666666667,2.3098610234990224,5
2020-10-11-170810,170810,1,0,1,168,1.0,9.632014987188883,6
2020-10-12-170810,170810,0,0,3,168,1.0,16.956585287379752,0
2020-10-13-170810,170810,2,0,3,170,2.0,24.35018875276326,1
2020-10-14-170810,170810,0,0,4,170,2.6666666666666665,42.40152182309373,2
2020-10-15-170810,170810,1,0,1,171,1.5,57.68313957256473,3
2020-10-16-170810,170810,2,0,3,173,5.333333333333333,78.49437103574095,4
2020-10-17-170810,170810,2,0,0,175,6.333333333333332,110.18171380353652,5
2020-10-18-170810,170810,0,0,0,175,3.1666666666666665,130.84966703846504,6
2020-10-19-170810,170810,0,0,3,175,0.5,146.1038752560906,0
2020-10-20-170810,170810,2,0,1,177,2.1666666666666665,133.5394437751467,1
2020-10-21-170810,170810,2,0,4,179,3.6666666666666665,141.2456041512021,2
2020-10-22-170810,170810,2,0,2,181,2.6666666666666665,146.61462142975049,3
2020-10-23-170810,170810,2,0,6,183,4.666666666666667,131.75193964363294,4
2020-10-24-170810,170810,0,0,4,183,3.1666666666666665,124.05898093553013,5
2020-10-25-170810,170810,1,0,11,184,3.0,108.60365991350625,6
2020-10-26-170810,170810,3,0,1,187,5.0,113.10646927423856,0
2020-10-27-170810,170810,3,0,7,190,1.8333333333333333,142.7438473372187,1
2020-10-28-170810,170810,4,0,5,194,7.0,134.20058634119005,2
2020-10-29-170810,170810,1,0,2,195,5.0,147.78427024774086,3
2020-10-30-170810,170810,3,0,2,198,5.833333333333332,143.51987534226458,4
2020-10-31-170810,170810,0,0,0,198,5.833333333333332,160.54639320340095,5
2020-11-01-170810,170810,0,1,0,198,2.833333333333333,74.79996422657487,6
2020-11-02-170810,170810,3,1,0,201,3.333333333333333,222.48880841193028,0
2020-11-03-170810,170810,1,0,0,202,3.6666666666666665,196.43402377087597,1
2020-11-04-170810,170810,4,0,0,206,3.8333333333333335,179.62824607472712,2
2020-11-05-170810,170810,2,0,0,208,3.8333333333333335,154.0254532474188,3
2020-11-06-170810,170810,6,0,0,214,4.5,146.7712951992674,4
2020-11-07-170810,170810,4,0,0,218,3.1666666666666665,156.91468182351383,5
2020-11-08-170810,170810,11,0,0,229,8.166666666666666,148.73920097933842,6
2020-11-09-170810,170810,1,0,0,230,4.333333333333333,166.04212574674864,0
2020-11-10-170810,170810,7,0,0,237,4.5,53.556414583567516,1
2020-11-11-170810,170810,5,0,0,242,2.833333333333333,79.81079215479173,2
2020-11-12-170810,170810,2,0,0,244,4.666666666666667,98.40006501660429,3
2020-11-13-170810,170810,2,1,0,246,4.5,121.2594136772627,4
2020-03-01-170811,170811,0,0,1,0,0.0,0.0,6
2020-03-02-170811,170811,0,0,5,0,0.0,30.913164926057256,0
2020-03-03-170811,170811,0,1,7,0,0.08333333333333333,107.76882284532088,1
2020-03-04-170811,170811,0,0,8,0,0.0,122.36958773311902,2
2020-03-05-170811,170811,1,0,3,1,0.0,130.3906807472948,3
2020-03-06-170811,170811,0,0,5,1,0.08333333333333333,111.61022683561052,4
2020-03-07-170811,170811,1,0,3,2,0.0,118.14199832336483,5
2020-03-08-170811,170811,0,0,2,2,0.0,124.50217032824193,6
2020-03-09-170811,170811,2,0,9,4,0.3333333333333333,123.33157551118057,0
2020-03-10-170811,170811,0,0,10,4,0.16666666666666666,230.8000363848191,1
2020-03-11-170811,170811,2,0,5,6,0.5,203.20877816137164,2
2020-03-12-170811,170811,1,0,9,7,0.9166666666666666,168.00992901600355,3
2020-03-13-170811,170811,0,0,12,7,0.8333333333333334,150.5856526808336,4
2020-03-14-170811,170811,0,0,3,7,0.75,116.88578120672733,5
2020-03-15-170811,170811,1,0,1,8,1.25,60.739004549597155,6
2020-03-16-170811,170811,5,0,10,13,5.583333333333332,40.77519784422604,0
2020-03-17-170811,170811,7,0,10,20,4.916666666666667,88.46509506983637,1
2020-03-18-170811,170811,8,0,27,28,7.833333333333332,113.44422976283302,2
2020-03-19-170811,170811,3,0,6,31,8.5,160.7656601966848,3
2020-03-20-170811,170811,5,0,3,36,9.5,162.9897086988342,4
2020-03-21-170811,170811,3,0,3,39,4.583333333333333,190.33782862377993,5
2020-03-22-170811,170811,2,0,3,41,2.833333333333333,189.85613192377343,6
2020-03-23-170811,170811,9,0,11,50,11.25,162.4935497726137,0
2020-03-24-170811,170811,10,0,10,60,8.5,187.92665268050132,1
2020-03-25-170811,170811,5,0,10,65,10.666666666666666,179.49838719186636,2
2020-03-26-170811,170811,9,0,8,74,10.5,194.31580498623316,3
2020-03-27-170811,170811,12,0,3,86,10.166666666666666,228.81259256853266,4
2020-03-28-170811,170811,3,0,4,89,5.166666666666667,238.72172088391397,5
2020-03-29-170811,170811,1,0,2,90,1.9166666666666667,231.0564535622992,6
2020-03-30-170811,170811,10,0,13,100,9.0,176.27259401063233,0
2020-03-31-170811,170811,10,0,19,110,9.25,171.03116151166915,1
2020-04-01-170811,170811,27,0,3,137,7.416666666666668,39.00498130477821,2
2020-04-02-170811,170811,6,0,22,143,5.666666666666668,164.1573051600481,3
2020-04-03-170811,170811,3,0,2,146,5.416666666666668,66.26273711149013,4
2020-04-04-170811,170811,3,0,11,149,2.083333333333333,69.24819632533745,5
2020-04-05-170811,170811,3,0,2,152,2.4166666666666665,75.51138105472353,6
2020-04-06-170811,170811,11,0,40,163,4.583333333333333,83.26778642827705,0
2020-04-07-170811,170811,10,1,1,173,4.416666666666667,95.2832181221556,1
2020-04-08-170811,170811,10,0,5,183,4.083333333333333,120.16850966842857,2
2020-04-09-170811,170811,8,0,0,191,5.0,145.12542503072967,3
2020-04-10-170811,170811,3,0,6,194,5.75,58.03975454801747,4
2020-04-11-170811,170811,4,0,3,198,1.3333333333333333,77.49087822706358,5
2020-04-12-170811,170811,2,0,0,200,2.75,88.48417621620423,6
2020-04-13-170811,170811,13,0,6,213,3.75,97.26886877280306,0
2020-04-14-170811,170811,19,0,4,232,2.9166666666666665,131.13970668649077,1
2020-04-15-170811,170811,3,0,1,235,3.9166666666666665,176.81043532582146,2
2020-04-16-170811,170811,22,0,3,257,5.0,194.80116769498875,3
2020-04-17-170811,170811,2,0,1,259,2.583333333333333,200.9431085418238,4
2020-04-18-170811,170811,11,0,2,270,2.333333333333333,190.9811607198966,5
2020-04-19-170811,170811,2,0,0,272,3.4166666666666665,215.1565555225983,6
2020-04-20-170811,170811,40,0,9,312,11.0,210.12754318879777,0
2020-04-21-170811,170811,1,0,7,313,2.75,257.50011738477946,1
2020-04-22-170811,170811,5,0,9,318,2.833333333333333,249.22263738788416,2
2020-04-23-170811,170811,0,0,5,318,3.0,203.83519312862848,3
2020-04-24-170811,170811,6,0,4,324,4.083333333333333,185.55347676059375,4
2020-04-25-170811,170811,3,0,0,327,3.8333333333333335,182.00582324339348,5
2020-04-26-170811,170811,0,0,0,327,0.5,181.7669353444407,6
2020-04-27-170811,170811,6,0,5,333,2.9166666666666665,157.24761596627832,0
2020-04-28-170811,170811,4,0,5,337,2.1666666666666665,82.38681880713844,1
2020-04-29-170811,170811,1,0,8,338,1.4166666666666667,86.07288991440299,2
2020-04-30-170811,170811,3,0,1,341,1.5833333333333333,98.29751030056917,3
2020-05-01-170811,170811,1,0,5,342,0.9166666666666666,194.03309188461407,4
2020-05-02-170811,170811,2,0,1,344,2.083333333333333,73.12575867761413,5
2020-05-03-170811,170811,0,0,0,344,1.1666666666666667,59.63781896136418,6
2020-05-04-170811,170811,9,0,3,353,3.9166666666666665,53.752736138908716,0
2020-05-05-170811,170811,7,0,5,360,3.9166666666666665,62.78754607798151,1
2020-05-06-170811,170811,9,0,1,369,6.083333333333332,81.37545026906375,2
2020-05-07-170811,170811,5,0,1,374,4.166666666666667,96.50507768809547,3
2020-05-08-170811,170811,4,0,0,378,4.166666666666667,117.4714260804198,4
2020-05-09-170811,170811,0,0,0,378,1.0,134.58785690657618,5
2020-05-10-170811,170811,0,2,4,378,0.5,230.7678805369583,6
2020-05-11-170811,170811,5,0,5,383,5.166666666666667,207.12380473206184,0
2020-05-12-170811,170811,5,0,5,388,2.9166666666666665,202.57841355281295,1
2020-05-13-170811,170811,8,0,0,396,4.5,174.70665472358854,2
2020-05-14-170811,170811,1,0,5,397,3.083333333333333,154.22353935960803,3
2020-05-15-170811,170811,5,1,2,402,2.6666666666666665,123.42400810030813,4
2020-05-16-170811,170811,1,0,3,403,0.8333333333333334,95.34246546713568,5
2020-05-17-170811,170811,0,0,0,403,0.08333333333333333,88.38127343664956,6
2020-05-18-170811,170811,3,0,1,406,2.5,89.36123400674676,0
2020-05-19-170811,170811,5,0,3,411,2.6666666666666665,87.03631539267946,1
2020-05-20-170811,170811,1,0,2,412,1.6666666666666667,75.32166367141832,2
2020-05-21-170811,170811,1,0,1,413,1.1666666666666667,75.57217611430856,3
2020-05-22-170811,170811,0,0,1,413,1.1666666666666667,64.9229547470009,4
2020-05-23-170811,170811,0,0,1,413,0.75,72.11236732205917,5
2020-05-24-170811,170811,4,0,1,417,0.4166666666666667,73.00165603109429,6
2020-05-25-170811,170811,5,0,3,422,2.1666666666666665,66.24030203780003,0
2020-05-26-170811,170811,5,0,2,427,1.9166666666666667,65.41107491576595,1
2020-05-27-170811,170811,0,0,4,427,3.0,68.57000747740744,2
2020-05-28-170811,170811,5,0,0,432,1.8333333333333333,66.15134900702421,3
2020-05-29-170811,170811,2,0,2,434,1.9166666666666667,84.50115265411972,4
2020-05-30-170811,170811,3,0,1,437,1.3333333333333333,89.85002908728237,5
2020-05-31-170811,170811,0,0,1,437,0.08333333333333333,96.70794031781551,6
2020-06-01-170811,170811,1,0,0,438,0.8333333333333334,168.2784221503032,0
2020-06-02-170811,170811,3,0,3,441,1.5,56.039988379111335,1
2020-06-03-170811,170811,2,0,6,443,0.9166666666666666,34.04205670344358,2
2020-06-04-170811,170811,1,0,1,444,2.0,40.723589676269114,3
2020-06-05-170811,170811,1,2,2,445,1.5833333333333333,43.34599280255429,4
2020-06-06-170811,170811,1,0,0,446,0.4166666666666667,36.88548563335141,5
2020-06-07-170811,170811,1,0,0,447,0.3333333333333333,39.14657987392904,6
2020-06-08-170811,170811,3,0,1,450,1.0,38.287228868930505,0
2020-06-09-170811,170811,2,0,0,452,2.083333333333333,44.6401829763332,1
2020-06-10-170811,170811,4,0,0,456,1.4166666666666667,178.61362494554766,2
2020-06-11-170811,170811,0,1,1,456,1.25,161.03873091338636,3
2020-06-12-170811,170811,2,0,1,458,1.4166666666666667,134.17019633237192,4
2020-06-13-170811,170811,1,0,1,459,0.3333333333333333,91.88096094548402,5
2020-06-14-170811,170811,1,0,2,460,0.25,64.83750882330357,6
2020-06-15-170811,170811,0,0,0,460,0.8333333333333334,49.812309465298654,0
2020-06-16-170811,170811,3,0,0,463,0.75,52.211470042405224,1
2020-06-17-170811,170811,6,0,1,469,0.75,54.37353426498017,2
2020-06-18-170811,170811,1,0,0,470,0.6666666666666666,57.941396497902616,3
2020-06-19-170811,170811,2,0,0,472,0.75,60.0882442349672,4
2020-06-20-170811,170811,0,0,0,472,0.25,72.0438285844278,5
2020-06-21-170811,170811,0,0,0,472,0.5,72.42034555283124,6
2020-06-22-170811,170811,1,0,0,473,0.8333333333333334,72.19583987877249,0
2020-06-23-170811,170811,0,0,1,473,0.6666666666666666,68.60275552164079,1
2020-06-24-170811,170811,0,1,1,473,0.6666666666666666,53.59148445963771,2
2020-06-25-170811,170811,1,0,0,474,0.5833333333333334,49.04198464287775,3
2020-06-26-170811,170811,1,0,1,475,1.0833333333333333,43.0621386672423,4
2020-06-27-170811,170811,1,0,0,476,0.0,45.547283920048365,5
2020-06-28-170811,170811,2,0,0,478,0.0,47.94878559841129,6
2020-06-29-170811,170811,0,0,2,478,0.25,52.81497176365798,0
2020-06-30-170811,170811,0,0,1,478,0.3333333333333333,52.58623589881316,1
2020-07-01-170811,170811,1,0,2,479,0.75,66.8166785317387,2
2020-07-02-170811,170811,0,0,3,479,0.5,62.70428817542391,3
2020-07-03-170811,170811,0,0,0,479,0.5,71.07388002863155,4
2020-07-04-170811,170811,0,0,0,479,0.08333333333333333,54.92435286201503,5
2020-07-05-170811,170811,0,0,0,479,0.25,48.2691512621107,6
2020-07-06-170811,170811,0,0,0,479,0.3333333333333333,46.32017311750786,0
2020-07-07-170811,170811,1,0,1,480,0.6666666666666666,51.44825513322223,1
2020-07-08-170811,170811,1,0,0,481,0.9166666666666666,48.48850447635877,2
2020-07-09-170811,170811,0,0,1,481,0.75,52.23533622526432,3
2020-07-10-170811,170811,1,0,1,482,0.3333333333333333,74.02176415214966,4
2020-07-11-170811,170811,0,0,0,482,0.25,62.42508831677271,5
2020-07-12-170811,170811,0,0,1,482,0.25,49.21708559408221,6
2020-07-13-170811,170811,2,0,0,484,1.0,46.55332951628249,0
2020-07-14-170811,170811,1,0,0,485,0.4166666666666667,64.7956730068324,1
2020-07-15-170811,170811,2,0,2,487,0.9166666666666666,62.67917008283988,2
2020-07-16-170811,170811,3,0,1,490,0.4166666666666667,54.62856589140452,3
2020-07-17-170811,170811,0,1,2,490,0.8333333333333334,64.35251541061473,4
2020-07-18-170811,170811,0,0,5,490,0.25,69.5005435270248,5
2020-07-19-170811,170811,0,0,0,490,0.25,73.40945558636353,6
2020-07-20-170811,170811,0,0,0,490,1.1666666666666667,53.13533635843367,0
2020-07-21-170811,170811,1,0,4,491,0.9166666666666666,60.14571883141787,1
2020-07-22-170811,170811,0,0,13,491,0.4166666666666667,59.41556559199053,2
2020-07-23-170811,170811,1,0,10,492,0.9166666666666666,54.19357508972742,3
2020-07-24-170811,170811,1,0,2,493,1.0833333333333333,79.49172252522402,4
2020-07-25-170811,170811,0,0,3,493,0.5833333333333334,92.01520220515188,5
2020-07-26-170811,170811,1,0,0,494,0.4166666666666667,103.56740821381295,6
2020-07-27-170811,170811,0,0,1,494,0.6666666666666666,103.32237226221429,0
2020-07-28-170811,170811,0,0,4,494,0.6666666666666666,94.52600180498175,1
2020-07-29-170811,170811,2,0,2,496,1.3333333333333333,83.53125553127508,2
2020-07-30-170811,170811,1,0,0,497,1.75,63.125292730365324,3
2020-07-31-170811,170811,2,0,5,499,1.3333333333333333,60.095730215692356,4
2020-08-01-170811,170811,5,0,1,504,1.0833333333333333,48.42575549237613,5
2020-08-02-170811,170811,0,0,2,504,0.6666666666666666,224.07985106182488,6
2020-08-03-170811,170811,0,0,1,504,2.5,158.59862779941278,0
2020-08-04-170811,170811,4,0,7,508,2.5,152.64246947792446,1
2020-08-05-170811,170811,13,0,3,521,1.6666666666666667,152.65233936391104,2
2020-08-06-170811,170811,10,0,1,531,1.8333333333333333,166.82319017434406,3
2020-08-07-170811,170811,2,0,0,533,0.9166666666666666,201.4796139442198,4
2020-08-08-170811,170811,3,0,3,536,0.6666666666666666,216.31251867899988,5
2020-08-09-170811,170811,0,0,0,536,1.0,227.3821392474896,6
2020-08-10-170811,170811,1,0,3,537,2.1666666666666665,53.55376658070466,0
2020-08-11-170811,170811,4,0,2,541,2.0,84.18638842908612,1
2020-08-12-170811,170811,2,0,4,543,2.083333333333333,131.17774566838108,2
2020-08-13-170811,170811,0,0,4,543,3.1666666666666665,182.83630729356372,3
2020-08-14-170811,170811,5,0,1,548,3.1666666666666665,200.65777401686748,4
2020-08-15-170811,170811,1,0,0,549,0.4166666666666667,270.0317748377334,5
2020-08-16-170811,170811,2,0,1,551,0.6666666666666666,284.1019980522376,6
2020-08-17-170811,170811,1,0,1,552,2.1666666666666665,286.2863672984118,0
2020-08-18-170811,170811,7,0,5,559,4.333333333333333,262.13100838099837,1
2020-08-19-170811,170811,3,0,1,562,2.583333333333333,272.1636839484431,2
2020-08-20-170811,170811,1,0,1,563,3.25,223.37212109259747,3
2020-08-21-170811,170811,0,0,2,563,1.6666666666666667,161.5097247812781,4
2020-08-22-170811,170811,3,0,0,566,1.3333333333333333,161.2218624769044,5
2020-08-23-170811,170811,0,0,1,566,0.5,161.8088130676718,6
2020-08-24-170811,170811,3,0,1,569,3.083333333333333,156.24498548334955,0
2020-08-25-170811,170811,2,0,1,571,1.0833333333333333,121.54916563103104,1
2020-08-26-170811,170811,4,0,1,575,2.75,105.4917960010047,2
2020-08-27-170811,170811,4,0,1,579,1.1666666666666667,128.39209556356218,3
2020-08-28-170811,170811,1,0,0,580,2.0,159.289254131946,4
2020-08-29-170811,170811,0,0,3,580,0.4166666666666667,172.07335476523937,5
2020-08-30-170811,170811,1,0,0,581,1.0,157.48163201996522,6
2020-08-31-170811,170811,1,0,4,582,2.6666666666666665,142.4363697291862,0
2020-09-01-170811,170811,5,1,0,587,2.333333333333333,201.94790716408045,1
2020-09-02-170811,170811,1,0,2,588,1.6666666666666667,119.03844014003593,2
2020-09-03-170811,170811,1,0,0,589,1.6666666666666667,182.90529322416813,3
2020-09-04-170811,170811,2,0,3,591,2.6666666666666665,162.52101981516057,4
2020-09-05-170811,170811,0,0,0,591,1.0833333333333333,153.2269988146413,5
2020-09-06-170811,170811,1,0,5,592,1.0,127.29038406089379,6
2020-09-07-170811,170811,1,0,1,593,2.583333333333333,134.46163637035295,0
2020-09-08-170811,170811,1,0,1,594,0.9166666666666666,123.34654863097603,1
2020-09-09-170811,170811,1,0,5,595,1.9166666666666667,128.89334371830782,2
2020-09-10-170811,170811,1,1,5,596,1.6666666666666667,189.7873898697337,3
2020-09-11-170811,170811,0,0,1,596,2.4166666666666665,188.8920440833965,4
2020-09-12-170811,170811,3,0,3,599,1.1666666666666667,165.9608424747629,5
2020-09-13-170811,170811,0,0,0,599,1.0833333333333333,142.00395115862113,6
2020-09-14-170811,170811,4,0,2,603,3.333333333333333,137.4771014449633,0
2020-09-15-170811,170811,0,0,0,603,3.0,135.99124916333176,1
2020-09-16-170811,170811,2,1,0,605,3.0,128.49749607977623,2
2020-09-17-170811,170811,0,0,1,605,2.0,112.82415883981194,3
2020-09-18-170811,170811,3,0,0,608,3.083333333333333,106.39234797085024,4
2020-09-19-170811,170811,0,0,0,608,0.3333333333333333,108.92238847325167,5
2020-09-20-170811,170811,5,0,0,613,1.0833333333333333,93.60324085132936,6
2020-09-21-170811,170811,1,0,2,614,2.5,102.57613509678214,0
2020-09-22-170811,170811,1,0,2,615,2.333333333333333,119.66005590634157,1
2020-09-23-170811,170811,5,1,1,620,1.9166666666666667,114.7182815364436,2
2020-09-24-170811,170811,5,1,1,625,1.75,127.67224222830797,3
2020-09-25-170811,170811,1,0,3,626,1.0,133.75460991537085,4
2020-09-26-170811,170811,3,0,3,629,2.1666666666666665,155.94691529643643,5
2020-09-27-170811,170811,0,0,2,629,0.25,176.96483397061587,6
2020-09-28-170811,170811,2,1,3,631,1.4166666666666667,155.9010869815878,0
2020-09-29-170811,170811,0,0,4,631,0.75,154.59530241278168,1
2020-09-30-170811,170811,0,0,2,631,1.25,146.18093667587152,2
2020-10-01-170811,170811,1,0,5,632,0.4166666666666667,0.0,3
2020-10-02-170811,170811,0,0,16,632,1.0,310.26380982601376,4
2020-10-03-170811,170811,0,0,35,632,0.0,237.18946654621618,5
2020-10-04-170811,170811,0,0,1,632,0.25,213.31200229934586,6
2020-10-05-170811,170811,2,1,1,634,1.0833333333333333,172.56626475984186,0
2020-10-06-170811,170811,2,0,1,636,0.5833333333333334,161.78690057981203,1
2020-10-07-170811,170811,1,0,8,637,1.5,121.5327043507461,2
2020-10-08-170811,170811,1,0,6,638,1.3333333333333333,113.37618656530806,3
2020-10-09-170811,170811,3,0,9,641,1.4166666666666667,135.9578815327216,4
2020-10-10-170811,170811,3,0,6,644,0.8333333333333334,6.088588144076387,5
2020-10-11-170811,170811,2,0,5,646,0.75,21.511895365171473,6
2020-10-12-170811,170811,3,0,7,649,0.25,38.15259115854866,0
2020-10-13-170811,170811,4,0,1,653,1.6666666666666667,52.7282156245498,1
2020-10-14-170811,170811,2,0,8,655,1.5833333333333333,91.71079394015193,2
2020-10-15-170811,170811,5,0,3,660,1.5833333333333333,110.15020007797698,3
2020-10-16-170811,170811,16,0,6,676,2.9166666666666665,139.18114369470652,4
2020-10-17-170811,170811,35,0,9,711,1.75,234.06619030814346,5
2020-10-18-170811,170811,1,0,3,712,2.5,352.5565176901699,6
2020-10-19-170811,170811,1,1,2,713,2.4166666666666665,361.34951533539714,0
2020-10-20-170811,170811,1,1,5,714,2.333333333333333,317.18749280085393,1
2020-10-21-170811,170811,8,2,2,722,2.333333333333333,314.86470767816775,2
2020-10-22-170811,170811,6,0,6,728,2.4166666666666665,331.46525033873814,3
2020-10-23-170811,170811,9,0,11,737,3.6666666666666665,270.0346785984918,4
2020-10-24-170811,170811,6,0,3,743,3.4166666666666665,183.86366333087076,5
2020-10-25-170811,170811,5,0,14,748,3.1666666666666665,177.04744507607705,6
2020-10-26-170811,170811,7,0,3,755,3.1666666666666665,190.70707760262988,0
2020-10-27-170811,170811,1,0,4,756,2.333333333333333,229.49895573512575,1
2020-10-28-170811,170811,8,1,5,764,2.833333333333333,237.625470194723,2
2020-10-29-170811,170811,3,0,6,767,3.4166666666666665,260.2686765431158,3
2020-10-30-170811,170811,6,0,2,773,4.75,220.38121415946136,4
2020-10-31-170811,170811,9,2,0,782,2.5,225.13872482573024,5
2020-11-01-170811,170811,3,1,0,785,2.25,125.63410315690268,6
2020-11-02-170811,170811,2,0,0,787,2.0,289.0870310982141,0
2020-11-03-170811,170811,5,0,0,792,4.583333333333333,297.84696075864406,1
2020-11-04-170811,170811,2,0,0,794,3.6666666666666665,280.64756988708655,2
2020-11-05-170811,170811,6,1,0,800,5.166666666666667,287.36013708358735,3
2020-11-06-170811,170811,11,1,0,811,3.583333333333333,286.4144785465145,4
2020-11-07-170811,170811,3,1,0,814,4.0,289.53841793212086,5
2020-11-08-170811,170811,14,1,0,828,5.833333333333332,274.1374882144946,6
2020-11-09-170811,170811,3,0,0,831,3.9166666666666665,290.15666003592014,0
2020-11-10-170811,170811,4,0,0,835,4.583333333333333,93.72409854488161,1
2020-11-11-170811,170811,5,0,0,840,5.083333333333333,116.16306166379232,2
2020-11-12-170811,170811,6,0,0,846,4.75,154.0585274787357,3
2020-11-13-170811,170811,2,0,0,848,5.333333333333333,184.07384523437548,4
2020-03-01-170812,170812,0,0,0,0,0.0,0.0,6
2020-03-02-170812,170812,0,0,2,0,0.0,6.416122363480813,0
2020-03-03-170812,170812,0,0,0,0,0.0,19.290854794649917,1
2020-03-04-170812,170812,0,0,4,0,0.0,21.114692442910453,2
2020-03-05-170812,170812,0,0,0,0,0.5,21.997239161768974,3
2020-03-06-170812,170812,0,0,2,0,0.0,17.12255205214408,4
2020-03-07-170812,170812,0,0,1,0,0.5,18.03260037660869,5
2020-03-08-170812,170812,0,0,0,0,0.0,20.497123368285227,6
2020-03-09-170812,170812,0,0,2,0,1.0,19.851320892599432,0
2020-03-10-170812,170812,0,1,2,0,0.0,51.24484238956923,1
2020-03-11-170812,170812,0,0,0,0,1.0,47.030202600983216,2
2020-03-12-170812,170812,2,0,0,2,0.5,37.53130433704034,3
2020-03-13-170812,170812,1,0,1,3,0.0,37.88753566434717,4
2020-03-14-170812,170812,0,0,0,3,0.0,29.65993984234869,5
2020-03-15-170812,170812,0,0,0,3,0.5,17.939949383057794,6
2020-03-16-170812,170812,2,0,0,5,2.5,10.545670670494816,0
2020-03-17-170812,170812,0,0,0,5,4.0,22.049277390895824,1
2020-03-18-170812,170812,4,0,0,9,4.0,28.03842192987262,2
2020-03-19-170812,170812,0,1,1,9,2.5,41.24018063583577,3
2020-03-20-170812,170812,2,0,0,11,2.5,37.67830754615466,4
2020-03-21-170812,170812,1,0,1,12,2.0,45.797941368463775,5
2020-03-22-170812,170812,0,1,1,12,1.0,47.194146398477514,6
2020-03-23-170812,170812,2,0,0,14,4.5,37.88330753654791,0
2020-03-24-170812,170812,2,0,3,16,5.0,44.679356050601456,1
2020-03-25-170812,170812,0,0,0,16,3.5,39.78092639429684,2
2020-03-26-170812,170812,0,0,1,16,4.5,42.42597957079126,3
2020-03-27-170812,170812,1,0,0,17,7.0,50.923273476782924,4
2020-03-28-170812,170812,0,0,0,17,1.5,54.63864933308294,5
2020-03-29-170812,170812,0,0,0,17,0.5,54.082225632957645,6
2020-03-30-170812,170812,0,0,0,17,5.5,41.27931698980486,0
2020-03-31-170812,170812,0,0,0,17,5.0,38.03173634867423,1
2020-04-01-170812,170812,0,0,0,17,13.5,8.448725216678632,2
2020-04-02-170812,170812,1,0,0,18,3.5,39.84123588492726,3
2020-04-03-170812,170812,0,0,0,18,1.5,20.710954880057987,4
2020-04-04-170812,170812,1,0,0,19,1.5,18.954277555898155,5
2020-04-05-170812,170812,1,0,0,20,1.5,20.877717325771172,6
2020-04-06-170812,170812,0,0,1,20,5.5,21.72378327426394,0
2020-04-07-170812,170812,3,0,0,23,5.0,23.6854254644385,1
2020-04-08-170812,170812,0,0,0,23,5.0,32.68109951220974,2
2020-04-09-170812,170812,1,1,0,24,4.0,36.74375635478435,3
2020-04-10-170812,170812,0,0,0,24,1.5,14.65573626957105,4
2020-04-11-170812,170812,0,0,0,24,2.5,17.30201396298542,5
2020-04-12-170812,170812,0,0,0,24,1.0,20.160918969569853,6
2020-04-13-170812,170812,0,0,0,24,7.0,21.3646540728438,0
2020-04-14-170812,170812,0,0,0,24,10.0,27.662265099884188,1
2020-04-15-170812,170812,0,0,0,24,2.0,38.868425263610675,2
2020-04-16-170812,170812,0,0,1,24,11.0,42.378499964816356,3
2020-04-17-170812,170812,0,0,0,24,1.0,43.314896539949686,4
2020-04-18-170812,170812,0,0,0,24,6.0,43.72896168392583,5
2020-04-19-170812,170812,0,0,0,24,1.0,48.0341498745589,6
2020-04-20-170812,170812,1,0,0,25,20.0,48.94266647884198,0
2020-04-21-170812,170812,0,0,0,25,1.0,63.08337397696161,1
2020-04-22-170812,170812,0,0,0,25,3.5,62.17453699382082,2
2020-04-23-170812,170812,0,0,1,25,0.5,53.642810551949914,3
2020-04-24-170812,170812,0,0,0,25,3.0,51.16136272254606,4
2020-04-25-170812,170812,0,0,0,25,1.5,51.315649906770915,5
2020-04-26-170812,170812,0,0,0,25,0.0,52.28703189083476,6
2020-04-27-170812,170812,0,0,0,25,3.0,47.830212982838525,0
2020-04-28-170812,170812,0,0,0,25,2.5,27.120345383322665,1
2020-04-29-170812,170812,0,0,0,25,0.5,28.379609330271315,2
2020-04-30-170812,170812,1,0,0,26,1.5,29.119149457125467,3
2020-05-01-170812,170812,0,0,0,26,1.5,55.76112586366891,4
2020-05-02-170812,170812,0,0,0,26,1.5,19.678143199500504,5
2020-05-03-170812,170812,0,0,0,26,0.0,16.60287772910751,6
2020-05-04-170812,170812,0,0,0,26,5.0,14.454959044971384,0
2020-05-05-170812,170812,0,0,0,26,3.5,17.297785138290493,1
2020-05-06-170812,170812,0,0,0,26,4.5,22.709625163102764,2
2020-05-07-170812,170812,1,0,0,27,2.5,23.17873705211486,3
2020-05-08-170812,170812,0,0,1,27,2.0,29.00969740821198,4
2020-05-09-170812,170812,0,0,0,27,0.5,34.06139715470516,5
2020-05-10-170812,170812,0,0,0,27,0.0,60.939716351417246,6
2020-05-11-170812,170812,0,0,0,27,2.5,52.87505647045411,0
2020-05-12-170812,170812,0,1,0,27,5.5,51.5158343570005,1
2020-05-13-170812,170812,0,1,0,27,4.5,46.33937710883035,2
2020-05-14-170812,170812,0,0,1,27,0.5,37.544529936211454,3
2020-05-15-170812,170812,0,0,0,27,2.5,31.318638830553937,4
2020-05-16-170812,170812,0,1,0,27,0.5,23.75141396028858,5
2020-05-17-170812,170812,0,0,0,27,0.0,21.87795089423872,6
2020-05-18-170812,170812,0,0,0,27,2.0,21.882668767810024,0
2020-05-19-170812,170812,0,0,0,27,3.0,21.328616736527973,1
2020-05-20-170812,170812,0,0,0,27,0.5,16.398548861419968,2
2020-05-21-170812,170812,0,0,0,27,1.0,15.840160443264047,3
2020-05-22-170812,170812,1,0,0,28,0.0,14.29119410346621,4
2020-05-23-170812,170812,0,0,0,28,0.0,17.718244363510838,5
2020-05-24-170812,170812,0,0,0,28,2.0,17.731245199451976,6
2020-05-25-170812,170812,0,0,0,28,2.5,16.715911370420947,0
2020-05-26-170812,170812,0,0,0,28,3.0,15.995313523280759,1
2020-05-27-170812,170812,0,0,0,28,0.0,17.036333071432885,2
2020-05-28-170812,170812,1,0,0,29,2.5,16.72624066769758,3
2020-05-29-170812,170812,0,0,0,29,1.0,21.10010611810001,4
2020-05-30-170812,170812,0,0,0,29,1.5,19.570711613685155,5
2020-05-31-170812,170812,0,0,0,29,0.5,20.045502459444858,6
2020-06-01-170812,170812,0,0,1,29,0.5,36.164953868288826,0
2020-06-02-170812,170812,0,0,0,29,1.5,14.531694828520433,1
2020-06-03-170812,170812,0,0,0,29,1.0,9.943983599056612,2
2020-06-04-170812,170812,0,0,0,29,0.5,11.507497780085911,3
2020-06-05-170812,170812,0,0,0,29,0.5,12.227292967595723,4
2020-06-06-170812,170812,0,0,0,29,0.5,7.0575903773223105,5
2020-06-07-170812,170812,0,0,0,29,0.5,7.571063406976071,6
2020-06-08-170812,170812,0,0,0,29,1.5,7.36486013717268,0
2020-06-09-170812,170812,0,0,0,29,1.0,8.663913571229694,1
2020-06-10-170812,170812,0,0,0,29,2.0,36.6509680917016,2
2020-06-11-170812,170812,0,0,0,29,0.0,32.3099324340555,3
2020-06-12-170812,170812,0,0,2,29,1.0,26.726583093960922,4
2020-06-13-170812,170812,0,0,0,29,0.5,20.286830607743262,5
2020-06-14-170812,170812,0,0,0,29,0.5,14.30157709375218,6
2020-06-15-170812,170812,1,4,0,30,0.0,10.003501885208571,0
2020-06-16-170812,170812,0,0,0,30,1.5,12.053502368472348,1
2020-06-17-170812,170812,0,0,0,30,3.0,13.17858055104168,2
2020-06-18-170812,170812,0,0,1,30,0.5,14.469358112075597,3
2020-06-19-170812,170812,0,0,0,30,1.0,14.594708207566619,4
2020-06-20-170812,170812,0,0,0,30,0.0,15.241383077364375,5
2020-06-21-170812,170812,0,0,0,30,0.0,15.070952052336867,6
2020-06-22-170812,170812,0,0,0,30,0.5,12.796346386672896,0
2020-06-23-170812,170812,0,1,0,30,0.0,11.464131545917263,1
2020-06-24-170812,170812,0,1,0,30,0.0,7.159741354693652,2
2020-06-25-170812,170812,0,0,0,30,0.5,6.173693198121617,3
2020-06-26-170812,170812,2,0,0,32,0.5,5.3431121105982715,4
2020-06-27-170812,170812,0,1,0,32,0.5,10.458476624119145,5
2020-06-28-170812,170812,0,0,0,32,1.0,11.138012028979373,6
2020-06-29-170812,170812,0,0,0,32,0.0,12.337692025813977,0
2020-06-30-170812,170812,0,0,0,32,0.0,12.485005956377936,1
2020-07-01-170812,170812,0,0,0,32,0.5,11.630936893174017,2
2020-07-02-170812,170812,1,0,0,33,0.0,9.256537139738127,3
2020-07-03-170812,170812,0,0,0,33,0.5,16.656589497263596,4
2020-07-04-170812,170812,0,0,0,33,0.0,10.051249728674733,5
2020-07-05-170812,170812,0,0,0,33,0.0,8.935764922124195,6
2020-07-06-170812,170812,0,0,0,33,0.0,8.183929922391215,0
2020-07-07-170812,170812,0,0,0,33,0.5,8.891687591596577,1
2020-07-08-170812,170812,0,3,1,33,0.5,8.111576217611006,2
2020-07-09-170812,170812,0,0,0,33,0.0,9.060291752555054,3
2020-07-10-170812,170812,0,0,0,33,0.5,13.472028455444306,4
2020-07-11-170812,170812,0,0,1,33,0.0,11.329998647539272,5
2020-07-12-170812,170812,0,0,0,33,0.0,9.153414630607081,6
2020-07-13-170812,170812,0,0,0,33,1.0,8.375220929633954,0
2020-07-14-170812,170812,0,0,0,33,0.5,9.967625453243206,1
2020-07-15-170812,170812,0,0,0,33,1.0,9.463244737810053,2
2020-07-16-170812,170812,0,0,0,33,1.5,7.872128045438278,3
2020-07-17-170812,170812,0,0,1,33,0.0,9.78560052857728,4
2020-07-18-170812,170812,0,0,0,33,0.0,10.316956347149107,5
2020-07-19-170812,170812,0,0,0,33,0.0,11.112689732479106,6
2020-07-20-170812,170812,0,0,1,33,0.5,10.807428919430626,0
2020-07-21-170812,170812,0,0,0,33,0.5,12.272595266438165,1
2020-07-22-170812,170812,1,0,0,34,0.0,11.686921594296548,2
2020-07-23-170812,170812,0,0,0,34,0.5,12.815678007317826,3
2020-07-24-170812,170812,0,0,0,34,0.5,22.029145336256764,4
2020-07-25-170812,170812,1,0,0,35,0.0,23.648076292165165,5
2020-07-26-170812,170812,0,0,0,35,0.5,27.588433229692814,6
2020-07-27-170812,170812,0,0,0,35,0.0,25.431513335998243,0
2020-07-28-170812,170812,0,0,1,35,0.0,24.191510835713643,1
2020-07-29-170812,170812,0,0,3,35,1.0,22.668107780772274,2
2020-07-30-170812,170812,0,0,0,35,0.5,12.079952833529571,3
2020-07-31-170812,170812,1,0,4,36,1.0,11.55252864400077,4
2020-08-01-170812,170812,0,0,0,36,2.5,9.314287107276996,5
2020-08-02-170812,170812,0,0,2,36,0.0,70.02609967538044,6
2020-08-03-170812,170812,1,0,0,37,0.0,31.422089536754633,0
2020-08-04-170812,170812,0,0,0,37,2.0,35.17687104494257,1
2020-08-05-170812,170812,0,0,0,37,6.5,35.63337536742332,2
2020-08-06-170812,170812,0,0,0,37,5.0,33.85493172647726,3
2020-08-07-170812,170812,0,1,0,37,1.0,42.07681124739263,4
2020-08-08-170812,170812,0,0,0,37,1.5,43.57497639093703,5
2020-08-09-170812,170812,0,0,0,37,0.0,42.70793342702024,6
2020-08-10-170812,170812,0,0,0,37,0.5,8.592137492767906,0
2020-08-11-170812,170812,1,0,0,38,2.0,15.782253794343987,1
2020-08-12-170812,170812,3,0,1,41,1.0,26.126985791254885,2
2020-08-13-170812,170812,0,0,2,41,3.0,42.40534443272995,3
2020-08-14-170812,170812,4,0,0,45,7.5,50.75704000651899,4
2020-08-15-170812,170812,0,0,0,45,0.5,76.15603330404716,5
2020-08-16-170812,170812,2,0,0,47,1.0,79.43592042531856,6
2020-08-17-170812,170812,0,0,0,47,0.5,86.60039022842352,0
2020-08-18-170812,170812,0,0,0,47,4.5,80.2859122764467,1
2020-08-19-170812,170812,0,0,0,47,2.0,87.0804799744315,2
2020-08-20-170812,170812,0,0,0,47,0.5,69.09196262525526,3
2020-08-21-170812,170812,0,0,1,47,0.5,43.623448444138944,4
2020-08-22-170812,170812,0,0,1,47,1.5,44.60556158042988,5
2020-08-23-170812,170812,0,0,0,47,0.0,38.7921938884278,6
2020-08-24-170812,170812,0,0,0,47,1.5,37.44614294950499,0
2020-08-25-170812,170812,0,0,0,47,1.0,25.262521203234854,1
2020-08-26-170812,170812,1,0,0,48,2.0,18.240716350394464,2
2020-08-27-170812,170812,2,0,1,50,2.5,21.651650797346456,3
2020-08-28-170812,170812,0,0,1,50,1.0,34.26845769652343,4
2020-08-29-170812,170812,0,0,0,50,0.5,35.973384442584475,5
2020-08-30-170812,170812,0,0,0,50,1.0,34.94579868543947,6
2020-08-31-170812,170812,0,0,0,50,1.5,31.677389129135403,0
2020-09-01-170812,170812,0,0,0,50,2.5,43.58036282315071,1
2020-09-02-170812,170812,0,0,0,50,1.0,20.843702964915117,2
2020-09-03-170812,170812,0,0,1,50,0.5,32.512082466794155,3
2020-09-04-170812,170812,1,0,1,51,1.5,30.448565059669356,4
2020-09-05-170812,170812,1,0,0,52,0.5,29.176220471284807,5
2020-09-06-170812,170812,0,0,0,52,0.5,24.225803839502056,6
2020-09-07-170812,170812,0,0,3,52,0.5,26.06895144481767,0
2020-09-08-170812,170812,0,0,0,52,0.5,25.12111871636136,1
2020-09-09-170812,170812,0,0,0,52,1.0,24.28267333149983,2
2020-09-10-170812,170812,1,0,0,53,1.0,36.58654351514206,3
2020-09-11-170812,170812,1,0,0,54,0.0,38.73323122133611,4
2020-09-12-170812,170812,0,0,0,54,1.5,34.54243151004005,5
2020-09-13-170812,170812,0,0,0,54,0.0,29.716589219124405,6
2020-09-14-170812,170812,0,0,0,54,2.0,28.014715591267475,0
2020-09-15-170812,170812,0,0,0,54,0.0,28.44725845433682,1
2020-09-16-170812,170812,0,0,2,54,1.0,24.786457642751117,2
2020-09-17-170812,170812,1,0,0,55,0.0,22.104588005215046,3
2020-09-18-170812,170812,1,0,0,56,1.5,20.006056511420134,4
2020-09-19-170812,170812,0,0,0,56,0.0,20.17498310546669,5
2020-09-20-170812,170812,0,0,0,56,2.5,17.646354891091203,6
2020-09-21-170812,170812,3,0,0,59,0.5,18.42778347561588,0
2020-09-22-170812,170812,0,0,0,59,0.5,24.58455384610392,1
2020-09-23-170812,170812,0,0,0,59,2.5,25.05225824677673,2
2020-09-24-170812,170812,0,0,0,59,2.5,26.561598755693907,3
2020-09-25-170812,170812,0,1,0,59,1.5,28.394682725472137,4
2020-09-26-170812,170812,0,1,0,59,2.5,33.224645673870754,5
2020-09-27-170812,170812,0,0,0,59,0.0,36.937041938611635,6
2020-09-28-170812,170812,0,0,0,59,1.0,32.74776514199579,0
2020-09-29-170812,170812,0,0,1,59,0.0,28.532913007089306,1
2020-09-30-170812,170812,2,0,0,61,0.0,25.069541200315246,2
2020-10-01-170812,170812,0,0,0,61,0.5,0.0,3
2020-10-02-170812,170812,0,0,3,61,0.5,71.97749897575117,4
2020-10-03-170812,170812,0,0,1,61,0.0,53.10855070874998,5
2020-10-04-170812,170812,0,0,0,61,0.0,46.756631316670045,6
2020-10-05-170812,170812,0,0,0,61,2.5,39.063810082751985,0
2020-10-06-170812,170812,0,0,0,61,1.0,36.24405577330606,1
2020-10-07-170812,170812,0,0,0,61,1.0,26.435732153989107,2
2020-10-08-170812,170812,0,0,0,61,1.0,23.78559626995436,3
2020-10-09-170812,170812,0,0,0,61,1.5,27.97148515484085,4
2020-10-10-170812,170812,0,0,0,61,2.0,1.4026011153885318,5
2020-10-11-170812,170812,0,0,0,61,1.0,4.9829226080298605,6
2020-10-12-170812,170812,0,0,0,61,1.5,8.055779082530622,0
2020-10-13-170812,170812,1,0,1,62,2.0,10.827105162188483,1
2020-10-14-170812,170812,0,0,1,62,1.5,19.803282019675702,2
2020-10-15-170812,170812,0,0,0,62,3.0,23.01490696135434,3
2020-10-16-170812,170812,3,0,0,65,10.5,27.995409318264365,4
2020-10-17-170812,170812,1,0,0,66,19.5,49.709654825577836,5
2020-10-18-170812,170812,0,0,0,66,1.0,77.22766151687007,6
2020-10-19-170812,170812,0,0,1,66,1.0,78.31116944809543,0
2020-10-20-170812,170812,0,0,0,66,0.5,69.22009509769005,1
2020-10-21-170812,170812,0,0,2,66,4.0,70.07722762486785,2
2020-10-22-170812,170812,0,0,1,66,4.5,75.66761870299882,3
2020-10-23-170812,170812,0,0,0,66,6.0,61.89031682434584,4
2020-10-24-170812,170812,0,0,1,66,4.5,39.162664848179375,5
2020-10-25-170812,170812,0,0,0,66,3.0,40.530716848468245,6
2020-10-26-170812,170812,0,0,0,66,4.0,43.3580499791569,0
2020-10-27-170812,170812,1,0,1,67,1.0,50.57177546992577,1
2020-10-28-170812,170812,1,0,4,68,6.5,54.580335999908336,2
2020-10-29-170812,170812,0,0,0,68,2.0,63.981138255217644,3
2020-10-30-170812,170812,0,0,0,68,5.0,53.45110289414399,4
2020-10-31-170812,170812,0,0,0,68,5.0,54.744005488677374,5
2020-11-01-170812,170812,0,0,0,68,2.0,25.292766105964418,6
2020-11-02-170812,170812,1,0,0,69,1.5,80.24848239934019,0
2020-11-03-170812,170812,0,0,0,69,3.0,78.2429576130477,1
2020-11-04-170812,170812,2,0,0,71,1.0,69.40614970724098,2
2020-11-05-170812,170812,1,0,0,72,3.0,67.95886357625238,3
2020-11-06-170812,170812,0,1,0,72,5.5,72.1047715301556,4
2020-11-07-170812,170812,1,0,0,73,2.5,67.05770687894915,5
2020-11-08-170812,170812,0,0,0,73,7.0,65.5203094495602,6
2020-11-09-170812,170812,0,0,0,73,2.5,66.84956877197952,0
2020-11-10-170812,170812,1,0,0,74,2.5,18.743658374905614,1
2020-11-11-170812,170812,4,0,0,78,2.5,26.66807954969644,2
2020-11-12-170812,170812,0,0,0,78,5.0,38.68120169251568,3
2020-11-13-170812,170812,0,0,0,78,3.5,47.97114150956682,4
2020-03-01-170902,170902,0,0,4,0,0.0,0.0,6
2020-03-02-170902,170902,0,0,6,0,0.2,56.1271446252018,0
2020-03-03-170902,170902,0,1,10,0,0.0,291.52307576453546,1
2020-03-04-170902,170902,0,0,11,0,0.4,311.9106746199585,2
2020-03-05-170902,170902,0,0,13,0,0.2,335.99756905918866,3
2020-03-06-170902,170902,0,0,13,0,0.2,306.45998410148235,4
2020-03-07-170902,170902,0,0,6,0,0.6,306.6371177842011,5
2020-03-08-170902,170902,0,1,2,0,0.4,306.03414764204564,6
2020-03-09-170902,170902,2,0,27,2,0.8,306.8655080220228,0
2020-03-10-170902,170902,0,0,19,2,0.8,1058.7009462483993,1
2020-03-11-170902,170902,0,0,29,2,1.0,852.0793235739712,2
2020-03-12-170902,170902,2,0,16,4,2.4,583.2464646280765,3
2020-03-13-170902,170902,2,0,11,6,4.2,342.31626690686903,4
2020-03-14-170902,170902,1,0,73,7,1.8,290.2569858725878,5
2020-03-15-170902,170902,4,0,3,11,3.4,238.81228909115836,6
2020-03-16-170902,170902,6,0,10,17,11.8,89.18538953360792,0
2020-03-17-170902,170902,10,0,18,27,7.2,160.46032986249895,1
2020-03-18-170902,170902,11,0,7,38,14.8,201.49665022165715,2
2020-03-19-170902,170902,13,0,6,51,16.0,267.49746641139836,3
2020-03-20-170902,170902,13,0,8,64,14.4,313.3277619671545,4
2020-03-21-170902,170902,6,0,3,70,5.4,364.345704923605,5
2020-03-22-170902,170902,2,1,3,72,6.2,356.07127849269426,6
2020-03-23-170902,170902,27,0,9,99,29.0,327.85239708138397,0
2020-03-24-170902,170902,19,0,11,118,28.4,414.07976438489646,1
2020-03-25-170902,170902,29,0,9,147,18.4,449.69819681655855,2
2020-03-26-170902,170902,16,0,7,163,17.2,469.79341229562726,3
2020-03-27-170902,170902,11,0,12,174,20.6,546.5777225968193,4
2020-03-28-170902,170902,73,0,3,247,6.0,550.3145164499693,5
2020-03-29-170902,170902,3,0,2,250,5.6,568.4942084282932,6
2020-03-30-170902,170902,10,0,16,260,19.8,439.93712162240354,0
2020-03-31-170902,170902,18,0,12,278,14.6,419.86832058910164,1
2020-04-01-170902,170902,7,0,8,285,11.8,68.86891144066519,2
2020-04-02-170902,170902,6,0,6,291,10.6,356.8281784098254,3
2020-04-03-170902,170902,8,0,6,299,8.6,110.41854791682995,4
2020-04-04-170902,170902,3,0,2,302,3.6,163.97563635832375,5
2020-04-05-170902,170902,3,0,1,305,1.8,179.90325368226004,6
2020-04-06-170902,170902,9,0,8,314,13.4,192.15376640995663,0
2020-04-07-170902,170902,11,2,5,325,27.0,226.61935686473697,1
2020-04-08-170902,170902,9,5,5,334,13.0,278.9530200876907,2
2020-04-09-170902,170902,7,0,0,341,7.4,314.67931094383005,3
2020-04-10-170902,170902,12,0,9,353,6.2,65.04603360546446,4
2020-04-11-170902,170902,3,0,0,356,5.4,90.62592270369808,5
2020-04-12-170902,170902,2,0,1,358,4.2,122.5953696489882,6
2020-04-13-170902,170902,16,0,4,374,59.0,136.4658632773445,0
2020-04-14-170902,170902,12,0,1,386,17.8,288.67124475710614,1
2020-04-15-170902,170902,8,0,2,394,12.2,354.599534881882,2
2020-04-16-170902,170902,6,0,6,400,11.6,398.4837919798971,3
2020-04-17-170902,170902,6,0,1,406,7.6,399.0878649629137,4
2020-04-18-170902,170902,2,0,0,408,1.6,414.2807853724613,5
2020-04-19-170902,170902,1,0,0,409,0.8,386.18668408849516,6
2020-04-20-170902,170902,8,0,4,417,8.0,262.3693896922347,0
2020-04-21-170902,170902,5,0,2,422,6.6,230.5559603344291,1
2020-04-22-170902,170902,5,0,2,427,10.6,212.87663725039243,2
2020-04-23-170902,170902,0,0,8,427,1.0,207.80419550564227,3
2020-04-24-170902,170902,9,0,10,436,4.0,172.64607035690207,4
2020-04-25-170902,170902,0,0,0,436,0.4,188.35009767311044,5
2020-04-26-170902,170902,1,0,0,437,0.2,188.24349113039477,6
2020-04-27-170902,170902,4,3,7,441,6.6,145.919230105887,0
2020-04-28-170902,170902,1,0,3,442,4.2,135.92800603491872,1
2020-04-29-170902,170902,2,0,0,444,4.4,125.6685663594665,2
2020-04-30-170902,170902,6,0,0,450,7.0,163.7110969358746,3
2020-05-01-170902,170902,1,0,3,451,1.2,304.4083502268625,4
2020-05-02-170902,170902,0,0,0,451,0.2,106.18556938298596,5
2020-05-03-170902,170902,0,0,0,451,0.2,107.20743912697549,6
2020-05-04-170902,170902,4,0,6,455,9.6,80.4982732224029,0
2020-05-05-170902,170902,2,0,6,457,8.6,96.73835243690905,1
2020-05-06-170902,170902,2,0,7,459,7.0,114.61695582864004,2
2020-05-07-170902,170902,8,0,0,467,7.8,131.25372032782232,3
2020-05-08-170902,170902,10,0,7,477,9.4,146.03049541724238,4
2020-05-09-170902,170902,0,0,1,477,0.2,192.14007019436963,5
2020-05-10-170902,170902,0,2,0,477,0.2,313.32330806560367,6
2020-05-11-170902,170902,7,0,4,484,7.6,294.3351221570608,0
2020-05-12-170902,170902,3,0,2,487,6.8,312.8423250198076,1
2020-05-13-170902,170902,0,0,4,487,0.6,272.05630624132425,2
2020-05-14-170902,170902,0,0,5,487,6.0,185.453298644089,3
2020-05-15-170902,170902,3,0,4,490,7.4,151.6286163032722,4
2020-05-16-170902,170902,0,0,0,490,0.2,141.73615832457028,5
2020-05-17-170902,170902,0,1,0,490,0.4,140.9976464810596,6
2020-05-18-170902,170902,6,0,3,496,4.4,141.1299672308472,0
2020-05-19-170902,170902,6,0,5,502,3.6,132.12178042007798,1
2020-05-20-170902,170902,7,0,1,509,5.2,116.78044742479037,2
2020-05-21-170902,170902,0,0,1,509,2.4,114.48972397170644,3
2020-05-22-170902,170902,7,0,4,516,2.2,99.56758344114822,4
2020-05-23-170902,170902,1,0,0,517,0.4,114.87240674282309,5
2020-05-24-170902,170902,0,0,0,517,0.2,119.50998777718323,6
2020-05-25-170902,170902,4,0,0,521,6.4,93.51544935001837,0
2020-05-26-170902,170902,2,0,1,523,6.4,105.84172629910873,1
2020-05-27-170902,170902,4,0,0,527,2.6,135.77199314208985,2
2020-05-28-170902,170902,5,1,0,532,3.4,132.1872546857363,3
2020-05-29-170902,170902,4,2,0,536,4.6,135.77428688819836,4
2020-05-30-170902,170902,0,0,0,536,0.4,137.80936921416856,5
2020-05-31-170902,170902,0,0,0,536,0.2,141.4681659748572,6
2020-06-01-170902,170902,3,0,0,539,5.2,235.13339294922042,0
2020-06-02-170902,170902,5,1,1,544,3.4,73.23812614801166,1
2020-06-03-170902,170902,1,0,1,545,3.2,62.34142753885754,2
2020-06-04-170902,170902,1,0,1,546,1.8,66.24363432685102,3
2020-06-05-170902,170902,4,0,1,550,3.2,74.95460804973689,4
2020-06-06-170902,170902,0,0,0,550,0.0,82.71993509656161,5
2020-06-07-170902,170902,0,0,0,550,0.4,80.64747846529266,6
2020-06-08-170902,170902,0,0,1,550,2.2,80.04959549719669,0
2020-06-09-170902,170902,1,0,0,551,2.4,80.50749479472601,1
2020-06-10-170902,170902,0,0,0,551,2.4,266.73270853740627,2
2020-06-11-170902,170902,0,0,1,551,1.6,229.4885627867505,3
2020-06-12-170902,170902,0,0,0,551,1.8,200.51402960523458,4
2020-06-13-170902,170902,0,0,0,551,0.0,169.96880668657386,5
2020-06-14-170902,170902,0,0,0,551,0.4,130.18130135747188,6
2020-06-15-170902,170902,0,0,0,551,1.8,79.59452692961787,0
2020-06-16-170902,170902,1,0,2,552,2.6,91.25627095530949,1
2020-06-17-170902,170902,1,0,3,553,1.6,87.3002359507098,2
2020-06-18-170902,170902,1,0,0,554,1.8,83.29332807485467,3
2020-06-19-170902,170902,1,0,0,555,1.8,82.86947947896155,4
2020-06-20-170902,170902,0,0,0,555,0.0,104.44824733761898,5
2020-06-21-170902,170902,0,0,0,555,0.0,104.22042595892538,6
2020-06-22-170902,170902,1,0,2,556,2.6,89.12400463562597,0
2020-06-23-170902,170902,0,0,0,556,1.8,79.90619100103945,1
2020-06-24-170902,170902,0,0,0,556,1.6,82.15382414613346,2
2020-06-25-170902,170902,1,2,0,557,1.2,77.98534271136731,3
2020-06-26-170902,170902,0,1,1,557,1.8,75.51557672603067,4
2020-06-27-170902,170902,0,0,0,557,0.6,65.92302095074632,5
2020-06-28-170902,170902,0,0,0,557,0.2,67.40489959933217,6
2020-06-29-170902,170902,0,0,2,557,2.2,67.76762880849355,0
2020-06-30-170902,170902,2,0,0,559,0.6,76.05570594970956,1
2020-07-01-170902,170902,3,0,0,562,0.2,81.39696033845479,2
2020-07-02-170902,170902,0,0,0,562,1.2,32.56873585333675,3
2020-07-03-170902,170902,0,0,0,562,0.8,36.162814059556304,4
2020-07-04-170902,170902,0,0,0,562,0.6,51.84065991517588,5
2020-07-05-170902,170902,0,0,1,562,0.2,52.09488855907465,6
2020-07-06-170902,170902,2,0,0,564,0.6,46.602374487655275,0
2020-07-07-170902,170902,0,0,0,564,0.8,44.78338399884906,1
2020-07-08-170902,170902,0,0,1,564,1.0,45.60341606008552,2
2020-07-09-170902,170902,0,0,1,564,1.6,43.75165826829593,3
2020-07-10-170902,170902,1,0,2,565,0.2,75.63576445627469,4
2020-07-11-170902,170902,0,0,0,565,1.6,64.18261425228442,5
2020-07-12-170902,170902,0,0,0,565,1.0,53.15840919895946,6
2020-07-13-170902,170902,2,0,0,567,0.6,58.1249272265849,0
2020-07-14-170902,170902,0,0,2,567,0.6,62.377360393500645,1
2020-07-15-170902,170902,0,0,0,567,1.2,52.64867113078934,2
2020-07-16-170902,170902,0,0,0,567,0.2,42.985528356679275,3
2020-07-17-170902,170902,0,0,0,567,1.2,42.49180016169034,4
2020-07-18-170902,170902,0,0,0,567,0.8,43.84305216021599,5
2020-07-19-170902,170902,1,0,1,568,0.2,34.48703744118422,6
2020-07-20-170902,170902,0,0,0,568,0.6,31.179369875178928,0
2020-07-21-170902,170902,0,0,1,568,0.2,31.09216542508134,1
2020-07-22-170902,170902,1,0,0,569,0.8,31.821830815393653,2
2020-07-23-170902,170902,1,0,0,570,0.8,34.92186426040199,3
2020-07-24-170902,170902,2,0,0,572,0.6,33.39949314130838,4
2020-07-25-170902,170902,0,0,1,572,0.2,38.47222910448143,5
2020-07-26-170902,170902,0,1,1,572,0.4,37.37452348943787,6
2020-07-27-170902,170902,0,0,1,572,0.6,32.67992315476431,0
2020-07-28-170902,170902,2,0,2,574,1.2,35.488647531626704,1
2020-07-29-170902,170902,0,0,0,574,0.6,38.00906273930107,2
2020-07-30-170902,170902,0,0,1,574,2.0,36.01556553908925,3
2020-07-31-170902,170902,0,0,7,574,0.4,42.28011688065493,4
2020-08-01-170902,170902,0,0,1,574,2.0,34.62465431150918,5
2020-08-02-170902,170902,1,0,1,575,0.4,193.3438972682185,6
2020-08-03-170902,170902,0,0,3,575,1.6,419.06103210586747,0
2020-08-04-170902,170902,1,0,4,576,2.0,350.4316442934516,1
2020-08-05-170902,170902,0,0,9,576,1.4,295.06557300421935,2
2020-08-06-170902,170902,0,0,2,576,2.2,225.6485716726341,3
2020-08-07-170902,170902,0,0,0,576,1.4,147.34112292276788,4
2020-08-08-170902,170902,1,1,0,577,6.0,136.37953230191027,5
2020-08-09-170902,170902,1,0,0,578,2.0,154.2149782274943,6
2020-08-10-170902,170902,1,0,0,579,2.8,33.20808080588231,0
2020-08-11-170902,170902,2,0,7,581,2.4,51.56689795547597,1
2020-08-12-170902,170902,0,0,14,581,2.2,67.07392787839899,2
2020-08-13-170902,170902,1,0,9,582,4.0,79.9877024275134,3
2020-08-14-170902,170902,7,0,6,589,5.2,105.2725194610851,4
2020-08-15-170902,170902,1,0,2,590,1.0,126.77418809182922,5
2020-08-16-170902,170902,1,0,0,591,3.4,130.67283763259104,6
2020-08-17-170902,170902,3,0,14,594,2.0,146.0588762011319,0
2020-08-18-170902,170902,4,0,8,598,4.4,146.46676042451472,1
2020-08-19-170902,170902,9,0,3,607,3.8,158.72158361181468,2
2020-08-20-170902,170902,2,0,6,609,5.8,144.33249075642777,3
2020-08-21-170902,170902,0,0,13,609,2.8,171.03834275759814,4
2020-08-22-170902,170902,0,0,0,609,1.2,191.14807510654424,5
2020-08-23-170902,170902,0,0,3,609,1.4,194.49350860499874,6
2020-08-24-170902,170902,0,0,12,609,6.4,195.7209976585599,0
2020-08-25-170902,170902,7,0,3,616,13.8,220.24025297548363,1
2020-08-26-170902,170902,14,0,10,630,10.6,262.8072894362428,2
2020-08-27-170902,170902,9,0,6,639,11.4,319.5673693045033,3
2020-08-28-170902,170902,6,0,7,645,10.6,340.0320101631303,4
2020-08-29-170902,170902,2,0,0,647,1.6,396.9027925054363,5
2020-08-30-170902,170902,0,0,4,647,1.0,388.9986568448801,6
2020-08-31-170902,170902,14,0,8,661,12.6,350.7614524188156,0
2020-09-01-170902,170902,8,0,13,669,6.4,165.14343026647123,1
2020-09-02-170902,170902,3,0,8,672,9.8,486.47862636053526,2
2020-09-03-170902,170902,6,1,3,678,9.2,382.40166929427494,3
2020-09-04-170902,170902,13,0,10,691,11.0,394.8899991893676,4
2020-09-05-170902,170902,0,1,3,691,1.0,363.3027681388844,5
2020-09-06-170902,170902,3,0,1,694,2.2,342.52347795891217,6
2020-09-07-170902,170902,12,1,8,706,9.0,358.01404571205967,0
2020-09-08-170902,170902,3,0,12,709,1.8,382.44568091027554,1
2020-09-09-170902,170902,10,0,11,719,9.6,338.43177149419944,2
2020-09-10-170902,170902,6,1,7,725,8.0,141.6786337596052,3
2020-09-11-170902,170902,7,0,16,732,8.2,201.59938683294845,4
2020-09-12-170902,170902,0,0,0,732,1.0,278.80041432786516,5
2020-09-13-170902,170902,4,0,0,736,1.2,285.35923892499886,6
2020-09-14-170902,170902,8,0,13,744,12.6,294.15019238962424,0
2020-09-15-170902,170902,13,0,5,757,7.8,355.9235072531761,1
2020-09-16-170902,170902,8,0,6,765,14.8,438.87641396857157,2
2020-09-17-170902,170902,3,0,7,768,14.8,493.8482320134391,3
2020-09-18-170902,170902,10,0,12,778,6.4,538.7298222351103,4
2020-09-19-170902,170902,3,0,0,781,1.4,520.0453957072732,5
2020-09-20-170902,170902,1,0,0,782,1.8,573.4368078756186,6
2020-09-21-170902,170902,8,0,11,790,12.8,497.5409712747896,0
2020-09-22-170902,170902,12,1,10,802,11.0,498.0813774771481,1
2020-09-23-170902,170902,11,0,14,813,11.0,481.7281899940082,2
2020-09-24-170902,170902,7,0,1,820,7.2,422.9889235786703,3
2020-09-25-170902,170902,16,0,5,836,15.0,404.90376831733727,4
2020-09-26-170902,170902,0,0,0,836,4.4,488.80861172475363,5
2020-09-27-170902,170902,0,0,0,836,3.2,472.89195115886156,6
2020-09-28-170902,170902,13,0,0,849,7.8,466.3582137229265,0
2020-09-29-170902,170902,5,0,12,854,7.2,446.15946706296563,1
2020-09-30-170902,170902,6,0,8,860,7.2,428.7654003088978,2
2020-10-01-170902,170902,7,0,21,867,8.4,0.0,3
2020-10-02-170902,170902,12,0,11,879,9.4,493.9723556095722,4
2020-10-03-170902,170902,0,0,1,879,1.4,960.3277291954504,5
2020-10-04-170902,170902,0,0,1,879,1.2,970.0971743379735,6
2020-10-05-170902,170902,11,1,19,890,15.6,802.4056956924028,0
2020-10-06-170902,170902,10,2,13,900,10.6,753.256783737811,1
2020-10-07-170902,170902,14,1,18,914,11.2,650.8854887019112,2
2020-10-08-170902,170902,1,0,18,915,9.8,563.6031897281426,3
2020-10-09-170902,170902,5,1,12,920,9.4,648.2441154311513,4
2020-10-10-170902,170902,0,0,1,920,1.0,71.10109024501368,5
2020-10-11-170902,170902,0,0,1,920,0.4,105.79051437717526,6
2020-10-12-170902,170902,0,0,38,920,1.8,117.2982024564917,0
2020-10-13-170902,170902,12,0,17,932,12.0,128.91866253074613,1
2020-10-14-170902,170902,8,0,21,940,9.2,207.87083490978029,2
2020-10-15-170902,170902,21,0,58,961,11.6,291.9248691390233,3
2020-10-16-170902,170902,11,0,35,972,8.8,374.86043075954944,4
2020-10-17-170902,170902,1,0,3,973,2.8,392.38852358452755,5
2020-10-18-170902,170902,1,0,25,974,3.4,390.8689051062463,6
2020-10-19-170902,170902,19,0,3,993,16.8,404.58531894036406,0
2020-10-20-170902,170902,13,1,14,1006,14.0,523.8879044146329,1
2020-10-21-170902,170902,18,0,36,1024,20.8,548.6558903820287,2
2020-10-22-170902,170902,18,0,21,1042,22.4,596.7546332707701,3
2020-10-23-170902,170902,12,0,37,1054,35.0,675.6839961056047,4
2020-10-24-170902,170902,1,1,4,1055,1.4,838.5863759831113,5
2020-10-25-170902,170902,1,2,5,1056,3.0,840.592544392933,6
2020-10-26-170902,170902,38,1,12,1094,26.8,764.7523507630383,0
2020-10-27-170902,170902,17,2,27,1111,18.4,851.7747955776738,1
2020-10-28-170902,170902,21,0,29,1132,21.2,874.404607716536,2
2020-10-29-170902,170902,58,0,22,1190,36.6,921.2414077289708,3
2020-10-30-170902,170902,35,0,21,1225,33.0,785.1465332350064,4
2020-10-31-170902,170902,3,0,0,1228,5.2,932.335715453486,5
2020-11-01-170902,170902,25,1,0,1253,5.2,521.1016140791694,6
2020-11-02-170902,170902,3,0,0,1256,2.6,743.217439379483,0
2020-11-03-170902,170902,14,0,0,1270,25.8,606.0193373177649,1
2020-11-04-170902,170902,36,2,0,1306,22.2,741.1486598818565,2
2020-11-05-170902,170902,21,0,0,1327,31.8,792.4177315221041,3
2020-11-06-170902,170902,37,0,0,1364,28.4,899.2194469117021,4
2020-11-07-170902,170902,4,1,0,1368,3.2,993.6382356467298,5
2020-11-08-170902,170902,5,1,0,1373,3.2,931.9077431953837,6
2020-11-09-170902,170902,12,2,0,1385,26.6,940.9226206628709,0
2020-11-10-170902,170902,27,4,0,1412,18.6,502.3355243908852,1
2020-11-11-170902,170902,29,1,0,1441,21.4,605.154632395994,2
2020-11-12-170902,170902,22,1,0,1463,17.4,664.6398924665358,3
2020-11-13-170902,170902,21,1,0,1484,26.0,716.4394672794153,4
2020-03-01-170903,170903,0,0,2,0,0.0,0.0,6
2020-03-02-170903,170903,0,0,7,0,0.25,60.474401665195856,0
2020-03-03-170903,170903,0,0,2,0,0.0,334.5562689386125,1
2020-03-04-170903,170903,0,0,11,0,0.25,351.69682172095554,2
2020-03-05-170903,170903,0,0,9,0,0.0,375.2056029547111,3
2020-03-06-170903,170903,0,0,16,0,0.0,338.64476826580915,4
2020-03-07-170903,170903,0,0,4,0,0.5,345.4901039811025,5
2020-03-08-170903,170903,0,1,1,0,0.25,349.5897356756988,6
2020-03-09-170903,170903,2,0,20,2,0.25,347.99215915205815,0
2020-03-10-170903,170903,1,0,12,3,1.0,1166.449785429921,1
2020-03-11-170903,170903,0,0,11,3,0.75,941.9544426246536,2
2020-03-12-170903,170903,2,0,9,5,1.25,646.8573137187313,3
2020-03-13-170903,170903,3,0,12,8,2.75,400.42100772724893,4
2020-03-14-170903,170903,0,0,2,8,1.75,320.7513051096033,5
2020-03-15-170903,170903,2,0,5,10,2.75,252.45673611936087,6
2020-03-16-170903,170903,7,0,16,17,6.75,88.90984784889152,0
2020-03-17-170903,170903,2,0,6,19,8.25,161.8383206124233,1
2020-03-18-170903,170903,11,0,4,30,13.5,205.983243982459,2
2020-03-19-170903,170903,9,0,4,39,17.25,264.17804557649606,3
2020-03-20-170903,170903,16,0,3,55,15.25,312.6163072311716,4
2020-03-21-170903,170903,4,0,0,59,4.25,369.70167432300167,5
2020-03-22-170903,170903,1,0,1,60,6.0,361.060664114076,6
2020-03-23-170903,170903,20,0,6,80,35.75,339.8585257038044,0
2020-03-24-170903,170903,12,0,3,92,28.75,430.8110704090818,1
2020-03-25-170903,170903,11,0,8,103,23.0,474.31579991080076,2
2020-03-26-170903,170903,9,0,5,112,23.5,493.15700682362217,3
2020-03-27-170903,170903,12,0,3,124,22.25,567.4998404764805,4
2020-03-28-170903,170903,2,0,0,126,6.0,568.5461398699933,5
2020-03-29-170903,170903,5,0,1,131,3.75,582.6064198600465,6
2020-03-30-170903,170903,16,0,6,147,24.0,439.326859428848,0
2020-03-31-170903,170903,6,0,4,153,11.25,417.954469338738,1
2020-04-01-170903,170903,4,0,5,157,14.5,64.88637118504802,2
2020-04-02-170903,170903,4,0,7,161,15.0,324.86218018673526,3
2020-04-03-170903,170903,3,0,2,164,14.5,106.64672118239989,4
2020-04-04-170903,170903,0,0,2,164,4.25,162.91248259247976,5
2020-04-05-170903,170903,1,1,0,165,1.5,177.7457926582049,6
2020-04-06-170903,170903,6,1,4,171,18.0,186.26928937825426,0
2020-04-07-170903,170903,3,0,6,174,13.5,222.8921522865748,1
2020-04-08-170903,170903,8,3,3,182,11.0,272.35522654577437,2
2020-04-09-170903,170903,5,0,0,187,8.75,308.69354920950514,3
2020-04-10-170903,170903,3,1,2,190,8.0,64.01721717356511,4
2020-04-11-170903,170903,0,0,1,190,4.5,90.44289070080023,5
2020-04-12-170903,170903,1,0,0,191,4.0,110.71303785523621,6
2020-04-13-170903,170903,6,0,5,197,60.75,123.95824094882201,0
2020-04-14-170903,170903,4,0,9,201,11.0,259.8755374255795,1
2020-04-15-170903,170903,5,0,6,206,14.5,322.3481795104892,2
2020-04-16-170903,170903,7,0,4,213,8.25,370.4401491335815,3
2020-04-17-170903,170903,2,0,1,215,7.5,363.0420846089079,4
2020-04-18-170903,170903,2,0,0,217,1.75,377.7842027634971,5
2020-04-19-170903,170903,0,0,0,217,1.5,359.7617184285428,6
2020-04-20-170903,170903,4,0,6,221,7.0,257.173981029821,0
2020-04-21-170903,170903,6,0,10,227,7.0,228.1119075681918,1
2020-04-22-170903,170903,3,0,3,230,9.0,205.4280116865536,2
2020-04-23-170903,170903,0,0,5,230,0.25,205.54726937715577,3
2020-04-24-170903,170903,2,0,1,232,5.5,172.68660348545052,4
2020-04-25-170903,170903,1,0,0,233,0.5,190.0035785227459,5
2020-04-26-170903,170903,0,0,0,233,0.25,189.47514689123227,6
2020-04-27-170903,170903,5,0,6,238,7.5,142.5593449213365,0
2020-04-28-170903,170903,9,0,6,247,2.0,135.13342951184,1
2020-04-29-170903,170903,6,0,0,253,6.5,123.3002947309458,2
2020-04-30-170903,170903,4,0,1,257,8.25,167.97485395596482,3
2020-05-01-170903,170903,1,0,0,258,1.0,299.38386730162074,4
2020-05-02-170903,170903,0,0,0,258,0.0,94.74220412264148,5
2020-05-03-170903,170903,0,0,0,258,0.25,92.57785066316072,6
2020-05-04-170903,170903,6,0,1,264,7.5,65.8460814026115,0
2020-05-05-170903,170903,10,0,4,274,7.75,85.39450741375751,1
2020-05-06-170903,170903,3,0,2,277,6.75,102.60338506522073,2
2020-05-07-170903,170903,5,0,4,282,7.5,122.24831643656543,3
2020-05-08-170903,170903,1,0,3,283,8.0,140.56833790166894,4
2020-05-09-170903,170903,0,2,0,283,0.5,187.75647336204918,5
2020-05-10-170903,170903,0,0,1,283,0.25,308.22827163291936,6
2020-05-11-170903,170903,6,0,5,289,4.75,286.91639720070543,0
2020-05-12-170903,170903,6,0,6,295,4.75,310.5369377784394,1
2020-05-13-170903,170903,0,0,5,295,0.5,262.45503017783244,2
2020-05-14-170903,170903,1,0,2,296,4.0,176.23756439168517,3
2020-05-15-170903,170903,0,0,7,296,4.5,143.41903207837217,4
2020-05-16-170903,170903,0,0,0,296,0.25,129.3629886741246,5
2020-05-17-170903,170903,0,0,0,296,0.5,129.34342144187426,6
2020-05-18-170903,170903,1,0,2,297,4.25,129.68720173295287,0
2020-05-19-170903,170903,4,0,4,301,3.75,122.00869706662868,1
2020-05-20-170903,170903,2,0,4,303,5.5,111.89314143001394,2
2020-05-21-170903,170903,4,0,6,307,3.0,110.17371747776701,3
2020-05-22-170903,170903,3,0,3,310,3.25,98.31094130850838,4
2020-05-23-170903,170903,0,0,0,310,0.75,115.33380629604005,5
2020-05-24-170903,170903,1,0,0,311,0.0,121.66795756981429,6
2020-05-25-170903,170903,5,0,1,316,5.0,93.85266734604528,0
2020-05-26-170903,170903,6,0,2,322,2.5,106.61434511243966,1
2020-05-27-170903,170903,5,0,1,327,2.0,132.61966852032086,2
2020-05-28-170903,170903,2,0,0,329,3.25,127.01981767643699,3
2020-05-29-170903,170903,7,1,0,336,3.25,128.2977304222484,4
2020-05-30-170903,170903,0,0,0,336,0.0,125.91119646489804,5
2020-05-31-170903,170903,0,0,0,336,0.25,128.77520647499915,6
2020-06-01-170903,170903,2,0,4,338,4.25,242.36287293525615,0
2020-06-02-170903,170903,4,0,0,342,3.75,77.4131214171249,1
2020-06-03-170903,170903,4,0,0,346,4.0,68.0094609453565,2
2020-06-04-170903,170903,6,0,1,352,2.25,71.9820853490508,3
2020-06-05-170903,170903,3,0,0,355,3.25,81.14112785641058,4
2020-06-06-170903,170903,0,0,0,355,0.25,87.36323422969046,5
2020-06-07-170903,170903,0,0,0,355,0.25,85.81727260012553,6
2020-06-08-170903,170903,1,0,2,356,3.5,84.35972238428948,0
2020-06-09-170903,170903,2,0,0,358,2.5,85.9178427252628,1
2020-06-10-170903,170903,1,0,1,359,2.25,279.09129870810625,2
2020-06-11-170903,170903,0,0,1,359,1.25,237.61339761410872,3
2020-06-12-170903,170903,0,0,2,359,1.75,207.3932859313439,4
2020-06-13-170903,170903,0,2,0,359,0.25,173.16889196503837,5
2020-06-14-170903,170903,0,0,0,359,0.5,131.25606102666455,6
2020-06-15-170903,170903,4,0,2,363,1.5,76.19131227739643,0
2020-06-16-170903,170903,0,0,1,363,2.5,88.62698090622649,1
2020-06-17-170903,170903,0,1,0,363,1.75,86.03259967610569,2
2020-06-18-170903,170903,1,0,0,364,1.75,85.08966407059762,3
2020-06-19-170903,170903,0,0,0,364,2.5,86.49703176463032,4
2020-06-20-170903,170903,0,0,0,364,0.0,110.49671206088695,5
2020-06-21-170903,170903,0,0,0,364,0.0,110.52691632988052,6
2020-06-22-170903,170903,2,0,0,366,2.0,95.85287139667963,0
2020-06-23-170903,170903,0,1,1,366,2.5,81.59770189263304,1
2020-06-24-170903,170903,1,0,0,367,2.0,84.43031983515402,2
2020-06-25-170903,170903,1,0,0,368,2.0,78.92482911633155,3
2020-06-26-170903,170903,2,0,0,370,4.5,77.57164538256106,4
2020-06-27-170903,170903,0,0,0,370,0.25,70.14453277051962,5
2020-06-28-170903,170903,0,0,0,370,0.5,70.80842605183675,6
2020-06-29-170903,170903,2,0,0,372,1.75,72.01919781421843,0
2020-06-30-170903,170903,1,0,0,373,0.5,81.00919079305447,1
2020-07-01-170903,170903,0,0,0,373,0.75,87.10490583903542,2
2020-07-02-170903,170903,0,0,0,373,1.25,33.468222954162755,3
2020-07-03-170903,170903,0,0,0,373,1.0,43.74493827161413,4
2020-07-04-170903,170903,0,0,0,373,0.5,59.476813786930634,5
2020-07-05-170903,170903,0,0,0,373,0.25,59.54823375646098,6
2020-07-06-170903,170903,0,0,0,373,0.75,52.87241225784379,0
2020-07-07-170903,170903,1,0,0,374,0.5,53.02084366751998,1
2020-07-08-170903,170903,0,0,2,374,0.75,53.781915702972995,2
2020-07-09-170903,170903,0,0,0,374,2.5,51.416462760278584,3
2020-07-10-170903,170903,0,0,0,374,1.5,79.2540065464115,4
2020-07-11-170903,170903,0,0,0,374,0.25,69.85718334956204,5
2020-07-12-170903,170903,0,1,0,374,0.0,56.4099498158974,6
2020-07-13-170903,170903,0,0,0,374,0.75,60.18689905641972,0
2020-07-14-170903,170903,0,0,0,374,0.5,64.06307471470987,1
2020-07-15-170903,170903,0,0,0,374,1.25,53.90516044158561,2
2020-07-16-170903,170903,0,0,0,374,1.0,44.11537530137393,3
2020-07-17-170903,170903,0,0,0,374,0.25,44.91012093329374,4
2020-07-18-170903,170903,0,0,0,374,0.75,42.68454113271165,5
2020-07-19-170903,170903,0,0,0,374,0.0,34.340763974026366,6
2020-07-20-170903,170903,0,0,0,374,0.25,32.08291808562413,0
2020-07-21-170903,170903,0,0,1,374,1.0,32.734764068273876,1
2020-07-22-170903,170903,2,0,4,376,1.5,33.5823818239507,2
2020-07-23-170903,170903,0,0,0,376,1.25,36.917050789356665,3
2020-07-24-170903,170903,0,0,5,376,2.25,38.17947355238474,4
2020-07-25-170903,170903,0,0,0,376,0.25,46.53355190205551,5
2020-07-26-170903,170903,0,0,0,376,0.5,44.75451430215179,6
2020-07-27-170903,170903,0,0,1,376,1.0,40.08885792539682,0
2020-07-28-170903,170903,0,0,0,376,0.5,43.42511930933497,1
2020-07-29-170903,170903,0,0,3,376,0.75,44.74869748948846,2
2020-07-30-170903,170903,0,0,0,376,1.75,41.36612120105951,3
2020-07-31-170903,170903,0,0,7,376,0.75,46.1883205729441,4
2020-08-01-170903,170903,0,0,3,376,1.0,41.32613575097842,5
2020-08-02-170903,170903,0,0,2,376,0.0,196.57527997776236,6
2020-08-03-170903,170903,0,0,4,376,1.75,453.7767462235314,0
2020-08-04-170903,170903,1,0,0,377,2.5,383.99526099403215,1
2020-08-05-170903,170903,4,0,3,381,2.25,328.5536633703592,2
2020-08-06-170903,170903,0,0,4,381,2.5,251.12183063270572,3
2020-08-07-170903,170903,5,0,5,386,1.75,168.50134511872673,4
2020-08-08-170903,170903,0,0,0,386,3.0,152.15299515569075,5
2020-08-09-170903,170903,0,0,1,386,0.75,168.08655177642015,6
2020-08-10-170903,170903,1,2,1,387,2.25,37.93960164549215,0
2020-08-11-170903,170903,0,0,4,387,1.75,57.4715040278929,1
2020-08-12-170903,170903,3,0,3,390,1.75,71.61105798239436,2
2020-08-13-170903,170903,0,0,7,390,4.25,86.4996780558206,3
2020-08-14-170903,170903,7,0,5,397,3.75,111.41399844541124,4
2020-08-15-170903,170903,3,1,5,400,2.5,132.8379293964283,5
2020-08-16-170903,170903,2,0,0,402,2.25,134.61627403278652,6
2020-08-17-170903,170903,4,0,6,406,4.5,154.18381595762932,0
2020-08-18-170903,170903,0,0,7,406,4.0,154.15915702394724,1
2020-08-19-170903,170903,3,0,2,409,3.0,165.82611763796928,2
2020-08-20-170903,170903,4,0,2,413,6.25,149.63200476255656,3
2020-08-21-170903,170903,5,0,3,418,3.0,180.53797960481518,4
2020-08-22-170903,170903,0,0,3,418,2.0,204.5947804459188,5
2020-08-23-170903,170903,1,1,0,419,2.0,208.47805768395799,6
2020-08-24-170903,170903,1,0,7,420,5.5,211.75778914294224,0
2020-08-25-170903,170903,4,0,0,424,12.0,245.71239132379364,1
2020-08-26-170903,170903,3,0,7,427,9.0,286.29495021982603,2
2020-08-27-170903,170903,7,0,3,434,14.0,346.4511044105502,3
2020-08-28-170903,170903,5,0,5,439,12.5,371.4985267152775,4
2020-08-29-170903,170903,5,0,1,444,3.0,426.61275622439587,5
2020-08-30-170903,170903,0,0,0,444,3.25,418.63283569844043,6
2020-08-31-170903,170903,6,0,5,450,11.25,383.6527677803145,0
2020-09-01-170903,170903,7,0,2,457,5.5,174.79437072721674,1
2020-09-02-170903,170903,2,0,3,459,9.0,519.0167709615132,2
2020-09-03-170903,170903,2,0,3,461,8.0,406.269113012012,3
2020-09-04-170903,170903,3,0,2,464,9.75,422.21902559802834,4
2020-09-05-170903,170903,3,0,1,467,2.5,390.1867602274051,5
2020-09-06-170903,170903,0,0,0,467,2.25,372.6759131721502,6
2020-09-07-170903,170903,7,0,3,474,14.5,393.10910131779724,0
2020-09-08-170903,170903,0,0,1,474,1.25,433.1756564312467,1
2020-09-09-170903,170903,7,0,4,481,11.0,376.900464749579,2
2020-09-10-170903,170903,3,0,0,484,8.75,153.21801189648966,3
2020-09-11-170903,170903,5,0,4,489,14.0,225.05174698764333,4
2020-09-12-170903,170903,1,0,3,490,2.5,307.5324081947222,5
2020-09-13-170903,170903,0,0,0,490,1.75,319.7318933394321,6
2020-09-14-170903,170903,5,0,10,495,15.25,329.72168099135183,0
2020-09-15-170903,170903,2,1,3,497,8.25,411.3735649277851,1
2020-09-16-170903,170903,3,0,5,500,16.5,507.22561639346657,2
2020-09-17-170903,170903,3,0,8,503,14.5,567.5546756512447,3
2020-09-18-170903,170903,2,1,4,505,7.0,593.8656819383706,4
2020-09-19-170903,170903,1,0,0,506,1.5,566.4150409195797,5
2020-09-20-170903,170903,0,1,0,506,1.0,614.6850911364143,6
2020-09-21-170903,170903,3,0,6,509,12.5,518.121492685327,0
2020-09-22-170903,170903,1,3,1,510,6.0,512.9747399959476,1
2020-09-23-170903,170903,4,1,6,514,11.5,486.96338397816896,2
2020-09-24-170903,170903,0,0,2,514,10.25,437.46916478695744,3
2020-09-25-170903,170903,4,0,2,518,16.5,426.6235774539673,4
2020-09-26-170903,170903,3,0,1,521,2.25,519.9836478308672,5
2020-09-27-170903,170903,0,0,0,521,3.5,508.0097948066222,6
2020-09-28-170903,170903,10,0,1,531,9.25,506.53724732490105,0
2020-09-29-170903,170903,3,0,3,534,7.75,484.43295457523993,1
2020-09-30-170903,170903,5,0,6,539,8.0,478.29455209172215,2
2020-10-01-170903,170903,8,0,2,547,6.0,0.0,3
2020-10-02-170903,170903,4,0,6,551,8.5,530.1602989135547,4
2020-10-03-170903,170903,0,1,0,551,1.25,1045.7108927854324,5
2020-10-04-170903,170903,0,1,1,551,5.0,1082.618734588949,6
2020-10-05-170903,170903,6,0,10,557,12.75,904.8280203153969,0
2020-10-06-170903,170903,1,0,5,558,12.75,849.6111693866602,1
2020-10-07-170903,170903,6,0,9,564,9.5,740.1132994335126,2
2020-10-08-170903,170903,2,1,8,566,7.25,647.0800518673932,3
2020-10-09-170903,170903,2,1,19,568,11.0,733.0478437415755,4
2020-10-10-170903,170903,1,0,2,569,2.25,72.67916759508513,5
2020-10-11-170903,170903,0,0,1,569,1.0,117.57945246451449,6
2020-10-12-170903,170903,1,0,20,570,2.25,133.17446188484286,0
2020-10-13-170903,170903,3,0,10,573,11.25,145.6565434817599,1
2020-10-14-170903,170903,6,0,14,579,9.75,226.35295979700948,2
2020-10-15-170903,170903,2,0,16,581,12.5,314.93607654460527,3
2020-10-16-170903,170903,6,0,14,587,12.5,398.32844948132583,4
2020-10-17-170903,170903,0,0,1,587,3.5,421.87281304833687,5
2020-10-18-170903,170903,1,0,6,588,1.75,419.19163091045857,6
2020-10-19-170903,170903,10,0,0,598,15.75,429.117404091507,0
2020-10-20-170903,170903,5,1,15,603,15.0,557.0420825302346,1
2020-10-21-170903,170903,9,0,14,612,19.0,585.1562390738027,2
2020-10-22-170903,170903,8,0,18,620,20.75,636.5676981994434,3
2020-10-23-170903,170903,19,0,17,639,28.0,730.8101948958123,4
2020-10-24-170903,170903,2,0,2,641,2.5,887.0660533501218,5
2020-10-25-170903,170903,1,0,3,642,2.25,889.0017590735126,6
2020-10-26-170903,170903,20,0,12,662,26.5,819.493393192514,0
2020-10-27-170903,170903,10,0,10,672,13.75,913.0489928719253,1
2020-10-28-170903,170903,14,0,6,686,25.0,944.3081396864757,2
2020-10-29-170903,170903,16,0,13,702,35.75,1002.0507426132611,3
2020-10-30-170903,170903,14,1,11,716,40.5,865.7412736469728,4
2020-10-31-170903,170903,1,0,0,717,8.25,1030.791157872227,5
2020-11-01-170903,170903,6,0,0,723,2.0,580.8877383679,6
2020-11-02-170903,170903,0,1,0,723,4.0,827.1476700414441,0
2020-11-03-170903,170903,15,0,0,738,27.75,661.8383090997427,1
2020-11-04-170903,170903,14,0,0,752,23.75,822.7736916582567,2
2020-11-05-170903,170903,18,2,0,770,30.25,888.1652594901808,3
2020-11-06-170903,170903,17,0,0,787,23.25,1006.2378792904998,4
2020-11-07-170903,170903,2,2,0,789,5.75,1098.0563198840875,5
2020-11-08-170903,170903,3,0,0,792,3.5,1046.064768749195,6
2020-11-09-170903,170903,12,0,0,804,25.25,1057.7988483028116,0
2020-11-10-170903,170903,10,0,0,814,21.25,545.7535104516685,1
2020-11-11-170903,170903,6,0,0,820,24.0,652.6458648524588,2
2020-11-12-170903,170903,13,0,0,833,18.75,726.6240743585204,3
2020-11-13-170903,170903,11,4,0,844,23.5,784.1077735911899,4
2020-03-01-170906,170906,0,0,0,0,0.0,0.0,6
2020-03-02-170906,170906,0,0,5,0,0.2,31.267066736050804,0
2020-03-03-170906,170906,0,0,5,0,0.0,163.3175666102042,1
2020-03-04-170906,170906,0,0,16,0,0.2,177.21948527491043,2
2020-03-05-170906,170906,0,0,10,0,0.0,191.83271884773418,3
2020-03-06-170906,170906,0,0,7,0,0.0,175.19207266595086,4
2020-03-07-170906,170906,2,0,6,2,0.0,174.5088211312215,5
2020-03-08-170906,170906,1,0,5,3,0.2,174.03881825543226,6
2020-03-09-170906,170906,0,0,26,3,1.0,174.1883205237587,0
2020-03-10-170906,170906,1,0,21,4,0.8,597.2860408845218,1
2020-03-11-170906,170906,0,0,19,4,0.8,481.16752072076963,2
2020-03-12-170906,170906,2,0,17,6,1.6,326.86397212957195,3
2020-03-13-170906,170906,2,0,18,8,3.0,188.68794074303798,4
2020-03-14-170906,170906,1,0,6,9,1.6,162.80555364818454,5
2020-03-15-170906,170906,0,0,2,9,4.0,134.6334502703603,6
2020-03-16-170906,170906,5,1,10,14,8.8,51.12007685451353,0
2020-03-17-170906,170906,5,0,8,19,8.6,91.44371064823835,1
2020-03-18-170906,170906,16,0,13,35,12.2,115.40008402273381,2
2020-03-19-170906,170906,10,0,8,45,17.4,153.12434866899474,3
2020-03-20-170906,170906,7,0,8,52,16.8,178.4802397608999,4
2020-03-21-170906,170906,6,1,4,58,4.4,207.17137245995988,5
2020-03-22-170906,170906,5,0,1,63,3.4,202.02806231435898,6
2020-03-23-170906,170906,26,0,10,89,26.8,186.13289901855455,0
2020-03-24-170906,170906,21,0,9,110,20.6,234.13339315011706,1
2020-03-25-170906,170906,19,0,7,129,19.8,254.64720255801706,2
2020-03-26-170906,170906,17,0,4,146,17.6,267.0588659356716,3
2020-03-27-170906,170906,18,0,9,164,19.0,310.5649843812587,4
2020-03-28-170906,170906,6,0,1,170,17.8,314.1717215626942,5
2020-03-29-170906,170906,2,0,1,172,5.6,326.2028115588066,6
2020-03-30-170906,170906,10,0,13,182,20.4,254.05538341807093,0
2020-03-31-170906,170906,8,0,11,190,13.2,242.7845815537511,1
2020-04-01-170906,170906,13,0,8,203,11.6,41.040040963293244,2
2020-04-02-170906,170906,8,0,9,211,11.2,207.69399821244093,3
2020-04-03-170906,170906,8,0,6,219,10.6,65.0624654084924,4
2020-04-04-170906,170906,4,0,2,223,3.8,96.98598404069968,5
2020-04-05-170906,170906,1,0,3,224,1.8,107.04077372713644,6
2020-04-06-170906,170906,10,1,3,234,12.2,114.3608231932269,0
2020-04-07-170906,170906,9,0,3,243,10.0,134.29268854497278,1
2020-04-08-170906,170906,7,0,15,250,11.0,163.23593070412414,2
2020-04-09-170906,170906,4,0,0,254,7.0,184.814749827475,3
2020-04-10-170906,170906,9,1,3,263,7.4,39.208008281988484,4
2020-04-11-170906,170906,1,0,1,264,2.8,55.105069589561744,5
2020-04-12-170906,170906,1,0,0,265,3.2,74.71933850123935,6
2020-04-13-170906,170906,13,0,8,278,44.6,82.65625472582863,0
2020-04-14-170906,170906,11,0,3,289,10.4,167.62359955745177,1
2020-04-15-170906,170906,8,0,5,297,11.6,206.83722275207384,2
2020-04-16-170906,170906,9,0,5,306,8.8,233.00346583372038,3
2020-04-17-170906,170906,6,0,2,312,6.2,232.9316678256466,4
2020-04-18-170906,170906,2,0,0,314,1.6,240.33259927956175,5
2020-04-19-170906,170906,3,0,0,317,0.6,222.69370284048685,6
2020-04-20-170906,170906,3,0,5,320,7.2,154.38344311732874,0
2020-04-21-170906,170906,3,0,11,323,7.4,134.3837504254705,1
2020-04-22-170906,170906,15,0,8,338,7.6,122.95884202133072,2
2020-04-23-170906,170906,0,0,9,338,0.4,119.97291257761557,3
2020-04-24-170906,170906,3,0,5,341,5.0,100.2929214011451,4
2020-04-25-170906,170906,1,0,0,342,0.2,109.57053773187829,5
2020-04-26-170906,170906,0,0,0,342,0.4,109.31018049455047,6
2020-04-27-170906,170906,8,2,2,350,5.4,85.03374911780662,0
2020-04-28-170906,170906,3,0,5,353,4.6,79.37693271993689,1
2020-04-29-170906,170906,5,0,1,358,5.0,73.99872439164072,2
2020-04-30-170906,170906,5,0,4,363,6.6,94.89761218572649,3
2020-05-01-170906,170906,2,0,6,365,0.8,174.1382401283288,4
2020-05-02-170906,170906,0,0,0,365,0.0,62.26385336748199,5
2020-05-03-170906,170906,0,0,0,365,0.2,63.67917730664985,6
2020-05-04-170906,170906,5,0,1,370,7.4,47.91886182380719,0
2020-05-05-170906,170906,11,1,5,381,5.4,56.921666050560404,1
2020-05-06-170906,170906,8,0,7,389,5.2,66.52806661936235,2
2020-05-07-170906,170906,9,0,4,398,6.6,75.26971818172984,3
2020-05-08-170906,170906,5,0,3,403,7.8,84.50223411137051,4
2020-05-09-170906,170906,0,0,0,403,0.4,110.89378091961294,5
2020-05-10-170906,170906,0,0,0,403,0.2,178.01501690033302,6
2020-05-11-170906,170906,2,0,6,405,6.4,166.69104154225295,0
2020-05-12-170906,170906,5,0,3,410,4.8,178.20269047646585,1
2020-05-13-170906,170906,1,0,1,411,0.2,156.05254904203304,2
2020-05-14-170906,170906,4,0,5,415,3.4,107.54164636000397,3
2020-05-15-170906,170906,6,2,7,421,4.0,88.07258050085537,4
2020-05-16-170906,170906,0,0,0,421,0.2,84.37766897163785,5
2020-05-17-170906,170906,0,0,0,421,0.4,83.56916761099795,6
2020-05-18-170906,170906,1,0,8,422,4.2,83.6632644704463,0
2020-05-19-170906,170906,5,0,6,427,4.0,77.563652794591,1
2020-05-20-170906,170906,7,0,7,434,5.6,68.24380936219691,2
2020-05-21-170906,170906,4,0,3,438,2.2,66.7653921601465,3
2020-05-22-170906,170906,3,0,3,441,3.4,56.83816705663633,4
2020-05-23-170906,170906,0,0,0,441,0.4,66.16049812838472,5
2020-05-24-170906,170906,0,0,1,441,0.2,68.66073084637378,6
2020-05-25-170906,170906,6,0,6,447,5.2,53.95346124214262,0
2020-05-26-170906,170906,3,0,2,450,4.2,61.51147788182352,1
2020-05-27-170906,170906,1,1,4,451,3.4,79.766019114036,2
2020-05-28-170906,170906,5,0,1,456,3.4,77.6217471095116,3
2020-05-29-170906,170906,7,2,0,463,3.4,80.60149304517445,4
2020-05-30-170906,170906,0,0,0,463,0.0,81.40114115731586,5
2020-05-31-170906,170906,0,0,1,463,0.2,83.4047778350367,6
2020-06-01-170906,170906,8,0,3,471,1.8,134.77372452359157,0
2020-06-02-170906,170906,6,0,0,477,3.0,41.54771295547174,1
2020-06-03-170906,170906,7,0,2,484,2.2,35.134983106656435,2
2020-06-04-170906,170906,3,0,1,487,2.0,37.25535285580759,3
2020-06-05-170906,170906,3,0,5,490,3.8,42.30176395808299,4
2020-06-06-170906,170906,0,0,0,490,0.0,47.45807100435826,5
2020-06-07-170906,170906,1,0,0,491,0.0,46.0290417352451,6
2020-06-08-170906,170906,6,0,4,497,1.4,45.73196226459298,0
2020-06-09-170906,170906,2,0,1,499,1.8,45.95690723331655,1
2020-06-10-170906,170906,4,0,4,503,1.4,151.99358745014047,2
2020-06-11-170906,170906,1,0,3,504,1.0,130.85388289594047,3
2020-06-12-170906,170906,0,0,4,504,1.6,114.74082121825937,4
2020-06-13-170906,170906,0,0,1,504,0.2,97.70148476428072,5
2020-06-14-170906,170906,1,0,0,505,0.2,74.64480639839473,6
2020-06-15-170906,170906,3,0,1,508,1.4,45.67335757626722,0
2020-06-16-170906,170906,0,0,0,508,1.2,52.48806700655064,1
2020-06-17-170906,170906,2,0,0,510,1.4,50.57046532674275,2
2020-06-18-170906,170906,1,0,2,511,1.4,47.56691477472692,3
2020-06-19-170906,170906,5,0,1,516,1.0,47.01667493984458,4
2020-06-20-170906,170906,0,0,2,516,0.0,59.89380161217644,5
2020-06-21-170906,170906,0,0,0,516,0.0,59.79444670228195,6
2020-06-22-170906,170906,4,0,1,520,1.6,51.09186133645326,0
2020-06-23-170906,170906,1,0,0,521,1.6,46.53307826247429,1
2020-06-24-170906,170906,4,0,1,525,1.2,47.681563489659084,2
2020-06-25-170906,170906,3,0,4,528,0.6,45.308664850319346,3
2020-06-26-170906,170906,4,0,0,532,1.6,43.574655576226306,4
2020-06-27-170906,170906,1,1,0,533,0.0,37.759482177353064,5
2020-06-28-170906,170906,0,0,0,533,0.2,38.82023846274856,6
2020-06-29-170906,170906,1,0,2,534,1.6,38.94431871510989,0
2020-06-30-170906,170906,0,0,0,534,1.0,43.126001620999276,1
2020-07-01-170906,170906,0,0,1,534,1.0,46.89269900634008,2
2020-07-02-170906,170906,2,0,0,536,0.6,19.374287321211767,3
2020-07-03-170906,170906,1,0,0,537,0.2,20.364186219616514,4
2020-07-04-170906,170906,2,0,3,539,0.0,29.7834577812787,5
2020-07-05-170906,170906,0,0,0,539,0.0,29.967376079726755,6
2020-07-06-170906,170906,1,0,0,540,0.4,27.06759117968341,0
2020-07-07-170906,170906,0,0,0,540,0.4,25.426762161739077,1
2020-07-08-170906,170906,1,0,0,541,0.4,25.713965003948417,2
2020-07-09-170906,170906,4,0,1,545,0.8,24.82412725835877,3
2020-07-10-170906,170906,0,1,3,545,1.0,43.5769690733319,4
2020-07-11-170906,170906,0,0,0,545,1.8,36.857286515559736,5
2020-07-12-170906,170906,0,0,0,545,1.0,30.98809996357819,6
2020-07-13-170906,170906,2,0,2,547,0.4,34.3968564259202,0
2020-07-14-170906,170906,0,0,1,547,0.4,36.821903442426866,1
2020-07-15-170906,170906,1,0,1,548,0.8,31.61137307562108,2
2020-07-16-170906,170906,0,0,0,548,0.2,26.138582258028535,3
2020-07-17-170906,170906,0,0,0,548,0.6,25.914370200990582,4
2020-07-18-170906,170906,3,0,3,551,0.2,26.940602402560124,5
2020-07-19-170906,170906,0,0,0,551,0.4,20.789638056934564,6
2020-07-20-170906,170906,0,0,1,551,0.2,18.2964858405594,0
2020-07-21-170906,170906,0,0,4,551,0.2,18.127243955834416,1
2020-07-22-170906,170906,0,0,4,551,1.2,18.147254795782747,2
2020-07-23-170906,170906,1,0,6,552,0.8,19.97493552517992,3
2020-07-24-170906,170906,3,0,2,555,0.8,18.772106363828186,4
2020-07-25-170906,170906,0,0,6,555,0.2,21.360524530501458,5
2020-07-26-170906,170906,0,0,2,555,0.4,20.623846764497237,6
2020-07-27-170906,170906,2,0,4,557,0.0,18.0976358119287,0
2020-07-28-170906,170906,1,0,3,558,0.6,19.562363205517673,1
2020-07-29-170906,170906,1,0,6,559,0.4,21.642562334637496,2
2020-07-30-170906,170906,0,0,5,559,2.0,20.58489553633035,3
2020-07-31-170906,170906,0,0,8,559,0.8,24.632773534617346,4
2020-08-01-170906,170906,3,0,4,562,1.6,19.292531293415795,5
2020-08-02-170906,170906,0,0,2,562,0.6,115.69293380314735,6
2020-08-03-170906,170906,1,0,2,563,1.2,247.61004568705738,0
2020-08-04-170906,170906,4,0,4,567,1.6,206.02627403377977,1
2020-08-05-170906,170906,4,0,1,571,1.0,172.04606803732094,2
2020-08-06-170906,170906,6,0,3,577,1.4,131.49036190033905,3
2020-08-07-170906,170906,2,0,3,579,2.6,85.08347754656276,4
2020-08-08-170906,170906,6,0,1,585,4.0,79.40112108838568,5
2020-08-09-170906,170906,2,0,1,587,1.4,91.09559925483254,6
2020-08-10-170906,170906,4,0,6,591,2.4,19.478238106340363,0
2020-08-11-170906,170906,3,0,14,594,1.2,30.395613460479865,1
2020-08-12-170906,170906,6,0,11,600,1.4,39.52226483964444,2
2020-08-13-170906,170906,5,0,18,605,3.2,46.60888715631812,3
2020-08-14-170906,170906,8,0,5,613,5.8,62.24300924132184,4
2020-08-15-170906,170906,4,1,1,617,0.8,75.12254095492918,5
2020-08-16-170906,170906,2,0,3,619,2.8,77.58262283486667,6
2020-08-17-170906,170906,2,0,15,621,4.6,86.23428586174795,0
2020-08-18-170906,170906,4,0,7,625,3.2,86.34079140013208,1
2020-08-19-170906,170906,1,0,3,626,5.4,93.6017176975497,2
2020-08-20-170906,170906,3,0,9,629,5.2,86.01402104353437,3
2020-08-21-170906,170906,3,0,7,632,2.6,101.00628989368998,4
2020-08-22-170906,170906,1,0,0,633,1.0,112.51670808337215,5
2020-08-23-170906,170906,1,0,0,634,1.2,113.59824410875734,6
2020-08-24-170906,170906,6,0,4,640,4.0,113.63627137677861,0
2020-08-25-170906,170906,14,0,2,654,10.0,128.67060801586504,1
2020-08-26-170906,170906,11,0,8,665,9.8,154.31236214059797,2
2020-08-27-170906,170906,18,0,9,683,10.2,189.0141908678495,3
2020-08-28-170906,170906,5,0,8,688,11.2,200.5561271939823,4
2020-08-29-170906,170906,1,0,1,689,2.8,234.82539010958453,5
2020-08-30-170906,170906,3,0,1,692,0.4,230.14530000663882,6
2020-08-31-170906,170906,15,0,7,707,12.6,206.08681857085207,0
2020-09-01-170906,170906,7,1,5,714,7.0,98.9867943954476,1
2020-09-02-170906,170906,3,0,17,717,10.0,278.28874949907333,2
2020-09-03-170906,170906,9,0,18,726,9.2,222.6234035444801,3
2020-09-04-170906,170906,7,0,5,733,9.8,232.10359951136314,4
2020-09-05-170906,170906,0,0,0,733,1.6,212.08539815514564,5
2020-09-06-170906,170906,0,0,0,733,2.2,197.7627459378375,6
2020-09-07-170906,170906,4,0,16,737,11.2,206.8739859629812,0
2020-09-08-170906,170906,2,0,8,739,1.0,219.33052830274744,1
2020-09-09-170906,170906,8,0,10,747,9.8,194.18133185267527,2
2020-09-10-170906,170906,9,0,6,756,7.6,84.31632285216605,3
2020-09-11-170906,170906,8,0,20,764,10.6,118.26185175430567,4
2020-09-12-170906,170906,1,0,1,765,1.0,163.2343326805306,5
2020-09-13-170906,170906,1,1,1,766,1.6,166.78116255193748,6
2020-09-14-170906,170906,7,1,8,773,12.4,171.87441988072283,0
2020-09-15-170906,170906,5,0,5,778,8.0,205.02827745475287,1
2020-09-16-170906,170906,17,0,6,795,13.2,253.366928382445,2
2020-09-17-170906,170906,18,0,6,813,11.4,283.2902434675592,3
2020-09-18-170906,170906,5,0,10,818,7.4,307.764387616494,4
2020-09-19-170906,170906,0,0,0,818,2.2,296.3875904273322,5
2020-09-20-170906,170906,0,1,2,818,2.2,327.1357881116468,6
2020-09-21-170906,170906,16,0,12,834,10.4,285.75333534026385,0
2020-09-22-170906,170906,8,0,8,842,11.0,285.8691720895272,1
2020-09-23-170906,170906,10,0,11,852,10.2,278.8172619105811,2
2020-09-24-170906,170906,6,0,5,858,8.0,246.3883833376346,3
2020-09-25-170906,170906,20,0,9,878,15.0,235.64537671365673,4
2020-09-26-170906,170906,1,0,1,879,4.8,285.5708066465021,5
2020-09-27-170906,170906,1,0,0,880,2.6,277.3990883458344,6
2020-09-28-170906,170906,8,1,4,888,11.2,271.86243694766915,0
2020-09-29-170906,170906,5,0,7,893,6.8,259.2115273896378,1
2020-09-30-170906,170906,6,0,9,899,8.6,247.98312880134677,2
2020-10-01-170906,170906,6,0,16,905,9.4,0.0,3
2020-10-02-170906,170906,10,1,13,915,10.8,283.81156020075366,4
2020-10-03-170906,170906,0,0,2,915,1.2,553.8917139250955,5
2020-10-04-170906,170906,2,0,3,917,3.6,556.8858300797165,6
2020-10-05-170906,170906,12,0,26,929,13.6,459.6560213742107,0
2020-10-06-170906,170906,8,0,12,937,11.6,431.99866253144626,1
2020-10-07-170906,170906,11,0,14,948,9.2,373.8955932988508,2
2020-10-08-170906,170906,5,1,20,953,6.2,322.424348429785,3
2020-10-09-170906,170906,9,0,26,962,6.4,368.0299585923797,4
2020-10-10-170906,170906,1,0,0,963,0.6,41.336933646213595,5
2020-10-11-170906,170906,0,0,2,963,0.2,59.41939821080466,6
2020-10-12-170906,170906,4,0,27,967,0.4,65.59211232000767,0
2020-10-13-170906,170906,7,0,10,974,9.0,72.0440588914312,1
2020-10-14-170906,170906,9,0,16,983,8.0,117.79337681160034,2
2020-10-15-170906,170906,16,0,52,999,9.6,165.29857578673983,3
2020-10-16-170906,170906,13,0,49,1012,10.0,214.53361469882083,4
2020-10-17-170906,170906,2,0,10,1014,2.2,223.22974940017377,5
2020-10-18-170906,170906,3,0,1,1017,2.0,223.62965302182647,6
2020-10-19-170906,170906,26,0,4,1043,13.8,231.94221335090364,0
2020-10-20-170906,170906,12,0,30,1055,14.0,303.79451298426727,1
2020-10-21-170906,170906,14,0,21,1069,16.6,318.8767448528891,2
2020-10-22-170906,170906,20,0,20,1089,18.6,344.70518660201697,3
2020-10-23-170906,170906,26,1,22,1115,23.2,392.6649471500724,4
2020-10-24-170906,170906,0,0,1,1115,1.4,489.8034611312988,5
2020-10-25-170906,170906,2,1,1,1117,1.8,489.1620368876081,6
2020-10-26-170906,170906,27,0,18,1144,28.6,443.571062358147,0
2020-10-27-170906,170906,10,2,24,1154,15.2,493.57123695111187,1
2020-10-28-170906,170906,16,3,29,1170,20.0,505.8746985199595,2
2020-10-29-170906,170906,52,1,10,1222,35.2,532.3218468971922,3
2020-10-30-170906,170906,49,2,21,1271,27.2,453.4377187974143,4
2020-10-31-170906,170906,10,0,0,1281,2.6,538.5301021087332,5
2020-11-01-170906,170906,1,1,0,1282,8.0,295.87912355142277,6
2020-11-02-170906,170906,4,2,0,1286,3.0,429.23772553265303,0
2020-11-03-170906,170906,30,0,0,1316,23.0,351.6840906992031,1
2020-11-04-170906,170906,21,1,0,1337,21.6,431.224910034478,2
2020-11-05-170906,170906,20,0,0,1357,26.2,459.0314703417161,3
2020-11-06-170906,170906,22,2,0,1379,25.2,522.2832243214087,4
2020-11-07-170906,170906,1,0,0,1380,3.0,576.9941536298384,5
2020-11-08-170906,170906,1,0,0,1381,3.6,537.8373712783466,6
2020-11-09-170906,170906,18,4,0,1399,21.8,541.7916929781953,0
2020-11-10-170906,170906,24,2,0,1423,17.0,286.1118112791353,1
2020-11-11-170906,170906,29,2,0,1452,19.2,344.84635643123295,2
2020-11-12-170906,170906,10,1,0,1462,18.6,376.581833924531,3
2020-11-13-170906,170906,21,2,0,1483,20.8,406.06954005097793,4
2020-03-01-170907,170907,0,0,8,0,0.0,0.0,6
2020-03-02-170907,170907,1,0,15,1,0.0,165.94699826388285,0
2020-03-03-170907,170907,0,2,11,1,0.0,856.5155329394081,1
2020-03-04-170907,170907,1,1,18,2,0.0,883.9917173773265,2
2020-03-05-170907,170907,0,0,30,2,0.1111111111111111,939.687869977259,3
2020-03-06-170907,170907,0,0,22,2,0.3333333333333333,854.1828451999622,4
2020-03-07-170907,170907,0,0,7,2,0.3333333333333333,866.2955047579353,5
2020-03-08-170907,170907,0,0,5,2,0.1111111111111111,868.0011791564193,6
2020-03-09-170907,170907,1,0,47,3,0.6666666666666666,873.7571851646971,0
2020-03-10-170907,170907,2,0,35,5,0.5555555555555556,3062.312389116831,1
2020-03-11-170907,170907,3,0,18,8,0.4444444444444444,2459.284879363937,2
2020-03-12-170907,170907,2,0,27,10,1.3333333333333333,1714.6247661643295,3
2020-03-13-170907,170907,4,0,28,14,2.6666666666666665,1049.9632002063881,4
2020-03-14-170907,170907,4,0,9,18,1.0,849.5523155909118,5
2020-03-15-170907,170907,8,0,8,26,1.6666666666666667,686.1077755249864,6
2020-03-16-170907,170907,15,0,29,41,7.222222222222222,244.93030590673624,0
2020-03-17-170907,170907,11,0,14,52,5.4444444444444455,447.4649129040683,1
2020-03-18-170907,170907,18,0,14,70,11.333333333333336,554.8873245730304,2
2020-03-19-170907,170907,30,0,18,100,10.222222222222221,735.5594361364906,3
2020-03-20-170907,170907,22,0,10,122,12.111111111111109,871.6488210961618,4
2020-03-21-170907,170907,7,0,5,129,4.5555555555555545,1017.5141863190554,5
2020-03-22-170907,170907,5,0,1,134,4.5555555555555545,999.8562600572077,6
2020-03-23-170907,170907,47,1,18,181,25.11111111111111,920.6980807915775,0
2020-03-24-170907,170907,35,0,15,216,20.11111111111111,1175.3786604599845,1
2020-03-25-170907,170907,18,0,16,234,19.555555555555557,1273.375888451962,2
2020-03-26-170907,170907,27,1,15,261,14.555555555555555,1317.7410101421647,3
2020-03-27-170907,170907,28,0,5,289,13.444444444444445,1533.762042741479,4
2020-03-28-170907,170907,9,0,6,298,11.333333333333336,1524.7609022842362,5
2020-03-29-170907,170907,8,0,8,306,3.4444444444444446,1554.1025957379597,6
2020-03-30-170907,170907,29,0,182,335,16.444444444444443,1180.45844553282,0
2020-03-31-170907,170907,14,0,12,349,9.111111111111109,1122.109486360796,1
2020-04-01-170907,170907,14,0,14,363,6.777777777777778,168.55397603060763,2
2020-04-02-170907,170907,18,0,12,381,6.5555555555555545,931.5447420147764,3
2020-04-03-170907,170907,10,0,13,391,7.222222222222222,280.28046596456704,4
2020-04-04-170907,170907,5,0,2,396,2.4444444444444446,412.2665492063047,5
2020-04-05-170907,170907,1,3,0,397,2.333333333333333,444.27174680196015,6
2020-04-06-170907,170907,18,0,10,415,11.333333333333336,473.69778603659415,0
2020-04-07-170907,170907,15,0,9,430,26.88888888888889,566.0476042941666,1
2020-04-08-170907,170907,16,4,8,446,8.555555555555555,721.7259214461337,2
2020-04-09-170907,170907,15,0,1,461,5.666666666666668,805.6920996658375,3
2020-04-10-170907,170907,5,0,4,466,5.888888888888888,154.14582034818673,4
2020-04-11-170907,170907,6,0,0,472,2.2222222222222223,209.0525629354331,5
2020-04-12-170907,170907,8,0,0,480,1.8888888888888888,279.1332496709432,6
2020-04-13-170907,170907,182,0,6,662,16.11111111111111,316.9900703767905,0
2020-04-14-170907,170907,12,0,2,674,9.444444444444443,757.4224139522589,1
2020-04-15-170907,170907,14,0,4,688,7.333333333333332,919.4784273827776,2
2020-04-16-170907,170907,12,0,7,700,6.222222222222222,1027.2584000644288,3
2020-04-17-170907,170907,13,0,1,713,4.0,1032.6754890758962,4
2020-04-18-170907,170907,2,0,0,715,1.8888888888888888,1089.810422947408,5
2020-04-19-170907,170907,0,0,0,715,0.7777777777777778,1033.221791960867,6
2020-04-20-170907,170907,10,0,6,725,5.222222222222221,666.1398683669108,0
2020-04-21-170907,170907,9,0,9,734,5.111111111111111,601.3067230854542,1
2020-04-22-170907,170907,8,0,7,742,5.777777777777778,567.8825233811864,2
2020-04-23-170907,170907,1,0,6,743,0.1111111111111111,555.8840982421734,3
2020-04-24-170907,170907,4,0,12,747,4.5555555555555545,454.40846975838946,4
2020-04-25-170907,170907,0,0,1,747,0.5555555555555556,494.4419646490378,5
2020-04-26-170907,170907,0,0,0,747,0.2222222222222222,496.5260314528315,6
2020-04-27-170907,170907,6,2,7,753,4.333333333333333,380.8075360147535,0
2020-04-28-170907,170907,2,0,8,755,3.0,353.4100409728369,1
2020-04-29-170907,170907,4,0,0,759,4.333333333333333,319.2540692601797,2
2020-04-30-170907,170907,7,0,3,766,4.4444444444444455,435.6986976204672,3
2020-05-01-170907,170907,1,0,6,767,0.8888888888888888,835.5687548716518,4
2020-05-02-170907,170907,0,0,1,767,0.4444444444444444,271.4354007877714,5
2020-05-03-170907,170907,0,0,2,767,0.1111111111111111,263.78469342263134,6
2020-05-04-170907,170907,6,0,4,773,6.4444444444444455,196.2403721321304,0
2020-05-05-170907,170907,9,0,2,782,5.777777777777778,244.83173045279995,1
2020-05-06-170907,170907,7,0,5,789,4.888888888888889,301.6915472787837,2
2020-05-07-170907,170907,6,0,3,795,5.777777777777778,356.95354254489973,3
2020-05-08-170907,170907,12,0,2,807,6.5555555555555545,388.6039717112341,4
2020-05-09-170907,170907,1,0,1,808,0.1111111111111111,515.385227403716,5
2020-05-10-170907,170907,0,0,0,808,0.3333333333333333,876.0108288403525,6
2020-05-11-170907,170907,7,1,5,815,5.0,829.1055443352892,0
2020-05-12-170907,170907,8,2,3,823,3.0,869.6016844525135,1
2020-05-13-170907,170907,0,0,1,823,1.0,741.9873489593881,2
2020-05-14-170907,170907,3,0,4,826,3.111111111111111,491.43165715937084,3
2020-05-15-170907,170907,6,0,3,832,3.555555555555556,399.8323460901584,4
2020-05-16-170907,170907,1,0,0,833,0.2222222222222222,347.54787591077184,5
2020-05-17-170907,170907,2,0,1,835,0.1111111111111111,350.34615877951774,6
2020-05-18-170907,170907,4,0,1,839,3.6666666666666665,350.58163536119764,0
2020-05-19-170907,170907,2,0,2,841,3.333333333333333,337.50537520626165,1
2020-05-20-170907,170907,5,0,3,846,3.0,302.7911027952699,2
2020-05-21-170907,170907,3,0,0,849,2.333333333333333,298.88603918063734,3
2020-05-22-170907,170907,2,0,1,851,2.555555555555556,275.36927122932866,4
2020-05-23-170907,170907,1,0,0,852,0.8888888888888888,310.86371283984886,5
2020-05-24-170907,170907,0,0,0,852,0.2222222222222222,325.80710825933187,6
2020-05-25-170907,170907,5,0,3,857,3.6666666666666665,252.06116557839687,0
2020-05-26-170907,170907,3,0,2,860,4.111111111111111,279.7148504487318,1
2020-05-27-170907,170907,1,0,1,861,2.2222222222222223,347.77065604570714,2
2020-05-28-170907,170907,4,0,1,865,1.7777777777777777,338.8879441403974,3
2020-05-29-170907,170907,3,0,2,868,4.4444444444444455,337.21827451387315,4
2020-05-30-170907,170907,0,0,0,868,0.4444444444444444,346.6149564280297,5
2020-05-31-170907,170907,1,0,1,869,0.0,357.79535567495867,6
2020-06-01-170907,170907,1,0,1,870,5.333333333333333,645.3108608569662,0
2020-06-02-170907,170907,2,0,0,872,3.555555555555556,206.80988514106124,1
2020-06-03-170907,170907,3,0,3,875,2.7777777777777777,179.40655846757696,2
2020-06-04-170907,170907,0,0,1,875,2.7777777777777777,191.77999696997807,3
2020-06-05-170907,170907,1,0,1,876,3.0,215.06533825622483,4
2020-06-06-170907,170907,0,0,0,876,0.2222222222222222,227.2903867341416,5
2020-06-07-170907,170907,0,0,0,876,0.2222222222222222,224.71024239941573,6
2020-06-08-170907,170907,3,0,1,879,1.8888888888888888,222.42038454565207,0
2020-06-09-170907,170907,2,0,4,881,1.8888888888888888,224.0512872770278,1
2020-06-10-170907,170907,1,0,1,882,1.2222222222222223,743.8539919891475,2
2020-06-11-170907,170907,1,0,0,883,1.1111111111111112,638.679607882826,3
2020-06-12-170907,170907,2,0,4,885,0.7777777777777778,552.7578062189318,4
2020-06-13-170907,170907,0,0,0,885,0.2222222222222222,462.8942059030701,5
2020-06-14-170907,170907,1,0,1,886,0.1111111111111111,356.54722058880066,6
2020-06-15-170907,170907,1,0,4,887,1.6666666666666667,216.9706476607787,0
2020-06-16-170907,170907,0,0,1,887,2.6666666666666665,247.70624465261352,1
2020-06-17-170907,170907,3,0,0,890,1.1111111111111112,233.14151378815347,2
2020-06-18-170907,170907,1,0,2,891,1.5555555555555556,231.35847216702837,3
2020-06-19-170907,170907,1,0,0,892,1.4444444444444444,234.353314952001,4
2020-06-20-170907,170907,0,0,0,892,0.0,287.91555570229235,5
2020-06-21-170907,170907,0,0,0,892,0.0,287.00640564342757,6
2020-06-22-170907,170907,1,0,0,893,1.8888888888888888,246.081601743103,0
2020-06-23-170907,170907,4,0,1,897,1.3333333333333333,210.94859025491266,1
2020-06-24-170907,170907,1,0,0,898,1.5555555555555556,218.94880886981895,2
2020-06-25-170907,170907,0,5,2,898,1.6666666666666667,206.98396461756982,3
2020-06-26-170907,170907,4,0,0,902,1.7777777777777777,204.29761313056102,4
2020-06-27-170907,170907,0,0,0,902,0.1111111111111111,182.30933151336023,5
2020-06-28-170907,170907,1,0,0,903,0.1111111111111111,183.7365914723904,6
2020-06-29-170907,170907,4,0,0,907,1.0,185.93643650370345,0
2020-06-30-170907,170907,1,0,0,908,0.6666666666666666,216.15183472051402,1
2020-07-01-170907,170907,0,0,2,908,0.7777777777777778,221.68606160774902,2
2020-07-02-170907,170907,2,0,0,910,0.5555555555555556,81.03989018492706,3
2020-07-03-170907,170907,0,0,1,910,0.8888888888888888,105.03051793974838,4
2020-07-04-170907,170907,0,0,0,910,0.3333333333333333,143.02111852290477,5
2020-07-05-170907,170907,0,0,0,910,0.1111111111111111,143.1983984773688,6
2020-07-06-170907,170907,0,0,0,910,1.3333333333333333,124.98313362312022,0
2020-07-07-170907,170907,1,0,1,911,0.6666666666666666,127.64345142330595,1
2020-07-08-170907,170907,0,0,0,911,0.8888888888888888,132.20520877592156,2
2020-07-09-170907,170907,2,0,0,913,1.1111111111111112,124.94914719238906,3
2020-07-10-170907,170907,0,0,0,913,0.8888888888888888,205.52814154819504,4
2020-07-11-170907,170907,0,0,1,913,0.0,176.2630748453896,5
2020-07-12-170907,170907,0,0,2,913,0.0,140.15197923269398,6
2020-07-13-170907,170907,0,0,0,913,0.7777777777777778,146.7077473097313,0
2020-07-14-170907,170907,0,0,0,913,0.2222222222222222,158.54167026610966,1
2020-07-15-170907,170907,2,0,0,915,0.5555555555555556,127.26270459189267,2
2020-07-16-170907,170907,0,0,0,915,0.5555555555555556,99.82310501464065,3
2020-07-17-170907,170907,1,0,0,916,0.4444444444444444,98.12517342996475,4
2020-07-18-170907,170907,0,0,0,916,0.3333333333333333,98.10645056972942,5
2020-07-19-170907,170907,0,0,0,916,0.1111111111111111,82.22586861829996,6
2020-07-20-170907,170907,0,0,4,916,0.5555555555555556,80.63453481551852,0
2020-07-21-170907,170907,1,0,3,917,0.8888888888888888,82.08669517085318,1
2020-07-22-170907,170907,0,0,0,917,1.1111111111111112,88.93411981393325,2
2020-07-23-170907,170907,0,0,1,917,0.8888888888888888,96.7303416740511,3
2020-07-24-170907,170907,0,0,1,917,1.6666666666666667,97.07521233102378,4
2020-07-25-170907,170907,1,0,4,918,0.1111111111111111,115.45626754014889,5
2020-07-26-170907,170907,2,0,0,920,0.0,113.63586999589631,6
2020-07-27-170907,170907,0,0,0,920,0.7777777777777778,98.69822376907669,0
2020-07-28-170907,170907,0,0,1,920,0.6666666666666666,108.10793036263863,1
2020-07-29-170907,170907,0,0,1,920,0.5555555555555556,107.14222862418949,2
2020-07-30-170907,170907,0,0,1,920,1.0,100.4614234103841,3
2020-07-31-170907,170907,0,0,2,920,0.7777777777777778,111.96918021879881,4
2020-08-01-170907,170907,0,0,0,920,0.3333333333333333,102.87669053229436,5
2020-08-02-170907,170907,0,0,1,920,0.1111111111111111,471.2907569095479,6
2020-08-03-170907,170907,4,0,1,924,0.8888888888888888,1062.5183912511345,0
2020-08-04-170907,170907,3,0,6,927,1.1111111111111112,902.0305450157038,1
2020-08-05-170907,170907,0,0,1,927,2.1111111111111107,777.7065539675189,2
2020-08-06-170907,170907,1,0,8,928,1.1111111111111112,595.7680313876317,3
2020-08-07-170907,170907,1,0,1,929,1.1111111111111112,399.4752309784219,4
2020-08-08-170907,170907,4,0,2,933,1.6666666666666667,360.8376703436534,5
2020-08-09-170907,170907,0,0,1,933,0.7777777777777778,391.2255264347973,6
2020-08-10-170907,170907,0,0,5,933,2.7777777777777777,86.23570648817207,0
2020-08-11-170907,170907,1,0,9,934,2.1111111111111107,131.6945598889602,1
2020-08-12-170907,170907,1,0,2,935,2.2222222222222223,170.89864938708217,2
2020-08-13-170907,170907,1,0,6,936,2.6666666666666665,210.77443729510117,3
2020-08-14-170907,170907,2,0,13,938,3.888888888888889,265.7863299266537,4
2020-08-15-170907,170907,0,0,4,938,1.7777777777777777,318.0256161200306,5
2020-08-16-170907,170907,1,0,1,939,1.3333333333333333,325.79384202471124,6
2020-08-17-170907,170907,1,0,12,940,3.0,370.8605077084,0
2020-08-18-170907,170907,6,0,3,946,2.6666666666666665,373.6111276453851,1
2020-08-19-170907,170907,1,0,15,947,3.6666666666666665,404.3220844244104,2
2020-08-20-170907,170907,8,0,11,955,4.222222222222221,356.28732377929236,3
2020-08-21-170907,170907,1,0,13,956,2.888888888888889,433.8454981013894,4
2020-08-22-170907,170907,2,0,2,958,1.2222222222222223,489.78202660636816,5
2020-08-23-170907,170907,1,0,1,959,1.6666666666666667,509.42670328808737,6
2020-08-24-170907,170907,5,0,19,964,3.555555555555556,521.1704149690331,0
2020-08-25-170907,170907,9,0,2,973,6.666666666666668,577.5757074371631,1
2020-08-26-170907,170907,2,0,10,975,7.0,678.6556050041997,2
2020-08-27-170907,170907,6,0,8,981,10.111111111111109,807.875642109153,3
2020-08-28-170907,170907,13,0,14,994,7.222222222222222,866.6224425318192,4
2020-08-29-170907,170907,4,0,2,998,2.6666666666666665,1001.2867033674643,5
2020-08-30-170907,170907,1,0,2,999,2.2222222222222223,981.8965996112427,6
2020-08-31-170907,170907,12,0,26,1011,6.777777777777778,904.2787235314183,0
2020-09-01-170907,170907,3,0,7,1014,4.5555555555555545,401.4154264259362,1
2020-09-02-170907,170907,15,0,26,1029,4.888888888888889,1344.1239437915578,2
2020-09-03-170907,170907,11,0,21,1040,6.333333333333332,1008.1990361635725,3
2020-09-04-170907,170907,13,1,9,1053,6.888888888888888,1013.6594489104452,4
2020-09-05-170907,170907,2,0,2,1055,2.4444444444444446,950.4354605348692,5
2020-09-06-170907,170907,1,0,0,1056,2.6666666666666665,923.7601073666831,6
2020-09-07-170907,170907,19,0,14,1075,9.222222222222221,964.4337741417822,0
2020-09-08-170907,170907,2,0,11,1077,2.2222222222222223,1053.5886998158526,1
2020-09-09-170907,170907,10,0,17,1087,7.222222222222222,930.169966471941,2
2020-09-10-170907,170907,8,0,18,1095,5.222222222222221,352.5474365217187,3
2020-09-11-170907,170907,14,0,16,1109,7.777777777777778,524.2827845299939,4
2020-09-12-170907,170907,2,0,1,1111,1.6666666666666667,727.6708792957129,5
2020-09-13-170907,170907,2,0,11,1113,2.1111111111111107,749.406056505203,6
2020-09-14-170907,170907,26,0,15,1139,7.111111111111112,772.6895626683372,0
2020-09-15-170907,170907,7,1,13,1146,5.5555555555555545,972.9963614426524,1
2020-09-16-170907,170907,26,1,12,1172,7.666666666666668,1193.0557239182706,2
2020-09-17-170907,170907,21,0,10,1193,9.111111111111109,1364.2951989735611,3
2020-09-18-170907,170907,9,0,7,1202,5.111111111111111,1498.748971424498,4
2020-09-19-170907,170907,2,1,1,1204,2.333333333333333,1453.848182784709,5
2020-09-20-170907,170907,0,0,2,1204,1.2222222222222223,1596.8835271391417,6
2020-09-21-170907,170907,14,0,19,1218,8.222222222222221,1359.5307648441299,0
2020-09-22-170907,170907,11,0,19,1229,5.888888888888888,1361.3797503833491,1
2020-09-23-170907,170907,17,2,10,1246,7.4444444444444455,1285.8632103687673,2
2020-09-24-170907,170907,18,0,12,1264,4.888888888888889,1111.381857844881,3
2020-09-25-170907,170907,16,0,17,1280,8.777777777777779,1068.1832173833282,4
2020-09-26-170907,170907,1,0,1,1281,2.2222222222222223,1276.4515489656533,5
2020-09-27-170907,170907,11,0,1,1292,0.6666666666666666,1222.351891517529,6
2020-09-28-170907,170907,15,0,1,1307,7.111111111111112,1226.9375997239035,0
2020-09-29-170907,170907,13,0,18,1320,4.888888888888889,1184.6356568369702,1
2020-09-30-170907,170907,12,0,15,1332,4.333333333333333,1153.3902803747771,2
2020-10-01-170907,170907,10,0,13,1342,6.5555555555555545,0.0,3
2020-10-02-170907,170907,7,0,18,1349,7.333333333333332,1351.970291299701,4
2020-10-03-170907,170907,1,0,5,1350,1.1111111111111112,2605.0804618288057,5
2020-10-04-170907,170907,2,1,2,1352,1.2222222222222223,2667.2540699629185,6
2020-10-05-170907,170907,19,1,15,1371,8.888888888888891,2219.1970044369896,0
2020-10-06-170907,170907,19,0,22,1390,6.333333333333332,2076.713006799358,1
2020-10-07-170907,170907,10,1,32,1400,8.444444444444445,1787.5285920057122,2
2020-10-08-170907,170907,12,0,21,1412,8.888888888888891,1563.406007558702,3
2020-10-09-170907,170907,17,3,28,1429,7.0,1830.994383593306,4
2020-10-10-170907,170907,1,0,2,1430,3.2222222222222223,187.82206090106843,5
2020-10-11-170907,170907,1,0,3,1431,0.4444444444444444,306.8106459757709,6
2020-10-12-170907,170907,1,0,34,1432,1.8888888888888888,344.29573576206207,0
2020-10-13-170907,170907,18,0,14,1450,7.111111111111112,379.07274971869356,1
2020-10-14-170907,170907,15,0,27,1465,7.111111111111112,589.8981710553423,2
2020-10-15-170907,170907,13,0,35,1478,8.222222222222221,829.5063416207208,3
2020-10-16-170907,170907,18,0,34,1496,7.666666666666668,1036.4241920082593,4
2020-10-17-170907,170907,5,0,4,1501,2.0,1102.3917543445486,5
2020-10-18-170907,170907,2,0,5,1503,1.6666666666666667,1081.780818341931,6
2020-10-19-170907,170907,15,0,3,1518,11.666666666666664,1113.286967756085,0
2020-10-20-170907,170907,22,0,20,1540,8.666666666666666,1399.075643076735,1
2020-10-21-170907,170907,32,0,21,1572,12.0,1456.5688003514367,2
2020-10-22-170907,170907,21,0,29,1593,12.111111111111109,1611.2625479568205,3
2020-10-23-170907,170907,28,0,20,1621,19.88888888888889,1797.1151490056025,4
2020-10-24-170907,170907,2,1,2,1623,4.0,2198.1514231299784,5
2020-10-25-170907,170907,3,1,4,1626,3.555555555555556,2225.107554003098,6
2020-10-26-170907,170907,34,0,40,1660,19.555555555555557,2044.303411720202,0
2020-10-27-170907,170907,14,0,20,1674,16.11111111111111,2283.515598718289,1
2020-10-28-170907,170907,27,0,21,1701,17.11111111111111,2354.0714517843653,2
2020-10-29-170907,170907,35,0,21,1736,24.777777777777782,2487.8618241429635,3
2020-10-30-170907,170907,34,1,24,1770,27.33333333333333,2122.9506391101727,4
2020-10-31-170907,170907,4,2,0,1774,7.777777777777778,2520.0175879974986,5
2020-11-01-170907,170907,5,1,0,1779,7.4444444444444455,1468.2601009108885,6
2020-11-02-170907,170907,3,0,0,1782,2.6666666666666665,2011.2479271444427,0
2020-11-03-170907,170907,20,1,0,1802,16.22222222222222,1615.871205153812,1
2020-11-04-170907,170907,21,0,0,1823,20.0,1964.0210790127467,2
2020-11-05-170907,170907,29,0,0,1852,20.444444444444443,2126.9488092434467,3
2020-11-06-170907,170907,20,3,0,1872,20.33333333333333,2397.614807195858,4
2020-11-07-170907,170907,2,0,0,1874,5.888888888888888,2647.4310073704564,5
2020-11-08-170907,170907,4,0,0,1878,3.888888888888889,2525.886468039223,6
2020-11-09-170907,170907,40,0,0,1918,15.333333333333336,2565.3891235247293,0
2020-11-10-170907,170907,20,0,0,1938,15.777777777777779,1400.141992418974,1
2020-11-11-170907,170907,21,1,0,1959,18.11111111111111,1684.8724165945623,2
2020-11-12-170907,170907,21,0,0,1980,13.444444444444445,1878.6295092493024,3
2020-11-13-170907,170907,24,0,0,2004,18.666666666666668,2023.7765189935894,4
2020-03-01-170909,170909,0,0,6,0,0.14285714285714285,0.0,6
2020-03-02-170909,170909,0,1,10,0,0.0,118.89770683381255,0
2020-03-03-170909,170909,0,1,5,0,0.0,530.0586368440825,1
2020-03-04-170909,170909,0,0,19,0,0.14285714285714285,615.2323817745039,2
2020-03-05-170909,170909,0,0,10,0,0.14285714285714285,643.9108758414121,3
2020-03-06-170909,170909,2,0,16,2,0.0,592.0297597283379,4
2020-03-07-170909,170909,0,0,7,2,0.0,642.0955319348509,5
2020-03-08-170909,170909,0,0,5,2,0.14285714285714285,616.204886599493,6
2020-03-09-170909,170909,0,0,10,2,0.14285714285714285,617.7654550060363,0
2020-03-10-170909,170909,0,0,13,2,0.2857142857142857,3112.2827325487874,1
2020-03-11-170909,170909,1,0,16,3,0.2857142857142857,2569.135480385542,2
2020-03-12-170909,170909,0,0,17,3,0.42857142857142855,1805.41336239696,3
2020-03-13-170909,170909,3,0,10,6,2.142857142857143,1192.1272930048594,4
2020-03-14-170909,170909,2,0,3,8,0.5714285714285714,1036.088901421777,5
2020-03-15-170909,170909,6,0,7,14,1.5714285714285714,604.6622226628763,6
2020-03-16-170909,170909,10,0,15,24,5.571428571428571,201.13507986551045,0
2020-03-17-170909,170909,5,1,4,29,5.7142857142857135,375.5708617878166,1
2020-03-18-170909,170909,19,0,15,48,8.142857142857142,464.28895405585627,2
2020-03-19-170909,170909,10,0,7,58,11.142857142857142,656.5686153740481,3
2020-03-20-170909,170909,16,0,5,74,10.857142857142858,747.5481011099614,4
2020-03-21-170909,170909,7,0,1,81,2.2857142857142856,868.7273152844282,5
2020-03-22-170909,170909,5,0,3,86,4.0,845.9442309617505,6
2020-03-23-170909,170909,10,0,11,96,14.571428571428573,785.5528022294375,0
2020-03-24-170909,170909,13,0,7,109,14.285714285714285,892.1588895989815,1
2020-03-25-170909,170909,16,0,4,125,12.0,889.6094745293135,2
2020-03-26-170909,170909,17,0,3,142,12.0,918.6878691936429,3
2020-03-27-170909,170909,10,0,6,152,14.0,1104.6174926112226,4
2020-03-28-170909,170909,3,0,4,155,2.8571428571428568,1058.9894022777298,5
2020-03-29-170909,170909,7,0,2,162,2.7142857142857144,1036.0477216389427,6
2020-03-30-170909,170909,15,0,11,177,12.142857142857142,833.6024118736962,0
2020-03-31-170909,170909,4,0,11,181,9.571428571428571,817.1727879385319,1
2020-04-01-170909,170909,15,0,5,196,9.285714285714286,112.21106672099587,2
2020-04-02-170909,170909,7,0,4,203,8.857142857142858,531.4751327816764,3
2020-04-03-170909,170909,5,0,7,208,12.857142857142858,259.23015352895493,4
2020-04-04-170909,170909,1,0,4,209,3.0,365.7364645220247,5
2020-04-05-170909,170909,3,0,2,212,1.0,375.71505871059776,6
2020-04-06-170909,170909,11,0,6,223,9.142857142857142,387.4368789379687,0
2020-04-07-170909,170909,7,0,7,230,7.857142857142858,464.0041336554554,1
2020-04-08-170909,170909,4,0,3,234,9.857142857142858,513.5071072189812,2
2020-04-09-170909,170909,3,0,1,237,5.285714285714286,552.9534405265135,3
2020-04-10-170909,170909,6,0,5,243,5.428571428571429,175.4024327927441,4
2020-04-11-170909,170909,4,0,1,247,6.2857142857142865,236.1971376407024,5
2020-04-12-170909,170909,2,0,2,249,4.857142857142857,297.7332530259205,6
2020-04-13-170909,170909,11,0,4,260,16.0,337.95163083382886,0
2020-04-14-170909,170909,11,0,7,271,12.285714285714285,493.2107132511412,1
2020-04-15-170909,170909,5,0,4,276,9.142857142857142,624.8616733879467,2
2020-04-16-170909,170909,4,0,3,280,6.7142857142857135,714.8542597809087,3
2020-04-17-170909,170909,7,0,0,287,4.285714285714286,647.4889765369511,4
2020-04-18-170909,170909,4,0,0,291,0.7142857142857143,682.5924518277512,5
2020-04-19-170909,170909,2,1,1,293,0.2857142857142857,645.0850721409033,6
2020-04-20-170909,170909,6,0,6,299,7.2857142857142865,544.5024456045012,0
2020-04-21-170909,170909,7,0,7,306,5.571428571428571,495.5524497422066,1
2020-04-22-170909,170909,3,1,4,309,5.142857142857143,494.0272348145743,2
2020-04-23-170909,170909,1,0,9,310,0.5714285714285714,481.17771316014137,3
2020-04-24-170909,170909,5,0,4,315,4.428571428571429,390.4852535356398,4
2020-04-25-170909,170909,1,0,0,316,0.2857142857142857,422.77276678343173,5
2020-04-26-170909,170909,2,0,1,318,0.7142857142857143,419.0366233546657,6
2020-04-27-170909,170909,4,0,1,322,4.714285714285714,325.5872919655881,0
2020-04-28-170909,170909,7,0,4,329,3.4285714285714284,307.9379354252577,1
2020-04-29-170909,170909,4,0,0,333,3.2857142857142856,294.5119829531045,2
2020-04-30-170909,170909,3,0,2,336,5.571428571428571,434.26692678485756,3
2020-05-01-170909,170909,0,0,4,336,0.5714285714285714,632.0710173840455,4
2020-05-02-170909,170909,0,0,0,336,0.8571428571428571,234.17745630266663,5
2020-05-03-170909,170909,1,0,0,337,0.2857142857142857,265.3340516316817,6
2020-05-04-170909,170909,6,0,7,343,5.428571428571429,215.30711579577633,0
2020-05-05-170909,170909,7,0,6,350,3.4285714285714284,265.6600355880082,1
2020-05-06-170909,170909,4,0,5,354,5.7142857142857135,274.60190560370967,2
2020-05-07-170909,170909,9,0,6,363,3.4285714285714284,323.2911076973236,3
2020-05-08-170909,170909,4,0,11,367,4.714285714285714,372.0260377878737,4
2020-05-09-170909,170909,0,1,0,367,0.5714285714285714,465.5030677925819,5
2020-05-10-170909,170909,1,0,1,368,0.2857142857142857,655.384959932527,6
2020-05-11-170909,170909,1,0,6,369,5.428571428571429,630.9863641143743,0
2020-05-12-170909,170909,4,0,3,373,4.142857142857143,661.8519255923048,1
2020-05-13-170909,170909,0,0,8,373,2.571428571428572,551.2252348095453,2
2020-05-14-170909,170909,2,0,2,375,4.857142857142857,389.0289627167908,3
2020-05-15-170909,170909,4,0,6,379,4.285714285714286,319.9765640013477,4
2020-05-16-170909,170909,0,0,0,379,0.14285714285714285,276.59478696530914,5
2020-05-17-170909,170909,0,0,1,379,0.42857142857142855,273.8233839645402,6
2020-05-18-170909,170909,7,0,5,386,3.2857142857142856,272.56459790182953,0
2020-05-19-170909,170909,6,0,2,392,2.142857142857143,297.22164557790916,1
2020-05-20-170909,170909,5,0,1,397,3.4285714285714284,282.21298534839855,2
2020-05-21-170909,170909,6,0,2,403,1.7142857142857142,331.0348724845212,3
2020-05-22-170909,170909,11,0,3,414,2.0,331.5430503074763,4
2020-05-23-170909,170909,0,0,0,414,0.14285714285714285,431.1541542271904,5
2020-05-24-170909,170909,1,0,1,415,0.14285714285714285,437.8773090497018,6
2020-05-25-170909,170909,6,0,1,421,3.2857142857142856,361.1746511502207,0
2020-05-26-170909,170909,3,0,2,424,3.2857142857142856,385.08756418124744,1
2020-05-27-170909,170909,8,1,2,432,3.0,440.8729215475348,2
2020-05-28-170909,170909,2,0,2,434,1.8571428571428568,447.5363610187625,3
2020-05-29-170909,170909,6,0,3,440,1.2857142857142858,420.7967859429632,4
2020-05-30-170909,170909,0,0,0,440,0.2857142857142857,398.05809694408214,5
2020-05-31-170909,170909,1,0,1,441,0.2857142857142857,401.6816037744985,6
2020-06-01-170909,170909,5,0,4,446,1.8571428571428568,621.7951725784415,0
2020-06-02-170909,170909,2,0,3,448,2.142857142857143,247.84151347498764,1
2020-06-03-170909,170909,1,0,3,449,1.1428571428571428,170.95533309830128,2
2020-06-04-170909,170909,2,0,3,451,1.5714285714285714,165.66381349864912,3
2020-06-05-170909,170909,3,1,3,454,2.0,177.88536692842385,4
2020-06-06-170909,170909,0,1,2,454,0.14285714285714285,204.50780208859646,5
2020-06-07-170909,170909,1,1,1,455,0.0,201.74177587312886,6
2020-06-08-170909,170909,1,0,1,456,1.4285714285714286,207.64045591646166,0
2020-06-09-170909,170909,2,0,2,458,1.1428571428571428,197.2373981868323,1
2020-06-10-170909,170909,2,0,2,460,2.142857142857143,685.990659807572,2
2020-06-11-170909,170909,2,0,2,462,2.0,597.5780089170605,3
2020-06-12-170909,170909,3,0,0,465,1.2857142857142858,530.5288574986486,4
2020-06-13-170909,170909,0,1,0,465,0.14285714285714285,462.99732714611764,5
2020-06-14-170909,170909,1,0,0,466,0.0,331.4945244882524,6
2020-06-15-170909,170909,4,0,3,470,1.8571428571428568,237.1942850361144,0
2020-06-16-170909,170909,3,0,2,473,2.142857142857143,280.12437072182377,1
2020-06-17-170909,170909,3,0,1,476,1.0,258.3969493239032,2
2020-06-18-170909,170909,3,0,0,479,1.2857142857142858,256.36877419326777,3
2020-06-19-170909,170909,3,0,0,482,2.142857142857143,259.05515190063477,4
2020-06-20-170909,170909,2,0,1,484,0.14285714285714285,308.94254757411386,5
2020-06-21-170909,170909,1,0,0,485,0.0,320.76130395035653,6
2020-06-22-170909,170909,1,0,0,486,1.2857142857142858,277.683511947007,0
2020-06-23-170909,170909,2,0,0,488,1.2857142857142858,245.97784459152453,1
2020-06-24-170909,170909,2,0,3,490,0.8571428571428571,251.95133787415713,2
2020-06-25-170909,170909,2,0,1,492,0.2857142857142857,231.41100214159079,3
2020-06-26-170909,170909,0,0,2,492,0.7142857142857143,214.29281220786208,4
2020-06-27-170909,170909,0,0,1,492,0.42857142857142855,186.40142167262795,5
2020-06-28-170909,170909,0,0,0,492,0.14285714285714285,170.1942391434002,6
2020-06-29-170909,170909,3,0,2,495,1.1428571428571428,163.1846915885421,0
2020-06-30-170909,170909,2,0,1,497,0.5714285714285714,173.8502353874144,1
2020-07-01-170909,170909,1,0,5,498,0.5714285714285714,217.10043928717437,2
2020-07-02-170909,170909,0,0,3,498,0.14285714285714285,113.327575716673,3
2020-07-03-170909,170909,0,0,1,498,1.2857142857142858,174.43272860915545,4
2020-07-04-170909,170909,1,0,0,499,0.14285714285714285,192.33580370319356,5
2020-07-05-170909,170909,0,0,0,499,0.14285714285714285,199.73075321584122,6
2020-07-06-170909,170909,0,0,2,499,0.5714285714285714,154.77380851618318,0
2020-07-07-170909,170909,0,0,0,499,0.42857142857142855,124.53435133208279,1
2020-07-08-170909,170909,3,2,1,502,0.7142857142857143,101.67166969133379,2
2020-07-09-170909,170909,1,0,0,503,0.42857142857142855,119.05797505112976,3
2020-07-10-170909,170909,2,0,3,505,1.0,200.06367548883497,4
2020-07-11-170909,170909,1,0,0,506,1.2857142857142858,182.43106986447805,5
2020-07-12-170909,170909,0,0,0,506,0.8571428571428571,150.91239473339886,6
2020-07-13-170909,170909,2,0,4,508,0.2857142857142857,159.47649705600935,0
2020-07-14-170909,170909,1,0,2,509,0.7142857142857143,173.5919828595185,1
2020-07-15-170909,170909,5,0,3,514,0.5714285714285714,152.05714543836575,2
2020-07-16-170909,170909,3,0,3,517,0.5714285714285714,136.8892079388171,3
2020-07-17-170909,170909,1,0,3,518,1.5714285714285714,126.32638234124342,4
2020-07-18-170909,170909,0,0,0,518,0.14285714285714285,125.09592408067758,5
2020-07-19-170909,170909,0,0,0,518,0.5714285714285714,108.20212771509489,6
2020-07-20-170909,170909,2,0,0,520,0.5714285714285714,91.40585701667308,0
2020-07-21-170909,170909,0,0,1,520,0.8571428571428571,95.14903162354523,1
2020-07-22-170909,170909,1,0,1,521,0.8571428571428571,84.6663642060932,2
2020-07-23-170909,170909,0,0,0,521,0.8571428571428571,98.21553742134486,3
2020-07-24-170909,170909,3,0,3,524,0.7142857142857143,88.06758383684286,4
2020-07-25-170909,170909,0,0,0,524,0.14285714285714285,114.19620046251148,5
2020-07-26-170909,170909,0,0,0,524,0.14285714285714285,108.69362367238188,6
2020-07-27-170909,170909,4,0,3,528,0.5714285714285714,102.41611696148144,0
2020-07-28-170909,170909,2,0,7,530,0.7142857142857143,127.78986263988469,1
2020-07-29-170909,170909,3,0,1,533,0.7142857142857143,155.4386264939232,2
2020-07-30-170909,170909,3,0,3,536,2.0,169.55019554121492,3
2020-07-31-170909,170909,3,0,4,539,1.2857142857142858,162.98392926384517,4
2020-08-01-170909,170909,0,0,0,539,1.5714285714285714,110.82817756740677,5
2020-08-02-170909,170909,0,0,0,539,0.42857142857142855,465.54331568520985,6
2020-08-03-170909,170909,0,0,2,539,0.7142857142857143,1308.354978257458,0
2020-08-04-170909,170909,1,0,5,540,1.1428571428571428,1004.8206607102977,1
2020-08-05-170909,170909,1,0,5,541,0.5714285714285714,841.7807995830399,2
2020-08-06-170909,170909,0,0,5,541,1.0,577.3166276229123,3
2020-08-07-170909,170909,3,0,8,544,1.4285714285714286,319.8126298954046,4
2020-08-08-170909,170909,0,0,3,544,3.1428571428571432,283.2221086429885,5
2020-08-09-170909,170909,0,0,4,544,1.4285714285714286,303.39059581100946,6
2020-08-10-170909,170909,3,0,13,547,1.7142857142857142,91.19046888772584,0
2020-08-11-170909,170909,7,0,10,554,2.2857142857142856,117.13949597288195,1
2020-08-12-170909,170909,1,0,10,555,0.42857142857142855,165.09787948590827,2
2020-08-13-170909,170909,3,1,21,558,2.8571428571428568,188.51530385685717,3
2020-08-14-170909,170909,4,0,19,562,2.7142857142857144,239.6248789363845,4
2020-08-15-170909,170909,0,0,3,562,0.42857142857142855,273.1188822709575,5
2020-08-16-170909,170909,0,0,1,562,2.2857142857142856,271.6853701073418,6
2020-08-17-170909,170909,2,0,6,564,2.571428571428572,289.420373891178,0
2020-08-18-170909,170909,5,0,11,569,3.0,300.0385814700097,1
2020-08-19-170909,170909,5,0,12,574,3.2857142857142856,323.49170606874276,2
2020-08-20-170909,170909,5,0,7,579,4.857142857142857,321.3161541624529,3
2020-08-21-170909,170909,8,0,5,587,3.8571428571428568,398.5441749056227,4
2020-08-22-170909,170909,3,0,0,590,1.0,498.1100982582135,5
2020-08-23-170909,170909,4,0,2,594,2.0,544.4565844888247,6
2020-08-24-170909,170909,13,0,8,607,4.142857142857143,562.6954523447183,0
2020-08-25-170909,170909,10,0,1,617,9.857142857142858,667.6661636961728,1
2020-08-26-170909,170909,10,0,13,627,6.857142857142858,774.6800933169341,2
2020-08-27-170909,170909,21,0,17,648,9.714285714285714,925.360717983665,3
2020-08-28-170909,170909,19,0,15,667,8.714285714285714,1049.31550415841,4
2020-08-29-170909,170909,3,0,7,670,0.5714285714285714,1208.188232307592,5
2020-08-30-170909,170909,1,0,3,671,1.1428571428571428,1148.0636875456478,6
2020-08-31-170909,170909,6,0,17,677,7.0,1005.8477534747078,0
2020-09-01-170909,170909,11,0,22,688,3.7142857142857135,327.34722968349024,1
2020-09-02-170909,170909,12,0,18,700,5.571428571428571,1304.7194918409928,2
2020-09-03-170909,170909,7,0,17,707,5.142857142857143,1060.7259872089617,3
2020-09-04-170909,170909,5,0,23,712,4.571428571428571,1096.9921588312875,4
2020-09-05-170909,170909,0,0,2,712,1.7142857142857142,997.4079653741245,5
2020-09-06-170909,170909,2,0,7,714,4.0,854.8727819324411,6
2020-09-07-170909,170909,8,0,18,722,5.7142857142857135,923.6059001698897,0
2020-09-08-170909,170909,1,0,21,723,2.4285714285714284,980.7883418129846,1
2020-09-09-170909,170909,13,0,15,736,5.857142857142858,844.3203873273969,2
2020-09-10-170909,170909,17,0,11,753,9.142857142857142,306.33693591681856,3
2020-09-11-170909,170909,15,0,15,768,6.2857142857142865,508.7756463847868,4
2020-09-12-170909,170909,7,0,13,775,1.1428571428571428,770.8688832145551,5
2020-09-13-170909,170909,3,0,0,778,0.7142857142857143,841.1490041583847,6
2020-09-14-170909,170909,17,0,3,795,7.571428571428571,863.7436156200595,0
2020-09-15-170909,170909,22,0,11,817,10.0,1051.5578023473354,1
2020-09-16-170909,170909,18,0,10,835,11.142857142857142,1323.5534783779285,2
2020-09-17-170909,170909,17,0,12,852,7.142857142857142,1428.029613784111,3
2020-09-18-170909,170909,23,0,15,875,10.714285714285714,1469.1550488350995,4
2020-09-19-170909,170909,2,2,1,877,9.285714285714286,1433.8186922660866,5
2020-09-20-170909,170909,7,0,0,884,1.8571428571428568,1540.7920136241655,6
2020-09-21-170909,170909,18,0,6,902,8.428571428571429,1382.0877259714584,0
2020-09-22-170909,170909,21,1,11,923,9.142857142857142,1339.9870372442717,1
2020-09-23-170909,170909,15,0,11,938,7.0,1355.0227826041119,2
2020-09-24-170909,170909,11,0,4,949,6.857142857142858,1218.4358749919577,3
2020-09-25-170909,170909,15,0,11,964,10.0,1137.99471027545,4
2020-09-26-170909,170909,13,0,4,977,6.571428571428571,1295.7529969360965,5
2020-09-27-170909,170909,0,0,1,977,0.42857142857142855,1325.2110575623706,6
2020-09-28-170909,170909,3,0,2,980,4.285714285714286,1265.8086161300503,0
2020-09-29-170909,170909,11,0,8,991,5.0,1200.080106989707,1
2020-09-30-170909,170909,10,0,14,1001,6.0,1126.883017611996,2
2020-10-01-170909,170909,12,0,10,1013,8.285714285714286,0.0,3
2020-10-02-170909,170909,15,0,11,1028,8.428571428571429,1342.5122111557623,4
2020-10-03-170909,170909,1,1,1,1029,2.4285714285714284,2600.3457991103114,5
2020-10-04-170909,170909,0,1,3,1029,2.8571428571428568,2711.99170562938,6
2020-10-05-170909,170909,6,0,9,1035,8.428571428571429,2307.453187091273,0
2020-10-06-170909,170909,11,0,52,1046,9.0,2084.1873225636496,1
2020-10-07-170909,170909,11,0,23,1057,8.285714285714286,1828.901125077199,2
2020-10-08-170909,170909,4,0,31,1061,5.428571428571429,1545.0650567772266,3
2020-10-09-170909,170909,11,4,34,1072,4.428571428571429,1673.4230787278357,4
2020-10-10-170909,170909,4,0,9,1076,1.5714285714285714,210.89007074456873,5
2020-10-11-170909,170909,1,0,3,1077,0.7142857142857143,301.59398815313375,6
2020-10-12-170909,170909,2,0,18,1079,1.2857142857142858,328.00087037032625,0
2020-10-13-170909,170909,8,0,24,1087,9.0,356.4417245568701,1
2020-10-14-170909,170909,14,0,30,1101,6.428571428571429,536.9701567241747,2
2020-10-15-170909,170909,10,0,45,1111,6.571428571428571,742.3844365080581,3
2020-10-16-170909,170909,11,0,29,1122,5.857142857142858,920.6908928049656,4
2020-10-17-170909,170909,1,0,16,1123,3.571428571428572,916.559945869643,5
2020-10-18-170909,170909,3,0,45,1126,2.2857142857142856,902.2637812248418,6
2020-10-19-170909,170909,9,0,18,1135,8.0,936.7207159297074,0
2020-10-20-170909,170909,52,0,26,1187,12.142857142857142,1420.327224860791,1
2020-10-21-170909,170909,23,0,36,1210,11.142857142857142,1673.6656049149346,2
2020-10-22-170909,170909,31,0,72,1241,14.857142857142858,1839.0013230218944,3
2020-10-23-170909,170909,34,0,51,1275,19.0,1953.2832143112764,4
2020-10-24-170909,170909,9,0,10,1284,3.2857142857142856,2391.4302949850853,5
2020-10-25-170909,170909,3,1,43,1287,1.7142857142857142,2475.0756340166204,6
2020-10-26-170909,170909,18,2,29,1305,14.857142857142858,2131.2232060168544,0
2020-10-27-170909,170909,24,0,22,1329,12.857142857142858,2277.639692553744,1
2020-10-28-170909,170909,30,0,9,1359,15.714285714285715,2201.9371204675685,2
2020-10-29-170909,170909,45,0,29,1404,19.0,2338.2625899452637,3
2020-10-30-170909,170909,29,1,26,1433,18.428571428571427,2127.141333910212,4
2020-10-31-170909,170909,16,0,0,1449,5.7142857142857135,2517.973222955984,5
2020-11-01-170909,170909,45,0,0,1494,2.2857142857142856,1310.9308193046945,6
2020-11-02-170909,170909,18,3,0,1512,2.8571428571428568,1944.7196206359074,0
2020-11-03-170909,170909,26,2,0,1538,15.285714285714285,1739.5375192646998,1
2020-11-04-170909,170909,36,1,0,1574,17.428571428571427,2144.3909442870026,2
2020-11-05-170909,170909,72,1,0,1646,21.428571428571427,2296.7649225065147,3
2020-11-06-170909,170909,51,7,0,1697,17.0,2624.42149302115,4
2020-11-07-170909,170909,10,6,0,1707,2.571428571428572,2916.583831551205,5
2020-11-08-170909,170909,43,2,0,1750,3.4285714285714284,2743.0176426848802,6
2020-11-09-170909,170909,29,2,0,1779,14.285714285714285,3007.304464372937,0
2020-11-10-170909,170909,22,5,0,1801,11.285714285714285,1447.0070216354875,1
2020-11-11-170909,170909,9,3,0,1810,11.428571428571427,1735.0268539261374,2
2020-11-12-170909,170909,29,3,0,1839,11.285714285714285,1863.6643053298494,3
2020-11-13-170909,170909,26,7,0,1865,12.142857142857142,2058.4010823327562,4
2020-03-01-170910,170910,0,0,0,0,0.0,0.0,6
2020-03-02-170910,170910,0,0,2,0,0.0,6.644835886307318,0
2020-03-03-170910,170910,0,0,0,0,0.0,32.04132512823265,1
2020-03-04-170910,170910,0,1,0,0,0.14285714285714285,25.31612537570007,2
2020-03-05-170910,170910,0,0,0,0,0.0,24.43718154189498,3
2020-03-06-170910,170910,0,0,0,0,0.0,18.435999991628748,4
2020-03-07-170910,170910,0,0,0,0,0.0,19.649563840850686,5
2020-03-08-170910,170910,0,0,0,0,0.0,19.72036055388825,6
2020-03-09-170910,170910,0,0,1,0,0.14285714285714285,19.569284915087028,0
2020-03-10-170910,170910,0,0,2,0,0.0,150.2104997624505,1
2020-03-11-170910,170910,0,0,3,0,0.14285714285714285,121.12362184327115,2
2020-03-12-170910,170910,0,0,0,0,0.0,90.65776075214728,3
2020-03-13-170910,170910,0,0,1,0,0.0,51.69603761742344,4
2020-03-14-170910,170910,0,0,0,0,0.0,38.87017133992802,5
2020-03-15-170910,170910,0,0,0,0,0.14285714285714285,32.36946602605439,6
2020-03-16-170910,170910,2,0,0,2,1.4285714285714286,8.810095181366341,0
2020-03-17-170910,170910,0,0,0,2,1.1428571428571428,20.694243738153972,1
2020-03-18-170910,170910,0,0,1,2,1.7142857142857142,26.98703905841003,2
2020-03-19-170910,170910,0,0,0,2,2.4285714285714284,30.74860254321836,3
2020-03-20-170910,170910,0,0,2,2,2.4285714285714284,38.97413842372548,4
2020-03-21-170910,170910,0,0,0,2,0.8571428571428571,47.808707157672856,5
2020-03-22-170910,170910,0,1,1,2,0.7142857142857143,46.77389865265819,6
2020-03-23-170910,170910,1,0,2,3,2.7142857142857144,42.91343732260508,0
2020-03-24-170910,170910,2,0,2,5,2.4285714285714284,49.92956425720934,1
2020-03-25-170910,170910,3,0,0,8,2.142857142857143,59.125970926657374,2
2020-03-26-170910,170910,0,0,0,8,1.5714285714285714,66.08894828976652,3
2020-03-27-170910,170910,1,0,1,9,1.5714285714285714,77.5134854840208,4
2020-03-28-170910,170910,0,0,0,9,0.5714285714285714,79.67626847456707,5
2020-03-29-170910,170910,0,0,1,9,0.14285714285714285,76.41724036435053,6
2020-03-30-170910,170910,0,0,3,9,1.0,57.92545604695716,0
2020-03-31-170910,170910,0,0,3,9,1.5714285714285714,46.76133359110139,1
2020-04-01-170910,170910,1,0,0,10,2.0,5.47703381716223,2
2020-04-02-170910,170910,0,0,0,10,0.2857142857142857,47.044813379041486,3
2020-04-03-170910,170910,2,0,1,12,1.0,20.659163645918103,4
2020-04-04-170910,170910,0,0,0,12,0.5714285714285714,21.71938207868759,5
2020-04-05-170910,170910,1,1,0,13,0.0,22.785716723899366,6
2020-04-06-170910,170910,2,1,0,15,1.1428571428571428,25.163384997808343,0
2020-04-07-170910,170910,2,0,0,17,1.1428571428571428,32.24970567452885,1
2020-04-08-170910,170910,0,0,0,17,1.4285714285714286,38.09157349412722,2
2020-04-09-170910,170910,0,1,0,17,0.5714285714285714,39.38687748957072,3
2020-04-10-170910,170910,1,0,1,18,0.8571428571428571,9.09100817153406,4
2020-04-11-170910,170910,0,0,0,18,0.5714285714285714,13.64770985999165,5
2020-04-12-170910,170910,1,0,0,19,0.14285714285714285,14.476995176290998,6
2020-04-13-170910,170910,3,1,0,22,1.2857142857142858,17.447229395315556,0
2020-04-14-170910,170910,3,0,0,25,2.2857142857142856,31.61727159222382,1
2020-04-15-170910,170910,0,0,0,25,1.0,43.34127472386356,2
2020-04-16-170910,170910,0,0,0,25,1.1428571428571428,46.648686954181755,3
2020-04-17-170910,170910,1,0,0,26,0.8571428571428571,45.940804470228095,4
2020-04-18-170910,170910,0,0,0,26,0.2857142857142857,50.24155154034699,5
2020-04-19-170910,170910,0,0,0,26,0.0,50.91256745511954,6
2020-04-20-170910,170910,0,0,0,26,1.0,37.53194844724538,0
2020-04-21-170910,170910,0,0,0,26,2.571428571428572,28.99981709153958,1
2020-04-22-170910,170910,0,0,1,26,0.8571428571428571,38.073974398595624,2
2020-04-23-170910,170910,0,0,0,26,0.14285714285714285,37.941585779935835,3
2020-04-24-170910,170910,1,0,0,27,0.7142857142857143,30.288349306101278,4
2020-04-25-170910,170910,0,0,0,27,0.8571428571428571,37.10342910466303,5
2020-04-26-170910,170910,0,0,0,27,0.2857142857142857,41.740022482740834,6
2020-04-27-170910,170910,0,0,0,27,0.2857142857142857,37.691683674408225,0
2020-04-28-170910,170910,0,0,0,27,1.0,35.126694261115944,1
2020-04-29-170910,170910,0,0,1,27,0.42857142857142855,26.898127644652643,2
2020-04-30-170910,170910,0,0,0,27,0.14285714285714285,33.49378088116963,3
2020-05-01-170910,170910,0,0,0,27,0.0,41.32473979714134,4
2020-05-02-170910,170910,0,0,0,27,0.14285714285714285,19.389173031992044,5
2020-05-03-170910,170910,0,0,0,27,0.14285714285714285,11.723864040697642,6
2020-05-04-170910,170910,0,0,0,27,0.2857142857142857,14.5664359816914,0
2020-05-05-170910,170910,0,0,0,27,0.8571428571428571,13.643577063767896,1
2020-05-06-170910,170910,1,0,1,28,0.8571428571428571,13.703024105039333,2
2020-05-07-170910,170910,0,0,0,28,1.0,15.560774120052606,3
2020-05-08-170910,170910,0,0,1,28,0.7142857142857143,18.619454480409615,4
2020-05-09-170910,170910,0,0,0,28,0.2857142857142857,21.903525871752628,5
2020-05-10-170910,170910,0,0,0,28,0.14285714285714285,38.58935620210997,6
2020-05-11-170910,170910,0,0,0,28,0.5714285714285714,35.64176626946104,0
2020-05-12-170910,170910,0,0,0,28,0.5714285714285714,40.16101164264424,1
2020-05-13-170910,170910,1,0,0,29,0.8571428571428571,33.0523396132939,2
2020-05-14-170910,170910,0,0,1,29,1.2857142857142858,26.671086333525285,3
2020-05-15-170910,170910,0,0,1,29,0.14285714285714285,26.433418642611652,4
2020-05-16-170910,170910,0,0,0,29,0.14285714285714285,23.317167003943467,5
2020-05-17-170910,170910,0,0,1,29,0.14285714285714285,23.707020338050146,6
2020-05-18-170910,170910,0,0,0,29,0.42857142857142855,21.689905796443647,0
2020-05-19-170910,170910,0,0,0,29,0.42857142857142855,23.639023175382448,1
2020-05-20-170910,170910,1,0,0,30,0.2857142857142857,16.131871797852263,2
2020-05-21-170910,170910,0,0,0,30,0.2857142857142857,15.193795851467804,3
2020-05-22-170910,170910,1,0,0,31,0.42857142857142855,15.529792893790862,4
2020-05-23-170910,170910,0,0,0,31,0.14285714285714285,20.332991466310887,5
2020-05-24-170910,170910,0,0,0,31,0.0,21.150337856451817,6
2020-05-25-170910,170910,0,0,1,31,0.42857142857142855,14.058727595157574,0
2020-05-26-170910,170910,0,0,1,31,0.2857142857142857,14.720975207120796,1
2020-05-27-170910,170910,0,1,0,31,0.2857142857142857,15.55072293210512,2
2020-05-28-170910,170910,1,0,0,32,0.14285714285714285,13.937410023811058,3
2020-05-29-170910,170910,1,0,0,33,0.14285714285714285,18.19308020463831,4
2020-05-30-170910,170910,0,0,0,33,0.14285714285714285,18.711966796241633,5
2020-05-31-170910,170910,1,0,0,34,0.14285714285714285,20.04978661470396,6
2020-06-01-170910,170910,0,0,0,34,0.5714285714285714,38.39015036408287,0
2020-06-02-170910,170910,0,0,0,34,0.14285714285714285,8.364925769557416,1
2020-06-03-170910,170910,0,0,0,34,0.0,9.064946579103271,2
2020-06-04-170910,170910,0,0,0,34,0.0,6.97603802754427,3
2020-06-05-170910,170910,0,0,0,34,0.2857142857142857,6.2831755182024445,4
2020-06-06-170910,170910,0,0,0,34,0.0,7.259030292038717,5
2020-06-07-170910,170910,0,0,0,34,0.0,7.18853790319267,6
2020-06-08-170910,170910,1,0,0,35,0.42857142857142855,7.17578289017813,0
2020-06-09-170910,170910,1,0,1,36,0.5714285714285714,11.053363832580972,1
2020-06-10-170910,170910,0,0,0,36,0.7142857142857143,35.247128832869635,2
2020-06-11-170910,170910,0,0,0,36,0.2857142857142857,37.10913167694257,3
2020-06-12-170910,170910,0,0,0,36,0.2857142857142857,36.70724040069874,4
2020-06-13-170910,170910,0,0,0,36,0.0,29.291845963642487,5
2020-06-14-170910,170910,0,0,0,36,0.14285714285714285,18.177248216788858,6
2020-06-15-170910,170910,0,0,0,36,0.42857142857142855,17.46850616862381,0
2020-06-16-170910,170910,0,0,0,36,0.0,17.831554600249675,1
2020-06-17-170910,170910,0,0,0,36,0.0,12.997740614346402,2
2020-06-18-170910,170910,0,0,0,36,0.0,9.40094895163648,3
2020-06-19-170910,170910,0,0,0,36,0.0,8.384880388079193,4
2020-06-20-170910,170910,0,0,0,36,0.0,9.432647253115093,5
2020-06-21-170910,170910,0,0,0,36,0.0,6.938716068963149,6
2020-06-22-170910,170910,0,0,1,36,0.14285714285714285,5.3642186066115976,0
2020-06-23-170910,170910,1,0,0,37,0.2857142857142857,5.32261241200922,1
2020-06-24-170910,170910,0,0,0,37,0.2857142857142857,8.902950487091005,2
2020-06-25-170910,170910,0,0,0,37,0.42857142857142855,9.356353006677555,3
2020-06-26-170910,170910,0,0,0,37,0.14285714285714285,10.667438160736953,4
2020-06-27-170910,170910,0,0,1,37,0.0,10.190439993593207,5
2020-06-28-170910,170910,0,0,0,37,0.0,10.63460759012446,6
2020-06-29-170910,170910,0,0,0,37,0.14285714285714285,10.558990278363185,0
2020-06-30-170910,170910,0,0,0,37,0.2857142857142857,8.357142123947433,1
2020-07-01-170910,170910,0,0,0,37,0.14285714285714285,19.404610545615128,2
2020-07-02-170910,170910,0,0,1,37,0.0,15.31130837844515,3
2020-07-03-170910,170910,0,0,0,37,0.14285714285714285,8.680506373554314,4
2020-07-04-170910,170910,0,0,0,37,0.0,8.808608551740724,5
2020-07-05-170910,170910,0,0,1,37,0.0,8.721078702761005,6
2020-07-06-170910,170910,1,0,0,38,0.0,8.30604846336656,0
2020-07-07-170910,170910,0,0,1,38,0.0,7.42945543505893,1
2020-07-08-170910,170910,0,0,1,38,0.2857142857142857,7.18637706295399,2
2020-07-09-170910,170910,0,0,0,38,0.14285714285714285,7.551679184627521,3
2020-07-10-170910,170910,0,0,0,38,0.2857142857142857,17.39746336642358,4
2020-07-11-170910,170910,1,0,0,39,0.14285714285714285,18.476184616266416,5
2020-07-12-170910,170910,0,0,0,39,0.0,18.641406853934953,6
2020-07-13-170910,170910,0,0,1,39,0.0,18.433639940904435,0
2020-07-14-170910,170910,0,0,2,39,0.0,18.360005259486446,1
2020-07-15-170910,170910,0,0,0,39,0.14285714285714285,12.874569400291895,2
2020-07-16-170910,170910,1,0,2,40,0.0,8.537340273420638,3
2020-07-17-170910,170910,0,0,1,40,0.2857142857142857,11.298239914204652,4
2020-07-18-170910,170910,0,0,0,40,0.0,13.307259974374205,5
2020-07-19-170910,170910,1,0,0,41,0.14285714285714285,10.154624215111264,6
2020-07-20-170910,170910,0,0,0,41,0.0,14.661348185065114,0
2020-07-21-170910,170910,1,0,0,42,0.2857142857142857,15.03929564613569,1
2020-07-22-170910,170910,1,0,0,43,0.0,19.47698062752805,2
2020-07-23-170910,170910,0,0,0,43,0.2857142857142857,15.884168927986778,3
2020-07-24-170910,170910,0,0,0,43,0.0,13.39358971069186,4
2020-07-25-170910,170910,0,0,0,43,0.0,13.612665782209973,5
2020-07-26-170910,170910,0,0,0,43,0.0,9.486451399161087,6
2020-07-27-170910,170910,1,0,0,44,0.0,9.230901646359877,0
2020-07-28-170910,170910,2,0,1,46,0.0,9.338624414345233,1
2020-07-29-170910,170910,0,0,1,46,0.0,8.11040398315541,2
2020-07-30-170910,170910,2,0,1,48,0.0,7.534817397236684,3
2020-07-31-170910,170910,1,0,0,49,0.14285714285714285,7.684299808422601,4
2020-08-01-170910,170910,0,0,0,49,0.0,7.517084093728382,5
2020-08-02-170910,170910,0,0,0,49,0.2857142857142857,26.70372975334768,6
2020-08-03-170910,170910,0,0,0,49,0.14285714285714285,81.3457820446092,0
2020-08-04-170910,170910,0,0,0,49,0.2857142857142857,60.25466179406118,1
2020-08-05-170910,170910,0,0,0,49,0.2857142857142857,52.16740674259628,2
2020-08-06-170910,170910,0,1,1,49,0.2857142857142857,37.16551308914207,3
2020-08-07-170910,170910,0,0,3,49,0.14285714285714285,32.03790569591362,4
2020-08-08-170910,170910,0,1,2,49,0.14285714285714285,26.10884638016944,5
2020-08-09-170910,170910,0,0,0,49,0.42857142857142855,24.4724711014061,6
2020-08-10-170910,170910,0,0,2,49,0.42857142857142855,7.416048761892414,0
2020-08-11-170910,170910,1,0,4,50,0.2857142857142857,10.35532358188615,1
2020-08-12-170910,170910,1,0,1,51,0.0,16.218548672160942,2
2020-08-13-170910,170910,1,0,6,52,0.5714285714285714,17.362692923915873,3
2020-08-14-170910,170910,0,0,2,52,0.14285714285714285,20.94017762289053,4
2020-08-15-170910,170910,0,0,0,52,0.0,22.484257090286466,5
2020-08-16-170910,170910,0,0,0,52,0.0,23.351242743345562,6
2020-08-17-170910,170910,0,0,0,52,0.2857142857142857,26.307872633523942,0
2020-08-18-170910,170910,0,0,0,52,0.0,31.917495953426695,1
2020-08-19-170910,170910,0,0,2,52,0.2857142857142857,27.90733580945137,2
2020-08-20-170910,170910,1,0,2,53,0.8571428571428571,27.679803197422288,3
2020-08-21-170910,170910,3,0,2,56,1.2857142857142858,31.39400263368516,4
2020-08-22-170910,170910,2,0,0,58,0.14285714285714285,43.10815869912208,5
2020-08-23-170910,170910,0,0,0,58,0.0,47.44101405213283,6
2020-08-24-170910,170910,2,0,5,60,0.14285714285714285,41.14583684131824,0
2020-08-25-170910,170910,4,0,2,64,2.2857142857142856,51.065310292838745,1
2020-08-26-170910,170910,1,0,4,65,1.4285714285714286,70.0313911411673,2
2020-08-27-170910,170910,6,0,0,71,1.2857142857142858,77.43637231624604,3
2020-08-28-170910,170910,2,0,3,73,0.7142857142857143,87.11190195641294,4
2020-08-29-170910,170910,0,0,0,73,1.2857142857142858,80.466828031,5
2020-08-30-170910,170910,0,0,0,73,0.5714285714285714,79.5009758635604,6
2020-08-31-170910,170910,0,0,0,73,1.0,70.54195907146016,0
2020-09-01-170910,170910,0,0,1,73,0.2857142857142857,17.89894530588589,1
2020-09-02-170910,170910,2,0,1,75,1.0,87.33416273430215,2
2020-09-03-170910,170910,2,0,0,77,0.5714285714285714,222.69010967348956,3
2020-09-04-170910,170910,2,0,2,79,1.8571428571428568,200.8296661236717,4
2020-09-05-170910,170910,0,0,0,79,0.0,77.8114491426312,5
2020-09-06-170910,170910,0,0,1,79,0.2857142857142857,73.51321197895001,6
2020-09-07-170910,170910,5,0,3,84,0.7142857142857143,61.32970747621076,0
2020-09-08-170910,170910,2,0,2,86,0.0,77.19747679667628,1
2020-09-09-170910,170910,4,0,9,90,2.8571428571428568,86.03360153930005,2
2020-09-10-170910,170910,0,0,2,90,1.8571428571428568,13.819571641732667,3
2020-09-11-170910,170910,3,0,44,93,1.7142857142857142,22.948826172493938,4
2020-09-12-170910,170910,0,0,3,93,0.8571428571428571,41.61460144299414,5
2020-09-13-170910,170910,0,0,0,93,0.2857142857142857,48.26286858852613,6
2020-09-14-170910,170910,0,0,0,93,1.1428571428571428,51.063878196124094,0
2020-09-15-170910,170910,1,0,2,94,0.7142857142857143,61.8224143281836,1
2020-09-16-170910,170910,1,0,8,95,1.5714285714285714,70.71844996477608,2
2020-09-17-170910,170910,0,0,1,95,3.0,74.51386627408273,3
2020-09-18-170910,170910,2,0,0,97,2.142857142857143,87.16595743258675,4
2020-09-19-170910,170910,0,0,1,97,0.7142857142857143,82.38519393831002,5
2020-09-20-170910,170910,1,1,3,98,0.2857142857142857,82.99116095879646,6
2020-09-21-170910,170910,3,0,2,101,2.7142857142857144,75.84588264350313,0
2020-09-22-170910,170910,2,1,1,103,2.8571428571428568,81.38270740706619,1
2020-09-23-170910,170910,9,0,6,112,3.4285714285714284,88.13122951021921,2
2020-09-24-170910,170910,2,0,2,114,10.428571428571429,86.09489307443522,3
2020-09-25-170910,170910,44,1,1,158,2.7142857142857144,91.65764966616143,4
2020-09-26-170910,170910,3,0,2,161,0.2857142857142857,206.1245568399112,5
2020-09-27-170910,170910,0,0,0,161,0.7142857142857143,207.96571111882616,6
2020-09-28-170910,170910,0,0,0,161,1.2857142857142858,215.20396392024884,0
2020-09-29-170910,170910,2,1,1,163,2.8571428571428568,208.03647882646814,1
2020-09-30-170910,170910,8,0,0,171,2.2857142857142856,181.64690790172784,2
2020-10-01-170910,170910,1,0,1,172,2.8571428571428568,0.0,3
2020-10-02-170910,170910,0,1,2,172,4.0,242.34327030157715,4
2020-10-03-170910,170910,1,0,0,173,2.8571428571428568,201.19704894594594,5
2020-10-04-170910,170910,3,0,3,176,0.42857142857142855,154.1949215119448,6
2020-10-05-170910,170910,2,2,6,178,1.8571428571428568,137.04616965172764,0
2020-10-06-170910,170910,1,0,0,179,1.4285714285714286,122.93800223497358,1
2020-10-07-170910,170910,6,0,2,185,2.2857142857142856,108.87830623574209,2
2020-10-08-170910,170910,2,0,5,187,2.8571428571428568,106.4006664762149,3
2020-10-09-170910,170910,1,1,0,188,3.2857142857142856,127.1039961931025,4
2020-10-10-170910,170910,2,0,0,190,1.5714285714285714,11.637776593807747,5
2020-10-11-170910,170910,0,0,1,190,0.42857142857142855,25.13193439106556,6
2020-10-12-170910,170910,0,0,0,190,1.8571428571428568,39.786457983496405,0
2020-10-13-170910,170910,1,0,1,191,3.4285714285714284,57.9917588931544,1
2020-10-14-170910,170910,0,0,1,191,3.7142857142857135,89.79221588142865,2
2020-10-15-170910,170910,1,0,4,192,8.571428571428571,111.16786677916619,3
2020-10-16-170910,170910,2,0,2,194,4.142857142857143,153.15496506598797,4
2020-10-17-170910,170910,0,0,0,194,3.8571428571428568,166.39274367802545,5
2020-10-18-170910,170910,3,1,0,197,2.2857142857142856,179.79538508379446,6
2020-10-19-170910,170910,6,0,0,203,4.0,198.8739570757379,0
2020-10-20-170910,170910,0,0,0,203,4.428571428571429,225.48382790090352,1
2020-10-21-170910,170910,2,1,2,205,6.2857142857142865,230.23699619247418,2
2020-10-22-170910,170910,5,0,2,210,3.8571428571428568,245.97242460491094,3
2020-10-23-170910,170910,0,0,4,210,9.571428571428571,266.07529746894727,4
2020-10-24-170910,170910,0,0,0,210,0.7142857142857143,290.70551443938615,5
2020-10-25-170910,170910,1,2,0,211,3.0,258.18274389846505,6
2020-10-26-170910,170910,0,0,1,211,4.142857142857143,219.58708207017753,0
2020-10-27-170910,170910,1,0,3,212,1.2857142857142858,226.88082459334575,1
2020-10-28-170910,170910,1,0,0,213,2.0,217.4612111002768,2
2020-10-29-170910,170910,4,0,1,217,4.428571428571429,186.82690448281664,3
2020-10-30-170910,170910,2,0,1,219,3.8571428571428568,126.49143728479334,4
2020-10-31-170910,170910,0,0,0,219,1.0,153.64739155647055,5
2020-11-01-170910,170910,0,0,0,219,3.4285714285714284,100.91499600412891,6
2020-11-02-170910,170910,0,0,0,219,1.2857142857142858,204.50560364325602,0
2020-11-03-170910,170910,0,0,0,219,3.4285714285714284,180.23292320985684,1
2020-11-04-170910,170910,2,0,0,221,2.2857142857142856,182.5359302266078,2
2020-11-05-170910,170910,2,0,0,223,4.857142857142857,194.50089990719312,3
2020-11-06-170910,170910,4,1,0,227,7.2857142857142865,184.44188162341436,4
2020-11-07-170910,170910,0,0,0,227,2.8571428571428568,177.6746891411644,5
2020-11-08-170910,170910,0,0,0,227,1.0,162.67634969545588,6
2020-11-09-170910,170910,1,0,0,228,6.428571428571429,150.40023638053015,0
2020-11-10-170910,170910,3,1,0,231,4.428571428571429,97.7987817831355,1
2020-11-11-170910,170910,0,1,0,231,4.428571428571429,106.961186461994,2
2020-11-12-170910,170910,1,0,0,232,7.142857142857142,118.3903415974791,3
2020-11-13-170910,170910,1,0,0,233,7.7142857142857135,138.54748444177818,4
2020-03-01-170913,170913,0,0,2,0,0.0,0.0,6
2020-03-02-170913,170913,0,0,0,0,0.0,11.999011606168146,0
2020-03-03-170913,170913,0,2,2,0,0.0,68.14952639028866,1
2020-03-04-170913,170913,0,0,2,0,0.0,70.86965781318206,2
2020-03-05-170913,170913,0,0,1,0,0.0,71.58616317466597,3
2020-03-06-170913,170913,0,0,7,0,0.14285714285714285,63.10044878812114,4
2020-03-07-170913,170913,0,0,3,0,0.0,69.08497972315416,5
2020-03-08-170913,170913,0,0,2,0,0.0,67.94191058232373,6
2020-03-09-170913,170913,0,0,7,0,0.14285714285714285,68.51926312191813,0
2020-03-10-170913,170913,1,0,6,1,0.14285714285714285,345.14833891491935,1
2020-03-11-170913,170913,0,0,5,1,0.14285714285714285,274.56915895239206,2
2020-03-12-170913,170913,0,0,5,1,0.14285714285714285,198.88517000544994,3
2020-03-13-170913,170913,1,0,3,2,0.2857142857142857,116.03334907395552,4
2020-03-14-170913,170913,0,0,0,2,0.14285714285714285,83.83664210788015,5
2020-03-15-170913,170913,2,0,1,4,0.2857142857142857,63.27687568261065,6
2020-03-16-170913,170913,0,0,3,4,2.7142857142857144,20.423067820104336,0
2020-03-17-170913,170913,2,0,4,6,1.2857142857142858,41.19292020173802,1
2020-03-18-170913,170913,2,4,4,8,2.4285714285714284,51.083399085590415,2
2020-03-19-170913,170913,1,0,1,9,2.571428571428572,60.3954205572968,3
2020-03-20-170913,170913,7,0,4,16,2.4285714285714284,65.96592243896444,4
2020-03-21-170913,170913,3,0,3,19,1.0,87.26266508501166,5
2020-03-22-170913,170913,2,0,3,21,0.8571428571428571,89.20021770174871,6
2020-03-23-170913,170913,7,0,2,28,4.571428571428571,85.85971714198452,0
2020-03-24-170913,170913,6,0,5,34,2.142857142857143,86.57736703467863,1
2020-03-25-170913,170913,5,0,2,39,2.8571428571428568,97.67031569834322,2
2020-03-26-170913,170913,5,0,1,44,3.571428571428572,103.36091857321512,3
2020-03-27-170913,170913,3,0,2,47,3.4285714285714284,126.20939747318094,4
2020-03-28-170913,170913,0,0,0,47,1.1428571428571428,123.48431412908762,5
2020-03-29-170913,170913,1,0,1,48,1.7142857142857142,117.48197629013211,6
2020-03-30-170913,170913,3,0,3,51,2.2857142857142856,91.3673995772048,0
2020-03-31-170913,170913,4,0,3,55,1.5714285714285714,82.73013362375667,1
2020-04-01-170913,170913,4,0,2,59,3.0,14.138295592624395,2
2020-04-02-170913,170913,1,0,2,60,5.285714285714286,70.5460345259023,3
2020-04-03-170913,170913,4,0,3,64,1.8571428571428568,30.629371926137736,4
2020-04-04-170913,170913,3,0,0,67,0.2857142857142857,41.058277871151105,5
2020-04-05-170913,170913,3,0,1,70,0.5714285714285714,45.643609360326835,6
2020-04-06-170913,170913,2,0,2,72,2.8571428571428568,51.319040876526536,0
2020-04-07-170913,170913,5,0,2,77,5.0,60.865283842557936,1
2020-04-08-170913,170913,2,0,1,79,2.2857142857142856,76.71533824258648,2
2020-04-09-170913,170913,1,4,1,80,3.0,79.53666460521718,3
2020-04-10-170913,170913,2,0,1,82,1.5714285714285714,14.641651030987788,4
2020-04-11-170913,170913,0,0,0,82,0.2857142857142857,19.772157647248672,5
2020-04-12-170913,170913,1,0,0,83,0.42857142857142855,21.860738768932663,6
2020-04-13-170913,170913,3,0,0,86,2.142857142857143,24.929755112079327,0
2020-04-14-170913,170913,3,0,0,89,1.7142857142857142,45.16590916232855,1
2020-04-15-170913,170913,2,0,1,91,2.7142857142857144,58.87125892094158,2
2020-04-16-170913,170913,2,0,1,93,1.8571428571428568,67.96528757117652,3
2020-04-17-170913,170913,3,0,0,96,1.2857142857142858,71.12246284090824,4
2020-04-18-170913,170913,0,0,0,96,0.5714285714285714,84.32275025821579,5
2020-04-19-170913,170913,1,0,0,97,0.14285714285714285,84.04438508474283,6
2020-04-20-170913,170913,2,0,0,99,1.2857142857142858,70.85384599898441,0
2020-04-21-170913,170913,2,0,0,101,3.7142857142857135,66.36401027386404,1
2020-04-22-170913,170913,1,0,3,102,1.0,98.5941610730209,2
2020-04-23-170913,170913,1,1,2,103,0.0,95.4886966745785,3
2020-04-24-170913,170913,1,0,1,104,1.4285714285714286,79.30222284224767,4
2020-04-25-170913,170913,0,0,1,104,0.42857142857142855,84.91844964644292,5
2020-04-26-170913,170913,0,0,0,104,0.14285714285714285,87.58902363552782,6
2020-04-27-170913,170913,0,0,3,104,1.0,73.31005958400122,0
2020-04-28-170913,170913,0,0,1,104,1.4285714285714286,69.10582171659536,1
2020-04-29-170913,170913,1,0,0,105,2.142857142857143,35.317495307593816,2
2020-04-30-170913,170913,1,0,1,106,1.1428571428571428,51.31547464908761,3
2020-05-01-170913,170913,0,0,0,106,0.2857142857142857,88.0008540082763,4
2020-05-02-170913,170913,0,0,0,106,0.0,35.81294864055029,5
2020-05-03-170913,170913,0,0,0,106,0.2857142857142857,23.453587989053336,6
2020-05-04-170913,170913,0,0,0,106,1.5714285714285714,21.326718079754215,0
2020-05-05-170913,170913,0,0,0,106,0.7142857142857143,25.21898835540337,1
2020-05-06-170913,170913,3,0,0,109,2.571428571428572,26.902532245041716,2
2020-05-07-170913,170913,2,0,0,111,1.4285714285714286,33.66102252838577,3
2020-05-08-170913,170913,1,0,0,112,1.1428571428571428,39.19794555631613,4
2020-05-09-170913,170913,1,1,0,113,0.2857142857142857,50.18628573498735,5
2020-05-10-170913,170913,0,0,0,113,0.42857142857142855,98.8702719924947,6
2020-05-11-170913,170913,3,0,0,116,0.7142857142857143,91.36165923033377,0
2020-05-12-170913,170913,1,1,0,117,1.0,94.55885270474464,1
2020-05-13-170913,170913,0,0,0,117,1.5714285714285714,89.5696365658747,2
2020-05-14-170913,170913,1,1,1,118,0.8571428571428571,68.151821474119,3
2020-05-15-170913,170913,0,0,0,118,0.2857142857142857,65.54428967633038,4
2020-05-16-170913,170913,0,0,0,118,0.2857142857142857,57.267108960491555,5
2020-05-17-170913,170913,0,0,0,118,0.0,57.41740719422382,6
2020-05-18-170913,170913,0,1,1,118,1.2857142857142858,55.87398856195493,0
2020-05-19-170913,170913,0,0,0,118,0.7142857142857143,55.917546426913454,1
2020-05-20-170913,170913,0,0,1,118,0.14285714285714285,32.25002255836571,2
2020-05-21-170913,170913,0,0,0,118,0.5714285714285714,25.392210818998876,3
2020-05-22-170913,170913,0,0,0,118,0.7142857142857143,25.56153832169417,4
2020-05-23-170913,170913,0,1,0,118,0.0,32.65220331176684,5
2020-05-24-170913,170913,0,0,0,118,0.14285714285714285,33.647984169102585,6
2020-05-25-170913,170913,0,0,0,118,1.2857142857142858,24.06849988249564,0
2020-05-26-170913,170913,0,0,0,118,0.42857142857142855,27.27133444466001,1
2020-05-27-170913,170913,0,0,0,118,0.5714285714285714,30.134248526209067,2
2020-05-28-170913,170913,1,2,0,119,0.5714285714285714,29.654010700624163,3
2020-05-29-170913,170913,0,0,0,119,1.0,38.16229686957318,4
2020-05-30-170913,170913,0,0,0,119,0.42857142857142855,40.2039731230063,5
2020-05-31-170913,170913,0,1,0,119,0.2857142857142857,43.04471666209653,6
2020-06-01-170913,170913,1,0,0,120,2.2857142857142856,75.21637706909975,0
2020-06-02-170913,170913,0,0,0,120,0.7142857142857143,23.06768687537707,1
2020-06-03-170913,170913,1,0,0,121,1.1428571428571428,14.962862835356503,2
2020-06-04-170913,170913,0,0,0,121,0.42857142857142855,19.11121220586883,3
2020-06-05-170913,170913,0,0,0,121,0.7142857142857143,20.060776099515007,4
2020-06-06-170913,170913,0,0,0,121,0.0,23.11917434685911,5
2020-06-07-170913,170913,0,0,0,121,0.14285714285714285,22.71181697104182,6
2020-06-08-170913,170913,0,0,0,121,0.5714285714285714,22.732116370163403,0
2020-06-09-170913,170913,0,0,0,121,1.2857142857142858,24.378023742472102,1
2020-06-10-170913,170913,0,0,0,121,1.0,92.78666904189281,2
2020-06-11-170913,170913,0,0,0,121,0.7142857142857143,93.05790672698326,3
2020-06-12-170913,170913,0,0,0,121,1.0,92.16173222437735,4
2020-06-13-170913,170913,0,1,0,121,0.14285714285714285,73.83405515401155,5
2020-06-14-170913,170913,0,0,0,121,0.14285714285714285,56.89795076308105,6
2020-06-15-170913,170913,0,0,0,121,1.0,46.4930499215553,0
2020-06-16-170913,170913,0,0,0,121,1.4285714285714286,47.51142250585358,1
2020-06-17-170913,170913,0,0,0,121,0.8571428571428571,32.71685279213656,2
2020-06-18-170913,170913,0,0,0,121,0.8571428571428571,25.92996068468158,3
2020-06-19-170913,170913,0,0,0,121,0.7142857142857143,25.084109488248508,4
2020-06-20-170913,170913,0,0,0,121,0.14285714285714285,29.870702911497332,5
2020-06-21-170913,170913,0,0,0,121,0.0,28.40704093447048,6
2020-06-22-170913,170913,0,0,0,121,0.5714285714285714,24.186685624082045,0
2020-06-23-170913,170913,0,0,0,121,0.5714285714285714,19.929318941964198,1
2020-06-24-170913,170913,0,0,0,121,0.2857142857142857,21.086724132717812,2
2020-06-25-170913,170913,0,0,0,121,0.14285714285714285,19.32638720234321,3
2020-06-26-170913,170913,0,0,0,121,0.0,18.28488586366683,4
2020-06-27-170913,170913,0,0,0,121,0.0,14.941947736339031,5
2020-06-28-170913,170913,0,0,0,121,0.0,15.013775537668959,6
2020-06-29-170913,170913,0,0,0,121,0.5714285714285714,15.220539461502682,0
2020-06-30-170913,170913,0,0,0,121,0.42857142857142855,20.66624629148661,1
2020-07-01-170913,170913,0,0,0,121,0.42857142857142855,30.661869827500006,2
2020-07-02-170913,170913,0,0,1,121,0.14285714285714285,14.095756756635943,3
2020-07-03-170913,170913,0,0,0,121,0.0,23.62663265537798,4
2020-07-04-170913,170913,0,0,0,121,0.0,17.86025226771006,5
2020-07-05-170913,170913,0,0,0,121,0.14285714285714285,17.817840308182475,6
2020-07-06-170913,170913,0,0,0,121,0.2857142857142857,16.678497284747618,0
2020-07-07-170913,170913,0,0,0,121,0.14285714285714285,16.16684799258578,1
2020-07-08-170913,170913,0,0,0,121,0.0,15.351097565775124,2
2020-07-09-170913,170913,0,0,0,121,0.14285714285714285,15.68492561326099,3
2020-07-10-170913,170913,0,1,0,121,0.14285714285714285,31.096013663847593,4
2020-07-11-170913,170913,0,0,0,121,0.0,29.36698873299393,5
2020-07-12-170913,170913,0,0,0,121,0.0,25.567340575891084,6
2020-07-13-170913,170913,0,0,0,121,0.14285714285714285,25.768174445836827,0
2020-07-14-170913,170913,0,0,0,121,0.14285714285714285,26.529657326697,1
2020-07-15-170913,170913,0,0,0,121,0.42857142857142855,20.11792354700548,2
2020-07-16-170913,170913,1,0,0,122,0.14285714285714285,12.488097496754236,3
2020-07-17-170913,170913,0,0,0,122,0.5714285714285714,12.628434413597278,4
2020-07-18-170913,170913,0,1,0,122,0.0,14.658095628587198,5
2020-07-19-170913,170913,0,0,0,122,0.0,12.146736106433764,6
2020-07-20-170913,170913,0,0,0,122,0.14285714285714285,14.470209952370382,0
2020-07-21-170913,170913,0,0,0,122,0.8571428571428571,14.235431722219102,1
2020-07-22-170913,170913,0,0,0,122,0.2857142857142857,24.416884221107356,2
2020-07-23-170913,170913,0,0,0,122,1.0,23.514370261257763,3
2020-07-24-170913,170913,0,0,1,122,0.14285714285714285,32.31545626064039,4
2020-07-25-170913,170913,0,0,0,122,0.0,33.386905252319586,5
2020-07-26-170913,170913,0,0,0,122,0.0,31.105632394530407,6
2020-07-27-170913,170913,0,0,1,122,0.7142857142857143,29.885262598376027,0
2020-07-28-170913,170913,0,0,1,122,0.7142857142857143,31.977950899685062,1
2020-07-29-170913,170913,0,0,0,122,0.42857142857142855,23.83057625513246,2
2020-07-30-170913,170913,0,0,0,122,0.5714285714285714,12.564402498872887,3
2020-07-31-170913,170913,0,0,2,122,0.42857142857142855,14.008282839721744,4
2020-08-01-170913,170913,0,0,0,122,0.0,13.569266297378928,5
2020-08-02-170913,170913,0,0,2,122,0.42857142857142855,72.69770497281115,6
2020-08-03-170913,170913,0,0,8,122,0.14285714285714285,134.16371429699058,0
2020-08-04-170913,170913,0,0,2,122,0.42857142857142855,120.06849889885329,1
2020-08-05-170913,170913,0,0,2,122,1.5714285714285714,104.44641118321724,2
2020-08-06-170913,170913,0,0,1,122,0.14285714285714285,83.02436535525709,3
2020-08-07-170913,170913,1,0,0,123,0.2857142857142857,61.44542451520982,4
2020-08-08-170913,170913,0,0,0,123,0.5714285714285714,60.072871241239355,5
2020-08-09-170913,170913,0,0,0,123,0.0,57.235017196083746,6
2020-08-10-170913,170913,1,0,0,124,0.7142857142857143,9.93128028905608,0
2020-08-11-170913,170913,1,0,2,125,1.1428571428571428,14.2603114061808,1
2020-08-12-170913,170913,0,0,0,125,0.2857142857142857,23.0312977211196,2
2020-08-13-170913,170913,0,0,1,125,0.7142857142857143,26.49414280092719,3
2020-08-14-170913,170913,2,0,0,127,1.1428571428571428,33.81167183124801,4
2020-08-15-170913,170913,0,0,0,127,0.2857142857142857,44.687712925108556,5
2020-08-16-170913,170913,2,0,1,129,0.2857142857142857,46.043357792471156,6
2020-08-17-170913,170913,8,0,4,137,0.7142857142857143,54.98179772781619,0
2020-08-18-170913,170913,2,0,3,139,0.8571428571428571,66.64354800489153,1
2020-08-19-170913,170913,2,0,1,141,0.7142857142857143,64.85489404937098,2
2020-08-20-170913,170913,1,0,1,142,2.8571428571428568,64.22080805446356,3
2020-08-21-170913,170913,0,0,4,142,1.1428571428571428,72.58055709178865,4
2020-08-22-170913,170913,0,0,0,142,0.7142857142857143,76.6339856955668,5
2020-08-23-170913,170913,0,0,0,142,0.2857142857142857,76.68868855961738,6
2020-08-24-170913,170913,0,0,6,142,2.0,64.82173035433635,0
2020-08-25-170913,170913,2,0,1,144,3.4285714285714284,72.03131342239735,1
2020-08-26-170913,170913,0,0,0,144,2.8571428571428568,87.73470022322971,2
2020-08-27-170913,170913,1,0,0,145,1.7142857142857142,104.24103969400463,3
2020-08-28-170913,170913,0,0,0,145,3.571428571428572,109.27506783253486,4
2020-08-29-170913,170913,0,0,4,145,1.7142857142857142,123.69974698270983,5
2020-08-30-170913,170913,1,0,0,146,2.8571428571428568,125.97309298197375,6
2020-08-31-170913,170913,4,0,0,150,0.8571428571428571,117.10450965784094,0
2020-09-01-170913,170913,3,0,1,153,1.4285714285714286,47.914698169702866,1
2020-09-02-170913,170913,1,0,0,154,3.0,168.40869962080015,2
2020-09-03-170913,170913,1,0,2,155,1.8571428571428568,235.49919220865488,3
2020-09-04-170913,170913,4,0,1,159,2.0,215.11239331818248,4
2020-09-05-170913,170913,0,0,0,159,0.2857142857142857,144.44825928350366,5
2020-09-06-170913,170913,0,0,0,159,1.1428571428571428,128.6801478376873,6
2020-09-07-170913,170913,6,0,1,165,1.8571428571428568,91.57896391457822,0
2020-09-08-170913,170913,1,0,8,166,1.7142857142857142,116.25160648706917,1
2020-09-09-170913,170913,0,0,5,166,1.4285714285714286,119.51343749505514,2
2020-09-10-170913,170913,0,0,1,166,0.8571428571428571,42.42577603707241,3
2020-09-11-170913,170913,0,0,2,166,2.2857142857142856,55.19536067821562,4
2020-09-12-170913,170913,4,0,1,170,1.0,74.43303920928402,5
2020-09-13-170913,170913,0,0,2,170,0.42857142857142855,92.6196349617453,6
2020-09-14-170913,170913,0,0,1,170,3.4285714285714284,94.7755290042929,0
2020-09-15-170913,170913,1,0,0,171,1.1428571428571428,121.01143103942212,1
2020-09-16-170913,170913,0,0,1,171,2.571428571428572,137.10429391635637,2
2020-09-17-170913,170913,2,0,2,173,4.714285714285714,136.15115747472885,3
2020-09-18-170913,170913,1,0,3,174,2.2857142857142856,167.84270941543272,4
2020-09-19-170913,170913,0,0,0,174,2.4285714285714284,170.3769037194021,5
2020-09-20-170913,170913,0,0,0,174,1.1428571428571428,160.90159146673096,6
2020-09-21-170913,170913,1,1,1,175,2.0,136.3622654664436,0
2020-09-22-170913,170913,8,0,3,183,2.8571428571428568,140.34581541412027,1
2020-09-23-170913,170913,5,0,0,188,1.2857142857142858,158.36416696863643,2
2020-09-24-170913,170913,1,0,4,189,3.0,144.40139634305493,3
2020-09-25-170913,170913,2,1,1,191,2.7142857142857144,130.88083263348403,4
2020-09-26-170913,170913,1,0,1,192,1.7142857142857142,204.51815583226244,5
2020-09-27-170913,170913,2,0,9,194,0.5714285714285714,207.88656502115015,6
2020-09-28-170913,170913,1,0,1,195,1.1428571428571428,236.45119226467116,0
2020-09-29-170913,170913,0,0,8,195,1.0,227.73647398921543,1
2020-09-30-170913,170913,1,0,3,196,1.1428571428571428,193.09460973650283,2
2020-10-01-170913,170913,2,0,4,198,3.0,0.0,3
2020-10-02-170913,170913,3,0,6,201,3.571428571428572,349.30340338044005,4
2020-10-03-170913,170913,0,0,6,201,2.4285714285714284,481.5968208463649,5
2020-10-04-170913,170913,0,0,7,201,0.42857142857142855,380.8951257023339,6
2020-10-05-170913,170913,1,0,31,202,3.0,322.1063893569405,0
2020-10-06-170913,170913,3,0,14,205,3.4285714285714284,283.5724951054989,1
2020-10-07-170913,170913,0,1,37,205,2.8571428571428568,227.02050193713183,2
2020-10-08-170913,170913,4,0,34,209,9.571428571428571,204.2895521953344,3
2020-10-09-170913,170913,1,0,31,210,2.7142857142857144,264.08553416203677,4
2020-10-10-170913,170913,1,0,5,211,2.142857142857143,17.99075936542236,5
2020-10-11-170913,170913,9,0,5,220,2.7142857142857144,44.44154057425451,6
2020-10-12-170913,170913,1,0,18,221,1.0,83.76811964217005,0
2020-10-13-170913,170913,8,0,13,229,2.2857142857142856,98.05904988329931,1
2020-10-14-170913,170913,3,0,20,232,8.142857142857142,141.6630410317269,2
2020-10-15-170913,170913,4,0,9,236,1.8571428571428568,187.66891264454227,3
2020-10-16-170913,170913,6,0,22,242,4.714285714285714,245.01753183321495,4
2020-10-17-170913,170913,6,0,4,248,2.8571428571428568,267.8172561638893,5
2020-10-18-170913,170913,7,0,0,255,2.142857142857143,278.8440541647446,6
2020-10-19-170913,170913,31,1,0,286,2.142857142857143,282.88018321676714,0
2020-10-20-170913,170913,14,0,12,300,4.0,365.3524178090357,1
2020-10-21-170913,170913,37,1,12,337,5.857142857142858,376.41166538639516,2
2020-10-22-170913,170913,34,0,13,371,2.2857142857142856,438.1762559447156,3
2020-10-23-170913,170913,31,0,12,402,3.7142857142857135,493.82605086133213,4
2020-10-24-170913,170913,5,0,3,407,2.2857142857142856,584.3919770066636,5
2020-10-25-170913,170913,5,1,2,412,2.7142857142857144,554.5900332667361,6
2020-10-26-170913,170913,18,1,10,430,3.1428571428571432,507.3552654895214,0
2020-10-27-170913,170913,13,0,3,443,6.0,520.815893129863,1
2020-10-28-170913,170913,20,2,4,463,6.142857142857142,514.7621662585898,2
2020-10-29-170913,170913,9,1,4,472,3.7142857142857135,480.749630733569,3
2020-10-30-170913,170913,22,0,1,494,4.285714285714286,321.7801885094008,4
2020-10-31-170913,170913,4,1,0,498,2.571428571428572,375.23564254691127,5
2020-11-01-170913,170913,0,3,0,498,0.7142857142857143,199.97272275684662,6
2020-11-02-170913,170913,0,0,0,498,1.0,302.21042552858205,0
2020-11-03-170913,170913,12,0,0,510,3.8571428571428568,242.86200750277487,1
2020-11-04-170913,170913,12,0,0,522,3.571428571428572,296.5452674959781,2
2020-11-05-170913,170913,13,1,0,535,4.142857142857143,329.5110439008905,3
2020-11-06-170913,170913,12,3,0,547,5.7142857142857135,333.04372726212,4
2020-11-07-170913,170913,3,0,0,550,3.571428571428572,361.5085098704733,5
2020-11-08-170913,170913,2,1,0,552,0.8571428571428571,326.48854218489436,6
2020-11-09-170913,170913,10,1,0,562,2.2857142857142856,311.50218378160577,0
2020-11-10-170913,170913,3,4,0,565,3.4285714285714284,185.1750412396829,1
2020-11-11-170913,170913,4,0,0,569,5.285714285714286,210.01668070022495,2
2020-11-12-170913,170913,4,0,0,573,3.571428571428572,233.44679437391414,3
2020-11-13-170913,170913,1,1,0,574,4.142857142857143,258.54667000558754,4
2020-03-01-170914,170914,0,0,0,0,0.0,0.0,6
2020-03-02-170914,170914,0,0,2,0,0.0,9.030918512399497,0
2020-03-03-170914,170914,0,0,1,0,0.0,40.056638047571,1
2020-03-04-170914,170914,0,0,0,0,0.16666666666666666,44.062793181952586,2
2020-03-05-170914,170914,0,0,0,0,0.0,47.27529172239049,3
2020-03-06-170914,170914,0,0,0,0,0.0,43.14716743005535,4
2020-03-07-170914,170914,0,0,0,0,0.0,46.03916401133992,5
2020-03-08-170914,170914,0,0,0,0,0.0,45.095220056293584,6
2020-03-09-170914,170914,0,0,0,0,0.0,45.04015618440074,0
2020-03-10-170914,170914,0,0,1,0,0.16666666666666666,157.50464246700986,1
2020-03-11-170914,170914,0,0,0,0,0.16666666666666666,128.0133313210103,2
2020-03-12-170914,170914,0,0,0,0,0.0,93.19430870209825,3
2020-03-13-170914,170914,0,0,1,0,0.3333333333333333,52.67267140581755,4
2020-03-14-170914,170914,0,0,0,0,0.0,37.20883098747402,5
2020-03-15-170914,170914,0,0,1,0,0.8333333333333334,29.273003036760677,6
2020-03-16-170914,170914,2,0,4,2,1.1666666666666667,8.83943896445307,0
2020-03-17-170914,170914,1,0,4,3,1.0,21.25465234804209,1
2020-03-18-170914,170914,0,0,0,3,2.833333333333333,28.115335722282765,2
2020-03-19-170914,170914,0,0,0,3,2.1666666666666665,37.38400396185192,3
2020-03-20-170914,170914,0,0,1,3,3.6666666666666665,45.11396893438385,4
2020-03-21-170914,170914,0,0,0,3,2.1666666666666665,53.10165087112131,5
2020-03-22-170914,170914,0,0,0,3,1.1666666666666667,53.43180599080229,6
2020-03-23-170914,170914,0,0,0,3,6.5,46.78187363427584,0
2020-03-24-170914,170914,1,0,3,4,2.333333333333333,59.541464258745194,1
2020-03-25-170914,170914,0,0,0,4,4.333333333333333,62.97675524794568,2
2020-03-26-170914,170914,0,0,0,4,3.0,65.33196898368108,3
2020-03-27-170914,170914,1,0,0,5,2.833333333333333,76.19648553937355,4
2020-03-28-170914,170914,0,0,0,5,0.6666666666666666,78.11968177609549,5
2020-03-29-170914,170914,1,0,0,6,1.0,76.32110194046024,6
2020-03-30-170914,170914,4,0,3,10,3.5,59.199383523692504,0
2020-03-31-170914,170914,4,0,0,14,2.5,61.00190222170404,1
2020-04-01-170914,170914,0,0,0,14,3.6666666666666665,11.525698186888022,2
2020-04-02-170914,170914,0,0,1,14,1.3333333333333333,45.39840811436723,3
2020-04-03-170914,170914,1,0,0,15,2.6666666666666665,23.967040980068788,4
2020-04-04-170914,170914,0,0,0,15,0.6666666666666666,30.353029073928276,5
2020-04-05-170914,170914,0,1,0,15,0.8333333333333334,31.38918475496231,6
2020-04-06-170914,170914,0,0,0,15,3.1666666666666665,33.3516625914187,0
2020-04-07-170914,170914,3,0,1,18,5.666666666666668,37.0005220268263,1
2020-04-08-170914,170914,0,1,0,18,2.0,51.13857571751773,2
2020-04-09-170914,170914,0,0,0,18,3.5,50.66431113117116,3
2020-04-10-170914,170914,0,0,1,18,3.333333333333333,9.383015807572145,4
2020-04-11-170914,170914,0,0,0,18,1.8333333333333333,13.702669499143791,5
2020-04-12-170914,170914,0,0,0,18,0.6666666666666666,17.838675332326257,6
2020-04-13-170914,170914,3,0,1,21,3.5,19.494124490358796,0
2020-04-14-170914,170914,0,0,0,21,3.0,34.17163534035583,1
2020-04-15-170914,170914,0,0,2,21,3.333333333333333,41.28003566105347,2
2020-04-16-170914,170914,1,0,0,22,1.8333333333333333,49.69086930353414,3
2020-04-17-170914,170914,0,0,0,22,2.5,48.78936420913577,4
2020-04-18-170914,170914,0,0,0,22,0.5,51.642282447142364,5
2020-04-19-170914,170914,0,0,0,22,0.5,48.09676885114634,6
2020-04-20-170914,170914,0,0,0,22,2.0,38.835765674393585,0
2020-04-21-170914,170914,1,1,0,23,3.1666666666666665,37.03365652795989,1
2020-04-22-170914,170914,0,0,0,23,1.3333333333333333,37.22661873262277,2
2020-04-23-170914,170914,0,0,0,23,0.5,35.473267303841666,3
2020-04-24-170914,170914,1,0,0,24,2.833333333333333,29.972805792077416,4
2020-04-25-170914,170914,0,0,0,24,0.3333333333333333,35.263549327814786,5
2020-04-26-170914,170914,0,0,0,24,0.16666666666666666,36.51423702710593,6
2020-04-27-170914,170914,1,2,1,25,1.1666666666666667,28.981020950392804,0
2020-04-28-170914,170914,0,0,0,25,1.0,27.927495351231197,1
2020-04-29-170914,170914,2,0,0,27,2.0,21.032187072609943,2
2020-04-30-170914,170914,0,0,0,27,2.0,33.02947968273777,3
2020-05-01-170914,170914,0,0,0,27,0.16666666666666666,54.07046759513923,4
2020-05-02-170914,170914,0,0,0,27,0.16666666666666666,20.924713838627795,5
2020-05-03-170914,170914,0,0,0,27,0.3333333333333333,15.534970986475036,6
2020-05-04-170914,170914,0,0,2,27,2.833333333333333,14.063571608034726,0
2020-05-05-170914,170914,0,0,1,27,1.1666666666666667,18.642374801713252,1
2020-05-06-170914,170914,0,0,0,27,13.5,20.291694562359456,2
2020-05-07-170914,170914,0,0,0,27,4.333333333333333,30.280499539652133,3
2020-05-08-170914,170914,0,0,0,27,4.0,35.164778526412434,4
2020-05-09-170914,170914,0,1,0,27,0.3333333333333333,43.13670029179954,5
2020-05-10-170914,170914,0,0,0,27,0.0,58.90630410546261,6
2020-05-11-170914,170914,1,0,0,28,1.8333333333333333,56.540499511416584,0
2020-05-12-170914,170914,0,0,0,28,4.333333333333333,58.17426103164322,1
2020-05-13-170914,170914,0,0,0,28,1.8333333333333333,53.950233657585486,2
2020-05-14-170914,170914,0,1,1,28,1.0,36.738115498774135,3
2020-05-15-170914,170914,0,0,0,28,1.0,32.31310590974698,4
2020-05-16-170914,170914,0,0,0,28,0.0,24.98910414675984,5
2020-05-17-170914,170914,0,0,0,28,0.0,24.820226535325855,6
2020-05-18-170914,170914,2,0,2,30,1.6666666666666667,24.67166467863148,0
2020-05-19-170914,170914,1,0,1,31,1.8333333333333333,26.25725994892275,1
2020-05-20-170914,170914,0,0,0,31,2.1666666666666665,20.71200908568806,2
2020-05-21-170914,170914,0,0,0,31,1.5,20.100118774163324,3
2020-05-22-170914,170914,0,0,1,31,1.8333333333333333,20.850256011265095,4
2020-05-23-170914,170914,0,0,0,31,0.0,23.994846375417616,5
2020-05-24-170914,170914,0,0,0,31,0.16666666666666666,24.249908360371034,6
2020-05-25-170914,170914,0,0,1,31,0.6666666666666666,17.969217797302157,0
2020-05-26-170914,170914,0,0,2,31,0.3333333333333333,17.191556500895125,1
2020-05-27-170914,170914,0,0,2,31,0.16666666666666666,19.47774654641274,2
2020-05-28-170914,170914,1,0,0,32,2.333333333333333,18.56807293825006,3
2020-05-29-170914,170914,0,1,0,32,0.6666666666666666,21.84441033530615,4
2020-05-30-170914,170914,0,0,0,32,0.3333333333333333,24.347699507000648,5
2020-05-31-170914,170914,0,0,0,32,0.16666666666666666,26.371229529938987,6
2020-06-01-170914,170914,2,0,0,34,0.6666666666666666,58.68088679404951,0
2020-06-02-170914,170914,1,0,1,35,0.8333333333333334,18.033876551711494,1
2020-06-03-170914,170914,0,0,0,35,0.8333333333333334,11.872751039788845,2
2020-06-04-170914,170914,0,0,0,35,1.0,13.85937353618973,3
2020-06-05-170914,170914,1,0,0,36,0.3333333333333333,16.155222442109636,4
2020-06-06-170914,170914,0,0,0,36,0.16666666666666666,19.781312281757117,5
2020-06-07-170914,170914,0,0,0,36,0.16666666666666666,19.581282425510302,6
2020-06-08-170914,170914,1,0,0,37,0.16666666666666666,20.08828594958954,0
2020-06-09-170914,170914,2,0,0,39,0.3333333333333333,20.72824341736603,1
2020-06-10-170914,170914,2,0,0,41,1.0,69.51294418371592,2
2020-06-11-170914,170914,0,0,0,41,0.5,65.45366860750629,3
2020-06-12-170914,170914,0,0,0,41,0.6666666666666666,62.37081486427964,4
2020-06-13-170914,170914,0,0,0,41,0.16666666666666666,45.009471577764536,5
2020-06-14-170914,170914,0,0,0,41,0.0,35.0705121336148,6
2020-06-15-170914,170914,0,0,1,41,0.16666666666666666,24.77075233446694,0
2020-06-16-170914,170914,1,0,0,42,0.3333333333333333,25.106415990384058,1
2020-06-17-170914,170914,0,0,0,42,0.8333333333333334,21.766257295448018,2
2020-06-18-170914,170914,0,0,0,42,0.5,19.89384826710179,3
2020-06-19-170914,170914,0,0,0,42,0.6666666666666666,19.75885037110848,4
2020-06-20-170914,170914,0,0,0,42,0.16666666666666666,24.441810652503964,5
2020-06-21-170914,170914,0,0,1,42,0.0,25.17062989574316,6
2020-06-22-170914,170914,0,0,0,42,0.3333333333333333,23.507423538030007,0
2020-06-23-170914,170914,0,0,0,42,0.5,20.49393225250086,1
2020-06-24-170914,170914,0,0,0,42,0.3333333333333333,19.90553622583805,2
2020-06-25-170914,170914,0,0,0,42,0.16666666666666666,18.87505877869325,3
2020-06-26-170914,170914,0,0,0,42,0.0,16.977064844772432,4
2020-06-27-170914,170914,0,0,0,42,0.0,12.452377365477409,5
2020-06-28-170914,170914,0,0,0,42,0.0,12.055492525619233,6
2020-06-29-170914,170914,1,0,0,43,0.3333333333333333,12.125607170614746,0
2020-06-30-170914,170914,0,0,0,43,0.5,17.410755713527628,1
2020-07-01-170914,170914,0,0,0,43,0.16666666666666666,26.481030131161916,2
2020-07-02-170914,170914,0,0,0,43,0.0,8.046518861994263,3
2020-07-03-170914,170914,0,0,0,43,0.0,23.082612132361906,4
2020-07-04-170914,170914,0,0,0,43,0.0,16.066845374793722,5
2020-07-05-170914,170914,1,0,0,44,0.0,16.049914572598027,6
2020-07-06-170914,170914,0,0,0,44,0.3333333333333333,15.34518067185828,0
2020-07-07-170914,170914,0,0,2,44,0.0,15.566747015432941,1
2020-07-08-170914,170914,0,1,0,44,0.0,13.619368138155291,2
2020-07-09-170914,170914,0,0,7,44,0.0,13.71354157739091,3
2020-07-10-170914,170914,0,0,0,44,0.3333333333333333,28.162332402132932,4
2020-07-11-170914,170914,0,0,0,44,0.0,24.907377563431204,5
2020-07-12-170914,170914,0,0,0,44,0.0,20.33926065619904,6
2020-07-13-170914,170914,0,0,0,44,0.16666666666666666,20.499981241738404,0
2020-07-14-170914,170914,0,0,0,44,0.16666666666666666,20.893797110741186,1
2020-07-15-170914,170914,0,0,0,44,0.3333333333333333,15.870776810973002,2
2020-07-16-170914,170914,0,0,0,44,0.3333333333333333,8.664904206960248,3
2020-07-17-170914,170914,0,0,1,44,0.3333333333333333,7.575305640045768,4
2020-07-18-170914,170914,0,0,0,44,0.0,8.874074839134845,5
2020-07-19-170914,170914,0,0,0,44,0.0,8.06798293097894,6
2020-07-20-170914,170914,0,0,1,44,0.16666666666666666,7.842209272650899,0
2020-07-21-170914,170914,2,0,0,46,0.3333333333333333,7.986949011444456,1
2020-07-22-170914,170914,0,0,0,46,0.16666666666666666,13.33700718107297,2
2020-07-23-170914,170914,7,0,0,53,0.16666666666666666,14.04086844580321,3
2020-07-24-170914,170914,0,0,1,53,0.3333333333333333,25.732679734055118,4
2020-07-25-170914,170914,0,0,0,53,0.0,26.991230429764002,5
2020-07-26-170914,170914,0,0,0,53,0.0,26.44443569825202,6
2020-07-27-170914,170914,0,0,0,53,0.16666666666666666,25.488878132100496,0
2020-07-28-170914,170914,0,0,3,53,0.5,27.78780301025369,1
2020-07-29-170914,170914,0,0,0,53,0.6666666666666666,22.616746934279433,2
2020-07-30-170914,170914,0,0,1,53,0.6666666666666666,10.33728478076077,3
2020-07-31-170914,170914,1,0,0,54,0.3333333333333333,12.020975849284689,4
2020-08-01-170914,170914,0,0,0,54,0.0,10.52994007643542,5
2020-08-02-170914,170914,0,0,0,54,0.5,36.78987972420802,6
2020-08-03-170914,170914,1,0,0,55,0.0,105.82020513217034,0
2020-08-04-170914,170914,0,0,0,55,0.16666666666666666,90.64629322077424,1
2020-08-05-170914,170914,0,0,0,55,0.16666666666666666,73.68676277707073,2
2020-08-06-170914,170914,0,0,0,55,0.0,59.67008350507629,3
2020-08-07-170914,170914,1,0,1,56,0.3333333333333333,42.17399907715975,4
2020-08-08-170914,170914,0,0,1,56,0.0,35.178931269601435,5
2020-08-09-170914,170914,0,0,0,56,0.5,33.98854781133996,6
2020-08-10-170914,170914,0,0,1,56,0.16666666666666666,6.649774611448236,0
2020-08-11-170914,170914,3,0,1,59,0.6666666666666666,9.334513491183358,1
2020-08-12-170914,170914,0,0,0,59,0.5,15.026143898884825,2
2020-08-13-170914,170914,1,0,0,60,0.16666666666666666,16.36912667017879,3
2020-08-14-170914,170914,0,0,1,60,0.5,22.849301555444093,4
2020-08-15-170914,170914,0,0,0,60,0.5,27.27764378161912,5
2020-08-16-170914,170914,0,0,0,60,0.3333333333333333,29.528936005472588,6
2020-08-17-170914,170914,0,0,0,60,1.3333333333333333,32.57668690975819,0
2020-08-18-170914,170914,0,0,1,60,0.5,35.36421404834943,1
2020-08-19-170914,170914,0,0,1,60,0.6666666666666666,31.517602978412434,2
2020-08-20-170914,170914,0,0,0,60,2.5,30.972570948437358,3
2020-08-21-170914,170914,1,0,1,61,0.8333333333333334,41.741213573586194,4
2020-08-22-170914,170914,1,0,0,62,0.6666666666666666,43.5119229459672,5
2020-08-23-170914,170914,0,0,0,62,0.3333333333333333,45.646145045180205,6
2020-08-24-170914,170914,1,0,1,63,2.0,42.84178913232619,0
2020-08-25-170914,170914,1,0,0,64,3.8333333333333335,51.99389074058727,1
2020-08-26-170914,170914,0,0,0,64,4.166666666666667,63.33929666792511,2
2020-08-27-170914,170914,0,0,1,64,2.5,78.97056818339664,3
2020-08-28-170914,170914,1,0,1,65,1.1666666666666667,79.76897600973805,4
2020-08-29-170914,170914,0,0,0,65,3.333333333333333,90.32513065460554,5
2020-08-30-170914,170914,0,0,0,65,2.6666666666666665,95.70559201088044,6
2020-08-31-170914,170914,0,0,0,65,1.6666666666666667,90.77003954615674,0
2020-09-01-170914,170914,1,0,0,66,1.6666666666666667,23.662200875163133,1
2020-09-02-170914,170914,1,0,0,67,2.1666666666666665,112.7443829200923,2
2020-09-03-170914,170914,0,0,0,67,1.5,120.62258165289461,3
2020-09-04-170914,170914,1,0,0,68,2.0,101.54118137165213,4
2020-09-05-170914,170914,0,0,0,68,0.5,82.39646627540284,5
2020-09-06-170914,170914,0,0,0,68,0.3333333333333333,71.98382315737513,6
2020-09-07-170914,170914,1,0,0,69,2.5,61.803738911804444,0
2020-09-08-170914,170914,0,0,1,69,1.5,70.13080791255759,1
2020-09-09-170914,170914,0,0,1,69,0.6666666666666666,67.41928087807082,2
2020-09-10-170914,170914,1,0,2,70,1.1666666666666667,20.74034687400632,3
2020-09-11-170914,170914,1,0,1,71,0.6666666666666666,32.55166664577017,4
2020-09-12-170914,170914,0,0,1,71,1.6666666666666667,44.100322930582045,5
2020-09-13-170914,170914,0,0,0,71,0.5,51.720337312986935,6
2020-09-14-170914,170914,0,0,0,71,2.1666666666666665,52.44223121745054,0
2020-09-15-170914,170914,0,0,0,71,1.3333333333333333,67.79297850149125,1
2020-09-16-170914,170914,0,0,1,71,2.333333333333333,77.80881156083099,2
2020-09-17-170914,170914,0,0,0,71,11.833333333333336,87.44509433965345,3
2020-09-18-170914,170914,0,0,8,71,3.5,99.5950982126949,4
2020-09-19-170914,170914,0,1,0,71,0.8333333333333334,103.15268743007199,5
2020-09-20-170914,170914,0,0,0,71,0.8333333333333334,105.58841257130365,6
2020-09-21-170914,170914,0,0,0,71,1.5,91.0606201653886,0
2020-09-22-170914,170914,1,0,5,72,2.833333333333333,88.7390028896442,1
2020-09-23-170914,170914,1,1,6,73,2.833333333333333,87.75385046996433,2
2020-09-24-170914,170914,2,1,13,75,4.333333333333333,77.72032108281269,3
2020-09-25-170914,170914,1,0,7,76,5.833333333333332,81.77653292394955,4
2020-09-26-170914,170914,1,0,10,77,1.6666666666666667,99.59912983966957,5
2020-09-27-170914,170914,0,1,8,77,1.5,103.60611376002407,6
2020-09-28-170914,170914,0,0,0,77,1.8333333333333333,111.72659746348137,0
2020-09-29-170914,170914,0,0,2,77,2.333333333333333,111.94753803015456,1
2020-09-30-170914,170914,1,0,0,78,2.833333333333333,101.47275423866968,2
2020-10-01-170914,170914,0,0,2,78,3.0,0.0,3
2020-10-02-170914,170914,8,0,0,86,2.6666666666666665,134.20686068900181,4
2020-10-03-170914,170914,0,0,2,86,2.333333333333333,190.91365900587908,5
2020-10-04-170914,170914,0,0,1,86,1.5,188.37051296227702,6
2020-10-05-170914,170914,0,0,0,86,1.8333333333333333,156.89117792606277,0
2020-10-06-170914,170914,5,0,0,91,5.0,138.78529254130012,1
2020-10-07-170914,170914,6,0,1,97,1.3333333333333333,129.66966216167776,2
2020-10-08-170914,170914,13,0,0,110,5.5,123.49847914894963,3
2020-10-09-170914,170914,7,0,0,117,2.6666666666666665,158.7918234451064,4
2020-10-10-170914,170914,10,0,0,127,1.0,14.596690008926995,5
2020-10-11-170914,170914,8,0,0,135,3.0,33.674928243104254,6
2020-10-12-170914,170914,0,0,0,135,0.6666666666666666,57.88093381250772,0
2020-10-13-170914,170914,2,0,1,137,2.1666666666666665,62.91215456101826,1
2020-10-14-170914,170914,0,0,0,137,3.0,79.03290527634425,2
2020-10-15-170914,170914,2,0,0,139,4.166666666666667,94.17270209204706,3
2020-10-16-170914,170914,0,0,0,139,7.0,117.44136642036797,4
2020-10-17-170914,170914,2,0,0,141,4.166666666666667,126.29966823838866,5
2020-10-18-170914,170914,1,0,0,142,2.5,121.97844384521127,6
2020-10-19-170914,170914,0,1,0,142,6.833333333333332,113.51271554905347,0
2020-10-20-170914,170914,0,0,1,142,8.166666666666666,144.25459832609081,1
2020-10-21-170914,170914,1,0,0,143,11.5,156.99752317327838,2
2020-10-22-170914,170914,0,0,0,143,10.166666666666666,172.05309352678796,3
2020-10-23-170914,170914,0,0,2,143,10.333333333333334,185.07669963285878,4
2020-10-24-170914,170914,0,0,0,143,3.0,210.31109856739894,5
2020-10-25-170914,170914,0,0,0,143,3.5,209.796700883552,6
2020-10-26-170914,170914,0,0,0,143,6.333333333333332,193.36227109422185,0
2020-10-27-170914,170914,1,0,0,144,5.5,196.3776420801425,1
2020-10-28-170914,170914,0,0,0,144,7.333333333333332,196.66971522119007,2
2020-10-29-170914,170914,0,0,0,144,5.333333333333333,195.0134555914292,3
2020-10-30-170914,170914,0,0,0,144,7.666666666666668,157.76980542958756,4
2020-10-31-170914,170914,0,0,0,144,1.6666666666666667,182.5177491800993,5
2020-11-01-170914,170914,0,0,0,144,1.3333333333333333,159.51793667778728,6
2020-11-02-170914,170914,0,0,0,144,1.0,125.09488950551241,0
2020-11-03-170914,170914,1,0,0,145,6.833333333333332,109.42484090768065,1
2020-11-04-170914,170914,0,0,0,145,4.166666666666667,138.33656559668486,2
2020-11-05-170914,170914,0,0,0,145,5.166666666666667,155.4408879106991,3
2020-11-06-170914,170914,2,0,0,147,4.166666666666667,159.4640123645838,4
2020-11-07-170914,170914,0,0,0,147,2.833333333333333,181.8725324359643,5
2020-11-08-170914,170914,0,0,0,147,1.6666666666666667,172.6504248691021,6
2020-11-09-170914,170914,0,1,0,147,2.333333333333333,162.56549765250375,0
2020-11-10-170914,170914,0,0,0,147,3.5,146.24833596227964,1
2020-11-11-170914,170914,0,0,0,147,3.1666666666666665,157.02602231888557,2
2020-11-12-170914,170914,0,0,0,147,2.833333333333333,167.41254185371355,3
2020-11-13-170914,170914,0,0,0,147,3.5,166.5397526702998,4
2020-03-01-170915,170915,0,0,4,0,0.0,0.0,6
2020-03-02-170915,170915,0,0,17,0,0.2,107.99582699648585,0
2020-03-03-170915,170915,0,0,6,0,0.0,553.7074972277551,1
2020-03-04-170915,170915,0,0,19,0,0.4,572.2988815424956,2
2020-03-05-170915,170915,1,0,14,1,0.0,608.9136285921497,3
2020-03-06-170915,170915,1,0,18,2,0.4,553.5201099916283,4
2020-03-07-170915,170915,1,0,8,3,0.0,560.316499324791,5
2020-03-08-170915,170915,0,0,11,3,0.0,560.27439747485,6
2020-03-09-170915,170915,2,0,33,5,0.8,564.3950129226139,0
2020-03-10-170915,170915,0,0,45,5,0.6,1977.0487013809138,1
2020-03-11-170915,170915,1,0,17,6,0.8,1587.545058641878,2
2020-03-12-170915,170915,6,0,16,12,1.2,1106.9876005094238,3
2020-03-13-170915,170915,4,0,21,16,2.6,675.570095349136,4
2020-03-14-170915,170915,2,0,4,18,1.2,549.7147825886143,5
2020-03-15-170915,170915,4,0,7,22,3.2,446.5285202535962,6
2020-03-16-170915,170915,17,0,33,39,8.6,159.86386300106682,0
2020-03-17-170915,170915,6,0,21,45,7.6,292.0179232754629,1
2020-03-18-170915,170915,19,0,8,64,13.2,362.1485661850961,2
2020-03-19-170915,170915,14,0,9,78,14.8,481.34252758817405,3
2020-03-20-170915,170915,18,1,12,96,13.6,571.0819320230712,4
2020-03-21-170915,170915,8,0,2,104,4.4,667.2027662461949,5
2020-03-22-170915,170915,11,0,5,115,3.8,655.630347192419,6
2020-03-23-170915,170915,33,0,21,148,25.8,602.8293785929375,0
2020-03-24-170915,170915,45,0,91,193,20.6,769.0429053919997,1
2020-03-25-170915,170915,17,0,11,210,18.6,832.1500588392751,2
2020-03-26-170915,170915,16,0,7,226,16.8,860.8406504735705,3
2020-03-27-170915,170915,21,0,3,247,14.2,1002.7145446934144,4
2020-03-28-170915,170915,4,0,3,251,19.8,997.4152974491321,5
2020-03-29-170915,170915,7,0,4,258,4.8,1016.828911783773,6
2020-03-30-170915,170915,33,0,29,291,15.4,773.6068875425245,0
2020-03-31-170915,170915,21,0,10,312,12.0,735.744196819955,1
2020-04-01-170915,170915,8,0,11,320,8.8,110.74507207739995,2
2020-04-02-170915,170915,9,0,13,329,9.2,613.6114337234338,3
2020-04-03-170915,170915,12,0,6,341,8.6,183.64585117528134,4
2020-04-04-170915,170915,2,0,3,343,2.6,269.9368210910901,5
2020-04-05-170915,170915,5,0,1,348,3.8,290.9529582738327,6
2020-04-06-170915,170915,21,0,9,369,10.2,310.4638037734707,0
2020-04-07-170915,170915,91,0,8,460,12.8,370.85714406503536,1
2020-04-08-170915,170915,11,0,7,471,11.0,473.2311479651758,2
2020-04-09-170915,170915,7,0,0,478,7.8,528.3404389182118,3
2020-04-10-170915,170915,3,0,1,481,6.4,101.02706382045001,4
2020-04-11-170915,170915,3,2,1,484,12.6,136.88789545199447,5
2020-04-12-170915,170915,4,0,0,488,4.6,183.6463795287462,6
2020-04-13-170915,170915,29,0,6,517,56.0,208.64873444949205,0
2020-04-14-170915,170915,10,0,2,527,16.6,499.6913063645616,1
2020-04-15-170915,170915,11,0,6,538,10.2,606.2951054479495,2
2020-04-16-170915,170915,13,0,9,551,9.0,676.8390975914726,3
2020-04-17-170915,170915,6,0,3,557,8.0,681.1901085354493,4
2020-04-18-170915,170915,3,0,1,560,1.6,719.0610029885677,5
2020-04-19-170915,170915,1,0,1,561,0.4,681.2291844704512,6
2020-04-20-170915,170915,9,0,20,570,8.8,438.0150095659572,0
2020-04-21-170915,170915,8,0,10,578,7.0,395.38062853855536,1
2020-04-22-170915,170915,7,0,7,585,5.6,374.12240123527465,2
2020-04-23-170915,170915,0,0,14,585,0.8,365.70745100660076,3
2020-04-24-170915,170915,1,0,17,586,5.2,298.81268552805494,4
2020-04-25-170915,170915,1,0,0,587,0.8,324.75386791844176,5
2020-04-26-170915,170915,0,0,1,587,1.4,326.17661102604336,6
2020-04-27-170915,170915,6,0,12,593,5.4,250.34616101036838,0
2020-04-28-170915,170915,2,0,4,595,3.6,231.9074325711249,1
2020-04-29-170915,170915,6,0,0,601,4.2,209.4239048627258,2
2020-04-30-170915,170915,9,0,7,610,5.8,285.3404931767618,3
2020-05-01-170915,170915,3,0,7,613,0.4,548.907616092519,4
2020-05-02-170915,170915,1,0,0,614,0.2,179.02189415859286,5
2020-05-03-170915,170915,1,0,0,615,0.4,174.01252537341105,6
2020-05-04-170915,170915,20,0,9,635,5.4,129.78265202578652,0
2020-05-05-170915,170915,10,1,6,645,5.8,161.44065550351817,1
2020-05-06-170915,170915,7,0,7,652,5.2,198.71008753591272,2
2020-05-07-170915,170915,14,0,3,666,4.8,235.03734591325824,3
2020-05-08-170915,170915,17,0,1,683,6.0,255.37002275130124,4
2020-05-09-170915,170915,0,1,0,683,0.8,338.3755063749447,5
2020-05-10-170915,170915,1,1,1,684,0.4,574.9059143851416,6
2020-05-11-170915,170915,12,0,5,696,5.6,544.4089560813691,0
2020-05-12-170915,170915,4,1,11,700,6.4,570.2935836229,1
2020-05-13-170915,170915,0,0,4,700,2.2,487.0368480158211,2
2020-05-14-170915,170915,7,2,0,707,3.4,322.5793519715995,3
2020-05-15-170915,170915,7,0,10,714,5.0,262.5655508046224,4
2020-05-16-170915,170915,0,1,1,714,0.8,228.6426576031797,5
2020-05-17-170915,170915,0,0,0,714,0.6,230.45258406883434,6
2020-05-18-170915,170915,9,0,14,723,3.8,230.53749174838634,0
2020-05-19-170915,170915,6,0,3,729,3.8,222.0103173258869,1
2020-05-20-170915,170915,7,1,2,736,3.6,198.7927388018519,2
2020-05-21-170915,170915,3,0,2,739,2.6,196.0688703928252,3
2020-05-22-170915,170915,1,0,4,740,2.6,180.5521081560466,4
2020-05-23-170915,170915,0,0,0,740,0.8,203.5661920813555,5
2020-05-24-170915,170915,1,0,1,741,0.0,213.17687102402965,6
2020-05-25-170915,170915,5,0,0,746,5.4,164.97124241223582,0
2020-05-26-170915,170915,11,0,3,757,3.8,183.06333126953243,1
2020-05-27-170915,170915,4,0,1,761,3.2,227.73979153378878,2
2020-05-28-170915,170915,0,0,0,761,4.0,221.990277531318,3
2020-05-29-170915,170915,10,0,3,771,3.2,220.85152379337725,4
2020-05-30-170915,170915,1,0,0,772,0.4,227.4342778275167,5
2020-05-31-170915,170915,0,0,0,772,0.6,234.7446179835327,6
2020-06-01-170915,170915,14,0,0,786,3.4,421.75852667460634,0
2020-06-02-170915,170915,3,0,6,789,3.2,134.94557078972645,1
2020-06-03-170915,170915,2,0,0,791,2.6,116.72950862836721,2
2020-06-04-170915,170915,2,0,3,793,2.0,124.68894758595533,3
2020-06-05-170915,170915,4,1,1,797,2.0,139.88781739952597,4
2020-06-06-170915,170915,0,0,0,797,0.0,148.04626318056495,5
2020-06-07-170915,170915,1,0,0,798,0.0,146.29230430564505,6
2020-06-08-170915,170915,0,0,2,798,1.8,144.84296335899276,0
2020-06-09-170915,170915,3,0,1,801,1.6,145.96982311500295,1
2020-06-10-170915,170915,1,0,1,802,2.4,485.7507500693371,2
2020-06-11-170915,170915,0,0,2,802,2.0,417.2685453222158,3
2020-06-12-170915,170915,3,0,0,805,1.4,361.2918155565635,4
2020-06-13-170915,170915,0,1,0,805,0.2,302.65887957753193,5
2020-06-14-170915,170915,0,0,0,805,0.2,233.30784386770188,6
2020-06-15-170915,170915,0,0,2,805,2.0,142.36141407204087,0
2020-06-16-170915,170915,6,0,1,811,2.2,162.22659730386567,1
2020-06-17-170915,170915,0,0,1,811,1.2,152.30068648879615,2
2020-06-18-170915,170915,3,0,2,814,1.2,150.86123391580549,3
2020-06-19-170915,170915,1,0,0,815,1.2,152.59441997461994,4
2020-06-20-170915,170915,0,0,1,815,0.0,187.19823313157053,5
2020-06-21-170915,170915,0,0,0,815,0.0,186.55362681262167,6
2020-06-22-170915,170915,2,0,1,817,1.4,159.8671696261996,0
2020-06-23-170915,170915,1,0,3,818,1.0,137.39057019034152,1
2020-06-24-170915,170915,1,0,1,819,0.4,142.55779742112628,2
2020-06-25-170915,170915,2,1,2,821,1.0,134.92654845535355,3
2020-06-26-170915,170915,0,0,1,821,1.4,133.07270497339118,4
2020-06-27-170915,170915,0,0,0,821,0.6,118.46412614785336,5
2020-06-28-170915,170915,0,0,0,821,0.2,119.39041657098555,6
2020-06-29-170915,170915,2,0,1,823,1.8,120.73119389626763,0
2020-06-30-170915,170915,1,0,1,824,0.8,140.2360651972363,1
2020-07-01-170915,170915,1,0,1,825,1.0,144.06943089854676,2
2020-07-02-170915,170915,2,0,0,827,0.8,52.68296958104011,3
2020-07-03-170915,170915,0,0,1,827,0.8,67.91821450448643,4
2020-07-04-170915,170915,1,0,0,828,0.0,92.5112595243873,5
2020-07-05-170915,170915,0,0,0,828,0.2,92.65579970902385,6
2020-07-06-170915,170915,1,0,2,829,0.6,80.75387661279257,0
2020-07-07-170915,170915,3,0,0,832,0.4,82.37525959095652,1
2020-07-08-170915,170915,1,2,2,833,0.4,85.33094768053192,2
2020-07-09-170915,170915,2,0,2,835,0.6,80.61112116140754,3
2020-07-10-170915,170915,1,0,0,836,0.6,133.83707565723148,4
2020-07-11-170915,170915,0,0,0,836,0.4,114.58907917457142,5
2020-07-12-170915,170915,0,0,0,836,0.0,91.15515422114845,6
2020-07-13-170915,170915,1,0,1,837,1.0,95.48454210263407,0
2020-07-14-170915,170915,1,0,2,838,0.6,103.2213652559969,1
2020-07-15-170915,170915,1,0,1,839,0.4,82.79669735310436,2
2020-07-16-170915,170915,0,0,1,839,0.2,64.93399967811189,3
2020-07-17-170915,170915,1,2,0,840,0.8,63.574518837139,4
2020-07-18-170915,170915,0,0,0,840,0.0,63.91585360387867,5
2020-07-19-170915,170915,0,0,0,840,0.2,53.55494559178894,6
2020-07-20-170915,170915,2,0,1,842,0.2,52.47330001565931,0
2020-07-21-170915,170915,0,0,0,842,1.0,53.29950332679495,1
2020-07-22-170915,170915,2,0,3,844,0.8,57.85617315194254,2
2020-07-23-170915,170915,2,1,1,846,0.2,62.99937764930703,3
2020-07-24-170915,170915,0,2,0,846,0.4,62.978888365921925,4
2020-07-25-170915,170915,0,0,4,846,0.2,74.70413545161935,5
2020-07-26-170915,170915,0,0,1,846,0.4,73.60800716494927,6
2020-07-27-170915,170915,1,0,2,847,0.4,63.84862900020911,0
2020-07-28-170915,170915,2,0,3,849,1.0,70.08215463344162,1
2020-07-29-170915,170915,1,0,1,850,0.2,69.4178723865045,2
2020-07-30-170915,170915,1,0,3,851,0.2,65.14566034947295,3
2020-07-31-170915,170915,0,0,4,851,0.2,72.64923201325537,4
2020-08-01-170915,170915,0,0,1,851,0.0,66.66771731856787,5
2020-08-02-170915,170915,0,0,1,851,0.2,307.13000807380195,6
2020-08-03-170915,170915,1,0,2,852,0.8,691.6414718912384,0
2020-08-04-170915,170915,0,0,6,852,1.2,586.7438931369072,1
2020-08-05-170915,170915,3,0,5,855,0.0,505.71092659489176,2
2020-08-06-170915,170915,1,0,2,856,0.6,387.3566459308339,3
2020-08-07-170915,170915,0,0,0,856,0.6,259.26257564232094,4
2020-08-08-170915,170915,4,0,0,860,1.8,234.66740284385048,5
2020-08-09-170915,170915,1,0,1,861,0.4,254.6568085645595,6
2020-08-10-170915,170915,2,0,5,863,1.4,55.97649831352234,0
2020-08-11-170915,170915,3,0,15,866,2.0,85.6925644989233,1
2020-08-12-170915,170915,1,0,18,867,0.8,111.54825565415669,2
2020-08-13-170915,170915,3,0,11,870,1.2,137.29841975373182,3
2020-08-14-170915,170915,4,1,10,874,2.2,173.32953872993613,4
2020-08-15-170915,170915,1,0,2,875,2.4,207.36887340407844,5
2020-08-16-170915,170915,1,0,0,876,1.4,212.5103648002966,6
2020-08-17-170915,170915,2,0,12,878,1.8,241.49628518634717,0
2020-08-18-170915,170915,6,0,11,884,3.4,243.27589783856445,1
2020-08-19-170915,170915,5,0,14,889,4.0,263.31418137321816,2
2020-08-20-170915,170915,2,0,5,891,6.4,232.1343790921099,3
2020-08-21-170915,170915,0,0,18,891,2.0,282.61571465541044,4
2020-08-22-170915,170915,0,0,1,891,2.0,318.87884468465313,5
2020-08-23-170915,170915,1,0,4,892,0.8,331.71216469786725,6
2020-08-24-170915,170915,5,0,9,897,3.8,339.32390309798336,0
2020-08-25-170915,170915,15,0,2,912,8.0,375.4163831948148,1
2020-08-26-170915,170915,18,0,12,930,5.6,441.6627455183563,2
2020-08-27-170915,170915,11,0,7,941,7.6,525.8401531802268,3
2020-08-28-170915,170915,10,0,8,951,8.6,564.167858278644,4
2020-08-29-170915,170915,2,0,0,953,1.2,652.5232220792038,5
2020-08-30-170915,170915,0,0,1,953,0.2,639.5577115314325,6
2020-08-31-170915,170915,12,0,9,965,7.2,588.4479181955226,0
2020-09-01-170915,170915,11,0,6,976,3.4,261.0035530114715,1
2020-09-02-170915,170915,14,0,8,990,7.2,877.1905494303084,2
2020-09-03-170915,170915,5,0,14,995,4.6,657.9188554636578,3
2020-09-04-170915,170915,18,0,8,1013,9.2,661.3972515945563,4
2020-09-05-170915,170915,1,0,1,1014,1.0,620.3076609687153,5
2020-09-06-170915,170915,4,0,0,1018,2.2,602.6701161819894,6
2020-09-07-170915,170915,9,0,14,1027,10.8,628.623469107901,0
2020-09-08-170915,170915,2,0,3,1029,3.6,685.1631356475975,1
2020-09-09-170915,170915,12,0,11,1041,6.6,605.5394739410608,2
2020-09-10-170915,170915,7,0,5,1048,5.0,228.88207051632435,3
2020-09-11-170915,170915,8,0,10,1056,8.4,339.76877623363094,4
2020-09-12-170915,170915,0,0,1,1056,0.6,472.3644308629131,5
2020-09-13-170915,170915,1,0,2,1057,2.2,485.91651276481866,6
2020-09-14-170915,170915,9,0,7,1066,10.8,501.22111852081514,0
2020-09-15-170915,170915,6,0,8,1072,8.0,630.4861476417607,1
2020-09-16-170915,170915,8,0,4,1080,12.4,772.9521165040738,2
2020-09-17-170915,170915,14,0,7,1094,12.8,884.4834464382245,3
2020-09-18-170915,170915,8,0,5,1102,6.0,974.8729572032879,4
2020-09-19-170915,170915,1,0,0,1103,1.8,946.7616422239876,5
2020-09-20-170915,170915,0,0,1,1103,0.6,1041.2794449819125,6
2020-09-21-170915,170915,14,1,15,1117,8.4,887.7899952116247,0
2020-09-22-170915,170915,3,1,9,1120,9.4,890.2322202316875,1
2020-09-23-170915,170915,11,0,5,1131,9.0,841.9081350127647,2
2020-09-24-170915,170915,5,0,8,1136,7.0,726.6219584769451,3
2020-09-25-170915,170915,10,0,7,1146,10.2,697.3269170365543,4
2020-09-26-170915,170915,1,0,1,1147,2.8,832.8658663660232,5
2020-09-27-170915,170915,2,0,0,1149,2.6,796.6524016548284,6
2020-09-28-170915,170915,7,0,2,1156,9.0,799.5150380070144,0
2020-09-29-170915,170915,8,0,6,1164,5.8,771.976611814433,1
2020-09-30-170915,170915,4,1,8,1168,6.0,751.0745998574471,2
2020-10-01-170915,170915,7,0,10,1175,6.6,0.0,3
2020-10-02-170915,170915,5,0,3,1180,8.6,880.5068804916565,4
2020-10-03-170915,170915,0,0,1,1180,1.2,1694.552465203331,5
2020-10-04-170915,170915,1,1,2,1181,0.6,1733.535555501025,6
2020-10-05-170915,170915,15,1,16,1196,11.6,1441.8455320307746,0
2020-10-06-170915,170915,9,1,13,1205,9.2,1349.4537348290992,1
2020-10-07-170915,170915,5,2,18,1210,10.8,1161.2117236129882,2
2020-10-08-170915,170915,8,0,16,1218,12.6,1016.3945376953874,3
2020-10-09-170915,170915,7,0,46,1225,7.2,1191.7625107525155,4
2020-10-10-170915,170915,1,0,3,1226,1.2,122.76238837873238,5
2020-10-11-170915,170915,0,0,7,1226,0.8,199.71244540254477,6
2020-10-12-170915,170915,2,0,26,1228,1.6,223.83830904336804,0
2020-10-13-170915,170915,6,0,25,1234,13.4,246.38583912304534,1
2020-10-14-170915,170915,8,0,19,1242,10.6,383.9312443045253,2
2020-10-15-170915,170915,10,0,40,1252,11.6,540.1691623966246,3
2020-10-16-170915,170915,3,0,49,1255,8.2,675.0559021875303,4
2020-10-17-170915,170915,1,0,4,1256,2.8,717.5353591455123,5
2020-10-18-170915,170915,2,0,13,1258,1.8,704.4755300275473,6
2020-10-19-170915,170915,16,0,2,1274,12.4,725.3546308755082,0
2020-10-20-170915,170915,13,1,39,1287,11.6,911.1537305902557,1
2020-10-21-170915,170915,18,0,37,1305,21.0,948.460785706981,2
2020-10-22-170915,170915,16,1,44,1321,18.0,1048.90443033572,3
2020-10-23-170915,170915,46,0,43,1367,26.0,1168.4465683929989,4
2020-10-24-170915,170915,3,0,9,1370,2.4,1429.8606524615311,5
2020-10-25-170915,170915,7,0,8,1377,1.4,1448.0654726362054,6
2020-10-26-170915,170915,26,2,42,1403,26.2,1329.397400348293,0
2020-10-27-170915,170915,25,0,26,1428,15.8,1484.5636364849115,1
2020-10-28-170915,170915,19,3,24,1447,25.4,1530.5645392768743,2
2020-10-29-170915,170915,40,1,19,1487,27.6,1617.8824332211614,3
2020-10-30-170915,170915,49,0,37,1536,27.2,1380.8316103029267,4
2020-10-31-170915,170915,4,0,0,1540,4.6,1639.0706254140543,5
2020-11-01-170915,170915,13,0,0,1553,7.8,957.6201485166952,6
2020-11-02-170915,170915,2,0,0,1555,2.4,1306.9664084488438,0
2020-11-03-170915,170915,39,0,0,1594,15.0,1051.9004113155133,1
2020-11-04-170915,170915,37,0,0,1631,21.8,1277.4828122205486,2
2020-11-05-170915,170915,44,0,0,1675,27.4,1382.458947720153,3
2020-11-06-170915,170915,43,1,0,1718,31.0,1557.4807489297502,4
2020-11-07-170915,170915,9,0,0,1727,3.0,1721.9863212959935,5
2020-11-08-170915,170915,8,2,0,1735,2.4,1642.1487904837418,6
2020-11-09-170915,170915,42,0,0,1777,19.6,1668.309850783113,0
2020-11-10-170915,170915,26,2,0,1803,17.8,915.8302657968612,1
2020-11-11-170915,170915,24,3,0,1827,22.2,1101.8489384244367,2
2020-11-12-170915,170915,19,0,0,1846,16.8,1227.8651305893536,3
2020-11-13-170915,170915,37,1,0,1883,19.2,1322.3946981583413,4
2020-03-01-170916,170916,0,0,2,0,0.0,0.0,6
2020-03-02-170916,170916,0,0,7,0,0.0,138.64004176226143,0
2020-03-03-170916,170916,0,0,10,0,0.0,661.0957420503493,1
2020-03-04-170916,170916,0,0,22,0,0.2,699.6875959221289,2
2020-03-05-170916,170916,0,0,19,0,0.2,743.9189250208404,3
2020-03-06-170916,170916,1,0,16,1,0.4,693.8069765057407,4
2020-03-07-170916,170916,0,0,7,1,0.2,698.5519987177954,5
2020-03-08-170916,170916,0,0,7,1,0.0,692.0225574999704,6
2020-03-09-170916,170916,0,0,24,1,0.6,695.1881598972417,0
2020-03-10-170916,170916,0,0,20,1,0.2,2411.535469953751,1
2020-03-11-170916,170916,1,0,25,2,0.2,1955.593282746487,2
2020-03-12-170916,170916,1,0,18,3,1.4,1351.3960198275402,3
2020-03-13-170916,170916,1,0,12,4,2.2,713.1649748620245,4
2020-03-14-170916,170916,1,0,9,5,0.4,606.1315395846138,5
2020-03-15-170916,170916,2,0,9,7,1.4,504.56273318688153,6
2020-03-16-170916,170916,7,0,23,14,7.2,186.92813167213637,0
2020-03-17-170916,170916,10,0,12,24,3.2,345.12102978223186,1
2020-03-18-170916,170916,22,0,11,46,8.6,460.9902857736472,2
2020-03-19-170916,170916,19,0,8,65,7.4,670.3550811981879,3
2020-03-20-170916,170916,16,0,13,81,8.8,833.5805092121159,4
2020-03-21-170916,170916,7,0,3,88,3.0,979.1978301773443,5
2020-03-22-170916,170916,7,0,14,95,3.6,976.4449419810064,6
2020-03-23-170916,170916,24,0,9,119,16.2,926.2714063979628,0
2020-03-24-170916,170916,20,0,23,139,16.4,1142.2774652942726,1
2020-03-25-170916,170916,25,0,5,164,9.6,1192.9678129739277,2
2020-03-26-170916,170916,18,0,6,182,9.2,1251.2062051800774,3
2020-03-27-170916,170916,12,0,5,194,9.8,1473.8846138539473,4
2020-03-28-170916,170916,9,0,39,203,3.4,1471.4081297864645,5
2020-03-29-170916,170916,9,0,4,212,2.8,1505.0504054691341,6
2020-03-30-170916,170916,23,0,16,235,10.6,1182.440200124459,0
2020-03-31-170916,170916,12,0,8,247,8.2,1155.8072674085706,1
2020-04-01-170916,170916,11,0,10,258,6.0,172.98681776970366,2
2020-04-02-170916,170916,8,0,8,266,5.2,841.6792497754861,3
2020-04-03-170916,170916,13,0,8,279,5.6,321.16454734310105,4
2020-04-04-170916,170916,3,0,2,282,1.0,466.40323635265463,5
2020-04-05-170916,170916,14,0,1,296,1.4,484.86575869772815,6
2020-04-06-170916,170916,9,1,9,305,8.8,544.8921673690987,0
2020-04-07-170916,170916,23,0,6,328,25.6,608.2404028707072,1
2020-04-08-170916,170916,5,0,6,333,8.4,787.6090886242081,2
2020-04-09-170916,170916,6,1,0,339,6.4,819.7832619812142,3
2020-04-10-170916,170916,5,0,3,344,4.4,158.49916383805095,4
2020-04-11-170916,170916,39,0,3,383,4.4,220.83555621914712,5
2020-04-12-170916,170916,4,0,4,387,2.8,465.35278672006484,6
2020-04-13-170916,170916,16,0,7,403,23.0,506.14784057528885,0
2020-04-14-170916,170916,8,0,4,411,13.2,835.2694698531652,1
2020-04-15-170916,170916,10,0,9,421,9.6,977.9033181282683,2
2020-04-16-170916,170916,8,0,6,429,7.2,1102.4778886675374,3
2020-04-17-170916,170916,8,0,0,437,4.8,1094.3727185839505,4
2020-04-18-170916,170916,2,0,1,439,1.2,1141.4101753088091,5
2020-04-19-170916,170916,1,0,2,440,0.2,922.0506761754534,6
2020-04-20-170916,170916,9,0,6,449,6.4,656.1903270466426,0
2020-04-21-170916,170916,6,0,5,455,5.4,608.2844114233972,1
2020-04-22-170916,170916,6,0,3,461,3.6,573.9478856311665,2
2020-04-23-170916,170916,0,0,4,461,0.6,555.0596030383924,3
2020-04-24-170916,170916,3,0,4,464,3.6,451.27615418587214,4
2020-04-25-170916,170916,3,0,3,467,1.0,482.54446031208465,5
2020-04-26-170916,170916,4,0,1,471,0.4,493.98063901413843,6
2020-04-27-170916,170916,7,0,3,478,3.8,407.1427472010388,0
2020-04-28-170916,170916,4,0,6,482,3.0,381.1613288951148,1
2020-04-29-170916,170916,9,0,5,491,3.0,348.81512080526295,2
2020-04-30-170916,170916,6,0,5,497,4.8,478.5159450782351,3
2020-05-01-170916,170916,0,0,4,497,0.6,837.3674166692552,4
2020-05-02-170916,170916,1,0,1,498,0.4,325.8951031274563,5
2020-05-03-170916,170916,2,0,1,500,0.6,301.87560841876757,6
2020-05-04-170916,170916,6,0,3,506,7.4,257.8410286222768,0
2020-05-05-170916,170916,5,0,8,511,5.0,292.29968021721925,1
2020-05-06-170916,170916,3,0,4,514,6.0,328.4352607897893,2
2020-05-07-170916,170916,4,0,7,518,4.8,348.0632286649591,3
2020-05-08-170916,170916,4,0,0,522,5.6,363.87687909652027,4
2020-05-09-170916,170916,3,0,1,525,0.4,450.2724021785157,5
2020-05-10-170916,170916,1,0,0,526,0.4,852.493743447652,6
2020-05-11-170916,170916,3,0,4,529,5.2,806.2674851913376,0
2020-05-12-170916,170916,6,0,5,535,4.2,779.494814697784,1
2020-05-13-170916,170916,5,0,4,540,1.6,688.3591621787107,2
2020-05-14-170916,170916,5,0,5,545,4.4,453.7447573369036,3
2020-05-15-170916,170916,4,0,4,549,4.0,392.1229605514982,4
2020-05-16-170916,170916,1,0,0,550,0.4,360.74900312875224,5
2020-05-17-170916,170916,1,0,2,551,0.0,363.8525041364826,6
2020-05-18-170916,170916,3,0,2,554,3.4,360.4497388919271,0
2020-05-19-170916,170916,8,0,3,562,1.8,350.68235852678606,1
2020-05-20-170916,170916,4,0,3,566,1.8,312.4365904217317,2
2020-05-21-170916,170916,7,0,4,573,1.2,294.7975207931662,3
2020-05-22-170916,170916,0,0,1,573,1.0,290.7291120907191,4
2020-05-23-170916,170916,1,0,0,574,0.2,311.56448357257295,5
2020-05-24-170916,170916,0,0,0,574,0.4,318.9915525775802,6
2020-05-25-170916,170916,4,0,3,578,4.4,257.1926908177213,0
2020-05-26-170916,170916,5,0,1,583,4.0,258.08770030790316,1
2020-05-27-170916,170916,4,0,4,587,3.0,328.45880584607727,2
2020-05-28-170916,170916,5,0,3,592,1.4,332.94478135117276,3
2020-05-29-170916,170916,4,0,2,596,3.4,331.9005262846618,4
2020-05-30-170916,170916,0,0,1,596,1.0,367.8761760248316,5
2020-05-31-170916,170916,2,0,0,598,0.2,380.56478674805214,6
2020-06-01-170916,170916,2,0,2,600,5.4,552.4284338148345,0
2020-06-02-170916,170916,3,0,3,603,2.2,179.38836165124818,1
2020-06-03-170916,170916,3,0,0,606,2.6,157.50373075625254,2
2020-06-04-170916,170916,4,0,2,610,1.8,181.5747333620381,3
2020-06-05-170916,170916,1,0,1,611,2.0,205.19596869897404,4
2020-06-06-170916,170916,0,0,0,611,0.0,211.85452179622598,5
2020-06-07-170916,170916,0,0,0,611,0.4,202.60360457237175,6
2020-06-08-170916,170916,3,0,1,614,0.8,201.9931217597936,0
2020-06-09-170916,170916,1,0,0,615,1.8,211.25196200832855,1
2020-06-10-170916,170916,4,0,1,619,2.0,625.0919475991235,2
2020-06-11-170916,170916,3,0,2,622,1.8,555.522072275792,3
2020-06-12-170916,170916,2,0,3,624,2.0,498.50175924182724,4
2020-06-13-170916,170916,1,2,1,625,0.2,431.9408937018884,5
2020-06-14-170916,170916,0,0,0,625,0.0,345.69679606153824,6
2020-06-15-170916,170916,2,0,2,627,1.4,241.2768010463435,0
2020-06-16-170916,170916,3,0,1,630,3.0,255.58427991697616,1
2020-06-17-170916,170916,0,1,0,630,1.4,245.8304716977139,2
2020-06-18-170916,170916,2,0,1,632,1.6,216.52905902308817,3
2020-06-19-170916,170916,1,0,1,633,1.4,202.96777856476407,4
2020-06-20-170916,170916,0,0,0,633,0.2,249.13996662833395,5
2020-06-21-170916,170916,0,0,0,633,0.0,255.53702438574976,6
2020-06-22-170916,170916,1,0,0,634,1.4,220.02410265335845,0
2020-06-23-170916,170916,0,0,0,634,1.0,188.97542979825405,1
2020-06-24-170916,170916,1,0,1,635,0.6,193.6754747868477,2
2020-06-25-170916,170916,2,0,0,637,0.8,185.32813076638786,3
2020-06-26-170916,170916,3,0,2,640,0.0,183.61294517834597,4
2020-06-27-170916,170916,1,0,2,641,0.4,161.3887144649867,5
2020-06-28-170916,170916,0,0,0,641,0.0,167.6315356465982,6
2020-06-29-170916,170916,2,0,3,643,1.4,166.73238985578035,0
2020-06-30-170916,170916,1,0,0,644,0.4,203.2786390614741,1
2020-07-01-170916,170916,0,0,0,644,0.8,211.89777262110897,2
2020-07-02-170916,170916,1,0,1,645,0.6,80.10479638612313,3
2020-07-03-170916,170916,1,0,0,646,0.6,88.96192978905148,4
2020-07-04-170916,170916,0,0,0,646,0.2,118.51607456482559,5
2020-07-05-170916,170916,0,0,0,646,0.2,118.70426255093385,6
2020-07-06-170916,170916,0,0,1,646,0.8,101.7474440012607,0
2020-07-07-170916,170916,0,0,2,646,0.8,93.42024877719707,1
2020-07-08-170916,170916,1,1,0,647,0.4,92.69257678661108,2
2020-07-09-170916,170916,0,0,0,647,0.8,89.06427862919271,3
2020-07-10-170916,170916,2,0,0,649,0.2,197.3477422458801,4
2020-07-11-170916,170916,2,0,0,651,0.0,165.2982258132273,5
2020-07-12-170916,170916,0,0,0,651,0.0,145.2574740362214,6
2020-07-13-170916,170916,3,0,1,654,0.4,152.9293132976415,0
2020-07-14-170916,170916,0,0,1,654,0.8,169.41352939285986,1
2020-07-15-170916,170916,0,0,1,654,0.6,135.28653276299858,2
2020-07-16-170916,170916,1,0,0,655,0.2,107.47600207752144,3
2020-07-17-170916,170916,0,0,0,655,1.2,107.379707330484,4
2020-07-18-170916,170916,0,0,0,655,0.0,104.37645380767745,5
2020-07-19-170916,170916,0,0,0,655,0.2,80.51914621252882,6
2020-07-20-170916,170916,1,0,0,656,0.6,72.09748272093886,0
2020-07-21-170916,170916,2,0,0,658,0.6,70.89631020478946,1
2020-07-22-170916,170916,0,0,0,658,1.2,85.26091315889457,2
2020-07-23-170916,170916,0,0,1,658,0.4,87.59694290427959,3
2020-07-24-170916,170916,0,0,1,658,0.2,86.78176526956884,4
2020-07-25-170916,170916,0,0,0,658,0.0,95.65442082713425,5
2020-07-26-170916,170916,0,0,0,658,0.0,93.6133159393359,6
2020-07-27-170916,170916,1,0,1,659,0.6,79.61085404788349,0
2020-07-28-170916,170916,1,0,3,660,1.4,90.0458638526571,1
2020-07-29-170916,170916,1,0,3,661,0.8,85.19792524854964,2
2020-07-30-170916,170916,0,0,1,661,1.2,81.20188430905482,3
2020-07-31-170916,170916,0,0,2,661,0.4,93.16957683024143,4
2020-08-01-170916,170916,0,0,11,661,0.0,70.08506620392708,5
2020-08-02-170916,170916,0,0,0,661,0.6,464.95417906364395,6
2020-08-03-170916,170916,0,0,3,661,0.2,872.8052353055023,0
2020-08-04-170916,170916,0,0,3,661,0.4,726.9947518020482,1
2020-08-05-170916,170916,0,0,7,661,0.6,607.1658687499333,2
2020-08-06-170916,170916,1,0,3,662,0.4,449.38861553274575,3
2020-08-07-170916,170916,1,0,2,663,0.2,287.0078511210111,4
2020-08-08-170916,170916,0,0,6,663,1.6,275.4637778738123,5
2020-08-09-170916,170916,0,0,0,663,0.6,306.4111436346367,6
2020-08-10-170916,170916,1,0,4,664,1.4,62.89635412626699,0
2020-08-11-170916,170916,3,0,7,667,2.2,101.90816200201476,1
2020-08-12-170916,170916,3,0,5,670,0.2,149.92557088271377,2
2020-08-13-170916,170916,1,0,10,671,1.2,181.93192719019328,3
2020-08-14-170916,170916,2,0,2,673,1.0,239.1274716187744,4
2020-08-15-170916,170916,11,0,0,684,0.4,275.5229280628538,5
2020-08-16-170916,170916,0,0,0,684,1.2,317.82116380781434,6
2020-08-17-170916,170916,3,0,5,687,0.8,342.5048242247218,0
2020-08-18-170916,170916,3,0,4,690,2.2,348.8107386720443,1
2020-08-19-170916,170916,7,0,8,697,2.2,364.8607841727003,2
2020-08-20-170916,170916,3,0,1,700,6.4,344.51157348869924,3
2020-08-21-170916,170916,2,0,9,702,2.2,403.4964520570302,4
2020-08-22-170916,170916,6,0,2,708,1.0,409.1650491053491,5
2020-08-23-170916,170916,0,1,3,708,1.4,447.9081210920576,6
2020-08-24-170916,170916,4,0,11,712,4.8,437.81324588390396,0
2020-08-25-170916,170916,7,0,7,719,10.4,476.9799467033997,1
2020-08-26-170916,170916,5,0,5,724,9.0,559.6157182249933,2
2020-08-27-170916,170916,10,0,4,734,6.8,678.9674842009082,3
2020-08-28-170916,170916,2,0,6,736,7.8,736.7313009918046,4
2020-08-29-170916,170916,0,0,1,736,2.8,847.96868668262,5
2020-08-30-170916,170916,0,0,4,736,2.6,814.4450738246848,6
2020-08-31-170916,170916,5,0,7,741,5.4,738.511659818176,0
2020-09-01-170916,170916,4,0,7,745,4.0,327.10729703324296,1
2020-09-02-170916,170916,8,0,12,753,7.0,1147.3853703255654,2
2020-09-03-170916,170916,1,0,9,754,3.6,882.5970324529701,3
2020-09-04-170916,170916,9,0,7,763,7.4,882.008259751963,4
2020-09-05-170916,170916,2,0,2,765,1.2,835.7081752930728,5
2020-09-06-170916,170916,3,0,2,768,1.8,771.5844781219081,6
2020-09-07-170916,170916,11,0,7,779,5.6,805.6212790410561,0
2020-09-08-170916,170916,7,0,12,786,3.0,867.3306369490506,1
2020-09-09-170916,170916,5,0,9,791,4.8,818.1396930318165,2
2020-09-10-170916,170916,4,0,2,795,4.8,295.27409114952627,3
2020-09-11-170916,170916,6,0,4,801,6.0,433.56139125561674,4
2020-09-12-170916,170916,1,0,6,802,0.8,619.9869345308035,5
2020-09-13-170916,170916,4,0,2,806,0.6,642.4038650074151,6
2020-09-14-170916,170916,7,0,9,813,7.0,666.2246060362273,0
2020-09-15-170916,170916,7,0,5,820,5.0,800.6899841638268,1
2020-09-16-170916,170916,12,0,7,832,7.8,970.2260094872892,2
2020-09-17-170916,170916,9,0,5,841,10.2,1111.9176040442521,3
2020-09-18-170916,170916,7,0,10,848,4.2,1238.9081447650155,4
2020-09-19-170916,170916,2,0,2,850,0.8,1227.846210199726,5
2020-09-20-170916,170916,2,1,1,852,0.6,1359.3025969977223,6
2020-09-21-170916,170916,7,0,4,859,7.2,1201.2272784219358,0
2020-09-22-170916,170916,12,0,10,871,4.2,1214.2654706376882,1
2020-09-23-170916,170916,9,0,7,880,4.4,1172.0061655317463,2
2020-09-24-170916,170916,2,0,6,882,6.2,1028.2910768574338,3
2020-09-25-170916,170916,4,1,3,886,8.0,960.5487421396599,4
2020-09-26-170916,170916,6,0,1,892,2.6,1127.3564370070656,5
2020-09-27-170916,170916,2,0,1,894,1.0,1091.070070968669,6
2020-09-28-170916,170916,9,0,4,903,3.4,1085.7842202661154,0
2020-09-29-170916,170916,5,0,9,908,3.0,1042.435374707457,1
2020-09-30-170916,170916,7,0,13,915,3.2,951.1230756796042,2
2020-10-01-170916,170916,5,0,8,920,6.8,0.0,3
2020-10-02-170916,170916,10,0,5,930,5.4,1187.237207134993,4
2020-10-03-170916,170916,2,1,3,932,3.2,2256.2611260685517,5
2020-10-04-170916,170916,1,0,2,933,0.8,2244.964946679565,6
2020-10-05-170916,170916,4,0,9,937,10.0,1866.864870174897,0
2020-10-06-170916,170916,10,0,7,947,6.4,1735.5270618894199,1
2020-10-07-170916,170916,7,0,15,954,7.8,1479.4062197219266,2
2020-10-08-170916,170916,6,0,13,960,14.0,1296.8407179254532,3
2020-10-09-170916,170916,3,0,27,963,5.0,1512.788547852982,4
2020-10-10-170916,170916,1,0,6,964,1.0,165.96754633009664,5
2020-10-11-170916,170916,1,0,1,965,2.0,241.07117532920245,6
2020-10-12-170916,170916,4,0,20,969,1.0,279.30419236178295,0
2020-10-13-170916,170916,9,0,15,978,8.0,319.4403209633098,1
2020-10-14-170916,170916,13,0,28,991,8.0,503.84436609514046,2
2020-10-15-170916,170916,8,0,17,999,7.8,721.8948264383866,3
2020-10-16-170916,170916,5,0,30,1004,6.4,918.5904165247093,4
2020-10-17-170916,170916,3,0,7,1007,3.0,964.7113654137464,5
2020-10-18-170916,170916,2,0,5,1009,2.8,975.2718814022842,6
2020-10-19-170916,170916,9,0,5,1018,8.8,989.446248533354,0
2020-10-20-170916,170916,7,0,19,1025,12.0,1251.6775117618756,1
2020-10-21-170916,170916,15,0,21,1040,14.0,1274.6504238210596,2
2020-10-22-170916,170916,13,0,32,1053,13.2,1397.2583597193607,3
2020-10-23-170916,170916,27,0,43,1080,22.6,1542.2862616236132,4
2020-10-24-170916,170916,6,0,4,1086,3.8,1947.0878149924192,5
2020-10-25-170916,170916,1,0,3,1087,2.6,1963.6142733847937,6
2020-10-26-170916,170916,20,0,12,1107,13.8,1795.9636678393,0
2020-10-27-170916,170916,15,0,19,1122,15.0,1966.4654062003256,1
2020-10-28-170916,170916,28,1,28,1150,16.2,2045.6463612628982,2
2020-10-29-170916,170916,17,1,14,1167,18.4,2185.1487147230473,3
2020-10-30-170916,170916,30,0,27,1197,19.6,1817.4852259662512,4
2020-10-31-170916,170916,7,0,0,1204,4.2,2158.0430351098753,5
2020-11-01-170916,170916,5,0,0,1209,3.4,1229.344509928644,6
2020-11-02-170916,170916,5,0,0,1214,1.4,1767.0933170817539,0
2020-11-03-170916,170916,19,1,0,1233,14.8,1513.4702844591216,1
2020-11-04-170916,170916,21,1,0,1254,17.0,1800.9756942317538,2
2020-11-05-170916,170916,32,0,0,1286,25.0,1949.8149667548332,3
2020-11-06-170916,170916,43,1,0,1329,22.2,2200.017207437179,4
2020-11-07-170916,170916,4,0,0,1333,4.6,2496.265662664515,5
2020-11-08-170916,170916,3,1,0,1336,2.6,2313.647188526297,6
2020-11-09-170916,170916,12,0,0,1348,18.4,2312.039189959199,0
2020-11-10-170916,170916,19,0,0,1367,12.2,1152.5294687387582,1
2020-11-11-170916,170916,28,1,0,1395,13.6,1409.8706957760796,2
2020-11-12-170916,170916,14,0,0,1409,11.6,1594.067205646371,3
2020-11-13-170916,170916,27,0,0,1436,15.0,1665.9952787258405,4
2020-03-01-170919,170919,0,0,2,0,0.0,0.0,6
2020-03-02-170919,170919,0,0,8,0,0.0,133.14017991096003,0
2020-03-03-170919,170919,0,0,5,0,0.0,695.8743483026207,1
2020-03-04-170919,170919,1,0,11,1,0.0,756.8110115350364,2
2020-03-05-170919,170919,0,0,10,1,0.16666666666666666,819.86422796705,3
2020-03-06-170919,170919,0,0,15,1,0.6666666666666666,748.939248504097,4
2020-03-07-170919,170919,0,0,2,1,0.16666666666666666,745.4352091290847,5
2020-03-08-170919,170919,0,0,5,1,0.16666666666666666,743.3195153864917,6
2020-03-09-170919,170919,1,0,23,2,0.6666666666666666,743.7554922737193,0
2020-03-10-170919,170919,1,0,22,3,0.0,2547.9403401140626,1
2020-03-11-170919,170919,0,0,15,3,0.6666666666666666,2052.9148515809457,2
2020-03-12-170919,170919,1,0,14,4,1.6666666666666667,1392.8491711683218,3
2020-03-13-170919,170919,5,0,16,9,2.6666666666666665,801.6716272304226,4
2020-03-14-170919,170919,0,0,8,9,1.3333333333333333,693.8459934125451,5
2020-03-15-170919,170919,2,0,1,11,3.1666666666666665,574.3504123479372,6
2020-03-16-170919,170919,8,0,10,19,9.166666666666666,218.68993605041598,0
2020-03-17-170919,170919,5,1,16,24,6.666666666666668,390.7927903352209,1
2020-03-18-170919,170919,11,0,8,35,13.666666666666664,493.5294238592395,2
2020-03-19-170919,170919,10,1,11,45,12.333333333333336,654.8906965080035,3
2020-03-20-170919,170919,15,0,8,60,12.666666666666664,762.6968256599382,4
2020-03-21-170919,170919,2,0,2,62,5.333333333333333,884.9823426149942,5
2020-03-22-170919,170919,5,0,0,67,5.0,862.7165112051914,6
2020-03-23-170919,170919,23,1,10,90,18.666666666666668,794.881251043365,0
2020-03-24-170919,170919,22,0,13,112,20.33333333333333,999.2329190448165,1
2020-03-25-170919,170919,15,0,22,127,18.5,1086.994293944216,2
2020-03-26-170919,170919,14,0,9,141,13.5,1140.7483495055028,3
2020-03-27-170919,170919,16,0,9,157,12.833333333333336,1326.4996274090604,4
2020-03-28-170919,170919,8,0,15,165,15.5,1342.961173965144,5
2020-03-29-170919,170919,1,0,7,166,6.0,1395.559262045236,6
2020-03-30-170919,170919,10,0,65,176,16.333333333333332,1088.086855713126,0
2020-03-31-170919,170919,16,0,45,192,11.666666666666664,1040.041629389831,1
2020-04-01-170919,170919,8,0,18,200,9.666666666666666,176.63238771841108,2
2020-04-02-170919,170919,11,0,11,211,6.333333333333332,890.8718444319807,3
2020-04-03-170919,170919,8,0,9,219,7.333333333333332,279.532793951439,4
2020-04-04-170919,170919,2,0,0,221,2.5,416.8021762129879,5
2020-04-05-170919,170919,0,0,0,221,4.5,460.4346397913484,6
2020-04-06-170919,170919,10,0,13,231,10.0,491.9914586561109,0
2020-04-07-170919,170919,13,1,8,244,23.33333333333333,577.3434228029553,1
2020-04-08-170919,170919,22,1,8,266,6.833333333333332,700.4965172668021,2
2020-04-09-170919,170919,9,0,3,275,4.333333333333333,793.5044636248563,3
2020-04-10-170919,170919,9,0,8,284,5.333333333333333,169.00858589992058,4
2020-04-11-170919,170919,15,0,0,299,9.0,237.82954992544208,5
2020-04-12-170919,170919,7,0,1,306,2.333333333333333,322.79215069998565,6
2020-04-13-170919,170919,65,0,8,371,15.666666666666664,356.7307404809436,0
2020-04-14-170919,170919,45,0,6,416,9.0,718.8426778370381,1
2020-04-15-170919,170919,18,0,2,434,7.833333333333332,887.5626365143103,2
2020-04-16-170919,170919,11,0,10,445,8.0,1000.14369899845,3
2020-04-17-170919,170919,9,0,0,454,5.5,999.6180995999954,4
2020-04-18-170919,170919,0,0,0,454,2.0,1030.4020024464585,5
2020-04-19-170919,170919,0,0,0,454,0.8333333333333334,953.7499607483091,6
2020-04-20-170919,170919,13,0,7,467,6.5,663.1143761589387,0
2020-04-21-170919,170919,8,0,10,475,5.666666666666668,576.3509285672355,1
2020-04-22-170919,170919,8,0,7,483,6.0,526.6483039799134,2
2020-04-23-170919,170919,3,0,4,486,0.3333333333333333,513.7879679808356,3
2020-04-24-170919,170919,8,0,3,494,4.0,429.91254651418,4
2020-04-25-170919,170919,0,0,0,494,1.1666666666666667,469.76368455882823,5
2020-04-26-170919,170919,1,0,0,495,1.1666666666666667,468.52768929674124,6
2020-04-27-170919,170919,8,0,11,503,4.833333333333333,364.72420656959184,0
2020-04-28-170919,170919,6,0,14,509,3.6666666666666665,340.54379667558914,1
2020-04-29-170919,170919,2,0,2,511,4.333333333333333,317.8734904866527,2
2020-04-30-170919,170919,10,0,7,521,4.666666666666667,406.4962657985392,3
2020-05-01-170919,170919,0,0,11,521,0.6666666666666666,744.607221274672,4
2020-05-02-170919,170919,0,0,0,521,0.5,267.3579500625402,5
2020-05-03-170919,170919,0,1,0,521,0.6666666666666666,274.01468505564407,6
2020-05-04-170919,170919,7,0,4,528,8.166666666666666,206.31009161170832,0
2020-05-05-170919,170919,10,0,1,538,4.5,244.58150212091547,1
2020-05-06-170919,170919,7,0,2,545,4.0,285.2327678261378,2
2020-05-07-170919,170919,4,0,2,549,6.833333333333332,322.05250442476563,3
2020-05-08-170919,170919,3,0,3,552,7.5,362.0265408830969,4
2020-05-09-170919,170919,0,6,1,552,0.6666666666666666,474.8646262609748,5
2020-05-10-170919,170919,0,0,0,552,0.5,760.3539838676688,6
2020-05-11-170919,170919,11,0,10,563,5.0,711.6331366892714,0
2020-05-12-170919,170919,14,0,7,577,3.333333333333333,761.4031575423833,1
2020-05-13-170919,170919,2,0,5,579,0.8333333333333334,667.5692473980913,2
2020-05-14-170919,170919,7,0,6,586,4.5,460.7954356409686,3
2020-05-15-170919,170919,11,0,1,597,4.166666666666667,377.4870716313512,4
2020-05-16-170919,170919,0,0,1,597,0.16666666666666666,363.0879878260031,5
2020-05-17-170919,170919,0,0,0,597,0.16666666666666666,359.3707217239473,6
2020-05-18-170919,170919,4,0,1,601,5.0,359.78461131589575,0
2020-05-19-170919,170919,1,0,4,602,5.0,333.06407580683674,1
2020-05-20-170919,170919,2,0,2,604,4.666666666666667,292.83337719551787,2
2020-05-21-170919,170919,2,0,4,606,2.6666666666666665,286.36888037882466,3
2020-05-22-170919,170919,3,0,2,609,3.5,242.95931103532823,4
2020-05-23-170919,170919,1,0,0,610,0.3333333333333333,283.1799475072994,5
2020-05-24-170919,170919,0,0,0,610,0.3333333333333333,293.757930560137,6
2020-05-25-170919,170919,10,0,1,620,4.166666666666667,230.9907014288675,0
2020-05-26-170919,170919,7,0,1,627,4.833333333333333,263.6347650477285,1
2020-05-27-170919,170919,5,3,5,632,4.333333333333333,342.49916619850507,2
2020-05-28-170919,170919,6,0,4,638,2.333333333333333,333.3094075237304,3
2020-05-29-170919,170919,1,0,2,639,4.333333333333333,346.7067492552527,4
2020-05-30-170919,170919,1,0,0,640,0.16666666666666666,349.9307947565324,5
2020-05-31-170919,170919,0,0,0,640,0.5,358.44769644253734,6
2020-06-01-170919,170919,1,0,5,641,4.5,576.4479331597163,0
2020-06-02-170919,170919,4,0,3,645,2.5,177.38045182032334,1
2020-06-03-170919,170919,2,0,1,647,1.6666666666666667,149.85224119201007,2
2020-06-04-170919,170919,4,0,1,651,1.5,158.84376025170502,3
2020-06-05-170919,170919,2,1,2,653,3.0,180.45993738697067,4
2020-06-06-170919,170919,0,0,0,653,0.0,203.00561636019117,5
2020-06-07-170919,170919,0,0,0,653,0.3333333333333333,196.72478168820916,6
2020-06-08-170919,170919,1,0,2,654,0.8333333333333334,195.4902603093161,0
2020-06-09-170919,170919,1,0,0,655,1.8333333333333333,196.43323853586054,1
2020-06-10-170919,170919,5,0,0,660,1.3333333333333333,649.4589092322715,2
2020-06-11-170919,170919,4,1,1,664,1.1666666666666667,559.1908726837966,3
2020-06-12-170919,170919,2,0,0,666,1.6666666666666667,490.6106266264649,4
2020-06-13-170919,170919,0,1,2,666,0.16666666666666666,418.075795985327,5
2020-06-14-170919,170919,0,0,0,666,0.16666666666666666,319.3067296449767,6
2020-06-15-170919,170919,5,0,3,671,1.0,195.43176111622614,0
2020-06-16-170919,170919,3,0,0,674,2.833333333333333,224.65438167066048,1
2020-06-17-170919,170919,1,0,0,675,1.0,216.67803811664038,2
2020-06-18-170919,170919,1,1,0,676,2.0,203.3358595957168,3
2020-06-19-170919,170919,2,0,3,678,1.0,200.7665657754633,4
2020-06-20-170919,170919,0,0,0,678,0.3333333333333333,256.16476819232867,5
2020-06-21-170919,170919,0,0,1,678,0.16666666666666666,255.75828116331044,6
2020-06-22-170919,170919,2,0,1,680,1.5,218.50840399476152,0
2020-06-23-170919,170919,0,0,0,680,1.0,199.5235250745812,1
2020-06-24-170919,170919,0,0,1,680,1.0,204.34165231082267,2
2020-06-25-170919,170919,1,0,0,681,1.1666666666666667,194.21668069872146,3
2020-06-26-170919,170919,0,0,0,681,0.6666666666666666,186.59338862279898,4
2020-06-27-170919,170919,2,0,0,683,0.16666666666666666,161.4929010148876,5
2020-06-28-170919,170919,0,0,0,683,0.0,166.18147309954097,6
2020-06-29-170919,170919,3,0,0,686,1.3333333333333333,166.6471794668145,0
2020-06-30-170919,170919,0,0,2,686,1.1666666666666667,184.1515586517127,1
2020-07-01-170919,170919,0,0,0,686,0.8333333333333334,200.7502077328022,2
2020-07-02-170919,170919,0,0,0,686,0.5,83.3501336830773,3
2020-07-03-170919,170919,3,0,2,689,0.16666666666666666,86.80969294014102,4
2020-07-04-170919,170919,0,0,0,689,0.3333333333333333,127.38825495103528,5
2020-07-05-170919,170919,1,0,0,690,0.0,128.20163878452803,6
2020-07-06-170919,170919,1,0,0,691,0.5,115.97857052328598,0
2020-07-07-170919,170919,0,0,0,691,0.5,108.53555735909093,1
2020-07-08-170919,170919,1,0,2,692,1.1666666666666667,109.63572189408717,2
2020-07-09-170919,170919,0,0,0,692,0.6666666666666666,105.95137024240726,3
2020-07-10-170919,170919,0,1,0,692,1.0,186.56363503895636,4
2020-07-11-170919,170919,0,1,0,692,1.8333333333333333,157.69248938308863,5
2020-07-12-170919,170919,0,0,0,692,0.8333333333333334,132.90043645305389,6
2020-07-13-170919,170919,0,0,0,692,1.3333333333333333,147.86314158722993,0
2020-07-14-170919,170919,2,0,2,694,0.3333333333333333,158.22739628522612,1
2020-07-15-170919,170919,0,0,0,694,1.3333333333333333,136.18015405731074,2
2020-07-16-170919,170919,0,0,1,694,0.8333333333333334,112.8094797500376,3
2020-07-17-170919,170919,2,0,0,696,0.6666666666666666,111.88725388973167,4
2020-07-18-170919,170919,0,0,0,696,0.16666666666666666,116.46420064002737,5
2020-07-19-170919,170919,0,0,0,696,0.5,89.61294561210438,6
2020-07-20-170919,170919,0,0,0,696,1.0,78.54622325513795,0
2020-07-21-170919,170919,0,1,1,696,0.3333333333333333,77.73315365709644,1
2020-07-22-170919,170919,2,0,0,698,0.6666666666666666,77.5513295830728,2
2020-07-23-170919,170919,0,0,0,698,0.6666666666666666,85.40234118693576,3
2020-07-24-170919,170919,0,1,0,698,0.8333333333333334,80.01847739374753,4
2020-07-25-170919,170919,0,0,2,698,0.0,90.85297479662667,5
2020-07-26-170919,170919,0,0,1,698,0.0,87.62970185423339,6
2020-07-27-170919,170919,0,1,1,698,1.0,76.93456949125701,0
2020-07-28-170919,170919,2,0,3,700,1.3333333333333333,83.09707256770488,1
2020-07-29-170919,170919,0,0,0,700,1.0,92.42993025947519,2
2020-07-30-170919,170919,1,0,1,701,2.0,87.97095055039426,3
2020-07-31-170919,170919,0,0,0,701,0.8333333333333334,105.59958383818218,4
2020-08-01-170919,170919,0,0,0,701,1.1666666666666667,82.09924041663942,5
2020-08-02-170919,170919,0,0,5,701,0.5,498.18941308240915,6
2020-08-03-170919,170919,0,1,0,701,0.5,1063.8920836388147,0
2020-08-04-170919,170919,1,0,3,702,0.6666666666666666,884.5445908154084,1
2020-08-05-170919,170919,0,0,2,702,0.6666666666666666,737.6768473826183,2
2020-08-06-170919,170919,0,0,12,702,0.8333333333333334,563.7366802586731,3
2020-08-07-170919,170919,0,0,6,702,1.3333333333333333,364.23054809654417,4
2020-08-08-170919,170919,2,0,1,704,3.1666666666666665,340.3747433573657,5
2020-08-09-170919,170919,1,0,3,705,1.5,391.4031603646892,6
2020-08-10-170919,170919,1,0,6,706,2.333333333333333,83.58938071022432,0
2020-08-11-170919,170919,3,0,14,709,3.5,130.55121913130114,1
2020-08-12-170919,170919,0,0,7,709,1.3333333333333333,169.77452833799316,2
2020-08-13-170919,170919,1,0,10,710,3.0,199.85749261827968,3
2020-08-14-170919,170919,0,0,9,710,5.0,267.5247173048905,4
2020-08-15-170919,170919,0,1,0,710,2.1666666666666665,322.984872742144,5
2020-08-16-170919,170919,5,0,0,715,1.6666666666666667,333.69489734579327,6
2020-08-17-170919,170919,0,0,5,715,2.5,370.55682954513645,0
2020-08-18-170919,170919,3,0,2,718,3.5,370.92404200463227,1
2020-08-19-170919,170919,2,0,1,720,6.166666666666668,402.1407035218043,2
2020-08-20-170919,170919,12,2,2,732,2.6666666666666665,370.15297135366103,3
2020-08-21-170919,170919,6,0,6,738,2.333333333333333,434.05139079795197,4
2020-08-22-170919,170919,1,0,1,739,1.8333333333333333,483.208506278367,5
2020-08-23-170919,170919,3,0,1,742,1.1666666666666667,487.27843304143477,6
2020-08-24-170919,170919,6,0,8,748,5.333333333333333,486.9806812476319,0
2020-08-25-170919,170919,14,0,3,762,9.333333333333334,551.8879443642238,1
2020-08-26-170919,170919,7,0,6,769,10.333333333333334,662.3886502464711,2
2020-08-27-170919,170919,10,1,7,779,10.666666666666666,812.2778150248197,3
2020-08-28-170919,170919,9,0,4,788,8.833333333333334,861.4765027073066,4
2020-08-29-170919,170919,0,0,0,788,1.3333333333333333,1009.2059843145437,5
2020-08-30-170919,170919,0,0,1,788,0.3333333333333333,989.0747464811803,6
2020-08-31-170919,170919,5,0,10,793,10.166666666666666,884.6873197202202,0
2020-09-01-170919,170919,2,0,11,795,7.333333333333332,426.27192493790926,1
2020-09-02-170919,170919,1,1,9,796,8.833333333333334,1189.8826600609293,2
2020-09-03-170919,170919,2,0,6,798,6.333333333333332,954.5758992982685,3
2020-09-04-170919,170919,6,0,2,804,9.833333333333334,996.6948212147694,4
2020-09-05-170919,170919,1,0,1,805,1.0,909.7856715404198,5
2020-09-06-170919,170919,1,0,0,806,2.833333333333333,846.8487471418433,6
2020-09-07-170919,170919,8,0,6,814,7.833333333333332,885.947004433885,0
2020-09-08-170919,170919,3,0,5,817,2.1666666666666665,938.0936362087198,1
2020-09-09-170919,170919,6,0,6,823,8.833333333333334,830.6444834944823,2
2020-09-10-170919,170919,7,0,3,830,8.0,362.6936218212192,3
2020-09-11-170919,170919,4,0,10,834,7.833333333333332,507.5243730306704,4
2020-09-12-170919,170919,0,0,3,834,1.6666666666666667,700.3878461088227,5
2020-09-13-170919,170919,1,0,0,835,2.1666666666666665,715.3907852418997,6
2020-09-14-170919,170919,10,0,2,845,9.333333333333334,737.2251445793614,0
2020-09-15-170919,170919,11,0,3,856,10.166666666666666,877.4112956376086,1
2020-09-16-170919,170919,9,0,5,865,11.166666666666664,1084.6204891160091,2
2020-09-17-170919,170919,6,0,1,871,9.666666666666666,1211.5158789985194,3
2020-09-18-170919,170919,2,0,7,873,9.333333333333334,1315.532018689421,4
2020-09-19-170919,170919,1,0,2,874,1.8333333333333333,1266.4634092593274,5
2020-09-20-170919,170919,0,0,0,874,3.1666666666666665,1398.1281824653713,6
2020-09-21-170919,170919,6,1,11,880,11.0,1222.6622305563783,0
2020-09-22-170919,170919,5,0,3,885,13.333333333333336,1223.0936859001824,1
2020-09-23-170919,170919,6,1,18,891,9.5,1194.5802008918731,2
2020-09-24-170919,170919,3,0,10,894,5.5,1056.6214906336222,3
2020-09-25-170919,170919,10,1,9,904,11.5,1010.3431952612365,4
2020-09-26-170919,170919,3,0,1,907,6.666666666666668,1225.1290126806557,5
2020-09-27-170919,170919,0,0,1,907,1.0,1190.7888082878674,6
2020-09-28-170919,170919,2,0,2,909,6.5,1165.8855632619834,0
2020-09-29-170919,170919,3,0,22,912,6.0,1111.068592828387,1
2020-09-30-170919,170919,5,1,9,917,6.333333333333332,1062.101011440564,2
2020-10-01-170919,170919,1,0,15,918,9.166666666666666,0.0,3
2020-10-02-170919,170919,7,0,1,925,10.166666666666666,1214.439665687321,4
2020-10-03-170919,170919,2,2,3,927,1.1666666666666667,2371.435512150397,5
2020-10-04-170919,170919,0,1,4,927,0.5,2382.290777355447,6
2020-10-05-170919,170919,11,0,16,938,11.0,1965.6469366422107,0
2020-10-06-170919,170919,3,0,11,941,9.333333333333334,1847.7095779841443,1
2020-10-07-170919,170919,18,0,32,959,9.333333333333334,1599.5372989015743,2
2020-10-08-170919,170919,10,0,35,969,5.666666666666668,1378.4080105494268,3
2020-10-09-170919,170919,9,1,53,978,5.333333333333333,1571.5663182076428,4
2020-10-10-170919,170919,1,0,2,979,1.1666666666666667,177.22563618062915,5
2020-10-11-170919,170919,1,0,0,980,0.5,253.2885198710172,6
2020-10-12-170919,170919,2,0,27,982,1.3333333333333333,279.38700431427634,0
2020-10-13-170919,170919,22,0,23,1004,7.5,306.84717102397883,1
2020-10-14-170919,170919,9,0,35,1013,9.0,502.88653263222307,2
2020-10-15-170919,170919,15,0,26,1028,9.833333333333334,705.6364839690857,3
2020-10-16-170919,170919,1,0,24,1029,6.833333333333332,917.4161523298742,4
2020-10-17-170919,170919,3,0,7,1032,1.5,953.6555817415854,5
2020-10-18-170919,170919,4,0,3,1036,2.833333333333333,956.2390416611541,6
2020-10-19-170919,170919,16,1,1,1052,11.833333333333336,992.1158128821053,0
2020-10-20-170919,170919,11,0,17,1063,19.0,1301.788760452664,1
2020-10-21-170919,170919,32,0,20,1095,14.5,1366.8452016202539,2
2020-10-22-170919,170919,35,2,43,1130,17.0,1476.1416471441198,3
2020-10-23-170919,170919,53,0,38,1183,23.5,1683.0278580420827,4
2020-10-24-170919,170919,2,0,1,1185,3.6666666666666665,2101.180043129165,5
2020-10-25-170919,170919,0,2,0,1185,3.0,2097.2130371547555,6
2020-10-26-170919,170919,27,2,23,1212,20.33333333333333,1900.6971183766796,0
2020-10-27-170919,170919,23,2,15,1235,17.5,2114.5710518264505,1
2020-10-28-170919,170919,35,2,18,1270,18.33333333333333,2166.753536673871,2
2020-10-29-170919,170919,26,2,24,1296,32.833333333333336,2279.588599743649,3
2020-10-30-170919,170919,24,2,17,1320,25.83333333333333,1941.616051734521,4
2020-10-31-170919,170919,7,1,0,1327,5.666666666666668,2305.9807988025864,5
2020-11-01-170919,170919,3,2,0,1330,15.333333333333336,1263.5730386382675,6
2020-11-02-170919,170919,1,1,0,1331,5.5,1838.0234257087695,0
2020-11-03-170919,170919,17,3,0,1348,21.166666666666668,1507.2188045720052,1
2020-11-04-170919,170919,20,2,0,1368,26.0,1848.7249345743376,2
2020-11-05-170919,170919,43,1,0,1411,34.833333333333336,1966.5163928445484,3
2020-11-06-170919,170919,38,0,0,1449,32.333333333333336,2238.448152531175,4
2020-11-07-170919,170919,1,1,0,1450,5.0,2472.947429547803,5
2020-11-08-170919,170919,0,0,0,1450,10.666666666666666,2302.7407604460814,6
2020-11-09-170919,170919,23,0,0,1473,19.83333333333333,2318.762300902717,0
2020-11-10-170919,170919,15,0,0,1488,18.0,1222.509677318293,1
2020-11-11-170919,170919,18,1,0,1506,17.833333333333332,1473.6233580319954,2
2020-11-12-170919,170919,24,2,0,1530,17.0,1607.706218324589,3
2020-11-13-170919,170919,17,1,0,1547,24.66666666666667,1733.6686580816329,4
2020-03-01-170920,170920,0,0,1,0,0.0,0.0,6
2020-03-02-170920,170920,0,0,3,0,0.0,43.27193609187459,0
2020-03-03-170920,170920,0,0,3,0,0.0,197.21752120829134,1
2020-03-04-170920,170920,0,0,8,0,0.0,203.47347913309864,2
2020-03-05-170920,170920,0,0,9,0,0.0,219.2239576750332,3
2020-03-06-170920,170920,0,0,6,0,0.25,196.92206326398045,4
2020-03-07-170920,170920,0,0,5,0,0.0,198.13441287146452,5
2020-03-08-170920,170920,0,0,2,0,0.0,193.5685231518425,6
2020-03-09-170920,170920,0,0,15,0,0.0,194.4988291715256,0
2020-03-10-170920,170920,0,0,2,0,0.125,848.6541241705136,1
2020-03-11-170920,170920,0,0,9,0,0.375,711.0419319603621,2
2020-03-12-170920,170920,0,0,5,0,0.125,502.7255848725415,3
2020-03-13-170920,170920,1,0,5,1,0.5,300.1671355636461,4
2020-03-14-170920,170920,0,0,4,1,0.125,180.83544049471539,5
2020-03-15-170920,170920,1,0,3,2,0.75,131.11559295651728,6
2020-03-16-170920,170920,3,0,5,5,2.5,36.638784060109735,0
2020-03-17-170920,170920,3,0,3,8,2.125,87.7006352557049,1
2020-03-18-170920,170920,8,0,9,16,4.25,119.28137893312416,2
2020-03-19-170920,170920,9,0,2,25,4.0,170.88146208787649,3
2020-03-20-170920,170920,6,0,3,31,4.625,219.40223032993737,4
2020-03-21-170920,170920,5,0,0,36,2.375,247.92652902005412,5
2020-03-22-170920,170920,2,0,1,38,1.875,261.7176789772691,6
2020-03-23-170920,170920,15,0,6,53,8.125,241.55840262243174,0
2020-03-24-170920,170920,2,0,21,55,5.875,312.7546061308261,1
2020-03-25-170920,170920,9,0,3,64,6.125,303.02092198076457,2
2020-03-26-170920,170920,5,0,13,69,5.5,306.93379793830934,3
2020-03-27-170920,170920,5,0,8,74,4.375,346.41495497005627,4
2020-03-28-170920,170920,4,0,1,78,1.375,353.85799627289396,5
2020-03-29-170920,170920,3,0,0,81,2.0,342.28293623838897,6
2020-03-30-170920,170920,5,0,4,86,5.875,243.2223579212658,0
2020-03-31-170920,170920,3,0,3,89,3.375,247.89117612157855,1
2020-04-01-170920,170920,9,0,15,98,3.5,36.776388659331346,2
2020-04-02-170920,170920,2,0,0,100,2.25,198.82124758549776,3
2020-04-03-170920,170920,3,0,3,103,4.125,93.4864004637823,4
2020-04-04-170920,170920,0,0,1,103,1.25,111.08153439599481,5
2020-04-05-170920,170920,1,0,0,104,2.25,111.92670625630055,6
2020-04-06-170920,170920,6,0,4,110,3.375,117.31130153170797,0
2020-04-07-170920,170920,21,0,1,131,5.375,145.2433342100696,1
2020-04-08-170920,170920,3,1,2,134,2.5,231.72610730524235,2
2020-04-09-170920,170920,13,0,0,147,2.0,241.4701669346643,3
2020-04-10-170920,170920,8,0,5,155,2.25,48.79047621863559,4
2020-04-11-170920,170920,1,0,1,156,6.375,80.12621511903951,5
2020-04-12-170920,170920,0,0,0,156,1.875,93.67252136404872,6
2020-04-13-170920,170920,4,1,0,160,6.875,102.12987324132439,0
2020-04-14-170920,170920,3,0,2,163,3.875,163.16914645609296,1
2020-04-15-170920,170920,15,0,3,178,2.375,193.08435818345947,2
2020-04-16-170920,170920,0,0,5,178,3.625,257.0141511947903,3
2020-04-17-170920,170920,3,1,0,181,2.75,237.84207446524135,4
2020-04-18-170920,170920,1,0,0,182,0.625,232.8844417910069,5
2020-04-19-170920,170920,0,0,2,182,0.375,222.17276926088715,6
2020-04-20-170920,170920,4,0,3,186,2.625,168.15615440358943,0
2020-04-21-170920,170920,1,0,2,187,2.75,167.71385325315936,1
2020-04-22-170920,170920,2,0,7,189,1.625,115.90074348098813,2
2020-04-23-170920,170920,0,0,4,189,0.375,118.23319387966065,3
2020-04-24-170920,170920,5,0,7,194,2.75,96.58810761218128,4
2020-04-25-170920,170920,1,0,1,195,0.875,126.90849794864567,5
2020-04-26-170920,170920,0,1,0,195,0.75,134.5908537085662,6
2020-04-27-170920,170920,0,0,2,195,2.625,112.03776975372057,0
2020-04-28-170920,170920,2,0,2,197,1.5,98.5544738379569,1
2020-04-29-170920,170920,3,0,2,200,3.0,94.3373356030669,2
2020-04-30-170920,170920,5,0,2,205,1.625,138.5538714416151,3
2020-05-01-170920,170920,0,0,1,205,0.0,307.00944484151813,4
2020-05-02-170920,170920,0,0,0,205,0.375,74.97216597619594,5
2020-05-03-170920,170920,2,0,0,207,0.25,72.31971033267655,6
2020-05-04-170920,170920,3,0,1,210,3.375,67.2570022694703,0
2020-05-05-170920,170920,2,0,0,212,1.75,92.20018629585503,1
2020-05-06-170920,170920,7,0,0,219,10.625,105.65622613191331,2
2020-05-07-170920,170920,4,0,0,223,3.625,148.0096740688593,3
2020-05-08-170920,170920,7,0,0,230,2.75,164.60452245783623,4
2020-05-09-170920,170920,1,0,0,231,0.625,216.3242297859618,5
2020-05-10-170920,170920,0,0,1,231,0.25,336.4796000785712,6
2020-05-11-170920,170920,2,1,3,233,1.75,322.13491304752233,0
2020-05-12-170920,170920,2,0,0,235,3.5,338.49670779323884,1
2020-05-13-170920,170920,2,0,0,237,1.875,301.12563113471606,2
2020-05-14-170920,170920,2,2,1,239,1.75,184.48897705956483,3
2020-05-15-170920,170920,1,0,2,240,1.375,163.57893608204984,4
2020-05-16-170920,170920,0,0,2,240,0.375,100.57342711053886,5
2020-05-17-170920,170920,0,0,1,240,0.125,98.78991335497942,6
2020-05-18-170920,170920,1,0,1,241,2.25,99.50902223562449,0
2020-05-19-170920,170920,0,0,2,241,3.0,99.38109866686584,1
2020-05-20-170920,170920,0,0,4,241,2.125,77.01686124172979,2
2020-05-21-170920,170920,0,0,2,241,2.25,66.841799863771,3
2020-05-22-170920,170920,0,0,2,241,1.5,66.39308581718436,4
2020-05-23-170920,170920,0,0,0,241,0.125,77.27611320814955,5
2020-05-24-170920,170920,1,0,1,242,0.0,79.74438164401985,6
2020-05-25-170920,170920,3,0,1,245,1.25,61.78566810413382,0
2020-05-26-170920,170920,0,0,2,245,1.375,75.47554359069805,1
2020-05-27-170920,170920,0,0,2,245,1.375,83.34361770154837,2
2020-05-28-170920,170920,1,2,3,246,2.875,82.67154046526593,3
2020-05-29-170920,170920,2,1,4,248,1.375,100.10318031492966,4
2020-05-30-170920,170920,2,0,1,250,0.125,128.9897598961614,5
2020-05-31-170920,170920,1,0,0,251,0.25,134.9301607589914,6
2020-06-01-170920,170920,1,0,0,252,2.125,299.3202848960133,0
2020-06-02-170920,170920,2,0,2,254,1.125,114.89060060706522,1
2020-06-03-170920,170920,4,0,5,258,1.25,72.44748253436704,2
2020-06-04-170920,170920,2,0,3,260,1.25,79.18796014873102,3
2020-06-05-170920,170920,2,1,3,262,0.5,96.27598254046,4
2020-06-06-170920,170920,0,0,1,262,0.125,114.36136636655436,5
2020-06-07-170920,170920,1,0,0,263,0.0,115.4271543344855,6
2020-06-08-170920,170920,1,0,1,264,1.0,122.46648764815029,0
2020-06-09-170920,170920,2,0,3,266,0.875,122.84783270777965,1
2020-06-10-170920,170920,2,0,2,268,1.375,344.85109356777116,2
2020-06-11-170920,170920,3,0,0,271,0.75,320.62518224255643,3
2020-06-12-170920,170920,4,0,0,275,0.375,316.86313962604527,4
2020-06-13-170920,170920,1,1,0,276,0.125,249.54211048130816,5
2020-06-14-170920,170920,0,0,0,276,0.0,206.51314839015134,6
2020-06-15-170920,170920,0,0,2,276,0.625,132.89229372324382,0
2020-06-16-170920,170920,2,0,1,278,1.0,128.7954887836428,1
2020-06-17-170920,170920,5,0,1,283,0.125,121.81979636359843,2
2020-06-18-170920,170920,3,0,0,286,0.375,133.29719564510725,3
2020-06-19-170920,170920,3,0,0,289,0.5,130.97724972672742,4
2020-06-20-170920,170920,1,0,0,290,0.0,146.982540066121,5
2020-06-21-170920,170920,0,0,0,290,0.0,154.33131153866813,6
2020-06-22-170920,170920,1,0,2,291,0.625,149.98140278669214,0
2020-06-23-170920,170920,3,0,0,294,0.125,146.43860077374453,1
2020-06-24-170920,170920,2,0,0,296,0.125,134.90597442257757,2
2020-06-25-170920,170920,0,0,0,296,0.625,127.36831528128275,3
2020-06-26-170920,170920,0,0,0,296,0.5,105.15661911267674,4
2020-06-27-170920,170920,0,0,0,296,0.125,85.96318046369502,5
2020-06-28-170920,170920,0,0,0,296,0.0,80.05252887776652,6
2020-06-29-170920,170920,2,0,1,298,0.375,80.64305651059169,0
2020-06-30-170920,170920,1,0,0,299,0.25,105.34068667005123,1
2020-07-01-170920,170920,1,0,2,300,0.25,132.4245274227966,2
2020-07-02-170920,170920,0,0,1,300,0.375,60.804933911314045,3
2020-07-03-170920,170920,0,1,2,300,0.125,109.76597218537954,4
2020-07-04-170920,170920,0,0,0,300,0.0,115.80620348483757,5
2020-07-05-170920,170920,0,0,0,300,0.125,115.7892264749306,6
2020-07-06-170920,170920,2,0,1,302,0.0,98.88674333523838,0
2020-07-07-170920,170920,0,0,1,302,0.125,99.95872710378747,1
2020-07-08-170920,170920,0,0,1,302,0.125,76.24528420546291,2
2020-07-09-170920,170920,0,0,0,302,0.25,76.1863588819418,3
2020-07-10-170920,170920,0,0,1,302,0.25,135.96068451322375,4
2020-07-11-170920,170920,0,0,0,302,0.25,112.3232602699091,5
2020-07-12-170920,170920,0,0,0,302,0.0,87.42756024073937,6
2020-07-13-170920,170920,1,0,1,303,0.375,88.08024448311453,0
2020-07-14-170920,170920,0,0,3,303,0.375,89.87265074910667,1
2020-07-15-170920,170920,2,0,3,305,0.125,69.81050210583717,2
2020-07-16-170920,170920,1,0,4,306,0.625,51.57889182260418,3
2020-07-17-170920,170920,2,0,1,308,0.125,45.653317916369005,4
2020-07-18-170920,170920,0,0,0,308,0.0,60.42087333421006,5
2020-07-19-170920,170920,0,0,3,308,0.125,58.028371468319584,6
2020-07-20-170920,170920,1,0,0,309,0.25,54.42289680075801,0
2020-07-21-170920,170920,1,0,0,310,0.75,61.1779016363364,1
2020-07-22-170920,170920,1,0,0,311,0.125,63.28340124246422,2
2020-07-23-170920,170920,0,0,0,311,0.875,68.88447678049447,3
2020-07-24-170920,170920,1,0,0,312,0.375,76.2262617872525,4
2020-07-25-170920,170920,0,0,0,312,0.0,91.53527852958992,5
2020-07-26-170920,170920,0,0,0,312,0.0,89.9280019885784,6
2020-07-27-170920,170920,1,0,0,313,0.375,84.68019220058738,0
2020-07-28-170920,170920,3,0,0,316,0.125,95.0658546003475,1
2020-07-29-170920,170920,3,2,0,319,0.25,93.0055051927788,2
2020-07-30-170920,170920,4,0,0,323,0.25,83.9372188671665,3
2020-07-31-170920,170920,1,0,0,324,0.5,97.38576709177076,4
2020-08-01-170920,170920,0,0,1,324,0.0,45.203742944927896,5
2020-08-02-170920,170920,3,0,0,327,0.0,143.91282053814018,6
2020-08-03-170920,170920,0,0,0,327,0.125,735.8518657209445,0
2020-08-04-170920,170920,0,0,1,327,0.25,638.3769342726006,1
2020-08-05-170920,170920,0,0,2,327,0.25,477.54774807355125,2
2020-08-06-170920,170920,0,0,11,327,0.25,386.3785933268842,3
2020-08-07-170920,170920,0,0,4,327,0.75,296.5542319580655,4
2020-08-08-170920,170920,0,0,3,327,0.25,209.7766207007143,5
2020-08-09-170920,170920,0,0,2,327,0.125,208.56156941748787,6
2020-08-10-170920,170920,0,0,9,327,0.75,31.45725149714616,0
2020-08-11-170920,170920,0,0,20,327,1.5,38.668548796983345,1
2020-08-12-170920,170920,0,0,20,327,0.75,54.563631391918506,2
2020-08-13-170920,170920,0,0,9,327,0.75,45.999895434389245,3
2020-08-14-170920,170920,0,0,7,327,0.875,66.62895571362799,4
2020-08-15-170920,170920,1,0,12,328,1.625,80.46185387493263,5
2020-08-16-170920,170920,0,0,13,328,0.25,90.91891448141348,6
2020-08-17-170920,170920,0,0,5,328,1.875,96.58136657287454,0
2020-08-18-170920,170920,1,0,6,329,1.0,105.04469659955379,1
2020-08-19-170920,170920,2,0,11,331,2.375,99.7117197149752,2
2020-08-20-170920,170920,11,1,8,342,1.625,144.80246666360736,3
2020-08-21-170920,170920,4,0,5,346,0.75,221.2195537045244,4
2020-08-22-170920,170920,3,0,2,349,1.0,233.55988742376402,5
2020-08-23-170920,170920,2,0,1,351,0.375,257.79822752879284,6
2020-08-24-170920,170920,9,0,5,360,1.5,266.5324428743369,0
2020-08-25-170920,170920,20,0,7,380,1.875,346.03450707710397,1
2020-08-26-170920,170920,20,0,3,400,1.0,422.7179115620106,2
2020-08-27-170920,170920,9,0,5,409,2.5,559.7563542324574,3
2020-08-28-170920,170920,7,0,3,416,2.125,569.9004840463541,4
2020-08-29-170920,170920,12,0,4,428,0.25,623.5890595281484,5
2020-08-30-170920,170920,13,0,1,441,0.25,658.5337303753194,6
2020-08-31-170920,170920,5,0,9,446,2.375,657.8394997224731,0
2020-09-01-170920,170920,6,0,3,452,1.375,98.66347653925537,1
2020-09-02-170920,170920,11,0,8,463,2.5,635.1403345885723,2
2020-09-03-170920,170920,8,0,6,471,1.0,685.0917042871145,3
2020-09-04-170920,170920,5,0,9,476,2.75,566.9603925572217,4
2020-09-05-170920,170920,2,0,1,478,1.375,444.887341687158,5
2020-09-06-170920,170920,1,0,3,479,1.125,401.8360492988479,6
2020-09-07-170920,170920,5,0,4,484,4.625,383.3909749843335,0
2020-09-08-170920,170920,7,0,2,491,2.0,428.74384184131566,1
2020-09-09-170920,170920,3,0,3,494,1.625,412.5085088701754,2
2020-09-10-170920,170920,5,0,14,499,1.875,86.85118154859248,3
2020-09-11-170920,170920,3,0,10,502,3.5,163.23595992222238,4
2020-09-12-170920,170920,4,0,1,506,1.625,217.55263815419534,5
2020-09-13-170920,170920,1,0,3,507,1.125,274.64815422093824,6
2020-09-14-170920,170920,9,0,2,516,3.75,292.67237039983786,0
2020-09-15-170920,170920,3,0,1,519,3.125,410.7627278851459,1
2020-09-16-170920,170920,8,0,5,527,4.625,488.25320869401145,2
2020-09-17-170920,170920,6,0,10,533,5.875,579.6504672590894,3
2020-09-18-170920,170920,9,0,7,542,3.0,599.1752749546131,4
2020-09-19-170920,170920,1,0,13,543,2.0,633.4038841464904,5
2020-09-20-170920,170920,3,0,3,546,0.875,647.9391940378549,6
2020-09-21-170920,170920,4,0,2,550,2.875,550.5898028424759,0
2020-09-22-170920,170920,2,1,14,552,4.75,530.2743707817419,1
2020-09-23-170920,170920,3,1,4,555,4.875,456.3538416466035,2
2020-09-24-170920,170920,14,1,17,569,5.125,425.7455820089449,3
2020-09-25-170920,170920,10,1,6,579,6.875,492.52243423866713,4
2020-09-26-170920,170920,1,0,0,580,5.25,612.2290053626153,5
2020-09-27-170920,170920,3,0,7,583,0.875,624.2737559838233,6
2020-09-28-170920,170920,2,0,0,585,3.75,632.0207223159957,0
2020-09-29-170920,170920,1,0,3,586,2.75,614.75839580088,1
2020-09-30-170920,170920,5,0,9,591,3.375,616.5079385111438,2
2020-10-01-170920,170920,10,0,7,601,4.25,0.0,3
2020-10-02-170920,170920,7,0,20,608,5.25,644.5719456329705,4
2020-10-03-170920,170920,13,1,9,621,1.25,912.7706408152633,5
2020-10-04-170920,170920,3,0,5,624,1.125,1028.570426822274,6
2020-10-05-170920,170920,2,0,2,626,4.375,881.1990576976668,0
2020-10-06-170920,170920,14,0,14,640,6.125,779.5275859730322,1
2020-10-07-170920,170920,4,1,7,644,4.625,795.7478754049125,2
2020-10-08-170920,170920,17,1,8,661,8.25,688.5861461571607,3
2020-10-09-170920,170920,6,2,4,667,4.0,791.2002329534619,4
2020-10-10-170920,170920,0,0,10,667,2.375,105.91663304099674,5
2020-10-11-170920,170920,7,0,1,674,2.75,154.65945035076786,6
2020-10-12-170920,170920,0,0,4,674,1.0,243.70604081763582,0
2020-10-13-170920,170920,3,0,13,677,4.125,252.21247946617103,1
2020-10-14-170920,170920,9,0,8,686,4.5,316.58089589280087,2
2020-10-15-170920,170920,7,0,17,693,3.625,411.99717370607016,3
2020-10-16-170920,170920,20,0,9,713,3.125,511.68759506533627,4
2020-10-17-170920,170920,9,0,5,722,2.125,570.6995372450174,5
2020-10-18-170920,170920,5,0,0,727,2.125,606.8627990297504,6
2020-10-19-170920,170920,2,0,2,729,7.25,571.1037973303272,0
2020-10-20-170920,170920,14,0,7,743,7.125,690.0316222484021,1
2020-10-21-170920,170920,7,0,3,750,8.875,753.8468822985769,2
2020-10-22-170920,170920,8,0,9,758,9.625,765.2774315022278,3
2020-10-23-170920,170920,4,0,12,762,10.25,731.0924793908772,4
2020-10-24-170920,170920,10,0,9,772,2.375,760.6443261345382,5
2020-10-25-170920,170920,1,0,3,773,1.5,788.1397380711268,6
2020-10-26-170920,170920,4,0,2,777,11.5,735.4336334002664,0
2020-10-27-170920,170920,13,0,6,790,6.5,777.6883190605953,1
2020-10-28-170920,170920,8,2,9,798,10.625,766.6303571861947,2
2020-10-29-170920,170920,17,2,7,815,5.75,787.3481653589788,3
2020-10-30-170920,170920,9,0,8,824,11.5,846.8619784168463,4
2020-10-31-170920,170920,5,1,0,829,4.75,907.7659743011229,5
2020-11-01-170920,170920,0,0,0,829,2.25,741.1657198638936,6
2020-11-02-170920,170920,2,0,0,831,3.875,507.0738985684129,0
2020-11-03-170920,170920,7,0,0,838,8.25,442.46579327448705,1
2020-11-04-170920,170920,3,0,0,841,9.5,560.1537189299811,2
2020-11-05-170920,170920,9,0,0,850,11.0,634.7325057440139,3
2020-11-06-170920,170920,12,1,0,862,10.0,672.9419085432472,4
2020-11-07-170920,170920,9,0,0,871,3.0,784.9294796186782,5
2020-11-08-170920,170920,3,0,0,874,1.0,797.8911721210306,6
2020-11-09-170920,170920,2,0,0,876,6.875,746.1314059775992,0
2020-11-10-170920,170920,6,0,0,882,6.5,664.2235945683167,1
2020-11-11-170920,170920,9,1,0,891,7.375,721.7585489098908,2
2020-11-12-170920,170920,7,0,0,898,4.875,777.7600944517237,3
2020-11-13-170920,170920,8,1,0,906,6.0,733.511771946677,4
2020-03-01-170924,170924,0,0,0,0,0.0,0.0,6
2020-03-02-170924,170924,0,0,0,0,0.0,4.279651313766568,0
2020-03-03-170924,170924,0,0,0,0,0.0,23.67486791405058,1
2020-03-04-170924,170924,0,0,0,0,0.2,22.448881228096095,2
2020-03-05-170924,170924,0,0,0,0,0.0,21.41475864809791,3
2020-03-06-170924,170924,0,0,0,0,0.0,18.899784512429026,4
2020-03-07-170924,170924,0,0,0,0,0.0,21.868533475164504,5
2020-03-08-170924,170924,0,0,0,0,0.0,22.067831211105762,6
2020-03-09-170924,170924,0,0,0,0,0.0,22.249471088184166,0
2020-03-10-170924,170924,0,0,0,0,0.2,139.48018441700307,1
2020-03-11-170924,170924,0,0,2,0,0.2,108.01816780081433,2
2020-03-12-170924,170924,0,0,1,0,0.0,77.15309351831083,3
2020-03-13-170924,170924,0,0,0,0,0.2,43.55609008842068,4
2020-03-14-170924,170924,0,0,0,0,0.0,32.458948229687465,5
2020-03-15-170924,170924,0,0,0,0,0.6,25.09701628045866,6
2020-03-16-170924,170924,0,0,0,0,0.8,7.586308196543486,0
2020-03-17-170924,170924,0,0,0,0,0.8,13.105252034291892,1
2020-03-18-170924,170924,0,2,0,0,0.4,16.66548104840121,2
2020-03-19-170924,170924,0,0,0,0,0.4,19.26385470571969,3
2020-03-20-170924,170924,0,0,0,0,1.6,20.930503749052612,4
2020-03-21-170924,170924,0,0,0,0,0.6,29.048560818510627,5
2020-03-22-170924,170924,0,0,0,0,0.8,29.387032545150042,6
2020-03-23-170924,170924,0,0,1,0,2.0,28.68286687715383,0
2020-03-24-170924,170924,0,0,2,0,2.0,33.598710606602666,1
2020-03-25-170924,170924,2,0,1,2,1.6,39.71555025498108,2
2020-03-26-170924,170924,1,0,0,3,1.4,44.13552315095371,3
2020-03-27-170924,170924,0,0,0,3,1.0,53.58842467033628,4
2020-03-28-170924,170924,0,1,0,3,0.0,51.65235029447984,5
2020-03-29-170924,170924,0,0,0,3,0.4,48.246606637627124,6
2020-03-30-170924,170924,0,0,1,3,1.8,36.27457268314218,0
2020-03-31-170924,170924,0,0,1,3,2.2,32.38912559664249,1
2020-04-01-170924,170924,0,0,0,3,1.6,6.961139857567565,2
2020-04-02-170924,170924,0,0,1,3,0.6,31.856534160697496,3
2020-04-03-170924,170924,0,0,1,3,1.8,11.936311809553395,4
2020-04-04-170924,170924,0,0,0,3,0.8,15.033419510088653,5
2020-04-05-170924,170924,0,1,0,3,0.8,16.914260809672783,6
2020-04-06-170924,170924,1,0,1,4,0.8,19.705017025860656,0
2020-04-07-170924,170924,2,0,14,6,2.0,23.193090277285247,1
2020-04-08-170924,170924,1,0,1,7,0.6,29.50305055909525,2
2020-04-09-170924,170924,0,0,0,7,0.2,30.546127227638003,3
2020-04-10-170924,170924,0,0,0,7,0.8,6.247210902235167,4
2020-04-11-170924,170924,0,0,0,7,0.4,8.631018728986582,5
2020-04-12-170924,170924,0,0,0,7,0.4,9.684241036919577,6
2020-04-13-170924,170924,1,0,0,8,2.2,11.19356633049515,0
2020-04-14-170924,170924,1,0,2,9,1.2,19.734224539329826,1
2020-04-15-170924,170924,0,0,0,9,0.6,25.249762949186707,2
2020-04-16-170924,170924,1,0,0,10,1.2,27.766533647929954,3
2020-04-17-170924,170924,1,0,0,11,1.4,27.641501269645335,4
2020-04-18-170924,170924,0,0,0,11,0.2,32.42065366236168,5
2020-04-19-170924,170924,0,0,0,11,0.2,32.19925919123918,6
2020-04-20-170924,170924,1,0,0,12,0.6,25.26317399692557,0
2020-04-21-170924,170924,14,0,0,26,0.6,22.748094650581784,1
2020-04-22-170924,170924,1,0,0,27,0.4,36.82423227648434,2
2020-04-23-170924,170924,0,1,0,27,0.4,35.71193401917871,3
2020-04-24-170924,170924,0,0,0,27,1.0,29.27191210322358,4
2020-04-25-170924,170924,0,0,0,27,0.2,32.34542357998917,5
2020-04-26-170924,170924,0,0,0,27,0.0,34.60800233234366,6
2020-04-27-170924,170924,0,0,0,27,0.2,32.21431348698528,0
2020-04-28-170924,170924,2,0,3,29,0.2,29.69124119814742,1
2020-04-29-170924,170924,0,0,3,29,0.6,14.260558202947443,2
2020-04-30-170924,170924,0,0,2,29,0.2,20.71803966159908,3
2020-05-01-170924,170924,0,0,0,29,0.0,34.9972768924639,4
2020-05-02-170924,170924,0,0,0,29,0.0,14.676201739758188,5
2020-05-03-170924,170924,0,0,0,29,0.0,8.271773521341526,6
2020-05-04-170924,170924,0,0,0,29,0.0,8.433169810058882,0
2020-05-05-170924,170924,0,0,0,29,0.0,9.078300755435244,1
2020-05-06-170924,170924,0,0,0,29,1.0,9.61320123520417,2
2020-05-07-170924,170924,0,0,0,29,0.6,11.835379312333886,3
2020-05-08-170924,170924,0,0,1,29,0.8,14.852401782188537,4
2020-05-09-170924,170924,0,0,0,29,0.2,19.99176926425484,5
2020-05-10-170924,170924,0,0,0,29,0.2,37.966704849477075,6
2020-05-11-170924,170924,0,0,1,29,1.0,34.04780056272985,0
2020-05-12-170924,170924,3,1,0,32,0.2,33.825480098108876,1
2020-05-13-170924,170924,3,0,0,35,0.4,32.040280023604645,2
2020-05-14-170924,170924,2,0,1,37,0.2,24.29227487260102,3
2020-05-15-170924,170924,0,0,1,37,0.0,23.965415794142125,4
2020-05-16-170924,170924,0,0,0,37,0.0,21.21870549542618,5
2020-05-17-170924,170924,0,0,0,37,0.0,21.489474293970357,6
2020-05-18-170924,170924,0,1,2,37,0.8,20.888090906107312,0
2020-05-19-170924,170924,0,0,0,37,0.2,21.135911911650783,1
2020-05-20-170924,170924,0,0,0,37,0.4,11.241412680220517,2
2020-05-21-170924,170924,0,0,0,37,0.0,8.710353199855055,3
2020-05-22-170924,170924,1,0,0,38,0.2,8.757619960346423,4
2020-05-23-170924,170924,0,1,0,38,0.0,11.657363056165881,5
2020-05-24-170924,170924,0,0,0,38,0.0,11.734478491171142,6
2020-05-25-170924,170924,1,1,0,39,0.0,7.309262174577462,0
2020-05-26-170924,170924,0,0,0,39,0.2,8.413762971696183,1
2020-05-27-170924,170924,0,1,1,39,0.0,8.903905865805346,2
2020-05-28-170924,170924,1,0,0,40,0.6,7.688060880494898,3
2020-05-29-170924,170924,1,0,0,41,0.2,12.11808932280632,4
2020-05-30-170924,170924,0,0,0,41,0.0,12.78823326601317,5
2020-05-31-170924,170924,0,0,0,41,0.4,13.816841793605114,6
2020-06-01-170924,170924,2,0,0,43,0.6,29.228727160287537,0
2020-06-02-170924,170924,0,0,0,43,0.2,5.722577136681679,1
2020-06-03-170924,170924,0,0,0,43,0.2,4.586109382193666,2
2020-06-04-170924,170924,0,0,0,43,0.0,6.57280758585556,3
2020-06-05-170924,170924,0,0,0,43,0.2,6.751357785679046,4
2020-06-06-170924,170924,0,0,0,43,0.0,7.806790229198105,5
2020-06-07-170924,170924,0,0,0,43,0.0,7.572739264861095,6
2020-06-08-170924,170924,0,0,0,43,0.4,7.598586936249387,0
2020-06-09-170924,170924,0,0,0,43,0.8,8.682726451072337,1
2020-06-10-170924,170924,1,0,0,44,0.4,35.126329408796536,2
2020-06-11-170924,170924,0,0,0,44,0.0,36.875416899894546,3
2020-06-12-170924,170924,0,0,0,44,0.0,36.78950271404344,4
2020-06-13-170924,170924,0,0,0,44,0.0,28.778613430679506,5
2020-06-14-170924,170924,0,1,0,44,0.2,21.275832035238995,6
2020-06-15-170924,170924,0,1,0,44,0.0,16.413320036025123,0
2020-06-16-170924,170924,0,0,0,44,0.2,15.412021317658226,1
2020-06-17-170924,170924,0,0,0,44,0.0,8.786546653822256,2
2020-06-18-170924,170924,0,0,0,44,0.0,6.078536483506112,3
2020-06-19-170924,170924,0,0,0,44,0.0,5.774769538207105,4
2020-06-20-170924,170924,0,0,0,44,0.0,7.157177778400554,5
2020-06-21-170924,170924,0,0,0,44,0.0,6.413012992699677,6
2020-06-22-170924,170924,0,0,0,44,0.0,5.584593537735131,0
2020-06-23-170924,170924,0,0,0,44,0.2,4.5459618903868595,1
2020-06-24-170924,170924,0,0,0,44,0.0,5.537495316034097,2
2020-06-25-170924,170924,0,0,0,44,0.0,5.6111972884438845,3
2020-06-26-170924,170924,0,0,0,44,0.0,5.584696029670538,4
2020-06-27-170924,170924,0,0,0,44,0.0,4.534752408111964,5
2020-06-28-170924,170924,0,0,0,44,0.0,4.612106468937799,6
2020-06-29-170924,170924,0,0,0,44,0.2,4.688609835475026,0
2020-06-30-170924,170924,0,0,0,44,0.2,7.057730936419242,1
2020-07-01-170924,170924,0,0,0,44,0.0,12.052243851051916,2
2020-07-02-170924,170924,0,0,0,44,0.0,5.9710695969335115,3
2020-07-03-170924,170924,0,0,0,44,0.0,9.491378384053638,4
2020-07-04-170924,170924,0,0,0,44,0.0,5.519848835919219,5
2020-07-05-170924,170924,0,0,0,44,0.2,5.496872098419933,6
2020-07-06-170924,170924,0,0,0,44,0.2,5.876172553436031,0
2020-07-07-170924,170924,0,0,1,44,0.0,5.583975606781051,1
2020-07-08-170924,170924,0,1,0,44,0.0,5.138051257484332,2
2020-07-09-170924,170924,0,0,0,44,0.0,5.394918456121591,3
2020-07-10-170924,170924,0,0,0,44,0.0,10.92346820216815,4
2020-07-11-170924,170924,0,0,0,44,0.2,11.147332849709217,5
2020-07-12-170924,170924,0,0,0,44,0.0,10.034616741897246,6
2020-07-13-170924,170924,0,0,0,44,0.0,9.831714460553505,0
2020-07-14-170924,170924,0,0,0,44,0.0,9.923709740677445,1
2020-07-15-170924,170924,0,0,0,44,0.0,7.265117659704104,2
2020-07-16-170924,170924,0,0,0,44,0.4,4.377985239334179,3
2020-07-17-170924,170924,0,0,0,44,0.2,4.958388378384576,4
2020-07-18-170924,170924,0,0,0,44,0.0,5.430773326476109,5
2020-07-19-170924,170924,0,0,0,44,0.2,4.305796289661095,6
2020-07-20-170924,170924,0,0,0,44,0.0,5.741946151465918,0
2020-07-21-170924,170924,1,0,0,45,0.6,5.829519929184432,1
2020-07-22-170924,170924,0,0,0,45,0.2,10.14824078005144,2
2020-07-23-170924,170924,0,0,0,45,1.6,9.221623447252348,3
2020-07-24-170924,170924,0,0,0,45,0.0,13.136816239458298,4
2020-07-25-170924,170924,0,0,0,45,0.0,13.512040738942908,5
2020-07-26-170924,170924,0,0,0,45,0.0,12.041264466759134,6
2020-07-27-170924,170924,0,0,0,45,0.2,11.945098626488765,0
2020-07-28-170924,170924,0,0,0,45,0.4,12.456152123183106,1
2020-07-29-170924,170924,0,0,0,45,0.0,9.195771077780915,2
2020-07-30-170924,170924,0,0,0,45,0.4,3.593006145691885,3
2020-07-31-170924,170924,0,0,0,45,0.4,4.034083454447143,4
2020-08-01-170924,170924,0,0,0,45,0.0,4.954629182230928,5
2020-08-02-170924,170924,0,0,0,45,0.0,31.314917972409212,6
2020-08-03-170924,170924,0,1,0,45,0.2,53.84094605646628,0
2020-08-04-170924,170924,0,0,0,45,0.0,50.76717163848315,1
2020-08-05-170924,170924,0,0,0,45,0.2,42.52479183358841,2
2020-08-06-170924,170924,0,0,1,45,0.0,31.232682899848207,3
2020-08-07-170924,170924,0,0,0,45,0.6,25.694748265475155,4
2020-08-08-170924,170924,0,0,0,45,0.0,26.37508721121411,5
2020-08-09-170924,170924,0,0,0,45,0.4,23.757905017690707,6
2020-08-10-170924,170924,0,0,0,45,0.2,3.7477649864627702,0
2020-08-11-170924,170924,0,0,0,45,1.0,4.993669941200421,1
2020-08-12-170924,170924,0,0,0,45,0.2,8.871458569560609,2
2020-08-13-170924,170924,0,0,0,45,0.4,10.579983996081946,3
2020-08-14-170924,170924,0,0,0,45,0.4,12.537477725611463,4
2020-08-15-170924,170924,0,0,0,45,0.0,16.82779684514228,5
2020-08-16-170924,170924,0,0,0,45,0.4,17.239946310199258,6
2020-08-17-170924,170924,0,0,1,45,1.8,21.736057109538592,0
2020-08-18-170924,170924,0,0,1,45,0.4,29.530874240966913,1
2020-08-19-170924,170924,0,0,0,45,0.4,29.457524136095124,2
2020-08-20-170924,170924,1,0,0,46,0.6,30.497726157676453,3
2020-08-21-170924,170924,0,0,3,46,1.0,33.12175104004844,4
2020-08-22-170924,170924,0,0,0,46,0.6,34.90841841154487,5
2020-08-23-170924,170924,0,0,0,46,0.0,34.60537431695866,6
2020-08-24-170924,170924,0,0,0,46,0.6,26.128872937505037,0
2020-08-25-170924,170924,0,0,0,46,1.4,28.164405469566987,1
2020-08-26-170924,170924,0,0,0,46,0.8,35.48371978288883,2
2020-08-27-170924,170924,0,0,0,46,1.4,42.36949138877322,3
2020-08-28-170924,170924,0,0,0,46,0.6,46.063173682095446,4
2020-08-29-170924,170924,0,0,2,46,0.0,49.06973084866918,5
2020-08-30-170924,170924,0,0,1,46,0.8,51.029886306334404,6
2020-08-31-170924,170924,1,0,3,47,0.8,48.112556793192205,0
2020-09-01-170924,170924,1,0,0,48,0.8,19.82701013633623,1
2020-09-02-170924,170924,0,0,0,48,0.8,69.53720639325729,2
2020-09-03-170924,170924,0,0,1,48,0.6,128.35314403936064,3
2020-09-04-170924,170924,3,0,0,51,1.4,113.42424349533735,4
2020-09-05-170924,170924,0,0,0,51,0.0,68.94214155316365,5
2020-09-06-170924,170924,0,0,0,51,0.0,62.08898608812893,6
2020-09-07-170924,170924,0,0,1,51,2.4,33.52434966189909,0
2020-09-08-170924,170924,0,0,0,51,0.6,48.50802490633447,1
2020-09-09-170924,170924,0,0,0,51,0.8,52.5040042145132,2
2020-09-10-170924,170924,0,0,0,51,0.4,17.956509696872253,3
2020-09-11-170924,170924,0,0,1,51,0.8,22.227527322625402,4
2020-09-12-170924,170924,2,0,0,53,0.8,30.543309047450244,5
2020-09-13-170924,170924,1,0,0,54,0.0,40.14717109583614,6
2020-09-14-170924,170924,3,0,0,57,0.0,39.63365685219125,0
2020-09-15-170924,170924,0,0,0,57,0.4,47.751347818783515,1
2020-09-16-170924,170924,0,0,0,57,0.2,51.56808346618024,2
2020-09-17-170924,170924,1,0,0,58,0.4,48.11492368565327,3
2020-09-18-170924,170924,0,0,0,58,1.2,67.57161795318697,4
2020-09-19-170924,170924,0,0,0,58,0.2,68.54658624966676,5
2020-09-20-170924,170924,0,0,0,58,0.4,62.50181426550584,6
2020-09-21-170924,170924,1,1,1,59,0.8,55.46418567178,0
2020-09-22-170924,170924,0,0,0,59,3.0,56.460678948177794,1
2020-09-23-170924,170924,0,0,0,59,3.6,69.83262418447302,2
2020-09-24-170924,170924,0,0,0,59,1.0,62.97616373777997,3
2020-09-25-170924,170924,1,0,0,60,9.4,60.85031339656361,4
2020-09-26-170924,170924,0,0,0,60,1.0,101.3135768330479,5
2020-09-27-170924,170924,0,0,0,60,0.8,101.83807976578909,6
2020-09-28-170924,170924,0,0,0,60,0.2,128.12530959423577,0
2020-09-29-170924,170924,0,0,0,60,1.2,126.8355216151312,1
2020-09-30-170924,170924,0,0,0,60,2.0,102.12602607311915,2
2020-10-01-170924,170924,0,0,0,60,1.0,0.0,3
2020-10-02-170924,170924,0,0,0,60,2.2,213.5401898277093,4
2020-10-03-170924,170924,0,1,0,60,0.4,263.8471653315011,5
2020-10-04-170924,170924,0,0,1,60,0.8,199.72889941391443,6
2020-10-05-170924,170924,1,0,1,61,0.8,165.76483701827573,0
2020-10-06-170924,170924,0,0,0,61,2.2,143.63724360248239,1
2020-10-07-170924,170924,0,0,2,61,2.8,108.79035302348291,2
2020-10-08-170924,170924,0,0,0,61,5.2,98.05569806331417,3
2020-10-09-170924,170924,0,0,7,61,2.4,124.88348785213105,4
2020-10-10-170924,170924,0,0,1,61,3.2,6.757533065509273,5
2020-10-11-170924,170924,0,0,9,61,4.0,20.225760976072003,6
2020-10-12-170924,170924,0,0,2,61,1.6,44.47674867598247,0
2020-10-13-170924,170924,0,0,2,61,2.8,52.865093477278506,1
2020-10-14-170924,170924,0,0,1,61,1.8,76.84439829854131,2
2020-10-15-170924,170924,0,0,4,61,4.6,94.2942986432873,3
2020-10-16-170924,170924,0,0,1,61,4.8,133.54715395142875,4
2020-10-17-170924,170924,0,0,1,61,4.8,147.4889737779495,5
2020-10-18-170924,170924,1,0,1,62,3.0,158.97083749436672,6
2020-10-19-170924,170924,1,0,0,63,9.2,160.81900225689253,0
2020-10-20-170924,170924,0,0,7,63,5.8,207.04966015407297,1
2020-10-21-170924,170924,2,0,0,65,15.0,221.36522830352635,2
2020-10-22-170924,170924,0,0,2,65,9.0,260.0454974868047,3
2020-10-23-170924,170924,7,0,1,72,8.8,300.80693244067186,4
2020-10-24-170924,170924,1,0,0,73,1.0,347.90857296718224,5
2020-10-25-170924,170924,9,0,1,82,2.2,322.13280892753795,6
2020-10-26-170924,170924,2,0,0,84,4.4,285.1845528804908,0
2020-10-27-170924,170924,2,0,1,86,3.2,292.4031209679942,1
2020-10-28-170924,170924,1,0,1,87,5.2,282.3061678760837,2
2020-10-29-170924,170924,4,0,3,91,2.8,246.61066374720167,3
2020-10-30-170924,170924,1,1,5,92,5.0,146.54858715572726,4
2020-10-31-170924,170924,1,0,0,93,1.2,178.63536468997827,5
2020-11-01-170924,170924,1,0,0,94,0.0,84.67913462507273,6
2020-11-02-170924,170924,0,0,0,94,0.8,116.1066343633812,0
2020-11-03-170924,170924,7,0,0,101,3.4,98.93072542969364,1
2020-11-04-170924,170924,0,0,0,101,3.4,121.51401440945048,2
2020-11-05-170924,170924,2,0,0,103,4.0,140.9403719604668,3
2020-11-06-170924,170924,1,0,0,104,3.8,144.40999839107866,4
2020-11-07-170924,170924,0,0,0,104,1.2,156.48321784066377,5
2020-11-08-170924,170924,1,0,0,105,0.6,142.33444388094912,6
2020-11-09-170924,170924,0,0,0,105,2.2,135.46229354561194,0
2020-11-10-170924,170924,1,0,0,106,2.0,75.16045483437682,1
2020-11-11-170924,170924,1,0,0,107,1.6,83.41043471297145,2
2020-11-12-170924,170924,3,0,0,110,2.0,93.08838015736764,3
2020-11-13-170924,170924,5,0,0,115,0.8,101.17869299954063,4
2020-03-01-170925,170925,0,0,1,0,0.0,0.0,6
2020-03-02-170925,170925,0,0,0,0,0.0,5.048015233094101,0
2020-03-03-170925,170925,0,0,1,0,0.0,26.75689016264915,1
2020-03-04-170925,170925,0,1,0,0,0.0,21.12671299216243,2
2020-03-05-170925,170925,0,0,1,0,0.0,19.76760540921737,3
2020-03-06-170925,170925,0,0,0,0,0.0,14.856211736579127,4
2020-03-07-170925,170925,0,0,0,0,0.0,16.333808953286873,5
2020-03-08-170925,170925,0,0,2,0,0.0,16.346270574708903,6
2020-03-09-170925,170925,0,0,2,0,0.0,16.220393811384653,0
2020-03-10-170925,170925,0,0,1,0,0.16666666666666666,129.0586717254568,1
2020-03-11-170925,170925,1,0,0,1,0.0,102.48806730460903,2
2020-03-12-170925,170925,0,0,2,1,0.0,74.96808379325502,3
2020-03-13-170925,170925,0,0,0,1,0.3333333333333333,40.35876072514329,4
2020-03-14-170925,170925,0,0,0,1,0.0,29.127786275337307,5
2020-03-15-170925,170925,1,0,0,2,0.5,23.219867420660893,6
2020-03-16-170925,170925,0,0,0,2,1.1666666666666667,8.209403068028697,0
2020-03-17-170925,170925,1,0,0,3,0.6666666666666666,17.23596159054929,1
2020-03-18-170925,170925,0,2,1,3,1.0,21.55861726256621,2
2020-03-19-170925,170925,1,0,1,4,0.6666666666666666,23.230608163004128,3
2020-03-20-170925,170925,0,0,0,4,3.1666666666666665,27.82642720140126,4
2020-03-21-170925,170925,0,0,1,4,1.1666666666666667,34.1505872843964,5
2020-03-22-170925,170925,2,1,0,6,1.0,33.56145645347708,6
2020-03-23-170925,170925,2,0,0,8,3.5,31.437338325077498,0
2020-03-24-170925,170925,1,0,0,9,2.1666666666666665,37.05643548738794,1
2020-03-25-170925,170925,0,0,0,9,2.5,45.349543861905744,2
2020-03-26-170925,170925,2,0,0,11,2.0,51.94301372494644,3
2020-03-27-170925,170925,0,0,0,11,2.1666666666666665,61.86457290555008,4
2020-03-28-170925,170925,0,0,0,11,0.3333333333333333,64.21762921419004,5
2020-03-29-170925,170925,0,0,0,11,0.8333333333333334,60.72136884938909,6
2020-03-30-170925,170925,0,0,1,11,1.8333333333333333,45.79635240935981,0
2020-03-31-170925,170925,0,1,0,11,1.8333333333333333,36.71381761928728,1
2020-04-01-170925,170925,1,0,0,12,1.6666666666666667,4.270459674216033,2
2020-04-02-170925,170925,1,0,1,13,0.5,37.50480205344897,3
2020-04-03-170925,170925,0,0,1,13,1.5,16.102488857699953,4
2020-04-04-170925,170925,1,0,1,14,1.0,16.87908226107629,5
2020-04-05-170925,170925,0,0,0,14,0.8333333333333334,17.893480337651496,6
2020-04-06-170925,170925,0,1,0,14,1.1666666666666667,20.479789687005358,0
2020-04-07-170925,170925,0,0,0,14,2.333333333333333,26.003104056726514,1
2020-04-08-170925,170925,0,0,1,14,1.3333333333333333,31.277104939549837,2
2020-04-09-170925,170925,0,0,0,14,0.16666666666666666,32.023877390539376,3
2020-04-10-170925,170925,0,0,1,14,0.8333333333333334,7.039677639428518,4
2020-04-11-170925,170925,0,0,1,14,0.5,9.775201992562206,5
2020-04-12-170925,170925,0,1,0,14,0.5,10.429810481862772,6
2020-04-13-170925,170925,1,1,0,15,1.6666666666666667,12.914074950763968,0
2020-04-14-170925,170925,0,0,1,15,1.5,24.7999567942737,1
2020-04-15-170925,170925,0,0,0,15,0.8333333333333334,33.46485731551801,2
2020-04-16-170925,170925,1,0,0,16,0.8333333333333334,35.38925841088897,3
2020-04-17-170925,170925,1,0,0,17,1.1666666666666667,34.98995617160625,4
2020-04-18-170925,170925,1,0,0,18,0.0,40.189931206512696,5
2020-04-19-170925,170925,0,1,0,18,0.16666666666666666,40.82844933224843,6
2020-04-20-170925,170925,0,0,0,18,0.8333333333333334,29.487398194350902,0
2020-04-21-170925,170925,0,0,0,18,3.1666666666666665,23.46155923523157,1
2020-04-22-170925,170925,1,0,0,19,0.5,34.32840960248616,2
2020-04-23-170925,170925,0,0,1,19,0.16666666666666666,34.28766363961643,3
2020-04-24-170925,170925,1,0,0,20,0.3333333333333333,27.212955030623434,4
2020-04-25-170925,170925,1,0,0,21,0.3333333333333333,32.678983255048614,5
2020-04-26-170925,170925,0,0,1,21,0.16666666666666666,36.555116488257845,6
2020-04-27-170925,170925,0,0,1,21,0.0,33.14298559040731,0
2020-04-28-170925,170925,1,0,0,22,0.6666666666666666,30.90210310779007,1
2020-04-29-170925,170925,0,0,0,22,0.6666666666666666,21.39947877651705,2
2020-04-30-170925,170925,0,0,0,22,0.16666666666666666,27.102223748463516,3
2020-05-01-170925,170925,0,0,0,22,0.0,34.52515849404863,4
2020-05-02-170925,170925,0,0,0,22,0.0,16.174039273384093,5
2020-05-03-170925,170925,0,0,0,22,0.0,9.16723122711443,6
2020-05-04-170925,170925,0,0,1,22,0.16666666666666666,11.936617648678194,0
2020-05-05-170925,170925,0,0,0,22,0.0,11.010631731030525,1
2020-05-06-170925,170925,0,0,0,22,1.1666666666666667,11.089219036866089,2
2020-05-07-170925,170925,1,0,0,23,0.6666666666666666,12.496359964312632,3
2020-05-08-170925,170925,0,0,0,23,0.5,14.90531485963285,4
2020-05-09-170925,170925,0,0,0,23,0.3333333333333333,17.91728563223189,5
2020-05-10-170925,170925,1,1,0,24,0.0,32.42790019185068,6
2020-05-11-170925,170925,1,0,0,25,0.5,29.758004806846014,0
2020-05-12-170925,170925,0,0,1,25,0.8333333333333334,33.30909705435364,1
2020-05-13-170925,170925,0,0,0,25,0.8333333333333334,28.555312355006656,2
2020-05-14-170925,170925,0,0,0,25,0.5,23.043216568550314,3
2020-05-15-170925,170925,0,0,0,25,0.16666666666666666,23.07673284819123,4
2020-05-16-170925,170925,0,1,0,25,0.0,20.605632838531314,5
2020-05-17-170925,170925,0,0,1,25,0.0,20.791012420893082,6
2020-05-18-170925,170925,1,0,0,26,0.3333333333333333,19.023658960276403,0
2020-05-19-170925,170925,0,0,0,26,0.0,20.836302392324093,1
2020-05-20-170925,170925,0,0,0,26,0.3333333333333333,12.85341908232584,2
2020-05-21-170925,170925,0,0,0,26,0.0,12.344578824440314,3
2020-05-22-170925,170925,0,0,0,26,0.3333333333333333,12.254430190431362,4
2020-05-23-170925,170925,0,0,0,26,0.16666666666666666,16.548294742882995,5
2020-05-24-170925,170925,0,0,0,26,0.0,17.162675783852443,6
2020-05-25-170925,170925,0,0,0,26,0.16666666666666666,10.668724543138103,0
2020-05-26-170925,170925,1,0,1,27,0.16666666666666666,11.3310955937486,1
2020-05-27-170925,170925,0,0,0,27,0.3333333333333333,11.855970371515888,2
2020-05-28-170925,170925,0,3,0,27,0.6666666666666666,9.795827781474836,3
2020-05-29-170925,170925,0,0,0,27,0.5,14.352432699391155,4
2020-05-30-170925,170925,0,1,0,27,0.0,15.035849606253885,5
2020-05-31-170925,170925,1,0,1,28,0.16666666666666666,16.11969061233058,6
2020-06-01-170925,170925,0,0,0,28,0.8333333333333334,32.281311174044134,0
2020-06-02-170925,170925,0,0,0,28,0.3333333333333333,6.661277124174952,1
2020-06-03-170925,170925,0,0,0,28,0.16666666666666666,7.253223749908894,2
2020-06-04-170925,170925,0,0,0,28,0.0,6.076239157879513,3
2020-06-05-170925,170925,0,0,0,28,0.3333333333333333,5.693807190750886,4
2020-06-06-170925,170925,0,0,0,28,0.0,6.077253524102936,5
2020-06-07-170925,170925,0,0,0,28,0.0,5.946069982645048,6
2020-06-08-170925,170925,0,0,0,28,0.3333333333333333,5.915956362030181,0
2020-06-09-170925,170925,1,0,0,29,0.16666666666666666,8.624460555342614,1
2020-06-10-170925,170925,0,0,0,29,0.5,30.231786799713962,2
2020-06-11-170925,170925,0,0,0,29,0.0,31.488963261802404,3
2020-06-12-170925,170925,0,0,0,29,0.0,31.606681529955793,4
2020-06-13-170925,170925,0,0,0,29,0.16666666666666666,24.769040572351923,5
2020-06-14-170925,170925,1,0,0,30,0.0,15.15270869143298,6
2020-06-15-170925,170925,0,0,0,30,0.16666666666666666,14.55172346119512,0
2020-06-16-170925,170925,0,2,0,30,0.0,14.632465208071531,1
2020-06-17-170925,170925,0,0,0,30,0.0,9.907474485945318,2
2020-06-18-170925,170925,0,0,0,30,0.0,7.253463832281594,3
2020-06-19-170925,170925,0,0,0,30,0.0,6.462931838392871,4
2020-06-20-170925,170925,0,0,0,30,0.0,7.2600821335202825,5
2020-06-21-170925,170925,0,0,0,30,0.0,5.009262817427029,6
2020-06-22-170925,170925,0,0,0,30,0.0,3.9571551045030366,0
2020-06-23-170925,170925,0,0,0,30,0.3333333333333333,3.669647820350394,1
2020-06-24-170925,170925,0,0,0,30,0.0,6.794683087656579,2
2020-06-25-170925,170925,0,3,0,30,0.0,7.164893813257899,3
2020-06-26-170925,170925,0,0,0,30,0.3333333333333333,7.961926636611951,4
2020-06-27-170925,170925,0,0,0,30,0.0,7.96049228924605,5
2020-06-28-170925,170925,0,0,0,30,0.0,8.32370482154286,6
2020-06-29-170925,170925,0,0,0,30,0.16666666666666666,8.252653091464643,0
2020-06-30-170925,170925,0,0,0,30,0.3333333333333333,7.072740505218313,1
2020-07-01-170925,170925,0,0,0,30,0.0,15.532499440449739,2
2020-07-02-170925,170925,0,0,0,30,0.0,13.184842275869661,3
2020-07-03-170925,170925,0,0,1,30,0.3333333333333333,8.18090636367487,4
2020-07-04-170925,170925,0,0,0,30,0.0,7.555967876432144,5
2020-07-05-170925,170925,0,0,0,30,0.0,7.494262241096243,6
2020-07-06-170925,170925,0,0,0,30,0.16666666666666666,7.241185676431263,0
2020-07-07-170925,170925,0,0,0,30,0.0,6.551227426065605,1
2020-07-08-170925,170925,0,1,0,30,0.0,6.2069629504634865,2
2020-07-09-170925,170925,0,0,0,30,0.0,6.620769151629643,3
2020-07-10-170925,170925,0,0,0,30,0.3333333333333333,13.527571862310994,4
2020-07-11-170925,170925,0,0,0,30,0.16666666666666666,14.49894159537663,5
2020-07-12-170925,170925,0,0,0,30,0.0,15.225496776404174,6
2020-07-13-170925,170925,0,0,0,30,0.0,15.000681290499555,0
2020-07-14-170925,170925,0,0,0,30,0.0,14.940431208188935,1
2020-07-15-170925,170925,0,0,0,30,0.0,10.755854655654634,2
2020-07-16-170925,170925,0,0,0,30,0.3333333333333333,7.410868603740287,3
2020-07-17-170925,170925,1,0,0,31,0.0,9.792288319585209,4
2020-07-18-170925,170925,0,0,0,31,0.0,11.492438279214706,5
2020-07-19-170925,170925,0,0,0,31,0.16666666666666666,8.464412611016549,6
2020-07-20-170925,170925,0,0,0,31,0.16666666666666666,12.46192473907034,0
2020-07-21-170925,170925,0,0,0,31,0.3333333333333333,12.76146597525661,1
2020-07-22-170925,170925,0,0,0,31,0.16666666666666666,16.783306788708156,2
2020-07-23-170925,170925,0,0,0,31,0.0,13.596581869151802,3
2020-07-24-170925,170925,0,0,0,31,0.0,12.225605614520301,4
2020-07-25-170925,170925,0,0,0,31,0.0,12.551919721333611,5
2020-07-26-170925,170925,0,0,0,31,0.0,8.897717315093745,6
2020-07-27-170925,170925,0,0,0,31,0.3333333333333333,8.678260234135372,0
2020-07-28-170925,170925,0,0,0,31,0.6666666666666666,8.895270817702595,1
2020-07-29-170925,170925,0,0,0,31,0.0,7.493507774095198,2
2020-07-30-170925,170925,0,0,0,31,0.3333333333333333,6.156466132068857,3
2020-07-31-170925,170925,0,0,0,31,0.3333333333333333,6.391908649044578,4
2020-08-01-170925,170925,0,0,0,31,0.0,6.271070600204649,5
2020-08-02-170925,170925,0,0,0,31,0.16666666666666666,24.969990429825998,6
2020-08-03-170925,170925,0,0,1,31,0.0,65.56309815698695,0
2020-08-04-170925,170925,0,0,0,31,0.0,49.78344652565403,1
2020-08-05-170925,170925,0,0,0,31,0.16666666666666666,42.9518416534147,2
2020-08-06-170925,170925,0,0,0,31,0.16666666666666666,29.93347182544594,3
2020-08-07-170925,170925,0,0,0,31,0.16666666666666666,25.476205263216144,4
2020-08-08-170925,170925,0,0,0,31,0.0,22.623127412024793,5
2020-08-09-170925,170925,0,0,0,31,0.0,20.97445682993896,6
2020-08-10-170925,170925,0,0,0,31,0.5,6.125023637484945,0
2020-08-11-170925,170925,0,0,0,31,0.6666666666666666,8.337338330231443,1
2020-08-12-170925,170925,0,0,0,31,0.16666666666666666,13.39585440298288,2
2020-08-13-170925,170925,0,0,0,31,0.5,14.612548768295081,3
2020-08-14-170925,170925,0,0,0,31,0.5,17.40663350215158,4
2020-08-15-170925,170925,0,0,0,31,0.0,19.29948864773819,5
2020-08-16-170925,170925,0,0,1,31,0.6666666666666666,20.276873904140622,6
2020-08-17-170925,170925,1,0,0,32,1.5,23.23926100979382,0
2020-08-18-170925,170925,0,0,0,32,0.3333333333333333,29.413649762041707,1
2020-08-19-170925,170925,0,0,0,32,0.6666666666666666,26.37434983315398,2
2020-08-20-170925,170925,0,0,0,32,0.6666666666666666,26.18516799660582,3
2020-08-21-170925,170925,0,0,0,32,1.8333333333333333,29.27298456532396,4
2020-08-22-170925,170925,0,0,0,32,0.3333333333333333,36.83966510100577,5
2020-08-23-170925,170925,0,0,0,32,0.0,40.31457648510282,6
2020-08-24-170925,170925,0,0,0,32,1.0,33.53129960902856,0
2020-08-25-170925,170925,0,0,0,32,1.6666666666666667,40.28605101201775,1
2020-08-26-170925,170925,0,1,0,32,1.1666666666666667,55.606238780664256,2
2020-08-27-170925,170925,0,0,0,32,2.1666666666666665,61.32671411320645,3
2020-08-28-170925,170925,0,0,0,32,0.8333333333333334,69.11455093998477,4
2020-08-29-170925,170925,0,0,0,32,0.8333333333333334,65.6369365340314,5
2020-08-30-170925,170925,1,0,0,33,0.3333333333333333,63.59804719994456,6
2020-08-31-170925,170925,0,0,0,33,1.3333333333333333,57.3649199554561,0
2020-09-01-170925,170925,0,0,0,33,1.3333333333333333,14.999350457932467,1
2020-09-02-170925,170925,0,0,0,33,0.6666666666666666,73.20485244563943,2
2020-09-03-170925,170925,0,0,0,33,0.8333333333333334,188.4016426754893,3
2020-09-04-170925,170925,0,0,1,33,2.0,175.68725917163192,4
2020-09-05-170925,170925,0,0,0,33,0.16666666666666666,66.03850417257188,5
2020-09-06-170925,170925,0,0,0,33,0.0,60.924015626515,6
2020-09-07-170925,170925,0,0,0,33,2.1666666666666665,46.07671761631933,0
2020-09-08-170925,170925,0,0,0,33,0.5,62.90319082214791,1
2020-09-09-170925,170925,0,0,0,33,2.5,72.18225243431291,2
2020-09-10-170925,170925,0,0,0,33,0.5,12.601473902658917,3
2020-09-11-170925,170925,0,0,0,33,0.6666666666666666,18.252714154386915,4
2020-09-12-170925,170925,0,0,0,33,1.1666666666666667,32.501551767863326,5
2020-09-13-170925,170925,0,0,0,33,0.3333333333333333,39.02088229617026,6
2020-09-14-170925,170925,0,0,0,33,0.5,41.015627542828454,0
2020-09-15-170925,170925,0,0,0,33,0.5,49.60544548171683,1
2020-09-16-170925,170925,0,0,0,33,0.3333333333333333,57.04702894298911,2
2020-09-17-170925,170925,0,0,0,33,0.5,57.65878405798031,3
2020-09-18-170925,170925,1,0,0,34,0.6666666666666666,71.58876636063678,4
2020-09-19-170925,170925,0,0,0,34,0.0,69.50685053878489,5
2020-09-20-170925,170925,0,0,0,34,0.16666666666666666,69.04630137942505,6
2020-09-21-170925,170925,0,0,0,34,1.3333333333333333,63.415564506855816,0
2020-09-22-170925,170925,0,0,0,34,2.5,67.54265843309811,1
2020-09-23-170925,170925,0,0,0,34,2.333333333333333,75.67665952271346,2
2020-09-24-170925,170925,0,0,0,34,0.5,73.49247257481287,3
2020-09-25-170925,170925,0,0,0,34,8.0,72.40653636215939,4
2020-09-26-170925,170925,0,0,0,34,0.6666666666666666,173.17839845709625,5
2020-09-27-170925,170925,0,0,2,34,0.3333333333333333,175.48909871190762,6
2020-09-28-170925,170925,0,0,5,34,0.3333333333333333,185.61420033259128,0
2020-09-29-170925,170925,0,0,2,34,0.3333333333333333,179.13846361666108,1
2020-09-30-170925,170925,0,0,3,34,1.6666666666666667,155.2365001488758,2
2020-10-01-170925,170925,0,0,3,34,0.6666666666666666,0.0,3
2020-10-02-170925,170925,0,0,2,34,0.8333333333333334,214.94608089373145,4
2020-10-03-170925,170925,0,0,7,34,0.16666666666666666,193.3846680679327,5
2020-10-04-170925,170925,0,0,3,34,0.6666666666666666,144.93780429681365,6
2020-10-05-170925,170925,0,0,8,34,0.6666666666666666,128.6325223718204,0
2020-10-06-170925,170925,0,0,1,34,0.6666666666666666,113.7109194061569,1
2020-10-07-170925,170925,0,0,17,34,1.3333333333333333,95.88746985007225,2
2020-10-08-170925,170925,0,0,4,34,1.6666666666666667,92.99929326474694,3
2020-10-09-170925,170925,0,1,1,34,0.6666666666666666,113.67134370441042,4
2020-10-10-170925,170925,0,0,0,34,0.6666666666666666,7.741912275574935,5
2020-10-11-170925,170925,2,0,5,36,1.5,20.12861268498085,6
2020-10-12-170925,170925,5,0,0,41,0.6666666666666666,35.965596917713846,0
2020-10-13-170925,170925,2,0,1,43,1.6666666666666667,51.64318215687183,1
2020-10-14-170925,170925,3,0,0,46,5.833333333333332,79.03092886350373,2
2020-10-15-170925,170925,3,0,0,49,1.1666666666666667,96.67333092363488,3
2020-10-16-170925,170925,2,0,1,51,1.5,133.26150231199097,4
2020-10-17-170925,170925,7,0,2,58,1.1666666666666667,145.88738427907595,5
2020-10-18-170925,170925,3,0,0,61,2.0,158.5972802869758,6
2020-10-19-170925,170925,8,0,4,69,6.5,174.00880533971025,0
2020-10-20-170925,170925,1,0,3,70,3.0,201.29777960768808,1
2020-10-21-170925,170925,17,0,2,87,7.333333333333332,208.73752296060198,2
2020-10-22-170925,170925,4,0,2,91,6.833333333333332,232.3146546081338,3
2020-10-23-170925,170925,1,0,1,92,7.833333333333332,255.53396138157763,4
2020-10-24-170925,170925,0,0,0,92,1.5,281.8326228639021,5
2020-10-25-170925,170925,5,0,0,97,2.833333333333333,250.51194017407522,6
2020-10-26-170925,170925,0,0,0,97,4.333333333333333,215.02612768608185,0
2020-10-27-170925,170925,1,1,1,98,3.0,220.94066508215045,1
2020-10-28-170925,170925,0,0,2,98,6.166666666666668,211.82718534507848,2
2020-10-29-170925,170925,0,0,5,98,3.8333333333333335,179.95027527501736,3
2020-10-30-170925,170925,1,0,0,99,4.666666666666667,115.97152922470775,4
2020-10-31-170925,170925,2,0,0,101,1.3333333333333333,141.3958927448433,5
2020-11-01-170925,170925,0,0,0,101,0.8333333333333334,84.78075382811099,6
2020-11-02-170925,170925,4,0,0,105,0.3333333333333333,172.48970257562706,0
2020-11-03-170925,170925,3,0,0,108,3.1666666666666665,151.4007094745519,1
2020-11-04-170925,170925,2,0,0,110,3.8333333333333335,153.60904517503405,2
2020-11-05-170925,170925,2,0,0,112,3.333333333333333,165.93899532574102,3
2020-11-06-170925,170925,1,0,0,113,3.5,159.47582378466944,4
2020-11-07-170925,170925,0,0,0,113,1.5,156.5811432668783,5
2020-11-08-170925,170925,0,1,0,113,1.3333333333333333,142.6659982569742,6
2020-11-09-170925,170925,0,0,0,113,2.5,131.86224775378005,0
2020-11-10-170925,170925,1,1,0,114,1.8333333333333333,80.98289362631579,1
2020-11-11-170925,170925,2,0,0,116,2.5,87.40982903921434,2
2020-11-12-170925,170925,5,1,0,121,2.0,96.89904908061888,3
2020-11-13-170925,170925,0,0,0,121,2.0,114.33304494669392,4
2020-03-01-170926,170926,0,0,0,0,0.0,0.0,6
2020-03-02-170926,170926,0,0,7,0,0.14285714285714285,64.65275568459343,0
2020-03-03-170926,170926,0,0,2,0,0.0,325.0008936133238,1
2020-03-04-170926,170926,0,0,4,0,0.14285714285714285,341.6777889833887,2
2020-03-05-170926,170926,0,0,2,0,0.14285714285714285,362.7992471121896,3
2020-03-06-170926,170926,1,0,2,1,0.2857142857142857,329.5596217294965,4
2020-03-07-170926,170926,0,0,0,1,0.14285714285714285,340.5387337017027,5
2020-03-08-170926,170926,0,0,0,1,0.0,351.9809327570146,6
2020-03-09-170926,170926,0,0,8,1,0.5714285714285714,352.8008701695145,0
2020-03-10-170926,170926,0,0,7,1,0.8571428571428571,1280.3841563101607,1
2020-03-11-170926,170926,0,0,6,1,1.1428571428571428,1021.9706696463951,2
2020-03-12-170926,170926,0,0,9,1,1.4285714285714286,722.6257768828129,3
2020-03-13-170926,170926,1,0,4,2,2.2857142857142856,423.44593356714137,4
2020-03-14-170926,170926,0,0,0,2,1.7142857142857142,333.9407952692624,5
2020-03-15-170926,170926,0,0,3,2,2.8571428571428568,262.6040554614924,6
2020-03-16-170926,170926,7,1,5,9,8.428571428571429,92.62013068203687,0
2020-03-17-170926,170926,2,0,0,11,5.7142857142857135,177.08989121762085,1
2020-03-18-170926,170926,4,2,4,15,13.0,221.83287096522437,2
2020-03-19-170926,170926,2,0,3,17,13.428571428571427,298.13809956978315,3
2020-03-20-170926,170926,2,0,4,19,14.0,353.08363851201545,4
2020-03-21-170926,170926,0,0,0,19,5.285714285714286,412.87688861815707,5
2020-03-22-170926,170926,0,0,1,19,4.571428571428571,403.7371939288444,6
2020-03-23-170926,170926,8,0,5,27,23.142857142857146,367.95227841602826,0
2020-03-24-170926,170926,7,1,2,34,18.571428571428573,467.0311976950437,1
2020-03-25-170926,170926,6,0,3,40,15.285714285714285,500.4461002666804,2
2020-03-26-170926,170926,9,0,2,49,13.571428571428573,519.3371130368596,3
2020-03-27-170926,170926,4,0,1,53,13.857142857142858,618.826968564303,4
2020-03-28-170926,170926,0,0,0,53,5.142857142857143,618.3384050212107,5
2020-03-29-170926,170926,3,0,2,56,4.714285714285714,633.489279851135,6
2020-03-30-170926,170926,5,0,1,61,16.571428571428573,491.44937911123236,0
2020-03-31-170926,170926,0,0,6,61,8.714285714285714,468.30182789382764,1
2020-04-01-170926,170926,4,0,1,65,8.428571428571429,67.72048597323942,2
2020-04-02-170926,170926,3,0,8,68,10.714285714285714,385.4360497660107,3
2020-04-03-170926,170926,4,0,4,72,7.7142857142857135,121.95589789305198,4
2020-04-04-170926,170926,0,0,2,72,2.7142857142857144,182.51773312942444,5
2020-04-05-170926,170926,1,0,0,73,4.571428571428571,193.38449141108572,6
2020-04-06-170926,170926,5,0,4,78,11.0,210.06987714654176,0
2020-04-07-170926,170926,2,0,7,80,23.57142857142857,250.15066140454343,1
2020-04-08-170926,170926,3,0,1,83,7.428571428571429,324.8618322498081,2
2020-04-09-170926,170926,2,0,0,85,6.857142857142858,351.45851458536663,3
2020-04-10-170926,170926,1,0,2,86,4.142857142857143,65.934855716378,4
2020-04-11-170926,170926,0,0,1,86,7.7142857142857135,88.30598164303916,5
2020-04-12-170926,170926,2,0,1,88,2.571428571428572,127.80554342467539,6
2020-04-13-170926,170926,1,0,2,89,34.857142857142854,145.75063832824685,0
2020-04-14-170926,170926,6,0,5,95,6.142857142857142,330.58954994967496,1
2020-04-15-170926,170926,1,0,4,96,8.857142857142858,393.3135948109852,2
2020-04-16-170926,170926,8,0,0,104,5.428571428571429,436.9511190508097,3
2020-04-17-170926,170926,4,0,0,108,5.428571428571429,439.4067748979147,4
2020-04-18-170926,170926,2,0,0,110,1.5714285714285714,462.43153278389985,5
2020-04-19-170926,170926,0,0,0,110,0.7142857142857143,428.4873049977828,6
2020-04-20-170926,170926,4,0,4,114,5.571428571428571,289.39228011314515,0
2020-04-21-170926,170926,7,0,3,121,4.428571428571429,269.7064833856071,1
2020-04-22-170926,170926,1,0,7,122,4.714285714285714,259.65225699617736,2
2020-04-23-170926,170926,0,0,2,122,0.42857142857142855,246.0246142510503,3
2020-04-24-170926,170926,2,0,1,124,2.7142857142857144,204.07076279881838,4
2020-04-25-170926,170926,1,0,0,125,0.7142857142857143,219.54387807478437,5
2020-04-26-170926,170926,1,0,1,126,0.5714285714285714,220.64555064058877,6
2020-04-27-170926,170926,2,2,0,128,3.2857142857142856,161.2071464593303,0
2020-04-28-170926,170926,5,0,1,133,1.8571428571428568,149.11552284521719,1
2020-04-29-170926,170926,4,0,4,137,4.142857142857143,131.98460482860185,2
2020-04-30-170926,170926,0,0,2,137,5.142857142857143,197.0310230579069,3
2020-05-01-170926,170926,0,0,1,137,1.0,361.24616584840675,4
2020-05-02-170926,170926,0,0,2,137,0.42857142857142855,124.99227081515988,5
2020-05-03-170926,170926,0,0,0,137,0.7142857142857143,112.65707660302826,6
2020-05-04-170926,170926,4,0,2,141,6.0,88.0114717974414,0
2020-05-05-170926,170926,3,0,2,144,4.142857142857143,108.83896339085575,1
2020-05-06-170926,170926,7,0,0,151,5.0,128.64674495161438,2
2020-05-07-170926,170926,2,0,1,153,5.285714285714286,156.83730869386216,3
2020-05-08-170926,170926,1,0,1,154,6.7142857142857135,169.561499428116,4
2020-05-09-170926,170926,0,0,0,154,1.1428571428571428,214.7915427817348,5
2020-05-10-170926,170926,1,1,0,155,0.5714285714285714,369.10429731937717,6
2020-05-11-170926,170926,0,0,4,155,4.571428571428571,353.9621577960768,0
2020-05-12-170926,170926,1,1,2,156,3.2857142857142856,361.5846964452384,1
2020-05-13-170926,170926,4,0,2,160,1.5714285714285714,310.91768157018475,2
2020-05-14-170926,170926,2,0,0,162,3.1428571428571432,209.52326466697536,3
2020-05-15-170926,170926,1,0,4,163,2.7142857142857144,172.3372948142147,4
2020-05-16-170926,170926,2,0,1,165,0.2857142857142857,146.00804002965765,5
2020-05-17-170926,170926,0,0,0,165,0.5714285714285714,146.7019107853104,6
2020-05-18-170926,170926,2,0,10,167,3.4285714285714284,144.4624608633266,0
2020-05-19-170926,170926,2,0,2,169,2.571428571428572,143.24484857128863,1
2020-05-20-170926,170926,0,0,4,169,2.4285714285714284,122.94451670038991,2
2020-05-21-170926,170926,1,0,1,170,2.4285714285714284,118.14566595518934,3
2020-05-22-170926,170926,1,0,2,171,1.0,115.8104839448046,4
2020-05-23-170926,170926,0,0,0,171,0.7142857142857143,128.43595089135638,5
2020-05-24-170926,170926,0,0,0,171,0.2857142857142857,132.36184014373288,6
2020-05-25-170926,170926,4,0,2,175,2.8571428571428568,101.51787529606992,0
2020-05-26-170926,170926,2,0,3,177,3.1428571428571432,109.12998063882651,1
2020-05-27-170926,170926,2,1,2,179,1.5714285714285714,133.14866701288724,2
2020-05-28-170926,170926,0,0,2,179,1.8571428571428568,132.05106016058937,3
2020-05-29-170926,170926,4,0,1,183,3.0,130.10057289290611,4
2020-05-30-170926,170926,1,0,0,184,0.5714285714285714,139.42460312847115,5
2020-05-31-170926,170926,0,0,0,184,0.5714285714285714,145.98615662608483,6
2020-06-01-170926,170926,10,0,2,194,2.8571428571428568,261.94349046216865,0
2020-06-02-170926,170926,2,0,4,196,1.7142857142857142,89.06788804900037,1
2020-06-03-170926,170926,4,0,1,200,1.8571428571428568,67.89544827722753,2
2020-06-04-170926,170926,1,0,1,201,1.7142857142857142,74.85164507588564,3
2020-06-05-170926,170926,2,1,1,203,1.5714285714285714,83.61837429456165,4
2020-06-06-170926,170926,0,0,0,203,0.0,89.57316061759903,5
2020-06-07-170926,170926,0,0,0,203,0.2857142857142857,88.01028072805693,6
2020-06-08-170926,170926,2,0,2,205,1.2857142857142858,87.1400167587093,0
2020-06-09-170926,170926,3,0,1,208,1.2857142857142858,92.00982179114794,1
2020-06-10-170926,170926,2,0,0,210,1.2857142857142858,319.85883967219684,2
2020-06-11-170926,170926,2,0,1,212,1.1428571428571428,286.3283096611834,3
2020-06-12-170926,170926,1,0,0,213,2.142857142857143,261.33470515993406,4
2020-06-13-170926,170926,0,0,0,213,0.42857142857142855,223.25605804024332,5
2020-06-14-170926,170926,0,0,0,213,0.14285714285714285,173.19150522924173,6
2020-06-15-170926,170926,2,0,0,215,1.2857142857142858,114.97424383631622,0
2020-06-16-170926,170926,4,0,0,219,2.2857142857142856,127.90213236751106,1
2020-06-17-170926,170926,1,0,2,220,1.2857142857142858,118.36982205978126,2
2020-06-18-170926,170926,1,0,1,221,1.7142857142857142,111.85624294287635,3
2020-06-19-170926,170926,1,0,0,222,1.1428571428571428,110.236841861557,4
2020-06-20-170926,170926,0,0,0,222,0.14285714285714285,132.26328108293694,5
2020-06-21-170926,170926,0,0,0,222,0.0,138.00105146226326,6
2020-06-22-170926,170926,2,0,0,224,1.0,119.75930000293285,0
2020-06-23-170926,170926,1,0,1,225,1.5714285714285714,102.62946826905589,1
2020-06-24-170926,170926,0,0,0,225,1.2857142857142858,106.46031212827093,2
2020-06-25-170926,170926,1,0,1,226,0.8571428571428571,101.04120931234516,3
2020-06-26-170926,170926,0,0,0,226,1.1428571428571428,98.66176420204252,4
2020-06-27-170926,170926,0,0,0,226,0.14285714285714285,86.01419822913894,5
2020-06-28-170926,170926,0,0,0,226,0.14285714285714285,88.05405695059312,6
2020-06-29-170926,170926,0,0,0,226,1.8571428571428568,86.94240210736676,0
2020-06-30-170926,170926,0,0,1,226,0.5714285714285714,104.78679489685695,1
2020-07-01-170926,170926,2,0,0,228,0.2857142857142857,113.29773052839184,2
2020-07-02-170926,170926,1,0,0,229,0.7142857142857143,41.95372115759494,3
2020-07-03-170926,170926,0,0,1,229,0.5714285714285714,61.79683089465671,4
2020-07-04-170926,170926,0,0,0,229,0.14285714285714285,74.06695635067474,5
2020-07-05-170926,170926,0,0,0,229,0.0,73.36396744728486,6
2020-07-06-170926,170926,0,0,0,229,0.7142857142857143,63.0984462722008,0
2020-07-07-170926,170926,1,0,2,230,0.5714285714285714,62.62964059341559,1
2020-07-08-170926,170926,0,0,1,230,0.2857142857142857,63.22979047578385,2
2020-07-09-170926,170926,1,0,0,231,0.5714285714285714,59.5154988668245,3
2020-07-10-170926,170926,0,0,0,231,0.5714285714285714,110.97087428621967,4
2020-07-11-170926,170926,0,0,0,231,0.2857142857142857,95.5548365420745,5
2020-07-12-170926,170926,0,0,0,231,0.0,78.40096583628883,6
2020-07-13-170926,170926,0,0,1,231,0.7142857142857143,79.60509942111403,0
2020-07-14-170926,170926,1,0,0,232,0.14285714285714285,85.68517583987943,1
2020-07-15-170926,170926,0,0,0,232,0.8571428571428571,68.01551006513863,2
2020-07-16-170926,170926,0,0,0,232,0.42857142857142855,49.447655279826265,3
2020-07-17-170926,170926,1,0,1,233,0.8571428571428571,46.13842755416646,4
2020-07-18-170926,170926,0,0,0,233,0.0,47.47389882581111,5
2020-07-19-170926,170926,0,0,0,233,0.0,40.361204881340655,6
2020-07-20-170926,170926,0,0,0,233,0.5714285714285714,39.884060050580906,0
2020-07-21-170926,170926,2,0,1,235,0.7142857142857143,39.965691157774984,1
2020-07-22-170926,170926,1,0,0,236,0.42857142857142855,49.07530902645819,2
2020-07-23-170926,170926,0,0,1,236,0.42857142857142855,52.02063341304803,3
2020-07-24-170926,170926,0,0,1,236,0.2857142857142857,56.942569153079326,4
2020-07-25-170926,170926,0,0,2,236,0.14285714285714285,63.53951077050486,5
2020-07-26-170926,170926,0,0,0,236,0.2857142857142857,63.96287000258505,6
2020-07-27-170926,170926,1,0,4,237,0.8571428571428571,56.331421754598296,0
2020-07-28-170926,170926,0,0,1,237,1.0,64.54257245324595,1
2020-07-29-170926,170926,0,0,0,237,0.7142857142857143,58.02705963052723,2
2020-07-30-170926,170926,0,0,2,237,1.0,49.351580020369795,3
2020-07-31-170926,170926,1,0,0,238,0.2857142857142857,55.85441087608787,4
2020-08-01-170926,170926,0,0,0,238,0.0,47.92576181064842,5
2020-08-02-170926,170926,0,0,0,238,0.42857142857142855,238.60268014377277,6
2020-08-03-170926,170926,0,0,2,238,1.0,491.7965186543526,0
2020-08-04-170926,170926,1,0,1,239,0.7142857142857143,419.7818576107246,1
2020-08-05-170926,170926,0,0,1,239,2.4285714285714284,367.29426300216306,2
2020-08-06-170926,170926,1,0,7,240,0.5714285714285714,293.9551887803047,3
2020-08-07-170926,170926,1,0,1,241,0.5714285714285714,198.14429218784437,4
2020-08-08-170926,170926,2,0,1,243,1.4285714285714286,180.33675425573833,5
2020-08-09-170926,170926,0,0,0,243,0.2857142857142857,191.0390076676254,6
2020-08-10-170926,170926,4,1,4,247,0.8571428571428571,38.552097856082995,0
2020-08-11-170926,170926,1,0,3,248,2.571428571428572,60.45514092117459,1
2020-08-12-170926,170926,0,2,0,248,1.8571428571428568,86.27588509681647,2
2020-08-13-170926,170926,2,1,3,250,1.4285714285714286,105.68796638058652,3
2020-08-14-170926,170926,0,0,13,250,2.8571428571428568,133.76167895009547,4
2020-08-15-170926,170926,0,0,0,250,2.0,161.68218159243992,5
2020-08-16-170926,170926,0,0,0,250,0.7142857142857143,162.61173161237474,6
2020-08-17-170926,170926,2,0,0,252,2.571428571428572,179.88552953814985,0
2020-08-18-170926,170926,1,0,0,253,3.7142857142857135,186.93669646339995,1
2020-08-19-170926,170926,1,0,9,254,3.0,195.6873575782425,2
2020-08-20-170926,170926,7,0,3,261,4.142857142857143,176.31907262669506,3
2020-08-21-170926,170926,1,0,5,262,2.4285714285714284,210.3220699087325,4
2020-08-22-170926,170926,1,0,0,263,1.5714285714285714,233.12874381722617,5
2020-08-23-170926,170926,0,0,3,263,1.2857142857142858,259.19447311616403,6
2020-08-24-170926,170926,4,0,4,267,3.571428571428572,255.25913525962565,0
2020-08-25-170926,170926,3,0,3,270,8.142857142857142,276.1293890721493,1
2020-08-26-170926,170926,0,0,2,270,6.7142857142857135,317.9449525229204,2
2020-08-27-170926,170926,3,0,0,273,6.7142857142857135,378.89685322946644,3
2020-08-28-170926,170926,13,0,11,286,5.285714285714286,403.3117842753323,4
2020-08-29-170926,170926,0,0,0,286,2.571428571428572,465.6881894766925,5
2020-08-30-170926,170926,0,0,0,286,3.2857142857142856,466.3555045970679,6
2020-08-31-170926,170926,0,0,3,286,6.0,432.83149134876567,0
2020-09-01-170926,170926,0,0,2,286,4.142857142857143,193.00858824794904,1
2020-09-02-170926,170926,9,0,7,295,7.428571428571429,697.3707234655031,2
2020-09-03-170926,170926,3,0,25,298,4.285714285714286,536.9471015554263,3
2020-09-04-170926,170926,5,0,2,303,7.571428571428571,510.44721553351826,4
2020-09-05-170926,170926,0,0,1,303,2.0,471.2619076799556,5
2020-09-06-170926,170926,3,0,0,306,2.571428571428572,439.02613449450547,6
2020-09-07-170926,170926,4,0,7,310,8.571428571428571,455.5579022589064,0
2020-09-08-170926,170926,3,0,7,313,3.4285714285714284,491.44856085294,1
2020-09-09-170926,170926,2,1,2,315,4.857142857142857,457.2558721745489,2
2020-09-10-170926,170926,0,0,5,315,4.285714285714286,171.95649367056387,3
2020-09-11-170926,170926,11,0,5,326,5.428571428571429,253.0600551739815,4
2020-09-12-170926,170926,0,0,4,326,1.7142857142857142,347.62349414597963,5
2020-09-13-170926,170926,0,0,0,326,2.0,364.3456569181764,6
2020-09-14-170926,170926,3,0,6,329,9.714285714285714,363.2335326351316,0
2020-09-15-170926,170926,2,0,3,331,4.714285714285714,450.96272283042214,1
2020-09-16-170926,170926,7,0,0,338,8.714285714285714,535.8573030332698,2
2020-09-17-170926,170926,25,0,10,363,8.714285714285714,611.4503768819931,3
2020-09-18-170926,170926,2,0,7,365,6.428571428571429,678.558045238902,4
2020-09-19-170926,170926,1,0,1,366,3.571428571428572,678.7276912018538,5
2020-09-20-170926,170926,0,0,0,366,1.8571428571428568,768.1084496365562,6
2020-09-21-170926,170926,7,1,13,373,7.2857142857142865,674.0077277729373,0
2020-09-22-170926,170926,7,0,4,380,8.285714285714286,670.9491661903526,1
2020-09-23-170926,170926,2,0,5,382,7.2857142857142865,638.2151123750093,2
2020-09-24-170926,170926,5,1,34,387,7.0,557.884266775237,3
2020-09-25-170926,170926,5,0,2,392,7.0,530.466688219344,4
2020-09-26-170926,170926,4,0,3,396,2.4285714285714284,608.626522580466,5
2020-09-27-170926,170926,0,0,1,396,3.0,584.3393020732905,6
2020-09-28-170926,170926,6,1,1,402,6.428571428571429,589.5980756896873,0
2020-09-29-170926,170926,3,0,6,405,5.142857142857143,573.0330596832251,1
2020-09-30-170926,170926,0,0,8,405,4.857142857142857,535.7876448640349,2
2020-10-01-170926,170926,10,1,1,415,6.142857142857142,0.0,3
2020-10-02-170926,170926,7,1,6,422,5.857142857142858,678.8350506120595,4
2020-10-03-170926,170926,1,1,2,423,2.7142857142857144,1213.0307207497096,5
2020-10-04-170926,170926,0,0,0,423,1.4285714285714286,1236.487536981507,6
2020-10-05-170926,170926,13,0,3,436,7.2857142857142865,1034.5927332204287,0
2020-10-06-170926,170926,4,1,5,440,8.857142857142858,958.3109732684245,1
2020-10-07-170926,170926,5,1,8,445,5.428571428571429,827.8525416037556,2
2020-10-08-170926,170926,34,0,3,479,8.428571428571429,731.5828582835152,3
2020-10-09-170926,170926,2,1,10,481,7.0,870.7255957162879,4
2020-10-10-170926,170926,3,0,1,484,2.7142857142857144,90.07063475833226,5
2020-10-11-170926,170926,1,0,2,485,2.7142857142857144,149.22654693588663,6
2020-10-12-170926,170926,1,0,12,486,1.7142857142857142,188.64566896972494,0
2020-10-13-170926,170926,6,0,10,492,8.142857142857142,207.19978782587185,1
2020-10-14-170926,170926,8,0,16,500,9.857142857142858,308.5937933164632,2
2020-10-15-170926,170926,1,0,2,501,6.7142857142857135,425.8017381539038,3
2020-10-16-170926,170926,6,0,13,507,9.142857142857142,527.071465286885,4
2020-10-17-170926,170926,2,0,2,509,3.4285714285714284,558.7320053686308,5
2020-10-18-170926,170926,0,2,1,509,3.7142857142857135,547.9399111841324,6
2020-10-19-170926,170926,3,2,0,512,11.857142857142858,528.87261516367,0
2020-10-20-170926,170926,5,0,5,517,13.142857142857142,663.9897944974625,1
2020-10-21-170926,170926,8,0,11,525,17.571428571428573,693.7510091326137,2
2020-10-22-170926,170926,3,1,12,528,15.571428571428573,768.8764070419469,3
2020-10-23-170926,170926,10,3,17,538,22.142857142857146,830.9193033521288,4
2020-10-24-170926,170926,1,3,4,539,4.571428571428571,1008.1427917568673,5
2020-10-25-170926,170926,2,1,0,541,3.4285714285714284,1004.9881508828759,6
2020-10-26-170926,170926,12,1,11,553,17.714285714285715,950.2555354800278,0
2020-10-27-170926,170926,10,2,8,563,16.285714285714285,1046.3845925241803,1
2020-10-28-170926,170926,16,0,15,579,18.857142857142858,1062.4823200500769,2
2020-10-29-170926,170926,2,1,3,581,19.285714285714285,1114.3091184269924,3
2020-10-30-170926,170926,13,0,7,594,24.857142857142854,947.3719514690172,4
2020-10-31-170926,170926,2,0,0,596,6.0,1120.2040991142812,5
2020-11-01-170926,170926,1,0,0,597,4.714285714285714,707.3767025865402,6
2020-11-02-170926,170926,0,0,0,597,2.571428571428572,851.0015406003349,0
2020-11-03-170926,170926,5,0,0,602,16.142857142857142,728.272395723604,1
2020-11-04-170926,170926,11,0,0,613,16.857142857142858,886.4500757257745,2
2020-11-05-170926,170926,12,0,0,625,21.428571428571427,987.5335113495446,3
2020-11-06-170926,170926,17,2,0,642,23.0,1105.7436242316987,4
2020-11-07-170926,170926,4,1,0,646,4.857142857142857,1216.7879773907066,5
2020-11-08-170926,170926,0,0,0,646,3.4285714285714284,1119.346910959851,6
2020-11-09-170926,170926,11,0,0,657,17.714285714285715,1119.4733294045254,0
2020-11-10-170926,170926,8,0,0,665,13.428571428571427,639.2168914073318,1
2020-11-11-170926,170926,15,0,0,680,15.571428571428573,747.5322564051928,2
2020-11-12-170926,170926,3,0,0,683,12.571428571428573,796.2333211436828,3
2020-11-13-170926,170926,7,2,0,690,17.0,817.6565037726475,4
2020-03-01-170927,170927,0,0,3,0,0.0,0.0,6
2020-03-02-170927,170927,0,0,2,0,0.0,183.82924635716452,0
2020-03-03-170927,170927,0,1,11,0,0.0,1043.2876595595535,1
2020-03-04-170927,170927,0,0,11,0,0.2222222222222222,1174.2471099323388,2
2020-03-05-170927,170927,0,0,19,0,0.1111111111111111,1255.5607665959092,3
2020-03-06-170927,170927,0,0,23,0,0.2222222222222222,1120.7837586701107,4
2020-03-07-170927,170927,0,0,1,0,0.3333333333333333,1164.311126250811,5
2020-03-08-170927,170927,0,0,4,0,0.3333333333333333,1155.741439571626,6
2020-03-09-170927,170927,0,0,24,0,0.3333333333333333,1150.343463478758,0
2020-03-10-170927,170927,1,0,18,1,0.2222222222222222,4174.327261463268,1
2020-03-11-170927,170927,0,0,18,1,0.3333333333333333,3348.6966770587615,2
2020-03-12-170927,170927,1,0,24,2,0.5555555555555556,2313.6065743678855,3
2020-03-13-170927,170927,0,0,24,2,2.333333333333333,1460.6655220698008,4
2020-03-14-170927,170927,1,0,2,3,0.7777777777777778,1136.4672764626234,5
2020-03-15-170927,170927,3,0,2,6,1.7777777777777777,832.6977280730855,6
2020-03-16-170927,170927,2,0,30,8,8.11111111111111,290.5588422101116,0
2020-03-17-170927,170927,11,0,14,19,7.333333333333332,578.9509818950753,1
2020-03-18-170927,170927,11,0,17,30,10.777777777777779,773.6828478297014,2
2020-03-19-170927,170927,19,0,21,49,11.222222222222221,1030.2337189715627,3
2020-03-20-170927,170927,23,0,27,72,11.333333333333336,1281.3985426912404,4
2020-03-21-170927,170927,1,0,6,73,4.222222222222221,1555.8622475953127,5
2020-03-22-170927,170927,4,0,2,77,5.777777777777778,1532.807338436154,6
2020-03-23-170927,170927,24,0,20,101,19.444444444444443,1443.0579306106142,0
2020-03-24-170927,170927,18,0,14,119,17.88888888888889,1750.9422359533028,1
2020-03-25-170927,170927,18,0,13,137,17.11111111111111,1873.7677514111692,2
2020-03-26-170927,170927,24,0,6,161,16.11111111111111,1883.0415376219391,3
2020-03-27-170927,170927,24,0,12,185,13.777777777777779,2232.5501513260356,4
2020-03-28-170927,170927,2,0,3,187,3.2222222222222223,2182.8247834183844,5
2020-03-29-170927,170927,2,0,4,189,3.888888888888889,2193.8755064530487,6
2020-03-30-170927,170927,30,0,13,219,15.777777777777779,1654.4826445079702,0
2020-03-31-170927,170927,14,0,13,233,8.666666666666666,1593.6587042363424,1
2020-04-01-170927,170927,17,0,21,250,10.555555555555557,252.97680555853498,2
2020-04-02-170927,170927,21,0,6,271,7.777777777777778,1068.657030596985,3
2020-04-03-170927,170927,27,0,6,298,10.333333333333334,454.09505165164035,4
2020-04-04-170927,170927,6,0,1,304,2.333333333333333,806.2057796819165,5
2020-04-05-170927,170927,2,0,2,306,1.5555555555555556,856.8285957837152,6
2020-04-06-170927,170927,20,0,9,326,12.111111111111109,887.2119564199052,0
2020-04-07-170927,170927,14,2,12,340,7.666666666666668,1027.8910365144477,1
2020-04-08-170927,170927,13,1,7,353,7.666666666666668,1195.3585419516658,2
2020-04-09-170927,170927,6,2,0,359,6.333333333333332,1334.0503038941547,3
2020-04-10-170927,170927,12,0,6,371,4.777777777777779,268.47586563883885,4
2020-04-11-170927,170927,3,0,0,374,2.4444444444444446,381.2784372015484,5
2020-04-12-170927,170927,4,0,1,378,2.333333333333333,446.60671125077096,6
2020-04-13-170927,170927,13,0,7,391,10.777777777777779,516.2046546478864,0
2020-04-14-170927,170927,13,0,3,404,7.5555555555555545,864.9010669600498,1
2020-04-15-170927,170927,21,0,8,425,7.5555555555555545,1096.266896499506,2
2020-04-16-170927,170927,6,0,12,431,6.5555555555555545,1294.1365199334195,3
2020-04-17-170927,170927,6,0,1,437,4.222222222222221,1238.4536068352882,4
2020-04-18-170927,170927,1,0,0,438,1.4444444444444444,1294.8463709292446,5
2020-04-19-170927,170927,2,0,1,440,0.7777777777777778,1232.2996132555186,6
2020-04-20-170927,170927,9,0,11,449,4.777777777777779,1004.0539475664509,0
2020-04-21-170927,170927,12,0,3,461,4.4444444444444455,922.2774014245457,1
2020-04-22-170927,170927,7,0,8,468,6.111111111111112,842.7534920740359,2
2020-04-23-170927,170927,0,0,8,468,0.3333333333333333,833.5614031322973,3
2020-04-24-170927,170927,6,0,6,474,4.0,684.8415135055087,4
2020-04-25-170927,170927,0,0,1,474,0.4444444444444444,759.3063321953497,5
2020-04-26-170927,170927,1,0,1,475,0.5555555555555556,754.0145032689844,6
2020-04-27-170927,170927,7,1,6,482,4.888888888888889,561.0061542147702,0
2020-04-28-170927,170927,3,0,4,485,4.222222222222221,549.3335326354604,1
2020-04-29-170927,170927,8,0,1,493,4.111111111111111,519.2529096494261,2
2020-04-30-170927,170927,12,0,4,505,4.222222222222221,884.4023626926571,3
2020-05-01-170927,170927,1,0,4,506,0.7777777777777778,1330.5270368661654,4
2020-05-02-170927,170927,0,0,0,506,0.3333333333333333,426.0178962948703,5
2020-05-03-170927,170927,1,0,0,507,0.1111111111111111,373.9292528765218,6
2020-05-04-170927,170927,11,0,6,518,4.666666666666667,269.20292170452353,0
2020-05-05-170927,170927,3,0,4,521,6.0,354.3209887771819,1
2020-05-06-170927,170927,8,0,9,529,4.333333333333333,424.94405352363026,2
2020-05-07-170927,170927,8,0,4,537,4.777777777777779,506.53512008890755,3
2020-05-08-170927,170927,6,0,3,543,5.5555555555555545,574.5370610547379,4
2020-05-09-170927,170927,1,0,0,544,0.2222222222222222,760.5523996072271,5
2020-05-10-170927,170927,1,1,0,545,0.4444444444444444,1364.7616292502114,6
2020-05-11-170927,170927,6,0,6,551,3.555555555555556,1287.2693521559236,0
2020-05-12-170927,170927,4,0,2,555,3.111111111111111,1383.5070230902643,1
2020-05-13-170927,170927,1,0,5,556,1.2222222222222223,1154.8900933605091,2
2020-05-14-170927,170927,4,1,4,560,3.888888888888889,846.1080158795609,3
2020-05-15-170927,170927,4,0,1,564,2.6666666666666665,691.9910296506712,4
2020-05-16-170927,170927,0,0,0,564,0.0,571.095463786488,5
2020-05-17-170927,170927,0,0,0,564,0.0,565.6399487843096,6
2020-05-18-170927,170927,6,0,1,570,3.333333333333333,563.0528319697562,0
2020-05-19-170927,170927,4,0,2,574,3.555555555555556,532.3563964183758,1
2020-05-20-170927,170927,9,0,1,583,3.888888888888889,458.5195090576801,2
2020-05-21-170927,170927,4,0,3,587,2.555555555555556,483.8538298703274,3
2020-05-22-170927,170927,3,0,5,590,3.111111111111111,463.1841237597867,4
2020-05-23-170927,170927,0,0,0,590,0.3333333333333333,546.6886736890709,5
2020-05-24-170927,170927,0,0,0,590,0.2222222222222222,564.746154030937,6
2020-05-25-170927,170927,6,0,2,596,3.555555555555556,454.3558080198493,0
2020-05-26-170927,170927,2,0,0,598,2.888888888888889,500.277758045087,1
2020-05-27-170927,170927,5,1,4,603,2.555555555555556,582.6904133661349,2
2020-05-28-170927,170927,4,0,2,607,1.5555555555555556,536.7909417265074,3
2020-05-29-170927,170927,1,1,4,608,3.555555555555556,513.8557651967067,4
2020-05-30-170927,170927,0,0,1,608,0.0,498.4512466435847,5
2020-05-31-170927,170927,0,0,0,608,0.1111111111111111,506.75080426560663,6
2020-06-01-170927,170927,1,0,2,609,3.6666666666666665,934.4997590990779,0
2020-06-02-170927,170927,2,1,1,611,3.0,341.29446076272814,1
2020-06-03-170927,170927,1,0,1,612,3.2222222222222223,264.3290912561781,2
2020-06-04-170927,170927,3,0,1,615,2.4444444444444446,288.40086774473843,3
2020-06-05-170927,170927,5,0,3,620,2.555555555555556,328.5231766717261,4
2020-06-06-170927,170927,0,0,0,620,0.2222222222222222,341.3529301978712,5
2020-06-07-170927,170927,0,0,0,620,0.2222222222222222,334.4044758252815,6
2020-06-08-170927,170927,2,0,0,622,1.6666666666666667,331.6357788384182,0
2020-06-09-170927,170927,0,0,1,622,2.1111111111111107,323.7291867222041,1
2020-06-10-170927,170927,4,0,2,626,1.7777777777777777,1081.1802923547143,2
2020-06-11-170927,170927,2,0,1,628,1.7777777777777777,953.8436413634278,3
2020-06-12-170927,170927,4,0,1,632,0.7777777777777778,846.9128284223066,4
2020-06-13-170927,170927,1,0,0,633,0.0,708.8303674975737,5
2020-06-14-170927,170927,0,0,0,633,0.2222222222222222,534.2159420133673,6
2020-06-15-170927,170927,2,0,1,635,2.0,336.12281641031313,0
2020-06-16-170927,170927,1,0,0,636,2.2222222222222223,389.4985635432108,1
2020-06-17-170927,170927,1,0,2,637,1.5555555555555556,377.76173227029625,2
2020-06-18-170927,170927,1,0,1,638,1.5555555555555556,353.1997462189286,3
2020-06-19-170927,170927,3,0,1,641,1.5555555555555556,342.25592688526325,4
2020-06-20-170927,170927,0,0,0,641,0.3333333333333333,444.35456814910987,5
2020-06-21-170927,170927,0,0,0,641,0.1111111111111111,453.1174469314843,6
2020-06-22-170927,170927,0,0,0,641,1.8888888888888888,379.1258989325213,0
2020-06-23-170927,170927,1,0,0,642,1.5555555555555556,329.1700555568059,1
2020-06-24-170927,170927,2,1,0,644,1.1111111111111112,334.225304300826,2
2020-06-25-170927,170927,1,1,2,645,1.1111111111111112,306.7689992713628,3
2020-06-26-170927,170927,1,0,4,646,2.2222222222222223,279.188910700067,4
2020-06-27-170927,170927,0,0,1,646,0.2222222222222222,246.00587059741008,5
2020-06-28-170927,170927,0,0,0,646,0.2222222222222222,244.06966373892828,6
2020-06-29-170927,170927,1,1,0,647,1.4444444444444444,249.14111312712907,0
2020-06-30-170927,170927,0,0,2,647,0.6666666666666666,287.43613816359067,1
2020-07-01-170927,170927,2,0,0,649,0.5555555555555556,292.2623570366942,2
2020-07-02-170927,170927,1,0,0,650,0.2222222222222222,131.55981254046847,3
2020-07-03-170927,170927,1,0,0,651,0.6666666666666666,184.38625574873106,4
2020-07-04-170927,170927,0,0,0,651,0.4444444444444444,241.91167431254883,5
2020-07-05-170927,170927,0,0,0,651,0.1111111111111111,243.4383979211724,6
2020-07-06-170927,170927,0,0,0,651,0.5555555555555556,203.14349230083857,0
2020-07-07-170927,170927,0,0,0,651,0.6666666666666666,204.69282063041464,1
2020-07-08-170927,170927,0,0,3,651,1.2222222222222223,208.34117632920135,2
2020-07-09-170927,170927,2,0,2,653,0.7777777777777778,200.19661506525318,3
2020-07-10-170927,170927,4,0,2,657,0.5555555555555556,272.7005508365828,4
2020-07-11-170927,170927,1,0,0,658,1.0,245.6461936693179,5
2020-07-12-170927,170927,0,0,0,658,0.6666666666666666,208.16411120328996,6
2020-07-13-170927,170927,0,0,0,658,1.0,227.5697003145714,0
2020-07-14-170927,170927,2,0,0,660,0.4444444444444444,252.61558609824147,1
2020-07-15-170927,170927,0,0,1,660,1.2222222222222223,217.05398361520372,2
2020-07-16-170927,170927,0,0,2,660,1.3333333333333333,185.26427166084594,3
2020-07-17-170927,170927,0,0,2,660,0.8888888888888888,179.27870889244483,4
2020-07-18-170927,170927,0,0,1,660,0.4444444444444444,176.49862825930228,5
2020-07-19-170927,170927,0,0,0,660,0.1111111111111111,145.1629592007941,6
2020-07-20-170927,170927,0,0,0,660,0.8888888888888888,123.55396547725222,0
2020-07-21-170927,170927,0,0,1,660,0.8888888888888888,130.69871107840328,1
2020-07-22-170927,170927,3,0,1,663,0.7777777777777778,138.39795877470732,2
2020-07-23-170927,170927,2,0,3,665,0.7777777777777778,147.48398014178053,3
2020-07-24-170927,170927,2,0,3,667,1.3333333333333333,147.2839122068183,4
2020-07-25-170927,170927,0,0,1,667,0.1111111111111111,177.44975681247496,5
2020-07-26-170927,170927,0,0,0,667,0.0,175.88638389305754,6
2020-07-27-170927,170927,0,0,3,667,1.6666666666666667,156.85818934611729,0
2020-07-28-170927,170927,0,0,1,667,1.0,176.81216541971335,1
2020-07-29-170927,170927,1,0,0,668,1.0,181.11164522242234,2
2020-07-30-170927,170927,2,0,4,670,2.333333333333333,175.31861015258346,3
2020-07-31-170927,170927,2,0,1,672,1.2222222222222223,194.94285369115286,4
2020-08-01-170927,170927,1,0,0,673,1.1111111111111112,158.47049800640423,5
2020-08-02-170927,170927,0,0,2,673,0.5555555555555556,704.18110979432,6
2020-08-03-170927,170927,0,0,10,673,0.7777777777777778,1727.957426322518,0
2020-08-04-170927,170927,1,0,3,674,1.3333333333333333,1402.1181145200035,1
2020-08-05-170927,170927,1,0,4,675,2.888888888888889,1193.1635158202075,2
2020-08-06-170927,170927,3,0,8,678,1.6666666666666667,888.5999437648575,3
2020-08-07-170927,170927,3,0,3,681,2.6666666666666665,581.5964047898233,4
2020-08-08-170927,170927,1,0,1,682,2.888888888888889,519.4404872939655,5
2020-08-09-170927,170927,0,0,3,682,1.1111111111111112,570.8298961881046,6
2020-08-10-170927,170927,3,0,4,685,2.4444444444444446,129.3676006679048,0
2020-08-11-170927,170927,1,0,13,686,2.888888888888889,191.38081325352462,1
2020-08-12-170927,170927,0,0,15,686,2.1111111111111107,239.70693059965078,2
2020-08-13-170927,170927,4,0,17,690,4.777777777777779,300.79042840182393,3
2020-08-14-170927,170927,1,0,16,691,4.777777777777779,367.70278910050877,4
2020-08-15-170927,170927,0,0,2,691,2.1111111111111107,445.84866686079147,5
2020-08-16-170927,170927,2,0,0,693,2.888888888888889,450.8000713819589,6
2020-08-17-170927,170927,10,0,12,703,3.555555555555556,516.8416322040673,0
2020-08-18-170927,170927,3,0,8,706,3.111111111111111,529.9422849212164,1
2020-08-19-170927,170927,4,0,14,710,4.666666666666667,571.3902831200963,2
2020-08-20-170927,170927,8,0,8,718,5.111111111111111,512.6780379064339,3
2020-08-21-170927,170927,3,0,9,721,5.333333333333333,614.7558021146989,4
2020-08-22-170927,170927,1,0,2,722,2.333333333333333,737.0614409885302,5
2020-08-23-170927,170927,3,0,2,725,2.4444444444444446,766.3617223243235,6
2020-08-24-170927,170927,4,0,13,729,5.5555555555555545,765.8651477252124,0
2020-08-25-170927,170927,13,0,0,742,9.777777777777779,884.1697718456205,1
2020-08-26-170927,170927,15,0,10,757,7.777777777777778,1074.0228517952548,2
2020-08-27-170927,170927,17,0,12,774,10.888888888888891,1280.1019424882502,3
2020-08-28-170927,170927,16,0,20,790,9.666666666666666,1411.5553969372118,4
2020-08-29-170927,170927,2,0,0,792,2.333333333333333,1606.552565307125,5
2020-08-30-170927,170927,0,0,1,792,2.888888888888889,1573.7523759077626,6
2020-08-31-170927,170927,12,0,12,804,6.5555555555555545,1453.1588391815656,0
2020-09-01-170927,170927,8,0,8,812,5.5555555555555545,612.3806228056806,1
2020-09-02-170927,170927,14,0,15,826,5.333333333333333,1876.2711148088206,2
2020-09-03-170927,170927,8,0,15,834,5.333333333333333,1373.7821949543766,3
2020-09-04-170927,170927,9,0,8,843,4.777777777777779,1374.4301524308805,4
2020-09-05-170927,170927,2,0,2,845,2.555555555555556,1257.8637463380123,5
2020-09-06-170927,170927,2,0,1,847,3.333333333333333,1186.1424336085781,6
2020-09-07-170927,170927,13,0,13,860,7.4444444444444455,1265.87866749994,0
2020-09-08-170927,170927,0,0,3,860,2.7777777777777777,1394.9382660483236,1
2020-09-09-170927,170927,10,0,8,870,8.555555555555555,1236.5580354700783,2
2020-09-10-170927,170927,12,0,11,882,8.222222222222221,535.2766462000851,3
2020-09-11-170927,170927,20,0,20,902,7.4444444444444455,841.6591607952348,4
2020-09-12-170927,170927,0,0,4,902,3.555555555555556,1114.9790345128338,5
2020-09-13-170927,170927,1,0,0,903,2.2222222222222223,1156.586992860123,6
2020-09-14-170927,170927,12,0,11,915,8.333333333333334,1170.593617093507,0
2020-09-15-170927,170927,8,0,6,923,9.555555555555557,1436.9332546972996,1
2020-09-16-170927,170927,15,0,11,938,10.888888888888891,1801.5059755267698,2
2020-09-17-170927,170927,15,0,4,953,8.333333333333334,2029.6866019602203,3
2020-09-18-170927,170927,8,0,13,961,8.666666666666666,2078.239217362026,4
2020-09-19-170927,170927,2,1,1,963,3.0,2021.7189840915362,5
2020-09-20-170927,170927,1,1,15,964,4.0,2202.019208222092,6
2020-09-21-170927,170927,13,0,11,977,9.444444444444443,1893.8102879519786,0
2020-09-22-170927,170927,3,1,14,980,8.222222222222221,1839.8084609837833,1
2020-09-23-170927,170927,8,0,4,988,9.444444444444443,1725.4695681298247,2
2020-09-24-170927,170927,11,1,2,999,5.111111111111111,1556.4437593231837,3
2020-09-25-170927,170927,20,0,3,1019,9.333333333333334,1518.6616491044983,4
2020-09-26-170927,170927,4,0,0,1023,5.0,1762.5742458261273,5
2020-09-27-170927,170927,0,0,0,1023,1.3333333333333333,1732.8928171721132,6
2020-09-28-170927,170927,11,1,0,1034,4.666666666666667,1692.19948660517,0
2020-09-29-170927,170927,6,1,5,1040,5.777777777777778,1593.991484793054,1
2020-09-30-170927,170927,11,0,6,1051,5.888888888888888,1532.8944903249962,2
2020-10-01-170927,170927,4,0,8,1055,6.888888888888888,0.0,3
2020-10-02-170927,170927,13,0,6,1068,8.11111111111111,1760.5999210015011,4
2020-10-03-170927,170927,1,0,2,1069,1.7777777777777777,3462.3459760029646,5
2020-10-04-170927,170927,15,0,0,1084,1.4444444444444444,3591.356927191421,6
2020-10-05-170927,170927,11,0,14,1095,7.5555555555555545,3008.403478723263,0
2020-10-06-170927,170927,14,0,18,1109,6.5555555555555545,2797.8013906034494,1
2020-10-07-170927,170927,4,0,16,1113,7.666666666666668,2468.068058034448,2
2020-10-08-170927,170927,2,1,26,1115,5.222222222222221,2152.295362216463,3
2020-10-09-170927,170927,3,3,35,1118,8.11111111111111,2405.9201524525474,4
2020-10-10-170927,170927,0,0,2,1118,3.6666666666666665,253.19863518278706,5
2020-10-11-170927,170927,0,0,1,1118,1.4444444444444444,415.0248394329477,6
2020-10-12-170927,170927,0,0,31,1118,2.333333333333333,470.09453140413143,0
2020-10-13-170927,170927,5,0,15,1123,7.0,515.873006244331,1
2020-10-14-170927,170927,6,0,29,1129,8.333333333333334,789.9624064556663,2
2020-10-15-170927,170927,8,0,37,1137,7.0,1100.9001722394053,3
2020-10-16-170927,170927,6,0,44,1143,9.888888888888891,1374.7892520805767,4
2020-10-17-170927,170927,2,0,4,1145,4.0,1463.527831783248,5
2020-10-18-170927,170927,0,0,0,1145,2.0,1455.6753047520267,6
2020-10-19-170927,170927,14,0,6,1159,8.777777777777779,1495.8579543690396,0
2020-10-20-170927,170927,18,0,43,1177,13.888888888888891,1945.5860118439366,1
2020-10-21-170927,170927,16,0,25,1193,10.111111111111109,2103.1311423544958,2
2020-10-22-170927,170927,26,0,40,1219,14.111111111111109,2295.453127186306,3
2020-10-23-170927,170927,35,0,33,1254,22.11111111111111,2596.6136367461695,4
2020-10-24-170927,170927,2,1,4,1256,3.7777777777777777,3148.505414646173,5
2020-10-25-170927,170927,1,0,3,1257,3.7777777777777777,3199.8048294161126,6
2020-10-26-170927,170927,31,0,35,1288,16.666666666666668,2947.7184479038524,0
2020-10-27-170927,170927,15,2,20,1303,13.222222222222221,3319.373838300978,1
2020-10-28-170927,170927,29,1,25,1332,17.555555555555557,3345.809791781303,2
2020-10-29-170927,170927,37,0,24,1369,22.222222222222218,3520.0128128730184,3
2020-10-30-170927,170927,44,2,17,1413,22.0,2921.4637799439683,4
2020-10-31-170927,170927,4,0,0,1417,8.444444444444445,3527.626324812354,5
2020-11-01-170927,170927,0,2,0,1417,9.444444444444443,1872.7928868796384,6
2020-11-02-170927,170927,6,1,0,1423,3.888888888888889,2713.6272707614366,0
2020-11-03-170927,170927,43,0,0,1466,18.666666666666668,2158.4601445790186,1
2020-11-04-170927,170927,25,1,0,1491,17.444444444444443,2704.386067028041,2
2020-11-05-170927,170927,40,0,0,1531,21.66666666666667,2961.947067450725,3
2020-11-06-170927,170927,33,3,0,1564,19.222222222222218,3322.431246756023,4
2020-11-07-170927,170927,4,0,0,1568,8.444444444444445,3668.65722606868,5
2020-11-08-170927,170927,3,0,0,1571,8.333333333333334,3564.5088213743115,6
2020-11-09-170927,170927,35,0,0,1606,12.222222222222221,3704.7951344952958,0
2020-11-10-170927,170927,20,0,0,1626,14.0,1832.5273222956719,1
2020-11-11-170927,170927,25,1,0,1651,12.333333333333336,2208.0360393173723,2
2020-11-12-170927,170927,24,2,0,1675,13.777777777777779,2480.663131503641,3
2020-11-13-170927,170927,17,1,0,1692,17.0,2663.2850303659443,4
2020-03-01-170928,170928,0,0,3,0,0.0,0.0,6
2020-03-02-170928,170928,0,0,14,0,0.0,196.77421277770225,0
2020-03-03-170928,170928,0,0,9,0,0.0,1059.639293096125,1
2020-03-04-170928,170928,0,0,10,0,0.2,1169.0005555008518,2
2020-03-05-170928,170928,0,0,16,0,0.0,1260.5857450768785,3
2020-03-06-170928,170928,0,0,10,0,0.4,1141.7616184385183,4
2020-03-07-170928,170928,0,0,4,0,0.4,1154.436519499281,5
2020-03-08-170928,170928,1,0,5,1,0.2,1148.947262344698,6
2020-03-09-170928,170928,0,0,16,1,0.6,1147.2526359532405,0
2020-03-10-170928,170928,0,0,19,1,0.6,4018.5312109243705,1
2020-03-11-170928,170928,1,0,23,2,0.2,3232.4039285359495,2
2020-03-12-170928,170928,1,0,12,3,1.2,2207.6994194227873,3
2020-03-13-170928,170928,6,0,20,9,2.4,1317.7084085984593,4
2020-03-14-170928,170928,2,0,3,11,1.0,1094.0047797602,5
2020-03-15-170928,170928,3,0,10,14,3.0,864.9996600596287,6
2020-03-16-170928,170928,14,0,17,28,6.2,319.8703661775843,0
2020-03-17-170928,170928,9,0,14,37,7.2,594.1496002642414,1
2020-03-18-170928,170928,10,0,16,47,13.6,766.787981872829,2
2020-03-19-170928,170928,16,1,7,63,12.4,1019.0553166963196,3
2020-03-20-170928,170928,10,1,5,73,14.8,1217.6116945065182,4
2020-03-21-170928,170928,4,0,5,77,4.4,1438.936798012896,5
2020-03-22-170928,170928,5,0,2,82,4.2,1408.7749593854574,6
2020-03-23-170928,170928,16,0,8,98,22.0,1309.5868627566806,0
2020-03-24-170928,170928,19,0,7,117,18.6,1621.671549445498,1
2020-03-25-170928,170928,23,0,9,140,19.4,1752.2796414324039,2
2020-03-26-170928,170928,12,0,2,152,17.6,1807.5186779321755,3
2020-03-27-170928,170928,20,0,5,172,15.8,2118.1960446990256,4
2020-03-28-170928,170928,3,0,2,175,18.4,2115.778149354969,5
2020-03-29-170928,170928,10,0,1,185,3.0,2171.094151598698,6
2020-03-30-170928,170928,17,0,6,202,15.0,1672.2868852226288,0
2020-03-31-170928,170928,14,0,11,216,12.0,1603.1878379579075,1
2020-04-01-170928,170928,16,0,10,232,12.0,266.1882297078743,2
2020-04-02-170928,170928,7,0,13,239,10.6,1261.5979176896294,3
2020-04-03-170928,170928,5,0,4,244,11.2,441.34756160647254,4
2020-04-04-170928,170928,5,0,1,249,3.2,707.7322008353764,5
2020-04-05-170928,170928,2,0,0,251,1.8,769.2039214333288,6
2020-04-06-170928,170928,8,0,5,259,12.0,811.2449344607714,0
2020-04-07-170928,170928,7,0,5,266,10.8,946.6900539930948,1
2020-04-08-170928,170928,9,0,15,275,11.0,1127.893961434589,2
2020-04-09-170928,170928,2,0,1,277,5.8,1270.304328423811,3
2020-04-10-170928,170928,5,0,4,282,9.6,265.0380922845783,4
2020-04-11-170928,170928,2,0,0,284,5.2,374.44546795503044,5
2020-04-12-170928,170928,1,0,0,285,3.2,481.30701720305717,6
2020-04-13-170928,170928,6,1,5,291,23.6,540.3524636543702,0
2020-04-14-170928,170928,11,0,8,302,18.4,1019.1438542484698,1
2020-04-15-170928,170928,10,0,5,312,12.0,1269.254836854075,2
2020-04-16-170928,170928,13,0,4,325,7.2,1452.7728749064092,3
2020-04-17-170928,170928,4,0,0,329,6.8,1430.867770910234,4
2020-04-18-170928,170928,1,0,0,330,1.8,1481.374076474921,5
2020-04-19-170928,170928,0,0,0,330,1.6,1383.3942320832934,6
2020-04-20-170928,170928,5,0,10,335,7.8,1019.0902365530701,0
2020-04-21-170928,170928,5,0,3,340,7.0,904.1836890173677,1
2020-04-22-170928,170928,15,1,6,355,7.6,825.8244369978138,2
2020-04-23-170928,170928,1,0,6,356,0.8,809.8588612212709,3
2020-04-24-170928,170928,4,0,10,360,6.2,673.0372321001321,4
2020-04-25-170928,170928,0,0,0,360,0.4,739.540979351335,5
2020-04-26-170928,170928,0,0,0,360,1.0,736.2668422763176,6
2020-04-27-170928,170928,5,0,6,365,6.2,563.4336916169949,0
2020-04-28-170928,170928,8,0,3,373,4.0,535.8018901502896,1
2020-04-29-170928,170928,5,0,0,378,4.2,503.00059735187193,2
2020-04-30-170928,170928,4,0,9,382,7.2,726.7162654727097,3
2020-05-01-170928,170928,0,1,7,382,0.8,1219.7865152189975,4
2020-05-02-170928,170928,0,0,0,382,0.0,419.08801260634976,5
2020-05-03-170928,170928,0,0,0,382,0.4,405.95671425743456,6
2020-05-04-170928,170928,10,0,4,392,6.6,301.05749724802183,0
2020-05-05-170928,170928,3,0,4,395,6.6,369.884962900956,1
2020-05-06-170928,170928,6,0,5,401,5.8,435.36158972403194,2
2020-05-07-170928,170928,6,0,0,407,7.6,501.28277669155455,3
2020-05-08-170928,170928,10,0,2,417,5.6,565.7433114264088,4
2020-05-09-170928,170928,0,0,0,417,0.2,744.5472919596798,5
2020-05-10-170928,170928,0,0,0,417,0.4,1246.8973947244071,6
2020-05-11-170928,170928,6,1,6,423,5.4,1170.558166138479,0
2020-05-12-170928,170928,3,0,8,426,6.0,1255.1805481131817,1
2020-05-13-170928,170928,0,0,2,426,0.8,1079.0048411140508,2
2020-05-14-170928,170928,9,0,2,435,3.4,764.150671976704,3
2020-05-15-170928,170928,7,0,2,442,5.6,625.6025198149771,4
2020-05-16-170928,170928,0,0,0,442,0.0,566.678742124471,5
2020-05-17-170928,170928,0,0,0,442,0.0,560.8236797462619,6
2020-05-18-170928,170928,4,0,2,446,4.8,560.2464384202257,0
2020-05-19-170928,170928,4,1,2,450,4.4,522.5668958289439,1
2020-05-20-170928,170928,5,0,2,455,6.0,455.4654481315942,2
2020-05-21-170928,170928,0,0,0,455,3.2,458.9224521830098,3
2020-05-22-170928,170928,2,0,6,457,5.4,408.86246772844197,4
2020-05-23-170928,170928,0,0,0,457,0.4,479.4611307202466,5
2020-05-24-170928,170928,0,0,0,457,0.2,496.30018199896153,6
2020-05-25-170928,170928,6,0,1,463,6.4,394.3394171350221,0
2020-05-26-170928,170928,8,0,4,471,3.4,443.3006496142275,1
2020-05-27-170928,170928,2,0,1,473,4.6,550.6615038096916,2
2020-05-28-170928,170928,2,3,2,475,4.4,524.2961083571826,3
2020-05-29-170928,170928,2,0,2,477,3.8,528.7782797418972,4
2020-05-30-170928,170928,0,0,0,477,0.2,525.8350047931049,5
2020-05-31-170928,170928,0,0,0,477,0.2,537.0975396902084,6
2020-06-01-170928,170928,2,0,0,479,3.6,907.1002804452875,0
2020-06-02-170928,170928,2,0,4,481,3.8,299.4343886875567,1
2020-06-03-170928,170928,2,0,2,483,2.4,243.5960228910019,2
2020-06-04-170928,170928,0,0,3,483,2.6,261.2463114179731,3
2020-06-05-170928,170928,6,0,0,489,3.4,297.1763269493168,4
2020-06-06-170928,170928,0,0,0,489,0.0,324.0038844982249,5
2020-06-07-170928,170928,0,0,0,489,0.4,315.2208266969189,6
2020-06-08-170928,170928,1,0,4,490,2.0,313.0334911681897,0
2020-06-09-170928,170928,4,1,3,494,1.2,310.86368916198876,1
2020-06-10-170928,170928,1,0,2,495,3.0,1032.4421398116233,2
2020-06-11-170928,170928,2,0,0,497,1.8,897.8522122084312,3
2020-06-12-170928,170928,2,0,1,499,1.8,791.8400426460148,4
2020-06-13-170928,170928,0,1,0,499,0.2,670.1442648474556,5
2020-06-14-170928,170928,0,0,0,499,0.4,509.039489338122,6
2020-06-15-170928,170928,0,0,1,499,2.8,315.2063198088418,0
2020-06-16-170928,170928,4,0,1,503,1.6,363.5206153374562,1
2020-06-17-170928,170928,2,0,0,505,1.6,351.48064404102365,2
2020-06-18-170928,170928,3,0,0,508,1.4,328.9322223563595,3
2020-06-19-170928,170928,0,0,0,508,2.8,322.0920625094785,4
2020-06-20-170928,170928,0,1,0,508,0.4,414.18730669000627,5
2020-06-21-170928,170928,0,0,0,508,0.2,417.1663895145747,6
2020-06-22-170928,170928,4,0,0,512,1.6,353.299293069899,0
2020-06-23-170928,170928,3,0,0,515,0.8,316.5919735266991,1
2020-06-24-170928,170928,2,0,2,517,1.6,323.06991684782787,2
2020-06-25-170928,170928,0,0,0,517,1.6,302.96503858555275,3
2020-06-26-170928,170928,1,0,0,518,1.0,284.95456793255687,4
2020-06-27-170928,170928,0,0,8,518,0.6,248.07968528492853,5
2020-06-28-170928,170928,0,0,5,518,0.0,251.92009409193696,6
2020-06-29-170928,170928,1,0,0,519,1.6,254.25341515847146,0
2020-06-30-170928,170928,1,0,0,520,0.8,285.17229575040153,1
2020-07-01-170928,170928,0,0,2,520,1.2,303.14047562879256,2
2020-07-02-170928,170928,0,0,1,520,0.6,130.145175310122,3
2020-07-03-170928,170928,0,0,2,520,1.0,152.96449060112832,4
2020-07-04-170928,170928,0,0,1,520,0.6,213.87656723941038,5
2020-07-05-170928,170928,0,0,1,520,0.2,215.25692183208673,6
2020-07-06-170928,170928,0,0,1,520,0.8,188.3007277786382,0
2020-07-07-170928,170928,0,0,0,520,0.0,181.44307690206264,1
2020-07-08-170928,170928,2,0,0,522,1.0,183.8028878352165,2
2020-07-09-170928,170928,0,0,1,522,1.4,177.2824370632622,3
2020-07-10-170928,170928,0,0,0,522,1.4,282.22740448528725,4
2020-07-11-170928,170928,8,0,0,530,0.4,244.22243674032325,5
2020-07-12-170928,170928,5,0,0,535,0.0,206.53659035079573,6
2020-07-13-170928,170928,0,0,0,535,1.2,228.537408151933,0
2020-07-14-170928,170928,0,0,1,535,1.0,248.00146796363316,1
2020-07-15-170928,170928,2,0,1,537,1.2,213.56615947958718,2
2020-07-16-170928,170928,1,0,8,538,0.6,179.14785075421705,3
2020-07-17-170928,170928,2,0,2,540,0.6,175.95352262291175,4
2020-07-18-170928,170928,1,0,7,541,0.6,179.53294891523305,5
2020-07-19-170928,170928,1,0,2,542,0.2,141.53942871890507,6
2020-07-20-170928,170928,1,0,2,543,0.4,122.3844362776578,0
2020-07-21-170928,170928,0,0,2,543,0.0,124.26329474546375,1
2020-07-22-170928,170928,0,0,0,543,1.4,126.85753858726133,2
2020-07-23-170928,170928,1,0,3,544,0.8,137.84582360464003,3
2020-07-24-170928,170928,0,0,4,544,2.0,132.35823113998197,4
2020-07-25-170928,170928,0,0,14,544,0.0,153.96666242419263,5
2020-07-26-170928,170928,0,0,6,544,0.0,150.2537360545858,6
2020-07-27-170928,170928,0,0,7,544,1.2,132.87296372426178,0
2020-07-28-170928,170928,1,0,2,545,1.4,146.33357565197184,1
2020-07-29-170928,170928,1,0,3,546,1.0,157.20991723490502,2
2020-07-30-170928,170928,8,0,10,554,1.2,150.84937898402944,3
2020-07-31-170928,170928,2,0,12,556,1.0,175.4371101668239,4
2020-08-01-170928,170928,7,0,0,563,0.8,138.47644804422382,5
2020-08-02-170928,170928,2,0,8,565,0.2,746.7174260864136,6
2020-08-03-170928,170928,2,0,5,567,0.2,1678.7826591852786,0
2020-08-04-170928,170928,2,0,3,569,1.6,1381.908353477606,1
2020-08-05-170928,170928,0,0,10,569,1.2,1160.902298177652,2
2020-08-06-170928,170928,3,0,4,572,1.8,878.0993054750463,3
2020-08-07-170928,170928,4,0,4,576,1.6,569.5556935107486,4
2020-08-08-170928,170928,14,0,2,590,2.0,523.5163839438065,5
2020-08-09-170928,170928,6,0,1,596,0.8,592.6185090748436,6
2020-08-10-170928,170928,7,0,10,603,2.4,129.32830488556223,0
2020-08-11-170928,170928,2,0,17,605,3.2,197.9868627832423,1
2020-08-12-170928,170928,3,0,15,608,1.4,254.06181632219875,2
2020-08-13-170928,170928,10,0,12,618,2.8,305.8354128232835,3
2020-08-14-170928,170928,12,0,16,630,4.0,396.57446938748467,4
2020-08-15-170928,170928,0,0,1,630,1.0,479.66070108975475,5
2020-08-16-170928,170928,8,0,1,638,2.0,491.88810576420104,6
2020-08-17-170928,170928,5,0,19,643,3.4,552.0915813079896,0
2020-08-18-170928,170928,3,0,9,646,3.8,557.4158112727383,1
2020-08-19-170928,170928,10,0,16,656,4.2,603.1588759601368,2
2020-08-20-170928,170928,4,0,19,660,6.0,550.6015865642039,3
2020-08-21-170928,170928,4,0,11,664,4.0,650.3438690318549,4
2020-08-22-170928,170928,2,0,1,666,1.2,743.9658633815861,5
2020-08-23-170928,170928,1,0,5,667,2.2,758.6400014175833,6
2020-08-24-170928,170928,10,0,5,677,5.8,757.8117561573854,0
2020-08-25-170928,170928,17,0,0,694,11.6,865.2034093853028,1
2020-08-26-170928,170928,15,0,12,709,11.4,1044.0462679707096,2
2020-08-27-170928,170928,12,1,9,721,15.0,1266.876167897845,3
2020-08-28-170928,170928,16,1,7,737,11.0,1364.0233780531769,4
2020-08-29-170928,170928,1,0,2,738,1.6,1580.455080854335,5
2020-08-30-170928,170928,1,0,1,739,0.8,1548.576007227907,6
2020-08-31-170928,170928,19,1,11,758,10.4,1401.6627607052542,0
2020-09-01-170928,170928,9,0,10,767,7.2,642.5648124887227,1
2020-09-02-170928,170928,16,0,14,783,6.6,1851.7972722886925,2
2020-09-03-170928,170928,19,0,15,802,6.4,1437.269040815076,3
2020-09-04-170928,170928,11,0,8,813,8.0,1478.7776339463858,4
2020-09-05-170928,170928,1,0,3,814,0.6,1350.443810980715,5
2020-09-06-170928,170928,5,1,9,819,1.6,1261.6871652369823,6
2020-09-07-170928,170928,5,0,14,824,9.0,1329.427351483056,0
2020-09-08-170928,170928,0,0,28,824,1.8,1427.211413516738,1
2020-09-09-170928,170928,12,0,11,836,9.4,1264.3163499651546,2
2020-09-10-170928,170928,9,0,4,845,10.2,551.7719786060836,3
2020-09-11-170928,170928,7,0,19,852,10.8,806.4761949849303,4
2020-09-12-170928,170928,2,1,16,854,1.6,1095.1608136509903,5
2020-09-13-170928,170928,1,0,2,855,2.0,1125.1894734688715,6
2020-09-14-170928,170928,11,0,7,866,10.8,1151.4375641602824,0
2020-09-15-170928,170928,10,0,7,876,11.8,1385.3120643757625,1
2020-09-16-170928,170928,14,0,9,890,13.4,1722.53936648521,2
2020-09-17-170928,170928,15,0,18,905,11.8,1929.8325631720704,3
2020-09-18-170928,170928,8,0,18,913,9.6,2047.6615493785462,4
2020-09-19-170928,170928,3,0,4,916,1.6,1979.3735759474598,5
2020-09-20-170928,170928,9,2,1,925,1.8,2174.0170679447165,6
2020-09-21-170928,170928,14,0,21,939,12.2,1890.3960274887277,0
2020-09-22-170928,170928,28,0,14,967,9.8,1870.2052510185497,1
2020-09-23-170928,170928,11,1,12,978,10.0,1800.9581384809594,2
2020-09-24-170928,170928,4,1,14,982,7.6,1605.0089106288265,3
2020-09-25-170928,170928,19,0,5,1001,16.2,1545.9270555366616,4
2020-09-26-170928,170928,16,1,1,1017,4.2,1844.701051144174,5
2020-09-27-170928,170928,2,0,0,1019,0.2,1800.9586454480257,6
2020-09-28-170928,170928,7,0,0,1026,7.4,1760.66604309396,0
2020-09-29-170928,170928,7,1,7,1033,6.0,1670.2899129877524,1
2020-09-30-170928,170928,9,0,5,1042,7.6,1599.2081416249944,2
2020-10-01-170928,170928,18,0,4,1060,6.0,0.0,3
2020-10-02-170928,170928,18,0,9,1078,11.4,1831.2375543688588,4
2020-10-03-170928,170928,4,0,3,1082,0.8,3585.258991447604,5
2020-10-04-170928,170928,1,0,6,1083,3.4,3643.3957532754716,6
2020-10-05-170928,170928,21,0,11,1104,10.2,3022.8523054093916,0
2020-10-06-170928,170928,14,0,12,1118,9.2,2830.2248477789694,1
2020-10-07-170928,170928,12,0,8,1130,11.6,2467.820794863248,2
2020-10-08-170928,170928,14,0,20,1144,4.4,2135.702904073712,3
2020-10-09-170928,170928,5,0,22,1149,7.4,2415.6193166007906,4
2020-10-10-170928,170928,1,0,0,1150,1.2,266.1800762153755,5
2020-10-11-170928,170928,0,0,3,1150,0.4,399.4723625413011,6
2020-10-12-170928,170928,0,0,20,1150,1.6,445.0606442514047,0
2020-10-13-170928,170928,7,0,20,1157,10.8,488.6406780642261,1
2020-10-14-170928,170928,5,0,9,1162,9.2,780.7304952958808,2
2020-10-15-170928,170928,4,0,30,1166,14.0,1092.5787588622757,3
2020-10-16-170928,170928,9,0,9,1175,8.4,1399.9520028824156,4
2020-10-17-170928,170928,3,1,1,1178,1.8,1467.5657347152094,5
2020-10-18-170928,170928,6,0,4,1184,2.2,1467.7379181037645,6
2020-10-19-170928,170928,11,1,3,1195,16.8,1517.679443412618,0
2020-10-20-170928,170928,12,1,23,1207,21.2,1986.383576975907,1
2020-10-21-170928,170928,8,1,12,1215,20.6,2109.332460629262,2
2020-10-22-170928,170928,20,0,23,1235,26.0,2286.006753366587,3
2020-10-23-170928,170928,22,0,19,1257,32.0,2599.3632018066664,4
2020-10-24-170928,170928,0,0,3,1257,2.8,3211.287765254964,5
2020-10-25-170928,170928,3,1,3,1260,1.4,3226.0600315412007,6
2020-10-26-170928,170928,20,0,10,1280,28.2,2940.9377448627215,0
2020-10-27-170928,170928,20,1,8,1300,17.8,3286.8873842988014,1
2020-10-28-170928,170928,9,3,15,1309,26.2,3346.125067428986,2
2020-10-29-170928,170928,30,1,13,1339,43.6,3520.009103073194,3
2020-10-30-170928,170928,9,0,31,1348,36.2,2968.54823886309,4
2020-10-31-170928,170928,1,1,0,1349,8.0,3547.8945548816337,5
2020-11-01-170928,170928,4,1,0,1353,14.8,1918.8318063494291,6
2020-11-02-170928,170928,3,1,0,1356,6.4,2789.986880886566,0
2020-11-03-170928,170928,23,1,0,1379,26.0,2263.700673378259,1
2020-11-04-170928,170928,12,2,0,1391,27.6,2798.3646135951644,2
2020-11-05-170928,170928,23,0,0,1414,39.2,3008.0078107116105,3
2020-11-06-170928,170928,19,1,0,1433,36.2,3405.979295386578,4
2020-11-07-170928,170928,3,0,0,1436,4.0,3762.6254687023466,5
2020-11-08-170928,170928,3,2,0,1439,10.4,3558.2544015500507,6
2020-11-09-170928,170928,10,0,0,1449,23.4,3626.727644207029,0
2020-11-10-170928,170928,8,2,0,1457,21.6,1865.5826642975676,1
2020-11-11-170928,170928,15,3,0,1472,22.0,2248.6190298324263,2
2020-11-12-170928,170928,13,1,0,1485,21.8,2479.026639198904,3
2020-11-13-170928,170928,31,0,0,1516,20.4,2668.813904949503,4
2020-03-01-171001,171001,0,0,0,0,0.0,0.0,6
2020-03-02-171001,171001,0,0,7,0,0.0,31.830462434693143,0
2020-03-03-171001,171001,0,0,2,0,0.4,181.44181594293133,1
2020-03-04-171001,171001,0,0,4,0,0.2,184.82719241098653,2
2020-03-05-171001,171001,0,1,7,0,0.0,192.79184764736453,3
2020-03-06-171001,171001,0,0,2,0,0.0,171.5605377292384,4
2020-03-07-171001,171001,0,0,2,0,0.0,177.14227686000723,5
2020-03-08-171001,171001,0,0,6,0,0.0,179.13950054510062,6
2020-03-09-171001,171001,1,0,5,1,0.4,175.78874654157087,0
2020-03-10-171001,171001,1,0,7,2,0.4,702.711199191529,1
2020-03-11-171001,171001,0,0,4,2,1.0,565.0402205330204,2
2020-03-12-171001,171001,1,0,5,3,0.8,401.95850040696337,3
2020-03-13-171001,171001,2,0,4,5,2.2,273.1279225569568,4
2020-03-14-171001,171001,2,0,2,7,1.2,185.6470546723948,5
2020-03-15-171001,171001,0,0,1,7,1.6,128.2992164124151,6
2020-03-16-171001,171001,7,0,2,14,5.6,40.98052165120408,0
2020-03-17-171001,171001,2,0,2,16,6.6,82.64898282167307,1
2020-03-18-171001,171001,4,0,4,20,12.0,106.11401688357344,2
2020-03-19-171001,171001,7,0,5,27,18.0,138.65690661751373,3
2020-03-20-171001,171001,2,0,4,29,15.4,170.79689765460765,4
2020-03-21-171001,171001,2,0,2,31,3.6,206.38256433949738,5
2020-03-22-171001,171001,6,0,1,37,4.2,201.34559877308126,6
2020-03-23-171001,171001,5,0,2,42,21.0,189.4925605016237,0
2020-03-24-171001,171001,7,0,1,49,14.0,236.6571477380358,1
2020-03-25-171001,171001,4,0,3,53,19.2,249.7177656413798,2
2020-03-26-171001,171001,5,0,9,58,16.4,252.61956459360084,3
2020-03-27-171001,171001,4,0,2,62,13.8,293.49517594508995,4
2020-03-28-171001,171001,2,0,0,64,3.8,278.9687168540768,5
2020-03-29-171001,171001,1,0,0,65,2.8,278.84536544025207,6
2020-03-30-171001,171001,2,0,5,67,11.2,204.59780869029998,0
2020-03-31-171001,171001,2,0,2,69,6.4,193.73100775173344,1
2020-04-01-171001,171001,4,0,1,73,8.8,28.847823669605685,2
2020-04-02-171001,171001,5,0,1,78,5.2,139.41315767796027,3
2020-04-03-171001,171001,4,0,1,82,14.0,52.84511034337865,4
2020-04-04-171001,171001,2,0,1,84,2.6,80.865504444874,5
2020-04-05-171001,171001,1,0,0,85,2.2,85.51556814692258,6
2020-04-06-171001,171001,2,0,2,87,8.4,89.28239952456141,0
2020-04-07-171001,171001,1,0,1,88,9.8,101.61059379732137,1
2020-04-08-171001,171001,3,0,4,91,8.8,130.0797837558941,2
2020-04-09-171001,171001,9,0,0,100,5.6,147.2642935092003,3
2020-04-10-171001,171001,2,0,4,102,4.4,28.421381683115303,4
2020-04-11-171001,171001,0,0,1,102,1.2,36.84925479129787,5
2020-04-12-171001,171001,0,0,1,102,2.8,43.150784602413516,6
2020-04-13-171001,171001,5,0,1,107,8.2,48.59860484587081,0
2020-04-14-171001,171001,2,1,3,109,8.2,105.95671911312311,1
2020-04-15-171001,171001,1,0,1,110,5.8,134.10709999923913,2
2020-04-16-171001,171001,1,0,1,111,3.6,151.59903564034337,3
2020-04-17-171001,171001,1,0,0,112,4.8,147.83188439334188,4
2020-04-18-171001,171001,1,0,0,113,0.8,160.21244285664415,5
2020-04-19-171001,171001,0,1,0,113,0.8,156.96595665230106,6
2020-04-20-171001,171001,2,0,0,115,5.8,113.34540142161373,0
2020-04-21-171001,171001,1,0,0,116,3.2,102.30488574413337,1
2020-04-22-171001,171001,4,0,2,120,4.2,96.62528313004398,2
2020-04-23-171001,171001,0,0,0,120,0.2,97.50071709408718,3
2020-04-24-171001,171001,4,0,1,124,3.4,76.96606090157374,4
2020-04-25-171001,171001,1,0,0,125,0.4,86.00766848312733,5
2020-04-26-171001,171001,1,0,0,126,0.4,85.60088165311353,6
2020-04-27-171001,171001,1,0,2,127,4.8,65.57879949785729,0
2020-04-28-171001,171001,3,0,3,130,2.4,64.54385832267728,1
2020-04-29-171001,171001,1,0,1,131,3.0,58.450014016941545,2
2020-04-30-171001,171001,1,0,1,132,3.6,89.15967681253365,3
2020-05-01-171001,171001,0,0,3,132,0.6,150.9314673505907,4
2020-05-02-171001,171001,0,0,2,132,0.8,47.03390254572007,5
2020-05-03-171001,171001,0,0,0,132,0.4,41.31429781791506,6
2020-05-04-171001,171001,0,0,2,132,3.2,28.342188208426542,0
2020-05-05-171001,171001,0,0,4,132,3.2,38.12378231575937,1
2020-05-06-171001,171001,2,0,1,134,3.8,49.94456041690435,2
2020-05-07-171001,171001,0,0,3,134,3.8,59.097200436949954,3
2020-05-08-171001,171001,1,0,0,135,4.6,63.97089224390816,4
2020-05-09-171001,171001,0,1,0,135,0.6,86.19569281629069,5
2020-05-10-171001,171001,0,0,0,135,0.8,163.3210626378291,6
2020-05-11-171001,171001,2,0,0,137,5.0,155.31032190323043,0
2020-05-12-171001,171001,3,2,0,140,3.0,164.09874791812726,1
2020-05-13-171001,171001,1,0,0,141,2.4,140.71033651421294,2
2020-05-14-171001,171001,1,1,0,142,3.0,96.64087617794942,3
2020-05-15-171001,171001,3,1,2,145,2.4,76.00102936911304,4
2020-05-16-171001,171001,2,0,0,147,0.8,59.6941230578292,5
2020-05-17-171001,171001,0,0,0,147,0.2,61.831734880940914,6
2020-05-18-171001,171001,2,0,0,149,4.0,62.07141614920094,0
2020-05-19-171001,171001,4,0,0,153,1.2,62.211973644134346,1
2020-05-20-171001,171001,1,0,0,154,2.6,57.67073701726362,2
2020-05-21-171001,171001,3,0,0,157,1.6,59.90783180966031,3
2020-05-22-171001,171001,0,0,0,157,2.2,58.60148391565853,4
2020-05-23-171001,171001,0,0,0,157,1.2,64.13375032500554,5
2020-05-24-171001,171001,0,0,0,157,0.0,69.34460732422876,6
2020-05-25-171001,171001,0,0,0,157,3.2,53.99526216309924,0
2020-05-26-171001,171001,0,0,0,157,2.6,57.71169433736992,1
2020-05-27-171001,171001,0,1,0,157,1.2,66.22306101732094,2
2020-05-28-171001,171001,0,0,0,157,1.2,63.46258504857837,3
2020-05-29-171001,171001,2,1,4,159,1.8,59.93952034306874,4
2020-05-30-171001,171001,0,0,0,159,0.2,58.71082039914368,5
2020-05-31-171001,171001,0,0,0,159,0.0,60.450700056352694,6
2020-06-01-171001,171001,0,0,1,159,1.8,116.69455308787772,0
2020-06-02-171001,171001,0,0,1,159,3.0,43.90223309291438,1
2020-06-03-171001,171001,0,0,2,159,1.6,35.674164711319705,2
2020-06-04-171001,171001,0,0,1,159,2.0,41.50101898138884,3
2020-06-05-171001,171001,0,0,0,159,1.4,45.96819869293496,4
2020-06-06-171001,171001,0,0,0,159,0.0,43.963315015070435,5
2020-06-07-171001,171001,0,0,0,159,0.0,44.215907654410216,6
2020-06-08-171001,171001,0,0,0,159,1.6,43.712170674496775,0
2020-06-09-171001,171001,0,0,0,159,0.4,41.09521431103106,1
2020-06-10-171001,171001,0,0,0,159,2.0,134.6582424776509,2
2020-06-11-171001,171001,0,0,1,159,1.6,115.61756184213303,3
2020-06-12-171001,171001,4,0,0,163,1.2,98.686003993453,4
2020-06-13-171001,171001,0,0,0,163,0.2,82.09804676900157,5
2020-06-14-171001,171001,0,0,0,163,0.0,62.16083914658377,6
2020-06-15-171001,171001,1,1,0,164,2.0,37.101041849823844,0
2020-06-16-171001,171001,1,0,0,165,3.6,45.15947062290097,1
2020-06-17-171001,171001,2,0,0,167,1.4,46.39976746419548,2
2020-06-18-171001,171001,1,0,0,168,1.2,48.38065468266902,3
2020-06-19-171001,171001,0,0,1,168,1.8,49.12211338994444,4
2020-06-20-171001,171001,0,0,0,168,0.2,60.40083924679544,5
2020-06-21-171001,171001,0,0,0,168,0.0,60.8069545649194,6
2020-06-22-171001,171001,0,0,0,168,0.6,51.25470678250643,0
2020-06-23-171001,171001,0,0,0,168,1.6,40.49163452081244,1
2020-06-24-171001,171001,0,1,0,168,1.0,40.33776160959529,2
2020-06-25-171001,171001,1,0,0,169,0.4,36.81036645704867,3
2020-06-26-171001,171001,0,0,0,169,2.0,35.93043090063772,4
2020-06-27-171001,171001,0,0,0,169,0.2,33.50640098477379,5
2020-06-28-171001,171001,0,0,0,169,0.2,33.68305777864008,6
2020-06-29-171001,171001,0,0,0,169,3.4,34.507414087141925,0
2020-06-30-171001,171001,0,0,0,169,1.2,45.68865500953177,1
2020-07-01-171001,171001,0,0,0,169,0.2,40.84869210247313,2
2020-07-02-171001,171001,0,0,0,169,0.4,16.666913923716407,3
2020-07-03-171001,171001,1,0,0,170,1.2,24.786425103873764,4
2020-07-04-171001,171001,0,0,0,170,0.0,34.021521994591396,5
2020-07-05-171001,171001,0,0,0,170,0.0,33.89940018117245,6
2020-07-06-171001,171001,0,0,0,170,1.2,29.44537784847636,0
2020-07-07-171001,171001,0,0,0,170,1.0,31.93144430978034,1
2020-07-08-171001,171001,0,0,0,170,0.4,33.45047891829831,2
2020-07-09-171001,171001,0,1,0,170,0.4,31.5679406392005,3
2020-07-10-171001,171001,0,0,0,170,0.6,34.222662190335285,4
2020-07-11-171001,171001,0,0,0,170,0.0,30.545939052496625,5
2020-07-12-171001,171001,0,0,0,170,0.2,24.252157002992803,6
2020-07-13-171001,171001,0,0,0,170,0.8,24.778240419122085,0
2020-07-14-171001,171001,0,0,0,170,0.4,28.19523264198914,1
2020-07-15-171001,171001,0,0,0,170,0.4,22.1001772035502,2
2020-07-16-171001,171001,0,0,0,170,0.4,18.289995521746082,3
2020-07-17-171001,171001,0,0,0,170,1.2,19.4293988459755,4
2020-07-18-171001,171001,0,0,0,170,0.0,17.33413106351437,5
2020-07-19-171001,171001,0,0,0,170,0.2,15.76800878879694,6
2020-07-20-171001,171001,0,0,0,170,0.6,15.821035292581847,0
2020-07-21-171001,171001,0,0,0,170,0.8,17.687688600880875,1
2020-07-22-171001,171001,0,0,1,170,0.0,18.49635748766196,2
2020-07-23-171001,171001,0,0,0,170,1.0,18.468211751507294,3
2020-07-24-171001,171001,0,0,0,170,0.8,20.71628975326504,4
2020-07-25-171001,171001,0,0,0,170,0.2,26.506478635495036,5
2020-07-26-171001,171001,0,0,0,170,0.0,26.406766123959773,6
2020-07-27-171001,171001,0,0,0,170,0.8,22.392700839845794,0
2020-07-28-171001,171001,0,0,0,170,0.2,23.78877577902028,1
2020-07-29-171001,171001,0,0,0,170,0.4,23.986015869796113,2
2020-07-30-171001,171001,0,0,1,170,1.6,23.889047589809294,3
2020-07-31-171001,171001,0,0,0,170,1.2,26.170940128402062,4
2020-08-01-171001,171001,0,0,0,170,0.0,25.72183617252888,5
2020-08-02-171001,171001,0,0,0,170,0.2,87.80463185478439,6
2020-08-03-171001,171001,0,0,0,170,1.6,208.0627215649644,0
2020-08-04-171001,171001,0,0,3,170,0.8,180.35545863043484,1
2020-08-05-171001,171001,1,0,3,171,1.8,160.32749245849652,2
2020-08-06-171001,171001,0,0,2,171,2.0,126.33302623487342,3
2020-08-07-171001,171001,0,0,2,171,1.8,93.70658183128499,4
2020-08-08-171001,171001,0,0,0,171,1.6,79.54264352631681,5
2020-08-09-171001,171001,0,0,0,171,1.8,84.9774857609132,6
2020-08-10-171001,171001,0,0,1,171,1.2,19.952594684854674,0
2020-08-11-171001,171001,0,0,1,171,2.6,29.520847752459616,1
2020-08-12-171001,171001,0,0,2,171,3.6,35.61896778110764,2
2020-08-13-171001,171001,1,0,5,172,1.8,52.60663684716637,3
2020-08-14-171001,171001,0,0,1,172,1.4,60.70403566370149,4
2020-08-15-171001,171001,0,0,3,172,0.4,71.09877858725567,5
2020-08-16-171001,171001,0,0,0,172,3.6,70.7445406630398,6
2020-08-17-171001,171001,0,0,4,172,1.8,86.77553728551284,0
2020-08-18-171001,171001,3,0,5,175,3.8,85.96498574544307,1
2020-08-19-171001,171001,3,0,3,178,3.4,91.872209465802,2
2020-08-20-171001,171001,2,0,3,180,5.0,71.96208187688512,3
2020-08-21-171001,171001,2,0,3,182,6.2,92.05687249888851,4
2020-08-22-171001,171001,0,0,11,182,3.2,109.1207443546463,5
2020-08-23-171001,171001,0,0,7,182,2.4,117.44914427998478,6
2020-08-24-171001,171001,1,0,2,183,4.4,123.53502953072525,0
2020-08-25-171001,171001,1,0,0,184,7.6,136.6465882251347,1
2020-08-26-171001,171001,2,0,1,186,3.2,154.89089615849488,2
2020-08-27-171001,171001,5,0,5,191,9.0,175.8577336833281,3
2020-08-28-171001,171001,1,0,13,192,5.0,186.1168037017188,4
2020-08-29-171001,171001,3,0,2,195,3.8,203.26291841782495,5
2020-08-30-171001,171001,0,0,1,195,2.6,201.54399802921742,6
2020-08-31-171001,171001,4,0,5,199,4.6,190.82881266961738,0
2020-09-01-171001,171001,5,1,3,204,3.4,90.66558258510398,1
2020-09-02-171001,171001,3,0,4,207,4.2,301.69109584538853,2
2020-09-03-171001,171001,3,0,7,210,2.8,199.95176803631946,3
2020-09-04-171001,171001,3,0,4,213,5.8,191.26442214643188,4
2020-09-05-171001,171001,11,0,4,224,5.4,178.06088854014166,5
2020-09-06-171001,171001,7,0,2,231,7.2,178.49827840572772,6
2020-09-07-171001,171001,2,0,1,233,10.0,193.8353786967845,0
2020-09-08-171001,171001,0,0,6,233,2.4,228.97426220455708,1
2020-09-09-171001,171001,1,0,5,234,6.0,203.09521177414464,2
2020-09-10-171001,171001,5,0,5,239,13.8,85.58960654544427,3
2020-09-11-171001,171001,13,0,4,252,6.4,141.271808264178,4
2020-09-12-171001,171001,2,0,0,254,2.2,184.02474910137846,5
2020-09-13-171001,171001,1,0,1,255,3.6,190.07449919625049,6
2020-09-14-171001,171001,5,0,0,260,8.6,192.0297071843707,0
2020-09-15-171001,171001,3,0,1,263,8.4,246.1396036231563,1
2020-09-16-171001,171001,4,0,2,267,8.6,293.53513138893265,2
2020-09-17-171001,171001,7,1,0,274,10.2,335.3799534078581,3
2020-09-18-171001,171001,4,0,1,278,7.0,342.5155356841102,4
2020-09-19-171001,171001,4,0,0,282,3.2,323.18844483935777,5
2020-09-20-171001,171001,2,1,0,284,2.4,341.86725850372744,6
2020-09-21-171001,171001,1,0,0,285,5.4,278.2170368288324,0
2020-09-22-171001,171001,6,0,5,291,5.8,266.5721122311313,1
2020-09-23-171001,171001,5,1,0,296,6.6,236.1137984958948,2
2020-09-24-171001,171001,5,1,5,301,6.8,207.3588773699564,3
2020-09-25-171001,171001,4,0,2,305,6.8,206.9241915458804,4
2020-09-26-171001,171001,0,0,2,305,1.6,242.14471964229259,5
2020-09-27-171001,171001,1,0,0,306,1.2,238.1331093418305,6
2020-09-28-171001,171001,0,0,1,306,3.4,242.2548824801128,0
2020-09-29-171001,171001,1,0,1,307,4.2,234.23884381751492,1
2020-09-30-171001,171001,2,0,3,309,3.4,229.71423381696343,2
2020-10-01-171001,171001,0,0,4,309,5.0,0.0,3
2020-10-02-171001,171001,1,1,3,310,6.0,267.54255568004027,4
2020-10-03-171001,171001,0,0,2,310,2.2,555.1138251929074,5
2020-10-04-171001,171001,0,0,2,310,2.2,566.4600304222993,6
2020-10-05-171001,171001,0,0,2,310,4.0,471.0888939843164,0
2020-10-06-171001,171001,5,0,6,315,6.2,430.55039188684736,1
2020-10-07-171001,171001,0,0,5,315,5.2,375.31066658075434,2
2020-10-08-171001,171001,5,0,10,320,6.8,329.3636660215635,3
2020-10-09-171001,171001,2,0,12,322,8.4,378.519789406777,4
2020-10-10-171001,171001,2,0,0,324,6.8,34.332311708431014,5
2020-10-11-171001,171001,0,0,6,324,1.8,69.08959303923683,6
2020-10-12-171001,171001,1,0,7,325,2.6,80.5518562888286,0
2020-10-13-171001,171001,1,0,9,326,6.4,89.93834155361513,1
2020-10-14-171001,171001,3,0,5,329,7.4,126.2889069085372,2
2020-10-15-171001,171001,4,0,10,333,4.8,179.3641809624176,3
2020-10-16-171001,171001,3,0,7,336,9.8,217.29228094376282,4
2020-10-17-171001,171001,2,0,1,338,4.0,237.1653405773924,5
2020-10-18-171001,171001,2,0,0,340,1.8,225.6903747362689,6
2020-10-19-171001,171001,2,0,1,342,5.6,231.07164027968722,0
2020-10-20-171001,171001,6,0,12,348,11.0,292.0860641150035,1
2020-10-21-171001,171001,5,0,8,353,10.0,303.4112430227336,2
2020-10-22-171001,171001,10,0,10,363,12.2,346.06221257676975,3
2020-10-23-171001,171001,12,0,11,375,18.2,394.72547324405946,4
2020-10-24-171001,171001,0,0,12,375,5.4,470.60388675539457,5
2020-10-25-171001,171001,6,0,3,381,4.2,478.7756611661739,6
2020-10-26-171001,171001,7,0,6,388,18.8,455.9247062623702,0
2020-10-27-171001,171001,9,0,0,397,11.6,505.7563188880613,1
2020-10-28-171001,171001,5,0,2,402,16.8,513.8123061022923,2
2020-10-29-171001,171001,10,0,8,412,13.2,531.100680208432,3
2020-10-30-171001,171001,7,0,1,419,24.0,440.66852763293906,4
2020-10-31-171001,171001,1,0,0,420,9.0,514.9923992234648,5
2020-11-01-171001,171001,0,0,0,420,5.6,287.61975529639847,6
2020-11-02-171001,171001,1,0,0,421,1.6,423.43169690060836,0
2020-11-03-171001,171001,12,0,0,433,10.4,319.79993068932004,1
2020-11-04-171001,171001,8,0,0,441,15.4,397.3626287875086,2
2020-11-05-171001,171001,10,0,0,451,16.4,444.58821501618434,3
2020-11-06-171001,171001,11,0,0,462,16.2,498.84140789654055,4
2020-11-07-171001,171001,12,0,0,474,9.0,540.4616516589588,5
2020-11-08-171001,171001,3,0,0,477,5.2,545.779822075937,6
2020-11-09-171001,171001,6,0,0,483,10.8,569.4697108877717,0
2020-11-10-171001,171001,0,0,0,483,10.2,259.4571744192361,1
2020-11-11-171001,171001,2,0,0,485,15.6,312.03864239093514,2
2020-11-12-171001,171001,8,0,0,493,10.4,366.78030132141896,3
2020-11-13-171001,171001,1,0,0,494,15.4,395.89514744158714,4
2020-03-01-171002,171002,0,0,0,0,0.14285714285714285,0.0,6
2020-03-02-171002,171002,0,0,1,0,0.0,9.318585670170282,0
2020-03-03-171002,171002,0,0,1,0,0.0,62.69923102805711,1
2020-03-04-171002,171002,0,0,0,0,0.0,64.31875289927463,2
2020-03-05-171002,171002,0,0,0,0,0.0,67.49262214900841,3
2020-03-06-171002,171002,0,0,0,0,0.0,51.200463591899904,4
2020-03-07-171002,171002,0,0,0,0,0.0,49.0205826348146,5
2020-03-08-171002,171002,0,0,0,0,0.14285714285714285,47.49184488456901,6
2020-03-09-171002,171002,0,0,1,0,0.42857142857142855,47.135092679451354,0
2020-03-10-171002,171002,0,0,0,0,0.2857142857142857,177.72144600523598,1
2020-03-11-171002,171002,0,0,2,0,0.14285714285714285,137.8872660172466,2
2020-03-12-171002,171002,0,0,1,0,0.42857142857142855,81.06313343642104,3
2020-03-13-171002,171002,1,0,1,1,0.5714285714285714,50.26498575198164,4
2020-03-14-171002,171002,0,0,0,1,0.42857142857142855,37.414067707916715,5
2020-03-15-171002,171002,0,0,0,1,1.4285714285714286,25.464981913524824,6
2020-03-16-171002,171002,1,0,0,2,4.285714285714286,11.660656728923659,0
2020-03-17-171002,171002,1,2,1,3,3.7142857142857135,23.66279852186721,1
2020-03-18-171002,171002,0,1,1,3,4.857142857142857,30.86976365164585,2
2020-03-19-171002,171002,0,0,0,3,6.428571428571429,41.20131517749622,3
2020-03-20-171002,171002,0,0,0,3,6.142857142857142,44.40371780437667,4
2020-03-21-171002,171002,0,0,1,3,2.571428571428572,55.82284129690734,5
2020-03-22-171002,171002,0,2,0,3,2.7142857142857144,53.92577343055564,6
2020-03-23-171002,171002,1,0,0,4,9.142857142857142,50.577089787085825,0
2020-03-24-171002,171002,0,0,0,4,6.0,68.51021273913001,1
2020-03-25-171002,171002,2,0,0,6,5.142857142857143,74.2935744082732,2
2020-03-26-171002,171002,1,0,0,7,7.0,77.81850211829996,3
2020-03-27-171002,171002,1,0,0,8,8.428571428571429,92.2691085827291,4
2020-03-28-171002,171002,0,0,1,8,2.8571428571428568,95.12640887345971,5
2020-03-29-171002,171002,0,0,1,8,2.7142857142857144,96.63410777445335,6
2020-03-30-171002,171002,0,0,1,8,5.0,70.20178145758642,0
2020-03-31-171002,171002,1,0,0,9,2.7142857142857144,65.577926263996,1
2020-04-01-171002,171002,1,0,2,10,5.428571428571429,8.914916828693833,2
2020-04-02-171002,171002,0,0,0,10,8.285714285714286,37.117619850202495,3
2020-04-03-171002,171002,0,0,0,10,8.0,25.783573381275623,4
2020-04-04-171002,171002,1,0,0,11,1.5714285714285714,29.824471965315464,5
2020-04-05-171002,171002,0,2,1,11,2.2857142857142856,33.96273018039159,6
2020-04-06-171002,171002,0,0,0,11,4.857142857142857,31.306232191065398,0
2020-04-07-171002,171002,0,0,0,11,4.857142857142857,33.67787875734318,1
2020-04-08-171002,171002,0,0,0,11,4.714285714285714,39.11561519089603,2
2020-04-09-171002,171002,0,0,0,11,5.142857142857143,44.75054085825096,3
2020-04-10-171002,171002,0,0,0,11,1.7142857142857142,11.842372190843225,4
2020-04-11-171002,171002,1,0,0,12,1.8571428571428568,12.96721931330434,5
2020-04-12-171002,171002,1,0,0,13,1.8571428571428568,18.194731577738597,6
2020-04-13-171002,171002,1,0,0,14,3.4285714285714284,21.937396053851963,0
2020-04-14-171002,171002,0,0,0,14,2.142857142857143,31.86737921909538,1
2020-04-15-171002,171002,2,0,0,16,3.1428571428571432,38.87571316500232,2
2020-04-16-171002,171002,0,0,0,16,2.571428571428572,49.850998530879956,3
2020-04-17-171002,171002,0,0,0,16,1.4285714285714286,47.55819092636588,4
2020-04-18-171002,171002,0,0,0,16,0.2857142857142857,52.330876084900396,5
2020-04-19-171002,171002,1,1,0,17,0.42857142857142855,46.34742321577377,6
2020-04-20-171002,171002,0,0,0,17,3.571428571428572,48.09886202547326,0
2020-04-21-171002,171002,0,0,0,17,1.4285714285714286,48.1884450020509,1
2020-04-22-171002,171002,0,0,0,17,2.571428571428572,38.772102880893954,2
2020-04-23-171002,171002,0,0,0,17,0.42857142857142855,40.029063829990136,3
2020-04-24-171002,171002,0,0,0,17,2.7142857142857144,36.52355178847848,4
2020-04-25-171002,171002,0,0,0,17,0.14285714285714285,43.22205569764348,5
2020-04-26-171002,171002,0,1,0,17,2.571428571428572,41.43233683589178,6
2020-04-27-171002,171002,0,1,1,17,2.0,39.757903292312065,0
2020-04-28-171002,171002,0,0,0,17,1.7142857142857142,38.423507053046094,1
2020-04-29-171002,171002,0,0,0,17,2.142857142857143,37.96914147729311,2
2020-04-30-171002,171002,0,1,0,17,1.5714285714285714,48.35376339745151,3
2020-05-01-171002,171002,0,0,0,17,0.7142857142857143,61.1066613070553,4
2020-05-02-171002,171002,0,0,0,17,0.5714285714285714,16.811131143513947,5
2020-05-03-171002,171002,0,0,0,17,0.2857142857142857,13.886734719532576,6
2020-05-04-171002,171002,0,1,0,17,1.5714285714285714,9.880652881224607,0
2020-05-05-171002,171002,0,0,0,17,1.7142857142857142,11.478910918809632,1
2020-05-06-171002,171002,0,0,0,17,2.571428571428572,14.038034278658014,2
2020-05-07-171002,171002,0,0,0,17,2.142857142857143,17.91006714133526,3
2020-05-08-171002,171002,0,0,0,17,2.0,18.285532756730387,4
2020-05-09-171002,171002,0,0,0,17,0.5714285714285714,25.646229193084526,5
2020-05-10-171002,171002,0,0,0,17,0.5714285714285714,65.28364299560505,6
2020-05-11-171002,171002,1,0,1,18,2.142857142857143,59.115827021037184,0
2020-05-12-171002,171002,0,0,0,18,1.4285714285714286,58.073864061630104,1
2020-05-13-171002,171002,0,0,0,18,2.2857142857142856,48.26704720889252,2
2020-05-14-171002,171002,0,0,0,18,1.5714285714285714,39.096775495898335,3
2020-05-15-171002,171002,0,0,0,18,1.7142857142857142,31.61491102927518,4
2020-05-16-171002,171002,0,0,0,18,0.7142857142857143,24.95160120412841,5
2020-05-17-171002,171002,0,0,0,18,0.5714285714285714,24.72850657132163,6
2020-05-18-171002,171002,0,0,0,18,1.8571428571428568,25.588852879987147,0
2020-05-19-171002,171002,0,0,0,18,1.1428571428571428,22.532097373231686,1
2020-05-20-171002,171002,0,1,0,18,1.4285714285714286,20.12120087311891,2
2020-05-21-171002,171002,0,0,0,18,1.8571428571428568,19.50814340814289,3
2020-05-22-171002,171002,0,0,0,18,1.5714285714285714,16.45358418797545,4
2020-05-23-171002,171002,0,0,0,18,0.0,19.48715257904187,5
2020-05-24-171002,171002,0,0,0,18,0.14285714285714285,18.79856762895096,6
2020-05-25-171002,171002,1,0,2,19,0.8571428571428571,15.671538774121279,0
2020-05-26-171002,171002,0,0,0,19,1.1428571428571428,18.298087464002812,1
2020-05-27-171002,171002,0,2,0,19,0.7142857142857143,21.50046759614704,2
2020-05-28-171002,171002,0,0,0,19,0.7142857142857143,20.883518288974912,3
2020-05-29-171002,171002,0,1,0,19,0.5714285714285714,19.173032865745526,4
2020-05-30-171002,171002,0,0,0,19,0.14285714285714285,22.260405791638902,5
2020-05-31-171002,171002,0,1,0,19,0.14285714285714285,24.16188227038778,6
2020-06-01-171002,171002,0,1,0,19,1.0,40.81485336658693,0
2020-06-02-171002,171002,0,0,0,19,1.2857142857142858,16.219501355114957,1
2020-06-03-171002,171002,0,0,0,19,0.42857142857142855,9.790413304297317,2
2020-06-04-171002,171002,0,0,0,19,0.42857142857142855,10.146076577956286,3
2020-06-05-171002,171002,0,0,0,19,0.14285714285714285,10.308936618656892,4
2020-06-06-171002,171002,0,0,0,19,0.14285714285714285,8.983884438917984,5
2020-06-07-171002,171002,0,0,0,19,0.0,9.332476072828342,6
2020-06-08-171002,171002,2,0,0,21,0.2857142857142857,9.044463795595744,0
2020-06-09-171002,171002,0,0,0,21,0.14285714285714285,16.393289888549088,1
2020-06-10-171002,171002,0,0,0,21,0.7142857142857143,44.956060586080326,2
2020-06-11-171002,171002,0,0,0,21,0.8571428571428571,38.988851002253746,3
2020-06-12-171002,171002,0,0,0,21,0.5714285714285714,34.26202621356579,4
2020-06-13-171002,171002,0,0,0,21,0.0,27.273180555361694,5
2020-06-14-171002,171002,0,0,0,21,0.0,19.726974403968292,6
2020-06-15-171002,171002,0,0,0,21,1.1428571428571428,11.260664268952413,0
2020-06-16-171002,171002,0,0,0,21,1.2857142857142858,13.462646332541798,1
2020-06-17-171002,171002,0,0,0,21,0.7142857142857143,14.712156114607318,2
2020-06-18-171002,171002,0,0,0,21,0.8571428571428571,14.196801825401085,3
2020-06-19-171002,171002,0,0,0,21,1.4285714285714286,14.868144407423937,4
2020-06-20-171002,171002,0,0,0,21,0.2857142857142857,21.00830200532608,5
2020-06-21-171002,171002,0,0,0,21,0.0,21.95892839906163,6
2020-06-22-171002,171002,0,0,0,21,0.5714285714285714,18.772202973843896,0
2020-06-23-171002,171002,0,0,0,21,0.5714285714285714,15.401027670483936,1
2020-06-24-171002,171002,0,0,0,21,0.42857142857142855,16.327985849841554,2
2020-06-25-171002,171002,0,0,0,21,0.14285714285714285,14.148436892812885,3
2020-06-26-171002,171002,0,0,0,21,0.5714285714285714,12.61430732996709,4
2020-06-27-171002,171002,0,0,0,21,0.2857142857142857,10.813400455871967,5
2020-06-28-171002,171002,0,0,0,21,0.14285714285714285,10.845206750597146,6
2020-06-29-171002,171002,0,0,0,21,0.5714285714285714,11.207827090944324,0
2020-06-30-171002,171002,0,0,0,21,0.42857142857142855,11.72352481504862,1
2020-07-01-171002,171002,0,0,0,21,0.2857142857142857,18.14836185262358,2
2020-07-02-171002,171002,0,0,0,21,0.2857142857142857,4.531487314372114,3
2020-07-03-171002,171002,0,0,0,21,0.2857142857142857,9.51083639659435,4
2020-07-04-171002,171002,0,0,0,21,0.14285714285714285,11.716809691553754,5
2020-07-05-171002,171002,0,0,0,21,0.0,11.68731309728338,6
2020-07-06-171002,171002,0,0,0,21,0.5714285714285714,9.123946673313924,0
2020-07-07-171002,171002,0,0,0,21,0.7142857142857143,9.18898180274915,1
2020-07-08-171002,171002,0,0,0,21,0.0,9.999170623184096,2
2020-07-09-171002,171002,0,0,0,21,0.2857142857142857,9.52972116279826,3
2020-07-10-171002,171002,0,0,0,21,0.42857142857142855,18.857452415291377,4
2020-07-11-171002,171002,0,0,0,21,0.14285714285714285,18.146123294377954,5
2020-07-12-171002,171002,0,0,0,21,0.14285714285714285,16.998439945485845,6
2020-07-13-171002,171002,0,0,0,21,0.2857142857142857,16.664694569485864,0
2020-07-14-171002,171002,0,0,0,21,0.42857142857142855,17.539239968472142,1
2020-07-15-171002,171002,0,0,0,21,1.0,7.521289442181947,2
2020-07-16-171002,171002,0,0,0,21,0.7142857142857143,6.20413184885907,3
2020-07-17-171002,171002,0,0,0,21,0.5714285714285714,5.581992877401465,4
2020-07-18-171002,171002,0,0,0,21,0.0,5.25948816891468,5
2020-07-19-171002,171002,0,0,0,21,0.0,4.797846239473154,6
2020-07-20-171002,171002,0,0,0,21,0.14285714285714285,5.8259780351056065,0
2020-07-21-171002,171002,0,0,0,21,0.5714285714285714,6.741691059497313,1
2020-07-22-171002,171002,0,0,0,21,0.0,7.948979783190683,2
2020-07-23-171002,171002,0,0,0,21,0.42857142857142855,8.168985585143067,3
2020-07-24-171002,171002,0,0,0,21,0.5714285714285714,8.656000118247722,4
2020-07-25-171002,171002,0,0,0,21,0.14285714285714285,10.728060732195747,5
2020-07-26-171002,171002,0,0,0,21,0.14285714285714285,10.740508888419281,6
2020-07-27-171002,171002,0,0,0,21,1.2857142857142858,8.582187339283204,0
2020-07-28-171002,171002,0,0,2,21,0.42857142857142855,10.16593441916687,1
2020-07-29-171002,171002,0,0,0,21,0.42857142857142855,9.742823075291664,2
2020-07-30-171002,171002,0,0,2,21,0.7142857142857143,9.600912790312046,3
2020-07-31-171002,171002,0,0,0,21,1.1428571428571428,10.180458983342529,4
2020-08-01-171002,171002,0,0,0,21,0.14285714285714285,7.511255029990169,5
2020-08-02-171002,171002,0,0,0,21,0.14285714285714285,57.22526132030664,6
2020-08-03-171002,171002,0,0,0,21,0.5714285714285714,109.38745664573801,0
2020-08-04-171002,171002,0,0,0,21,0.8571428571428571,112.95099370793034,1
2020-08-05-171002,171002,0,0,0,21,1.7142857142857142,94.90572578405232,2
2020-08-06-171002,171002,0,0,0,21,0.8571428571428571,83.42228572427021,3
2020-08-07-171002,171002,0,0,0,21,0.2857142857142857,63.23719457885154,4
2020-08-08-171002,171002,0,0,0,21,1.2857142857142858,51.60623810764773,5
2020-08-09-171002,171002,0,0,0,21,0.42857142857142855,56.23023941608883,6
2020-08-10-171002,171002,0,0,0,21,0.2857142857142857,5.434788618761167,0
2020-08-11-171002,171002,2,0,0,23,1.5714285714285714,9.960941547404133,1
2020-08-12-171002,171002,0,0,1,23,1.7142857142857142,23.45593286285223,2
2020-08-13-171002,171002,2,0,0,25,1.7142857142857142,28.9133416922525,3
2020-08-14-171002,171002,0,0,0,25,2.2857142857142856,41.47638563086595,4
2020-08-15-171002,171002,0,1,0,25,1.2857142857142858,50.44574779789936,5
2020-08-16-171002,171002,0,0,2,25,0.7142857142857143,53.59383010029738,6
2020-08-17-171002,171002,0,0,0,25,1.8571428571428568,60.189586028315794,0
2020-08-18-171002,171002,0,0,0,25,2.8571428571428568,59.67225037418892,1
2020-08-19-171002,171002,0,0,0,25,1.2857142857142858,53.70846418795657,2
2020-08-20-171002,171002,0,0,0,25,3.4285714285714284,42.00805607397706,3
2020-08-21-171002,171002,0,0,4,25,3.1428571428571432,48.49176198331181,4
2020-08-22-171002,171002,0,0,0,25,0.42857142857142855,56.67394955562024,5
2020-08-23-171002,171002,0,0,0,25,1.4285714285714286,54.695540504477655,6
2020-08-24-171002,171002,0,0,0,25,2.0,54.58996757758368,0
2020-08-25-171002,171002,0,0,0,25,4.285714285714286,58.86371787711556,1
2020-08-26-171002,171002,1,0,0,26,2.142857142857143,65.90945401905702,2
2020-08-27-171002,171002,0,0,0,26,5.285714285714286,83.67067673498212,3
2020-08-28-171002,171002,0,0,0,26,4.142857142857143,84.2107005833941,4
2020-08-29-171002,171002,0,0,1,26,2.0,93.41499429076488,5
2020-08-30-171002,171002,2,0,0,28,2.571428571428572,98.71234332921223,6
2020-08-31-171002,171002,0,0,1,28,2.0,100.70600886430286,0
2020-09-01-171002,171002,0,0,4,28,1.1428571428571428,38.995835936760365,1
2020-09-02-171002,171002,0,0,2,28,1.5714285714285714,205.09536771752505,2
2020-09-03-171002,171002,0,0,8,28,3.571428571428572,105.6315299088455,3
2020-09-04-171002,171002,4,0,0,32,2.571428571428572,91.63478081185903,4
2020-09-05-171002,171002,0,0,2,32,1.0,79.93326288601642,5
2020-09-06-171002,171002,0,0,0,32,4.285714285714286,79.16603948388126,6
2020-09-07-171002,171002,0,0,1,32,2.4285714285714284,87.11204215668948,0
2020-09-08-171002,171002,0,0,1,32,4.428571428571429,90.044786377018,1
2020-09-09-171002,171002,0,0,3,32,5.0,94.49217701191424,2
2020-09-10-171002,171002,0,0,0,32,6.142857142857142,25.706966111340687,3
2020-09-11-171002,171002,0,0,8,32,4.428571428571429,55.11456809842994,4
2020-09-12-171002,171002,1,0,1,33,2.4285714285714284,78.2333817484809,5
2020-09-13-171002,171002,0,0,0,33,1.0,89.45183228018766,6
2020-09-14-171002,171002,1,0,0,34,4.714285714285714,90.74276675406917,0
2020-09-15-171002,171002,4,0,3,38,7.2857142857142865,100.33778861354321,1
2020-09-16-171002,171002,2,0,0,40,7.7142857142857135,141.65678395780714,2
2020-09-17-171002,171002,8,0,0,48,4.142857142857143,167.62834535746893,3
2020-09-18-171002,171002,0,0,0,48,12.714285714285715,175.91738816059853,4
2020-09-19-171002,171002,2,0,0,50,11.428571428571427,162.26188301266004,5
2020-09-20-171002,171002,0,0,0,50,2.571428571428572,182.50586316776423,6
2020-09-21-171002,171002,1,0,1,51,3.571428571428572,168.89422594763533,0
2020-09-22-171002,171002,1,0,0,52,4.428571428571429,144.778791210593,1
2020-09-23-171002,171002,3,1,0,55,4.714285714285714,125.38056872182422,2
2020-09-24-171002,171002,0,0,0,55,4.0,106.26354049713174,3
2020-09-25-171002,171002,8,0,2,63,3.0,101.12768903895216,4
2020-09-26-171002,171002,1,0,0,64,1.8571428571428568,88.51311602048085,5
2020-09-27-171002,171002,0,0,0,64,1.0,95.11220657195307,6
2020-09-28-171002,171002,0,0,0,64,2.142857142857143,96.23955326824435,0
2020-09-29-171002,171002,3,0,0,67,4.714285714285714,87.89342430643853,1
2020-09-30-171002,171002,0,1,0,67,2.8571428571428568,84.73691891988494,2
2020-10-01-171002,171002,0,0,0,67,4.857142857142857,0.0,3
2020-10-02-171002,171002,0,0,0,67,3.1428571428571432,110.12362947664614,4
2020-10-03-171002,171002,0,0,0,67,1.4285714285714286,198.47104247082888,5
2020-10-04-171002,171002,0,0,0,67,0.14285714285714285,193.09913601758086,6
2020-10-05-171002,171002,1,0,1,68,2.571428571428572,166.42284429437433,0
2020-10-06-171002,171002,0,0,3,68,4.857142857142857,143.49627668582127,1
2020-10-07-171002,171002,0,0,0,68,3.1428571428571432,124.69933169263061,2
2020-10-08-171002,171002,0,0,0,68,3.571428571428572,112.29843646018898,3
2020-10-09-171002,171002,2,0,1,70,4.857142857142857,126.87998666140835,4
2020-10-10-171002,171002,0,0,2,70,3.0,15.726567893313447,5
2020-10-11-171002,171002,0,0,1,70,1.1428571428571428,24.41051448591205,6
2020-10-12-171002,171002,0,0,0,70,1.2857142857142858,31.26355176765296,0
2020-10-13-171002,171002,0,0,4,70,3.2857142857142856,35.28114583662301,1
2020-10-14-171002,171002,0,0,1,70,5.857142857142858,48.47378339532305,2
2020-10-15-171002,171002,0,0,1,70,3.1428571428571432,69.0641789334902,3
2020-10-16-171002,171002,0,0,2,70,6.2857142857142865,88.29424566202451,4
2020-10-17-171002,171002,0,0,0,70,2.7142857142857144,94.32987118328379,5
2020-10-18-171002,171002,0,0,0,70,2.0,91.75522475535877,6
2020-10-19-171002,171002,1,0,0,71,2.571428571428572,91.62157770137144,0
2020-10-20-171002,171002,3,0,0,74,7.2857142857142865,101.6630758668216,1
2020-10-21-171002,171002,0,0,2,74,5.285714285714286,111.17673402716377,2
2020-10-22-171002,171002,0,0,1,74,3.4285714285714284,111.90290478770505,3
2020-10-23-171002,171002,1,0,1,75,9.857142857142858,106.33839189372426,4
2020-10-24-171002,171002,2,0,0,77,6.142857142857142,126.99413212904787,5
2020-10-25-171002,171002,1,0,0,78,1.7142857142857142,135.59294025875036,6
2020-10-26-171002,171002,0,0,0,78,6.2857142857142865,124.25930589065649,0
2020-10-27-171002,171002,4,0,1,82,8.0,136.5915110449571,1
2020-10-28-171002,171002,1,0,1,83,9.0,145.9299782313193,2
2020-10-29-171002,171002,1,0,0,84,6.2857142857142865,158.77121537682407,3
2020-10-30-171002,171002,2,0,3,86,11.857142857142858,145.86844559390778,4
2020-10-31-171002,171002,0,0,0,86,6.0,161.0046077452801,5
2020-11-01-171002,171002,0,1,0,86,3.0,97.1206224960597,6
2020-11-02-171002,171002,0,0,0,86,1.0,133.73753140005408,0
2020-11-03-171002,171002,0,0,0,86,6.2857142857142865,113.40900494323677,1
2020-11-04-171002,171002,2,0,0,88,9.0,131.0614340400962,2
2020-11-05-171002,171002,1,0,0,89,9.142857142857142,147.8146099439216,3
2020-11-06-171002,171002,1,0,0,90,9.142857142857142,170.0379678220166,4
2020-11-07-171002,171002,0,0,0,90,5.857142857142858,175.37196588223196,5
2020-11-08-171002,171002,0,0,0,90,2.7142857142857144,168.6471078088332,6
2020-11-09-171002,171002,0,0,0,90,2.7142857142857144,168.89415861802547,0
2020-11-10-171002,171002,1,1,0,91,6.571428571428571,85.08547206310215,1
2020-11-11-171002,171002,1,1,0,92,5.142857142857143,101.87815419197763,2
2020-11-12-171002,171002,0,0,0,92,4.428571428571429,106.71635988822261,3
2020-11-13-171002,171002,3,0,0,95,6.142857142857142,118.03217447994359,4
2020-03-01-171003,171003,0,0,1,0,0.0,0.0,6
2020-03-02-171003,171003,0,1,6,0,0.0,322.54534704384673,0
2020-03-03-171003,171003,2,0,6,2,0.0,1807.0712851871092,1
2020-03-04-171003,171003,1,0,8,3,0.0,1868.7026287328463,2
2020-03-05-171003,171003,0,0,17,3,0.2,1944.1345555513963,3
2020-03-06-171003,171003,0,0,24,3,0.0,1726.4493619296495,4
2020-03-07-171003,171003,0,0,4,3,0.2,1798.472012387306,5
2020-03-08-171003,171003,0,0,5,3,0.0,1823.8045168331178,6
2020-03-09-171003,171003,1,0,24,4,0.2,1795.2193303285185,0
2020-03-10-171003,171003,0,0,11,4,0.2,7198.145238817891,1
2020-03-11-171003,171003,0,0,20,4,0.2,5813.7713732801785,2
2020-03-12-171003,171003,2,0,16,6,0.4,4126.299084388211,3
2020-03-13-171003,171003,0,0,11,6,1.2,2783.6841935247844,4
2020-03-14-171003,171003,0,0,4,6,0.6,1894.5160795891397,5
2020-03-15-171003,171003,1,0,1,7,0.6,1296.9578892041163,6
2020-03-16-171003,171003,6,0,8,13,5.4,403.24558505951927,0
2020-03-17-171003,171003,6,0,9,19,5.6,823.901096707996,1
2020-03-18-171003,171003,8,0,10,27,9.0,1089.5945462835666,2
2020-03-19-171003,171003,17,0,2,44,13.8,1431.756520582915,3
2020-03-20-171003,171003,24,0,14,68,10.2,1795.840852175862,4
2020-03-21-171003,171003,4,0,1,72,4.2,2211.9119843121334,5
2020-03-22-171003,171003,5,0,2,77,4.4,2157.3872605573283,6
2020-03-23-171003,171003,24,0,9,101,15.6,2038.743082366438,0
2020-03-24-171003,171003,11,0,11,112,12.0,2511.199281353007,1
2020-03-25-171003,171003,20,0,13,132,9.4,2652.312124323033,2
2020-03-26-171003,171003,16,0,6,148,13.2,2677.5984538802695,3
2020-03-27-171003,171003,11,0,3,159,9.8,3112.91952673674,4
2020-03-28-171003,171003,4,0,1,163,2.8,2947.410118591012,5
2020-03-29-171003,171003,1,0,1,164,2.2,2942.160837196294,6
2020-03-30-171003,171003,8,0,6,172,9.0,2169.700962602779,0
2020-03-31-171003,171003,9,0,9,181,5.4,2055.336388754179,1
2020-04-01-171003,171003,10,0,4,191,7.4,316.1324834102091,2
2020-04-02-171003,171003,2,0,4,193,6.8,1354.0757626497907,3
2020-04-03-171003,171003,14,0,8,207,12.0,586.922222656725,4
2020-04-04-171003,171003,1,0,1,208,1.8,932.2809306374062,5
2020-04-05-171003,171003,2,0,1,210,0.8,981.9571245302396,6
2020-04-06-171003,171003,9,0,6,219,8.0,1014.8076105371473,0
2020-04-07-171003,171003,11,0,3,230,7.0,1154.852942444135,1
2020-04-08-171003,171003,13,1,5,243,8.2,1408.5790258802112,2
2020-04-09-171003,171003,6,3,0,249,7.4,1595.4752430475023,3
2020-04-10-171003,171003,3,0,4,252,3.8,331.1005592118886,4
2020-04-11-171003,171003,1,0,1,253,0.6,434.8047470907662,5
2020-04-12-171003,171003,1,0,1,254,3.0,501.7491979717113,6
2020-04-13-171003,171003,6,0,10,260,7.8,563.044621048924,0
2020-04-14-171003,171003,9,0,3,269,7.4,1022.7706502819286,1
2020-04-15-171003,171003,4,0,5,273,5.0,1323.3935667009087,2
2020-04-16-171003,171003,4,0,2,277,4.8,1534.0169646433046,3
2020-04-17-171003,171003,8,0,0,285,2.6,1471.605710632215,4
2020-04-18-171003,171003,1,0,1,286,0.6,1584.6013436058765,5
2020-04-19-171003,171003,1,0,0,287,0.4,1547.3784003947003,6
2020-04-20-171003,171003,6,0,6,293,4.0,1239.6381780114884,0
2020-04-21-171003,171003,3,0,5,296,2.8,1131.9101492715713,1
2020-04-22-171003,171003,5,0,3,301,2.8,1060.9114487165452,2
2020-04-23-171003,171003,0,0,4,301,0.0,1060.8465667020585,3
2020-04-24-171003,171003,4,0,3,305,3.8,845.5095149809611,4
2020-04-25-171003,171003,1,0,0,306,0.4,949.6763908124747,5
2020-04-26-171003,171003,1,0,0,307,1.0,948.1049918597278,6
2020-04-27-171003,171003,10,0,3,317,3.4,727.6233560801415,0
2020-04-28-171003,171003,3,0,5,320,2.2,727.3252674231057,1
2020-04-29-171003,171003,5,0,0,325,2.2,664.2205540811794,2
2020-04-30-171003,171003,2,0,2,327,2.0,1049.579621732246,3
2020-05-01-171003,171003,0,1,3,327,1.0,1638.0433832188498,4
2020-05-02-171003,171003,1,0,2,328,0.2,519.8336145921877,5
2020-05-03-171003,171003,0,0,0,328,0.4,468.9466595331073,6
2020-05-04-171003,171003,6,0,3,334,1.8,321.12692629963396,0
2020-05-05-171003,171003,5,0,3,339,2.8,438.46440846947,1
2020-05-06-171003,171003,3,0,2,342,3.0,559.0760396494325,2
2020-05-07-171003,171003,4,0,2,346,1.6,658.6227567360502,3
2020-05-08-171003,171003,3,0,2,349,3.8,728.8314897788006,4
2020-05-09-171003,171003,0,0,2,349,0.6,961.5580325037845,5
2020-05-10-171003,171003,0,0,0,349,0.2,1770.1137785366827,6
2020-05-11-171003,171003,3,0,5,352,3.0,1680.3088534790295,0
2020-05-12-171003,171003,5,0,2,357,2.2,1778.4357492074669,1
2020-05-13-171003,171003,0,0,2,357,2.2,1505.181612511276,2
2020-05-14-171003,171003,2,0,2,359,3.2,1054.1262572779726,3
2020-05-15-171003,171003,3,0,3,362,2.2,824.8963714080179,4
2020-05-16-171003,171003,2,2,0,364,1.0,663.9690464729699,5
2020-05-17-171003,171003,0,0,0,364,0.0,685.5116096277135,6
2020-05-18-171003,171003,3,0,2,367,3.6,684.7544054537652,0
2020-05-19-171003,171003,3,0,4,370,1.6,678.514862558174,1
2020-05-20-171003,171003,2,0,4,372,3.8,623.0588786804483,2
2020-05-21-171003,171003,2,0,0,374,2.4,655.9844272012116,3
2020-05-22-171003,171003,2,0,0,376,2.2,629.2057753880468,4
2020-05-23-171003,171003,2,0,0,378,0.2,692.699447495674,5
2020-05-24-171003,171003,0,0,0,378,0.0,745.8341898081763,6
2020-05-25-171003,171003,5,0,1,383,1.8,584.5557724793385,0
2020-05-26-171003,171003,2,0,0,385,1.4,640.4018894337156,1
2020-05-27-171003,171003,2,0,2,387,1.4,737.4879129855614,2
2020-05-28-171003,171003,2,0,2,389,1.0,699.627653482484,3
2020-05-29-171003,171003,3,0,0,392,2.2,673.5825648822753,4
2020-05-30-171003,171003,0,0,0,392,0.0,659.6861339076378,5
2020-05-31-171003,171003,0,0,0,392,0.0,676.7062535415705,6
2020-06-01-171003,171003,2,0,3,394,1.8,1276.9343169224248,0
2020-06-02-171003,171003,4,0,2,398,1.6,476.51607603706503,1
2020-06-03-171003,171003,4,0,1,402,1.4,385.8438537929661,2
2020-06-04-171003,171003,0,0,1,402,2.6,453.55667634934355,3
2020-06-05-171003,171003,0,0,0,402,0.6,503.49847466931817,4
2020-06-06-171003,171003,0,0,0,402,0.0,485.4384991788829,5
2020-06-07-171003,171003,0,0,0,402,0.0,485.0891177572561,6
2020-06-08-171003,171003,1,0,0,403,0.4,478.6688045965663,0
2020-06-09-171003,171003,0,0,1,403,1.2,449.92358832263824,1
2020-06-10-171003,171003,2,0,1,405,2.2,1471.195466242788,2
2020-06-11-171003,171003,2,0,0,407,1.2,1259.4222770541073,3
2020-06-12-171003,171003,0,0,3,407,1.4,1080.9093660185872,4
2020-06-13-171003,171003,0,0,0,407,0.0,902.4109425576072,5
2020-06-14-171003,171003,0,0,0,407,0.0,679.1578888926377,6
2020-06-15-171003,171003,3,3,2,410,1.8,411.7252599667279,0
2020-06-16-171003,171003,2,1,3,412,3.4,500.55317498067785,1
2020-06-17-171003,171003,1,0,0,413,2.0,507.9605675071424,2
2020-06-18-171003,171003,1,0,2,414,2.4,516.6547562528847,3
2020-06-19-171003,171003,0,0,0,414,1.4,516.6704272071682,4
2020-06-20-171003,171003,0,0,0,414,0.2,649.2785845956789,5
2020-06-21-171003,171003,0,0,0,414,0.0,654.750042203347,6
2020-06-22-171003,171003,0,0,2,414,0.6,547.553297575645,0
2020-06-23-171003,171003,1,0,1,415,1.0,438.41412354907175,1
2020-06-24-171003,171003,1,0,1,416,0.4,435.0922183486841,2
2020-06-25-171003,171003,0,0,1,416,0.6,394.31164497308646,3
2020-06-26-171003,171003,3,0,1,419,0.8,375.7168266311279,4
2020-06-27-171003,171003,0,0,0,419,0.2,347.0569214389828,5
2020-06-28-171003,171003,0,0,0,419,0.2,346.9960665893592,6
2020-06-29-171003,171003,2,0,1,421,1.8,353.53959740596224,0
2020-06-30-171003,171003,3,0,0,424,0.6,467.88427409163035,1
2020-07-01-171003,171003,0,0,1,424,0.6,425.54583950281693,2
2020-07-02-171003,171003,2,0,1,426,0.0,177.81395111085504,3
2020-07-03-171003,171003,0,0,0,426,1.0,256.23860827011856,4
2020-07-04-171003,171003,0,0,0,426,0.0,357.42860822506486,5
2020-07-05-171003,171003,0,0,0,426,0.0,357.3717357061321,6
2020-07-06-171003,171003,2,0,1,428,0.6,313.2553260341705,0
2020-07-07-171003,171003,1,0,0,429,1.0,333.9286556518796,1
2020-07-08-171003,171003,1,0,0,430,0.8,349.86157565861265,2
2020-07-09-171003,171003,1,0,1,431,0.8,332.96508848690206,3
2020-07-10-171003,171003,1,0,1,432,0.6,367.8378892523708,4
2020-07-11-171003,171003,0,0,0,432,0.0,333.9220940525202,5
2020-07-12-171003,171003,0,0,0,432,0.2,273.0787839576245,6
2020-07-13-171003,171003,1,0,0,433,1.0,283.8144801599996,0
2020-07-14-171003,171003,0,0,1,433,0.2,318.7997986175589,1
2020-07-15-171003,171003,1,0,0,434,1.2,258.23737568992436,2
2020-07-16-171003,171003,1,0,3,435,0.4,217.92948357006907,3
2020-07-17-171003,171003,0,0,1,435,1.2,226.97147927909424,4
2020-07-18-171003,171003,0,0,0,435,0.0,202.8624300125091,5
2020-07-19-171003,171003,0,0,0,435,0.0,176.2743817634526,6
2020-07-20-171003,171003,1,0,3,436,0.2,172.5001841082206,0
2020-07-21-171003,171003,0,0,1,436,0.8,190.89573990869584,1
2020-07-22-171003,171003,0,1,4,436,0.2,199.55368671958612,2
2020-07-23-171003,171003,1,0,2,437,0.6,200.03487451154749,3
2020-07-24-171003,171003,1,0,6,438,0.2,220.8737252412229,4
2020-07-25-171003,171003,0,0,5,438,0.2,277.2162291523149,5
2020-07-26-171003,171003,0,0,8,438,0.0,275.5277793869935,6
2020-07-27-171003,171003,0,0,3,438,1.0,233.091690040486,0
2020-07-28-171003,171003,1,0,0,439,0.4,244.16975892234063,1
2020-07-29-171003,171003,0,0,8,439,0.6,249.05624178892265,2
2020-07-30-171003,171003,3,0,4,442,0.4,244.3732471805495,3
2020-07-31-171003,171003,1,0,1,443,1.2,276.6245546652687,4
2020-08-01-171003,171003,0,0,0,443,0.0,267.61258833638954,5
2020-08-02-171003,171003,0,0,11,443,0.4,987.1935703074549,6
2020-08-03-171003,171003,3,1,2,446,2.0,2381.5371912187347,0
2020-08-04-171003,171003,1,0,0,447,0.4,2028.369734171224,1
2020-08-05-171003,171003,4,0,1,451,0.8,1786.7016689556222,2
2020-08-06-171003,171003,2,0,14,453,1.0,1413.4778278775239,3
2020-08-07-171003,171003,6,0,6,459,2.0,1027.0187939830598,4
2020-08-08-171003,171003,5,0,12,464,0.8,875.6852705390291,5
2020-08-09-171003,171003,8,0,1,472,1.0,939.9498263219549,6
2020-08-10-171003,171003,3,0,5,475,1.2,213.95970739589424,0
2020-08-11-171003,171003,0,0,6,475,2.4,320.92718743515553,1
2020-08-12-171003,171003,8,0,4,483,0.8,386.4259048231356,2
2020-08-13-171003,171003,4,0,11,487,2.2,567.1618844676439,3
2020-08-14-171003,171003,1,0,5,488,2.2,655.139007731964,4
2020-08-15-171003,171003,0,0,9,488,1.0,764.4599654908263,5
2020-08-16-171003,171003,11,0,1,499,3.2,756.9712464572765,6
2020-08-17-171003,171003,2,0,3,501,1.6,920.2044122638617,0
2020-08-18-171003,171003,0,0,3,501,2.4,917.7691153884558,1
2020-08-19-171003,171003,1,0,4,502,3.4,972.9973630026956,2
2020-08-20-171003,171003,14,0,1,516,5.0,773.5511080695392,3
2020-08-21-171003,171003,6,0,8,522,5.0,988.5117268483463,4
2020-08-22-171003,171003,12,0,1,534,2.2,1169.028219399323,5
2020-08-23-171003,171003,1,0,4,535,3.2,1246.4294774298687,6
2020-08-24-171003,171003,5,0,12,540,2.6,1300.1798406571802,0
2020-08-25-171003,171003,6,0,1,546,7.0,1471.375643566062,1
2020-08-26-171003,171003,4,0,14,550,5.8,1687.2192747803742,2
2020-08-27-171003,171003,11,0,24,561,5.8,1931.768257763989,3
2020-08-28-171003,171003,5,1,14,566,6.2,2030.130456633272,4
2020-08-29-171003,171003,9,0,3,575,2.2,2256.7471519993296,5
2020-08-30-171003,171003,1,0,5,576,2.8,2237.3339716922846,6
2020-08-31-171003,171003,3,0,24,579,3.0,2092.00757311886,0
2020-09-01-171003,171003,3,0,16,582,4.0,1001.9890494192314,1
2020-09-02-171003,171003,4,0,23,586,3.0,3201.479767083409,2
2020-09-03-171003,171003,1,0,24,587,1.6,2107.2145403345176,3
2020-09-04-171003,171003,8,0,12,595,4.4,2048.7962331011795,4
2020-09-05-171003,171003,1,0,5,596,6.4,1888.5311443841024,5
2020-09-06-171003,171003,4,0,0,600,6.8,1865.4761240684036,6
2020-09-07-171003,171003,12,0,5,612,6.6,2026.279817705458,0
2020-09-08-171003,171003,1,0,4,613,4.0,2390.1573399335975,1
2020-09-09-171003,171003,14,0,6,627,3.2,2136.9946587814093,2
2020-09-10-171003,171003,24,0,9,651,6.8,945.1231288152641,3
2020-09-11-171003,171003,14,0,13,665,7.2,1548.5759378500265,4
2020-09-12-171003,171003,3,0,2,668,3.6,2009.4070238455072,5
2020-09-13-171003,171003,5,0,2,673,1.4,2067.953702671261,6
2020-09-14-171003,171003,24,0,4,697,4.6,2087.94418715908,0
2020-09-15-171003,171003,16,0,6,713,6.8,2646.9537618019913,1
2020-09-16-171003,171003,23,0,6,736,7.8,3150.785783813618,2
2020-09-17-171003,171003,24,0,6,760,5.6,3596.3272770756867,3
2020-09-18-171003,171003,12,0,12,772,6.6,3646.7122585272646,4
2020-09-19-171003,171003,5,0,2,777,4.6,3446.0134452765055,5
2020-09-20-171003,171003,0,0,3,777,1.8,3673.87818662886,6
2020-09-21-171003,171003,5,0,5,782,5.6,3017.3741327342827,0
2020-09-22-171003,171003,4,1,8,786,4.4,2888.6651665866557,1
2020-09-23-171003,171003,6,0,7,792,10.2,2552.911167153434,2
2020-09-24-171003,171003,9,0,10,801,3.8,2234.782056033,3
2020-09-25-171003,171003,13,0,14,814,4.6,2212.1774535790505,4
2020-09-26-171003,171003,2,0,9,816,1.8,2602.590092242933,5
2020-09-27-171003,171003,2,0,4,818,0.6,2562.329791166445,6
2020-09-28-171003,171003,4,0,3,822,1.6,2579.5607067045603,0
2020-09-29-171003,171003,6,0,5,828,2.2,2471.4946331923356,1
2020-09-30-171003,171003,6,0,11,834,3.8,2415.9174921357308,2
2020-10-01-171003,171003,6,0,5,840,2.6,0.0,3
2020-10-02-171003,171003,12,0,10,852,4.8,2750.4576603322953,4
2020-10-03-171003,171003,2,0,1,854,0.4,5699.363839595179,5
2020-10-04-171003,171003,3,1,3,857,2.2,5809.3924448033,6
2020-10-05-171003,171003,5,0,7,862,1.6,4821.402098897676,0
2020-10-06-171003,171003,8,0,13,870,4.0,4416.607562769157,1
2020-10-07-171003,171003,7,0,18,877,2.8,3869.766385218607,2
2020-10-08-171003,171003,10,0,25,887,3.6,3397.642488682004,3
2020-10-09-171003,171003,14,0,19,901,5.0,3879.703494348185,4
2020-10-10-171003,171003,9,0,3,910,3.0,359.89642885100557,5
2020-10-11-171003,171003,4,0,8,914,2.2,704.7564207737728,6
2020-10-12-171003,171003,3,0,17,917,2.4,822.5743749198684,0
2020-10-13-171003,171003,5,0,10,922,4.6,919.3025315169909,1
2020-10-14-171003,171003,11,0,15,933,6.4,1283.5664514332686,2
2020-10-15-171003,171003,5,0,14,938,4.8,1828.6368602830796,3
2020-10-16-171003,171003,10,0,25,948,9.8,2220.3749325220633,4
2020-10-17-171003,171003,1,0,10,949,4.4,2427.364859623237,5
2020-10-18-171003,171003,3,0,6,952,1.6,2313.2948620045054,6
2020-10-19-171003,171003,7,0,3,959,3.4,2371.277714291824,0
2020-10-20-171003,171003,13,0,19,972,10.8,3075.10743339212,1
2020-10-21-171003,171003,18,0,24,990,7.4,3227.440000425129,2
2020-10-22-171003,171003,25,0,28,1015,8.8,3692.3421262428988,3
2020-10-23-171003,171003,19,0,22,1034,16.6,4273.410051232506,4
2020-10-24-171003,171003,3,0,27,1037,4.0,5109.268501228809,5
2020-10-25-171003,171003,8,0,16,1045,5.8,5186.267943473118,6
2020-10-26-171003,171003,17,0,13,1062,15.2,4946.233878021421,0
2020-10-27-171003,171003,10,0,13,1072,9.0,5485.686645317932,1
2020-10-28-171003,171003,15,0,25,1087,13.4,5559.381387698742,2
2020-10-29-171003,171003,14,0,12,1101,12.8,5764.139757259454,3
2020-10-30-171003,171003,25,0,31,1126,14.4,4737.533958036026,4
2020-10-31-171003,171003,10,1,0,1136,6.4,5592.719361400971,5
2020-11-01-171003,171003,6,1,0,1142,3.8,3085.778235148674,6
2020-11-02-171003,171003,3,0,0,1145,1.4,4623.764643522512,0
2020-11-03-171003,171003,19,0,0,1164,11.2,3541.8795487366942,1
2020-11-04-171003,171003,24,0,0,1188,10.4,4456.795962693881,2
2020-11-05-171003,171003,28,1,0,1216,10.8,4952.453711292625,3
2020-11-06-171003,171003,22,1,0,1238,12.8,5542.887106564289,4
2020-11-07-171003,171003,27,0,0,1265,10.0,6032.612416543028,5
2020-11-08-171003,171003,16,0,0,1281,3.4,6081.427385112334,6
2020-11-09-171003,171003,13,1,0,1294,6.6,6315.753918430176,0
2020-11-10-171003,171003,13,1,0,1307,7.0,2776.452484709098,1
2020-11-11-171003,171003,25,1,0,1332,8.6,3315.71716303286,2
2020-11-12-171003,171003,12,0,0,1344,9.2,3879.083625273757,3
2020-11-13-171003,171003,31,1,0,1375,7.0,4166.0327091246045,4
2020-03-01-171006,171006,0,0,2,0,0.0,0.0,6
2020-03-02-171006,171006,0,0,1,0,0.5,7.7628946875038265,0
2020-03-03-171006,171006,0,0,8,0,0.0,43.608008749330764,1
2020-03-04-171006,171006,0,0,0,0,0.0,47.2700650320303,2
2020-03-05-171006,171006,0,0,9,0,0.5,50.78595545011875,3
2020-03-06-171006,171006,0,0,5,0,0.0,47.05950923433929,4
2020-03-07-171006,171006,0,0,1,0,0.0,50.15966915835922,5
2020-03-08-171006,171006,0,0,4,0,0.0,46.474747214458375,6
2020-03-09-171006,171006,0,0,14,0,0.0,47.085267114184944,0
2020-03-10-171006,171006,0,0,7,0,0.0,225.04175534909814,1
2020-03-11-171006,171006,0,0,8,0,0.0,182.52512161556984,2
2020-03-12-171006,171006,0,0,7,0,0.0,129.616404080759,3
2020-03-13-171006,171006,0,0,4,0,0.5,80.926108384087,4
2020-03-14-171006,171006,0,0,1,0,0.0,52.97621474042764,5
2020-03-15-171006,171006,2,0,3,2,0.25,34.17490875984816,6
2020-03-16-171006,171006,1,0,5,3,3.5,7.781549615642411,0
2020-03-17-171006,171006,8,0,7,11,6.75,14.792686138915643,1
2020-03-18-171006,171006,0,0,5,11,7.5,31.02719238489723,2
2020-03-19-171006,171006,9,0,5,20,5.75,37.21754880381134,3
2020-03-20-171006,171006,5,0,3,25,10.5,53.18069660425577,4
2020-03-21-171006,171006,1,0,5,26,4.0,63.325733816448256,5
2020-03-22-171006,171006,4,0,3,30,7.25,60.44560651343299,6
2020-03-23-171006,171006,14,0,5,44,13.0,66.62087273776424,0
2020-03-24-171006,171006,7,0,5,51,9.0,79.2613569036383,1
2020-03-25-171006,171006,8,0,4,59,10.0,89.28374616344087,2
2020-03-26-171006,171006,7,0,1,66,9.25,88.41802356522358,3
2020-03-27-171006,171006,4,0,2,70,10.5,104.04444808931649,4
2020-03-28-171006,171006,1,0,0,71,4.25,102.94798644137421,5
2020-03-29-171006,171006,3,0,0,74,2.75,104.2704526581526,6
2020-03-30-171006,171006,5,0,1,79,5.75,76.19707238484008,0
2020-03-31-171006,171006,7,0,0,86,6.5,73.26724554163852,1
2020-04-01-171006,171006,5,0,3,91,8.5,13.91764490197161,2
2020-04-02-171006,171006,5,0,4,96,5.5,35.98556332735596,3
2020-04-03-171006,171006,3,0,3,99,5.0,33.87540227097628,4
2020-04-04-171006,171006,5,0,0,104,3.0,38.7725304907153,5
2020-04-05-171006,171006,3,0,0,107,4.0,47.024009204018554,6
2020-04-06-171006,171006,5,0,5,112,13.0,51.7751672162365,0
2020-04-07-171006,171006,5,0,1,117,3.75,63.60162634552713,1
2020-04-08-171006,171006,4,0,2,121,5.0,65.12175009514019,2
2020-04-09-171006,171006,1,0,2,122,2.75,71.9806563465595,3
2020-04-10-171006,171006,2,0,1,124,3.0,12.413151789161475,4
2020-04-11-171006,171006,0,0,1,124,4.25,16.917801620925772,5
2020-04-12-171006,171006,0,0,0,124,4.0,18.401267197808544,6
2020-04-13-171006,171006,1,0,3,125,5.5,20.021704695871605,0
2020-04-14-171006,171006,0,0,6,125,3.5,27.199406466701657,1
2020-04-15-171006,171006,3,1,2,128,3.0,32.41025766854146,2
2020-04-16-171006,171006,4,0,1,132,3.5,40.22457435134726,3
2020-04-17-171006,171006,3,0,0,135,5.0,37.6983179800845,4
2020-04-18-171006,171006,0,0,0,135,1.5,41.49299459624076,5
2020-04-19-171006,171006,0,1,0,135,1.0,42.466835878273116,6
2020-04-20-171006,171006,5,0,4,140,8.5,46.025963524078065,0
2020-04-21-171006,171006,1,0,1,141,2.75,58.86652747505911,1
2020-04-22-171006,171006,2,0,3,143,2.0,52.78587218759175,2
2020-04-23-171006,171006,2,0,7,145,1.0,50.73252710173092,3
2020-04-24-171006,171006,1,0,1,146,3.5,46.67812550601799,4
2020-04-25-171006,171006,1,0,0,147,0.75,48.98688537178832,5
2020-04-26-171006,171006,0,0,0,147,0.5,50.40434913066139,6
2020-04-27-171006,171006,3,0,3,150,3.75,39.56227519794083,0
2020-04-28-171006,171006,6,0,1,156,3.0,33.35636659890212,1
2020-04-29-171006,171006,2,0,2,158,2.5,39.51065275082178,2
2020-04-30-171006,171006,1,0,2,159,3.0,43.54364716976927,3
2020-05-01-171006,171006,0,0,0,159,1.25,69.76919046978689,4
2020-05-02-171006,171006,0,0,1,159,2.75,18.829323504003185,5
2020-05-03-171006,171006,0,0,0,159,1.75,22.720955893802085,6
2020-05-04-171006,171006,4,0,1,163,4.75,15.80981917135824,0
2020-05-05-171006,171006,1,0,0,164,3.25,19.76195586054341,1
2020-05-06-171006,171006,3,0,3,167,5.25,18.758922207177633,2
2020-05-07-171006,171006,7,0,1,174,3.0,21.410920240759395,3
2020-05-08-171006,171006,1,0,4,175,2.75,33.354234827108556,4
2020-05-09-171006,171006,0,0,0,175,0.25,41.58201048181894,5
2020-05-10-171006,171006,0,1,0,175,0.25,78.71327294727254,6
2020-05-11-171006,171006,3,0,3,178,3.75,65.9211989717326,0
2020-05-12-171006,171006,1,0,1,179,2.5,70.94833991011788,1
2020-05-13-171006,171006,2,0,2,181,2.0,49.84276110730261,2
2020-05-14-171006,171006,2,0,3,183,3.75,39.038923607346206,3
2020-05-15-171006,171006,0,0,1,183,1.0,34.06972020602905,4
2020-05-16-171006,171006,1,0,0,184,1.75,28.187294657767257,5
2020-05-17-171006,171006,0,0,0,184,1.25,30.742416598286354,6
2020-05-18-171006,171006,1,0,5,185,4.25,31.04472711824227,0
2020-05-19-171006,171006,0,0,1,185,3.75,29.140102512177776,1
2020-05-20-171006,171006,3,0,2,188,3.75,26.319532857182647,2
2020-05-21-171006,171006,1,0,2,189,3.75,26.66121946726504,3
2020-05-22-171006,171006,4,0,2,193,1.5,30.292595974669958,4
2020-05-23-171006,171006,0,0,0,193,2.0,36.612209572510736,5
2020-05-24-171006,171006,0,0,1,193,0.75,38.27371492977145,6
2020-05-25-171006,171006,3,0,1,196,3.5,31.73539516132862,0
2020-05-26-171006,171006,1,0,1,197,2.0,38.115944772248845,1
2020-05-27-171006,171006,2,0,1,199,3.75,40.72531030591812,2
2020-05-28-171006,171006,3,0,8,202,1.0,38.56812968093888,3
2020-05-29-171006,171006,1,0,0,203,1.25,39.538238252749146,4
2020-05-30-171006,171006,0,0,0,203,0.25,33.822921700685846,5
2020-05-31-171006,171006,0,0,0,203,0.5,33.61252903091794,6
2020-06-01-171006,171006,5,0,5,208,2.0,54.63015466970379,0
2020-06-02-171006,171006,1,0,1,209,0.75,28.17389511017459,1
2020-06-03-171006,171006,2,0,1,211,1.0,17.687073787378772,2
2020-06-04-171006,171006,2,0,3,213,0.25,19.8542438512915,3
2020-06-05-171006,171006,2,2,3,215,1.25,21.60606856230202,4
2020-06-06-171006,171006,0,0,1,215,0.0,22.120190795294135,5
2020-06-07-171006,171006,1,0,0,216,0.5,22.108839582609914,6
2020-06-08-171006,171006,1,0,2,217,1.75,23.894193163259434,0
2020-06-09-171006,171006,1,0,1,218,2.0,24.22091089019696,1
2020-06-10-171006,171006,1,0,1,219,0.75,68.05354717544489,2
2020-06-11-171006,171006,8,0,1,227,1.25,56.78057733154484,3
2020-06-12-171006,171006,0,0,2,227,0.5,65.8482953646928,4
2020-06-13-171006,171006,0,0,0,227,0.0,54.798941773262555,5
2020-06-14-171006,171006,0,0,0,227,0.0,38.63595534644768,6
2020-06-15-171006,171006,5,0,1,232,0.75,32.28377121814036,0
2020-06-16-171006,171006,1,0,1,233,1.25,42.41608029577015,1
2020-06-17-171006,171006,1,0,4,234,1.0,36.18482766985062,2
2020-06-18-171006,171006,3,0,1,237,0.0,35.922991632048024,3
2020-06-19-171006,171006,3,0,1,240,2.5,25.598084779505157,4
2020-06-20-171006,171006,1,0,0,241,0.0,38.01436774818081,5
2020-06-21-171006,171006,0,0,0,241,0.5,40.43791653113022,6
2020-06-22-171006,171006,2,0,2,243,0.75,30.185738211792756,0
2020-06-23-171006,171006,1,0,1,244,0.75,31.29141874418528,1
2020-06-24-171006,171006,1,0,1,245,1.75,31.536582422357583,2
2020-06-25-171006,171006,1,0,0,246,1.25,30.380631465351247,3
2020-06-26-171006,171006,2,0,0,248,0.75,25.780327974597206,4
2020-06-27-171006,171006,0,0,0,248,0.25,28.077584522050135,5
2020-06-28-171006,171006,0,0,0,248,0.0,27.654213791472877,6
2020-06-29-171006,171006,1,0,0,249,1.25,27.591066399034624,0
2020-06-30-171006,171006,1,0,0,250,0.5,29.37860511951302,1
2020-07-01-171006,171006,4,0,1,254,0.25,30.192301704751515,2
2020-07-02-171006,171006,1,0,5,255,0.5,28.805313841243315,3
2020-07-03-171006,171006,1,0,1,256,2.0,98.39407800331597,4
2020-07-04-171006,171006,0,0,0,256,0.5,117.46916496085309,5
2020-07-05-171006,171006,0,0,0,256,0.0,108.10759680771926,6
2020-07-06-171006,171006,2,0,2,258,1.25,85.2186689335467,0
2020-07-07-171006,171006,1,0,3,259,0.5,63.77723995836548,1
2020-07-08-171006,171006,1,0,0,260,1.5,53.594198498861495,2
2020-07-09-171006,171006,0,0,1,260,0.75,53.01322716521823,3
2020-07-10-171006,171006,0,0,6,260,0.5,35.15680452820102,4
2020-07-11-171006,171006,0,0,1,260,0.0,29.954904371430402,5
2020-07-12-171006,171006,0,0,1,260,0.0,23.49287109970169,6
2020-07-13-171006,171006,0,0,10,260,0.25,23.577023211615366,0
2020-07-14-171006,171006,0,0,14,260,0.75,21.391433800545602,1
2020-07-15-171006,171006,1,0,7,261,0.75,18.940189860828987,2
2020-07-16-171006,171006,5,0,12,266,1.0,16.857535201064927,3
2020-07-17-171006,171006,1,0,11,267,0.75,23.321072853685152,4
2020-07-18-171006,171006,0,0,0,267,0.25,26.669005675503264,5
2020-07-19-171006,171006,0,0,0,267,0.75,26.688201984556038,6
2020-07-20-171006,171006,2,0,7,269,0.5,29.804260123946793,0
2020-07-21-171006,171006,3,0,9,272,1.25,33.49529824668443,1
2020-07-22-171006,171006,0,0,10,272,0.75,35.81819619414908,2
2020-07-23-171006,171006,1,0,7,273,1.25,21.117524976856053,3
2020-07-24-171006,171006,6,0,7,279,1.25,22.173765938540498,4
2020-07-25-171006,171006,1,0,2,280,0.5,35.660611901587814,5
2020-07-26-171006,171006,1,0,3,281,0.5,40.149930893890385,6
2020-07-27-171006,171006,10,0,1,291,0.5,39.40133051313765,0
2020-07-28-171006,171006,14,0,3,305,1.5,58.5904307482164,1
2020-07-29-171006,171006,7,0,4,312,1.25,79.34865068086327,2
2020-07-30-171006,171006,12,0,2,324,1.25,89.46391639220329,3
2020-07-31-171006,171006,11,0,3,335,0.75,102.55552896334524,4
2020-08-01-171006,171006,0,0,1,335,0.75,30.16080100732529,5
2020-08-02-171006,171006,0,0,1,335,0.5,57.90960006283527,6
2020-08-03-171006,171006,7,0,2,342,2.25,72.25558542640503,0
2020-08-04-171006,171006,9,0,1,351,1.25,81.72489362056388,1
2020-08-05-171006,171006,10,0,3,361,1.5,74.52672728592248,2
2020-08-06-171006,171006,7,0,6,368,1.5,86.03499528328936,3
2020-08-07-171006,171006,7,0,1,375,1.75,84.1317927863554,4
2020-08-08-171006,171006,2,0,0,377,0.5,88.53077592766942,5
2020-08-09-171006,171006,3,0,0,380,1.0,79.16325589988944,6
2020-08-10-171006,171006,1,0,4,381,1.75,9.659965586832987,0
2020-08-11-171006,171006,3,0,2,384,2.0,12.569828334488696,1
2020-08-12-171006,171006,4,0,9,388,1.75,21.36813059434126,2
2020-08-13-171006,171006,2,0,2,390,2.0,22.819248668076693,3
2020-08-14-171006,171006,3,0,1,393,1.5,26.10560206801454,4
2020-08-15-171006,171006,1,0,0,394,1.5,30.17524049008788,5
2020-08-16-171006,171006,1,0,3,395,0.5,33.21605726395429,6
2020-08-17-171006,171006,2,0,1,397,1.25,36.460061759397036,0
2020-08-18-171006,171006,1,0,2,398,2.75,40.84539761769883,1
2020-08-19-171006,171006,3,0,9,401,3.25,39.67999568437528,2
2020-08-20-171006,171006,6,0,7,407,2.75,42.268639832837444,3
2020-08-21-171006,171006,1,0,3,408,5.75,50.35357753697624,4
2020-08-22-171006,171006,0,0,3,408,2.0,60.6963612379749,5
2020-08-23-171006,171006,0,1,0,408,1.25,66.15777638261842,6
2020-08-24-171006,171006,4,0,11,412,2.0,60.59319444167451,0
2020-08-25-171006,171006,2,0,11,414,4.0,62.042421776294056,1
2020-08-26-171006,171006,9,0,6,423,4.0,60.20151951813993,2
2020-08-27-171006,171006,2,0,14,425,2.0,75.76811783411549,3
2020-08-28-171006,171006,1,0,9,426,5.0,66.19976841397698,4
2020-08-29-171006,171006,0,0,9,426,0.75,63.5092368429995,5
2020-08-30-171006,171006,3,0,5,429,0.5,72.78612950113538,6
2020-08-31-171006,171006,1,0,18,430,2.75,70.96768089146647,0
2020-09-01-171006,171006,2,0,18,432,2.75,84.59618068770402,1
2020-09-02-171006,171006,9,0,19,441,8.0,226.53698205917027,2
2020-09-03-171006,171006,7,0,21,448,5.5,227.27952210223773,3
2020-09-04-171006,171006,3,0,7,451,6.0,190.28462722219172,4
2020-09-05-171006,171006,3,0,11,454,4.5,179.01565959137739,5
2020-09-06-171006,171006,0,0,3,454,9.25,160.49536801000153,6
2020-09-07-171006,171006,11,0,11,465,6.0,161.66406077089033,0
2020-09-08-171006,171006,11,0,11,476,9.5,181.69093940823956,1
2020-09-09-171006,171006,6,0,20,482,6.75,178.89183042444193,2
2020-09-10-171006,171006,14,0,16,496,3.75,88.92285941523036,3
2020-09-11-171006,171006,9,0,16,505,10.25,106.41784505564152,4
2020-09-12-171006,171006,9,0,12,514,3.0,121.34276598469705,5
2020-09-13-171006,171006,5,0,3,519,2.75,127.62433282753841,6
2020-09-14-171006,171006,18,0,10,537,5.0,123.56802141403159,0
2020-09-15-171006,171006,18,0,10,555,10.25,151.40013552477907,1
2020-09-16-171006,171006,19,0,7,574,4.75,193.2063292129707,2
2020-09-17-171006,171006,21,0,9,595,5.5,212.57125670381802,3
2020-09-18-171006,171006,7,0,12,602,5.25,221.16060996838246,4
2020-09-19-171006,171006,11,0,1,613,5.5,219.24542019713087,5
2020-09-20-171006,171006,3,0,10,616,3.5,234.110063266848,6
2020-09-21-171006,171006,11,0,2,627,11.0,212.96430913008035,0
2020-09-22-171006,171006,11,0,17,638,10.25,195.52292637949574,1
2020-09-23-171006,171006,20,0,6,658,10.75,180.35125004291604,2
2020-09-24-171006,171006,16,0,6,674,6.75,181.7296251404636,3
2020-09-25-171006,171006,16,0,3,690,8.5,196.6764982350737,4
2020-09-26-171006,171006,12,0,1,702,9.75,188.30199279808096,5
2020-09-27-171006,171006,3,0,7,705,2.25,208.41851291776152,6
2020-09-28-171006,171006,10,0,4,715,3.25,207.9225855613745,0
2020-09-29-171006,171006,10,0,6,725,6.0,205.6330399464893,1
2020-09-30-171006,171006,7,0,6,732,5.25,191.96344161646186,2
2020-10-01-171006,171006,9,1,3,741,5.0,0.0,3
2020-10-02-171006,171006,12,0,12,753,7.75,138.15695465692187,4
2020-10-03-171006,171006,1,1,4,754,4.25,230.79043651597334,5
2020-10-04-171006,171006,10,1,5,764,1.25,235.84497823759853,6
2020-10-05-171006,171006,2,0,16,766,1.0,219.69120761639388,0
2020-10-06-171006,171006,17,0,10,783,7.25,189.56810669923274,1
2020-10-07-171006,171006,6,0,3,789,4.75,188.91361947297383,2
2020-10-08-171006,171006,6,0,7,795,11.5,172.9983867079356,3
2020-10-09-171006,171006,3,1,5,798,3.75,186.25248711249253,4
2020-10-10-171006,171006,1,0,6,799,4.25,33.288562799939285,5
2020-10-11-171006,171006,7,0,10,806,1.0,44.38360032723634,6
2020-10-12-171006,171006,4,0,16,810,2.25,61.74462820422146,0
2020-10-13-171006,171006,6,0,15,816,6.25,66.66784719798628,1
2020-10-14-171006,171006,6,0,15,822,3.25,88.05367454160799,2
2020-10-15-171006,171006,3,0,10,825,5.25,108.53019715405469,3
2020-10-16-171006,171006,12,0,7,837,6.5,125.56504465695775,4
2020-10-17-171006,171006,4,1,10,841,4.5,110.36535048395174,5
2020-10-18-171006,171006,5,1,4,846,3.5,119.1528166599536,6
2020-10-19-171006,171006,16,1,10,862,4.25,117.2787870022793,0
2020-10-20-171006,171006,10,0,8,872,7.0,157.41041287631955,1
2020-10-21-171006,171006,3,0,13,875,6.5,172.20914035846874,2
2020-10-22-171006,171006,7,0,10,882,6.25,172.30311458459366,3
2020-10-23-171006,171006,5,0,13,887,6.5,176.29751791269783,4
2020-10-24-171006,171006,6,0,10,893,9.5,187.7489784609479,5
2020-10-25-171006,171006,10,1,7,903,2.0,206.8018246318877,6
2020-10-26-171006,171006,16,0,11,919,6.0,187.35812015688583,0
2020-10-27-171006,171006,15,0,11,934,7.5,202.06829425243978,1
2020-10-28-171006,171006,15,0,11,949,7.75,213.78837070554565,2
2020-10-29-171006,171006,10,0,5,959,7.75,253.7090812347491,3
2020-10-30-171006,171006,7,1,11,966,5.75,259.73934598106075,4
2020-10-31-171006,171006,10,3,0,976,8.0,264.25268291813774,5
2020-11-01-171006,171006,4,1,0,980,3.5,187.23317877382846,6
2020-11-02-171006,171006,10,1,0,990,4.25,201.7819752459634,0
2020-11-03-171006,171006,8,0,0,998,6.25,187.8041412145838,1
2020-11-04-171006,171006,13,0,0,1011,8.25,206.2350456845704,2
2020-11-05-171006,171006,10,0,0,1021,13.0,226.7931442663199,3
2020-11-06-171006,171006,13,0,0,1034,10.0,217.23451806630325,4
2020-11-07-171006,171006,10,0,0,1044,3.75,250.91200168411038,5
2020-11-08-171006,171006,7,0,0,1051,4.5,260.7498874412943,6
2020-11-09-171006,171006,11,1,0,1062,7.75,255.90673683305687,0
2020-11-10-171006,171006,11,2,0,1073,12.75,168.3849601032679,1
2020-11-11-171006,171006,11,0,0,1084,6.25,181.94966946911333,2
2020-11-12-171006,171006,5,0,0,1089,6.5,203.83197408173015,3
2020-11-13-171006,171006,11,1,0,1100,10.25,178.5868346221372,4
2020-03-01-171007,171007,0,0,0,0,0.0,0.0,6
2020-03-02-171007,171007,0,0,0,0,0.0,24.022454784086676,0
2020-03-03-171007,171007,0,1,5,0,0.3333333333333333,140.55484778428456,1
2020-03-04-171007,171007,0,2,12,0,0.16666666666666666,144.74626685437562,2
2020-03-05-171007,171007,0,0,24,0,0.0,151.57440319438786,3
2020-03-06-171007,171007,0,0,7,0,0.16666666666666666,135.60764336105007,4
2020-03-07-171007,171007,0,0,3,0,0.0,140.6690716254137,5
2020-03-08-171007,171007,0,1,3,0,0.0,142.76159258867744,6
2020-03-09-171007,171007,0,0,17,0,0.5,139.6225338047783,0
2020-03-10-171007,171007,0,0,11,0,0.3333333333333333,583.6098375324777,1
2020-03-11-171007,171007,1,0,13,1,0.16666666666666666,473.5585008856748,2
2020-03-12-171007,171007,1,0,17,2,0.6666666666666666,337.4498633237514,3
2020-03-13-171007,171007,1,0,11,3,1.3333333333333333,230.06608330667535,4
2020-03-14-171007,171007,0,0,2,3,0.6666666666666666,150.2255983567811,5
2020-03-15-171007,171007,0,0,2,3,0.6666666666666666,98.81096393456647,6
2020-03-16-171007,171007,0,0,10,3,4.833333333333333,29.86665660084825,0
2020-03-17-171007,171007,5,0,3,8,5.333333333333333,61.60075299597506,1
2020-03-18-171007,171007,12,3,7,20,8.666666666666666,79.9097341864212,2
2020-03-19-171007,171007,24,0,6,44,11.166666666666664,102.76080053105125,3
2020-03-20-171007,171007,7,0,3,51,12.833333333333336,127.01274596152614,4
2020-03-21-171007,171007,3,0,0,54,3.8333333333333335,157.01842120034794,5
2020-03-22-171007,171007,3,0,1,57,4.166666666666667,154.16684198392895,6
2020-03-23-171007,171007,17,0,3,74,18.33333333333333,146.3778239021751,0
2020-03-24-171007,171007,11,0,6,85,10.666666666666666,181.02775201282006,1
2020-03-25-171007,171007,13,0,3,98,15.0,191.17450847055312,2
2020-03-26-171007,171007,17,0,5,115,12.166666666666664,192.69761702014594,3
2020-03-27-171007,171007,11,1,2,126,11.166666666666664,224.3294718183575,4
2020-03-28-171007,171007,2,0,0,128,3.5,209.81929910686972,5
2020-03-29-171007,171007,2,0,3,130,3.0,207.87583870652384,6
2020-03-30-171007,171007,10,0,12,140,9.333333333333334,151.98025190503094,0
2020-03-31-171007,171007,3,0,16,143,6.833333333333332,142.2012387342009,1
2020-04-01-171007,171007,7,0,5,150,5.666666666666668,22.12855664159907,2
2020-04-02-171007,171007,6,0,1,156,4.833333333333333,91.47200037364811,3
2020-04-03-171007,171007,3,0,0,159,7.666666666666668,42.17718616963536,4
2020-04-04-171007,171007,0,0,0,159,2.333333333333333,64.82822679637943,5
2020-04-05-171007,171007,1,0,1,160,1.0,67.98569037695562,6
2020-04-06-171007,171007,3,0,2,163,6.333333333333332,70.57707281479793,0
2020-04-07-171007,171007,6,0,5,169,22.83333333333333,79.16923001911796,1
2020-04-08-171007,171007,3,0,1,172,11.0,96.69280745001484,2
2020-04-09-171007,171007,5,0,0,177,5.666666666666668,109.81971975243026,3
2020-04-10-171007,171007,2,0,2,179,5.0,23.68889551799674,4
2020-04-11-171007,171007,0,0,1,179,0.3333333333333333,30.11206940757856,5
2020-04-12-171007,171007,3,0,0,182,1.3333333333333333,34.43656028911046,6
2020-04-13-171007,171007,12,0,4,194,11.5,37.956732465467404,0
2020-04-14-171007,171007,16,0,1,210,9.0,67.44362067594999,1
2020-04-15-171007,171007,5,0,3,215,4.666666666666667,88.67198859741816,2
2020-04-16-171007,171007,1,1,1,216,4.666666666666667,102.17020857791044,3
2020-04-17-171007,171007,0,0,0,216,3.5,96.29775346327932,4
2020-04-18-171007,171007,0,0,0,216,0.8333333333333334,106.13755585543348,5
2020-04-19-171007,171007,1,0,2,217,0.5,103.24950095714767,6
2020-04-20-171007,171007,2,0,2,219,5.5,83.8215595446837,0
2020-04-21-171007,171007,5,0,0,224,3.5,76.56188944616025,1
2020-04-22-171007,171007,1,0,0,225,4.166666666666667,71.82151529501837,2
2020-04-23-171007,171007,0,0,3,225,0.0,72.44143269988172,3
2020-04-24-171007,171007,2,0,3,227,4.5,56.98575769204155,4
2020-04-25-171007,171007,1,0,0,228,0.3333333333333333,64.13204039879152,5
2020-04-26-171007,171007,0,0,0,228,0.8333333333333334,64.0638356431292,6
2020-04-27-171007,171007,4,0,0,232,4.166666666666667,50.656990914268064,0
2020-04-28-171007,171007,1,0,1,233,2.333333333333333,51.46369686982082,1
2020-04-29-171007,171007,3,0,1,236,2.333333333333333,47.3105688141049,2
2020-04-30-171007,171007,1,0,2,237,2.0,73.95764084073376,3
2020-05-01-171007,171007,0,0,1,237,0.3333333333333333,112.71069414252895,4
2020-05-02-171007,171007,0,0,2,237,0.6666666666666666,35.978546372245084,5
2020-05-03-171007,171007,2,0,0,239,0.0,33.310303408233466,6
2020-05-04-171007,171007,2,1,5,241,3.1666666666666665,22.372752678749826,0
2020-05-05-171007,171007,0,0,1,241,3.333333333333333,30.569164012303165,1
2020-05-06-171007,171007,0,0,2,241,3.8333333333333335,39.797794924149244,2
2020-05-07-171007,171007,3,0,1,244,2.5,46.288181779598844,3
2020-05-08-171007,171007,3,0,3,247,4.5,50.43460262903095,4
2020-05-09-171007,171007,0,0,1,247,0.16666666666666666,66.6156534180526,5
2020-05-10-171007,171007,0,0,0,247,0.3333333333333333,124.35956413416639,6
2020-05-11-171007,171007,0,0,1,247,5.666666666666668,118.45656562518226,0
2020-05-12-171007,171007,1,0,2,248,3.5,125.36098809274723,1
2020-05-13-171007,171007,1,0,0,249,0.5,106.45347133785137,2
2020-05-14-171007,171007,2,0,1,251,2.333333333333333,75.03423545201353,3
2020-05-15-171007,171007,1,0,2,252,4.666666666666667,57.84466914740665,4
2020-05-16-171007,171007,2,0,0,254,0.8333333333333334,45.641794057170756,5
2020-05-17-171007,171007,0,0,0,254,0.0,47.89524423811885,6
2020-05-18-171007,171007,5,0,0,259,3.5,47.90691127548034,0
2020-05-19-171007,171007,1,0,1,260,2.1666666666666665,47.76004959749995,1
2020-05-20-171007,171007,2,0,0,262,2.333333333333333,44.515640700701375,2
2020-05-21-171007,171007,1,0,2,263,2.6666666666666665,46.944472255426035,3
2020-05-22-171007,171007,3,0,2,266,1.6666666666666667,45.27142595226376,4
2020-05-23-171007,171007,1,0,0,267,0.6666666666666666,49.39811076089795,5
2020-05-24-171007,171007,0,0,0,267,0.0,53.3885234133537,6
2020-05-25-171007,171007,1,0,0,268,3.1666666666666665,41.81784268772405,0
2020-05-26-171007,171007,2,0,1,270,3.1666666666666665,45.84705967154773,1
2020-05-27-171007,171007,0,0,3,270,2.0,52.598618069969675,2
2020-05-28-171007,171007,1,9,0,271,1.5,50.445696067565834,3
2020-05-29-171007,171007,2,1,1,273,2.0,48.45438438679601,4
2020-05-30-171007,171007,0,0,0,273,0.16666666666666666,47.53220878545261,5
2020-05-31-171007,171007,0,0,0,273,0.0,49.01505685562341,6
2020-06-01-171007,171007,0,0,1,273,2.333333333333333,90.9667025244448,0
2020-06-02-171007,171007,1,0,10,274,2.5,34.40947846004708,1
2020-06-03-171007,171007,0,0,1,274,1.6666666666666667,28.235983994442556,2
2020-06-04-171007,171007,2,0,1,276,2.333333333333333,34.114958243151094,3
2020-06-05-171007,171007,2,0,2,278,1.1666666666666667,37.59637248289914,4
2020-06-06-171007,171007,0,0,0,278,0.16666666666666666,35.02273841891083,5
2020-06-07-171007,171007,0,1,0,278,0.0,34.980750937473736,6
2020-06-08-171007,171007,0,0,0,278,1.5,34.71068816180851,0
2020-06-09-171007,171007,1,0,1,279,0.8333333333333334,32.21870458180715,1
2020-06-10-171007,171007,3,0,0,282,1.1666666666666667,105.1590813359513,2
2020-06-11-171007,171007,0,0,0,282,1.6666666666666667,89.6643691342248,3
2020-06-12-171007,171007,1,0,2,283,1.5,75.77012582873236,4
2020-06-13-171007,171007,0,0,0,283,0.16666666666666666,63.243437180080306,5
2020-06-14-171007,171007,0,0,0,283,0.0,47.500665656761484,6
2020-06-15-171007,171007,1,0,5,284,1.8333333333333333,28.562717558584897,0
2020-06-16-171007,171007,10,0,1,294,1.3333333333333333,35.508168109557865,1
2020-06-17-171007,171007,1,1,0,295,1.8333333333333333,36.246981928717155,2
2020-06-18-171007,171007,1,0,0,296,2.1666666666666665,37.58808495953508,3
2020-06-19-171007,171007,2,0,1,298,1.1666666666666667,37.66154539079166,4
2020-06-20-171007,171007,0,0,0,298,0.0,47.44632142506848,5
2020-06-21-171007,171007,0,0,0,298,0.0,48.13528190950848,6
2020-06-22-171007,171007,0,0,0,298,0.6666666666666666,40.1048345757148,0
2020-06-23-171007,171007,1,0,1,299,0.6666666666666666,31.623254002152642,1
2020-06-24-171007,171007,0,0,1,299,1.0,31.422502099599562,2
2020-06-25-171007,171007,0,0,1,299,0.6666666666666666,28.514186656248555,3
2020-06-26-171007,171007,2,0,0,301,1.1666666666666667,27.616937855971162,4
2020-06-27-171007,171007,0,0,0,301,0.0,25.597233844574017,5
2020-06-28-171007,171007,0,0,0,301,0.0,25.546470155976344,6
2020-06-29-171007,171007,5,0,1,306,1.6666666666666667,25.928410785006925,0
2020-06-30-171007,171007,1,0,1,307,1.0,35.69685365535895,1
2020-07-01-171007,171007,0,0,1,307,0.0,30.5306710822762,2
2020-07-02-171007,171007,0,0,0,307,0.3333333333333333,12.755732134275469,3
2020-07-03-171007,171007,1,0,0,308,0.6666666666666666,18.556040033947145,4
2020-07-04-171007,171007,0,0,0,308,0.0,26.51424726560756,5
2020-07-05-171007,171007,0,0,0,308,0.0,26.4378159210056,6
2020-07-06-171007,171007,0,0,0,308,1.1666666666666667,23.38895454585121,0
2020-07-07-171007,171007,1,0,0,309,0.5,24.95059841545202,1
2020-07-08-171007,171007,1,0,0,310,1.3333333333333333,26.176863423709605,2
2020-07-09-171007,171007,1,0,0,311,0.8333333333333334,24.66550758355414,3
2020-07-10-171007,171007,0,0,0,311,1.3333333333333333,24.829552217550372,4
2020-07-11-171007,171007,0,1,0,311,0.0,22.56908685043093,5
2020-07-12-171007,171007,0,0,0,311,0.0,18.303096471585334,6
2020-07-13-171007,171007,1,0,0,312,0.6666666666666666,18.861277065569297,0
2020-07-14-171007,171007,1,0,0,313,0.16666666666666666,21.45997101548675,1
2020-07-15-171007,171007,1,0,0,314,1.1666666666666667,17.235651394950665,2
2020-07-16-171007,171007,0,0,1,314,0.5,14.559283082663239,3
2020-07-17-171007,171007,0,0,0,314,0.3333333333333333,15.559147247214707,4
2020-07-18-171007,171007,0,0,0,314,0.0,13.585287705896633,5
2020-07-19-171007,171007,0,0,0,314,0.16666666666666666,12.090204073034045,6
2020-07-20-171007,171007,0,0,0,314,0.6666666666666666,12.237693391235844,0
2020-07-21-171007,171007,0,0,1,314,0.5,13.75537642865168,1
2020-07-22-171007,171007,0,0,0,314,0.3333333333333333,14.374526669733083,2
2020-07-23-171007,171007,0,0,2,314,0.6666666666666666,14.05548681746541,3
2020-07-24-171007,171007,0,0,0,314,1.1666666666666667,15.848414388349006,4
2020-07-25-171007,171007,0,0,0,314,0.16666666666666666,19.988382965690185,5
2020-07-26-171007,171007,0,0,0,314,0.0,19.80290978702378,6
2020-07-27-171007,171007,0,0,2,314,0.16666666666666666,16.427948703856174,0
2020-07-28-171007,171007,0,0,1,314,0.16666666666666666,16.878760439781,1
2020-07-29-171007,171007,0,0,1,314,0.6666666666666666,17.442988523442306,2
2020-07-30-171007,171007,1,0,2,315,0.8333333333333334,17.3036940755553,3
2020-07-31-171007,171007,0,0,0,315,1.3333333333333333,19.936304219172218,4
2020-08-01-171007,171007,0,0,1,315,0.0,19.560850331862603,5
2020-08-02-171007,171007,0,0,3,315,0.16666666666666666,69.77262753955432,6
2020-08-03-171007,171007,0,0,2,315,2.333333333333333,169.18336523340523,0
2020-08-04-171007,171007,1,0,1,316,0.5,145.0782446927687,1
2020-08-05-171007,171007,0,0,2,316,1.3333333333333333,128.42205321235093,2
2020-08-06-171007,171007,2,0,2,318,1.3333333333333333,103.00426612161857,3
2020-08-07-171007,171007,0,0,3,318,2.1666666666666665,76.39311220256741,4
2020-08-08-171007,171007,0,0,0,318,1.1666666666666667,63.839714362148754,5
2020-08-09-171007,171007,0,0,1,318,2.333333333333333,67.88225938577817,6
2020-08-10-171007,171007,2,0,0,320,2.6666666666666665,15.475785462281927,0
2020-08-11-171007,171007,1,0,3,321,1.8333333333333333,23.26122518880455,1
2020-08-12-171007,171007,1,0,1,322,3.0,27.727800616532882,2
2020-08-13-171007,171007,2,0,0,324,1.8333333333333333,42.42574731109658,3
2020-08-14-171007,171007,0,0,5,324,1.5,48.1298981963816,4
2020-08-15-171007,171007,1,0,4,325,0.3333333333333333,55.924438950444454,5
2020-08-16-171007,171007,3,0,2,328,4.666666666666667,55.35614934635518,6
2020-08-17-171007,171007,2,0,6,330,1.8333333333333333,68.01245728215179,0
2020-08-18-171007,171007,1,0,9,331,2.833333333333333,67.90590154125539,1
2020-08-19-171007,171007,2,0,5,333,3.8333333333333335,71.45538018843122,2
2020-08-20-171007,171007,2,0,1,335,6.5,55.2877657401597,3
2020-08-21-171007,171007,3,0,13,338,4.0,71.67054001492991,4
2020-08-22-171007,171007,0,0,6,338,4.166666666666667,85.07281859673694,5
2020-08-23-171007,171007,1,0,7,339,2.1666666666666665,91.43239194873638,6
2020-08-24-171007,171007,0,0,12,339,4.333333333333333,96.21838091184037,0
2020-08-25-171007,171007,3,0,0,342,3.6666666666666665,108.06082533069905,1
2020-08-26-171007,171007,1,0,1,343,4.166666666666667,123.28010954493261,2
2020-08-27-171007,171007,0,0,5,343,6.666666666666668,140.5389728068101,3
2020-08-28-171007,171007,5,0,4,348,4.833333333333333,146.0263278332764,4
2020-08-29-171007,171007,4,0,1,352,4.833333333333333,160.82654729969522,5
2020-08-30-171007,171007,2,0,1,354,1.5,160.26273700749823,6
2020-08-31-171007,171007,6,0,2,360,3.333333333333333,150.89028309914482,0
2020-09-01-171007,171007,9,0,2,369,2.6666666666666665,73.80027515417689,1
2020-09-02-171007,171007,5,0,6,374,3.333333333333333,238.7815305703145,2
2020-09-03-171007,171007,1,0,11,375,5.5,151.86899866812064,3
2020-09-04-171007,171007,13,0,4,388,3.1666666666666665,145.02917256230157,4
2020-09-05-171007,171007,6,0,3,394,6.5,134.40463033109376,5
2020-09-06-171007,171007,7,0,0,401,7.166666666666668,133.91252826584937,6
2020-09-07-171007,171007,12,2,1,413,9.833333333333334,146.52876073139868,0
2020-09-08-171007,171007,0,0,3,413,1.8333333333333333,175.98985596020947,1
2020-09-09-171007,171007,1,0,10,414,5.833333333333332,157.13856848080476,2
2020-09-10-171007,171007,5,0,2,419,11.833333333333336,70.45579223103887,3
2020-09-11-171007,171007,4,0,5,423,9.166666666666666,116.90924929012394,4
2020-09-12-171007,171007,1,0,1,424,3.333333333333333,150.99456092122836,5
2020-09-13-171007,171007,1,0,0,425,3.5,155.4502836339875,6
2020-09-14-171007,171007,2,0,0,427,8.5,156.3865961922321,0
2020-09-15-171007,171007,2,0,3,429,6.0,199.84260514618046,1
2020-09-16-171007,171007,6,0,1,435,10.333333333333334,237.64738681279877,2
2020-09-17-171007,171007,11,0,2,446,7.666666666666668,273.17279564571095,3
2020-09-18-171007,171007,4,0,4,450,5.666666666666668,276.6225627057991,4
2020-09-19-171007,171007,3,0,1,453,3.333333333333333,261.4917387208957,5
2020-09-20-171007,171007,0,0,1,453,2.6666666666666665,276.1463163980142,6
2020-09-21-171007,171007,1,1,0,454,4.833333333333333,224.91914480691952,0
2020-09-22-171007,171007,3,0,2,457,4.5,212.87869709373985,1
2020-09-23-171007,171007,10,1,2,467,7.833333333333332,185.5407878652095,2
2020-09-24-171007,171007,2,0,0,469,4.166666666666667,160.90772900017106,3
2020-09-25-171007,171007,5,0,0,474,7.0,160.53688503346402,4
2020-09-26-171007,171007,1,0,0,475,2.5,188.14287056491168,5
2020-09-27-171007,171007,0,0,1,475,1.5,186.22718728548517,6
2020-09-28-171007,171007,0,0,1,475,2.6666666666666665,188.28500414534278,0
2020-09-29-171007,171007,3,0,3,478,3.6666666666666665,182.17926105329974,1
2020-09-30-171007,171007,1,0,3,479,4.333333333333333,178.52352488006952,2
2020-10-01-171007,171007,2,0,3,481,3.6666666666666665,0.0,3
2020-10-02-171007,171007,4,0,4,485,7.166666666666668,206.04671923750476,4
2020-10-03-171007,171007,1,0,1,486,2.5,433.5404907741241,5
2020-10-04-171007,171007,1,1,0,487,2.0,439.8906542432277,6
2020-10-05-171007,171007,0,0,3,487,3.8333333333333335,366.5417135865325,0
2020-10-06-171007,171007,2,0,10,489,5.666666666666668,337.61099359040657,1
2020-10-07-171007,171007,2,0,12,491,5.333333333333333,295.0878404864961,2
2020-10-08-171007,171007,0,0,5,491,7.5,260.6376819322125,3
2020-10-09-171007,171007,0,0,12,491,7.5,298.3706179960344,4
2020-10-10-171007,171007,0,0,12,491,4.0,27.287261502324963,5
2020-10-11-171007,171007,1,0,2,492,1.3333333333333333,55.89771183601571,6
2020-10-12-171007,171007,1,0,18,493,2.333333333333333,65.45862581350514,0
2020-10-13-171007,171007,3,0,1,496,2.5,72.782626559381,1
2020-10-14-171007,171007,3,0,12,499,4.833333333333333,100.00582197509668,2
2020-10-15-171007,171007,3,0,13,502,5.333333333333333,142.91976690026988,3
2020-10-16-171007,171007,4,0,15,506,9.5,172.23401368110433,4
2020-10-17-171007,171007,1,0,8,507,4.333333333333333,187.65996282453006,5
2020-10-18-171007,171007,0,0,2,507,2.1666666666666665,176.47892146429217,6
2020-10-19-171007,171007,3,0,0,510,6.166666666666668,180.1178420769362,0
2020-10-20-171007,171007,10,0,4,520,6.666666666666668,233.36568359435228,1
2020-10-21-171007,171007,12,0,6,532,10.0,242.45040550667957,2
2020-10-22-171007,171007,5,0,11,537,11.333333333333336,277.8770492042232,3
2020-10-23-171007,171007,12,0,19,549,16.666666666666668,322.2237318573987,4
2020-10-24-171007,171007,12,0,3,561,4.666666666666667,384.9441023082471,5
2020-10-25-171007,171007,2,0,3,563,6.666666666666668,387.00354116762765,6
2020-10-26-171007,171007,18,0,8,581,17.333333333333332,369.95909100840413,0
2020-10-27-171007,171007,1,0,6,582,14.333333333333336,408.47937121576024,1
2020-10-28-171007,171007,12,0,11,594,13.166666666666664,411.53363006943414,2
2020-10-29-171007,171007,13,0,6,607,13.5,422.249318372777,3
2020-10-30-171007,171007,15,0,10,622,16.333333333333332,341.5421484259679,4
2020-10-31-171007,171007,8,0,0,630,9.0,399.4229571387195,5
2020-11-01-171007,171007,2,0,0,632,5.166666666666667,220.85871636253,6
2020-11-02-171007,171007,0,0,0,632,2.1666666666666665,335.274764037641,0
2020-11-03-171007,171007,4,0,0,636,11.166666666666664,249.06860355655408,1
2020-11-04-171007,171007,6,1,0,642,12.5,312.7458786895376,2
2020-11-05-171007,171007,11,0,0,653,15.0,352.7722408758548,3
2020-11-06-171007,171007,19,0,0,672,10.666666666666666,396.3594776805784,4
2020-11-07-171007,171007,3,0,0,675,13.0,432.83810491825045,5
2020-11-08-171007,171007,3,1,0,678,6.333333333333332,444.99926615498003,6
2020-11-09-171007,171007,8,1,0,686,10.333333333333334,466.99388482899764,0
2020-11-10-171007,171007,6,1,0,692,7.833333333333332,201.52371302291846,1
2020-11-11-171007,171007,11,0,0,703,13.666666666666664,243.03903748512437,2
2020-11-12-171007,171007,6,0,0,709,11.0,287.2669695743991,3
2020-11-13-171007,171007,10,0,0,719,14.666666666666664,310.005465070593,4
2020-03-01-171008,171008,0,0,0,0,0.0,0.0,6
2020-03-02-171008,171008,0,0,6,0,0.0,37.11809699891018,0
2020-03-03-171008,171008,0,0,7,0,0.3333333333333333,199.74328111712597,1
2020-03-04-171008,171008,0,2,5,0,0.5,209.96426288164866,2
2020-03-05-171008,171008,1,0,8,1,0.0,217.12149482487774,3
2020-03-06-171008,171008,0,0,11,1,0.0,191.62339624231888,4
2020-03-07-171008,171008,1,0,6,2,0.0,201.72653977521475,5
2020-03-08-171008,171008,0,0,6,2,0.16666666666666666,204.9735962412796,6
2020-03-09-171008,171008,0,0,11,2,0.3333333333333333,203.0924062747554,0
2020-03-10-171008,171008,0,0,22,2,0.16666666666666666,795.898756172035,1
2020-03-11-171008,171008,0,0,10,2,0.16666666666666666,643.5329904803382,2
2020-03-12-171008,171008,0,0,13,2,0.5,454.601125960077,3
2020-03-13-171008,171008,0,0,3,2,0.5,302.5244941757371,4
2020-03-14-171008,171008,1,0,4,3,0.16666666666666666,211.64761829584484,5
2020-03-15-171008,171008,0,0,3,3,1.5,147.1325677747823,6
2020-03-16-171008,171008,6,1,14,9,6.5,45.392381554891074,0
2020-03-17-171008,171008,7,1,10,16,9.0,93.31638048164892,1
2020-03-18-171008,171008,5,0,10,21,10.166666666666666,127.95434042165496,2
2020-03-19-171008,171008,8,0,7,29,14.333333333333336,170.8198222318892,3
2020-03-20-171008,171008,11,0,5,40,16.333333333333332,218.97922463571146,4
2020-03-21-171008,171008,6,1,3,46,3.333333333333333,273.2383008197611,5
2020-03-22-171008,171008,6,0,1,52,5.333333333333333,265.6138452285116,6
2020-03-23-171008,171008,11,0,11,63,20.666666666666668,251.21526396177194,0
2020-03-24-171008,171008,22,0,3,85,12.0,305.5160697041219,1
2020-03-25-171008,171008,10,0,6,95,14.833333333333336,323.0061410037752,2
2020-03-26-171008,171008,13,0,3,108,17.833333333333332,325.8281713507132,3
2020-03-27-171008,171008,3,0,4,111,15.833333333333336,378.7799701383992,4
2020-03-28-171008,171008,4,1,2,115,2.5,359.8055600163708,5
2020-03-29-171008,171008,3,0,3,118,2.0,360.1365990158679,6
2020-03-30-171008,171008,14,0,6,132,15.333333333333336,267.77841613732335,0
2020-03-31-171008,171008,10,0,6,142,9.5,255.24916072003023,1
2020-04-01-171008,171008,10,0,8,152,9.333333333333334,40.01077637950766,2
2020-04-02-171008,171008,7,0,5,159,9.166666666666666,158.068815778579,3
2020-04-03-171008,171008,5,0,1,164,17.5,74.069926947914,4
2020-04-04-171008,171008,3,0,0,167,2.5,122.66959571322109,5
2020-04-05-171008,171008,1,2,0,168,1.5,129.1146116762501,6
2020-04-06-171008,171008,11,0,1,179,13.0,132.25099633390155,0
2020-04-07-171008,171008,3,0,2,182,9.833333333333334,151.50023517443717,1
2020-04-08-171008,171008,6,0,1,188,11.666666666666664,178.37667206689434,2
2020-04-09-171008,171008,3,0,0,191,7.5,201.83705372907548,3
2020-04-10-171008,171008,4,0,4,195,5.0,43.298151076475406,4
2020-04-11-171008,171008,2,0,0,197,1.5,58.209801743453916,5
2020-04-12-171008,171008,3,0,0,200,2.6666666666666665,66.8104125299902,6
2020-04-13-171008,171008,6,0,3,206,7.833333333333332,75.38322144892417,0
2020-04-14-171008,171008,6,0,0,212,7.833333333333332,120.18138383828541,1
2020-04-15-171008,171008,8,0,1,220,7.833333333333332,157.31919420910629,2
2020-04-16-171008,171008,5,0,1,225,6.166666666666668,186.81115985210192,3
2020-04-17-171008,171008,1,0,1,226,5.333333333333333,178.21433255137518,4
2020-04-18-171008,171008,0,0,0,226,1.0,188.74059024710434,5
2020-04-19-171008,171008,0,0,0,226,0.8333333333333334,184.0833455334366,6
2020-04-20-171008,171008,1,0,1,227,6.833333333333332,159.1356657120624,0
2020-04-21-171008,171008,2,0,4,229,5.5,146.5128970156764,1
2020-04-22-171008,171008,1,0,2,230,4.666666666666667,136.50006959325498,2
2020-04-23-171008,171008,0,0,1,230,0.16666666666666666,135.05701085955184,3
2020-04-24-171008,171008,4,0,3,234,4.0,109.05491916671505,4
2020-04-25-171008,171008,0,0,0,234,0.16666666666666666,122.82415919164151,5
2020-04-26-171008,171008,0,1,0,234,1.3333333333333333,122.85775407859214,6
2020-04-27-171008,171008,3,1,2,237,5.166666666666667,93.13523914134669,0
2020-04-28-171008,171008,0,0,1,237,3.333333333333333,93.41169821082153,1
2020-04-29-171008,171008,1,0,0,238,3.6666666666666665,85.55971377879494,2
2020-04-30-171008,171008,1,0,2,239,4.666666666666667,139.1710187387411,3
2020-05-01-171008,171008,1,0,2,240,1.0,207.48874182227672,4
2020-05-02-171008,171008,0,0,0,240,0.6666666666666666,66.54674501979329,5
2020-05-03-171008,171008,0,0,0,240,0.16666666666666666,60.45200062198385,6
2020-05-04-171008,171008,1,0,1,241,4.5,41.72835815410531,0
2020-05-05-171008,171008,4,0,0,245,4.166666666666667,57.53187250912603,1
2020-05-06-171008,171008,2,0,5,247,4.666666666666667,71.28386634708154,2
2020-05-07-171008,171008,1,0,2,248,3.333333333333333,84.2178840954448,3
2020-05-08-171008,171008,3,0,1,251,5.666666666666668,95.32444634185488,4
2020-05-09-171008,171008,0,0,0,251,0.6666666666666666,123.86739820030655,5
2020-05-10-171008,171008,0,0,0,251,0.6666666666666666,221.7662359130225,6
2020-05-11-171008,171008,2,0,4,253,4.333333333333333,209.88669274352907,0
2020-05-12-171008,171008,1,1,2,254,3.1666666666666665,222.45339429782402,1
2020-05-13-171008,171008,0,0,2,254,1.8333333333333333,186.09363916906122,2
2020-05-14-171008,171008,2,0,0,256,3.8333333333333335,131.8751584932611,3
2020-05-15-171008,171008,2,1,4,258,2.333333333333333,103.57823550156726,4
2020-05-16-171008,171008,0,0,0,258,0.5,85.66817517801434,5
2020-05-17-171008,171008,0,0,0,258,0.0,87.57025209776347,6
2020-05-18-171008,171008,1,0,2,259,4.333333333333333,87.10379348668259,0
2020-05-19-171008,171008,0,0,3,259,3.0,85.32068843385824,1
2020-05-20-171008,171008,5,0,3,264,4.5,77.21461615223562,2
2020-05-21-171008,171008,2,0,2,266,2.5,82.05237135979388,3
2020-05-22-171008,171008,1,0,0,267,2.0,77.33322152650247,4
2020-05-23-171008,171008,0,0,0,267,0.5,85.93253068994736,5
2020-05-24-171008,171008,0,0,0,267,0.0,92.03465021170892,6
2020-05-25-171008,171008,4,0,0,271,2.6666666666666665,72.52301378213033,0
2020-05-26-171008,171008,2,0,1,273,1.5,80.89824668561486,1
2020-05-27-171008,171008,2,2,1,275,2.6666666666666665,93.5905338639261,2
2020-05-28-171008,171008,0,0,0,275,2.0,87.6646028602756,3
2020-05-29-171008,171008,4,0,0,279,1.6666666666666667,85.6854224272315,4
2020-05-30-171008,171008,0,0,0,279,0.0,83.84782533306428,5
2020-05-31-171008,171008,0,0,0,279,0.0,85.56465569969275,6
2020-06-01-171008,171008,2,0,2,281,2.333333333333333,160.05553449470924,0
2020-06-02-171008,171008,3,0,1,284,2.0,58.94866139893005,1
2020-06-03-171008,171008,3,0,1,287,2.333333333333333,47.29771792084533,2
2020-06-04-171008,171008,2,0,0,289,2.6666666666666665,55.23334823984868,3
2020-06-05-171008,171008,0,0,1,289,1.6666666666666667,61.656783439163945,4
2020-06-06-171008,171008,0,0,0,289,0.16666666666666666,60.86891951232526,5
2020-06-07-171008,171008,0,2,0,289,0.0,60.54337615579999,6
2020-06-08-171008,171008,0,0,1,289,1.1666666666666667,59.49765470824198,0
2020-06-09-171008,171008,1,0,0,290,1.0,56.27565706946169,1
2020-06-10-171008,171008,1,1,0,291,2.6666666666666665,183.89804669982158,2
2020-06-11-171008,171008,0,0,0,291,2.6666666666666665,157.39704924929546,3
2020-06-12-171008,171008,0,0,0,291,1.1666666666666667,136.66182323434728,4
2020-06-13-171008,171008,0,1,0,291,0.16666666666666666,114.40440970549024,5
2020-06-14-171008,171008,0,0,0,291,0.0,85.80539105629542,6
2020-06-15-171008,171008,2,0,1,293,2.0,52.816538858021985,0
2020-06-16-171008,171008,1,0,0,294,1.3333333333333333,63.47592839633932,1
2020-06-17-171008,171008,1,0,2,295,1.6666666666666667,63.62988665184906,2
2020-06-18-171008,171008,0,0,0,295,2.0,62.87707330141546,3
2020-06-19-171008,171008,1,0,0,296,1.3333333333333333,62.05887716592363,4
2020-06-20-171008,171008,0,0,0,296,0.16666666666666666,79.25159881806451,5
2020-06-21-171008,171008,0,0,0,296,0.0,79.78312433553492,6
2020-06-22-171008,171008,1,0,0,297,0.5,66.43992499286706,0
2020-06-23-171008,171008,0,0,1,297,1.1666666666666667,54.189944225655374,1
2020-06-24-171008,171008,0,0,0,297,0.8333333333333334,53.605049765033726,2
2020-06-25-171008,171008,0,1,0,297,0.5,48.29803307680666,3
2020-06-26-171008,171008,0,0,0,297,1.5,44.7669356466534,4
2020-06-27-171008,171008,0,0,0,297,0.16666666666666666,40.94755149546159,5
2020-06-28-171008,171008,0,0,0,297,0.16666666666666666,40.79207099021711,6
2020-06-29-171008,171008,1,0,0,298,1.3333333333333333,41.453104412556534,0
2020-06-30-171008,171008,0,0,0,298,0.8333333333333334,53.624805622598885,1
2020-07-01-171008,171008,2,0,0,300,0.5,51.155182739474405,2
2020-07-02-171008,171008,0,0,0,300,0.5,21.783916125672782,3
2020-07-03-171008,171008,0,1,0,300,0.8333333333333334,30.4527744895387,4
2020-07-04-171008,171008,0,0,0,300,0.16666666666666666,42.49962924792675,5
2020-07-05-171008,171008,0,0,0,300,0.0,42.67424527050814,6
2020-07-06-171008,171008,0,1,0,300,0.8333333333333334,37.49411407869358,0
2020-07-07-171008,171008,1,0,2,301,0.8333333333333334,39.38849473977376,1
2020-07-08-171008,171008,0,0,0,301,1.1666666666666667,41.23688046950207,2
2020-07-09-171008,171008,0,0,0,301,1.0,39.72672336405,3
2020-07-10-171008,171008,0,0,0,301,1.3333333333333333,46.66355543855849,4
2020-07-11-171008,171008,0,0,0,301,0.16666666666666666,42.86302286327071,5
2020-07-12-171008,171008,0,0,0,301,0.16666666666666666,35.92730897174113,6
2020-07-13-171008,171008,0,0,1,301,1.1666666666666667,37.91972760456289,0
2020-07-14-171008,171008,0,1,2,301,0.8333333333333334,41.98639494738359,1
2020-07-15-171008,171008,0,0,1,301,1.1666666666666667,34.89813341802793,2
2020-07-16-171008,171008,0,0,0,301,1.0,29.802915072120435,3
2020-07-17-171008,171008,0,0,1,301,1.1666666666666667,30.306528492496998,4
2020-07-18-171008,171008,0,1,0,301,0.0,27.404317702559013,5
2020-07-19-171008,171008,0,0,0,301,0.0,22.844070299807385,6
2020-07-20-171008,171008,0,0,0,301,0.8333333333333334,21.602009795694094,0
2020-07-21-171008,171008,2,0,0,303,0.5,23.535693081808738,1
2020-07-22-171008,171008,0,0,1,303,0.8333333333333334,24.603919693516858,2
2020-07-23-171008,171008,0,0,1,303,1.1666666666666667,25.045683545855564,3
2020-07-24-171008,171008,0,0,3,303,0.8333333333333334,27.032292585215963,4
2020-07-25-171008,171008,0,0,0,303,0.16666666666666666,33.32156309934364,5
2020-07-26-171008,171008,0,0,0,303,0.0,33.107136640846505,6
2020-07-27-171008,171008,1,0,1,304,1.0,28.235978288411705,0
2020-07-28-171008,171008,2,0,4,306,0.5,29.526526456767286,1
2020-07-29-171008,171008,1,0,0,307,0.6666666666666666,30.20903498369431,2
2020-07-30-171008,171008,0,0,5,307,1.6666666666666667,29.114555029420067,3
2020-07-31-171008,171008,1,0,2,308,1.5,33.54880186492313,4
2020-08-01-171008,171008,0,0,4,308,0.16666666666666666,31.78853191364329,5
2020-08-02-171008,171008,0,0,2,308,0.6666666666666666,126.62689735620683,6
2020-08-03-171008,171008,0,0,3,308,2.1666666666666665,308.5795622311138,0
2020-08-04-171008,171008,0,0,2,308,0.6666666666666666,258.72702803414364,1
2020-08-05-171008,171008,1,0,5,309,3.1666666666666665,225.8405917445071,2
2020-08-06-171008,171008,1,0,11,310,1.8333333333333333,177.93503181059546,3
2020-08-07-171008,171008,3,0,6,313,3.5,125.96101867343526,4
2020-08-08-171008,171008,0,0,1,313,2.0,108.87968143294184,5
2020-08-09-171008,171008,0,0,12,313,2.333333333333333,117.82784389624108,6
2020-08-10-171008,171008,1,0,4,314,2.1666666666666665,26.17896682277776,0
2020-08-11-171008,171008,4,0,8,318,2.5,39.63778534927167,1
2020-08-12-171008,171008,0,0,17,318,2.833333333333333,47.89905808119329,2
2020-08-13-171008,171008,5,0,0,323,4.0,68.45424214287019,3
2020-08-14-171008,171008,2,0,13,325,2.333333333333333,79.89907620580946,4
2020-08-15-171008,171008,4,0,2,329,0.3333333333333333,93.17853813175891,5
2020-08-16-171008,171008,2,0,6,331,5.333333333333333,91.94718019335633,6
2020-08-17-171008,171008,3,0,2,334,4.0,110.34487869834754,0
2020-08-18-171008,171008,2,0,1,336,2.6666666666666665,110.59994792805998,1
2020-08-19-171008,171008,5,0,1,341,3.5,116.97273967947247,2
2020-08-20-171008,171008,11,0,1,352,7.166666666666668,95.44098591181083,3
2020-08-21-171008,171008,6,0,2,358,5.333333333333333,120.96337522344623,4
2020-08-22-171008,171008,1,0,4,359,5.0,142.5267162525118,5
2020-08-23-171008,171008,12,0,9,371,1.1666666666666667,150.2023340008291,6
2020-08-24-171008,171008,4,0,1,375,3.5,154.89359956426603,0
2020-08-25-171008,171008,8,0,16,383,8.0,179.21811974243832,1
2020-08-26-171008,171008,17,0,5,400,5.166666666666667,207.9322119272804,2
2020-08-27-171008,171008,0,0,4,400,9.333333333333334,240.1512745612984,3
2020-08-28-171008,171008,13,0,6,413,6.666666666666668,252.514645867968,4
2020-08-29-171008,171008,2,0,9,415,2.833333333333333,285.71419390895187,5
2020-08-30-171008,171008,6,0,2,421,1.1666666666666667,282.5229865280084,6
2020-08-31-171008,171008,2,0,3,423,3.5,260.85649029043174,0
2020-09-01-171008,171008,1,0,13,424,4.166666666666667,124.31455302971877,1
2020-09-02-171008,171008,1,0,12,425,5.0,382.38150540768,2
2020-09-03-171008,171008,1,0,6,426,2.5,254.91651826629015,3
2020-09-04-171008,171008,2,0,13,428,4.166666666666667,253.31878910673618,4
2020-09-05-171008,171008,4,0,10,432,3.6666666666666665,231.10804388555908,5
2020-09-06-171008,171008,9,0,4,441,4.0,224.61140708687415,6
2020-09-07-171008,171008,1,0,15,442,10.0,243.0841670553836,0
2020-09-08-171008,171008,16,0,6,458,1.0,283.64820951694287,1
2020-09-09-171008,171008,5,0,17,463,7.5,255.41911033636563,2
2020-09-10-171008,171008,4,0,1,467,11.833333333333336,116.43651164805608,3
2020-09-11-171008,171008,6,0,5,473,9.5,188.4375126970395,4
2020-09-12-171008,171008,9,0,2,482,2.0,244.4222621453613,5
2020-09-13-171008,171008,2,0,1,484,3.1666666666666665,250.807550908799,6
2020-09-14-171008,171008,3,0,2,487,10.166666666666666,253.5962507937441,0
2020-09-15-171008,171008,13,0,5,500,8.5,317.3755252843796,1
2020-09-16-171008,171008,12,0,9,512,13.0,377.51942651707384,2
2020-09-17-171008,171008,6,0,3,518,8.833333333333334,428.9203060227734,3
2020-09-18-171008,171008,13,0,9,531,7.833333333333332,432.8225539754685,4
2020-09-19-171008,171008,10,0,0,541,3.0,409.4663980731535,5
2020-09-20-171008,171008,4,1,7,545,2.6666666666666665,441.5560994613812,6
2020-09-21-171008,171008,15,0,3,560,6.0,366.9286711487098,0
2020-09-22-171008,171008,6,1,0,566,3.0,353.1532928647335,1
2020-09-23-171008,171008,17,0,6,583,7.333333333333332,313.86113147967285,2
2020-09-24-171008,171008,1,0,3,584,6.5,275.3681427643495,3
2020-09-25-171008,171008,5,0,11,589,8.5,269.80501230830106,4
2020-09-26-171008,171008,2,0,5,591,2.833333333333333,319.36158371078966,5
2020-09-27-171008,171008,1,0,4,592,1.5,313.8376406170896,6
2020-09-28-171008,171008,2,0,2,594,4.833333333333333,312.65784721156524,0
2020-09-29-171008,171008,5,0,3,599,4.666666666666667,295.86698363300087,1
2020-09-30-171008,171008,9,0,10,608,5.333333333333333,288.06701075369233,2
2020-10-01-171008,171008,3,1,1,611,4.0,0.0,3
2020-10-02-171008,171008,9,0,12,620,7.833333333333332,319.5129457604754,4
2020-10-03-171008,171008,0,0,3,620,1.8333333333333333,655.5486201025778,5
2020-10-04-171008,171008,7,0,2,627,3.6666666666666665,669.335078549176,6
2020-10-05-171008,171008,3,0,5,630,4.833333333333333,553.3170401657572,0
2020-10-06-171008,171008,0,0,13,630,7.0,506.38438872985694,1
2020-10-07-171008,171008,6,0,8,636,4.0,446.2513337994362,2
2020-10-08-171008,171008,3,0,13,639,4.833333333333333,390.62565537553155,3
2020-10-09-171008,171008,11,0,19,650,7.333333333333332,442.9220128798768,4
2020-10-10-171008,171008,5,0,0,655,4.333333333333333,42.23942038013387,5
2020-10-11-171008,171008,4,0,12,659,2.0,78.6573460186584,6
2020-10-12-171008,171008,2,0,7,661,2.6666666666666665,91.69768684126933,0
2020-10-13-171008,171008,3,0,12,664,5.5,102.87358879213261,1
2020-10-14-171008,171008,10,0,12,674,8.333333333333334,144.35622092082255,2
2020-10-15-171008,171008,1,0,11,675,6.833333333333332,205.81820602993997,3
2020-10-16-171008,171008,12,0,7,687,10.0,251.55362825996747,4
2020-10-17-171008,171008,3,0,6,690,5.333333333333333,275.88602404696377,5
2020-10-18-171008,171008,2,0,7,692,1.3333333333333333,265.3063403725791,6
2020-10-19-171008,171008,5,0,4,697,6.166666666666668,272.89961141013487,0
2020-10-20-171008,171008,13,0,16,710,11.166666666666664,361.7842505841829,1
2020-10-21-171008,171008,8,0,9,718,9.666666666666666,385.0431048999865,2
2020-10-22-171008,171008,13,0,9,731,13.5,441.0532934503053,3
2020-10-23-171008,171008,19,0,14,750,21.83333333333333,515.7860828362388,4
2020-10-24-171008,171008,0,1,22,750,4.0,618.3540276134052,5
2020-10-25-171008,171008,12,0,7,762,4.666666666666667,629.7066761673516,6
2020-10-26-171008,171008,7,0,10,769,20.5,600.4181235829703,0
2020-10-27-171008,171008,12,0,13,781,10.666666666666666,667.3971306775961,1
2020-10-28-171008,171008,12,0,6,793,19.33333333333333,677.1252386464768,2
2020-10-29-171008,171008,11,0,18,804,16.5,707.5395664824367,3
2020-10-30-171008,171008,7,1,11,811,22.83333333333333,581.975106010543,4
2020-10-31-171008,171008,6,0,0,817,8.5,695.6125653493058,5
2020-11-01-171008,171008,7,0,0,824,5.333333333333333,379.8060170219674,6
2020-11-02-171008,171008,4,0,0,828,2.333333333333333,573.0392014115193,0
2020-11-03-171008,171008,16,0,0,844,19.5,450.2325541740791,1
2020-11-04-171008,171008,9,1,0,853,16.5,572.2003001971984,2
2020-11-05-171008,171008,9,0,0,862,18.0,628.2689514896256,3
2020-11-06-171008,171008,14,0,0,876,17.0,700.6242122469241,4
2020-11-07-171008,171008,22,0,0,898,10.666666666666666,763.8396109201574,5
2020-11-08-171008,171008,7,1,0,905,5.833333333333332,761.5877642751744,6
2020-11-09-171008,171008,10,1,0,915,13.166666666666664,784.0876885432363,0
2020-11-10-171008,171008,13,0,0,928,11.5,338.8060581010961,1
2020-11-11-171008,171008,6,0,0,934,15.0,400.4069970782298,2
2020-11-12-171008,171008,18,0,0,952,11.666666666666664,464.08423973305156,3
2020-11-13-171008,171008,11,0,0,963,13.5,495.14157833884417,4
2020-03-01-171009,171009,0,0,0,0,0.0,0.0,6
2020-03-02-171009,171009,0,0,5,0,0.0,27.572048340130568,0
2020-03-03-171009,171009,0,0,5,0,0.4,161.44493155479768,1
2020-03-04-171009,171009,0,0,15,0,0.6,166.80230363628573,2
2020-03-05-171009,171009,0,0,12,0,0.2,174.69487688575296,3
2020-03-06-171009,171009,0,0,18,0,0.2,156.32448501280055,4
2020-03-07-171009,171009,0,0,7,0,0.2,162.39742853205567,5
2020-03-08-171009,171009,0,0,3,0,0.2,164.90766342164727,6
2020-03-09-171009,171009,0,0,30,0,0.2,161.2762485129748,0
2020-03-10-171009,171009,0,0,10,0,0.0,677.6218365318531,1
2020-03-11-171009,171009,0,0,13,0,0.4,550.6166261779965,2
2020-03-12-171009,171009,0,0,16,0,0.6,392.3457421241351,3
2020-03-13-171009,171009,1,0,18,1,0.4,267.39910754918077,4
2020-03-14-171009,171009,0,0,5,1,0.2,173.900807998005,5
2020-03-15-171009,171009,0,0,4,1,0.4,113.64591455820681,6
2020-03-16-171009,171009,5,0,11,6,4.0,34.01188423515435,0
2020-03-17-171009,171009,5,0,7,11,6.6,70.48135988228779,1
2020-03-18-171009,171009,15,0,6,26,8.8,91.90373971888583,2
2020-03-19-171009,171009,12,0,8,38,14.4,118.08402336358584,3
2020-03-20-171009,171009,18,0,10,56,13.8,146.39729060340073,4
2020-03-21-171009,171009,7,0,2,63,3.6,181.91305675585266,5
2020-03-22-171009,171009,3,0,1,66,5.4,178.70978102741225,6
2020-03-23-171009,171009,30,0,10,96,17.6,169.9157974079749,0
2020-03-24-171009,171009,10,0,10,106,14.2,209.5158508544984,1
2020-03-25-171009,171009,13,0,17,119,15.4,221.25898807887057,2
2020-03-26-171009,171009,16,0,3,135,13.8,222.85472110367394,3
2020-03-27-171009,171009,18,0,5,153,11.2,259.5250918591339,4
2020-03-28-171009,171009,5,0,0,158,3.0,242.1936855997745,5
2020-03-29-171009,171009,4,0,1,162,2.0,239.6738188853651,6
2020-03-30-171009,171009,11,0,8,173,13.0,175.2929244123581,0
2020-03-31-171009,171009,7,0,8,180,8.4,163.83177258908023,1
2020-04-01-171009,171009,6,0,5,186,7.2,25.73250096652789,2
2020-04-02-171009,171009,8,0,12,194,6.6,102.69363374972659,3
2020-04-03-171009,171009,10,0,5,204,7.4,49.31072566187234,4
2020-04-04-171009,171009,2,0,2,206,2.0,76.20434015754049,5
2020-04-05-171009,171009,1,0,1,207,1.2,79.81964773409176,6
2020-04-06-171009,171009,10,0,8,217,8.2,82.70489877288219,0
2020-04-07-171009,171009,10,0,5,227,7.4,92.63465832855701,1
2020-04-08-171009,171009,17,3,4,244,7.8,111.8883439169395,2
2020-04-09-171009,171009,3,1,0,247,7.4,127.1446651873049,3
2020-04-10-171009,171009,5,1,5,252,3.4,27.97502210953088,4
2020-04-11-171009,171009,0,0,0,252,1.2,35.56115211196726,5
2020-04-12-171009,171009,1,0,3,253,2.4,40.503479258854654,6
2020-04-13-171009,171009,8,0,4,261,10.2,44.53900998822546,0
2020-04-14-171009,171009,8,0,3,269,13.0,75.3158419809085,1
2020-04-15-171009,171009,5,0,2,274,5.6,99.8853238650983,2
2020-04-16-171009,171009,12,0,2,286,3.6,115.78979036094822,3
2020-04-17-171009,171009,5,0,2,291,2.6,108.39448779482925,4
2020-04-18-171009,171009,2,0,0,293,0.6,119.63660089058357,5
2020-04-19-171009,171009,1,0,0,294,0.6,116.21886281221843,6
2020-04-20-171009,171009,8,0,4,302,4.0,97.10143703396105,0
2020-04-21-171009,171009,5,0,6,307,5.2,88.92503221057815,1
2020-04-22-171009,171009,4,0,5,311,3.2,83.28150449778082,2
2020-04-23-171009,171009,0,0,2,311,0.0,83.89175908068249,3
2020-04-24-171009,171009,5,0,7,316,3.6,66.05263403744527,4
2020-04-25-171009,171009,0,0,1,316,0.4,74.43800486896518,5
2020-04-26-171009,171009,3,0,0,319,0.4,74.41554516407132,6
2020-04-27-171009,171009,4,1,6,323,4.6,59.037159230562466,0
2020-04-28-171009,171009,3,3,3,326,1.6,60.27565288106106,1
2020-04-29-171009,171009,2,0,0,328,2.8,55.54508097306146,2
2020-04-30-171009,171009,2,0,5,330,1.8,87.41318475564063,3
2020-05-01-171009,171009,2,0,4,332,0.4,130.5137975337077,4
2020-05-02-171009,171009,0,0,1,332,0.8,41.877413032271804,5
2020-05-03-171009,171009,0,0,0,332,0.4,39.085174172608376,6
2020-05-04-171009,171009,4,0,7,336,2.4,26.19449426987698,0
2020-05-05-171009,171009,6,0,2,342,2.8,35.90863539682472,1
2020-05-06-171009,171009,5,0,6,347,3.4,46.55598631988866,2
2020-05-07-171009,171009,2,0,3,349,2.6,54.0325955366288,3
2020-05-08-171009,171009,7,0,4,356,4.0,59.07411901407828,4
2020-05-09-171009,171009,1,0,0,357,0.0,77.66342473506043,5
2020-05-10-171009,171009,0,0,0,357,0.2,144.2468624313882,6
2020-05-11-171009,171009,6,0,3,363,3.0,137.39439894504423,0
2020-05-12-171009,171009,3,0,3,366,2.6,145.45441197710997,1
2020-05-13-171009,171009,0,0,5,366,0.4,123.19588466530263,2
2020-05-14-171009,171009,5,0,3,371,2.6,87.2965079525627,3
2020-05-15-171009,171009,4,2,2,375,2.6,67.11998399736454,4
2020-05-16-171009,171009,1,0,0,376,0.8,53.16071215310685,5
2020-05-17-171009,171009,0,0,0,376,0.0,55.83257896086042,6
2020-05-18-171009,171009,7,0,4,383,3.0,55.78849026419763,0
2020-05-19-171009,171009,2,1,1,385,2.6,55.510847281352355,1
2020-05-20-171009,171009,6,1,2,391,2.6,51.70023088678184,2
2020-05-21-171009,171009,3,0,7,394,2.2,54.69887248003864,3
2020-05-22-171009,171009,4,0,1,398,1.4,52.54348405884427,4
2020-05-23-171009,171009,0,0,0,398,1.2,57.35366184378127,5
2020-05-24-171009,171009,0,0,0,398,0.0,61.95258447368518,6
2020-05-25-171009,171009,3,0,1,401,2.8,48.5980923762434,0
2020-05-26-171009,171009,3,0,4,404,2.2,53.57765791774301,1
2020-05-27-171009,171009,5,0,3,409,1.2,61.48332079582337,2
2020-05-28-171009,171009,3,0,2,412,1.2,58.88943767248758,3
2020-05-29-171009,171009,2,0,2,414,2.6,56.7820170462483,4
2020-05-30-171009,171009,0,0,0,414,0.0,55.702037942857274,5
2020-05-31-171009,171009,0,0,0,414,0.0,57.41614172561609,6
2020-06-01-171009,171009,4,0,2,418,1.2,105.84931188120578,0
2020-06-02-171009,171009,1,0,2,419,2.2,40.03382196163143,1
2020-06-03-171009,171009,2,0,3,421,2.0,32.847333445523624,2
2020-06-04-171009,171009,7,0,8,428,2.0,39.88756037915421,3
2020-06-05-171009,171009,1,0,1,429,1.6,43.95144841426168,4
2020-06-06-171009,171009,0,0,0,429,0.0,40.879559271737335,5
2020-06-07-171009,171009,0,0,0,429,0.0,40.770087986340414,6
2020-06-08-171009,171009,1,0,1,430,0.8,40.45980772756326,0
2020-06-09-171009,171009,4,0,1,434,0.8,37.50253900350568,1
2020-06-10-171009,171009,3,0,2,437,1.4,122.34662181419462,2
2020-06-11-171009,171009,2,0,2,439,1.4,104.2134652158698,3
2020-06-12-171009,171009,2,0,1,441,0.4,88.04572120412453,4
2020-06-13-171009,171009,0,0,0,441,0.2,73.54877734860304,5
2020-06-14-171009,171009,0,0,0,441,0.0,55.15238990631788,6
2020-06-15-171009,171009,2,0,1,443,1.6,33.260624055992864,0
2020-06-16-171009,171009,2,0,1,445,2.8,41.42627577349197,1
2020-06-17-171009,171009,3,0,0,448,1.6,42.19884894956087,2
2020-06-18-171009,171009,8,0,0,456,0.6,43.59550900475516,3
2020-06-19-171009,171009,1,0,1,457,0.6,43.53086365127956,4
2020-06-20-171009,171009,0,0,0,457,0.0,55.12534817951313,5
2020-06-21-171009,171009,0,0,0,457,0.0,55.980689230891784,6
2020-06-22-171009,171009,1,0,1,458,0.4,46.53782200343166,0
2020-06-23-171009,171009,1,0,1,459,0.4,36.75057893469856,1
2020-06-24-171009,171009,2,0,3,461,0.2,36.48106559119346,2
2020-06-25-171009,171009,2,1,3,463,0.0,33.05510871931984,3
2020-06-26-171009,171009,1,1,2,464,1.2,31.884331675463613,4
2020-06-27-171009,171009,0,0,0,464,0.0,29.494536279256305,5
2020-06-28-171009,171009,0,0,0,464,0.0,29.392481744169658,6
2020-06-29-171009,171009,1,0,2,465,1.8,29.779565964642252,0
2020-06-30-171009,171009,1,0,0,466,0.8,41.18541294187123,1
2020-07-01-171009,171009,0,0,5,466,0.4,35.12827048053329,2
2020-07-02-171009,171009,0,0,1,466,0.4,14.769613983679395,3
2020-07-03-171009,171009,1,0,2,467,0.6,21.349126928908763,4
2020-07-04-171009,171009,0,0,0,467,0.0,30.698178618082995,5
2020-07-05-171009,171009,0,0,0,467,0.0,30.62523650983855,6
2020-07-06-171009,171009,1,0,0,468,0.6,27.170899509103823,0
2020-07-07-171009,171009,1,0,0,469,0.8,28.876988831543077,1
2020-07-08-171009,171009,3,0,1,472,1.4,30.300910852501545,2
2020-07-09-171009,171009,3,0,1,475,0.4,28.577208685202336,3
2020-07-10-171009,171009,2,0,0,477,0.6,28.590524817876116,4
2020-07-11-171009,171009,0,0,0,477,0.0,26.100426194023377,5
2020-07-12-171009,171009,0,0,0,477,0.0,21.301198873067882,6
2020-07-13-171009,171009,2,0,0,479,1.0,22.022164251979945,0
2020-07-14-171009,171009,0,0,0,479,0.8,25.017036336785885,1
2020-07-15-171009,171009,5,0,1,484,0.6,20.228208100733006,2
2020-07-16-171009,171009,1,0,0,485,0.6,17.169476252837406,3
2020-07-17-171009,171009,2,0,2,487,0.2,18.307344794976295,4
2020-07-18-171009,171009,0,0,0,487,0.0,15.96057853917728,5
2020-07-19-171009,171009,0,0,1,487,0.0,14.08938931812479,6
2020-07-20-171009,171009,0,0,8,487,0.8,14.222497892219108,0
2020-07-21-171009,171009,0,0,0,487,0.6,15.975243051681172,1
2020-07-22-171009,171009,1,0,2,488,0.4,16.69027937486357,2
2020-07-23-171009,171009,1,0,1,489,0.6,16.29216686887564,3
2020-07-24-171009,171009,0,0,6,489,1.2,18.343909607139295,4
2020-07-25-171009,171009,0,0,1,489,0.0,23.045564046500786,5
2020-07-26-171009,171009,0,0,5,489,0.0,22.813485847790787,6
2020-07-27-171009,171009,0,0,3,489,0.8,18.871843992235295,0
2020-07-28-171009,171009,0,0,6,489,0.8,19.281813806476453,1
2020-07-29-171009,171009,1,0,3,490,0.6,20.01702821725384,2
2020-07-30-171009,171009,0,0,3,490,1.4,19.81405287262576,3
2020-07-31-171009,171009,2,0,6,492,1.0,23.051331092767963,4
2020-08-01-171009,171009,0,0,0,492,0.0,22.567846131294438,5
2020-08-02-171009,171009,1,0,11,493,0.2,81.63182094333925,6
2020-08-03-171009,171009,8,0,1,501,0.8,198.8343561299909,0
2020-08-04-171009,171009,0,0,2,501,0.4,169.95315655100796,1
2020-08-05-171009,171009,2,0,4,503,3.0,150.21317165343623,2
2020-08-06-171009,171009,1,0,8,504,2.0,120.7435797935612,3
2020-08-07-171009,171009,6,0,6,510,2.8,89.33080045501175,4
2020-08-08-171009,171009,1,0,7,511,1.6,74.58688664117793,5
2020-08-09-171009,171009,5,0,3,516,1.8,79.33311968352808,6
2020-08-10-171009,171009,3,0,3,519,2.2,17.963979480964074,0
2020-08-11-171009,171009,6,0,6,525,1.4,27.093675411081414,1
2020-08-12-171009,171009,3,0,6,528,3.6,32.24875168425793,2
2020-08-13-171009,171009,3,0,3,531,4.0,49.482064344481586,3
2020-08-14-171009,171009,6,0,6,537,1.2,56.04808889622232,4
2020-08-15-171009,171009,0,0,2,537,1.4,65.0386312232666,5
2020-08-16-171009,171009,11,0,0,548,4.2,64.29876242285395,6
2020-08-17-171009,171009,1,0,1,549,1.8,78.92759707863536,0
2020-08-18-171009,171009,2,0,3,551,2.0,78.92507854401953,1
2020-08-19-171009,171009,4,0,2,555,2.6,82.83574128024225,2
2020-08-20-171009,171009,8,0,0,563,8.4,64.12122181496892,3
2020-08-21-171009,171009,6,0,3,569,4.8,83.22931238316262,4
2020-08-22-171009,171009,7,1,10,576,3.6,98.78806019286002,5
2020-08-23-171009,171009,3,0,10,579,3.6,106.03692334371652,6
2020-08-24-171009,171009,3,0,15,582,3.0,111.48408402240636,0
2020-08-25-171009,171009,6,0,0,588,3.6,125.7493347848847,1
2020-08-26-171009,171009,6,0,5,594,5.4,143.75465108965284,2
2020-08-27-171009,171009,3,0,9,597,6.0,164.10442212156343,3
2020-08-28-171009,171009,6,0,11,603,6.6,170.06034461089104,4
2020-08-29-171009,171009,2,1,4,605,3.8,187.8586168807766,5
2020-08-30-171009,171009,0,0,3,605,2.8,187.27738161886182,6
2020-08-31-171009,171009,1,0,9,606,2.6,175.9427497615721,0
2020-09-01-171009,171009,3,0,6,609,4.2,86.38795720487636,1
2020-09-02-171009,171009,2,0,14,611,3.6,277.36211848188015,2
2020-09-03-171009,171009,0,0,2,611,5.0,175.47338155956012,3
2020-09-04-171009,171009,3,0,6,614,5.6,167.89164781539003,4
2020-09-05-171009,171009,10,0,2,624,3.0,155.30424710397185,5
2020-09-06-171009,171009,10,0,2,634,5.0,154.3355462121744,6
2020-09-07-171009,171009,15,0,6,649,8.8,169.02929014761747,0
2020-09-08-171009,171009,0,0,3,649,4.0,203.33549229781937,1
2020-09-09-171009,171009,5,0,13,654,6.2,181.8781621802866,2
2020-09-10-171009,171009,9,0,1,663,9.8,82.55067884625129,3
2020-09-11-171009,171009,11,0,7,674,7.6,136.9342750282987,4
2020-09-12-171009,171009,4,0,4,678,3.0,176.62467632553646,5
2020-09-13-171009,171009,3,0,1,681,2.4,181.68938060125785,6
2020-09-14-171009,171009,9,0,5,690,8.8,182.69575123908123,0
2020-09-15-171009,171009,6,0,2,696,7.6,233.0645425962117,1
2020-09-16-171009,171009,14,0,4,710,13.0,276.99236423281644,2
2020-09-17-171009,171009,2,0,3,712,10.4,318.53858874404875,3
2020-09-18-171009,171009,6,0,9,718,8.2,321.9957940346378,4
2020-09-19-171009,171009,2,0,0,720,4.0,304.48291576957456,5
2020-09-20-171009,171009,2,1,2,722,3.0,321.7998632715098,6
2020-09-21-171009,171009,6,0,2,728,6.6,262.4147943278458,0
2020-09-22-171009,171009,3,0,5,731,3.8,248.0498196559308,1
2020-09-23-171009,171009,13,2,3,744,9.4,215.78810790473267,2
2020-09-24-171009,171009,1,1,8,745,4.8,186.83840497129532,3
2020-09-25-171009,171009,7,1,7,752,7.4,186.21069374863265,4
2020-09-26-171009,171009,4,0,3,756,2.8,218.4012720663692,5
2020-09-27-171009,171009,1,0,3,757,1.4,216.35251967564201,6
2020-09-28-171009,171009,5,0,5,762,1.8,218.3164214919688,0
2020-09-29-171009,171009,2,0,3,764,5.0,211.0005006280647,1
2020-09-30-171009,171009,4,0,11,768,5.6,206.66835857573986,2
2020-10-01-171009,171009,3,0,11,771,3.6,0.0,3
2020-10-02-171009,171009,9,1,19,780,8.6,237.56438946800716,4
2020-10-03-171009,171009,0,0,7,780,2.2,500.63073841221103,5
2020-10-04-171009,171009,2,0,4,782,3.2,507.5606472661211,6
2020-10-05-171009,171009,2,0,6,784,3.4,422.90004697704256,0
2020-10-06-171009,171009,5,0,13,789,4.2,389.92148824571245,1
2020-10-07-171009,171009,3,0,9,792,5.0,341.1446276709504,2
2020-10-08-171009,171009,8,0,11,800,5.8,301.56844276064635,3
2020-10-09-171009,171009,7,0,21,807,8.6,344.79812520712966,4
2020-10-10-171009,171009,3,0,2,810,5.0,31.644439469817986,5
2020-10-11-171009,171009,3,0,9,813,2.0,64.74103224273904,6
2020-10-12-171009,171009,5,0,31,818,1.6,75.86073762003389,0
2020-10-13-171009,171009,3,0,12,821,3.6,84.32154765835189,1
2020-10-14-171009,171009,11,0,23,832,6.8,115.49872950555768,2
2020-10-15-171009,171009,11,0,21,843,3.6,165.2389222773827,3
2020-10-16-171009,171009,19,0,13,862,8.4,199.07043230168833,4
2020-10-17-171009,171009,7,0,10,869,3.6,216.90528706311022,5
2020-10-18-171009,171009,4,0,6,873,1.4,203.76320975170398,6
2020-10-19-171009,171009,6,0,2,879,4.6,207.92961670814879,0
2020-10-20-171009,171009,13,0,15,892,8.4,270.94855689091224,1
2020-10-21-171009,171009,9,1,13,901,10.6,281.85777523288436,2
2020-10-22-171009,171009,11,0,19,912,11.4,323.322294938034,3
2020-10-23-171009,171009,21,0,15,933,17.0,376.1912925623485,4
2020-10-24-171009,171009,2,0,11,935,5.8,449.62243753514326,5
2020-10-25-171009,171009,9,1,4,944,6.8,451.43271570204604,6
2020-10-26-171009,171009,31,0,8,975,13.6,431.8131264945431,0
2020-10-27-171009,171009,12,0,8,987,10.8,476.52799884853874,1
2020-10-28-171009,171009,23,1,15,1010,14.6,479.55540532027504,2
2020-10-29-171009,171009,21,0,13,1031,14.0,491.8653495592112,3
2020-10-30-171009,171009,13,1,12,1044,15.8,396.38107441077676,4
2020-10-31-171009,171009,10,0,0,1054,9.6,464.16048965922766,5
2020-11-01-171009,171009,6,0,0,1060,5.4,256.011257632078,6
2020-11-02-171009,171009,2,0,0,1062,2.6,390.6634616193898,0
2020-11-03-171009,171009,15,1,0,1077,12.4,290.28456905843325,1
2020-11-04-171009,171009,13,1,0,1090,11.8,365.4854119778613,2
2020-11-05-171009,171009,19,0,0,1109,13.4,412.21032508270537,3
2020-11-06-171009,171009,15,1,0,1124,15.6,463.0200895577466,4
2020-11-07-171009,171009,11,1,0,1135,14.2,506.31265666191155,5
2020-11-08-171009,171009,4,2,0,1139,8.0,521.3350125208547,6
2020-11-09-171009,171009,8,0,0,1147,10.8,547.1218220219146,0
2020-11-10-171009,171009,8,2,0,1155,10.6,233.8154135769155,1
2020-11-11-171009,171009,15,0,0,1170,11.4,281.79398277168946,2
2020-11-12-171009,171009,13,0,0,1183,10.6,333.1001253809602,3
2020-11-13-171009,171009,12,0,0,1195,15.4,359.2268126631814,4
2020-03-01-171010,171010,0,0,1,0,0.0,0.0,6
2020-03-02-171010,171010,0,0,4,0,0.0,10.854134110204935,0
2020-03-03-171010,171010,0,1,11,0,0.0,62.34923161559004,1
2020-03-04-171010,171010,2,0,10,2,0.0,64.67832008799265,2
2020-03-05-171010,171010,0,2,12,2,0.16666666666666666,67.56014599191938,3
2020-03-06-171010,171010,0,0,12,2,0.16666666666666666,60.28477674468894,4
2020-03-07-171010,171010,0,0,3,2,0.16666666666666666,62.81967765935199,5
2020-03-08-171010,171010,1,0,7,3,0.0,63.8130710025148,6
2020-03-09-171010,171010,0,0,18,3,0.16666666666666666,62.59591631294931,0
2020-03-10-171010,171010,0,0,18,3,0.16666666666666666,258.8688465701373,1
2020-03-11-171010,171010,1,0,20,4,0.0,210.12036305900148,2
2020-03-12-171010,171010,0,0,15,4,0.16666666666666666,149.4461359367192,3
2020-03-13-171010,171010,0,0,19,4,1.1666666666666667,101.33020491018692,4
2020-03-14-171010,171010,0,0,3,4,0.5,66.94608272557996,5
2020-03-15-171010,171010,1,0,2,5,0.6666666666666666,44.357626163246444,6
2020-03-16-171010,171010,4,1,17,9,5.833333333333332,13.373595345377094,0
2020-03-17-171010,171010,11,0,13,20,7.5,27.642006764679167,1
2020-03-18-171010,171010,10,0,9,30,9.5,36.45417726611319,2
2020-03-19-171010,171010,12,0,12,42,11.333333333333336,47.26171063368335,3
2020-03-20-171010,171010,12,1,9,54,14.0,59.048111826447666,4
2020-03-21-171010,171010,3,0,4,57,3.5,73.41442619776916,5
2020-03-22-171010,171010,7,0,2,64,6.333333333333332,71.92526843679603,6
2020-03-23-171010,171010,18,0,13,82,23.66666666666667,68.29245875008638,0
2020-03-24-171010,171010,18,0,7,100,17.5,83.91626932949123,1
2020-03-25-171010,171010,20,0,10,120,17.166666666666668,88.64680869911963,2
2020-03-26-171010,171010,15,0,11,135,18.0,89.32180690886072,3
2020-03-27-171010,171010,19,0,4,154,14.333333333333336,103.96971317561005,4
2020-03-28-171010,171010,3,0,2,157,3.333333333333333,97.46678544770576,5
2020-03-29-171010,171010,2,0,2,159,2.6666666666666665,96.73609690048019,6
2020-03-30-171010,171010,17,0,5,176,19.33333333333333,71.05527997239417,0
2020-03-31-171010,171010,13,0,6,189,9.333333333333334,66.75713829586044,1
2020-04-01-171010,171010,9,0,6,198,8.5,10.477167990262195,2
2020-04-02-171010,171010,12,0,7,210,9.833333333333334,41.740686072376704,3
2020-04-03-171010,171010,9,0,2,219,11.333333333333336,19.896449381270184,4
2020-04-04-171010,171010,4,0,1,223,2.5,31.302511505185194,5
2020-04-05-171010,171010,2,1,1,225,1.3333333333333333,32.831852985283234,6
2020-04-06-171010,171010,13,0,6,238,13.666666666666664,33.91510292797348,0
2020-04-07-171010,171010,7,3,11,245,9.166666666666666,38.2225979486424,1
2020-04-08-171010,171010,10,0,5,255,9.333333333333334,45.85714644855815,2
2020-04-09-171010,171010,11,0,0,266,6.0,52.045462812386376,3
2020-04-10-171010,171010,4,0,2,270,5.166666666666667,11.36937182072566,4
2020-04-11-171010,171010,2,0,0,272,2.6666666666666665,14.671655709690151,5
2020-04-12-171010,171010,2,0,1,274,2.333333333333333,16.74873932466109,6
2020-04-13-171010,171010,5,0,3,279,15.166666666666664,18.549594203733253,0
2020-04-14-171010,171010,6,0,2,285,11.5,30.90113474665069,1
2020-04-15-171010,171010,6,0,0,291,9.833333333333334,40.83696527258295,2
2020-04-16-171010,171010,7,0,4,298,5.5,47.64325237244559,3
2020-04-17-171010,171010,2,0,1,300,4.0,44.84435196848973,4
2020-04-18-171010,171010,1,0,1,301,1.1666666666666667,48.94854174725724,5
2020-04-19-171010,171010,1,0,0,302,0.6666666666666666,47.598803150729786,6
2020-04-20-171010,171010,6,0,0,308,5.666666666666668,40.10450623857144,0
2020-04-21-171010,171010,11,0,2,319,4.833333333333333,36.776114704546615,1
2020-04-22-171010,171010,5,1,6,324,4.166666666666667,34.393168328944796,2
2020-04-23-171010,171010,0,0,3,324,0.16666666666666666,34.47990594970944,3
2020-04-24-171010,171010,2,0,6,326,5.5,27.335548691989278,4
2020-04-25-171010,171010,0,0,0,326,0.16666666666666666,30.80041178286764,5
2020-04-26-171010,171010,1,0,1,327,0.8333333333333334,30.797097895775668,6
2020-04-27-171010,171010,3,0,3,330,4.666666666666667,24.133938401558,0
2020-04-28-171010,171010,2,0,4,332,2.1666666666666665,24.522922685406847,1
2020-04-29-171010,171010,0,0,0,332,4.666666666666667,22.56285583820198,2
2020-04-30-171010,171010,4,0,3,336,4.666666666666667,35.80917569819613,3
2020-05-01-171010,171010,1,0,2,337,0.6666666666666666,53.47554902274288,4
2020-05-02-171010,171010,1,0,0,338,0.5,17.15075952817682,5
2020-05-03-171010,171010,0,0,0,338,0.16666666666666666,15.898311300944197,6
2020-05-04-171010,171010,0,0,4,338,5.166666666666667,10.739735521467928,0
2020-05-05-171010,171010,2,0,7,340,4.833333333333333,14.743368235877831,1
2020-05-06-171010,171010,6,0,4,346,4.166666666666667,18.889774351975618,2
2020-05-07-171010,171010,3,0,1,349,3.5,22.028779914494827,3
2020-05-08-171010,171010,6,0,0,355,6.166666666666668,24.30684177264472,4
2020-05-09-171010,171010,0,0,1,355,0.3333333333333333,31.862357119154048,5
2020-05-10-171010,171010,1,0,0,356,0.3333333333333333,58.59999676756142,6
2020-05-11-171010,171010,3,0,1,359,4.666666666666667,55.724105113629555,0
2020-05-12-171010,171010,4,0,0,363,2.0,59.01868559792258,1
2020-05-13-171010,171010,0,0,2,363,0.5,49.830166088604244,2
2020-05-14-171010,171010,3,0,2,366,3.8333333333333335,35.302589941745744,3
2020-05-15-171010,171010,2,0,2,368,2.833333333333333,27.303690589828072,4
2020-05-16-171010,171010,0,0,0,368,0.16666666666666666,21.87699479636106,5
2020-05-17-171010,171010,0,0,0,368,0.0,22.81011092426676,6
2020-05-18-171010,171010,4,0,1,372,4.166666666666667,22.766219586664167,0
2020-05-19-171010,171010,7,0,1,379,2.1666666666666665,22.55532576712359,1
2020-05-20-171010,171010,4,0,2,383,3.6666666666666665,20.85558153781122,2
2020-05-21-171010,171010,1,0,3,384,2.833333333333333,22.08832714841461,3
2020-05-22-171010,171010,0,0,3,384,2.333333333333333,21.11494906738516,4
2020-05-23-171010,171010,1,0,0,385,0.6666666666666666,23.158527947673434,5
2020-05-24-171010,171010,0,0,0,385,0.0,24.96117406780386,6
2020-05-25-171010,171010,1,2,1,386,3.1666666666666665,19.603998908910615,0
2020-05-26-171010,171010,0,0,2,386,2.6666666666666665,21.68063544529689,1
2020-05-27-171010,171010,2,0,1,388,2.5,24.93888723970788,2
2020-05-28-171010,171010,2,0,5,390,1.3333333333333333,23.75724369747202,3
2020-05-29-171010,171010,2,0,1,392,2.0,22.99059641949532,4
2020-05-30-171010,171010,0,0,0,392,0.0,22.545345125860905,5
2020-05-31-171010,171010,0,0,0,392,0.0,23.18259378284538,6
2020-06-01-171010,171010,1,0,2,393,3.0,42.89310303253927,0
2020-06-02-171010,171010,1,0,0,394,2.333333333333333,16.10163717293991,1
2020-06-03-171010,171010,2,0,2,396,2.5,13.143730312302104,2
2020-06-04-171010,171010,3,0,0,399,3.1666666666666665,15.804610149724674,3
2020-06-05-171010,171010,3,0,0,402,2.333333333333333,17.47287828653594,4
2020-06-06-171010,171010,0,2,0,402,0.3333333333333333,16.499140165824514,5
2020-06-07-171010,171010,0,0,0,402,0.0,16.44436347009468,6
2020-06-08-171010,171010,1,0,1,403,1.5,16.27954841298414,0
2020-06-09-171010,171010,2,0,0,405,1.8333333333333333,15.173289555128983,1
2020-06-10-171010,171010,1,0,0,406,1.6666666666666667,49.50924621931258,2
2020-06-11-171010,171010,5,0,0,411,1.0,42.22643229643929,3
2020-06-12-171010,171010,1,0,1,412,1.1666666666666667,35.92852674900364,4
2020-06-13-171010,171010,0,0,0,412,0.3333333333333333,30.031037104376427,5
2020-06-14-171010,171010,0,0,0,412,0.0,22.524685212159245,6
2020-06-15-171010,171010,2,4,1,414,1.0,13.654698373984878,0
2020-06-16-171010,171010,0,0,0,414,2.333333333333333,16.846074925801524,1
2020-06-17-171010,171010,2,0,0,416,1.5,17.085425419685947,2
2020-06-18-171010,171010,0,0,0,416,2.333333333333333,17.455268072099393,3
2020-06-19-171010,171010,0,0,1,416,1.1666666666666667,17.38190950403939,4
2020-06-20-171010,171010,0,0,0,416,0.0,22.05747751173893,5
2020-06-21-171010,171010,0,0,0,416,0.0,22.34963526091861,6
2020-06-22-171010,171010,1,0,0,417,0.8333333333333334,18.58873667575797,0
2020-06-23-171010,171010,0,0,1,417,1.1666666666666667,14.802106173750563,1
2020-06-24-171010,171010,0,0,3,417,0.8333333333333334,14.681967984994266,2
2020-06-25-171010,171010,0,0,0,417,1.1666666666666667,13.287281642739277,3
2020-06-26-171010,171010,1,0,0,418,2.1666666666666665,12.694927922868734,4
2020-06-27-171010,171010,0,0,0,418,0.0,11.709955677845747,5
2020-06-28-171010,171010,0,0,0,418,0.16666666666666666,11.669090541401303,6
2020-06-29-171010,171010,1,0,2,419,0.8333333333333334,11.83136209757454,0
2020-06-30-171010,171010,0,0,3,419,0.3333333333333333,16.102409772554076,1
2020-07-01-171010,171010,0,0,0,419,0.8333333333333334,14.11767326391726,2
2020-07-02-171010,171010,0,0,2,419,0.16666666666666666,5.94812537605104,3
2020-07-03-171010,171010,1,0,1,420,0.8333333333333334,8.530040527506884,4
2020-07-04-171010,171010,0,0,0,420,0.16666666666666666,12.171939506728958,5
2020-07-05-171010,171010,0,0,0,420,0.16666666666666666,12.161954951651285,6
2020-07-06-171010,171010,0,0,3,420,0.6666666666666666,10.764246716062633,0
2020-07-07-171010,171010,1,0,1,421,0.5,11.407904956307025,1
2020-07-08-171010,171010,3,0,1,424,1.1666666666666667,11.962892168825455,2
2020-07-09-171010,171010,0,0,1,424,1.1666666666666667,11.340455533998723,3
2020-07-10-171010,171010,0,0,1,424,1.6666666666666667,11.838199918238201,4
2020-07-11-171010,171010,0,0,0,424,0.16666666666666666,10.821151755774963,5
2020-07-12-171010,171010,0,0,0,424,0.0,8.89310094951855,6
2020-07-13-171010,171010,2,0,2,426,0.6666666666666666,9.24732407089244,0
2020-07-14-171010,171010,3,0,1,429,0.3333333333333333,10.428831790832929,1
2020-07-15-171010,171010,0,0,1,429,1.5,8.496507039385232,2
2020-07-16-171010,171010,2,0,3,431,1.0,7.2233091736720905,3
2020-07-17-171010,171010,1,0,1,432,0.3333333333333333,7.60043886726149,4
2020-07-18-171010,171010,0,0,0,432,0.0,6.6941337106896315,5
2020-07-19-171010,171010,0,0,1,432,0.0,5.816180099722448,6
2020-07-20-171010,171010,3,0,0,435,0.16666666666666666,5.770931047481284,0
2020-07-21-171010,171010,1,0,0,436,0.8333333333333334,6.43045582960834,1
2020-07-22-171010,171010,1,0,10,437,1.3333333333333333,6.718612507141183,2
2020-07-23-171010,171010,1,0,4,438,1.0,6.632136974862139,3
2020-07-24-171010,171010,1,0,5,439,1.6666666666666667,7.3860004098089655,4
2020-07-25-171010,171010,0,0,2,439,0.0,9.236230459743572,5
2020-07-26-171010,171010,0,0,1,439,0.0,9.151227663569925,6
2020-07-27-171010,171010,2,0,3,441,0.6666666666666666,7.630063515847269,0
2020-07-28-171010,171010,1,0,2,442,0.6666666666666666,7.84430466672716,1
2020-07-29-171010,171010,1,0,6,443,0.8333333333333334,8.113014120834656,2
2020-07-30-171010,171010,3,0,8,446,1.3333333333333333,7.97486839982041,3
2020-07-31-171010,171010,1,0,1,447,1.3333333333333333,9.252142461737513,4
2020-08-01-171010,171010,0,0,2,447,0.16666666666666666,8.986735666494068,5
2020-08-02-171010,171010,1,0,4,448,0.3333333333333333,33.32057234867585,6
2020-08-03-171010,171010,0,0,2,448,1.8333333333333333,81.15883769800409,0
2020-08-04-171010,171010,0,0,6,448,0.6666666666666666,69.0291658693249,1
2020-08-05-171010,171010,10,0,3,458,1.6666666666666667,60.813786132491146,2
2020-08-06-171010,171010,4,0,9,462,1.0,48.62359320628828,3
2020-08-07-171010,171010,5,0,7,467,2.1666666666666665,35.57593305607313,4
2020-08-08-171010,171010,2,1,1,469,0.6666666666666666,29.960930198195946,5
2020-08-09-171010,171010,1,0,0,470,1.0,32.00486094987312,6
2020-08-10-171010,171010,3,0,2,473,2.0,7.211985777410332,0
2020-08-11-171010,171010,2,0,1,475,3.0,10.887223545643545,1
2020-08-12-171010,171010,6,0,2,481,1.0,13.008503158171788,2
2020-08-13-171010,171010,8,0,3,489,4.166666666666667,19.60524617488234,3
2020-08-14-171010,171010,1,0,3,490,2.833333333333333,22.373498587424926,4
2020-08-15-171010,171010,2,0,1,492,1.6666666666666667,25.999683539026925,5
2020-08-16-171010,171010,4,0,0,496,4.0,25.69469835078047,6
2020-08-17-171010,171010,2,0,2,498,4.333333333333333,31.362960309727946,0
2020-08-18-171010,171010,6,0,7,504,2.0,31.38137592815849,1
2020-08-19-171010,171010,3,0,5,507,4.5,33.00450784666994,2
2020-08-20-171010,171010,9,0,2,516,6.833333333333332,25.896526300117525,3
2020-08-21-171010,171010,7,0,3,523,4.0,33.40623775785451,4
2020-08-22-171010,171010,1,0,1,524,3.8333333333333335,39.577296493656675,5
2020-08-23-171010,171010,0,0,4,524,4.166666666666667,42.290538352420256,6
2020-08-24-171010,171010,2,0,13,526,4.0,44.25133160541591,0
2020-08-25-171010,171010,1,0,1,527,7.333333333333332,50.221273778700315,1
2020-08-26-171010,171010,2,0,10,529,8.333333333333334,57.61791729171292,2
2020-08-27-171010,171010,3,0,9,532,8.666666666666666,65.97359782815039,3
2020-08-28-171010,171010,3,0,8,535,10.333333333333334,68.63178133683553,4
2020-08-29-171010,171010,1,0,2,536,2.833333333333333,76.28042821192155,5
2020-08-30-171010,171010,0,0,2,536,3.333333333333333,75.88153787487943,6
2020-08-31-171010,171010,2,0,8,538,3.6666666666666665,70.97478369431849,0
2020-09-01-171010,171010,7,0,6,545,3.1666666666666665,34.57511055080151,1
2020-09-02-171010,171010,5,0,17,550,4.166666666666667,109.8613817674133,2
2020-09-03-171010,171010,2,0,8,552,5.666666666666668,70.4558943044508,3
2020-09-04-171010,171010,3,0,9,555,4.5,68.0806285720079,4
2020-09-05-171010,171010,1,0,0,556,5.333333333333333,62.756753376922916,5
2020-09-06-171010,171010,4,0,11,560,5.166666666666667,62.017538085212976,6
2020-09-07-171010,171010,13,0,5,573,10.166666666666666,67.71019345209118,0
2020-09-08-171010,171010,1,0,3,574,3.1666666666666665,80.82530730524425,1
2020-09-09-171010,171010,10,0,9,584,6.5,72.40161176424122,2
2020-09-10-171010,171010,9,0,7,593,7.333333333333332,32.87278051416989,3
2020-09-11-171010,171010,8,0,5,601,9.833333333333334,54.19608526132158,4
2020-09-12-171010,171010,2,0,5,603,3.5,70.00867632207365,5
2020-09-13-171010,171010,2,0,4,605,3.1666666666666665,71.98006600762835,6
2020-09-14-171010,171010,8,0,2,613,8.5,72.47662437752211,0
2020-09-15-171010,171010,6,0,7,619,7.666666666666668,92.04091903809004,1
2020-09-16-171010,171010,17,0,6,636,10.333333333333334,109.42708587940535,2
2020-09-17-171010,171010,8,0,3,644,5.333333333333333,125.4764144553958,3
2020-09-18-171010,171010,9,0,8,653,7.0,126.80686974019375,4
2020-09-19-171010,171010,0,0,5,653,3.8333333333333335,119.92410462810746,5
2020-09-20-171010,171010,11,1,1,664,1.8333333333333333,127.34442783910171,6
2020-09-21-171010,171010,5,0,8,669,8.333333333333334,104.31816254020433,0
2020-09-22-171010,171010,3,0,6,672,3.0,99.0615024533177,1
2020-09-23-171010,171010,9,0,3,681,9.333333333333334,86.65412995412906,2
2020-09-24-171010,171010,7,0,6,688,4.166666666666667,75.28261413768197,3
2020-09-25-171010,171010,5,2,13,693,9.166666666666666,74.70754831301446,4
2020-09-26-171010,171010,5,0,8,698,2.833333333333333,87.83496653791059,5
2020-09-27-171010,171010,4,0,1,702,1.0,86.83949942978103,6
2020-09-28-171010,171010,2,0,2,704,4.666666666666667,87.35541803952957,0
2020-09-29-171010,171010,7,0,4,711,5.166666666666667,83.99381130525421,1
2020-09-30-171010,171010,6,0,10,717,5.833333333333332,82.16247528221321,2
2020-10-01-171010,171010,3,0,7,720,3.5,0.0,3
2020-10-02-171010,171010,8,0,13,728,8.166666666666666,93.63177839986719,4
2020-10-03-171010,171010,5,1,6,733,1.5,196.0397405160605,5
2020-10-04-171010,171010,1,0,1,734,4.833333333333333,199.08165562985226,6
2020-10-05-171010,171010,8,0,4,742,4.333333333333333,165.5768447579199,0
2020-10-06-171010,171010,6,1,4,748,5.833333333333332,152.40901696732843,1
2020-10-07-171010,171010,3,1,5,751,6.166666666666668,133.55639743371108,2
2020-10-08-171010,171010,6,0,8,757,5.666666666666668,117.78694079888052,3
2020-10-09-171010,171010,13,0,24,770,7.166666666666668,134.4227682253817,4
2020-10-10-171010,171010,8,0,1,778,3.1666666666666665,12.453456898802568,5
2020-10-11-171010,171010,1,0,8,779,1.8333333333333333,24.925660976232727,6
2020-10-12-171010,171010,2,0,18,781,2.333333333333333,29.1720025342146,0
2020-10-13-171010,171010,4,0,11,785,5.333333333333333,32.486108669404246,1
2020-10-14-171010,171010,10,0,20,795,7.166666666666668,44.7512926040593,2
2020-10-15-171010,171010,7,0,14,802,6.666666666666668,63.96936327850756,3
2020-10-16-171010,171010,13,0,15,815,9.0,77.32460025573783,4
2020-10-17-171010,171010,6,0,11,821,5.166666666666667,84.36103447747402,5
2020-10-18-171010,171010,1,0,6,822,1.5,79.6820761163579,6
2020-10-19-171010,171010,4,0,2,826,7.0,81.45503865667308,0
2020-10-20-171010,171010,4,0,15,830,10.166666666666666,106.5691956164399,1
2020-10-21-171010,171010,5,0,13,835,10.666666666666666,111.44942109628721,2
2020-10-22-171010,171010,8,0,11,843,13.0,127.78698212237272,3
2020-10-23-171010,171010,24,0,21,867,20.33333333333333,148.8332413893002,4
2020-10-24-171010,171010,1,0,13,868,5.5,178.02568755106643,5
2020-10-25-171010,171010,8,0,8,876,5.166666666666667,179.34073639591168,6
2020-10-26-171010,171010,18,0,14,894,17.333333333333332,171.38860762964478,0
2020-10-27-171010,171010,11,0,14,905,13.333333333333336,189.47942501136117,1
2020-10-28-171010,171010,20,1,6,925,20.0,191.0897775922549,2
2020-10-29-171010,171010,14,0,11,939,18.33333333333333,196.91319817507448,3
2020-10-30-171010,171010,15,0,16,954,21.0,159.54465445510874,4
2020-10-31-171010,171010,11,1,0,965,9.5,187.7728984401503,5
2020-11-01-171010,171010,6,0,0,971,5.166666666666667,103.30478974843825,6
2020-11-02-171010,171010,2,1,0,973,3.333333333333333,157.16443524718315,0
2020-11-03-171010,171010,15,1,0,988,19.33333333333333,118.47150245418872,1
2020-11-04-171010,171010,13,0,0,1001,15.0,149.5158453131728,2
2020-11-05-171010,171010,11,1,0,1012,18.83333333333333,167.42862348969794,3
2020-11-06-171010,171010,21,2,0,1033,14.666666666666664,187.73195229707073,4
2020-11-07-171010,171010,13,0,0,1046,11.0,205.0994345891998,5
2020-11-08-171010,171010,8,0,0,1054,5.0,209.39985088797326,6
2020-11-09-171010,171010,14,0,0,1068,13.0,218.67485879331588,0
2020-11-10-171010,171010,14,1,0,1082,12.5,93.77898292989394,1
2020-11-11-171010,171010,6,1,0,1088,14.333333333333336,112.47985923469501,2
2020-11-12-171010,171010,11,0,0,1099,15.0,132.30363981629722,3
2020-11-13-171010,171010,16,0,0,1115,14.166666666666664,142.30586369792036,4
2020-03-01-171011,171011,0,0,2,0,0.0,0.0,6
2020-03-02-171011,171011,0,0,4,0,0.2,3.7654220253993627,0
2020-03-03-171011,171011,0,0,8,0,0.0,21.444393439740644,1
2020-03-04-171011,171011,0,0,4,0,0.2,21.631276276117624,2
2020-03-05-171011,171011,0,0,6,0,0.0,22.534506672649478,3
2020-03-06-171011,171011,0,0,7,0,0.2,20.147974650136604,4
2020-03-07-171011,171011,0,0,6,0,0.0,20.86166538025242,5
2020-03-08-171011,171011,0,0,1,0,0.0,21.200957403694176,6
2020-03-09-171011,171011,0,0,16,0,0.4,20.85251931326807,0
2020-03-10-171011,171011,1,0,8,1,0.8,82.24514662500242,1
2020-03-11-171011,171011,0,0,13,1,1.6,66.10133743796618,2
2020-03-12-171011,171011,0,0,12,1,0.8,46.89724025132846,3
2020-03-13-171011,171011,1,0,6,2,2.8,31.663485185861372,4
2020-03-14-171011,171011,0,0,2,2,2.0,21.71517691820103,5
2020-03-15-171011,171011,2,0,3,4,2.4,15.10337052746923,6
2020-03-16-171011,171011,4,0,10,8,6.4,4.8684203556209535,0
2020-03-17-171011,171011,8,0,7,16,6.6,9.66131592181019,1
2020-03-18-171011,171011,4,0,4,20,14.0,12.283706432508238,2
2020-03-19-171011,171011,6,0,4,26,19.2,15.95333919982763,3
2020-03-20-171011,171011,7,0,4,33,15.4,19.43204161750064,4
2020-03-21-171011,171011,6,0,3,39,4.0,23.25440051844208,5
2020-03-22-171011,171011,1,0,1,40,4.6,22.728647310322767,6
2020-03-23-171011,171011,16,0,9,56,26.2,21.408639393018177,0
2020-03-24-171011,171011,8,0,94,64,18.6,26.942155811816477,1
2020-03-25-171011,171011,13,0,17,77,20.2,28.664742963268306,2
2020-03-26-171011,171011,12,0,4,89,17.2,29.129587664392066,3
2020-03-27-171011,171011,6,0,10,95,17.0,33.78391714092965,4
2020-03-28-171011,171011,2,0,0,97,5.0,32.21641802711812,5
2020-03-29-171011,171011,3,0,1,100,4.4,32.2599225688993,6
2020-03-30-171011,171011,10,0,18,110,17.0,23.611541175302428,0
2020-03-31-171011,171011,7,0,1,117,7.8,22.277172888704893,1
2020-04-01-171011,171011,4,0,6,121,7.6,3.259030014847838,2
2020-04-02-171011,171011,4,0,4,125,8.0,16.090087902816624,3
2020-04-03-171011,171011,4,0,0,129,6.8,5.985551203380431,4
2020-04-04-171011,171011,3,0,0,132,3.4,9.093905580170558,5
2020-04-05-171011,171011,1,0,0,133,2.0,9.602967890031204,6
2020-04-06-171011,171011,9,0,3,142,8.4,10.04836504875069,0
2020-04-07-171011,171011,94,0,4,236,9.6,11.535267625341884,1
2020-04-08-171011,171011,17,0,4,253,8.4,14.802614276875316,2
2020-04-09-171011,171011,4,0,0,257,6.4,16.675188036478602,3
2020-04-10-171011,171011,10,0,5,267,4.4,3.1882150251928074,4
2020-04-11-171011,171011,0,0,0,267,2.2,4.145971414722419,5
2020-04-12-171011,171011,1,0,0,268,3.2,4.896230942374436,6
2020-04-13-171011,171011,18,0,2,286,46.2,5.5184364756868645,0
2020-04-14-171011,171011,1,0,2,287,13.4,12.318353891605723,1
2020-04-15-171011,171011,6,0,0,293,7.6,15.448876804544275,2
2020-04-16-171011,171011,4,0,1,297,4.4,17.453169576988763,3
2020-04-17-171011,171011,0,0,0,297,5.0,17.049503291142326,4
2020-04-18-171011,171011,0,0,0,297,1.2,18.414723086321644,5
2020-04-19-171011,171011,0,0,0,297,0.6,18.026289517180263,6
2020-04-20-171011,171011,3,0,4,300,6.2,12.773733733456377,0
2020-04-21-171011,171011,4,1,2,304,5.2,11.592658676595148,1
2020-04-22-171011,171011,4,0,2,308,4.8,10.919090691182388,2
2020-04-23-171011,171011,0,0,1,308,0.4,11.017661461231032,3
2020-04-24-171011,171011,5,0,5,313,3.8,8.722366923712332,4
2020-04-25-171011,171011,0,0,0,313,0.2,9.757586945711086,5
2020-04-26-171011,171011,0,0,0,313,0.0,9.720962025427689,6
2020-04-27-171011,171011,2,0,3,315,3.6,7.438954940393699,0
2020-04-28-171011,171011,2,0,3,317,1.8,7.3110033672542105,1
2020-04-29-171011,171011,0,0,1,317,3.0,6.619174944792354,2
2020-04-30-171011,171011,1,0,1,318,3.8,10.039448699038573,3
2020-05-01-171011,171011,0,0,7,318,0.4,17.223265489184524,4
2020-05-02-171011,171011,0,0,0,318,0.8,5.2974928778590105,5
2020-05-03-171011,171011,0,0,0,318,0.4,4.705454544651022,6
2020-05-04-171011,171011,4,0,2,322,3.4,3.2407091546573836,0
2020-05-05-171011,171011,2,0,1,324,3.8,4.366836061347728,1
2020-05-06-171011,171011,2,0,2,326,4.6,5.7300752667860495,2
2020-05-07-171011,171011,1,0,2,327,4.2,6.779902798456227,3
2020-05-08-171011,171011,5,0,1,332,6.4,7.3671524525016805,4
2020-05-09-171011,171011,0,0,0,332,0.4,9.940478890205704,5
2020-05-10-171011,171011,0,0,0,332,0.6,18.685653293977317,6
2020-05-11-171011,171011,3,0,1,335,6.2,17.748637234519947,0
2020-05-12-171011,171011,3,0,3,338,3.4,18.772065644000342,1
2020-05-13-171011,171011,1,0,2,339,0.8,16.033463383798573,2
2020-05-14-171011,171011,1,0,2,340,2.8,10.93257564761474,3
2020-05-15-171011,171011,7,0,2,347,3.8,8.617295011000508,4
2020-05-16-171011,171011,0,0,1,347,0.6,6.759691398520681,5
2020-05-17-171011,171011,0,0,0,347,0.6,6.985501832869332,6
2020-05-18-171011,171011,2,0,3,349,4.0,7.021300895824211,0
2020-05-19-171011,171011,1,0,3,350,1.2,7.006220369072255,1
2020-05-20-171011,171011,2,0,1,352,2.2,6.508009824655982,2
2020-05-21-171011,171011,2,0,2,354,2.2,6.740481547578378,3
2020-05-22-171011,171011,1,1,1,355,1.8,6.58988132320879,4
2020-05-23-171011,171011,0,0,1,355,1.4,7.246852307389066,5
2020-05-24-171011,171011,0,0,0,355,0.0,7.821692767841072,6
2020-05-25-171011,171011,1,0,1,356,3.6,6.076069654958509,0
2020-05-26-171011,171011,3,0,0,359,3.8,6.503956633517859,1
2020-05-27-171011,171011,2,0,2,361,1.0,7.526724513888312,2
2020-05-28-171011,171011,2,1,5,363,1.6,7.237243853927145,3
2020-05-29-171011,171011,2,0,0,365,2.0,6.879150560665752,4
2020-05-30-171011,171011,1,0,0,366,0.2,6.769603707092979,5
2020-05-31-171011,171011,0,0,0,366,0.2,6.9900387275723235,6
2020-06-01-171011,171011,3,0,4,369,1.2,13.548219318674835,0
2020-06-02-171011,171011,3,0,1,372,2.4,5.010594852936231,1
2020-06-03-171011,171011,1,0,1,373,1.2,4.173554809968101,2
2020-06-04-171011,171011,2,0,1,375,2.2,4.808560188536954,3
2020-06-05-171011,171011,1,4,3,376,2.2,5.319165973986049,4
2020-06-06-171011,171011,1,0,0,377,0.0,5.122109802737849,5
2020-06-07-171011,171011,0,4,0,377,0.0,5.152529306695363,6
2020-06-08-171011,171011,1,0,2,378,2.2,5.093719784883216,0
2020-06-09-171011,171011,0,0,2,378,0.8,4.82249542231764,1
2020-06-10-171011,171011,2,0,3,380,1.0,15.699931578386774,2
2020-06-11-171011,171011,5,0,1,385,0.6,13.4580325880129,3
2020-06-12-171011,171011,0,0,0,385,1.6,11.471968439173605,4
2020-06-13-171011,171011,0,0,0,385,0.4,9.538928623004246,5
2020-06-14-171011,171011,0,0,0,385,0.2,7.228128202009537,6
2020-06-15-171011,171011,4,9,1,389,1.0,4.295083930096414,0
2020-06-16-171011,171011,1,1,1,390,2.8,5.2138414060981155,1
2020-06-17-171011,171011,1,0,0,391,1.8,5.329585852228064,2
2020-06-18-171011,171011,1,0,0,392,1.0,5.562713209519664,3
2020-06-19-171011,171011,3,1,1,395,1.4,5.680647803133547,4
2020-06-20-171011,171011,0,0,0,395,0.0,6.993529770114481,5
2020-06-21-171011,171011,0,0,0,395,0.0,7.03481565582754,6
2020-06-22-171011,171011,2,0,3,397,0.6,5.951011883343006,0
2020-06-23-171011,171011,2,0,0,399,1.6,4.711145969979878,1
2020-06-24-171011,171011,3,0,2,402,1.0,4.74073156287646,2
2020-06-25-171011,171011,1,0,1,403,0.4,4.335560912772618,3
2020-06-26-171011,171011,0,0,2,403,2.0,4.265869307815159,4
2020-06-27-171011,171011,0,0,0,403,0.0,3.9933794378265928,5
2020-06-28-171011,171011,0,0,0,403,0.2,4.016157712284958,6
2020-06-29-171011,171011,1,0,0,404,3.4,4.119003606153067,0
2020-06-30-171011,171011,1,0,0,405,0.6,5.370421005228319,1
2020-07-01-171011,171011,0,0,0,405,0.0,4.838967986037879,2
2020-07-02-171011,171011,0,0,1,405,0.4,1.9196657059244464,3
2020-07-03-171011,171011,1,0,0,406,1.0,2.84928158723689,4
2020-07-04-171011,171011,0,0,0,406,0.0,3.9056970160630113,5
2020-07-05-171011,171011,0,0,0,406,0.0,3.891297940075706,6
2020-07-06-171011,171011,3,0,2,409,0.6,3.3943099897637503,0
2020-07-07-171011,171011,0,0,2,409,0.6,3.6738483180726265,1
2020-07-08-171011,171011,2,0,0,411,0.6,3.8506260893117665,2
2020-07-09-171011,171011,1,0,0,412,0.6,3.6334808770663813,3
2020-07-10-171011,171011,2,2,1,414,0.6,4.092673103775889,4
2020-07-11-171011,171011,0,0,1,414,0.0,3.641893220732361,5
2020-07-12-171011,171011,0,1,0,414,0.0,2.8777492421853896,6
2020-07-13-171011,171011,0,0,0,414,0.4,2.9335041720121913,0
2020-07-14-171011,171011,0,0,0,414,0.4,3.307809674241014,1
2020-07-15-171011,171011,0,0,1,414,0.8,2.5926473217879007,2
2020-07-16-171011,171011,1,1,1,415,0.0,2.1103681919374297,3
2020-07-17-171011,171011,0,0,2,415,0.6,2.2465191512087186,4
2020-07-18-171011,171011,0,0,0,415,0.0,2.0015607593955744,5
2020-07-19-171011,171011,0,0,0,415,0.2,1.8129251948182405,6
2020-07-20-171011,171011,2,0,1,417,0.2,1.8355164404975592,0
2020-07-21-171011,171011,2,0,1,419,0.6,2.042090880898962,1
2020-07-22-171011,171011,0,0,0,419,0.2,2.146789353411752,2
2020-07-23-171011,171011,0,0,0,419,0.6,2.156175100672235,3
2020-07-24-171011,171011,1,0,0,420,1.2,2.4071969751110887,4
2020-07-25-171011,171011,1,0,0,421,0.2,3.0679234254092105,5
2020-07-26-171011,171011,0,0,1,421,0.4,3.045169956331277,6
2020-07-27-171011,171011,0,0,8,421,0.2,2.596111338601679,0
2020-07-28-171011,171011,0,0,1,421,0.0,2.749210768982308,1
2020-07-29-171011,171011,1,0,1,422,0.4,2.7546687812899844,2
2020-07-30-171011,171011,1,1,2,423,0.8,2.715838358855172,3
2020-07-31-171011,171011,2,0,0,425,0.8,2.980028084922682,4
2020-08-01-171011,171011,0,0,1,425,0.0,2.9247248316960395,5
2020-08-02-171011,171011,0,0,1,425,0.0,10.134940026047186,6
2020-08-03-171011,171011,1,0,7,426,1.6,23.837900175963366,0
2020-08-04-171011,171011,1,0,1,427,1.0,20.685991141156688,1
2020-08-05-171011,171011,0,0,4,427,1.0,18.354925532473015,2
2020-08-06-171011,171011,0,0,5,427,1.8,14.412570118937015,3
2020-08-07-171011,171011,0,0,2,427,0.6,10.615685277698663,4
2020-08-08-171011,171011,0,0,1,427,1.0,9.015813853721726,5
2020-08-09-171011,171011,1,0,0,428,0.2,9.586010412488253,6
2020-08-10-171011,171011,8,0,3,436,1.0,2.25153918394908,0
2020-08-11-171011,171011,1,0,1,437,2.6,3.3133056979666473,1
2020-08-12-171011,171011,1,0,4,438,2.8,4.006874910353054,2
2020-08-13-171011,171011,2,0,2,440,1.4,5.8501923215217015,3
2020-08-14-171011,171011,0,0,2,440,1.4,6.775773410220125,4
2020-08-15-171011,171011,1,0,6,441,0.4,7.966850706889956,5
2020-08-16-171011,171011,1,0,1,442,1.8,7.96251775553505,6
2020-08-17-171011,171011,7,0,4,449,1.2,9.738126269549475,0
2020-08-18-171011,171011,1,0,2,450,4.4,9.677864586870216,1
2020-08-19-171011,171011,4,0,3,454,3.2,10.364502649914561,2
2020-08-20-171011,171011,5,0,4,459,4.6,8.205913516485262,3
2020-08-21-171011,171011,2,0,0,461,4.0,10.44315439465691,4
2020-08-22-171011,171011,1,0,2,462,1.4,12.319535259783628,5
2020-08-23-171011,171011,0,0,2,462,3.2,13.222600595165526,6
2020-08-24-171011,171011,3,0,10,465,4.2,13.864933762682735,0
2020-08-25-171011,171011,1,0,4,466,4.8,15.358537697156827,1
2020-08-26-171011,171011,4,0,6,470,2.8,17.427230927845077,2
2020-08-27-171011,171011,2,0,3,472,7.0,19.85351926076457,3
2020-08-28-171011,171011,2,0,5,474,6.8,21.040577520515257,4
2020-08-29-171011,171011,6,0,6,480,3.4,23.059706853531022,5
2020-08-30-171011,171011,1,0,3,481,2.4,22.884386250936977,6
2020-08-31-171011,171011,4,0,1,485,6.0,21.696532106113132,0
2020-09-01-171011,171011,2,0,2,487,3.2,10.216701837782946,1
2020-09-02-171011,171011,3,0,7,490,6.2,34.01903462061411,2
2020-09-03-171011,171011,4,0,4,494,8.2,22.818593691423263,3
2020-09-04-171011,171011,0,0,3,494,7.0,21.874459411957144,4
2020-09-05-171011,171011,2,0,7,496,6.0,20.42933314242295,5
2020-09-06-171011,171011,2,0,4,498,6.6,20.48832163809316,6
2020-09-07-171011,171011,10,0,3,508,12.0,22.183136671674834,0
2020-09-08-171011,171011,4,0,5,512,2.2,26.159406225915497,1
2020-09-09-171011,171011,6,0,10,518,4.6,23.125609873623773,2
2020-09-10-171011,171011,3,0,1,521,9.8,9.622267208321151,3
2020-09-11-171011,171011,5,0,0,526,7.2,15.796171825268743,4
2020-09-12-171011,171011,6,0,3,532,1.6,20.65704421586097,5
2020-09-13-171011,171011,3,0,1,535,3.4,21.398463783249753,6
2020-09-14-171011,171011,1,0,5,536,9.6,21.63973990390909,0
2020-09-15-171011,171011,2,0,3,538,4.8,27.81429354978664,1
2020-09-16-171011,171011,7,0,5,545,10.0,33.298846058815485,2
2020-09-17-171011,171011,4,0,5,549,9.8,38.05695433732965,3
2020-09-18-171011,171011,3,0,6,552,5.8,39.01504098045642,4
2020-09-19-171011,171011,7,0,3,559,2.2,36.86084803741524,5
2020-09-20-171011,171011,4,0,0,563,2.2,39.03073261313493,6
2020-09-21-171011,171011,3,0,8,566,7.6,31.805538853088333,0
2020-09-22-171011,171011,5,2,4,571,7.0,30.51759753752728,1
2020-09-23-171011,171011,10,0,8,581,8.6,27.116244206256383,2
2020-09-24-171011,171011,1,0,0,582,7.6,23.782348768840546,3
2020-09-25-171011,171011,0,0,6,582,8.8,23.724102833194298,4
2020-09-26-171011,171011,3,0,0,585,1.8,27.832063048742498,5
2020-09-27-171011,171011,1,0,0,586,3.0,27.330247745142955,6
2020-09-28-171011,171011,5,0,2,591,5.6,27.810090091162863,0
2020-09-29-171011,171011,3,0,2,594,6.4,26.917760531512165,1
2020-09-30-171011,171011,5,0,1,599,5.2,26.383990947769004,2
2020-10-01-171011,171011,5,0,4,604,5.6,0.0,3
2020-10-02-171011,171011,6,0,6,610,6.8,31.04219037114059,4
2020-10-03-171011,171011,3,0,0,613,2.4,63.77975955435255,5
2020-10-04-171011,171011,0,0,1,613,2.6,65.23737683304239,6
2020-10-05-171011,171011,8,1,10,621,6.4,54.291375044317064,0
2020-10-06-171011,171011,4,0,3,625,7.8,49.75566253134933,1
2020-10-07-171011,171011,8,1,9,633,6.6,43.23832446157232,2
2020-10-08-171011,171011,0,0,6,633,8.8,37.77594632050037,3
2020-10-09-171011,171011,6,0,14,639,9.0,43.5257350894029,4
2020-10-10-171011,171011,0,0,7,639,4.8,3.961697419534711,5
2020-10-11-171011,171011,0,0,7,639,0.6,7.888609108080654,6
2020-10-12-171011,171011,2,0,13,641,1.6,9.180313243840033,0
2020-10-13-171011,171011,2,0,18,643,7.0,10.255134358430551,1
2020-10-14-171011,171011,1,0,3,644,7.2,14.547312806998441,2
2020-10-15-171011,171011,4,0,3,648,5.8,20.605436190399974,3
2020-10-16-171011,171011,6,0,10,654,9.8,25.004692861347255,4
2020-10-17-171011,171011,0,0,11,654,4.4,27.277275347314294,5
2020-10-18-171011,171011,1,0,5,655,1.8,25.984598965258026,6
2020-10-19-171011,171011,10,0,3,665,7.8,26.59050239887143,0
2020-10-20-171011,171011,3,0,5,668,10.8,33.49273311340727,1
2020-10-21-171011,171011,9,0,9,677,14.2,34.79172566434384,2
2020-10-22-171011,171011,6,0,8,683,11.6,39.638334930673025,3
2020-10-23-171011,171011,14,0,3,697,18.4,45.1374902404839,4
2020-10-24-171011,171011,7,0,10,704,6.6,53.988724863033646,5
2020-10-25-171011,171011,7,0,4,711,4.0,54.790495499829916,6
2020-10-26-171011,171011,13,0,10,724,21.2,52.029538508455005,0
2020-10-27-171011,171011,18,0,7,742,14.2,57.850441909134425,1
2020-10-28-171011,171011,3,0,14,745,19.0,58.843876732692685,2
2020-10-29-171011,171011,3,0,11,748,19.2,60.95314551387569,3
2020-10-30-171011,171011,10,0,15,758,23.2,50.64511976903216,4
2020-10-31-171011,171011,11,0,0,769,9.0,59.35682355631771,5
2020-11-01-171011,171011,5,2,0,774,5.8,33.09217300178358,6
2020-11-02-171011,171011,3,0,0,777,2.4,48.80412538253684,0
2020-11-03-171011,171011,5,1,0,782,10.4,36.93697668141769,1
2020-11-04-171011,171011,9,1,0,791,13.0,45.766088222821,2
2020-11-05-171011,171011,8,1,0,799,17.2,51.133705713254336,3
2020-11-06-171011,171011,3,0,0,802,15.2,57.51854231604709,4
2020-11-07-171011,171011,10,1,0,812,4.8,62.228082594268834,5
2020-11-08-171011,171011,4,0,0,816,4.0,62.42580965348699,6
2020-11-09-171011,171011,10,1,0,826,17.8,64.81553703837679,0
2020-11-10-171011,171011,7,0,0,833,11.4,29.723814708904918,1
2020-11-11-171011,171011,14,0,0,847,14.8,35.81683539874556,2
2020-11-12-171011,171011,11,1,0,858,13.2,41.88629799280851,3
2020-11-13-171011,171011,15,1,0,873,15.6,45.239342753463326,4
2020-03-01-171012,171012,0,0,1,0,0.0,0.0,6
2020-03-02-171012,171012,0,0,3,0,0.0,5.238868332695485,0
2020-03-03-171012,171012,0,0,7,0,0.0,29.856132465525622,1
2020-03-04-171012,171012,0,1,12,0,0.0,30.408361920275556,2
2020-03-05-171012,171012,0,0,14,0,0.0,31.716478932686584,3
2020-03-06-171012,171012,0,0,11,0,0.0,28.221129125244346,4
2020-03-07-171012,171012,0,0,2,0,0.0,29.13812631499123,5
2020-03-08-171012,171012,0,0,4,0,0.0,29.46563197182136,6
2020-03-09-171012,171012,1,0,17,1,0.25,28.915039866290964,0
2020-03-10-171012,171012,0,0,19,1,1.0,115.53109576977056,1
2020-03-11-171012,171012,1,0,26,2,1.0,92.88525296656968,2
2020-03-12-171012,171012,1,0,16,3,0.5,66.07627697708548,3
2020-03-13-171012,171012,3,0,16,6,2.25,44.90010911421602,4
2020-03-14-171012,171012,2,0,6,8,1.5,30.531246939804948,5
2020-03-15-171012,171012,1,0,7,9,1.25,21.11026802868333,6
2020-03-16-171012,171012,3,0,9,12,5.25,6.746694252466103,0
2020-03-17-171012,171012,7,0,9,19,5.25,13.604393014809572,1
2020-03-18-171012,171012,12,1,10,31,9.75,17.465198452690814,2
2020-03-19-171012,171012,14,1,4,45,13.5,22.825488425554433,3
2020-03-20-171012,171012,11,0,8,56,9.5,28.116170297529663,4
2020-03-21-171012,171012,2,0,4,58,4.25,33.965543295247755,5
2020-03-22-171012,171012,4,0,1,62,3.75,33.13366044535948,6
2020-03-23-171012,171012,17,0,3,79,17.5,31.180317562480788,0
2020-03-24-171012,171012,19,1,11,98,11.25,38.94523543607989,1
2020-03-25-171012,171012,26,0,9,124,15.0,41.09314657040559,2
2020-03-26-171012,171012,16,0,0,140,13.0,41.571655921653246,3
2020-03-27-171012,171012,16,0,6,156,9.75,48.296839036056795,4
2020-03-28-171012,171012,6,0,0,162,3.0,45.91351917892662,5
2020-03-29-171012,171012,7,0,2,169,2.25,45.89730355280845,6
2020-03-30-171012,171012,9,0,10,178,10.75,33.67637671839148,0
2020-03-31-171012,171012,9,0,6,187,4.5,31.89221482081291,1
2020-04-01-171012,171012,10,0,7,197,5.5,4.746252669834343,2
2020-04-02-171012,171012,4,1,6,201,5.25,22.97587294205545,3
2020-04-03-171012,171012,8,0,5,209,4.5,8.690950632295692,4
2020-04-04-171012,171012,4,0,0,213,2.75,13.298962389658058,5
2020-04-05-171012,171012,1,0,1,214,2.5,14.064979074810495,6
2020-04-06-171012,171012,3,0,9,217,6.75,14.685292442208933,0
2020-04-07-171012,171012,11,0,3,228,26.75,16.715357121765095,1
2020-04-08-171012,171012,9,0,4,237,7.5,21.41155351607853,2
2020-04-09-171012,171012,0,0,0,237,4.5,24.23955472600038,3
2020-04-10-171012,171012,6,0,3,243,4.75,4.671310950714638,4
2020-04-11-171012,171012,0,0,0,243,1.0,6.0578614659259316,5
2020-04-12-171012,171012,2,0,0,245,1.0,7.094887648622152,6
2020-04-13-171012,171012,10,0,5,255,10.0,7.992804472066903,0
2020-04-14-171012,171012,6,0,1,261,6.0,17.466138156671143,1
2020-04-15-171012,171012,7,0,1,268,4.75,22.09870039895673,2
2020-04-16-171012,171012,6,0,5,274,2.0,24.9762155548701,3
2020-04-17-171012,171012,5,0,0,279,1.5,24.36365139019676,4
2020-04-18-171012,171012,0,0,1,279,1.0,26.400131835253394,5
2020-04-19-171012,171012,1,0,0,280,0.5,25.868388845095303,6
2020-04-20-171012,171012,9,0,2,289,3.0,18.656823051842863,0
2020-04-21-171012,171012,3,0,4,292,3.5,16.837075351342147,1
2020-04-22-171012,171012,4,1,5,296,4.0,15.903639078742213,2
2020-04-23-171012,171012,0,0,6,296,0.25,16.04842212284693,3
2020-04-24-171012,171012,3,0,6,299,3.75,12.668492121209521,4
2020-04-25-171012,171012,0,0,0,299,0.5,14.15596279902718,5
2020-04-26-171012,171012,0,1,2,299,0.25,14.088215319436996,6
2020-04-27-171012,171012,5,0,13,304,1.75,10.788614860791526,0
2020-04-28-171012,171012,1,0,5,305,2.25,10.614682118216543,1
2020-04-29-171012,171012,1,0,0,306,1.5,9.61059717108164,2
2020-04-30-171012,171012,5,0,1,311,2.0,14.6568262918817,3
2020-05-01-171012,171012,0,0,6,311,0.25,24.842412113689427,4
2020-05-02-171012,171012,1,0,0,312,0.25,7.738706204584163,5
2020-05-03-171012,171012,0,0,0,312,0.5,6.792097785288344,6
2020-05-04-171012,171012,2,0,5,314,2.5,4.660257866919663,0
2020-05-05-171012,171012,4,0,1,318,1.25,6.268004721017975,1
2020-05-06-171012,171012,5,0,3,323,2.25,8.212833023441885,2
2020-05-07-171012,171012,6,0,1,329,2.0,9.720093826447185,3
2020-05-08-171012,171012,6,0,2,335,3.75,10.520758818171934,4
2020-05-09-171012,171012,0,2,0,335,0.25,14.17987261381121,5
2020-05-10-171012,171012,2,0,0,337,0.25,26.87608269727901,6
2020-05-11-171012,171012,13,0,7,350,2.25,25.5574055871427,0
2020-05-12-171012,171012,5,0,6,355,2.0,27.00331023753371,1
2020-05-13-171012,171012,0,0,3,355,1.25,23.157558770572805,2
2020-05-14-171012,171012,1,0,1,356,2.0,15.900078900191822,3
2020-05-15-171012,171012,6,0,1,362,3.0,12.507007267225973,4
2020-05-16-171012,171012,0,0,0,362,1.0,9.821748578464867,5
2020-05-17-171012,171012,0,0,0,362,0.25,10.17208128767772,6
2020-05-18-171012,171012,5,0,4,367,3.25,10.212035717984643,0
2020-05-19-171012,171012,1,0,5,368,1.5,10.23631675719251,1
2020-05-20-171012,171012,3,0,2,371,1.5,9.488808288287103,2
2020-05-21-171012,171012,1,1,2,372,1.75,9.855487745146288,3
2020-05-22-171012,171012,2,0,2,374,1.25,9.642943826062192,4
2020-05-23-171012,171012,0,0,0,374,1.0,10.553395080268674,5
2020-05-24-171012,171012,0,0,0,374,0.0,11.411272750106342,6
2020-05-25-171012,171012,7,0,4,381,1.0,8.884769448827086,0
2020-05-26-171012,171012,6,0,1,387,2.0,9.49279004017484,1
2020-05-27-171012,171012,3,1,0,390,0.75,10.89193578009159,2
2020-05-28-171012,171012,1,0,1,391,1.0,10.43761877284628,3
2020-05-29-171012,171012,1,0,3,392,2.0,9.855401216241544,4
2020-05-30-171012,171012,0,0,0,392,0.5,9.652619904035713,5
2020-05-31-171012,171012,0,0,0,392,0.0,9.938447659101046,6
2020-06-01-171012,171012,4,0,1,396,0.75,19.196947698746214,0
2020-06-02-171012,171012,5,0,1,401,1.5,7.22285402666737,1
2020-06-03-171012,171012,2,0,1,403,0.25,5.868083800756253,2
2020-06-04-171012,171012,2,0,1,405,2.0,6.823621423724194,3
2020-06-05-171012,171012,2,0,3,407,1.5,7.558546959069151,4
2020-06-06-171012,171012,0,0,0,407,0.25,7.230728757733219,5
2020-06-07-171012,171012,0,0,0,407,0.0,7.273076701335686,6
2020-06-08-171012,171012,4,0,1,411,0.75,7.189852691145664,0
2020-06-09-171012,171012,1,0,0,412,0.25,6.76005717939638,1
2020-06-10-171012,171012,0,0,0,412,1.5,22.15163836536605,2
2020-06-11-171012,171012,1,0,0,413,1.5,19.02109454848074,3
2020-06-12-171012,171012,3,0,3,416,1.75,16.237385926388757,4
2020-06-13-171012,171012,0,0,0,416,0.25,13.50738660065249,5
2020-06-14-171012,171012,0,0,0,416,0.0,10.22801231073733,6
2020-06-15-171012,171012,1,1,6,417,2.0,6.103895048702514,0
2020-06-16-171012,171012,1,0,1,418,3.5,7.4282012954156285,1
2020-06-17-171012,171012,1,0,0,419,1.25,7.63359682836603,2
2020-06-18-171012,171012,1,0,0,420,1.0,7.9604684554490355,3
2020-06-19-171012,171012,3,0,0,423,1.5,8.083891824101418,4
2020-06-20-171012,171012,0,0,0,423,0.0,9.936900833510485,5
2020-06-21-171012,171012,0,0,0,423,0.0,10.002792567396341,6
2020-06-22-171012,171012,1,0,0,424,0.75,8.43260295663048,0
2020-06-23-171012,171012,0,0,1,424,1.5,6.6614200124499465,1
2020-06-24-171012,171012,0,1,0,424,1.75,6.636053743324134,2
2020-06-25-171012,171012,0,0,0,424,1.0,6.055949768718222,3
2020-06-26-171012,171012,3,0,1,427,0.75,5.9117219132731975,4
2020-06-27-171012,171012,0,1,0,427,0.0,5.513618305365801,5
2020-06-28-171012,171012,0,0,0,427,0.0,5.543183613555604,6
2020-06-29-171012,171012,6,0,0,433,2.0,5.679599304605636,0
2020-06-30-171012,171012,1,0,1,434,0.5,7.517148711728366,1
2020-07-01-171012,171012,0,0,0,434,0.0,6.723686072966282,2
2020-07-02-171012,171012,0,0,0,434,0.0,2.742840979483853,3
2020-07-03-171012,171012,0,0,0,434,1.5,4.080726277624076,4
2020-07-04-171012,171012,0,0,0,434,0.0,5.598315599265161,5
2020-07-05-171012,171012,0,0,1,434,0.0,5.57814394854142,6
2020-07-06-171012,171012,0,0,1,434,1.25,4.8440599073346675,0
2020-07-07-171012,171012,1,0,1,435,0.25,5.254443577747433,1
2020-07-08-171012,171012,0,0,0,435,0.75,5.504349097261377,2
2020-07-09-171012,171012,0,0,1,435,0.5,5.194673813641709,3
2020-07-10-171012,171012,1,0,1,436,0.5,5.634438593870807,4
2020-07-11-171012,171012,0,0,0,436,0.0,5.028228495433381,5
2020-07-12-171012,171012,0,0,0,436,0.0,3.991125305752953,6
2020-07-13-171012,171012,0,0,0,436,0.25,4.077134238087336,0
2020-07-14-171012,171012,1,0,0,437,0.25,4.639657179850578,1
2020-07-15-171012,171012,0,0,1,437,0.25,3.6354496263403275,2
2020-07-16-171012,171012,0,0,1,437,0.25,3.008038882144924,3
2020-07-17-171012,171012,0,0,1,437,0.5,3.1954556005134336,4
2020-07-18-171012,171012,0,0,0,437,0.0,2.8512975799043057,5
2020-07-19-171012,171012,1,0,0,438,0.0,2.594654880895593,6
2020-07-20-171012,171012,1,0,1,439,0.5,2.603159233568557,0
2020-07-21-171012,171012,1,0,1,440,0.75,2.910364504737004,1
2020-07-22-171012,171012,0,0,1,440,0.0,3.043346542379815,2
2020-07-23-171012,171012,1,0,4,441,0.25,3.0392672280267448,3
2020-07-24-171012,171012,1,0,1,442,0.5,3.409395060489055,4
2020-07-25-171012,171012,0,0,0,442,0.25,4.363413373252804,5
2020-07-26-171012,171012,0,0,0,442,0.0,4.347339324950717,6
2020-07-27-171012,171012,0,0,0,442,0.0,3.687439264217857,0
2020-07-28-171012,171012,0,0,4,442,0.0,3.918788352241223,1
2020-07-29-171012,171012,1,0,3,443,0.25,3.950170903421511,2
2020-07-30-171012,171012,1,0,0,444,1.0,3.9345849669934716,3
2020-07-31-171012,171012,1,0,0,445,0.75,4.307661230931736,4
2020-08-01-171012,171012,0,0,1,445,0.0,4.2340749845707775,5
2020-08-02-171012,171012,0,0,4,445,0.0,14.441240520714707,6
2020-08-03-171012,171012,1,0,1,446,0.75,34.2113173078082,0
2020-08-04-171012,171012,1,0,10,447,0.5,29.660471458809038,1
2020-08-05-171012,171012,1,0,9,448,1.25,26.369065291553017,2
2020-08-06-171012,171012,4,0,4,452,0.75,20.773567461949312,3
2020-08-07-171012,171012,1,0,6,453,0.25,15.410083623466141,4
2020-08-08-171012,171012,0,0,1,453,0.0,13.082832384983039,5
2020-08-09-171012,171012,0,0,5,453,0.5,13.977385503229447,6
2020-08-10-171012,171012,0,0,10,453,2.75,3.2833408293266437,0
2020-08-11-171012,171012,4,0,8,457,2.25,4.856707853473043,1
2020-08-12-171012,171012,3,0,6,460,2.0,5.860470362479153,2
2020-08-13-171012,171012,0,0,3,460,2.0,8.65282973528308,3
2020-08-14-171012,171012,0,0,8,460,0.75,9.986215247642185,4
2020-08-15-171012,171012,1,0,6,461,0.5,11.697235156759106,5
2020-08-16-171012,171012,4,0,2,465,1.0,11.63944819341754,6
2020-08-17-171012,171012,1,0,8,466,2.75,14.27766375184456,0
2020-08-18-171012,171012,10,0,2,476,2.25,14.142650335300136,1
2020-08-19-171012,171012,9,0,5,485,2.75,15.117392770849019,2
2020-08-20-171012,171012,4,0,5,489,3.0,11.841794790025634,3
2020-08-21-171012,171012,6,0,3,495,3.75,15.146637702470338,4
2020-08-22-171012,171012,1,0,12,496,0.25,17.954737665781614,5
2020-08-23-171012,171012,5,0,19,501,1.5,19.32603974357528,6
2020-08-24-171012,171012,10,1,14,511,1.5,20.32780524442544,0
2020-08-25-171012,171012,8,0,4,519,2.25,22.4808493759427,1
2020-08-26-171012,171012,6,2,8,525,2.25,25.47936788464254,2
2020-08-27-171012,171012,3,0,23,528,4.25,28.925586150851995,3
2020-08-28-171012,171012,8,0,6,536,2.25,30.620096809598426,4
2020-08-29-171012,171012,6,0,5,542,3.25,33.435440270424216,5
2020-08-30-171012,171012,2,0,7,544,1.25,33.15089389231318,6
2020-08-31-171012,171012,8,0,5,552,4.5,31.3916486975753,0
2020-09-01-171012,171012,2,0,8,554,4.25,14.909755557763841,1
2020-09-02-171012,171012,5,0,7,559,3.5,49.63066072861929,2
2020-09-03-171012,171012,5,0,6,564,3.0,32.907426910202034,3
2020-09-04-171012,171012,3,0,6,567,5.0,31.476718077952057,4
2020-09-05-171012,171012,12,0,0,579,6.5,29.30526593014121,5
2020-09-06-171012,171012,19,0,8,598,5.25,29.380505887060007,6
2020-09-07-171012,171012,14,0,7,612,8.25,31.903221895980394,0
2020-09-08-171012,171012,4,0,6,616,1.75,37.68168880560193,1
2020-09-09-171012,171012,8,0,8,624,2.75,33.42006594642604,2
2020-09-10-171012,171012,23,0,4,647,4.75,14.073754261266908,3
2020-09-11-171012,171012,6,0,9,653,7.0,23.229978067864554,4
2020-09-12-171012,171012,5,0,2,658,2.25,30.262098451091553,5
2020-09-13-171012,171012,7,0,4,665,2.5,31.258480658257632,6
2020-09-14-171012,171012,5,0,1,670,4.0,31.581319782111684,0
2020-09-15-171012,171012,8,0,6,678,3.25,40.482594575709825,1
2020-09-16-171012,171012,7,1,3,685,5.25,48.27856343168298,2
2020-09-17-171012,171012,6,0,4,691,7.5,55.15630744760962,3
2020-09-18-171012,171012,6,0,5,697,4.5,56.33267739300967,4
2020-09-19-171012,171012,0,0,7,697,4.5,53.15131388892709,5
2020-09-20-171012,171012,8,0,3,705,2.25,56.222434867011515,6
2020-09-21-171012,171012,7,2,7,712,3.5,45.752132751789055,0
2020-09-22-171012,171012,6,0,7,718,6.5,43.8423427835229,1
2020-09-23-171012,171012,8,0,7,726,7.0,38.83851351446614,2
2020-09-24-171012,171012,4,0,12,730,4.25,34.11484236311449,3
2020-09-25-171012,171012,9,0,11,739,3.5,34.04485217838619,4
2020-09-26-171012,171012,2,0,7,741,1.25,39.83800986407475,5
2020-09-27-171012,171012,4,0,1,745,0.5,39.1758523102121,6
2020-09-28-171012,171012,1,0,3,746,4.0,39.85770687582202,0
2020-09-29-171012,171012,6,0,1,752,3.25,38.53857049365206,1
2020-09-30-171012,171012,3,0,3,755,3.0,37.794830929633264,2
2020-10-01-171012,171012,4,0,6,759,3.75,0.0,3
2020-10-02-171012,171012,5,0,16,764,4.75,44.02370921935306,4
2020-10-03-171012,171012,7,0,9,771,1.0,91.33313430826855,5
2020-10-04-171012,171012,3,0,2,774,1.0,93.20667280861778,6
2020-10-05-171012,171012,7,0,8,781,3.25,77.51212899623056,0
2020-10-06-171012,171012,7,0,3,788,4.25,70.83324089102003,1
2020-10-07-171012,171012,7,0,9,795,4.25,61.743862016792065,2
2020-10-08-171012,171012,12,0,10,807,3.75,54.18039491777891,3
2020-10-09-171012,171012,11,0,23,818,5.0,62.268617633763526,4
2020-10-10-171012,171012,7,0,3,825,3.75,5.64648721534147,5
2020-10-11-171012,171012,1,0,6,826,0.25,11.362569275382908,6
2020-10-12-171012,171012,3,0,28,829,1.75,13.247337906193925,0
2020-10-13-171012,171012,1,0,17,830,4.0,14.792033627136114,1
2020-10-14-171012,171012,3,0,19,833,5.5,20.774690718840144,2
2020-10-15-171012,171012,6,0,15,839,4.0,29.503452049492157,3
2020-10-16-171012,171012,16,0,26,855,5.25,35.74365521480678,4
2020-10-17-171012,171012,9,0,9,864,0.75,39.014574632568625,5
2020-10-18-171012,171012,2,0,8,866,1.75,37.13156835902143,6
2020-10-19-171012,171012,8,0,0,874,6.0,38.01826375586557,0
2020-10-20-171012,171012,3,0,8,877,9.0,48.04159123080217,1
2020-10-21-171012,171012,9,0,14,886,8.5,49.904125341071335,2
2020-10-22-171012,171012,10,0,17,896,9.25,56.91720671088882,3
2020-10-23-171012,171012,23,0,11,919,14.0,64.90782782421273,4
2020-10-24-171012,171012,3,0,12,922,5.5,77.38114750107772,5
2020-10-25-171012,171012,6,0,5,928,5.0,78.73782307826903,6
2020-10-26-171012,171012,28,0,16,956,14.0,74.97841115217301,0
2020-10-27-171012,171012,17,0,12,973,11.75,83.17820648522274,1
2020-10-28-171012,171012,19,1,17,992,10.75,84.51148151266192,2
2020-10-29-171012,171012,15,0,16,1007,10.25,87.36187153262179,3
2020-10-30-171012,171012,26,1,20,1033,14.0,72.50875177737379,4
2020-10-31-171012,171012,9,2,0,1042,7.75,84.7362006721255,5
2020-11-01-171012,171012,8,1,0,1050,3.75,47.32847508445235,6
2020-11-02-171012,171012,0,0,0,1050,2.25,69.6541531527114,0
2020-11-03-171012,171012,8,0,0,1058,8.25,52.614908038129094,1
2020-11-04-171012,171012,14,0,0,1072,10.0,65.36835379591703,2
2020-11-05-171012,171012,17,1,0,1089,12.5,73.13176200509761,3
2020-11-06-171012,171012,11,0,0,1100,14.25,82.05430374667002,4
2020-11-07-171012,171012,12,0,0,1112,6.5,88.88921350243021,5
2020-11-08-171012,171012,5,0,0,1117,3.0,89.74699035753423,6
2020-11-09-171012,171012,16,2,0,1133,10.0,93.63734072926025,0
2020-11-10-171012,171012,12,1,0,1145,6.25,42.68521974273088,1
2020-11-11-171012,171012,17,1,0,1162,10.75,51.333939764236476,2
2020-11-12-171012,171012,16,1,0,1178,10.5,60.33858498397382,3
2020-11-13-171012,171012,20,0,0,1198,10.25,65.12857010097238,4
2020-03-01-171013,171013,0,0,1,0,0.0,0.0,6
2020-03-02-171013,171013,0,0,13,0,0.0,6.75176379706768,0
2020-03-03-171013,171013,0,0,12,0,0.0,38.30610929147322,1
2020-03-04-171013,171013,0,0,8,0,0.5,43.17755335323549,2
2020-03-05-171013,171013,0,2,8,0,0.25,46.16955338127752,3
2020-03-06-171013,171013,0,0,8,0,0.0,41.210714426947284,4
2020-03-07-171013,171013,0,0,2,0,0.25,42.80955999826969,5
2020-03-08-171013,171013,0,0,9,0,0.25,42.47818547315484,6
2020-03-09-171013,171013,1,0,13,1,0.0,42.284075456218574,0
2020-03-10-171013,171013,0,0,5,1,0.25,153.58819138833462,1
2020-03-11-171013,171013,0,0,11,1,0.25,123.20007523600137,2
2020-03-12-171013,171013,0,0,21,1,0.25,85.11423811188499,3
2020-03-13-171013,171013,0,0,10,1,1.25,53.70847163835933,4
2020-03-14-171013,171013,0,0,0,1,0.75,41.818287706169734,5
2020-03-15-171013,171013,1,0,2,2,1.0,30.630294803609264,6
2020-03-16-171013,171013,13,0,18,15,4.25,10.701267486084538,0
2020-03-17-171013,171013,12,0,9,27,8.75,21.350490797594396,1
2020-03-18-171013,171013,8,2,4,35,8.75,28.552208561032767,2
2020-03-19-171013,171013,8,0,4,43,12.25,38.04448086647603,3
2020-03-20-171013,171013,8,0,7,51,13.75,47.36071083482015,4
2020-03-21-171013,171013,2,0,0,53,3.25,57.52516064264464,5
2020-03-22-171013,171013,9,0,2,62,6.75,56.68807928628779,6
2020-03-23-171013,171013,13,0,12,75,24.75,53.36169481164485,0
2020-03-24-171013,171013,5,0,2,80,24.75,64.71568491237502,1
2020-03-25-171013,171013,11,0,5,91,21.25,69.23067656096298,2
2020-03-26-171013,171013,21,0,2,112,19.5,69.53970536213762,3
2020-03-27-171013,171013,10,0,0,122,16.25,82.4671538440561,4
2020-03-28-171013,171013,0,0,2,122,4.0,80.62383045852746,5
2020-03-29-171013,171013,2,0,0,124,2.5,81.02226093585439,6
2020-03-30-171013,171013,18,0,7,142,22.0,61.10305378594559,0
2020-03-31-171013,171013,9,0,6,151,11.5,58.856243505391625,1
2020-04-01-171013,171013,4,0,5,155,12.5,9.353392651851308,2
2020-04-02-171013,171013,4,1,3,159,13.25,39.43528542377076,3
2020-04-03-171013,171013,7,0,5,166,13.5,16.793478664492838,4
2020-04-04-171013,171013,0,0,1,166,3.75,29.885550897312196,5
2020-04-05-171013,171013,2,0,0,168,1.75,31.755198695230295,6
2020-04-06-171013,171013,12,1,5,180,17.0,32.88742066474187,0
2020-04-07-171013,171013,2,1,1,182,10.0,38.09431527944868,1
2020-04-08-171013,171013,5,0,3,187,9.25,44.274779708231435,2
2020-04-09-171013,171013,2,0,1,189,7.5,49.406868362230064,3
2020-04-10-171013,171013,0,0,3,189,6.5,9.940091802118435,4
2020-04-11-171013,171013,2,0,0,191,3.75,14.115404934863681,5
2020-04-12-171013,171013,0,0,1,191,3.0,16.52950835851633,6
2020-04-13-171013,171013,7,0,2,198,14.75,19.11186231051738,0
2020-04-14-171013,171013,6,0,5,204,8.25,31.955050883298938,1
2020-04-15-171013,171013,5,0,3,209,12.5,40.483082572050826,2
2020-04-16-171013,171013,3,0,3,212,6.0,47.799690125172376,3
2020-04-17-171013,171013,5,0,0,217,3.5,45.72546036954697,4
2020-04-18-171013,171013,1,0,1,218,1.0,47.82056755729618,5
2020-04-19-171013,171013,0,1,0,218,1.0,45.50249581353292,6
2020-04-20-171013,171013,5,0,4,223,5.5,37.115354220454364,0
2020-04-21-171013,171013,1,0,5,224,7.25,34.11273755136,1
2020-04-22-171013,171013,3,0,0,227,4.75,31.175410066957518,2
2020-04-23-171013,171013,1,0,1,228,0.0,30.8269837891751,3
2020-04-24-171013,171013,3,0,7,231,5.25,25.318938978326017,4
2020-04-25-171013,171013,0,0,0,231,0.25,28.062600442046428,5
2020-04-26-171013,171013,1,0,1,232,0.5,27.867531665066128,6
2020-04-27-171013,171013,2,0,3,234,5.5,20.732650873275624,0
2020-04-28-171013,171013,5,0,0,239,1.25,20.303355049375657,1
2020-04-29-171013,171013,3,0,1,242,4.5,19.207472477172765,2
2020-04-30-171013,171013,3,0,3,245,6.5,32.787578811760376,3
2020-05-01-171013,171013,0,0,0,245,0.75,49.25403938912817,4
2020-05-02-171013,171013,1,0,0,246,0.25,15.777744034986583,5
2020-05-03-171013,171013,0,0,0,246,0.25,13.829437673253407,6
2020-05-04-171013,171013,4,0,3,250,5.0,9.959673140324501,0
2020-05-05-171013,171013,5,0,1,255,4.25,13.101323872372195,1
2020-05-06-171013,171013,0,0,1,255,5.0,15.706285881539976,2
2020-05-07-171013,171013,1,0,2,256,4.75,18.718847898110003,3
2020-05-08-171013,171013,7,0,0,263,6.0,21.229754318526897,4
2020-05-09-171013,171013,0,0,0,263,0.25,28.099594275656923,5
2020-05-10-171013,171013,1,0,0,264,0.5,50.47093793618893,6
2020-05-11-171013,171013,3,1,0,267,3.75,47.60562768397868,0
2020-05-12-171013,171013,0,0,2,267,2.75,51.16095879873979,1
2020-05-13-171013,171013,1,0,2,268,0.25,42.71189017951626,2
2020-05-14-171013,171013,3,0,0,271,3.5,31.329551831794806,3
2020-05-15-171013,171013,0,0,1,271,2.5,25.621974402612082,4
2020-05-16-171013,171013,0,0,0,271,0.0,21.135091071148807,5
2020-05-17-171013,171013,0,0,0,271,0.0,20.927854507087442,6
2020-05-18-171013,171013,3,0,3,274,4.25,20.83160556503464,0
2020-05-19-171013,171013,1,1,1,275,3.75,19.69565526687628,1
2020-05-20-171013,171013,1,0,3,276,4.75,16.938437391539487,2
2020-05-21-171013,171013,2,0,1,278,2.0,17.888172450176956,3
2020-05-22-171013,171013,0,0,1,278,2.25,17.131888080304016,4
2020-05-23-171013,171013,0,0,1,278,0.75,20.225330934692636,5
2020-05-24-171013,171013,0,0,0,278,0.0,20.883250689665633,6
2020-05-25-171013,171013,0,0,1,278,3.5,16.81100966304775,0
2020-05-26-171013,171013,2,0,0,280,1.5,18.506666058081386,1
2020-05-27-171013,171013,2,0,2,282,2.5,21.54139466199382,2
2020-05-28-171013,171013,0,0,1,282,1.5,19.83053372468479,3
2020-05-29-171013,171013,1,0,0,283,2.25,18.97253451085445,4
2020-05-30-171013,171013,0,0,0,283,0.0,18.398518800379378,5
2020-05-31-171013,171013,0,0,0,283,0.0,18.702553218021844,6
2020-06-01-171013,171013,3,0,0,286,2.75,34.46558088619665,0
2020-06-02-171013,171013,1,0,0,287,2.75,12.607187694586976,1
2020-06-03-171013,171013,3,0,0,290,2.75,9.745622189374732,2
2020-06-04-171013,171013,1,0,0,291,2.75,10.632351692821079,3
2020-06-05-171013,171013,1,0,1,292,3.0,12.110842471633513,4
2020-06-06-171013,171013,1,0,0,293,0.25,12.583315356417053,5
2020-06-07-171013,171013,0,0,0,293,0.0,12.324609088992037,6
2020-06-08-171013,171013,1,0,0,294,1.5,12.224587710529637,0
2020-06-09-171013,171013,0,0,1,294,2.25,11.926153891644482,1
2020-06-10-171013,171013,2,0,0,296,1.5,39.889354213259224,2
2020-06-11-171013,171013,1,0,0,297,2.0,35.213740497543576,3
2020-06-12-171013,171013,0,0,2,297,1.5,31.28060734595963,4
2020-06-13-171013,171013,0,2,0,297,0.25,26.185335565513437,5
2020-06-14-171013,171013,0,0,0,297,0.0,19.736095864628286,6
2020-06-15-171013,171013,0,0,1,297,1.5,12.43462282964704,0
2020-06-16-171013,171013,0,0,0,297,2.75,14.403401360211685,1
2020-06-17-171013,171013,0,0,0,297,1.25,13.963594767489802,2
2020-06-18-171013,171013,0,0,0,297,1.25,13.040341949891586,3
2020-06-19-171013,171013,1,0,0,298,1.25,12.624180668162047,4
2020-06-20-171013,171013,0,0,1,298,0.0,16.398348125318297,5
2020-06-21-171013,171013,0,0,0,298,0.0,16.72659076037167,6
2020-06-22-171013,171013,0,0,0,298,1.25,13.987651469326988,0
2020-06-23-171013,171013,1,0,0,299,1.25,12.15503315864445,1
2020-06-24-171013,171013,0,0,0,299,0.75,12.340581970172485,2
2020-06-25-171013,171013,0,2,0,299,1.25,11.327036644624943,3
2020-06-26-171013,171013,2,0,0,301,2.75,10.295850152887478,4
2020-06-27-171013,171013,0,0,0,301,0.0,9.064756000941443,5
2020-06-28-171013,171013,0,0,0,301,0.25,8.991959580124574,6
2020-06-29-171013,171013,1,0,0,302,1.0,9.180095863000412,0
2020-06-30-171013,171013,0,0,0,302,0.25,10.581088865197314,1
2020-07-01-171013,171013,0,0,1,302,1.25,10.746373315037964,2
2020-07-02-171013,171013,0,0,1,302,0.25,4.855526321816364,3
2020-07-03-171013,171013,0,0,0,302,1.0,6.80145761457268,4
2020-07-04-171013,171013,1,0,0,303,0.0,8.923869948247102,5
2020-07-05-171013,171013,0,0,0,303,0.25,8.98034190350659,6
2020-07-06-171013,171013,0,0,0,303,0.5,7.485749721604327,0
2020-07-07-171013,171013,0,0,0,303,0.75,7.5407895899346205,1
2020-07-08-171013,171013,0,0,0,303,1.25,7.676626123765201,2
2020-07-09-171013,171013,0,0,0,303,1.0,7.377541961020692,3
2020-07-10-171013,171013,0,0,0,303,1.5,10.036501478259037,4
2020-07-11-171013,171013,0,0,0,303,0.25,9.04231783289866,5
2020-07-12-171013,171013,0,0,0,303,0.0,7.6725861253880705,6
2020-07-13-171013,171013,0,0,0,303,0.75,8.39389851982195,0
2020-07-14-171013,171013,0,0,1,303,1.25,9.322931630602568,1
2020-07-15-171013,171013,1,0,0,304,0.5,8.014464476713988,2
2020-07-16-171013,171013,1,0,1,305,1.5,6.844343705978013,3
2020-07-17-171013,171013,0,0,0,305,0.25,6.61707681521635,4
2020-07-18-171013,171013,0,0,0,305,0.0,6.526100053242258,5
2020-07-19-171013,171013,0,0,1,305,0.0,5.368053650880756,6
2020-07-20-171013,171013,0,0,0,305,1.0,4.560369551203996,0
2020-07-21-171013,171013,0,0,1,305,1.5,4.825407759319974,1
2020-07-22-171013,171013,0,0,2,305,1.75,5.113486463295401,2
2020-07-23-171013,171013,0,0,0,305,1.25,5.446557091189355,3
2020-07-24-171013,171013,0,0,0,305,1.75,5.43025370839706,4
2020-07-25-171013,171013,0,0,0,305,0.0,6.5359646090263075,5
2020-07-26-171013,171013,0,0,0,305,0.0,6.480446587874167,6
2020-07-27-171013,171013,0,0,1,305,1.25,5.7800805999009786,0
2020-07-28-171013,171013,1,0,5,306,1.0,6.52144634554195,1
2020-07-29-171013,171013,0,0,0,306,1.0,6.679666115779408,2
2020-07-30-171013,171013,1,0,5,307,2.5,6.4729631582658875,3
2020-07-31-171013,171013,0,0,2,307,1.25,7.2016824231544,4
2020-08-01-171013,171013,0,0,0,307,0.25,5.837795151606354,5
2020-08-02-171013,171013,1,0,4,308,0.25,25.95515168683425,6
2020-08-03-171013,171013,0,0,7,308,0.5,63.75475408229639,0
2020-08-04-171013,171013,1,0,1,309,0.75,51.6952119626371,1
2020-08-05-171013,171013,2,0,6,311,4.0,43.99301493517214,2
2020-08-06-171013,171013,0,0,2,311,2.0,32.739531044376456,3
2020-08-07-171013,171013,0,0,2,311,3.0,21.40357393708637,4
2020-08-08-171013,171013,0,0,6,311,1.0,19.122726899863025,5
2020-08-09-171013,171013,0,0,0,311,0.5,21.021014143562056,6
2020-08-10-171013,171013,1,0,2,312,2.25,4.763823827599792,0
2020-08-11-171013,171013,5,0,5,317,2.25,7.04450891927647,1
2020-08-12-171013,171013,0,0,1,317,1.5,8.828119560772079,2
2020-08-13-171013,171013,5,0,1,322,6.0,11.074351391374911,3
2020-08-14-171013,171013,2,0,4,324,2.0,13.535610119795745,4
2020-08-15-171013,171013,0,0,3,324,3.0,16.420607222107183,5
2020-08-16-171013,171013,4,0,0,328,3.0,16.601906415857663,6
2020-08-17-171013,171013,7,0,1,335,5.0,19.028601229582915,0
2020-08-18-171013,171013,1,0,2,336,3.5,19.519593775661157,1
2020-08-19-171013,171013,6,0,1,342,4.5,21.04567390129168,2
2020-08-20-171013,171013,2,0,1,344,8.5,18.887973885013388,3
2020-08-21-171013,171013,2,0,1,346,5.25,22.64177070044045,4
2020-08-22-171013,171013,6,1,7,352,1.75,27.168707839763282,5
2020-08-23-171013,171013,0,0,3,352,4.5,28.25375477727704,6
2020-08-24-171013,171013,2,0,4,354,4.25,28.22550746330687,0
2020-08-25-171013,171013,5,0,0,359,8.5,32.5786686467637,1
2020-08-26-171013,171013,1,0,2,360,10.5,39.620685713998114,2
2020-08-27-171013,171013,1,0,6,361,8.75,47.22056994008575,3
2020-08-28-171013,171013,4,0,2,365,12.0,52.09548322486211,4
2020-08-29-171013,171013,3,0,1,368,2.5,59.290720381659284,5
2020-08-30-171013,171013,0,0,8,368,3.75,58.0752056266154,6
2020-08-31-171013,171013,1,0,4,369,5.5,53.61978915728815,0
2020-09-01-171013,171013,2,0,5,371,5.0,22.559474124974244,1
2020-09-02-171013,171013,1,0,6,372,6.0,69.14985794358378,2
2020-09-03-171013,171013,1,0,2,373,3.75,50.591661382303684,3
2020-09-04-171013,171013,1,0,6,374,6.0,50.59115691275319,4
2020-09-05-171013,171013,7,0,5,381,3.25,46.29704593127398,5
2020-09-06-171013,171013,3,0,1,384,5.25,43.63901220617082,6
2020-09-07-171013,171013,4,0,2,388,12.25,46.57532260876539,0
2020-09-08-171013,171013,0,0,1,388,4.5,51.29462153194719,1
2020-09-09-171013,171013,2,0,2,390,10.25,45.476554013778966,2
2020-09-10-171013,171013,6,0,1,396,7.75,19.71063691442985,3
2020-09-11-171013,171013,2,0,4,398,12.0,31.006651744644664,4
2020-09-12-171013,171013,1,0,0,399,4.5,41.05714109273525,5
2020-09-13-171013,171013,8,0,2,407,2.0,42.588298541864006,6
2020-09-14-171013,171013,4,0,6,411,9.75,43.09807046442429,0
2020-09-15-171013,171013,5,0,7,416,10.0,52.86709325560891,1
2020-09-16-171013,171013,6,0,2,422,13.0,66.31317963195026,2
2020-09-17-171013,171013,2,0,3,424,8.25,74.71105518946601,3
2020-09-18-171013,171013,6,0,4,430,9.0,76.49633050564182,4
2020-09-19-171013,171013,5,1,2,435,3.5,74.46235832715833,5
2020-09-20-171013,171013,1,0,0,436,4.75,81.10335045939603,6
2020-09-21-171013,171013,2,0,0,438,10.0,69.79147796235983,0
2020-09-22-171013,171013,1,1,1,439,3.5,67.78523439477586,1
2020-09-23-171013,171013,2,0,4,441,11.25,63.598995639089964,2
2020-09-24-171013,171013,1,0,1,442,6.25,57.37050470286508,3
2020-09-25-171013,171013,4,0,2,446,10.0,55.965143026792305,4
2020-09-26-171013,171013,0,0,1,446,3.5,64.89948628417662,5
2020-09-27-171013,171013,2,1,1,448,1.75,63.813290114868714,6
2020-09-28-171013,171013,6,0,3,454,4.5,62.29018511226604,0
2020-09-29-171013,171013,7,0,3,461,6.25,58.65244270470433,1
2020-09-30-171013,171013,2,0,7,463,7.25,56.35727553403851,2
2020-10-01-171013,171013,3,0,5,466,3.5,0.0,3
2020-10-02-171013,171013,4,0,1,470,8.5,64.77359882785072,4
2020-10-03-171013,171013,2,0,7,472,2.25,127.31910550336384,5
2020-10-04-171013,171013,0,0,0,472,6.0,132.08205786251028,6
2020-10-05-171013,171013,0,1,5,472,7.75,110.64668301575878,0
2020-10-06-171013,171013,1,0,7,473,7.5,102.8899479719534,1
2020-10-07-171013,171013,4,1,7,477,6.5,90.77980244760255,2
2020-10-08-171013,171013,1,0,6,478,5.25,79.17108353256302,3
2020-10-09-171013,171013,2,1,13,480,10.5,88.48806019960469,4
2020-10-10-171013,171013,1,0,10,481,5.0,9.328635150158702,5
2020-10-11-171013,171013,1,0,2,482,2.0,15.27813242408882,6
2020-10-12-171013,171013,3,0,13,485,2.0,17.29854997971282,0
2020-10-13-171013,171013,3,0,5,488,6.75,18.985681701779285,1
2020-10-14-171013,171013,7,0,14,495,8.75,29.083676276028683,2
2020-10-15-171013,171013,5,0,4,500,7.25,40.529996440763306,3
2020-10-16-171013,171013,1,0,10,501,11.0,50.59469469334688,4
2020-10-17-171013,171013,7,0,9,508,4.0,53.85409182915762,5
2020-10-18-171013,171013,0,0,10,508,1.25,53.57888342457563,6
2020-10-19-171013,171013,5,0,1,513,7.75,55.06769658106418,0
2020-10-20-171013,171013,7,0,16,520,10.75,71.61469229900624,1
2020-10-21-171013,171013,7,0,8,527,10.75,77.46989900552407,2
2020-10-22-171013,171013,6,0,5,533,15.75,84.53052052290333,3
2020-10-23-171013,171013,13,0,6,546,25.25,95.60413684408971,4
2020-10-24-171013,171013,10,0,7,556,2.25,115.94720354489355,5
2020-10-25-171013,171013,2,0,4,558,6.0,117.8331571353113,6
2020-10-26-171013,171013,13,0,8,571,17.5,108.53853975255547,0
2020-10-27-171013,171013,5,1,6,576,13.5,122.24378572984355,1
2020-10-28-171013,171013,14,1,10,590,22.25,123.16117924407862,2
2020-10-29-171013,171013,4,0,9,594,20.25,129.56468226826456,3
2020-10-30-171013,171013,10,0,4,604,25.25,107.45972754929943,4
2020-10-31-171013,171013,9,0,0,613,9.0,129.8014619699572,5
2020-11-01-171013,171013,10,0,0,623,3.75,68.86100959081793,6
2020-11-02-171013,171013,1,0,0,624,3.75,99.75901092103511,0
2020-11-03-171013,171013,16,0,0,640,23.0,79.37013032278008,1
2020-11-04-171013,171013,8,0,0,648,18.75,99.43610667445927,2
2020-11-05-171013,171013,5,0,0,653,23.0,108.91951894840142,3
2020-11-06-171013,171013,6,1,0,659,21.5,122.16637624762697,4
2020-11-07-171013,171013,7,1,0,666,13.75,134.95508635785342,5
2020-11-08-171013,171013,4,0,0,670,6.0,131.13786199707772,6
2020-11-09-171013,171013,8,0,0,678,16.75,136.36154625097035,0
2020-11-10-171013,171013,6,1,0,684,17.0,67.4645334653985,1
2020-11-11-171013,171013,10,0,0,694,14.5,81.30057818670282,2
2020-11-12-171013,171013,9,0,0,703,18.25,91.31514723039976,3
2020-11-13-171013,171013,4,0,0,707,19.0,98.02335776139513,4
2020-03-01-171014,171014,0,0,0,0,0.0,0.0,6
2020-03-02-171014,171014,0,0,4,0,0.14285714285714285,71.8249282801226,0
2020-03-03-171014,171014,0,1,4,0,0.0,408.89669684560016,1
2020-03-04-171014,171014,0,3,9,0,0.42857142857142855,396.8611155313017,2
2020-03-05-171014,171014,0,0,11,0,0.0,411.48735352115926,3
2020-03-06-171014,171014,1,0,15,1,0.0,375.58862692664025,4
2020-03-07-171014,171014,0,0,2,1,0.0,393.6059635079157,5
2020-03-08-171014,171014,0,0,6,1,0.14285714285714285,408.1776553309765,6
2020-03-09-171014,171014,0,0,18,1,0.14285714285714285,404.98564071469093,0
2020-03-10-171014,171014,0,0,9,1,0.7142857142857143,1522.5142837409758,1
2020-03-11-171014,171014,0,0,14,1,1.1428571428571428,1223.0712121472554,2
2020-03-12-171014,171014,0,0,8,1,0.42857142857142855,858.2196134499538,3
2020-03-13-171014,171014,1,0,12,2,2.4285714285714284,563.8852499816702,4
2020-03-14-171014,171014,0,0,2,2,1.2857142857142858,399.42517287473635,5
2020-03-15-171014,171014,0,0,2,2,2.0,283.3198987327895,6
2020-03-16-171014,171014,4,0,16,6,6.142857142857142,94.0573442078132,0
2020-03-17-171014,171014,4,0,7,10,7.428571428571429,175.1608975515895,1
2020-03-18-171014,171014,9,1,0,19,12.428571428571427,213.68323393437734,2
2020-03-19-171014,171014,11,0,6,30,15.857142857142858,269.2346093256141,3
2020-03-20-171014,171014,15,0,6,45,13.857142857142858,310.82521821302873,4
2020-03-21-171014,171014,2,1,2,47,5.0,355.38492580727257,5
2020-03-22-171014,171014,6,0,0,53,4.857142857142857,351.1216408196809,6
2020-03-23-171014,171014,18,0,5,71,29.42857142857143,332.6657875880995,0
2020-03-24-171014,171014,9,1,10,80,20.285714285714285,434.32578298688895,1
2020-03-25-171014,171014,14,0,7,94,20.571428571428573,480.91724593396634,2
2020-03-26-171014,171014,8,0,12,102,18.714285714285715,498.8452439276327,3
2020-03-27-171014,171014,12,0,4,114,17.0,574.1203584382682,4
2020-03-28-171014,171014,2,0,1,116,4.857142857142857,554.3985681900322,5
2020-03-29-171014,171014,2,0,3,118,3.571428571428572,558.9510877747706,6
2020-03-30-171014,171014,16,0,22,134,17.857142857142858,404.3812917057711,0
2020-03-31-171014,171014,7,0,28,141,8.428571428571429,374.5406258899555,1
2020-04-01-171014,171014,0,0,5,141,8.714285714285714,50.61892899576751,2
2020-04-02-171014,171014,6,0,1,147,9.571428571428571,270.8714861592099,3
2020-04-03-171014,171014,6,0,2,153,8.0,94.83191657117055,4
2020-04-04-171014,171014,2,0,1,155,3.1428571428571432,138.95848661627122,5
2020-04-05-171014,171014,0,0,0,155,2.142857142857143,145.40398323170433,6
2020-04-06-171014,171014,5,0,5,160,12.857142857142858,153.7978957201612,0
2020-04-07-171014,171014,10,0,5,170,22.0,184.09446851401452,1
2020-04-08-171014,171014,7,0,4,177,11.142857142857142,237.10495567322022,2
2020-04-09-171014,171014,12,0,0,189,6.857142857142858,260.6341582913524,3
2020-04-10-171014,171014,4,0,6,193,5.285714285714286,48.472003817713485,4
2020-04-11-171014,171014,1,0,0,194,2.8571428571428568,63.791052590236674,5
2020-04-12-171014,171014,3,0,0,197,2.571428571428572,78.36227883144583,6
2020-04-13-171014,171014,22,2,3,219,37.857142857142854,88.30253429764805,0
2020-04-14-171014,171014,28,0,2,247,8.0,213.64311085942768,1
2020-04-15-171014,171014,5,0,5,252,8.285714285714286,258.13884108060006,2
2020-04-16-171014,171014,1,0,1,253,6.2857142857142865,291.56511881212447,3
2020-04-17-171014,171014,2,0,0,255,4.285714285714286,285.86089643252046,4
2020-04-18-171014,171014,1,0,2,256,1.4285714285714286,304.5074740078263,5
2020-04-19-171014,171014,0,0,0,256,0.7142857142857143,296.502237527401,6
2020-04-20-171014,171014,5,0,3,261,5.7142857142857135,194.61039196823663,0
2020-04-21-171014,171014,5,0,3,266,6.0,182.0581445957988,1
2020-04-22-171014,171014,4,0,6,270,5.0,168.88597347712212,2
2020-04-23-171014,171014,0,0,2,270,0.2857142857142857,170.3355545281963,3
2020-04-24-171014,171014,6,0,5,276,4.428571428571429,136.80768437110348,4
2020-04-25-171014,171014,0,0,0,276,0.2857142857142857,154.0490777197262,5
2020-04-26-171014,171014,0,0,0,276,0.5714285714285714,154.33707550177684,6
2020-04-27-171014,171014,3,2,7,279,4.0,118.10729888081754,0
2020-04-28-171014,171014,2,0,2,281,1.8571428571428568,115.86402150309605,1
2020-04-29-171014,171014,5,0,1,286,2.8571428571428568,105.06813595975181,2
2020-04-30-171014,171014,1,0,4,287,4.142857142857143,155.4336243057236,3
2020-05-01-171014,171014,0,1,5,287,0.7142857142857143,279.89488820084205,4
2020-05-02-171014,171014,2,0,0,289,0.2857142857142857,80.94856767515955,5
2020-05-03-171014,171014,0,0,0,289,0.2857142857142857,76.84694118093398,6
2020-05-04-171014,171014,3,0,2,292,4.0,53.76110626196352,0
2020-05-05-171014,171014,3,0,2,295,4.285714285714286,73.20816702823835,1
2020-05-06-171014,171014,6,0,0,301,4.142857142857143,96.64838813239521,2
2020-05-07-171014,171014,2,0,5,303,3.7142857142857135,114.00257701919398,3
2020-05-08-171014,171014,5,0,1,308,6.857142857142858,126.22875989672795,4
2020-05-09-171014,171014,0,1,2,308,0.42857142857142855,170.8281317326195,5
2020-05-10-171014,171014,0,0,0,308,0.2857142857142857,308.4573388731902,6
2020-05-11-171014,171014,7,0,3,315,3.8571428571428568,291.4462540855842,0
2020-05-12-171014,171014,2,0,5,317,3.1428571428571432,309.83348422813526,1
2020-05-13-171014,171014,1,0,0,318,0.5714285714285714,259.21275069864225,2
2020-05-14-171014,171014,4,0,1,322,3.2857142857142856,171.22334988226442,3
2020-05-15-171014,171014,5,2,2,327,3.2857142857142856,136.07034921196137,4
2020-05-16-171014,171014,0,0,0,327,0.5714285714285714,106.20163346250881,5
2020-05-17-171014,171014,0,0,0,327,0.42857142857142855,108.69329255829075,6
2020-05-18-171014,171014,2,0,1,329,4.571428571428571,109.87223338579005,0
2020-05-19-171014,171014,2,0,2,331,2.4285714285714284,107.02979649540798,1
2020-05-20-171014,171014,0,0,1,331,3.0,100.56026048290822,2
2020-05-21-171014,171014,5,0,3,336,1.7142857142857142,102.81687665335718,3
2020-05-22-171014,171014,1,0,3,337,2.2857142857142856,99.9247436475392,4
2020-05-23-171014,171014,2,0,0,339,1.1428571428571428,112.6427861225571,5
2020-05-24-171014,171014,0,0,0,339,0.0,120.43249627643232,6
2020-05-25-171014,171014,3,0,2,342,2.2857142857142856,92.51055267632205,0
2020-05-26-171014,171014,5,0,0,347,2.2857142857142856,100.30353049706594,1
2020-05-27-171014,171014,0,2,0,347,1.7142857142857142,121.2123671222324,2
2020-05-28-171014,171014,1,3,0,348,1.8571428571428568,118.50518214516666,3
2020-05-29-171014,171014,2,3,0,350,2.142857142857143,116.46749768879361,4
2020-05-30-171014,171014,0,0,1,350,0.2857142857142857,117.14745612145788,5
2020-05-31-171014,171014,0,0,0,350,0.14285714285714285,122.54414760044985,6
2020-06-01-171014,171014,1,0,0,351,2.2857142857142856,240.15185440451395,0
2020-06-02-171014,171014,2,1,1,353,2.142857142857143,82.10264451776914,1
2020-06-03-171014,171014,1,0,3,354,1.8571428571428568,76.59093427237705,2
2020-06-04-171014,171014,3,0,1,357,3.0,85.1407112197538,3
2020-06-05-171014,171014,3,1,0,360,2.142857142857143,93.56503708845547,4
2020-06-06-171014,171014,0,1,0,360,0.2857142857142857,92.47236246585808,5
2020-06-07-171014,171014,0,0,0,360,0.0,92.98924077790907,6
2020-06-08-171014,171014,2,0,0,362,1.5714285714285714,91.97376185557047,0
2020-06-09-171014,171014,0,0,0,362,2.142857142857143,89.54427246189636,1
2020-06-10-171014,171014,0,0,0,362,1.5714285714285714,283.5105667491022,2
2020-06-11-171014,171014,0,0,0,362,2.142857142857143,241.0695914722261,3
2020-06-12-171014,171014,0,0,0,362,1.2857142857142858,204.011068650561,4
2020-06-13-171014,171014,1,1,0,363,0.14285714285714285,169.3613909472458,5
2020-06-14-171014,171014,0,0,0,363,0.14285714285714285,128.62878910538475,6
2020-06-15-171014,171014,0,0,0,363,1.7142857142857142,75.04990421945368,0
2020-06-16-171014,171014,1,0,0,364,3.4285714285714284,90.27771020890972,1
2020-06-17-171014,171014,3,0,0,367,1.7142857142857142,89.9950020409307,2
2020-06-18-171014,171014,1,0,0,368,2.2857142857142856,94.26204093220352,3
2020-06-19-171014,171014,0,0,1,368,1.2857142857142858,98.61505104568276,4
2020-06-20-171014,171014,0,0,0,368,0.0,122.55023017686277,5
2020-06-21-171014,171014,0,0,0,368,0.0,122.97494861309318,6
2020-06-22-171014,171014,0,0,1,368,1.2857142857142858,105.5021760647899,0
2020-06-23-171014,171014,0,0,0,368,2.142857142857143,84.29155459705066,1
2020-06-24-171014,171014,0,0,2,368,1.5714285714285714,88.48667717085544,2
2020-06-25-171014,171014,0,0,0,368,1.2857142857142858,81.59267853268446,3
2020-06-26-171014,171014,0,0,2,368,2.571428571428572,82.79678311246647,4
2020-06-27-171014,171014,0,1,0,368,0.0,78.58920279264274,5
2020-06-28-171014,171014,0,1,0,368,0.2857142857142857,79.09150651941684,6
2020-06-29-171014,171014,0,0,1,368,2.142857142857143,81.35558392112259,0
2020-06-30-171014,171014,0,0,0,368,0.7142857142857143,100.28435013435109,1
2020-07-01-171014,171014,0,0,1,368,0.14285714285714285,92.71619816597162,2
2020-07-02-171014,171014,0,0,0,368,0.2857142857142857,32.712989605426046,3
2020-07-03-171014,171014,1,0,0,369,1.2857142857142858,47.9153843244235,4
2020-07-04-171014,171014,0,0,0,369,0.0,65.70543266737226,5
2020-07-05-171014,171014,0,0,0,369,0.14285714285714285,65.4425353464739,6
2020-07-06-171014,171014,1,0,0,370,1.1428571428571428,58.385922126615746,0
2020-07-07-171014,171014,0,0,0,370,0.7142857142857143,62.45520143407552,1
2020-07-08-171014,171014,2,1,1,372,1.5714285714285714,65.63107237301796,2
2020-07-09-171014,171014,0,0,1,372,1.2857142857142858,61.880453134256115,3
2020-07-10-171014,171014,2,0,4,374,0.8571428571428571,81.09086011644797,4
2020-07-11-171014,171014,0,0,0,374,0.0,71.47608755924014,5
2020-07-12-171014,171014,0,1,0,374,0.0,55.596257166763515,6
2020-07-13-171014,171014,1,0,1,375,0.8571428571428571,56.23985935181301,0
2020-07-14-171014,171014,0,0,0,375,0.5714285714285714,61.09261778056238,1
2020-07-15-171014,171014,1,0,1,376,1.4285714285714286,48.054911550405635,2
2020-07-16-171014,171014,0,0,0,376,1.1428571428571428,36.51423406068833,3
2020-07-17-171014,171014,0,0,2,376,0.8571428571428571,39.25861706643739,4
2020-07-18-171014,171014,0,0,0,376,0.0,34.66519587785349,5
2020-07-19-171014,171014,0,0,0,376,0.0,30.66337884614107,6
2020-07-20-171014,171014,0,1,1,376,0.8571428571428571,32.3815775152718,0
2020-07-21-171014,171014,0,0,0,376,1.1428571428571428,35.263270247697506,1
2020-07-22-171014,171014,1,0,0,377,0.7142857142857143,37.95914839076287,2
2020-07-23-171014,171014,1,0,1,378,0.7142857142857143,39.00128555972903,3
2020-07-24-171014,171014,4,0,0,382,1.0,42.66817620741601,4
2020-07-25-171014,171014,0,0,1,382,0.2857142857142857,53.30275110505628,5
2020-07-26-171014,171014,0,0,0,382,0.2857142857142857,51.98349527245133,6
2020-07-27-171014,171014,1,0,2,383,0.5714285714285714,45.25430685634211,0
2020-07-28-171014,171014,0,0,0,383,0.2857142857142857,47.00758313589127,1
2020-07-29-171014,171014,1,0,3,384,0.5714285714285714,45.91644665717778,2
2020-07-30-171014,171014,0,0,1,384,1.7142857142857142,43.046365277590894,3
2020-07-31-171014,171014,2,0,2,386,1.0,48.02556500097042,4
2020-08-01-171014,171014,0,0,0,386,0.0,46.7766426470905,5
2020-08-02-171014,171014,0,0,1,386,0.2857142857142857,175.58437423329303,6
2020-08-03-171014,171014,1,0,0,387,2.4285714285714284,400.5837408151865,0
2020-08-04-171014,171014,0,0,1,387,1.0,348.69453124450865,1
2020-08-05-171014,171014,0,0,2,387,2.8571428571428568,306.45769115469955,2
2020-08-06-171014,171014,1,0,6,388,1.2857142857142858,237.37684444557425,3
2020-08-07-171014,171014,0,0,2,388,2.0,168.85123678658653,4
2020-08-08-171014,171014,1,0,4,389,1.1428571428571428,143.4014450563496,5
2020-08-09-171014,171014,0,0,4,389,1.2857142857142858,148.70424428628777,6
2020-08-10-171014,171014,2,1,4,391,2.7142857142857144,34.78284335118636,0
2020-08-11-171014,171014,0,0,0,391,2.8571428571428568,49.90940992383324,1
2020-08-12-171014,171014,3,0,3,394,2.571428571428572,60.97379655455596,2
2020-08-13-171014,171014,1,0,16,395,3.7142857142857135,84.12775834854634,3
2020-08-14-171014,171014,2,0,7,397,2.2857142857142856,99.1724586569266,4
2020-08-15-171014,171014,0,0,3,397,1.4285714285714286,118.92338694301822,5
2020-08-16-171014,171014,1,0,5,398,3.4285714285714284,121.60317321738216,6
2020-08-17-171014,171014,0,0,0,398,2.8571428571428568,146.40616039472093,0
2020-08-18-171014,171014,1,0,1,399,3.2857142857142856,148.2021457680228,1
2020-08-19-171014,171014,2,0,3,401,3.1428571428571432,159.99350652779918,2
2020-08-20-171014,171014,6,0,20,407,5.857142857142858,133.47236317326227,3
2020-08-21-171014,171014,2,1,2,409,4.571428571428571,165.92188279878027,4
2020-08-22-171014,171014,4,0,3,413,2.142857142857143,191.01055068915304,5
2020-08-23-171014,171014,4,0,1,417,1.8571428571428568,201.9494875631668,6
2020-08-24-171014,171014,4,0,6,421,3.1428571428571432,208.3175957473552,0
2020-08-25-171014,171014,0,0,2,421,5.142857142857143,233.2123675612746,1
2020-08-26-171014,171014,3,0,1,424,3.571428571428572,266.45391284285165,2
2020-08-27-171014,171014,16,0,7,440,5.571428571428571,309.25342954270764,3
2020-08-28-171014,171014,7,0,6,447,6.571428571428571,328.94163377892266,4
2020-08-29-171014,171014,3,0,0,450,3.1428571428571432,367.6240941875063,5
2020-08-30-171014,171014,5,0,2,455,2.142857142857143,366.7037559318981,6
2020-08-31-171014,171014,0,1,7,455,5.0,349.54986943680404,0
2020-09-01-171014,171014,1,0,1,456,4.142857142857143,158.15284621839217,1
2020-09-02-171014,171014,3,0,7,459,5.285714285714286,525.6173174329408,2
2020-09-03-171014,171014,20,0,3,479,3.7142857142857135,371.87848312175606,3
2020-09-04-171014,171014,2,0,3,481,6.571428571428571,360.2353302098543,4
2020-09-05-171014,171014,3,0,2,484,4.857142857142857,341.3201603786567,5
2020-09-06-171014,171014,1,0,0,485,5.0,342.5981324341058,6
2020-09-07-171014,171014,6,0,7,491,14.285714285714285,366.1588008253841,0
2020-09-08-171014,171014,2,0,3,493,1.5714285714285714,429.2643203276806,1
2020-09-09-171014,171014,1,1,5,494,7.2857142857142865,373.8030899478774,2
2020-09-10-171014,171014,7,0,5,501,6.571428571428571,147.43257971102548,3
2020-09-11-171014,171014,6,0,9,507,8.857142857142858,235.27642012282843,4
2020-09-12-171014,171014,0,0,4,507,3.1428571428571432,313.7091203539327,5
2020-09-13-171014,171014,2,1,0,509,2.7142857142857144,329.75479513670973,6
2020-09-14-171014,171014,7,0,1,516,10.0,334.92038334314464,0
2020-09-15-171014,171014,1,0,4,517,6.0,436.34736532518406,1
2020-09-16-171014,171014,7,0,6,524,11.714285714285715,532.4406016094142,2
2020-09-17-171014,171014,3,1,4,527,8.285714285714286,610.1014200814902,3
2020-09-18-171014,171014,3,0,10,530,6.2857142857142865,636.4691404648835,4
2020-09-19-171014,171014,2,0,3,532,2.8571428571428568,605.3478249229199,5
2020-09-20-171014,171014,0,0,4,532,3.2857142857142856,644.028082814089,6
2020-09-21-171014,171014,7,0,1,539,6.428571428571429,528.2978178961198,0
2020-09-22-171014,171014,3,0,5,542,5.571428571428571,509.3428668668382,1
2020-09-23-171014,171014,5,0,7,547,10.428571428571429,458.2132944771897,2
2020-09-24-171014,171014,5,0,10,552,6.2857142857142865,398.511422713846,3
2020-09-25-171014,171014,9,0,5,561,6.857142857142858,396.77864110852204,4
2020-09-26-171014,171014,4,0,3,565,2.571428571428572,471.156079450201,5
2020-09-27-171014,171014,0,0,0,565,2.7142857142857144,459.9015193729929,6
2020-09-28-171014,171014,1,0,0,566,5.857142857142858,467.99129135125565,0
2020-09-29-171014,171014,4,1,3,570,5.857142857142858,455.21475626358165,1
2020-09-30-171014,171014,6,1,0,576,5.0,445.0327593889868,2
2020-10-01-171014,171014,4,0,2,580,5.0,0.0,3
2020-10-02-171014,171014,10,0,3,590,6.571428571428571,547.4531601154704,4
2020-10-03-171014,171014,3,0,7,593,1.8571428571428568,1078.0192364035129,5
2020-10-04-171014,171014,4,0,1,597,1.4285714285714286,1113.7176969584616,6
2020-10-05-171014,171014,1,0,4,598,7.2857142857142865,930.0943409388241,0
2020-10-06-171014,171014,5,1,2,603,7.428571428571429,864.2412641986913,1
2020-10-07-171014,171014,7,2,10,610,6.571428571428571,740.8873200410923,2
2020-10-08-171014,171014,10,0,6,620,6.571428571428571,634.7466927671107,3
2020-10-09-171014,171014,5,0,11,625,10.0,739.7408735904994,4
2020-10-10-171014,171014,3,0,13,628,4.571428571428571,68.55625058561107,5
2020-10-11-171014,171014,0,0,4,628,1.2857142857142858,130.227606299577,6
2020-10-12-171014,171014,0,0,8,628,2.571428571428572,150.29883828540835,0
2020-10-13-171014,171014,3,0,20,631,7.857142857142858,168.15738595775645,1
2020-10-14-171014,171014,0,0,14,631,9.142857142857142,249.3834430652495,2
2020-10-15-171014,171014,2,0,18,633,8.0,349.2326264793078,3
2020-10-16-171014,171014,3,0,17,636,11.571428571428573,426.7804621757338,4
2020-10-17-171014,171014,7,0,13,643,3.4285714285714284,464.2529164954791,5
2020-10-18-171014,171014,1,1,6,644,2.0,443.5658810931043,6
2020-10-19-171014,171014,4,0,4,648,7.857142857142858,452.61031045639265,0
2020-10-20-171014,171014,2,0,8,650,11.0,563.1295902824552,1
2020-10-21-171014,171014,10,0,7,660,12.714285714285715,585.0182444894483,2
2020-10-22-171014,171014,6,0,8,666,11.857142857142858,663.5078579874894,3
2020-10-23-171014,171014,11,0,2,677,20.0,751.7870546587257,4
2020-10-24-171014,171014,13,1,6,690,4.714285714285714,913.3861846013893,5
2020-10-25-171014,171014,4,1,6,694,5.285714285714286,914.3415813790863,6
2020-10-26-171014,171014,8,0,9,702,20.857142857142858,857.2201864507556,0
2020-10-27-171014,171014,20,1,7,722,13.0,962.9532320356539,1
2020-10-28-171014,171014,14,0,9,736,19.428571428571427,983.7934533856787,2
2020-10-29-171014,171014,18,0,6,754,17.142857142857142,1028.0442041527035,3
2020-10-30-171014,171014,17,2,9,771,20.857142857142858,856.1872863331009,4
2020-10-31-171014,171014,13,0,0,784,10.0,1016.9824901972519,5
2020-11-01-171014,171014,6,0,0,790,4.857142857142857,561.6181577653488,6
2020-11-02-171014,171014,4,0,0,794,2.571428571428572,838.9506309665535,0
2020-11-03-171014,171014,8,0,0,802,12.714285714285715,639.4629757302126,1
2020-11-04-171014,171014,7,0,0,809,15.285714285714285,783.4831208929265,2
2020-11-05-171014,171014,8,1,0,817,18.714285714285715,870.8133860119474,3
2020-11-06-171014,171014,2,0,0,819,17.142857142857142,991.163892539754,4
2020-11-07-171014,171014,6,0,0,825,8.0,1066.8380046211037,5
2020-11-08-171014,171014,6,0,0,831,4.428571428571429,1040.7594232300285,6
2020-11-09-171014,171014,9,1,0,840,14.857142857142858,1056.3735457573277,0
2020-11-10-171014,171014,7,0,0,847,12.571428571428573,495.4997642772467,1
2020-11-11-171014,171014,9,0,0,856,14.857142857142858,602.8049408546248,2
2020-11-12-171014,171014,6,0,0,862,14.142857142857142,688.596327139792,3
2020-11-13-171014,171014,9,2,0,871,17.714285714285715,745.9024757343317,4
2020-03-01-171015,171015,0,0,0,0,0.14285714285714285,0.0,6
2020-03-02-171015,171015,0,0,1,0,0.0,22.248777073883453,0
2020-03-03-171015,171015,0,0,1,0,0.0,188.80750932214846,1
2020-03-04-171015,171015,0,0,3,0,0.0,192.2725603563406,2
2020-03-05-171015,171015,0,0,0,0,0.14285714285714285,210.12748158640008,3
2020-03-06-171015,171015,0,0,6,0,0.0,164.25505715186114,4
2020-03-07-171015,171015,0,0,2,0,0.0,156.23521619758344,5
2020-03-08-171015,171015,0,1,6,0,0.0,150.10532126670716,6
2020-03-09-171015,171015,1,0,15,1,0.14285714285714285,149.09996820553732,0
2020-03-10-171015,171015,1,0,8,2,0.0,525.759397438894,1
2020-03-11-171015,171015,0,0,2,2,0.2857142857142857,417.71481451719507,2
2020-03-12-171015,171015,0,0,5,2,0.0,250.24105695327918,3
2020-03-13-171015,171015,0,0,9,2,0.42857142857142855,151.2698350683309,4
2020-03-14-171015,171015,0,0,4,2,0.14285714285714285,114.09636331334623,5
2020-03-15-171015,171015,0,0,2,2,0.2857142857142857,72.46754035055744,6
2020-03-16-171015,171015,1,0,6,3,3.2857142857142856,27.912088907177363,0
2020-03-17-171015,171015,1,0,2,4,3.0,57.52344458301299,1
2020-03-18-171015,171015,3,0,6,7,5.285714285714286,75.39844460505311,2
2020-03-19-171015,171015,0,0,5,7,3.7142857142857135,105.32525059645052,3
2020-03-20-171015,171015,6,2,4,13,5.571428571428571,106.13130793856412,4
2020-03-21-171015,171015,2,0,1,15,2.0,145.78594577808298,5
2020-03-22-171015,171015,6,1,7,21,2.2857142857142856,146.69058575702138,6
2020-03-23-171015,171015,15,0,3,36,6.857142857142858,153.99989499136123,0
2020-03-24-171015,171015,8,0,5,44,6.2857142857142865,222.64152955163027,1
2020-03-25-171015,171015,2,0,4,46,5.857142857142858,245.56302050494082,2
2020-03-26-171015,171015,5,0,7,51,5.142857142857143,266.11533098105855,3
2020-03-27-171015,171015,9,0,0,60,8.714285714285714,308.5796341933304,4
2020-03-28-171015,171015,4,0,2,64,2.2857142857142856,316.8044591719238,5
2020-03-29-171015,171015,2,0,0,66,2.4285714285714284,325.4664540460934,6
2020-03-30-171015,171015,6,0,4,72,5.0,219.57370792244257,0
2020-03-31-171015,171015,2,0,3,74,4.571428571428571,204.62475062639464,1
2020-04-01-171015,171015,6,0,6,80,5.0,28.159102185260092,2
2020-04-02-171015,171015,5,0,2,85,3.2857142857142856,120.03586279449777,3
2020-04-03-171015,171015,4,0,1,89,2.142857142857143,122.64170549420868,4
2020-04-04-171015,171015,1,0,0,90,1.5714285714285714,116.99191736356147,5
2020-04-05-171015,171015,7,0,0,97,2.2857142857142856,127.60080649892338,6
2020-04-06-171015,171015,3,0,2,100,3.2857142857142856,108.71680404423329,0
2020-04-07-171015,171015,5,0,2,105,2.571428571428572,113.70888723640884,1
2020-04-08-171015,171015,4,1,6,109,2.2857142857142856,134.5481161117534,2
2020-04-09-171015,171015,7,0,1,116,1.1428571428571428,149.7336475107895,3
2020-04-10-171015,171015,0,0,7,116,1.7142857142857142,42.97825836715507,4
2020-04-11-171015,171015,2,0,0,118,3.1428571428571432,44.94303445144466,5
2020-04-12-171015,171015,0,0,14,118,2.4285714285714284,61.20591689673576,6
2020-04-13-171015,171015,4,0,3,122,2.0,69.99186601415673,0
2020-04-14-171015,171015,3,0,2,125,2.142857142857143,101.72524010497968,1
2020-04-15-171015,171015,6,0,2,131,2.2857142857142856,122.70933829853445,2
2020-04-16-171015,171015,2,0,0,133,2.2857142857142856,156.706509354645,3
2020-04-17-171015,171015,1,0,0,134,1.1428571428571428,146.59372639249125,4
2020-04-18-171015,171015,0,0,0,134,0.8571428571428571,162.88836369792546,5
2020-04-19-171015,171015,0,1,0,134,0.42857142857142855,144.7313490758889,6
2020-04-20-171015,171015,2,0,2,136,2.2857142857142856,143.3675476086784,0
2020-04-21-171015,171015,2,0,2,138,3.7142857142857135,137.85158915253297,1
2020-04-22-171015,171015,6,0,1,144,1.1428571428571428,110.02370811917277,2
2020-04-23-171015,171015,1,0,1,145,0.5714285714285714,120.3568051455251,3
2020-04-24-171015,171015,7,0,2,152,2.2857142857142856,111.87361209656807,4
2020-04-25-171015,171015,0,0,0,152,0.14285714285714285,146.1975911823203,5
2020-04-26-171015,171015,14,0,0,166,0.42857142857142855,144.4461861105909,6
2020-04-27-171015,171015,3,0,0,169,1.2857142857142858,177.16756903275115,0
2020-04-28-171015,171015,2,2,0,171,2.0,176.35897823939166,1
2020-04-29-171015,171015,2,0,0,173,1.7142857142857142,174.1547411832703,2
2020-04-30-171015,171015,0,0,1,173,1.5714285714285714,185.43877628167303,3
2020-05-01-171015,171015,0,0,0,173,0.7142857142857143,197.72984337012338,4
2020-05-02-171015,171015,0,0,0,173,0.8571428571428571,38.36986527664491,5
2020-05-03-171015,171015,0,0,0,173,0.7142857142857143,35.383345642341894,6
2020-05-04-171015,171015,2,0,0,175,2.142857142857143,25.52122728893282,0
2020-05-05-171015,171015,2,0,0,177,1.7142857142857142,33.62135238747318,1
2020-05-06-171015,171015,1,0,2,178,2.8571428571428568,44.53629780204679,2
2020-05-07-171015,171015,1,0,0,179,2.0,56.099603239211135,3
2020-05-08-171015,171015,2,0,0,181,2.142857142857143,60.79652299091062,4
2020-05-09-171015,171015,0,0,0,181,0.14285714285714285,83.72650871306796,5
2020-05-10-171015,171015,0,0,0,181,0.2857142857142857,212.20239596084875,6
2020-05-11-171015,171015,0,0,0,181,2.0,196.21963031418917,0
2020-05-12-171015,171015,0,0,1,181,1.4285714285714286,170.62076883690244,1
2020-05-13-171015,171015,0,0,0,181,1.5714285714285714,146.85881338299865,2
2020-05-14-171015,171015,1,0,0,182,1.4285714285714286,113.32699251771693,3
2020-05-15-171015,171015,0,0,0,182,1.2857142857142858,90.54913087054435,4
2020-05-16-171015,171015,0,0,0,182,0.5714285714285714,55.61174159584117,5
2020-05-17-171015,171015,0,0,0,182,1.0,55.44935157890974,6
2020-05-18-171015,171015,0,0,0,182,1.7142857142857142,57.427460147045146,0
2020-05-19-171015,171015,0,0,2,182,2.2857142857142856,49.75451289771381,1
2020-05-20-171015,171015,2,0,0,184,2.0,47.943002135877784,2
2020-05-21-171015,171015,0,0,0,184,1.8571428571428568,49.27221137576298,3
2020-05-22-171015,171015,0,0,0,184,1.0,44.77021661672172,4
2020-05-23-171015,171015,0,0,0,184,0.14285714285714285,49.55576274764883,5
2020-05-24-171015,171015,0,0,0,184,0.2857142857142857,49.28460949035827,6
2020-05-25-171015,171015,0,0,0,184,1.4285714285714286,41.93894565524454,0
2020-05-26-171015,171015,1,0,0,185,1.2857142857142858,47.86288180273161,1
2020-05-27-171015,171015,0,0,0,185,1.8571428571428568,57.02727989914045,2
2020-05-28-171015,171015,0,1,0,185,0.8571428571428571,50.509341899417684,3
2020-05-29-171015,171015,0,0,0,185,0.7142857142857143,47.045920219797466,4
2020-05-30-171015,171015,0,0,0,185,0.2857142857142857,55.86531258312931,5
2020-05-31-171015,171015,0,0,0,185,0.42857142857142855,59.443690345787616,6
2020-06-01-171015,171015,0,0,0,185,1.0,118.84407757353176,0
2020-06-02-171015,171015,2,0,1,187,0.7142857142857143,32.62429806042139,1
2020-06-03-171015,171015,0,0,0,187,0.2857142857142857,29.3517893945938,2
2020-06-04-171015,171015,0,0,0,187,0.2857142857142857,28.71125808176498,3
2020-06-05-171015,171015,0,0,0,187,0.5714285714285714,24.424574568581427,4
2020-06-06-171015,171015,0,1,0,187,0.14285714285714285,19.43343309538287,5
2020-06-07-171015,171015,0,0,0,187,0.2857142857142857,20.115372091368286,6
2020-06-08-171015,171015,0,0,0,187,1.2857142857142858,20.478882822660733,0
2020-06-09-171015,171015,0,0,0,187,0.7142857142857143,38.04736447645108,1
2020-06-10-171015,171015,0,0,0,187,0.2857142857142857,128.2607736730959,2
2020-06-11-171015,171015,0,0,0,187,0.8571428571428571,105.40464792830343,3
2020-06-12-171015,171015,0,0,0,187,0.2857142857142857,86.5661826616103,4
2020-06-13-171015,171015,0,0,0,187,0.0,66.44340295127189,5
2020-06-14-171015,171015,0,2,0,187,0.0,47.51602018992476,6
2020-06-15-171015,171015,0,0,0,187,0.42857142857142855,22.44157710751566,0
2020-06-16-171015,171015,1,0,0,188,0.8571428571428571,26.750823037044295,1
2020-06-17-171015,171015,0,0,0,188,0.2857142857142857,31.671967119562115,2
2020-06-18-171015,171015,0,0,1,188,0.7142857142857143,31.093359729911512,3
2020-06-19-171015,171015,0,0,0,188,2.0,30.02238318409611,4
2020-06-20-171015,171015,0,0,0,188,0.14285714285714285,47.451689124313056,5
2020-06-21-171015,171015,0,0,0,188,0.2857142857142857,49.819891197731486,6
2020-06-22-171015,171015,0,0,0,188,0.5714285714285714,45.37104568518242,0
2020-06-23-171015,171015,0,0,0,188,0.42857142857142855,35.573924977258606,1
2020-06-24-171015,171015,0,0,0,188,0.8571428571428571,37.080375186284535,2
2020-06-25-171015,171015,0,1,0,188,0.2857142857142857,36.85256249092302,3
2020-06-26-171015,171015,0,0,0,188,0.5714285714285714,37.85522608396387,4
2020-06-27-171015,171015,0,0,0,188,0.0,34.615398658070475,5
2020-06-28-171015,171015,0,0,0,188,0.0,34.19796462883484,6
2020-06-29-171015,171015,0,0,0,188,0.5714285714285714,34.4982909671831,0
2020-06-30-171015,171015,0,0,1,188,0.42857142857142855,36.41948292913288,1
2020-07-01-171015,171015,0,0,1,188,0.2857142857142857,44.99230593825046,2
2020-07-02-171015,171015,1,0,3,189,0.14285714285714285,12.755620684280306,3
2020-07-03-171015,171015,0,0,0,189,1.1428571428571428,25.33758316894478,4
2020-07-04-171015,171015,0,0,0,189,0.14285714285714285,32.57134390409834,5
2020-07-05-171015,171015,0,0,0,189,0.0,32.344423549456764,6
2020-07-06-171015,171015,0,0,0,189,0.5714285714285714,28.255188092699186,0
2020-07-07-171015,171015,0,0,0,189,0.42857142857142855,28.715244851220966,1
2020-07-08-171015,171015,0,1,0,189,0.8571428571428571,28.248977567709282,2
2020-07-09-171015,171015,0,0,0,189,0.2857142857142857,26.60274797621905,3
2020-07-10-171015,171015,0,0,0,189,0.42857142857142855,47.997366755488684,4
2020-07-11-171015,171015,0,0,0,189,0.14285714285714285,46.77915569766997,5
2020-07-12-171015,171015,0,0,0,189,0.0,42.09232604561683,6
2020-07-13-171015,171015,0,0,0,189,0.0,41.235271161720604,0
2020-07-14-171015,171015,1,0,0,190,0.2857142857142857,41.275747812518304,1
2020-07-15-171015,171015,1,0,0,191,0.5714285714285714,17.085096297415653,2
2020-07-16-171015,171015,3,0,0,194,0.2857142857142857,13.956705755446809,3
2020-07-17-171015,171015,0,0,0,194,0.42857142857142855,13.162570122152921,4
2020-07-18-171015,171015,0,0,0,194,0.0,13.117290497520155,5
2020-07-19-171015,171015,0,0,0,194,0.42857142857142855,12.304421452783934,6
2020-07-20-171015,171015,0,0,0,194,0.2857142857142857,21.826179353380937,0
2020-07-21-171015,171015,0,0,0,194,0.8571428571428571,23.804156814913142,1
2020-07-22-171015,171015,0,0,0,194,0.42857142857142855,26.72592865108846,2
2020-07-23-171015,171015,0,0,0,194,0.5714285714285714,28.04036274494515,3
2020-07-24-171015,171015,0,0,0,194,0.5714285714285714,29.142752920114255,4
2020-07-25-171015,171015,0,0,2,194,0.42857142857142855,34.51045102708192,5
2020-07-26-171015,171015,0,0,0,194,0.14285714285714285,34.2462490914265,6
2020-07-27-171015,171015,0,0,0,194,0.14285714285714285,25.319909754059346,0
2020-07-28-171015,171015,0,0,2,194,0.42857142857142855,26.685784893595674,1
2020-07-29-171015,171015,0,0,1,194,0.7142857142857143,25.737352041497196,2
2020-07-30-171015,171015,0,0,2,194,0.7142857142857143,28.33467395803527,3
2020-07-31-171015,171015,0,0,2,194,0.5714285714285714,30.677946720144888,4
2020-08-01-171015,171015,0,0,2,194,0.7142857142857143,19.23500689916175,5
2020-08-02-171015,171015,0,0,3,194,0.2857142857142857,175.11105840650688,6
2020-08-03-171015,171015,0,0,0,194,1.0,374.1003974442274,0
2020-08-04-171015,171015,0,0,1,194,1.0,400.5681720686805,1
2020-08-05-171015,171015,0,0,2,194,1.0,334.27647144513503,2
2020-08-06-171015,171015,0,0,9,194,1.0,290.8337112208523,3
2020-08-07-171015,171015,0,0,3,194,1.1428571428571428,227.4135846143964,4
2020-08-08-171015,171015,2,0,0,196,0.5714285714285714,172.5549558779829,5
2020-08-09-171015,171015,0,0,2,196,1.0,186.75313839898547,6
2020-08-10-171015,171015,0,0,1,196,0.7142857142857143,16.984913198971164,0
2020-08-11-171015,171015,2,0,6,198,2.0,34.710675445873456,1
2020-08-12-171015,171015,1,0,6,199,1.8571428571428568,68.37920250420572,2
2020-08-13-171015,171015,2,0,3,201,2.2857142857142856,85.6444716657934,3
2020-08-14-171015,171015,2,0,8,203,0.8571428571428571,115.72822285517866,4
2020-08-15-171015,171015,2,0,8,205,1.5714285714285714,140.6861786029471,5
2020-08-16-171015,171015,3,0,3,208,0.5714285714285714,156.22840647214048,6
2020-08-17-171015,171015,0,0,10,208,0.42857142857142855,186.1439965937553,0
2020-08-18-171015,171015,1,0,1,209,2.4285714285714284,178.97406825150068,1
2020-08-19-171015,171015,2,0,3,211,1.7142857142857142,166.57113102319272,2
2020-08-20-171015,171015,9,0,1,220,2.2857142857142856,144.4772031735821,3
2020-08-21-171015,171015,3,0,8,223,2.8571428571428568,180.2064984540758,4
2020-08-22-171015,171015,0,0,5,223,0.0,213.56491251888278,5
2020-08-23-171015,171015,2,1,3,225,1.4285714285714286,197.44302886255056,6
2020-08-24-171015,171015,1,0,0,226,1.4285714285714286,190.35678712198313,0
2020-08-25-171015,171015,6,0,12,232,2.0,207.9273878539651,1
2020-08-26-171015,171015,6,0,17,238,2.142857142857143,224.20759093177313,2
2020-08-27-171015,171015,3,0,9,241,2.0,293.69446194137885,3
2020-08-28-171015,171015,8,0,16,249,3.2857142857142856,285.068988010935,4
2020-08-29-171015,171015,8,0,5,257,0.8571428571428571,308.3151959916613,5
2020-08-30-171015,171015,3,0,1,260,0.7142857142857143,347.72436700744447,6
2020-08-31-171015,171015,10,0,3,270,1.8571428571428568,342.9626869285221,0
2020-09-01-171015,171015,1,0,13,271,0.7142857142857143,135.1936692208023,1
2020-09-02-171015,171015,3,0,7,274,1.0,522.2495641787473,2
2020-09-03-171015,171015,1,0,5,275,4.0,297.51003020551974,3
2020-09-04-171015,171015,8,0,3,283,2.0,259.3698278378334,4
2020-09-05-171015,171015,5,0,4,288,1.2857142857142858,226.2647213816834,5
2020-09-06-171015,171015,3,0,1,291,6.2857142857142865,242.25235926438046,6
2020-09-07-171015,171015,0,0,7,291,2.2857142857142856,271.6339981462076,0
2020-09-08-171015,171015,12,0,9,303,4.0,269.9612421714538,1
2020-09-09-171015,171015,17,0,8,320,3.2857142857142856,335.0023119812822,2
2020-09-10-171015,171015,9,0,5,329,4.285714285714286,74.81812018408132,3
2020-09-11-171015,171015,16,0,3,345,3.2857142857142856,173.48391818816964,4
2020-09-12-171015,171015,5,1,0,350,2.0,277.9150940644402,5
2020-09-13-171015,171015,1,0,1,351,1.2857142857142858,322.4895483481845,6
2020-09-14-171015,171015,3,0,4,354,2.8571428571428568,324.37349956474077,0
2020-09-15-171015,171015,13,0,4,367,6.571428571428571,343.88626255583773,1
2020-09-16-171015,171015,7,0,1,374,7.0,477.36858441162906,2
2020-09-17-171015,171015,5,0,5,379,4.571428571428571,531.067782798066,3
2020-09-18-171015,171015,3,0,3,382,8.857142857142858,533.7706905269996,4
2020-09-19-171015,171015,4,0,0,386,9.285714285714286,464.76229640235135,5
2020-09-20-171015,171015,1,0,0,387,1.7142857142857142,481.09326428263654,6
2020-09-21-171015,171015,7,0,5,394,5.142857142857143,452.20643156668564,0
2020-09-22-171015,171015,9,1,1,403,5.7142857142857135,382.1811598797443,1
2020-09-23-171015,171015,8,0,5,411,5.571428571428571,345.868304639239,2
2020-09-24-171015,171015,5,0,2,416,3.571428571428572,297.9980075317422,3
2020-09-25-171015,171015,3,0,8,419,6.2857142857142865,275.2811821840959,4
2020-09-26-171015,171015,0,0,1,419,4.571428571428571,261.66128591040734,5
2020-09-27-171015,171015,1,0,3,420,1.5714285714285714,280.3579307231306,6
2020-09-28-171015,171015,4,1,0,424,2.142857142857143,285.7864036322436,0
2020-09-29-171015,171015,4,0,3,428,6.857142857142858,257.36468991001516,1
2020-09-30-171015,171015,1,0,4,429,3.1428571428571432,250.5930774492641,2
2020-10-01-171015,171015,5,0,4,434,4.0,0.0,3
2020-10-02-171015,171015,3,0,7,437,4.857142857142857,348.1848680918211,4
2020-10-03-171015,171015,0,2,1,437,1.5714285714285714,586.0385960951414,5
2020-10-04-171015,171015,0,1,3,437,0.7142857142857143,547.0633020276239,6
2020-10-05-171015,171015,5,1,4,442,1.0,469.9474385438944,0
2020-10-06-171015,171015,1,1,7,443,4.285714285714286,418.73355650428596,1
2020-10-07-171015,171015,5,0,9,448,3.1428571428571432,349.1286748269945,2
2020-10-08-171015,171015,2,0,1,450,6.142857142857142,333.8938498179391,3
2020-10-09-171015,171015,8,0,12,458,2.7142857142857144,396.51033244606833,4
2020-10-10-171015,171015,1,0,2,459,1.2857142857142858,43.17036607675585,5
2020-10-11-171015,171015,3,0,0,462,0.2857142857142857,63.69682801678423,6
2020-10-12-171015,171015,0,0,5,462,1.0,90.94615865049332,0
2020-10-13-171015,171015,3,0,7,465,3.4285714285714284,98.91129234712358,1
2020-10-14-171015,171015,4,0,8,469,3.571428571428572,140.98589181700447,2
2020-10-15-171015,171015,4,0,1,473,2.0,201.52191207157392,3
2020-10-16-171015,171015,7,0,13,480,3.2857142857142856,279.00873908116057,4
2020-10-17-171015,171015,1,0,3,481,1.7142857142857142,291.02534091375213,5
2020-10-18-171015,171015,3,0,0,484,1.5714285714285714,284.75940161044286,6
2020-10-19-171015,171015,4,0,0,488,2.8571428571428568,284.39546691859636,0
2020-10-20-171015,171015,7,0,3,495,4.285714285714286,323.18154219439134,1
2020-10-21-171015,171015,9,0,5,504,5.428571428571429,353.0802039953581,2
2020-10-22-171015,171015,1,0,6,505,4.142857142857143,345.41330114983907,3
2020-10-23-171015,171015,12,0,5,517,3.8571428571428568,334.42976376123784,4
2020-10-24-171015,171015,2,0,3,519,5.142857142857143,412.1020279431558,5
2020-10-25-171015,171015,0,1,3,519,1.8571428571428568,431.71963363034047,6
2020-10-26-171015,171015,5,1,2,524,3.0,385.3447793367542,0
2020-10-27-171015,171015,7,0,2,531,4.714285714285714,430.9992702117995,1
2020-10-28-171015,171015,8,0,4,539,5.571428571428571,453.37784486210256,2
2020-10-29-171015,171015,1,0,5,540,5.428571428571429,487.8843342886659,3
2020-10-30-171015,171015,13,0,12,553,5.285714285714286,439.87443249561255,4
2020-10-31-171015,171015,3,0,0,556,3.4285714285714284,477.8079755687389,5
2020-11-01-171015,171015,0,1,0,556,2.4285714285714284,341.5849323647001,6
2020-11-02-171015,171015,0,0,0,556,2.7142857142857144,414.22997689767965,0
2020-11-03-171015,171015,3,1,0,559,4.714285714285714,364.24360079356484,1
2020-11-04-171015,171015,5,0,0,564,6.7142857142857135,421.61698410994944,2
2020-11-05-171015,171015,6,2,0,570,10.0,463.44249580476526,3
2020-11-06-171015,171015,5,0,0,575,6.2857142857142865,512.1534616242889,4
2020-11-07-171015,171015,3,0,0,578,3.1428571428571432,516.938981339851,5
2020-11-08-171015,171015,3,0,0,581,3.571428571428572,503.4939946467527,6
2020-11-09-171015,171015,2,1,0,583,4.0,505.6668837642725,0
2020-11-10-171015,171015,2,0,0,585,8.857142857142858,306.17441129072324,1
2020-11-11-171015,171015,4,0,0,589,5.428571428571429,355.8198220452679,2
2020-11-12-171015,171015,5,0,0,594,4.571428571428571,358.3623760893738,3
2020-11-13-171015,171015,12,2,0,606,6.142857142857142,371.63538387351537,4
2020-03-01-171016,171016,0,0,0,0,0.125,0.0,6
2020-03-02-171016,171016,0,0,2,0,0.25,22.2002268621443,0
2020-03-03-171016,171016,0,0,4,0,0.0,120.67101645936239,1
2020-03-04-171016,171016,0,0,4,0,0.0,133.5406471831467,2
2020-03-05-171016,171016,1,0,3,1,0.0,139.85197784298282,3
2020-03-06-171016,171016,0,0,8,1,0.25,126.10538626189629,4
2020-03-07-171016,171016,0,0,4,1,0.0,133.46393360207207,5
2020-03-08-171016,171016,0,0,9,1,0.0,134.44741088752698,6
2020-03-09-171016,171016,0,0,9,1,0.125,133.403460385676,0
2020-03-10-171016,171016,0,0,16,1,0.125,589.2376415799991,1
2020-03-11-171016,171016,0,0,11,1,0.25,472.7266578053967,2
2020-03-12-171016,171016,0,0,7,1,0.0,320.22779283988865,3
2020-03-13-171016,171016,1,0,7,2,0.75,212.0885833370245,4
2020-03-14-171016,171016,0,0,2,2,0.375,178.16785344042336,5
2020-03-15-171016,171016,0,0,0,2,1.375,113.36177801289239,6
2020-03-16-171016,171016,2,0,10,4,4.625,29.110716611286634,0
2020-03-17-171016,171016,4,1,12,8,5.0,60.59446699074906,1
2020-03-18-171016,171016,4,0,7,12,7.75,82.8180950052725,2
2020-03-19-171016,171016,3,0,7,15,7.625,120.39155517392393,3
2020-03-20-171016,171016,8,1,8,23,9.5,142.0276585126482,4
2020-03-21-171016,171016,4,0,2,27,3.0,174.8305021240185,5
2020-03-22-171016,171016,9,0,0,36,3.0,174.36075382064072,6
2020-03-23-171016,171016,9,0,4,45,11.625,171.1536003856508,0
2020-03-24-171016,171016,16,0,3,61,8.25,194.9257386726236,1
2020-03-25-171016,171016,11,0,6,72,7.375,203.34107754628945,2
2020-03-26-171016,171016,7,1,0,79,8.25,204.56441177388507,3
2020-03-27-171016,171016,7,0,2,86,9.125,233.1247896776342,4
2020-03-28-171016,171016,2,0,13,88,2.125,224.29321976929097,5
2020-03-29-171016,171016,0,0,11,88,3.25,225.31827900548313,6
2020-03-30-171016,171016,10,0,3,98,6.5,172.635056092016,0
2020-03-31-171016,171016,12,0,6,110,4.375,159.97567402549365,1
2020-04-01-171016,171016,7,0,2,117,7.75,29.57000669650421,2
2020-04-02-171016,171016,7,0,5,124,4.875,120.42750228680254,3
2020-04-03-171016,171016,8,0,3,132,7.25,58.57721243828886,4
2020-04-04-171016,171016,2,0,2,134,2.25,77.90325738923977,5
2020-04-05-171016,171016,0,1,0,134,3.375,80.48101404072264,6
2020-04-06-171016,171016,4,0,4,138,10.375,80.6137968816,0
2020-04-07-171016,171016,3,0,6,141,5.625,93.5706990532235,1
2020-04-08-171016,171016,6,0,1,147,4.625,106.01709477487913,2
2020-04-09-171016,171016,0,1,0,147,4.5,119.49866988252333,3
2020-04-10-171016,171016,2,0,5,149,3.375,29.427436448647892,4
2020-04-11-171016,171016,13,0,0,162,2.125,39.79773293902098,5
2020-04-12-171016,171016,11,0,1,173,1.875,60.90297347016295,6
2020-04-13-171016,171016,3,0,4,176,6.5,78.31784374877462,0
2020-04-14-171016,171016,6,0,1,182,3.875,117.24567448737247,1
2020-04-15-171016,171016,2,0,1,184,4.25,141.81515894953802,2
2020-04-16-171016,171016,5,0,7,189,3.625,163.5980521203703,3
2020-04-17-171016,171016,3,0,1,192,3.25,161.14792460245326,4
2020-04-18-171016,171016,2,0,3,194,0.875,171.64106905448443,5
2020-04-19-171016,171016,0,0,0,194,0.5,151.4605813711817,6
2020-04-20-171016,171016,4,0,5,198,4.125,119.45544487706215,0
2020-04-21-171016,171016,6,0,2,204,2.75,113.02040868426593,1
2020-04-22-171016,171016,1,0,8,205,2.625,112.04284561871731,2
2020-04-23-171016,171016,0,0,1,205,0.875,102.6741452102626,3
2020-04-24-171016,171016,5,0,3,210,3.625,84.81496034948275,4
2020-04-25-171016,171016,0,0,0,210,0.5,96.9297976531798,5
2020-04-26-171016,171016,1,0,0,211,2.375,101.11484631169704,6
2020-04-27-171016,171016,4,1,8,215,3.625,81.21951377133203,0
2020-04-28-171016,171016,1,0,3,216,3.625,81.38914408808726,1
2020-04-29-171016,171016,1,0,3,217,2.75,72.0665394704142,2
2020-04-30-171016,171016,7,0,1,224,1.75,104.18691774256914,3
2020-05-01-171016,171016,1,0,1,225,0.625,141.17534517983597,4
2020-05-02-171016,171016,3,1,0,228,0.75,52.03120378249453,5
2020-05-03-171016,171016,0,0,0,228,0.75,42.24948343947199,6
2020-05-04-171016,171016,5,0,3,233,3.5,37.27329911101084,0
2020-05-05-171016,171016,2,0,2,235,2.875,48.988673654731784,1
2020-05-06-171016,171016,8,0,3,243,3.875,46.42610321714005,2
2020-05-07-171016,171016,1,0,0,244,3.75,60.84065241559166,3
2020-05-08-171016,171016,3,0,0,247,2.75,67.14547959897433,4
2020-05-09-171016,171016,0,1,0,247,0.5,85.5850900370819,5
2020-05-10-171016,171016,0,0,0,247,0.375,138.38058365722603,6
2020-05-11-171016,171016,8,0,0,255,1.75,127.81574357871027,0
2020-05-12-171016,171016,3,0,1,258,1.75,140.6579579671238,1
2020-05-13-171016,171016,3,0,3,261,2.375,114.56536123370644,2
2020-05-14-171016,171016,1,0,0,262,3.125,92.43353927545272,3
2020-05-15-171016,171016,1,1,2,263,1.5,77.56715527695093,4
2020-05-16-171016,171016,0,0,0,263,0.625,65.35759181068063,5
2020-05-17-171016,171016,0,0,2,263,1.0,64.37455644172474,6
2020-05-18-171016,171016,3,0,3,266,2.75,65.44635795639849,0
2020-05-19-171016,171016,2,0,1,268,2.75,60.59072456113991,1
2020-05-20-171016,171016,3,0,0,271,3.25,57.96504357125557,2
2020-05-21-171016,171016,0,0,1,271,2.625,58.38839988469529,3
2020-05-22-171016,171016,0,0,1,271,2.875,57.69598597335158,4
2020-05-23-171016,171016,0,0,0,271,0.125,67.80215063097432,5
2020-05-24-171016,171016,0,0,0,271,0.375,66.91504385246203,6
2020-05-25-171016,171016,0,0,4,271,2.25,52.63443589523432,0
2020-05-26-171016,171016,1,0,3,272,1.5,54.36282488088592,1
2020-05-27-171016,171016,3,0,1,275,2.625,58.04046623003151,2
2020-05-28-171016,171016,0,1,1,275,1.0,64.18752006291416,3
2020-05-29-171016,171016,2,0,1,277,1.375,63.7824642235279,4
2020-05-30-171016,171016,0,0,0,277,0.25,65.8171533279942,5
2020-05-31-171016,171016,2,0,0,279,0.125,69.88685600884311,6
2020-06-01-171016,171016,3,0,3,282,2.25,131.53267825462012,0
2020-06-02-171016,171016,1,0,2,283,1.5,50.67307554778054,1
2020-06-03-171016,171016,0,1,0,283,1.0,34.00367575347556,2
2020-06-04-171016,171016,1,0,0,284,0.875,33.953019216871326,3
2020-06-05-171016,171016,1,0,4,285,1.0,37.4237838835552,4
2020-06-06-171016,171016,0,0,0,285,0.125,40.144626144582105,5
2020-06-07-171016,171016,0,0,0,285,0.5,39.14118148464799,6
2020-06-08-171016,171016,4,0,1,289,0.75,39.54222386373405,0
2020-06-09-171016,171016,3,0,1,292,0.625,43.06742001760067,1
2020-06-10-171016,171016,1,0,2,293,1.0,146.15069685057676,2
2020-06-11-171016,171016,1,0,0,294,2.375,122.47059919595685,3
2020-06-12-171016,171016,1,0,1,295,0.5,110.83188550051814,4
2020-06-13-171016,171016,0,0,0,295,0.0,86.98545545325283,5
2020-06-14-171016,171016,0,0,0,295,0.125,66.63039390507234,6
2020-06-15-171016,171016,3,2,1,298,1.5,45.94474360842975,0
2020-06-16-171016,171016,2,0,2,300,1.5,54.577246040643985,1
2020-06-17-171016,171016,0,0,0,300,1.125,49.92080563371171,2
2020-06-18-171016,171016,0,0,0,300,1.25,49.29778691274819,3
2020-06-19-171016,171016,4,0,3,304,1.875,46.76318302287482,4
2020-06-20-171016,171016,0,0,1,304,0.5,63.50269495579723,5
2020-06-21-171016,171016,0,0,0,304,0.375,65.99552777222256,6
2020-06-22-171016,171016,1,0,1,305,0.75,55.168686426409664,0
2020-06-23-171016,171016,1,2,0,306,1.125,48.527033153578486,1
2020-06-24-171016,171016,2,0,2,308,0.75,51.22673060810025,2
2020-06-25-171016,171016,0,0,0,308,0.625,50.67303855239584,3
2020-06-26-171016,171016,1,0,2,309,0.625,42.114324251164746,4
2020-06-27-171016,171016,0,0,0,309,0.125,38.71666377116166,5
2020-06-28-171016,171016,0,0,0,309,0.125,38.33445502732776,6
2020-06-29-171016,171016,1,0,0,310,1.125,38.572284478632426,0
2020-06-30-171016,171016,2,0,1,312,0.5,41.50928450636191,1
2020-07-01-171016,171016,0,0,2,312,1.0,55.20925056685959,2
2020-07-02-171016,171016,0,0,2,312,0.375,33.719631688492164,3
2020-07-03-171016,171016,3,0,3,315,1.0,37.55965672948838,4
2020-07-04-171016,171016,1,0,0,316,0.125,44.80351710541305,5
2020-07-05-171016,171016,0,0,2,316,0.0,43.82231592350893,6
2020-07-06-171016,171016,1,0,2,317,0.875,36.10797821293071,0
2020-07-07-171016,171016,0,0,3,317,0.75,35.038417640605346,1
2020-07-08-171016,171016,2,1,1,319,1.0,31.660082763125406,2
2020-07-09-171016,171016,0,0,0,319,0.375,31.04698020136604,3
2020-07-10-171016,171016,2,0,0,321,0.375,48.227651166035514,4
2020-07-11-171016,171016,0,0,0,321,0.125,46.06345622207651,5
2020-07-12-171016,171016,0,0,1,321,0.125,39.695460980707026,6
2020-07-13-171016,171016,0,0,0,321,0.5,40.92109853476085,0
2020-07-14-171016,171016,1,0,0,322,0.5,43.09779879584778,1
2020-07-15-171016,171016,2,0,1,324,1.0,32.06157362837059,2
2020-07-16-171016,171016,2,0,0,326,1.5,26.6831660228358,3
2020-07-17-171016,171016,3,0,0,329,0.75,26.002991617205154,4
2020-07-18-171016,171016,0,0,3,329,0.125,28.187747326184024,5
2020-07-19-171016,171016,2,0,0,331,0.25,25.98913616409353,6
2020-07-20-171016,171016,2,0,1,333,0.625,30.219983362070355,0
2020-07-21-171016,171016,3,0,3,336,1.0,33.76612988971534,1
2020-07-22-171016,171016,1,0,3,337,0.375,34.45166304958558,2
2020-07-23-171016,171016,0,1,0,337,1.125,35.99827535042158,3
2020-07-24-171016,171016,0,0,2,337,1.875,32.65227369437707,4
2020-07-25-171016,171016,0,0,1,337,0.5,38.63773194279563,5
2020-07-26-171016,171016,1,0,1,338,0.125,33.28360044758335,6
2020-07-27-171016,171016,0,0,1,338,2.375,31.33245059537708,0
2020-07-28-171016,171016,0,0,3,338,2.375,33.10271158579266,1
2020-07-29-171016,171016,1,0,0,339,1.875,32.5757972461919,2
2020-07-30-171016,171016,0,0,4,339,2.625,37.31306102938363,3
2020-07-31-171016,171016,0,0,1,339,2.625,37.44322165303679,4
2020-08-01-171016,171016,3,0,3,342,0.0,25.176392090023853,5
2020-08-02-171016,171016,0,0,1,342,0.375,109.04253858674531,6
2020-08-03-171016,171016,1,0,0,343,1.75,255.31040633770203,0
2020-08-04-171016,171016,3,0,6,346,1.625,225.9257524610773,1
2020-08-05-171016,171016,3,0,3,349,1.75,192.79915167609482,2
2020-08-06-171016,171016,0,0,6,349,1.625,155.53377158334035,3
2020-08-07-171016,171016,2,0,6,351,2.0,103.08342257830425,4
2020-08-08-171016,171016,1,0,0,352,1.125,95.05508348627289,5
2020-08-09-171016,171016,1,0,1,353,0.875,98.66195364004896,6
2020-08-10-171016,171016,1,0,2,354,1.125,26.584171283800895,0
2020-08-11-171016,171016,3,0,6,357,2.875,32.841562868587474,1
2020-08-12-171016,171016,0,0,8,357,1.5,51.799955584750165,2
2020-08-13-171016,171016,4,0,5,361,1.5,55.9283787914071,3
2020-08-14-171016,171016,1,0,12,362,2.0,70.86922030677336,4
2020-08-15-171016,171016,3,1,1,365,0.75,78.80971250550763,5
2020-08-16-171016,171016,1,0,1,366,0.625,82.0891041701376,6
2020-08-17-171016,171016,0,0,6,366,1.0,85.20933079722442,0
2020-08-18-171016,171016,6,0,3,372,2.125,85.78206387597378,1
2020-08-19-171016,171016,3,0,3,375,2.25,86.36784759825474,2
2020-08-20-171016,171016,6,0,4,381,3.5,84.91396804039312,3
2020-08-21-171016,171016,6,0,1,387,3.875,102.8964060298103,4
2020-08-22-171016,171016,0,0,4,387,0.875,126.00257334078222,5
2020-08-23-171016,171016,1,1,18,388,1.75,130.17249471000628,6
2020-08-24-171016,171016,2,0,4,390,3.5,130.14636314865655,0
2020-08-25-171016,171016,6,0,4,396,5.125,140.40670945506957,1
2020-08-26-171016,171016,8,0,5,404,4.25,160.9348247365698,2
2020-08-27-171016,171016,5,0,3,409,6.375,195.19099682156644,3
2020-08-28-171016,171016,12,0,4,421,5.0,206.22544389092656,4
2020-08-29-171016,171016,1,0,2,422,1.5,225.6894457861707,5
2020-08-30-171016,171016,1,0,0,423,1.625,222.98212633347168,6
2020-08-31-171016,171016,6,0,7,429,3.125,205.25060298945556,0
2020-09-01-171016,171016,3,0,17,432,2.5,86.01351707318682,1
2020-09-02-171016,171016,3,0,4,435,4.125,295.93801947111797,2
2020-09-03-171016,171016,4,1,8,439,3.375,271.6030867431534,3
2020-09-04-171016,171016,1,0,3,440,3.25,239.9597188429522,4
2020-09-05-171016,171016,4,0,2,444,1.875,213.9489924462194,5
2020-09-06-171016,171016,18,0,2,462,2.0,184.65043267162753,6
2020-09-07-171016,171016,4,0,14,466,4.5,212.51442195090112,0
2020-09-08-171016,171016,4,0,20,470,6.5,221.32471091316427,1
2020-09-09-171016,171016,5,0,15,475,7.125,206.8445264415844,2
2020-09-10-171016,171016,3,0,10,478,10.0,66.81895613373607,3
2020-09-11-171016,171016,4,0,13,482,7.625,111.2309776248878,4
2020-09-12-171016,171016,2,0,17,484,3.875,151.7745463160675,5
2020-09-13-171016,171016,0,0,1,484,2.25,168.43355396977157,6
2020-09-14-171016,171016,7,1,7,491,7.5,170.32784517828335,0
2020-09-15-171016,171016,17,0,10,508,10.875,210.35857839100618,1
2020-09-16-171016,171016,4,0,4,512,10.5,276.18538725849197,2
2020-09-17-171016,171016,8,0,10,520,7.25,312.42986261886097,3
2020-09-18-171016,171016,3,0,15,523,11.625,305.1251590879038,4
2020-09-19-171016,171016,2,0,7,525,11.125,289.6856401637059,5
2020-09-20-171016,171016,2,0,3,527,2.0,306.3610410543322,6
2020-09-21-171016,171016,14,0,2,541,8.625,266.6375540977463,0
2020-09-22-171016,171016,20,3,10,561,8.25,253.3889894189615,1
2020-09-23-171016,171016,15,0,11,576,9.625,247.9422855162449,2
2020-09-24-171016,171016,10,1,9,586,7.875,242.02492086818086,3
2020-09-25-171016,171016,13,0,4,599,7.375,251.94473791987969,4
2020-09-26-171016,171016,17,0,0,616,5.875,269.4629616239525,5
2020-09-27-171016,171016,1,1,0,617,1.5,304.4917856819139,6
2020-09-28-171016,171016,7,0,2,624,3.0,303.51437953758426,0
2020-09-29-171016,171016,10,0,10,634,5.375,279.4031964632758,1
2020-09-30-171016,171016,4,0,4,638,6.0,249.60161208880973,2
2020-10-01-171016,171016,10,1,6,648,7.5,0.0,3
2020-10-02-171016,171016,15,0,7,663,6.375,274.41122640565095,4
2020-10-03-171016,171016,7,1,5,670,1.75,494.20891068572405,5
2020-10-04-171016,171016,3,0,2,673,1.625,520.4973668385041,6
2020-10-05-171016,171016,2,0,6,675,3.625,456.6896641327098,0
2020-10-06-171016,171016,10,0,6,685,8.0,416.7449292630417,1
2020-10-07-171016,171016,11,0,9,696,5.25,378.0627691686367,2
2020-10-08-171016,171016,9,2,12,705,5.875,336.25522678622343,3
2020-10-09-171016,171016,4,2,3,709,4.625,364.9182774925581,4
2020-10-10-171016,171016,0,0,6,709,2.625,47.43418130873218,5
2020-10-11-171016,171016,0,0,4,709,2.0,64.57283309402845,6
2020-10-12-171016,171016,2,0,12,711,1.375,73.4520007198289,0
2020-10-13-171016,171016,10,0,13,721,5.875,81.28704860513412,1
2020-10-14-171016,171016,4,0,16,725,6.125,123.68322965035277,2
2020-10-15-171016,171016,6,0,14,731,4.375,163.4570544469016,3
2020-10-16-171016,171016,7,0,14,738,7.875,206.55683681767948,4
2020-10-17-171016,171016,5,0,12,743,3.5,200.69977765419063,5
2020-10-18-171016,171016,2,0,2,745,2.75,209.31923185880197,6
2020-10-19-171016,171016,6,0,6,751,5.875,218.78756049063634,0
2020-10-20-171016,171016,6,1,5,757,15.125,269.77391276729264,1
2020-10-21-171016,171016,9,0,23,766,7.875,308.9279828069194,2
2020-10-22-171016,171016,12,0,11,778,7.625,329.96174213809354,3
2020-10-23-171016,171016,3,0,19,781,10.875,349.858806159668,4
2020-10-24-171016,171016,6,2,3,787,7.625,407.8884311139376,5
2020-10-25-171016,171016,4,1,12,791,2.5,424.47637282235263,6
2020-10-26-171016,171016,12,1,15,803,7.25,387.4571095898414,0
2020-10-27-171016,171016,13,2,15,816,9.875,427.1965041664139,1
2020-10-28-171016,171016,16,0,9,832,10.75,431.3228420806237,2
2020-10-29-171016,171016,14,1,9,846,11.875,460.8576602356909,3
2020-10-30-171016,171016,14,0,13,860,11.75,426.48240144481247,4
2020-10-31-171016,171016,12,0,0,872,7.25,486.32810057838526,5
2020-11-01-171016,171016,2,0,0,874,8.0,296.1150636885527,6
2020-11-02-171016,171016,6,1,0,880,5.25,382.0345425223171,0
2020-11-03-171016,171016,5,0,0,885,8.75,340.81629701820873,1
2020-11-04-171016,171016,23,1,0,908,13.0,403.4793613062146,2
2020-11-05-171016,171016,11,0,0,919,19.25,444.2463388047819,3
2020-11-06-171016,171016,19,0,0,938,12.125,513.6959222131486,4
2020-11-07-171016,171016,3,0,0,941,5.125,551.0214949632258,5
2020-11-08-171016,171016,12,0,0,953,7.75,515.5667168539753,6
2020-11-09-171016,171016,15,1,0,968,8.875,535.2606881955044,0
2020-11-10-171016,171016,15,0,0,983,10.625,278.6681121910339,1
2020-11-11-171016,171016,9,1,0,992,6.375,343.35072060182097,2
2020-11-12-171016,171016,9,1,0,1001,7.625,367.6721504122393,3
2020-11-13-171016,171016,13,0,0,1014,9.375,386.3186154505544,4
2020-03-01-171017,171017,0,0,0,0,0.0,0.0,6
2020-03-02-171017,171017,0,0,1,0,0.2857142857142857,10.609359910722532,0
2020-03-03-171017,171017,0,1,0,0,0.0,56.356546195438106,1
2020-03-04-171017,171017,0,0,1,0,0.14285714285714285,59.116216971233044,2
2020-03-05-171017,171017,0,2,2,0,0.14285714285714285,62.32546109013769,3
2020-03-06-171017,171017,0,0,3,0,0.42857142857142855,56.708649126198104,4
2020-03-07-171017,171017,0,1,0,0,0.0,57.92089554086092,5
2020-03-08-171017,171017,0,1,0,0,0.0,59.44003709531757,6
2020-03-09-171017,171017,0,0,2,0,0.14285714285714285,59.7445441071858,0
2020-03-10-171017,171017,0,0,6,0,0.14285714285714285,377.56199830757873,1
2020-03-11-171017,171017,0,1,1,0,0.2857142857142857,305.1373408384525,2
2020-03-12-171017,171017,0,0,2,0,0.2857142857142857,192.04726844228622,3
2020-03-13-171017,171017,0,0,3,0,1.5714285714285714,127.19823045849117,4
2020-03-14-171017,171017,0,0,1,0,0.42857142857142855,94.04257358931588,5
2020-03-15-171017,171017,0,0,0,0,1.5714285714285714,69.66176618590615,6
2020-03-16-171017,171017,1,0,0,1,4.285714285714286,9.941066451581275,0
2020-03-17-171017,171017,0,0,1,1,4.0,23.403977123199848,1
2020-03-18-171017,171017,1,0,1,2,9.571428571428571,32.54714160499171,2
2020-03-19-171017,171017,2,0,1,4,8.285714285714286,49.7402507651276,3
2020-03-20-171017,171017,3,0,1,7,9.571428571428571,68.09017739271373,4
2020-03-21-171017,171017,0,1,1,7,4.142857142857143,88.81576118335943,5
2020-03-22-171017,171017,0,0,0,7,4.285714285714286,93.78912419539856,6
2020-03-23-171017,171017,2,0,2,9,12.142857142857142,92.15874876960547,0
2020-03-24-171017,171017,6,0,1,15,10.571428571428571,110.53233081438987,1
2020-03-25-171017,171017,1,0,3,16,11.285714285714285,120.63267814874612,2
2020-03-26-171017,171017,2,0,1,18,9.142857142857142,119.73516194014125,3
2020-03-27-171017,171017,3,0,1,21,7.428571428571429,137.08725933783265,4
2020-03-28-171017,171017,1,0,3,22,4.0,133.42461726211036,5
2020-03-29-171017,171017,0,0,1,22,3.0,131.5045148365732,6
2020-03-30-171017,171017,0,0,16,22,9.285714285714286,98.58028180398665,0
2020-03-31-171017,171017,1,0,2,23,7.142857142857142,87.35739895920572,1
2020-04-01-171017,171017,1,0,3,24,7.571428571428571,16.980793440760653,2
2020-04-02-171017,171017,1,0,4,25,5.142857142857143,95.68604320868666,3
2020-04-03-171017,171017,1,0,2,26,5.857142857142858,43.158742418921165,4
2020-04-04-171017,171017,1,0,0,27,2.142857142857143,51.74121648642842,5
2020-04-05-171017,171017,0,1,0,27,2.571428571428572,56.03631701980655,6
2020-04-06-171017,171017,2,0,2,29,10.571428571428571,56.51506926144619,0
2020-04-07-171017,171017,1,0,3,30,10.571428571428571,77.13948770070121,1
2020-04-08-171017,171017,3,0,0,33,6.2857142857142865,94.77990599854381,2
2020-04-09-171017,171017,1,0,0,34,4.571428571428571,104.66399686508858,3
2020-04-10-171017,171017,1,0,2,35,4.714285714285714,15.575142210699497,4
2020-04-11-171017,171017,3,0,2,38,10.428571428571429,24.293836039815684,5
2020-04-12-171017,171017,1,0,0,39,4.0,38.55480697488923,6
2020-04-13-171017,171017,16,0,3,55,15.0,49.21080142743416,0
2020-04-14-171017,171017,2,0,0,57,10.857142857142858,91.05128745144084,1
2020-04-15-171017,171017,3,0,0,60,7.428571428571429,105.97545460718521,2
2020-04-16-171017,171017,4,0,0,64,4.0,122.53525597810489,3
2020-04-17-171017,171017,2,0,0,66,4.714285714285714,123.42540149607002,4
2020-04-18-171017,171017,0,0,1,66,1.2857142857142858,128.07768727139475,5
2020-04-19-171017,171017,0,0,0,66,0.42857142857142855,113.87289735760083,6
2020-04-20-171017,171017,2,0,3,68,5.142857142857143,71.48359925651869,0
2020-04-21-171017,171017,3,0,0,71,4.142857142857143,68.44630839219069,1
2020-04-22-171017,171017,0,0,2,71,3.1428571428571432,62.04285546377616,2
2020-04-23-171017,171017,0,0,0,71,0.7142857142857143,55.02150077957303,3
2020-04-24-171017,171017,2,0,0,73,4.142857142857143,43.926168300745545,4
2020-04-25-171017,171017,2,0,1,75,0.7142857142857143,54.677721023034145,5
2020-04-26-171017,171017,0,0,0,75,1.1428571428571428,59.282479429397355,6
2020-04-27-171017,171017,3,0,1,78,4.285714285714286,47.484857827386136,0
2020-04-28-171017,171017,0,0,0,78,3.0,51.49907315456087,1
2020-04-29-171017,171017,0,0,0,78,3.0,44.05980538106013,2
2020-04-30-171017,171017,0,0,4,78,4.714285714285714,61.76074877601447,3
2020-05-01-171017,171017,0,0,0,78,0.14285714285714285,107.80911695645972,4
2020-05-02-171017,171017,1,0,0,79,0.7142857142857143,36.869044802296415,5
2020-05-03-171017,171017,0,0,0,79,0.7142857142857143,32.62209382131859,6
2020-05-04-171017,171017,3,0,1,82,4.285714285714286,29.181505589507886,0
2020-05-05-171017,171017,0,0,0,82,3.8571428571428568,37.00272174887846,1
2020-05-06-171017,171017,2,0,0,84,4.571428571428571,35.25818092443291,2
2020-05-07-171017,171017,0,0,0,84,3.2857142857142856,40.32484011518778,3
2020-05-08-171017,171017,0,0,0,84,3.2857142857142856,41.115681241751815,4
2020-05-09-171017,171017,1,0,0,85,0.5714285714285714,53.851407140174565,5
2020-05-10-171017,171017,0,0,0,85,0.2857142857142857,113.18841857577803,6
2020-05-11-171017,171017,1,0,0,86,3.7142857142857135,103.74851464752797,0
2020-05-12-171017,171017,0,0,0,86,4.142857142857143,116.52447743774532,1
2020-05-13-171017,171017,0,0,4,86,1.8571428571428568,84.87722633693765,2
2020-05-14-171017,171017,4,0,0,90,2.8571428571428568,61.39162053292071,3
2020-05-15-171017,171017,0,1,0,90,3.1428571428571432,53.79590377777676,4
2020-05-16-171017,171017,0,0,0,90,0.14285714285714285,45.186966924272184,5
2020-05-17-171017,171017,0,0,0,90,0.2857142857142857,42.51565012387675,6
2020-05-18-171017,171017,1,0,1,91,3.2857142857142856,42.89403208881861,0
2020-05-19-171017,171017,0,0,0,91,3.0,42.18887552591312,1
2020-05-20-171017,171017,0,0,1,91,2.0,43.361505007975666,2
2020-05-21-171017,171017,0,0,0,91,2.2857142857142856,34.33915143296646,3
2020-05-22-171017,171017,0,0,0,91,2.142857142857143,33.87981320946052,4
2020-05-23-171017,171017,0,0,0,91,0.2857142857142857,39.0906816492182,5
2020-05-24-171017,171017,0,0,0,91,0.2857142857142857,39.16522856461593,6
2020-05-25-171017,171017,0,0,0,91,3.7142857142857135,28.056898047590984,0
2020-05-26-171017,171017,0,0,0,91,2.571428571428572,29.22815696066764,1
2020-05-27-171017,171017,4,0,0,95,2.8571428571428568,29.790062601123665,2
2020-05-28-171017,171017,0,1,0,95,2.7142857142857144,37.9041587126868,3
2020-05-29-171017,171017,0,1,0,95,2.4285714285714284,45.32734623796057,4
2020-05-30-171017,171017,0,0,0,95,0.42857142857142855,51.03163479525345,5
2020-05-31-171017,171017,0,0,0,95,0.8571428571428571,53.490739600355,6
2020-06-01-171017,171017,1,0,0,96,1.8571428571428568,80.45210172221044,0
2020-06-02-171017,171017,0,0,0,96,1.7142857142857142,25.21388523731153,1
2020-06-03-171017,171017,1,0,0,97,1.7142857142857142,19.217021778088807,2
2020-06-04-171017,171017,0,0,0,97,2.0,23.218215610148746,3
2020-06-05-171017,171017,0,0,0,97,1.2857142857142858,25.804241840961254,4
2020-06-06-171017,171017,0,0,0,97,0.0,25.921907246599112,5
2020-06-07-171017,171017,0,0,0,97,0.2857142857142857,25.598171805829278,6
2020-06-08-171017,171017,0,0,0,97,1.7142857142857142,26.27271639855368,0
2020-06-09-171017,171017,0,0,0,97,1.2857142857142858,30.914569829163653,1
2020-06-10-171017,171017,0,0,0,97,2.142857142857143,87.06844953716126,2
2020-06-11-171017,171017,0,0,0,97,2.0,72.25662294142518,3
2020-06-12-171017,171017,0,0,0,97,1.7142857142857142,69.03601673450618,4
2020-06-13-171017,171017,0,0,0,97,0.2857142857142857,53.20915215352633,5
2020-06-14-171017,171017,0,1,0,97,0.14285714285714285,44.09323814082728,6
2020-06-15-171017,171017,0,0,0,97,2.0,30.268753801465028,0
2020-06-16-171017,171017,0,0,0,97,1.8571428571428568,30.98239184429834,1
2020-06-17-171017,171017,0,0,0,97,1.2857142857142858,26.439154773863446,2
2020-06-18-171017,171017,0,0,0,97,1.2857142857142858,25.517347326218214,3
2020-06-19-171017,171017,0,0,0,97,2.0,23.20467074186451,4
2020-06-20-171017,171017,0,0,0,97,0.42857142857142855,30.360700070830426,5
2020-06-21-171017,171017,0,0,0,97,0.14285714285714285,31.299707536659938,6
2020-06-22-171017,171017,0,0,0,97,0.8571428571428571,27.644249982189535,0
2020-06-23-171017,171017,0,0,0,97,1.0,25.493987103827067,1
2020-06-24-171017,171017,0,1,0,97,1.0,25.963209361550902,2
2020-06-25-171017,171017,0,0,1,97,0.8571428571428571,26.11694834559471,3
2020-06-26-171017,171017,0,0,0,97,0.7142857142857143,21.695034585731264,4
2020-06-27-171017,171017,0,0,0,97,0.42857142857142855,21.79468699776785,5
2020-06-28-171017,171017,0,0,0,97,0.0,21.90700468324242,6
2020-06-29-171017,171017,0,0,0,97,1.5714285714285714,21.773033678302752,0
2020-06-30-171017,171017,0,0,0,97,0.8571428571428571,28.51427868711255,1
2020-07-01-171017,171017,0,0,0,97,0.2857142857142857,33.06405139043059,2
2020-07-02-171017,171017,0,0,0,97,0.2857142857142857,24.20426967438599,3
2020-07-03-171017,171017,0,0,0,97,1.0,25.40442830347689,4
2020-07-04-171017,171017,0,0,0,97,0.2857142857142857,24.3826220531205,5
2020-07-05-171017,171017,0,0,1,97,0.14285714285714285,23.576486531825296,6
2020-07-06-171017,171017,0,0,0,97,0.5714285714285714,19.396767907918957,0
2020-07-07-171017,171017,0,0,0,97,0.0,19.005446294383916,1
2020-07-08-171017,171017,0,0,0,97,1.0,16.636581282652436,2
2020-07-09-171017,171017,1,0,0,98,0.14285714285714285,16.465620214659268,3
2020-07-10-171017,171017,0,0,0,98,0.8571428571428571,30.26275870836064,4
2020-07-11-171017,171017,0,0,0,98,0.42857142857142855,26.61969367418415,5
2020-07-12-171017,171017,0,0,0,98,0.0,22.81527175815778,6
2020-07-13-171017,171017,0,0,0,98,0.8571428571428571,23.20466490203644,0
2020-07-14-171017,171017,0,0,0,98,0.8571428571428571,24.214809494206,1
2020-07-15-171017,171017,0,0,0,98,1.4285714285714286,17.70108774707658,2
2020-07-16-171017,171017,0,0,0,98,1.2857142857142858,14.445773044397122,3
2020-07-17-171017,171017,0,0,0,98,1.1428571428571428,16.126268592403193,4
2020-07-18-171017,171017,0,0,0,98,0.14285714285714285,18.43207262331203,5
2020-07-19-171017,171017,1,0,0,99,0.2857142857142857,17.936217409300575,6
2020-07-20-171017,171017,0,0,0,99,1.0,22.129855098052435,0
2020-07-21-171017,171017,0,0,0,99,1.0,23.192425429286544,1
2020-07-22-171017,171017,0,0,0,99,0.7142857142857143,23.31800819944289,2
2020-07-23-171017,171017,0,0,0,99,0.2857142857142857,21.936818307976832,3
2020-07-24-171017,171017,0,0,0,99,1.0,21.832336752965027,4
2020-07-25-171017,171017,0,0,0,99,0.0,27.309205253419357,5
2020-07-26-171017,171017,0,0,1,99,0.14285714285714285,23.723678923374564,6
2020-07-27-171017,171017,0,0,0,99,1.0,21.469837551175885,0
2020-07-28-171017,171017,0,0,4,99,1.1428571428571428,21.889309423758196,1
2020-07-29-171017,171017,0,0,0,99,1.1428571428571428,21.468572074820685,2
2020-07-30-171017,171017,0,0,0,99,1.4285714285714286,21.509599340447178,3
2020-07-31-171017,171017,0,0,1,99,0.7142857142857143,20.77147058361738,4
2020-08-01-171017,171017,0,0,0,99,0.42857142857142855,12.315966493984604,5
2020-08-02-171017,171017,0,0,0,99,0.42857142857142855,68.68262114276413,6
2020-08-03-171017,171017,0,0,0,99,0.14285714285714285,136.0725408647629,0
2020-08-04-171017,171017,0,0,0,99,0.7142857142857143,127.4951082829169,1
2020-08-05-171017,171017,0,0,1,99,0.8571428571428571,101.97309882587078,2
2020-08-06-171017,171017,0,0,0,99,0.14285714285714285,87.8464154899437,3
2020-08-07-171017,171017,0,0,0,99,1.1428571428571428,66.33490571247467,4
2020-08-08-171017,171017,0,0,0,99,0.42857142857142855,56.20591780036777,5
2020-08-09-171017,171017,1,0,1,100,0.2857142857142857,56.607733738242786,6
2020-08-10-171017,171017,0,0,0,100,1.1428571428571428,11.364870658112102,0
2020-08-11-171017,171017,4,0,0,104,2.2857142857142856,13.371915154957478,1
2020-08-12-171017,171017,0,0,0,104,0.5714285714285714,26.061202093973552,2
2020-08-13-171017,171017,0,0,1,104,1.4285714285714286,25.993611786713267,3
2020-08-14-171017,171017,1,0,0,105,1.1428571428571428,34.03065486848912,4
2020-08-15-171017,171017,0,0,0,105,2.2857142857142856,39.225235692113614,5
2020-08-16-171017,171017,0,0,0,105,0.8571428571428571,40.19316529176608,6
2020-08-17-171017,171017,0,0,5,105,1.0,40.747646875334155,0
2020-08-18-171017,171017,0,0,1,105,3.2857142857142856,43.65141749591545,1
2020-08-19-171017,171017,1,1,0,106,4.0,41.27839409168027,2
2020-08-20-171017,171017,0,0,0,106,5.857142857142858,52.8629840649105,3
2020-08-21-171017,171017,0,0,3,106,4.142857142857143,63.110714151109164,4
2020-08-22-171017,171017,0,0,2,106,2.0,73.38925250356657,5
2020-08-23-171017,171017,1,0,0,107,1.7142857142857142,77.60904174812286,6
2020-08-24-171017,171017,0,0,2,107,5.142857142857143,77.02088872054395,0
2020-08-25-171017,171017,0,0,0,107,8.428571428571429,81.77070906892024,1
2020-08-26-171017,171017,0,0,1,107,7.7142857142857135,83.0590384867258,2
2020-08-27-171017,171017,1,0,5,108,8.0,105.13206436149648,3
2020-08-28-171017,171017,0,0,4,108,7.142857142857142,109.12020687611599,4
2020-08-29-171017,171017,0,0,0,108,2.571428571428572,116.78210016581214,5
2020-08-30-171017,171017,0,0,0,108,2.2857142857142856,118.97115204031891,6
2020-08-31-171017,171017,5,0,4,113,4.428571428571429,113.61565241042153,0
2020-09-01-171017,171017,1,0,3,114,4.142857142857143,49.09614184044272,1
2020-09-02-171017,171017,0,0,7,114,5.428571428571429,234.78122949631938,2
2020-09-03-171017,171017,0,0,0,114,3.571428571428572,236.47605874702856,3
2020-09-04-171017,171017,3,0,0,117,3.7142857142857135,181.65640498542905,4
2020-09-05-171017,171017,2,0,0,119,2.142857142857143,154.5563039189246,5
2020-09-06-171017,171017,0,0,0,119,3.8571428571428568,125.64035512738185,6
2020-09-07-171017,171017,2,0,5,121,7.0,133.17633298114288,0
2020-09-08-171017,171017,0,0,4,121,3.8571428571428568,145.54351325121718,1
2020-09-09-171017,171017,1,0,0,122,5.142857142857143,135.02503420077036,2
2020-09-10-171017,171017,5,0,4,127,5.571428571428571,36.790171867575296,3
2020-09-11-171017,171017,4,0,5,131,5.571428571428571,64.21766072320798,4
2020-09-12-171017,171017,0,0,4,131,3.1428571428571432,84.36047868541871,5
2020-09-13-171017,171017,0,0,0,131,2.0,102.70147048397293,6
2020-09-14-171017,171017,4,0,0,135,9.571428571428571,110.40147881022907,0
2020-09-15-171017,171017,3,0,0,138,10.285714285714286,154.03669748280595,1
2020-09-16-171017,171017,7,0,2,145,8.857142857142858,196.55523032653173,2
2020-09-17-171017,171017,0,0,6,145,8.0,232.62380654474518,3
2020-09-18-171017,171017,0,0,1,145,7.571428571428571,235.762398664808,4
2020-09-19-171017,171017,0,1,0,145,4.142857142857143,238.95970684754627,5
2020-09-20-171017,171017,0,0,0,145,2.7142857142857144,245.5906023244367,6
2020-09-21-171017,171017,5,0,9,150,8.285714285714286,209.63255772236735,0
2020-09-22-171017,171017,4,0,2,154,9.714285714285714,201.49813022403367,1
2020-09-23-171017,171017,0,0,7,154,11.0,181.64785685498853,2
2020-09-24-171017,171017,4,0,1,158,9.0,189.0385860832435,3
2020-09-25-171017,171017,5,0,1,163,10.714285714285714,220.28600087704143,4
2020-09-26-171017,171017,4,0,0,167,8.142857142857142,229.0806420871098,5
2020-09-27-171017,171017,0,0,1,167,1.1428571428571428,263.75918500256995,6
2020-09-28-171017,171017,0,0,0,167,4.142857142857143,259.74795018847635,0
2020-09-29-171017,171017,0,0,3,167,4.857142857142857,244.55783060046608,1
2020-09-30-171017,171017,2,0,6,169,6.7142857142857135,213.01700223939122,2
2020-10-01-171017,171017,6,0,6,175,7.428571428571429,0.0,3
2020-10-02-171017,171017,1,0,2,176,9.428571428571429,190.0611697501077,4
2020-10-03-171017,171017,0,0,0,176,5.285714285714286,336.80807417059856,5
2020-10-04-171017,171017,0,0,3,176,1.2857142857142858,383.9130158067418,6
2020-10-05-171017,171017,9,0,7,185,4.142857142857143,321.29852369562934,0
2020-10-06-171017,171017,2,0,17,187,10.142857142857142,298.20955655895114,1
2020-10-07-171017,171017,7,1,5,194,9.0,294.65688670786074,2
2020-10-08-171017,171017,1,0,4,195,7.571428571428571,245.99157801163634,3
2020-10-09-171017,171017,1,0,0,196,6.428571428571429,258.2250128252661,4
2020-10-10-171017,171017,0,0,3,196,1.8571428571428568,38.593239005409096,5
2020-10-11-171017,171017,1,0,3,197,1.5714285714285714,50.855655333343584,6
2020-10-12-171017,171017,0,0,0,197,1.5714285714285714,61.89152093255425,0
2020-10-13-171017,171017,3,0,4,200,8.428571428571429,65.56726782781112,1
2020-10-14-171017,171017,6,0,3,206,7.7142857142857135,90.61022075356178,2
2020-10-15-171017,171017,6,0,7,212,7.7142857142857135,114.5728683607455,3
2020-10-16-171017,171017,2,0,3,214,7.857142857142858,143.86015534249879,4
2020-10-17-171017,171017,0,0,3,214,4.714285714285714,133.2173789615283,5
2020-10-18-171017,171017,3,0,0,217,2.7142857142857144,145.28482130021914,6
2020-10-19-171017,171017,7,0,2,224,6.2857142857142865,149.2208719506342,0
2020-10-20-171017,171017,17,0,6,241,14.571428571428573,178.87406426065823,1
2020-10-21-171017,171017,5,0,14,246,12.714285714285715,212.0995898648754,2
2020-10-22-171017,171017,4,0,17,250,14.857142857142858,215.72324714455905,3
2020-10-23-171017,171017,0,0,1,250,18.428571428571427,225.88683665479587,4
2020-10-24-171017,171017,3,0,0,253,7.0,240.9131176527294,5
2020-10-25-171017,171017,3,0,2,256,1.2857142857142858,253.52049315539628,6
2020-10-26-171017,171017,0,0,14,256,14.857142857142858,233.97536082064863,0
2020-10-27-171017,171017,4,1,6,260,14.285714285714285,260.2964024037197,1
2020-10-28-171017,171017,3,1,2,263,18.571428571428573,247.66074886053684,2
2020-10-29-171017,171017,7,0,5,270,19.0,261.1131318984797,3
2020-10-30-171017,171017,3,0,6,273,16.857142857142858,283.28862201665186,4
2020-10-31-171017,171017,3,0,0,276,10.428571428571429,303.75001345401876,5
2020-11-01-171017,171017,0,1,0,276,9.714285714285714,224.38818597967506,6
2020-11-02-171017,171017,2,0,0,278,7.142857142857142,234.90935663912987,0
2020-11-03-171017,171017,6,0,0,284,12.285714285714285,199.00403699242185,1
2020-11-04-171017,171017,14,0,0,298,16.428571428571427,237.41989357254377,2
2020-11-05-171017,171017,17,0,0,315,26.57142857142857,269.73567565833224,3
2020-11-06-171017,171017,1,0,0,316,25.285714285714285,298.8060518916778,4
2020-11-07-171017,171017,0,0,0,316,5.857142857142858,325.8878411953145,5
2020-11-08-171017,171017,2,0,0,318,9.0,311.10833500337185,6
2020-11-09-171017,171017,14,0,0,332,12.857142857142858,295.97486672026673,0
2020-11-10-171017,171017,6,0,0,338,12.285714285714285,195.43647381735317,1
2020-11-11-171017,171017,2,0,0,340,11.428571428571427,227.0929910076089,2
2020-11-12-171017,171017,5,0,0,345,13.428571428571427,240.66182109558565,3
2020-11-13-171017,171017,6,0,0,351,14.285714285714285,235.38214535297885,4
2020-03-01-171018,171018,1,0,0,1,0.0,0.0,6
2020-03-02-171018,171018,0,0,3,1,0.0,27.999023762398004,0
2020-03-03-171018,171018,0,1,2,1,0.0,150.60087460017647,1
2020-03-04-171018,171018,0,0,11,1,0.0,161.43245710717227,2
2020-03-05-171018,171018,0,0,10,1,0.2,168.3059175013149,3
2020-03-06-171018,171018,0,0,4,1,0.4,139.60981362057922,4
2020-03-07-171018,171018,0,0,2,1,0.0,143.61605752272388,5
2020-03-08-171018,171018,0,0,1,1,0.0,142.82693820497627,6
2020-03-09-171018,171018,0,0,13,1,0.2,141.9473283592257,0
2020-03-10-171018,171018,0,0,9,1,0.2,531.7991731696901,1
2020-03-11-171018,171018,1,0,9,2,0.2,420.3466194501731,2
2020-03-12-171018,171018,0,0,10,2,0.0,282.1773453259509,3
2020-03-13-171018,171018,1,0,15,3,1.4,182.64637677342472,4
2020-03-14-171018,171018,1,0,3,4,0.4,132.56104545329453,5
2020-03-15-171018,171018,0,0,5,4,1.8,91.98150063506961,6
2020-03-16-171018,171018,3,0,10,7,4.6,33.89505382027853,0
2020-03-17-171018,171018,2,0,5,9,4.0,70.85410192529325,1
2020-03-18-171018,171018,11,0,6,20,7.0,92.79808745183784,2
2020-03-19-171018,171018,10,0,7,30,6.2,124.05892590378232,3
2020-03-20-171018,171018,4,0,3,34,8.6,148.00732884568572,4
2020-03-21-171018,171018,2,0,3,36,3.2,170.8175898732039,5
2020-03-22-171018,171018,1,0,3,37,4.8,162.27215319604306,6
2020-03-23-171018,171018,13,0,6,50,10.0,150.07615668280408,0
2020-03-24-171018,171018,9,0,2,59,9.4,179.76776694532748,1
2020-03-25-171018,171018,9,0,4,68,7.6,184.04361523327282,2
2020-03-26-171018,171018,10,0,2,78,9.0,162.26030724787233,3
2020-03-27-171018,171018,15,0,3,93,8.0,171.14905491790762,4
2020-03-28-171018,171018,3,0,7,96,2.0,153.67548718389247,5
2020-03-29-171018,171018,5,0,2,101,2.0,138.65804543003281,6
2020-03-30-171018,171018,10,0,1,111,7.8,105.86475637677398,0
2020-03-31-171018,171018,5,0,4,116,4.8,99.78088635725237,1
2020-04-01-171018,171018,6,0,4,122,7.8,13.53386139767718,2
2020-04-02-171018,171018,7,0,3,129,5.4,54.64215112303211,3
2020-04-03-171018,171018,3,0,0,132,11.0,30.16391175434004,4
2020-04-04-171018,171018,3,0,1,135,1.4,47.61438669206848,5
2020-04-05-171018,171018,3,0,0,138,2.0,51.7952630285662,6
2020-04-06-171018,171018,6,0,11,144,6.4,51.78551528080361,0
2020-04-07-171018,171018,2,1,4,146,6.0,47.4397487554828,1
2020-04-08-171018,171018,4,0,1,150,5.2,43.741013357280735,2
2020-04-09-171018,171018,2,0,0,152,5.4,66.15208709842125,3
2020-04-10-171018,171018,3,0,2,155,2.8,14.638298644368081,4
2020-04-11-171018,171018,7,0,0,162,4.2,18.013553892544625,5
2020-04-12-171018,171018,2,0,1,164,4.4,28.623574568642915,6
2020-04-13-171018,171018,1,0,1,165,5.4,38.44914055834924,0
2020-04-14-171018,171018,4,0,2,169,5.0,66.8177706749284,1
2020-04-15-171018,171018,4,0,3,173,4.2,96.77250557333196,2
2020-04-16-171018,171018,3,0,1,176,3.2,118.67447766018019,3
2020-04-17-171018,171018,0,0,0,176,3.4,124.55700000303052,4
2020-04-18-171018,171018,1,0,1,177,1.2,140.00580419415382,5
2020-04-19-171018,171018,0,0,1,177,0.6,118.58677653304531,6
2020-04-20-171018,171018,11,1,0,188,3.8,121.36921520257793,0
2020-04-21-171018,171018,4,0,2,192,3.2,120.86764153216905,1
2020-04-22-171018,171018,1,0,3,193,2.8,106.85578247189324,2
2020-04-23-171018,171018,0,0,3,193,0.4,104.42859501490123,3
2020-04-24-171018,171018,2,0,6,195,4.2,89.0994367929751,4
2020-04-25-171018,171018,0,0,0,195,0.2,100.23287895403445,5
2020-04-26-171018,171018,1,0,0,196,3.6,97.9579596537981,6
2020-04-27-171018,171018,1,0,1,197,3.2,67.55213017864857,0
2020-04-28-171018,171018,2,0,2,199,2.8,61.854889666801164,1
2020-04-29-171018,171018,3,0,3,202,2.2,60.02344247807335,2
2020-04-30-171018,171018,1,0,3,203,3.0,105.13104801595604,3
2020-05-01-171018,171018,0,0,6,203,0.6,136.52356691575233,4
2020-05-02-171018,171018,1,0,1,204,0.8,43.377348123926915,5
2020-05-03-171018,171018,1,0,3,205,0.2,28.919507149328965,6
2020-05-04-171018,171018,0,0,2,205,3.0,22.45950021733417,0
2020-05-05-171018,171018,2,0,3,207,3.0,22.4310142272346,1
2020-05-06-171018,171018,3,0,0,210,3.8,26.339103762969735,2
2020-05-07-171018,171018,3,0,3,213,2.6,34.557485010329316,3
2020-05-08-171018,171018,6,0,3,219,2.8,45.53460598230137,4
2020-05-09-171018,171018,0,1,0,219,0.4,68.38840047950428,5
2020-05-10-171018,171018,0,1,1,219,0.4,160.6949898228122,6
2020-05-11-171018,171018,1,0,0,220,3.0,143.2683581188902,0
2020-05-12-171018,171018,2,0,5,222,2.0,166.70712836068645,1
2020-05-13-171018,171018,3,1,2,225,2.4,137.81489266786554,2
2020-05-14-171018,171018,3,0,0,228,2.0,112.92942793425703,3
2020-05-15-171018,171018,6,0,2,234,1.2,92.7561920077979,4
2020-05-16-171018,171018,1,0,1,235,0.0,75.96843881921362,5
2020-05-17-171018,171018,3,0,0,238,0.0,73.56702907101379,6
2020-05-18-171018,171018,2,0,2,240,2.6,74.82702102650983,0
2020-05-19-171018,171018,3,0,3,243,1.8,71.00365419693279,1
2020-05-20-171018,171018,0,0,0,243,3.0,61.34723337792945,2
2020-05-21-171018,171018,3,0,1,246,1.8,62.373510042034624,3
2020-05-22-171018,171018,3,0,0,249,2.8,58.469796870063654,4
2020-05-23-171018,171018,0,0,1,249,0.0,70.52339589479126,5
2020-05-24-171018,171018,1,0,0,250,0.2,69.9417648775829,6
2020-05-25-171018,171018,0,0,1,250,1.6,57.71783793688677,0
2020-05-26-171018,171018,5,0,0,255,1.0,61.10337603645448,1
2020-05-27-171018,171018,2,0,0,257,2.2,70.0576783993064,2
2020-05-28-171018,171018,0,0,1,257,0.6,68.33087972372974,3
2020-05-29-171018,171018,2,0,0,259,1.8,63.15582159735488,4
2020-05-30-171018,171018,1,0,0,260,0.0,64.74736321115444,5
2020-05-31-171018,171018,0,0,0,260,0.6,70.08754843467727,6
2020-06-01-171018,171018,2,0,0,262,2.2,129.56290119433638,0
2020-06-02-171018,171018,3,0,2,265,1.6,58.50596852712725,1
2020-06-03-171018,171018,0,0,0,265,0.6,33.075327196741625,2
2020-06-04-171018,171018,1,1,2,266,1.0,34.85833960041785,3
2020-06-05-171018,171018,0,0,3,266,0.8,39.69528652780677,4
2020-06-06-171018,171018,1,0,0,267,0.0,38.11784830174836,5
2020-06-07-171018,171018,0,0,0,267,0.2,37.94779289885875,6
2020-06-08-171018,171018,1,0,1,268,1.6,36.902802337445706,0
2020-06-09-171018,171018,0,0,1,268,1.0,42.55766218840479,1
2020-06-10-171018,171018,0,0,0,268,1.4,142.99453497544306,2
2020-06-11-171018,171018,1,0,0,269,1.4,129.12096874204394,3
2020-06-12-171018,171018,0,0,1,269,0.8,118.1949479052374,4
2020-06-13-171018,171018,0,2,0,269,0.0,95.65742001692405,5
2020-06-14-171018,171018,0,0,0,269,0.2,72.65987512276729,6
2020-06-15-171018,171018,0,0,0,269,2.0,45.777492185916785,0
2020-06-16-171018,171018,2,0,0,271,1.8,54.318277412136126,1
2020-06-17-171018,171018,0,0,1,271,1.2,55.81570443568171,2
2020-06-18-171018,171018,2,0,0,273,1.0,52.732343532230885,3
2020-06-19-171018,171018,3,0,0,276,2.0,52.91313914276682,4
2020-06-20-171018,171018,0,0,0,276,0.6,71.7327909268837,5
2020-06-21-171018,171018,0,0,0,276,0.2,74.60956167369454,6
2020-06-22-171018,171018,1,0,0,277,0.6,62.248297740812106,0
2020-06-23-171018,171018,1,0,1,278,1.2,52.67154173282779,1
2020-06-24-171018,171018,0,0,0,278,0.8,54.49490103246326,2
2020-06-25-171018,171018,0,0,0,278,0.4,48.4420989631526,3
2020-06-26-171018,171018,1,0,0,279,0.4,40.307942522579516,4
2020-06-27-171018,171018,0,0,0,279,0.2,34.783938685106264,5
2020-06-28-171018,171018,0,0,0,279,0.2,35.207360163539946,6
2020-06-29-171018,171018,0,0,0,279,1.2,36.51870163338015,0
2020-06-30-171018,171018,0,0,0,279,1.0,40.030768155400644,1
2020-07-01-171018,171018,1,0,0,280,0.4,48.131517488499384,2
2020-07-02-171018,171018,0,0,0,280,0.2,19.167420536024586,3
2020-07-03-171018,171018,0,0,0,280,1.0,34.34914841701203,4
2020-07-04-171018,171018,0,0,0,280,0.4,41.73591788459973,5
2020-07-05-171018,171018,0,0,0,280,0.0,40.73262694326016,6
2020-07-06-171018,171018,0,0,0,280,0.6,31.311668310382274,0
2020-07-07-171018,171018,1,0,1,281,0.4,32.18887525826701,1
2020-07-08-171018,171018,0,0,0,281,1.0,34.921619430001954,2
2020-07-09-171018,171018,0,0,1,281,0.2,32.92810138657775,3
2020-07-10-171018,171018,0,0,2,281,1.0,45.475788195434234,4
2020-07-11-171018,171018,0,0,0,281,0.2,43.11109092622421,5
2020-07-12-171018,171018,0,0,0,281,0.2,39.225636289694265,6
2020-07-13-171018,171018,0,0,0,281,0.8,40.04447156318598,0
2020-07-14-171018,171018,0,0,2,281,0.6,44.36263481710612,1
2020-07-15-171018,171018,0,0,1,281,1.6,29.724062671472225,2
2020-07-16-171018,171018,0,0,2,281,1.8,24.656820800408212,3
2020-07-17-171018,171018,0,0,2,281,1.6,22.505753782814033,4
2020-07-18-171018,171018,0,0,0,281,0.0,22.069210932587048,5
2020-07-19-171018,171018,0,0,0,281,0.4,19.651285335284197,6
2020-07-20-171018,171018,0,0,0,281,1.0,17.973296931809823,0
2020-07-21-171018,171018,1,0,0,282,1.0,20.892219690048357,1
2020-07-22-171018,171018,0,0,0,282,0.4,24.39527993339346,2
2020-07-23-171018,171018,1,0,0,283,0.4,25.298485896364042,3
2020-07-24-171018,171018,2,0,0,285,0.8,25.723269762854216,4
2020-07-25-171018,171018,0,0,1,285,0.2,32.447358736100036,5
2020-07-26-171018,171018,0,0,1,285,0.2,32.00519401165814,6
2020-07-27-171018,171018,0,0,0,285,1.6,28.74707759056092,0
2020-07-28-171018,171018,2,0,2,287,0.4,34.39920042288631,1
2020-07-29-171018,171018,1,0,0,288,1.0,32.676088278033966,2
2020-07-30-171018,171018,2,0,1,290,0.8,32.135758873147125,3
2020-07-31-171018,171018,2,0,1,292,1.2,34.307369989473244,4
2020-08-01-171018,171018,0,0,0,292,0.6,26.35371982013046,5
2020-08-02-171018,171018,0,0,0,292,0.2,125.3280288460844,6
2020-08-03-171018,171018,0,0,1,292,0.6,265.2260621656053,0
2020-08-04-171018,171018,0,0,2,292,1.0,235.57443809774543,1
2020-08-05-171018,171018,0,0,0,292,0.8,206.8839304017341,2
2020-08-06-171018,171018,0,0,2,292,0.2,172.39884474600888,3
2020-08-07-171018,171018,0,0,0,292,1.2,119.4004094370008,4
2020-08-08-171018,171018,1,0,0,293,1.2,104.71642078881592,5
2020-08-09-171018,171018,1,0,5,294,0.2,113.26976744722373,6
2020-08-10-171018,171018,0,0,2,294,0.8,19.592873877589803,0
2020-08-11-171018,171018,2,0,2,296,3.0,28.312774324477203,1
2020-08-12-171018,171018,0,0,0,296,0.4,47.92354439846932,2
2020-08-13-171018,171018,1,0,2,297,2.2,59.249036856397694,3
2020-08-14-171018,171018,1,0,2,298,2.0,76.85483045806114,4
2020-08-15-171018,171018,0,0,0,298,1.0,95.06552026599871,5
2020-08-16-171018,171018,0,0,0,298,0.8,96.52777610913309,6
2020-08-17-171018,171018,1,0,0,299,0.8,107.46911126550837,0
2020-08-18-171018,171018,2,0,1,301,3.2,111.94956536517577,1
2020-08-19-171018,171018,0,0,1,301,2.6,110.21115915797444,2
2020-08-20-171018,171018,2,0,0,303,4.4,90.47954094411276,3
2020-08-21-171018,171018,0,0,1,303,5.0,101.82985528630735,4
2020-08-22-171018,171018,0,0,1,303,1.2,122.2267329629884,5
2020-08-23-171018,171018,5,0,1,308,1.4,126.49751193007228,6
2020-08-24-171018,171018,2,0,5,310,4.2,126.87858709686897,0
2020-08-25-171018,171018,2,0,6,312,7.8,135.64098011897312,1
2020-08-26-171018,171018,0,0,3,312,5.6,159.7826077550451,2
2020-08-27-171018,171018,2,0,17,314,10.0,190.37358752338778,3
2020-08-28-171018,171018,2,0,3,316,9.0,204.62695818170292,4
2020-08-29-171018,171018,0,0,2,316,2.4,232.72556261152712,5
2020-08-30-171018,171018,0,0,2,316,2.6,230.27244171706047,6
2020-08-31-171018,171018,0,0,5,316,4.8,225.6847672365523,0
2020-09-01-171018,171018,1,0,11,317,3.4,96.0882680353019,1
2020-09-02-171018,171018,1,0,26,318,4.4,441.32777902922,2
2020-09-03-171018,171018,0,0,4,318,3.0,244.59744775951216,3
2020-09-04-171018,171018,1,0,48,319,3.8,219.11105417301223,4
2020-09-05-171018,171018,1,0,53,320,2.0,196.73375786119453,5
2020-09-06-171018,171018,1,0,0,321,4.8,185.50363646025076,6
2020-09-07-171018,171018,5,0,2,326,3.0,203.07527746536658,0
2020-09-08-171018,171018,6,1,0,332,4.2,219.14337089762822,1
2020-09-09-171018,171018,3,0,3,335,7.8,205.37236732775887,2
2020-09-10-171018,171018,17,0,6,352,8.0,77.64403372179592,3
2020-09-11-171018,171018,3,0,1,355,7.4,141.83148625616985,4
2020-09-12-171018,171018,2,0,0,357,3.4,179.64322344856308,5
2020-09-13-171018,171018,2,0,0,359,0.8,196.66410198897103,6
2020-09-14-171018,171018,5,0,2,364,6.4,200.0149039658167,0
2020-09-15-171018,171018,11,0,9,375,13.2,239.3750800075145,1
2020-09-16-171018,171018,26,0,8,401,6.8,311.53155550116855,2
2020-09-17-171018,171018,4,1,14,405,8.0,371.5818671337929,3
2020-09-18-171018,171018,48,0,4,453,7.0,375.14593424403955,4
2020-09-19-171018,171018,53,1,2,506,2.8,365.8026093155539,5
2020-09-20-171018,171018,0,0,0,506,2.2,427.6223090476734,6
2020-09-21-171018,171018,2,1,2,508,9.0,381.55832169033624,0
2020-09-22-171018,171018,0,0,12,508,11.0,349.78531703984373,1
2020-09-23-171018,171018,3,2,3,511,9.4,309.5283939075772,2
2020-09-24-171018,171018,6,0,0,517,7.2,280.55510225081105,3
2020-09-25-171018,171018,1,0,4,518,8.2,273.1757191589718,4
2020-09-26-171018,171018,0,0,4,518,6.6,243.37487670418955,5
2020-09-27-171018,171018,0,0,0,518,0.4,250.318538724657,6
2020-09-28-171018,171018,2,1,2,520,3.0,247.48863034994272,0
2020-09-29-171018,171018,9,0,3,529,5.6,227.73663522388063,1
2020-09-30-171018,171018,8,0,10,537,3.6,211.13647484424848,2
2020-10-01-171018,171018,14,0,2,551,6.4,0.0,3
2020-10-02-171018,171018,4,0,5,555,6.8,255.99729889562457,4
2020-10-03-171018,171018,2,1,3,557,1.8,472.62683371532387,5
2020-10-04-171018,171018,0,4,1,557,0.8,490.67885066280525,6
2020-10-05-171018,171018,2,0,1,559,3.4,418.791177318747,0
2020-10-06-171018,171018,12,0,9,571,6.0,369.92234417129555,1
2020-10-07-171018,171018,3,2,5,574,6.0,334.61181564234266,2
2020-10-08-171018,171018,0,2,2,574,3.4,293.7686255933264,3
2020-10-09-171018,171018,4,1,1,578,6.0,328.78556199667355,4
2020-10-10-171018,171018,4,0,4,582,2.0,41.856229568203254,5
2020-10-11-171018,171018,0,0,1,582,1.4,67.54219374549702,6
2020-10-12-171018,171018,2,0,1,584,1.4,78.21835334472303,0
2020-10-13-171018,171018,3,0,4,587,6.8,88.8574517265868,1
2020-10-14-171018,171018,10,0,3,597,5.4,124.96913786686787,2
2020-10-15-171018,171018,2,0,10,599,5.0,175.71488633820027,3
2020-10-16-171018,171018,5,0,5,604,7.2,209.6361042616041,4
2020-10-17-171018,171018,3,0,6,607,3.2,216.24297770376492,5
2020-10-18-171018,171018,1,0,3,608,1.6,210.78395950730788,6
2020-10-19-171018,171018,1,0,2,609,4.2,214.65057018152888,0
2020-10-20-171018,171018,9,0,4,618,16.0,247.7691682731696,1
2020-10-21-171018,171018,5,0,12,623,8.8,267.4350361882262,2
2020-10-22-171018,171018,2,1,11,625,9.8,287.6236044840147,3
2020-10-23-171018,171018,1,0,4,626,13.8,302.568505432621,4
2020-10-24-171018,171018,4,1,5,630,5.0,363.75022975170043,5
2020-10-25-171018,171018,1,0,4,631,1.6,380.38363387913694,6
2020-10-26-171018,171018,1,0,2,632,9.6,359.7174107563683,0
2020-10-27-171018,171018,4,0,7,636,11.8,395.32451225536533,1
2020-10-28-171018,171018,3,0,2,639,14.0,407.34784940798977,2
2020-10-29-171018,171018,10,0,3,649,14.0,432.514918472067,3
2020-10-30-171018,171018,5,0,0,654,17.6,380.30863357703095,4
2020-10-31-171018,171018,6,0,0,660,7.6,440.1883054492679,5
2020-11-01-171018,171018,3,1,0,663,10.2,252.5020798598267,6
2020-11-02-171018,171018,2,1,0,665,4.8,360.4824763846433,0
2020-11-03-171018,171018,4,0,0,669,8.6,284.31456749707604,1
2020-11-04-171018,171018,12,0,0,681,16.4,338.390363840052,2
2020-11-05-171018,171018,11,0,0,692,19.0,381.0800372267728,3
2020-11-06-171018,171018,4,0,0,696,16.2,429.52310932336263,4
2020-11-07-171018,171018,5,0,0,701,3.6,449.4995353267887,5
2020-11-08-171018,171018,4,2,0,705,11.6,431.256425569777,6
2020-11-09-171018,171018,2,0,0,707,9.4,443.7705577983498,0
2020-11-10-171018,171018,7,0,0,714,9.6,239.5118632350585,1
2020-11-11-171018,171018,2,1,0,716,6.4,289.84114580097025,2
2020-11-12-171018,171018,3,0,0,719,8.8,321.7711813316437,3
2020-11-13-171018,171018,0,0,0,719,11.0,354.24510140494584,4
2020-03-01-171019,171019,0,0,0,0,0.0,0.0,6
2020-03-02-171019,171019,0,0,0,0,0.0,6.797277768579578,0
2020-03-03-171019,171019,0,0,1,0,0.0,38.84222299766896,1
2020-03-04-171019,171019,0,0,0,0,0.0,40.0539365671756,2
2020-03-05-171019,171019,0,0,1,0,0.0,43.05397842703704,3
2020-03-06-171019,171019,0,1,0,0,0.0,37.760488740644796,4
2020-03-07-171019,171019,0,0,2,0,0.0,37.291458126558425,5
2020-03-08-171019,171019,0,0,2,0,0.0,36.50293109832348,6
2020-03-09-171019,171019,0,0,5,0,0.0,37.09652349863451,0
2020-03-10-171019,171019,0,0,1,0,0.0,192.7575905306564,1
2020-03-11-171019,171019,1,0,3,1,0.3333333333333333,159.11215990800986,2
2020-03-12-171019,171019,0,0,1,1,0.0,107.14140142819674,3
2020-03-13-171019,171019,1,0,2,2,0.5,70.33461166656753,4
2020-03-14-171019,171019,0,0,0,2,0.0,38.73457860969548,5
2020-03-15-171019,171019,0,0,0,2,0.5,31.098171533262153,6
2020-03-16-171019,171019,0,0,0,2,1.5,8.7881573076089,0
2020-03-17-171019,171019,1,0,0,3,1.3333333333333333,16.258189439872883,1
2020-03-18-171019,171019,0,0,1,3,3.333333333333333,22.61263451623375,2
2020-03-19-171019,171019,1,0,1,4,4.0,30.025170702725266,3
2020-03-20-171019,171019,0,0,1,4,3.5,43.34034590876773,4
2020-03-21-171019,171019,2,0,0,6,2.833333333333333,50.03268613735095,5
2020-03-22-171019,171019,2,0,0,8,1.6666666666666667,55.83050199098254,6
2020-03-23-171019,171019,5,0,0,13,7.5,54.542988717605425,0
2020-03-24-171019,171019,1,0,0,14,2.5,74.68279234080751,1
2020-03-25-171019,171019,3,0,0,17,5.0,75.98258250598214,2
2020-03-26-171019,171019,1,0,0,18,3.1666666666666665,78.19401467110632,3
2020-03-27-171019,171019,2,0,0,20,4.833333333333333,89.07032287396419,4
2020-03-28-171019,171019,0,0,0,20,1.5,96.12202796030076,5
2020-03-29-171019,171019,0,0,0,20,0.8333333333333334,93.31869328944158,6
2020-03-30-171019,171019,0,0,0,20,4.166666666666667,65.07338260916282,0
2020-03-31-171019,171019,0,0,0,20,2.5,67.07046707733353,1
2020-04-01-171019,171019,1,0,0,21,3.1666666666666665,9.572001574322764,2
2020-04-02-171019,171019,1,0,0,22,1.8333333333333333,47.51496136839816,3
2020-04-03-171019,171019,1,0,0,23,3.1666666666666665,26.3826734746327,4
2020-04-04-171019,171019,0,0,0,23,0.6666666666666666,28.711470247622284,5
2020-04-05-171019,171019,0,0,0,23,0.3333333333333333,31.280462028748065,6
2020-04-06-171019,171019,0,0,0,23,5.333333333333333,31.71703965228087,0
2020-04-07-171019,171019,0,0,0,23,5.833333333333332,39.359746497889816,1
2020-04-08-171019,171019,0,1,0,23,2.333333333333333,54.133460553257805,2
2020-04-09-171019,171019,0,0,0,23,3.1666666666666665,55.288834376943676,3
2020-04-10-171019,171019,0,0,0,23,4.333333333333333,10.44832399587456,4
2020-04-11-171019,171019,0,0,0,23,2.0,18.083315243083966,5
2020-04-12-171019,171019,0,0,0,23,1.1666666666666667,20.484653904870523,6
2020-04-13-171019,171019,0,0,0,23,4.5,24.105434280219765,0
2020-04-14-171019,171019,0,0,0,23,3.333333333333333,35.81941924411964,1
2020-04-15-171019,171019,0,1,0,23,5.166666666666667,42.5250934147262,2
2020-04-16-171019,171019,0,0,0,23,1.6666666666666667,54.6917727286902,3
2020-04-17-171019,171019,0,0,0,23,3.1666666666666665,51.46103626137837,4
2020-04-18-171019,171019,0,0,0,23,0.5,50.98835708637769,5
2020-04-19-171019,171019,0,0,0,23,0.3333333333333333,48.824976222460336,6
2020-04-20-171019,171019,0,2,0,23,1.8333333333333333,37.33591216669529,0
2020-04-21-171019,171019,0,0,0,23,2.833333333333333,34.997630685405035,1
2020-04-22-171019,171019,0,0,1,23,2.0,24.227386318342248,2
2020-04-23-171019,171019,0,0,0,23,0.5,25.74843966440913,3
2020-04-24-171019,171019,0,0,1,23,4.0,21.747546351289863,4
2020-04-25-171019,171019,0,0,0,23,0.6666666666666666,29.77194714332927,5
2020-04-26-171019,171019,0,0,0,23,0.16666666666666666,30.91382006724303,6
2020-04-27-171019,171019,0,0,0,23,1.8333333333333333,25.072086462351628,0
2020-04-28-171019,171019,0,0,0,23,1.5,25.133551194512084,1
2020-04-29-171019,171019,0,0,0,23,2.333333333333333,25.672072650668657,2
2020-04-30-171019,171019,0,0,0,23,2.6666666666666665,35.71786311078861,3
2020-05-01-171019,171019,0,0,0,23,0.16666666666666666,62.43271087406179,4
2020-05-02-171019,171019,0,0,0,23,0.16666666666666666,21.600303166016552,5
2020-05-03-171019,171019,0,0,0,23,0.6666666666666666,22.536581939434065,6
2020-05-04-171019,171019,0,0,0,23,3.5,19.599618014766932,0
2020-05-05-171019,171019,0,0,0,23,2.5,23.53950618669863,1
2020-05-06-171019,171019,1,0,2,24,12.833333333333336,26.977335038395122,2
2020-05-07-171019,171019,0,0,0,24,6.0,34.8245632429161,3
2020-05-08-171019,171019,1,0,0,25,4.0,38.157327441727915,4
2020-05-09-171019,171019,0,0,0,25,0.3333333333333333,50.904442193477365,5
2020-05-10-171019,171019,0,0,0,25,0.0,70.02542066403664,6
2020-05-11-171019,171019,0,0,0,25,2.0,64.06153034179997,0
2020-05-12-171019,171019,0,0,0,25,4.333333333333333,68.17833613548873,1
2020-05-13-171019,171019,0,0,0,25,1.6666666666666667,56.141062571411425,2
2020-05-14-171019,171019,0,0,0,25,0.8333333333333334,36.50107858591668,3
2020-05-15-171019,171019,0,1,0,25,1.3333333333333333,31.780381998699944,4
2020-05-16-171019,171019,0,0,0,25,0.0,24.338473726802093,5
2020-05-17-171019,171019,0,0,0,25,0.0,23.908420425865515,6
2020-05-18-171019,171019,0,0,0,25,2.1666666666666665,24.480284555907517,0
2020-05-19-171019,171019,0,0,0,25,2.6666666666666665,26.539694998935857,1
2020-05-20-171019,171019,2,0,0,27,2.1666666666666665,23.241876484151703,2
2020-05-21-171019,171019,0,0,0,27,1.8333333333333333,23.09027126818381,3
2020-05-22-171019,171019,0,0,0,27,2.0,24.655765420576103,4
2020-05-23-171019,171019,0,0,0,27,0.16666666666666666,30.549764579967636,5
2020-05-24-171019,171019,0,0,0,27,0.16666666666666666,31.90884970972523,6
2020-05-25-171019,171019,0,0,0,27,1.6666666666666667,24.76623648198435,0
2020-05-26-171019,171019,0,0,1,27,0.8333333333333334,25.933338506447917,1
2020-05-27-171019,171019,0,0,0,27,0.3333333333333333,28.80588224290425,2
2020-05-28-171019,171019,0,6,0,27,3.333333333333333,26.528117258679487,3
2020-05-29-171019,171019,0,1,0,27,1.0,33.6955372314668,4
2020-05-30-171019,171019,0,0,0,27,0.3333333333333333,36.91795997156882,5
2020-05-31-171019,171019,0,0,0,27,0.16666666666666666,37.78594868994363,6
2020-06-01-171019,171019,0,1,0,27,0.3333333333333333,65.09617866082633,0
2020-06-02-171019,171019,0,0,0,27,1.3333333333333333,16.919314806399402,1
2020-06-03-171019,171019,0,0,0,27,1.1666666666666667,14.079295606232682,2
2020-06-04-171019,171019,0,0,0,27,1.5,15.643990983415378,3
2020-06-05-171019,171019,0,0,0,27,0.6666666666666666,17.736118732057157,4
2020-06-06-171019,171019,0,2,0,27,0.16666666666666666,18.684051980594514,5
2020-06-07-171019,171019,0,1,0,27,0.16666666666666666,18.89119700485864,6
2020-06-08-171019,171019,0,0,1,27,0.6666666666666666,19.302427311456782,0
2020-06-09-171019,171019,1,0,0,28,0.5,22.519427637115374,1
2020-06-10-171019,171019,0,0,0,28,0.8333333333333334,71.38643639408298,2
2020-06-11-171019,171019,0,0,0,28,0.8333333333333334,67.90494542683582,3
2020-06-12-171019,171019,0,0,0,28,0.8333333333333334,66.26508020794218,4
2020-06-13-171019,171019,0,1,0,28,0.16666666666666666,45.93448432414648,5
2020-06-14-171019,171019,0,0,0,28,0.0,36.060512654405755,6
2020-06-15-171019,171019,0,1,0,28,0.16666666666666666,20.701081919845663,0
2020-06-16-171019,171019,0,1,0,28,0.5,20.293987887597797,1
2020-06-17-171019,171019,0,0,0,28,1.0,18.57281386001284,2
2020-06-18-171019,171019,0,0,0,28,0.6666666666666666,18.275069155886445,3
2020-06-19-171019,171019,0,0,0,28,1.0,16.75197500363966,4
2020-06-20-171019,171019,0,0,0,28,0.16666666666666666,21.482430324714546,5
2020-06-21-171019,171019,0,0,0,28,0.0,22.48952173330929,6
2020-06-22-171019,171019,1,0,0,29,0.3333333333333333,22.23272646862054,0
2020-06-23-171019,171019,0,0,0,29,0.6666666666666666,23.32357422544526,1
2020-06-24-171019,171019,0,1,0,29,0.5,22.60840117334023,2
2020-06-25-171019,171019,0,0,0,29,0.6666666666666666,21.566623436670692,3
2020-06-26-171019,171019,0,0,0,29,0.16666666666666666,18.604239639191274,4
2020-06-27-171019,171019,0,0,0,29,0.0,17.357381132611422,5
2020-06-28-171019,171019,0,0,0,29,0.16666666666666666,17.250567098817328,6
2020-06-29-171019,171019,0,0,0,29,0.3333333333333333,17.501302511871252,0
2020-06-30-171019,171019,0,0,0,29,0.5,20.192115007804507,1
2020-07-01-171019,171019,0,0,0,29,0.16666666666666666,25.257068283435785,2
2020-07-02-171019,171019,0,0,1,29,0.16666666666666666,13.562823444633446,3
2020-07-03-171019,171019,0,0,0,29,0.0,20.434004402495205,4
2020-07-04-171019,171019,0,0,0,29,0.16666666666666666,19.071700200226356,5
2020-07-05-171019,171019,0,0,0,29,0.16666666666666666,18.8294372655347,6
2020-07-06-171019,171019,0,0,0,29,0.3333333333333333,15.36532853017302,0
2020-07-07-171019,171019,0,0,0,29,0.0,15.45545367316929,1
2020-07-08-171019,171019,0,1,0,29,0.0,12.574824208426863,2
2020-07-09-171019,171019,0,0,0,29,0.0,12.905438381571905,3
2020-07-10-171019,171019,0,0,0,29,0.3333333333333333,25.441393328112063,4
2020-07-11-171019,171019,0,0,0,29,0.0,20.17481237404626,5
2020-07-12-171019,171019,0,0,0,29,0.0,16.93951813238695,6
2020-07-13-171019,171019,0,0,0,29,0.5,16.924407884860926,0
2020-07-14-171019,171019,0,0,0,29,0.8333333333333334,17.895163067112804,1
2020-07-15-171019,171019,0,0,0,29,0.5,14.10543812249248,2
2020-07-16-171019,171019,1,0,0,30,0.6666666666666666,10.30488010249584,3
2020-07-17-171019,171019,0,0,0,30,0.5,11.637860021119803,4
2020-07-18-171019,171019,0,0,0,30,0.0,13.501215110855549,5
2020-07-19-171019,171019,0,0,0,30,0.0,12.977021801692304,6
2020-07-20-171019,171019,0,0,0,30,0.3333333333333333,14.698450271558713,0
2020-07-21-171019,171019,0,0,0,30,0.16666666666666666,15.351287451404986,1
2020-07-22-171019,171019,0,0,0,30,0.16666666666666666,15.401502086472293,2
2020-07-23-171019,171019,0,0,0,30,0.0,13.909061493506059,3
2020-07-24-171019,171019,0,0,0,30,0.6666666666666666,14.931301015831684,4
2020-07-25-171019,171019,0,0,0,30,0.0,20.437277433509408,5
2020-07-26-171019,171019,0,0,0,30,0.0,19.42760619670339,6
2020-07-27-171019,171019,0,0,0,30,0.5,17.32076629910717,0
2020-07-28-171019,171019,0,0,0,30,0.5,18.584507318609205,1
2020-07-29-171019,171019,0,0,0,30,0.8333333333333334,18.068998243682188,2
2020-07-30-171019,171019,0,0,0,30,1.1666666666666667,16.841170423039095,3
2020-07-31-171019,171019,0,0,0,30,0.6666666666666666,17.193200551314565,4
2020-08-01-171019,171019,0,0,0,30,0.0,7.576617194832419,5
2020-08-02-171019,171019,0,0,0,30,0.5,49.94172026686701,6
2020-08-03-171019,171019,0,0,0,30,0.6666666666666666,123.08312072843214,0
2020-08-04-171019,171019,0,0,0,30,0.16666666666666666,108.83419421028515,1
2020-08-05-171019,171019,0,0,0,30,0.5,86.6017280267676,2
2020-08-06-171019,171019,0,0,0,30,0.3333333333333333,76.5262709301398,3
2020-08-07-171019,171019,0,0,0,30,1.1666666666666667,61.42391753552931,4
2020-08-08-171019,171019,0,0,0,30,0.0,49.39034762512816,5
2020-08-09-171019,171019,0,0,0,30,0.0,49.13217741817805,6
2020-08-10-171019,171019,0,0,0,30,0.3333333333333333,5.70465637568656,0
2020-08-11-171019,171019,0,0,0,30,0.16666666666666666,7.127898082572524,1
2020-08-12-171019,171019,0,0,0,30,0.6666666666666666,9.870764463279611,2
2020-08-13-171019,171019,0,0,2,30,1.1666666666666667,9.687886951349086,3
2020-08-14-171019,171019,0,0,1,30,0.8333333333333334,17.668996886319977,4
2020-08-15-171019,171019,0,0,0,30,0.5,22.728878566995064,5
2020-08-16-171019,171019,0,0,0,30,0.3333333333333333,24.950286703907494,6
2020-08-17-171019,171019,0,0,1,30,0.5,26.095551509809297,0
2020-08-18-171019,171019,0,0,1,30,0.5,31.44606260574124,1
2020-08-19-171019,171019,0,0,0,30,2.0,34.40099452467035,2
2020-08-20-171019,171019,0,0,0,30,2.833333333333333,53.12939798877031,3
2020-08-21-171019,171019,0,0,0,30,1.3333333333333333,62.20777057418201,4
2020-08-22-171019,171019,0,0,0,30,0.5,70.16794549425072,5
2020-08-23-171019,171019,0,0,0,30,1.0,73.36417232561051,6
2020-08-24-171019,171019,0,0,0,30,3.1666666666666665,74.09437563727872,0
2020-08-25-171019,171019,0,0,1,30,3.8333333333333335,85.06365795037698,1
2020-08-26-171019,171019,0,0,1,30,4.166666666666667,80.99948750780489,2
2020-08-27-171019,171019,2,0,1,32,2.5,102.63954761782249,3
2020-08-28-171019,171019,1,0,0,33,2.333333333333333,106.80595270868852,4
2020-08-29-171019,171019,0,0,0,33,2.333333333333333,108.5981607081604,5
2020-08-30-171019,171019,0,0,0,33,2.333333333333333,115.91815431200754,6
2020-08-31-171019,171019,1,0,3,34,2.5,112.49340278460699,0
2020-09-01-171019,171019,1,0,1,35,1.5,30.14817350475044,1
2020-09-02-171019,171019,0,0,0,35,2.333333333333333,224.11728710031772,2
2020-09-03-171019,171019,0,0,0,35,2.0,237.56138781380497,3
2020-09-04-171019,171019,0,0,0,35,1.5,171.79517980410094,4
2020-09-05-171019,171019,0,0,0,35,1.5,144.6109018181897,5
2020-09-06-171019,171019,0,0,0,35,0.6666666666666666,113.15426910074451,6
2020-09-07-171019,171019,0,0,0,35,3.5,111.91276752562898,0
2020-09-08-171019,171019,1,0,1,36,2.0,125.15603675630689,1
2020-09-09-171019,171019,1,0,0,37,1.3333333333333333,115.46683383575561,2
2020-09-10-171019,171019,1,0,0,38,2.1666666666666665,23.936809013387183,3
2020-09-11-171019,171019,0,0,0,38,2.0,43.79849469512399,4
2020-09-12-171019,171019,0,0,5,38,2.1666666666666665,54.13349245435481,5
2020-09-13-171019,171019,0,0,0,38,1.3333333333333333,74.42415372165169,6
2020-09-14-171019,171019,3,0,2,41,4.166666666666667,82.8792732761097,0
2020-09-15-171019,171019,1,0,1,42,2.6666666666666665,122.8018736560571,1
2020-09-16-171019,171019,0,0,1,42,3.5,150.81399672758846,2
2020-09-17-171019,171019,0,0,0,42,3.0,175.10257478482131,3
2020-09-18-171019,171019,0,0,0,42,4.5,188.62977771955545,4
2020-09-19-171019,171019,0,0,2,42,3.0,202.54192475013633,5
2020-09-20-171019,171019,0,0,1,42,2.0,198.84411826942699,6
2020-09-21-171019,171019,0,0,0,42,1.3333333333333333,170.09945773855424,0
2020-09-22-171019,171019,1,0,1,43,1.1666666666666667,157.79317051612065,1
2020-09-23-171019,171019,0,0,0,43,4.833333333333333,136.69620724573173,2
2020-09-24-171019,171019,0,0,0,43,7.5,136.88840004262912,3
2020-09-25-171019,171019,0,0,0,43,8.0,158.82124082311628,4
2020-09-26-171019,171019,5,0,0,48,4.166666666666667,164.25041007780882,5
2020-09-27-171019,171019,0,0,0,48,1.1666666666666667,192.01595139464257,6
2020-09-28-171019,171019,2,0,0,50,2.833333333333333,186.73842173335723,0
2020-09-29-171019,171019,1,0,0,51,3.0,180.76196664238472,1
2020-09-30-171019,171019,1,0,0,52,4.666666666666667,167.46272023073703,2
2020-10-01-171019,171019,0,0,1,52,3.8333333333333335,0.0,3
2020-10-02-171019,171019,0,0,1,52,4.166666666666667,123.99956028586092,4
2020-10-03-171019,171019,2,0,0,54,3.1666666666666665,237.36409578593205,5
2020-10-04-171019,171019,1,0,0,55,2.333333333333333,284.89063417246325,6
2020-10-05-171019,171019,0,0,1,55,2.1666666666666665,226.68823112671134,0
2020-10-06-171019,171019,1,0,2,56,7.333333333333332,207.2613804113019,1
2020-10-07-171019,171019,0,0,0,56,3.1666666666666665,211.33812583130577,2
2020-10-08-171019,171019,0,0,1,56,5.666666666666668,174.30046032821542,3
2020-10-09-171019,171019,0,0,0,56,5.166666666666667,185.62895945286846,4
2020-10-10-171019,171019,0,0,2,56,1.6666666666666667,22.823173318569403,5
2020-10-11-171019,171019,0,0,0,56,1.6666666666666667,32.89140246386391,6
2020-10-12-171019,171019,0,0,10,56,0.3333333333333333,45.43187761400822,0
2020-10-13-171019,171019,0,0,0,56,2.5,47.798422953697965,1
2020-10-14-171019,171019,0,0,0,56,3.6666666666666665,63.01458164006188,2
2020-10-15-171019,171019,1,0,1,57,4.0,81.04245993604398,3
2020-10-16-171019,171019,1,0,1,58,6.333333333333332,101.84769751255605,4
2020-10-17-171019,171019,0,0,7,58,3.8333333333333335,102.50962945716356,5
2020-10-18-171019,171019,0,0,0,58,2.0,110.58782468767063,6
2020-10-19-171019,171019,1,0,3,59,2.833333333333333,108.16780840531374,0
2020-10-20-171019,171019,2,0,2,61,6.0,131.24109017281194,1
2020-10-21-171019,171019,0,0,0,61,3.0,145.07756789142863,2
2020-10-22-171019,171019,1,0,0,62,5.833333333333332,138.80286824830273,3
2020-10-23-171019,171019,0,0,1,62,4.333333333333333,141.32081557076228,4
2020-10-24-171019,171019,2,0,5,64,2.6666666666666665,146.1333708807349,5
2020-10-25-171019,171019,0,0,0,64,0.6666666666666666,150.49960485535058,6
2020-10-26-171019,171019,10,1,0,74,7.333333333333332,141.37822412576662,0
2020-10-27-171019,171019,0,2,0,74,5.833333333333332,177.5043500079533,1
2020-10-28-171019,171019,0,0,0,74,5.5,175.06810028621632,2
2020-10-29-171019,171019,1,0,0,75,6.166666666666668,187.32677931020146,3
2020-10-30-171019,171019,1,0,0,76,7.5,222.38833342749268,4
2020-10-31-171019,171019,7,0,0,83,4.166666666666667,243.41209926300158,5
2020-11-01-171019,171019,0,0,0,83,2.6666666666666665,182.7465454273116,6
2020-11-02-171019,171019,3,0,0,86,4.166666666666667,161.0658356488505,0
2020-11-03-171019,171019,2,0,0,88,5.5,145.6423856563609,1
2020-11-04-171019,171019,0,0,0,88,4.5,171.87587549658738,2
2020-11-05-171019,171019,0,0,0,88,6.166666666666668,189.071253165977,3
2020-11-06-171019,171019,1,0,0,89,3.6666666666666665,177.99084182652174,4
2020-11-07-171019,171019,5,0,0,94,3.6666666666666665,196.34598281622786,5
2020-11-08-171019,171019,0,1,0,94,1.0,204.31839374585905,6
2020-11-09-171019,171019,0,0,0,94,1.6666666666666667,175.1849756309145,0
2020-11-10-171019,171019,0,0,0,94,4.166666666666667,157.38550028815308,1
2020-11-11-171019,171019,0,0,0,94,3.6666666666666665,172.11801101694417,2
2020-11-12-171019,171019,0,0,0,94,3.6666666666666665,184.11611320361712,3
2020-11-13-171019,171019,0,0,0,94,3.8333333333333335,176.36001808785144,4
2020-03-01-171020,171020,0,0,0,0,0.16666666666666666,0.0,6
2020-03-02-171020,171020,2,1,0,2,0.0,11.376982553672233,0
2020-03-03-171020,171020,0,0,1,2,0.0,48.00857709512307,1
2020-03-04-171020,171020,0,1,3,2,0.0,53.016626939585606,2
2020-03-05-171020,171020,0,1,3,2,0.5,55.892406501138275,3
2020-03-06-171020,171020,0,0,5,2,0.0,52.84515584599818,4
2020-03-07-171020,171020,0,0,2,2,0.0,50.54278074512087,5
2020-03-08-171020,171020,0,0,1,2,0.0,46.29059416201317,6
2020-03-09-171020,171020,0,0,1,2,0.0,46.45138213534777,0
2020-03-10-171020,171020,0,0,1,2,0.16666666666666666,369.77564358033266,1
2020-03-11-171020,171020,0,0,2,2,0.0,317.42174084008286,2
2020-03-12-171020,171020,0,0,1,2,0.0,208.1451944203994,3
2020-03-13-171020,171020,0,0,1,2,0.5,127.46172905295634,4
2020-03-14-171020,171020,0,0,1,2,0.0,73.32856757319803,5
2020-03-15-171020,171020,0,0,1,2,0.8333333333333334,51.822969575988054,6
2020-03-16-171020,171020,0,0,1,2,1.3333333333333333,6.801715953092068,0
2020-03-17-171020,171020,1,2,1,3,3.6666666666666665,17.024478750807724,1
2020-03-18-171020,171020,3,0,2,6,2.5,27.22086387955077,2
2020-03-19-171020,171020,3,0,1,9,7.0,44.57909497361972,3
2020-03-20-171020,171020,5,0,1,14,4.333333333333333,75.9865190405568,4
2020-03-21-171020,171020,2,0,5,16,2.1666666666666665,100.19871204004454,5
2020-03-22-171020,171020,1,0,0,17,6.0,106.08083877848753,6
2020-03-23-171020,171020,1,0,32,18,10.666666666666666,106.410086465863,0
2020-03-24-171020,171020,1,0,3,19,8.0,115.18043858945205,1
2020-03-25-171020,171020,2,0,1,21,8.333333333333334,114.8563946699475,2
2020-03-26-171020,171020,1,0,1,22,9.166666666666666,109.81767556876261,3
2020-03-27-171020,171020,1,0,3,23,6.833333333333332,117.68367244733483,4
2020-03-28-171020,171020,1,0,0,24,5.166666666666667,106.87596629763833,5
2020-03-29-171020,171020,1,0,0,25,2.833333333333333,105.3357312547871,6
2020-03-30-171020,171020,1,0,2,26,6.0,83.60323587383729,0
2020-03-31-171020,171020,1,0,1,27,5.666666666666668,80.1671113055319,1
2020-04-01-171020,171020,2,0,1,29,4.333333333333333,12.718955426158784,2
2020-04-02-171020,171020,1,0,0,30,5.833333333333332,70.87298030551273,3
2020-04-03-171020,171020,1,0,2,31,4.333333333333333,51.241719417386754,4
2020-04-04-171020,171020,5,0,0,36,3.5,64.2473149608702,5
2020-04-05-171020,171020,0,1,0,36,1.6666666666666667,81.25783567507591,6
2020-04-06-171020,171020,32,1,0,68,4.5,82.15754158289411,0
2020-04-07-171020,171020,3,1,0,71,3.0,168.3037240336306,1
2020-04-08-171020,171020,1,0,1,72,4.833333333333333,183.48980827685764,2
2020-04-09-171020,171020,1,0,0,73,2.5,192.82011566253226,3
2020-04-10-171020,171020,3,0,0,76,2.833333333333333,14.214449638541156,4
2020-04-11-171020,171020,0,0,0,76,4.833333333333333,28.653858535604112,5
2020-04-12-171020,171020,0,0,0,76,3.6666666666666665,33.27184510289692,6
2020-04-13-171020,171020,2,0,6,78,6.666666666666668,38.382930887283656,0
2020-04-14-171020,171020,1,0,0,79,4.0,60.79691337488807,1
2020-04-15-171020,171020,1,0,0,80,3.333333333333333,70.64599461605074,2
2020-04-16-171020,171020,0,1,2,80,3.333333333333333,82.96020868519382,3
2020-04-17-171020,171020,2,0,0,82,4.166666666666667,78.05813710069114,4
2020-04-18-171020,171020,0,0,1,82,2.0,78.70017101901277,5
2020-04-19-171020,171020,0,0,0,82,0.6666666666666666,75.21578759560349,6
2020-04-20-171020,171020,0,2,3,82,9.0,63.871627161572256,0
2020-04-21-171020,171020,0,0,0,82,2.6666666666666665,60.97788754922577,1
2020-04-22-171020,171020,1,0,3,83,3.0,52.082580206422705,2
2020-04-23-171020,171020,0,0,0,83,1.3333333333333333,54.14981996690725,3
2020-04-24-171020,171020,0,0,0,83,3.0,41.190616813695385,4
2020-04-25-171020,171020,0,0,0,83,1.3333333333333333,45.89799213208353,5
2020-04-26-171020,171020,0,0,0,83,0.5,50.01909046430667,6
2020-04-27-171020,171020,6,0,0,89,3.1666666666666665,33.07377305606587,0
2020-04-28-171020,171020,0,0,0,89,2.0,52.95363415121795,1
2020-04-29-171020,171020,0,0,0,89,2.6666666666666665,52.57761198723324,2
2020-04-30-171020,171020,2,0,2,91,2.0,62.29679142978446,3
2020-05-01-171020,171020,0,0,0,91,0.5,200.53992154894303,4
2020-05-02-171020,171020,1,0,0,92,1.8333333333333333,47.77990040618186,5
2020-05-03-171020,171020,0,0,1,92,0.5,26.627440925647072,6
2020-05-04-171020,171020,3,0,3,95,3.5,18.89231499271827,0
2020-05-05-171020,171020,0,0,2,95,1.8333333333333333,30.319748471287816,1
2020-05-06-171020,171020,3,0,0,98,3.1666666666666665,29.062870028419113,2
2020-05-07-171020,171020,0,0,0,98,2.833333333333333,37.122733391480025,3
2020-05-08-171020,171020,0,0,0,98,2.6666666666666665,40.35365510052566,4
2020-05-09-171020,171020,0,0,0,98,0.3333333333333333,49.57096364367122,5
2020-05-10-171020,171020,0,0,0,98,0.3333333333333333,221.7167993982337,6
2020-05-11-171020,171020,0,0,1,98,3.333333333333333,192.29078815421272,0
2020-05-12-171020,171020,0,0,0,98,2.0,211.0590961602007,1
2020-05-13-171020,171020,0,0,0,98,1.5,60.093593766198524,2
2020-05-14-171020,171020,2,0,0,100,3.0,36.87440845481591,3
2020-05-15-171020,171020,0,0,0,100,0.8333333333333334,37.36768238989153,4
2020-05-16-171020,171020,0,0,0,100,1.1666666666666667,31.435398494329494,5
2020-05-17-171020,171020,1,1,0,101,0.0,30.894848555437832,6
2020-05-18-171020,171020,3,0,0,104,3.1666666666666665,34.71809098412929,0
2020-05-19-171020,171020,2,0,0,106,1.1666666666666667,49.0749558420393,1
2020-05-20-171020,171020,0,0,1,106,1.5,62.34305283750816,2
2020-05-21-171020,171020,0,0,0,106,2.0,49.8679744116695,3
2020-05-22-171020,171020,0,0,0,106,1.6666666666666667,49.904419385033464,4
2020-05-23-171020,171020,0,0,0,106,1.5,53.290201642905714,5
2020-05-24-171020,171020,0,0,0,106,0.5,51.22534163262047,6
2020-05-25-171020,171020,1,0,0,107,1.8333333333333333,32.09096090158127,0
2020-05-26-171020,171020,0,0,0,107,1.8333333333333333,29.827216959743126,1
2020-05-27-171020,171020,0,0,0,107,3.8333333333333335,27.715312145749376,2
2020-05-28-171020,171020,0,4,0,107,2.0,31.859257746294148,3
2020-05-29-171020,171020,0,0,0,107,1.1666666666666667,37.813450879165885,4
2020-05-30-171020,171020,0,0,0,107,0.0,38.66408644799233,5
2020-05-31-171020,171020,0,0,0,107,0.3333333333333333,40.158875554552935,6
2020-06-01-171020,171020,0,0,0,107,2.1666666666666665,64.28375402320216,0
2020-06-02-171020,171020,0,0,0,107,1.5,12.799381835332637,1
2020-06-03-171020,171020,1,0,0,108,1.1666666666666667,17.07235105906078,2
2020-06-04-171020,171020,0,0,0,108,1.0,18.249685546498977,3
2020-06-05-171020,171020,0,0,0,108,1.0,19.34357341347371,4
2020-06-06-171020,171020,0,3,0,108,0.16666666666666666,18.35178150478679,5
2020-06-07-171020,171020,0,3,0,108,0.16666666666666666,17.48013471084572,6
2020-06-08-171020,171020,0,0,0,108,1.5,16.889454056237412,0
2020-06-09-171020,171020,0,0,1,108,1.1666666666666667,20.637115465004882,1
2020-06-10-171020,171020,0,0,0,108,1.0,66.58374669414968,2
2020-06-11-171020,171020,0,0,0,108,2.0,51.39651034789449,3
2020-06-12-171020,171020,0,0,0,108,0.3333333333333333,52.85038162125219,4
2020-06-13-171020,171020,0,2,0,108,0.16666666666666666,32.38139222522449,5
2020-06-14-171020,171020,0,0,0,108,0.0,26.129788559276566,6
2020-06-15-171020,171020,0,0,0,108,1.6666666666666667,18.145475327255014,0
2020-06-16-171020,171020,0,0,0,108,1.1666666666666667,20.078843219584243,1
2020-06-17-171020,171020,0,0,0,108,0.5,16.987730548693722,2
2020-06-18-171020,171020,0,0,0,108,0.5,14.619079549402162,3
2020-06-19-171020,171020,0,0,0,108,2.6666666666666665,11.187502636668853,4
2020-06-20-171020,171020,0,0,0,108,0.3333333333333333,17.79421326781208,5
2020-06-21-171020,171020,0,0,0,108,0.3333333333333333,18.590112231583127,6
2020-06-22-171020,171020,0,0,0,108,0.6666666666666666,16.408226117307024,0
2020-06-23-171020,171020,1,0,0,109,0.3333333333333333,16.138804927034574,1
2020-06-24-171020,171020,0,0,0,109,1.3333333333333333,22.36116453236754,2
2020-06-25-171020,171020,0,0,0,109,0.8333333333333334,23.22895907869271,3
2020-06-26-171020,171020,0,0,0,109,1.1666666666666667,21.183635760652823,4
2020-06-27-171020,171020,0,0,0,109,0.3333333333333333,21.320584082769578,5
2020-06-28-171020,171020,0,0,0,109,0.3333333333333333,21.84740732875194,6
2020-06-29-171020,171020,0,1,0,109,0.5,22.412259125305813,0
2020-06-30-171020,171020,0,0,1,109,0.6666666666666666,24.37966013935818,1
2020-07-01-171020,171020,0,0,0,109,1.0,19.077615582834646,2
2020-07-02-171020,171020,0,0,0,109,0.5,34.031502304403034,3
2020-07-03-171020,171020,0,0,0,109,0.6666666666666666,39.03766420713701,4
2020-07-04-171020,171020,0,0,1,109,0.5,26.39353960145516,5
2020-07-05-171020,171020,0,0,0,109,0.0,26.11843500160533,6
2020-07-06-171020,171020,0,0,0,109,0.8333333333333334,20.84178401272965,0
2020-07-07-171020,171020,0,0,1,109,0.3333333333333333,17.839818732637212,1
2020-07-08-171020,171020,0,0,0,109,0.5,15.666101106615162,2
2020-07-09-171020,171020,0,0,2,109,0.8333333333333334,15.794968843443728,3
2020-07-10-171020,171020,0,0,1,109,0.3333333333333333,20.611077245267076,4
2020-07-11-171020,171020,0,0,0,109,0.0,16.67080242556972,5
2020-07-12-171020,171020,0,0,0,109,0.0,14.79568648546131,6
2020-07-13-171020,171020,0,0,0,109,0.16666666666666666,14.565852238603743,0
2020-07-14-171020,171020,1,0,0,110,0.3333333333333333,15.056727267838049,1
2020-07-15-171020,171020,0,0,0,110,0.6666666666666666,16.9078723744499,2
2020-07-16-171020,171020,0,0,0,110,1.8333333333333333,15.163386826627685,3
2020-07-17-171020,171020,0,0,0,110,0.8333333333333334,22.774593070525782,4
2020-07-18-171020,171020,1,0,0,111,0.0,29.42175449368273,5
2020-07-19-171020,171020,0,0,0,111,0.5,33.594966940229114,6
2020-07-20-171020,171020,0,0,0,111,0.8333333333333334,37.21683003974717,0
2020-07-21-171020,171020,1,0,0,112,1.0,32.621193298471034,1
2020-07-22-171020,171020,0,0,0,112,0.16666666666666666,33.00858879240144,2
2020-07-23-171020,171020,2,0,0,114,0.3333333333333333,24.139204315353844,3
2020-07-24-171020,171020,1,0,0,115,1.6666666666666667,30.574364797222582,4
2020-07-25-171020,171020,0,0,0,115,0.16666666666666666,37.00367479291435,5
2020-07-26-171020,171020,0,0,0,115,0.5,35.552606974348826,6
2020-07-27-171020,171020,0,0,2,115,2.0,34.173323940096964,0
2020-07-28-171020,171020,0,0,0,115,3.1666666666666665,37.87549762920791,1
2020-07-29-171020,171020,0,0,0,115,1.8333333333333333,41.95552415005639,2
2020-07-30-171020,171020,0,0,0,115,2.833333333333333,30.94824755362524,3
2020-07-31-171020,171020,0,1,0,115,2.333333333333333,25.149936605179775,4
2020-08-01-171020,171020,0,0,1,115,0.6666666666666666,10.385670325256008,5
2020-08-02-171020,171020,0,0,0,115,0.16666666666666666,109.76773569661214,6
2020-08-03-171020,171020,0,0,0,115,2.333333333333333,97.2557088393827,0
2020-08-04-171020,171020,0,0,3,115,2.0,82.26757836273235,1
2020-08-05-171020,171020,0,0,1,115,2.5,64.87117470962548,2
2020-08-06-171020,171020,0,0,3,115,1.5,64.35117928473235,3
2020-08-07-171020,171020,0,0,1,115,2.0,47.59197129282536,4
2020-08-08-171020,171020,0,0,1,115,0.5,43.27606453724664,5
2020-08-09-171020,171020,0,0,0,115,1.0,40.58614877815596,6
2020-08-10-171020,171020,2,0,0,117,0.5,7.147712296886116,0
2020-08-11-171020,171020,0,0,1,117,2.333333333333333,8.890360060491421,1
2020-08-12-171020,171020,0,0,1,117,1.3333333333333333,19.70585494691072,2
2020-08-13-171020,171020,0,0,0,117,1.3333333333333333,20.953048061068934,3
2020-08-14-171020,171020,0,0,1,117,1.8333333333333333,26.82724085435009,4
2020-08-15-171020,171020,1,0,0,118,2.0,31.62509995536937,5
2020-08-16-171020,171020,0,0,0,118,0.3333333333333333,39.58730891060604,6
2020-08-17-171020,171020,0,0,0,118,1.8333333333333333,39.95541161400054,0
2020-08-18-171020,171020,3,0,2,121,3.1666666666666665,49.34869208271497,1
2020-08-19-171020,171020,1,0,2,122,4.833333333333333,67.99002120767713,2
2020-08-20-171020,171020,3,0,0,125,3.1666666666666665,86.60997020088783,3
2020-08-21-171020,171020,1,0,0,126,5.666666666666668,99.45823918169292,4
2020-08-22-171020,171020,1,0,0,127,1.6666666666666667,123.07133244992944,5
2020-08-23-171020,171020,0,0,0,127,1.6666666666666667,130.80295264332665,6
2020-08-24-171020,171020,0,0,0,127,2.833333333333333,123.39504199018947,0
2020-08-25-171020,171020,1,0,1,128,3.8333333333333335,106.57029828520638,1
2020-08-26-171020,171020,1,0,1,129,4.666666666666667,98.93204041986463,2
2020-08-27-171020,171020,0,0,0,129,2.1666666666666665,114.97885222227201,3
2020-08-28-171020,171020,1,0,2,130,4.333333333333333,105.70054174385818,4
2020-08-29-171020,171020,0,0,0,130,1.3333333333333333,90.49872623824426,5
2020-08-30-171020,171020,0,0,0,130,1.1666666666666667,87.43159498469637,6
2020-08-31-171020,171020,0,0,4,130,3.6666666666666665,80.68707715353591,0
2020-09-01-171020,171020,2,0,2,132,3.1666666666666665,38.68895977538408,1
2020-09-02-171020,171020,2,0,0,134,6.833333333333332,275.61277093000825,2
2020-09-03-171020,171020,0,0,0,134,4.333333333333333,290.21542367903527,3
2020-09-04-171020,171020,0,0,1,134,4.333333333333333,208.88652346365953,4
2020-09-05-171020,171020,0,0,10,134,4.833333333333333,197.23116045266687,5
2020-09-06-171020,171020,0,0,1,134,5.0,154.48295573447467,6
2020-09-07-171020,171020,0,0,6,134,7.833333333333332,152.7601417366037,0
2020-09-08-171020,171020,1,0,4,135,6.166666666666668,163.1885108000605,1
2020-09-09-171020,171020,1,0,11,136,4.333333333333333,163.07462745093994,2
2020-09-10-171020,171020,0,1,5,136,5.166666666666667,52.72172335298038,3
2020-09-11-171020,171020,2,0,6,138,9.166666666666666,70.678338306904,4
2020-09-12-171020,171020,0,0,4,138,3.8333333333333335,89.4330520616401,5
2020-09-13-171020,171020,0,0,1,138,2.5,105.4424464922999,6
2020-09-14-171020,171020,4,0,2,142,8.166666666666666,113.19624214889802,0
2020-09-15-171020,171020,2,0,0,144,10.5,152.7132812519041,1
2020-09-16-171020,171020,0,0,10,144,9.5,199.55273832558225,2
2020-09-17-171020,171020,0,0,7,144,8.166666666666666,205.81661869106415,3
2020-09-18-171020,171020,1,0,5,145,5.666666666666668,219.3207161431407,4
2020-09-19-171020,171020,10,0,7,155,5.166666666666667,226.3962094765927,5
2020-09-20-171020,171020,1,0,0,156,3.333333333333333,283.55028864754667,6
2020-09-21-171020,171020,6,0,1,162,7.166666666666668,249.820265976143,0
2020-09-22-171020,171020,4,0,9,166,8.0,262.0986692613901,1
2020-09-23-171020,171020,11,1,2,177,10.333333333333334,254.69865407253897,2
2020-09-24-171020,171020,5,0,3,182,9.833333333333334,300.7493554374821,3
2020-09-25-171020,171020,6,0,0,188,10.666666666666666,339.88593306454584,4
2020-09-26-171020,171020,4,0,5,192,9.666666666666666,291.0777617319233,5
2020-09-27-171020,171020,1,0,0,193,0.8333333333333334,330.87201340429647,6
2020-09-28-171020,171020,2,0,0,195,4.333333333333333,334.360407225976,0
2020-09-29-171020,171020,0,0,3,195,5.333333333333333,300.40824951761795,1
2020-09-30-171020,171020,10,0,1,205,3.5,224.2727730271762,2
2020-10-01-171020,171020,7,1,2,212,7.5,0.0,3
2020-10-02-171020,171020,5,0,8,217,7.5,201.57515005955923,4
2020-10-03-171020,171020,7,0,9,224,3.1666666666666665,402.04359408990524,5
2020-10-04-171020,171020,0,0,0,224,3.6666666666666665,458.063878620379,6
2020-10-05-171020,171020,1,0,1,225,4.0,395.20854846371395,0
2020-10-06-171020,171020,9,0,6,234,9.666666666666666,364.4497226839268,1
2020-10-07-171020,171020,2,1,2,236,6.333333333333332,397.7053384796355,2
2020-10-08-171020,171020,3,1,0,239,4.333333333333333,335.82551446789466,3
2020-10-09-171020,171020,0,0,2,239,5.0,316.9572149176468,4
2020-10-10-171020,171020,5,0,16,244,2.5,61.14618874081209,5
2020-10-11-171020,171020,0,0,0,244,2.1666666666666665,94.92999234151927,6
2020-10-12-171020,171020,0,0,1,244,2.333333333333333,106.57620640511641,0
2020-10-13-171020,171020,3,0,6,247,4.833333333333333,110.32222103838882,1
2020-10-14-171020,171020,1,0,4,248,4.5,144.32471241834128,2
2020-10-15-171020,171020,2,0,5,250,5.166666666666667,167.52438049832045,3
2020-10-16-171020,171020,8,0,1,258,6.166666666666668,202.77630317195187,4
2020-10-17-171020,171020,9,0,11,267,4.333333333333333,152.12080464929338,5
2020-10-18-171020,171020,0,0,2,267,3.333333333333333,182.39677496041224,6
2020-10-19-171020,171020,1,1,1,268,6.333333333333332,184.66527761592542,0
2020-10-20-171020,171020,6,0,4,274,10.0,210.33370851595208,1
2020-10-21-171020,171020,2,1,2,276,4.0,257.4580181842665,2
2020-10-22-171020,171020,0,0,9,276,6.5,251.52597784190345,3
2020-10-23-171020,171020,2,0,10,278,4.666666666666667,259.42884944295923,4
2020-10-24-171020,171020,16,0,6,294,6.333333333333332,231.1426627315051,5
2020-10-25-171020,171020,0,1,2,294,4.5,312.3662977898812,6
2020-10-26-171020,171020,1,0,3,295,10.666666666666666,289.33249788104945,0
2020-10-27-171020,171020,6,0,0,301,9.666666666666666,321.518602898112,1
2020-10-28-171020,171020,4,0,0,305,12.166666666666664,317.9494970979181,2
2020-10-29-171020,171020,5,0,1,310,10.333333333333334,349.44498527906046,3
2020-10-30-171020,171020,1,0,7,311,10.166666666666666,436.0359291799005,4
2020-10-31-171020,171020,11,0,0,322,9.666666666666666,377.3286652617433,5
2020-11-01-171020,171020,2,0,0,324,5.5,310.90583396304123,6
2020-11-02-171020,171020,1,0,0,325,6.666666666666668,330.9911229859299,0
2020-11-03-171020,171020,4,0,0,329,7.0,237.5633887159505,1
2020-11-04-171020,171020,2,1,0,331,11.333333333333336,278.0455590892915,2
2020-11-05-171020,171020,9,1,0,340,10.666666666666666,310.9731371169832,3
2020-11-06-171020,171020,10,0,0,350,10.833333333333336,326.8212448285812,4
2020-11-07-171020,171020,6,0,0,356,5.166666666666667,387.9415874965607,5
2020-11-08-171020,171020,2,0,0,358,4.166666666666667,406.1273211698175,6
2020-11-09-171020,171020,3,0,0,361,9.166666666666666,386.8489944632495,0
2020-11-10-171020,171020,0,0,0,361,9.666666666666666,245.64497893868142,1
2020-11-11-171020,171020,0,1,0,361,6.166666666666668,264.9451969221133,2
2020-11-12-171020,171020,1,0,0,362,6.5,269.0813923064122,3
2020-11-13-171020,171020,7,2,0,369,8.833333333333334,226.57394713695348,4
2020-03-01-171021,171021,0,0,0,0,0.125,0.0,6
2020-03-02-171021,171021,0,0,0,0,0.25,49.2405174307901,0
2020-03-03-171021,171021,0,0,0,0,0.0,257.23132058587964,1
2020-03-04-171021,171021,0,1,0,0,0.0,283.1684923130789,2
2020-03-05-171021,171021,0,0,4,0,0.125,293.7361607309184,3
2020-03-06-171021,171021,0,0,1,0,0.0,270.2880498587565,4
2020-03-07-171021,171021,0,0,2,0,0.0,261.1858121966047,5
2020-03-08-171021,171021,0,0,1,0,0.0,265.9900419284451,6
2020-03-09-171021,171021,0,0,3,0,0.125,267.8932427989206,0
2020-03-10-171021,171021,0,0,0,0,0.375,2556.854273675065,1
2020-03-11-171021,171021,0,0,1,0,0.25,2033.5148570043712,2
2020-03-12-171021,171021,0,0,2,0,0.0,1201.1669848236372,3
2020-03-13-171021,171021,0,0,1,0,0.375,776.7424315825363,4
2020-03-14-171021,171021,0,0,1,0,0.0,401.0823219418659,5
2020-03-15-171021,171021,0,0,0,0,0.375,344.5518653722172,6
2020-03-16-171021,171021,0,0,1,0,1.5,38.604050561113596,0
2020-03-17-171021,171021,0,1,2,0,1.25,73.88106904770734,1
2020-03-18-171021,171021,0,0,1,0,3.0,100.16396734566354,2
2020-03-19-171021,171021,4,0,0,4,5.125,135.6807374683872,3
2020-03-20-171021,171021,1,0,3,5,3.375,271.7186323971991,4
2020-03-21-171021,171021,2,0,2,7,2.0,315.58939745711905,5
2020-03-22-171021,171021,1,1,0,8,2.125,361.66301350249626,6
2020-03-23-171021,171021,3,0,2,11,7.0,372.8780959606483,0
2020-03-24-171021,171021,0,0,4,11,4.375,506.0208174573538,1
2020-03-25-171021,171021,1,0,3,12,5.75,515.2078501477226,2
2020-03-26-171021,171021,2,0,0,14,5.875,461.0920838974365,3
2020-03-27-171021,171021,1,0,0,15,5.5,536.1999933501615,4
2020-03-28-171021,171021,1,0,1,16,3.625,545.9925916661631,5
2020-03-29-171021,171021,0,0,4,16,2.625,524.3411165230896,6
2020-03-30-171021,171021,1,0,4,17,5.75,346.0499456926788,0
2020-03-31-171021,171021,2,0,2,19,3.625,352.3901746472528,1
2020-04-01-171021,171021,1,0,1,20,3.625,70.84223092812658,2
2020-04-02-171021,171021,0,0,0,20,3.875,335.84571614804776,3
2020-04-03-171021,171021,3,0,1,23,3.125,238.42362794842467,4
2020-04-04-171021,171021,2,0,0,25,3.625,238.1639604554659,5
2020-04-05-171021,171021,0,0,0,25,1.0,287.6457450215628,6
2020-04-06-171021,171021,2,0,0,27,15.375,290.7809751578867,0
2020-04-07-171021,171021,4,1,1,31,4.625,381.1590800386988,1
2020-04-08-171021,171021,3,0,1,34,3.0,474.8485513573331,2
2020-04-09-171021,171021,0,0,1,34,3.25,492.0807321992001,3
2020-04-10-171021,171021,0,0,3,34,4.25,54.854801435325584,4
2020-04-11-171021,171021,1,0,0,35,1.625,82.88409305854887,5
2020-04-12-171021,171021,4,0,0,39,0.75,112.06139946859176,6
2020-04-13-171021,171021,4,0,1,43,5.125,172.58055997776523,0
2020-04-14-171021,171021,2,0,1,45,3.0,298.4313217678785,1
2020-04-15-171021,171021,1,0,2,46,4.0,360.412930480622,2
2020-04-16-171021,171021,0,0,0,46,2.75,418.9413530545391,3
2020-04-17-171021,171021,1,0,0,47,3.25,405.9356154953011,4
2020-04-18-171021,171021,0,0,0,47,1.25,438.8451571878128,5
2020-04-19-171021,171021,0,0,0,47,0.75,411.46481374562825,6
2020-04-20-171021,171021,0,0,0,47,3.25,239.0022425113857,0
2020-04-21-171021,171021,1,0,1,48,1.375,196.9602523293268,1
2020-04-22-171021,171021,1,0,0,49,2.375,148.0767094925303,2
2020-04-23-171021,171021,1,0,1,50,0.625,163.50646808603156,3
2020-04-24-171021,171021,3,0,2,53,3.625,137.27855336735269,4
2020-04-25-171021,171021,0,0,0,53,0.625,215.69180319187268,5
2020-04-26-171021,171021,0,0,0,53,0.375,220.98178774482767,6
2020-04-27-171021,171021,1,0,1,54,3.5,189.57279975642317,0
2020-04-28-171021,171021,1,0,0,55,1.25,217.87757735037013,1
2020-04-29-171021,171021,2,0,1,57,2.125,228.68413161640999,2
2020-04-30-171021,171021,0,0,1,57,1.625,318.59707558939607,3
2020-05-01-171021,171021,0,0,1,57,0.5,478.04907797873267,4
2020-05-02-171021,171021,0,0,0,57,0.75,207.5715940756901,5
2020-05-03-171021,171021,0,0,0,57,0.25,281.76740839334644,6
2020-05-04-171021,171021,0,0,2,57,2.75,235.71414398722465,0
2020-05-05-171021,171021,1,0,2,58,0.875,239.87056554111152,1
2020-05-06-171021,171021,0,0,0,58,3.25,263.70797255464566,2
2020-05-07-171021,171021,1,0,1,59,1.25,185.64562639303804,3
2020-05-08-171021,171021,2,0,1,61,1.875,153.90262962723966,4
2020-05-09-171021,171021,0,1,0,61,0.375,236.50308061693192,5
2020-05-10-171021,171021,0,0,0,61,0.25,553.8682618702602,6
2020-05-11-171021,171021,1,0,2,62,1.0,477.1149721555395,0
2020-05-12-171021,171021,0,0,2,62,1.375,514.7922958861074,1
2020-05-13-171021,171021,1,0,0,63,1.0,343.9199254964604,2
2020-05-14-171021,171021,1,0,5,64,1.5,217.4946643887069,3
2020-05-15-171021,171021,1,1,2,65,0.375,181.7649029667376,4
2020-05-16-171021,171021,0,0,0,65,0.25,178.26041135069076,5
2020-05-17-171021,171021,0,0,0,65,0.125,175.92141703394338,6
2020-05-18-171021,171021,2,0,1,67,1.75,178.93343931960288,0
2020-05-19-171021,171021,2,0,0,69,0.5,211.95389502318116,1
2020-05-20-171021,171021,0,0,1,69,0.5,234.45890871493992,2
2020-05-21-171021,171021,1,0,1,70,0.5,199.2072197112539,3
2020-05-22-171021,171021,1,0,0,71,0.25,203.0443280054313,4
2020-05-23-171021,171021,0,0,0,71,0.375,263.4546843183964,5
2020-05-24-171021,171021,0,0,0,71,0.25,266.84265092178214,6
2020-05-25-171021,171021,2,0,2,73,1.125,192.7408706660321,0
2020-05-26-171021,171021,2,0,0,75,1.0,201.1062514061754,1
2020-05-27-171021,171021,0,1,1,75,2.25,232.87129531934198,2
2020-05-28-171021,171021,5,6,1,80,0.75,244.75164468134182,3
2020-05-29-171021,171021,2,0,0,82,0.625,365.78916183487365,4
2020-05-30-171021,171021,0,0,0,82,0.375,408.4958979961326,5
2020-05-31-171021,171021,0,0,0,82,0.125,418.16914557285213,6
2020-06-01-171021,171021,1,0,0,83,0.375,311.2424660805689,0
2020-06-02-171021,171021,0,0,0,83,1.375,86.81042525014541,1
2020-06-03-171021,171021,1,0,0,84,2.0,108.6149909011351,2
2020-06-04-171021,171021,1,0,0,85,0.875,141.69031021277505,3
2020-06-05-171021,171021,0,0,1,85,1.125,147.4728945547254,4
2020-06-06-171021,171021,0,0,0,85,0.125,123.25320806330384,5
2020-06-07-171021,171021,0,0,0,85,0.125,122.78374797527516,6
2020-06-08-171021,171021,2,0,0,87,0.875,122.71310341165857,0
2020-06-09-171021,171021,0,0,0,87,1.25,185.16198829860218,1
2020-06-10-171021,171021,1,0,0,88,1.5,355.1377609761271,2
2020-06-11-171021,171021,1,0,1,89,1.125,357.8578218420507,3
2020-06-12-171021,171021,0,0,1,89,1.0,353.6304586284235,4
2020-06-13-171021,171021,0,0,0,89,0.25,303.4390301100944,5
2020-06-14-171021,171021,0,0,0,89,0.0,249.23664592052373,6
2020-06-15-171021,171021,0,0,0,89,0.25,155.48089879410728,0
2020-06-16-171021,171021,0,0,0,89,1.375,153.14246494784,1
2020-06-17-171021,171021,0,0,0,89,1.25,121.85910143680738,2
2020-06-18-171021,171021,0,0,1,89,1.25,92.77039635797328,3
2020-06-19-171021,171021,1,0,0,90,1.25,61.776337575164355,4
2020-06-20-171021,171021,0,0,0,90,0.25,107.11205076048074,5
2020-06-21-171021,171021,0,0,0,90,0.25,110.82806400657104,6
2020-06-22-171021,171021,0,0,0,90,1.0,107.77090233102746,0
2020-06-23-171021,171021,0,0,0,90,1.125,111.48957138624849,1
2020-06-24-171021,171021,0,1,0,90,0.75,114.46390655767742,2
2020-06-25-171021,171021,1,1,0,91,0.375,111.87208644983247,3
2020-06-26-171021,171021,1,0,0,92,0.375,103.2937805348388,4
2020-06-27-171021,171021,0,1,0,92,0.125,128.56081319519936,5
2020-06-28-171021,171021,0,0,0,92,0.25,129.7324446108608,6
2020-06-29-171021,171021,0,0,0,92,1.25,131.22263434970253,0
2020-06-30-171021,171021,0,0,1,92,0.25,169.82075359306353,1
2020-07-01-171021,171021,0,0,1,92,1.125,176.23835486175076,2
2020-07-02-171021,171021,1,0,2,93,1.375,129.43672426105786,3
2020-07-03-171021,171021,0,0,0,93,0.5,166.26069259222749,4
2020-07-04-171021,171021,0,0,0,93,0.125,129.49420591451582,5
2020-07-05-171021,171021,0,0,0,93,0.25,129.04632384735774,6
2020-07-06-171021,171021,0,0,1,93,1.25,88.56580019712007,0
2020-07-07-171021,171021,0,0,0,93,0.875,89.3351162938896,1
2020-07-08-171021,171021,0,0,0,93,0.0,83.19121271619312,2
2020-07-09-171021,171021,0,0,0,93,0.375,82.53171700415561,3
2020-07-10-171021,171021,0,0,2,93,0.75,180.9395726496447,4
2020-07-11-171021,171021,0,0,0,93,0.25,137.43603690457456,5
2020-07-12-171021,171021,0,0,0,93,0.0,125.71957922733499,6
2020-07-13-171021,171021,0,0,1,93,1.625,125.02436681917192,0
2020-07-14-171021,171021,1,0,0,94,0.25,132.35929077115384,1
2020-07-15-171021,171021,1,0,0,95,1.0,91.85493119258052,2
2020-07-16-171021,171021,2,1,2,97,0.75,78.78408107759235,3
2020-07-17-171021,171021,0,0,1,97,0.75,114.67791373469619,4
2020-07-18-171021,171021,0,0,0,97,0.25,122.06346249835721,5
2020-07-19-171021,171021,0,0,0,97,0.625,121.39464362293161,6
2020-07-20-171021,171021,1,0,0,98,1.0,158.93718386365092,0
2020-07-21-171021,171021,0,0,0,98,0.875,160.4154885658845,1
2020-07-22-171021,171021,0,0,2,98,0.75,160.18603662682364,2
2020-07-23-171021,171021,0,0,0,98,0.5,123.97821476353334,3
2020-07-24-171021,171021,2,0,2,100,0.5,129.2735175587312,4
2020-07-25-171021,171021,0,0,0,100,0.125,202.83537624945205,5
2020-07-26-171021,171021,0,0,0,100,0.125,196.63068800616594,6
2020-07-27-171021,171021,1,0,0,101,0.125,159.56517703486782,0
2020-07-28-171021,171021,0,0,0,101,0.5,161.56640799120893,1
2020-07-29-171021,171021,0,0,0,101,0.625,160.71155226293558,2
2020-07-30-171021,171021,2,0,1,103,0.75,151.38071807117413,3
2020-07-31-171021,171021,1,0,1,104,0.75,119.62032807809113,4
2020-08-01-171021,171021,0,0,0,104,0.25,37.20237606106075,5
2020-08-02-171021,171021,0,0,0,104,0.625,628.9209488887191,6
2020-08-03-171021,171021,0,0,2,104,0.5,686.5995378853717,0
2020-08-04-171021,171021,0,0,2,104,0.75,641.0887102190412,1
2020-08-05-171021,171021,2,0,8,106,0.375,512.1420129763271,2
2020-08-06-171021,171021,0,0,1,106,0.375,520.6385668135845,3
2020-08-07-171021,171021,2,0,2,108,0.25,447.8094541725046,4
2020-08-08-171021,171021,0,0,0,108,0.375,374.5966284969184,5
2020-08-09-171021,171021,0,0,2,108,0.375,364.3925989323333,6
2020-08-10-171021,171021,0,0,2,108,0.5,29.02964001380809,0
2020-08-11-171021,171021,0,0,1,108,1.75,35.82623977308179,1
2020-08-12-171021,171021,0,0,3,108,0.875,58.748095850446596,2
2020-08-13-171021,171021,1,0,1,109,1.0,58.84817471062765,3
2020-08-14-171021,171021,1,0,0,110,1.625,124.36943067748399,4
2020-08-15-171021,171021,0,0,2,110,1.875,166.30204243187828,5
2020-08-16-171021,171021,0,0,1,110,0.25,175.97962206838423,6
2020-08-17-171021,171021,2,0,4,112,0.75,181.2843619097901,0
2020-08-18-171021,171021,2,0,1,114,2.0,243.01786641321172,1
2020-08-19-171021,171021,8,0,1,122,2.125,276.2487816330708,2
2020-08-20-171021,171021,1,0,3,123,3.125,463.5267049770011,3
2020-08-21-171021,171021,2,0,0,125,3.25,492.4308492728516,4
2020-08-22-171021,171021,0,0,6,125,1.125,588.503088840514,5
2020-08-23-171021,171021,2,0,2,127,0.875,606.8434640074865,6
2020-08-24-171021,171021,2,0,13,129,3.375,604.6177619324517,0
2020-08-25-171021,171021,1,0,4,130,5.0,627.8756818162266,1
2020-08-26-171021,171021,3,0,3,133,4.5,470.77030123134017,2
2020-08-27-171021,171021,1,0,3,134,2.125,586.2674263334777,3
2020-08-28-171021,171021,0,0,5,134,3.375,602.2027160335457,4
2020-08-29-171021,171021,2,0,8,136,2.375,549.6170631085854,5
2020-08-30-171021,171021,1,0,5,137,2.0,564.8954668634701,6
2020-08-31-171021,171021,4,0,13,141,2.375,544.5638951110159,0
2020-09-01-171021,171021,1,0,10,142,2.25,283.22512008557254,1
2020-09-02-171021,171021,1,0,11,143,3.25,2255.785995720542,2
2020-09-03-171021,171021,3,0,10,146,2.125,2255.823697066957,3
2020-09-04-171021,171021,0,0,8,146,2.5,1507.4842328848597,4
2020-09-05-171021,171021,6,0,11,152,1.625,1277.9267901776027,5
2020-09-06-171021,171021,2,0,4,154,0.625,975.8778295994816,6
2020-09-07-171021,171021,13,0,3,167,3.0,992.4551474260996,0
2020-09-08-171021,171021,4,0,4,171,2.125,1150.3775885113657,1
2020-09-09-171021,171021,3,0,18,174,2.625,1033.7525105191803,2
2020-09-10-171021,171021,3,0,18,177,3.25,215.4449106649779,3
2020-09-11-171021,171021,5,0,17,182,5.25,392.59160631747466,4
2020-09-12-171021,171021,8,0,13,190,3.5,472.3290681976174,5
2020-09-13-171021,171021,5,0,1,195,1.125,685.424411084698,6
2020-09-14-171021,171021,13,0,4,208,5.25,798.2602409369556,0
2020-09-15-171021,171021,10,0,4,218,5.75,1203.6047902558637,1
2020-09-16-171021,171021,11,0,6,229,5.125,1520.8359810393767,2
2020-09-17-171021,171021,10,0,7,239,5.125,1803.98973510952,3
2020-09-18-171021,171021,8,0,7,247,5.625,1953.2136998477704,4
2020-09-19-171021,171021,11,0,5,258,4.25,2102.6882317530253,5
2020-09-20-171021,171021,4,0,2,262,1.625,2082.3003958127592,6
2020-09-21-171021,171021,3,0,3,265,4.25,1777.0278354542452,0
2020-09-22-171021,171021,4,0,14,269,4.625,1640.3490799971664,1
2020-09-23-171021,171021,18,1,10,287,7.5,1437.026345402884,2
2020-09-24-171021,171021,18,0,4,305,7.25,1547.4343184279323,3
2020-09-25-171021,171021,17,0,12,322,9.375,1888.3422826302658,4
2020-09-26-171021,171021,13,0,2,335,4.5,1839.2967398763979,5
2020-09-27-171021,171021,1,0,1,336,1.625,2243.5379127191163,6
2020-09-28-171021,171021,4,0,1,340,3.375,2181.211660925392,0
2020-09-29-171021,171021,4,0,4,344,2.75,2149.830956509858,1
2020-09-30-171021,171021,6,0,4,350,5.25,1863.7266823256193,2
2020-10-01-171021,171021,7,0,6,357,9.75,0.0,3
2020-10-02-171021,171021,7,1,3,364,5.875,938.8279885962334,4
2020-10-03-171021,171021,5,0,3,369,4.625,2137.4139780400496,5
2020-10-04-171021,171021,2,1,3,371,3.625,2611.0842260313607,6
2020-10-05-171021,171021,3,0,1,374,3.75,1965.7438208554859,0
2020-10-06-171021,171021,14,0,6,388,6.75,1742.5309212238924,1
2020-10-07-171021,171021,10,0,1,398,4.875,1744.9426478324008,2
2020-10-08-171021,171021,4,1,5,402,4.875,1473.2931425004967,3
2020-10-09-171021,171021,12,1,6,414,3.875,1446.3392641025569,4
2020-10-10-171021,171021,2,0,0,416,1.625,193.5398116572231,5
2020-10-11-171021,171021,1,0,0,417,3.625,264.75265241550545,6
2020-10-12-171021,171021,1,0,22,418,1.625,318.93318919139017,0
2020-10-13-171021,171021,4,0,6,422,2.5,341.0231554561679,1
2020-10-14-171021,171021,4,0,9,426,4.625,466.61970588639696,2
2020-10-15-171021,171021,6,0,9,432,4.25,589.5333385428107,3
2020-10-16-171021,171021,3,0,11,435,6.75,757.4384602812971,4
2020-10-17-171021,171021,3,0,15,438,5.125,630.4622793184972,5
2020-10-18-171021,171021,3,1,11,441,1.875,701.9147792065388,6
2020-10-19-171021,171021,1,0,17,442,3.0,736.6088446104498,0
2020-10-20-171021,171021,6,1,8,448,8.5,904.7198219513884,1
2020-10-21-171021,171021,1,0,10,449,4.25,1031.6340219825108,2
2020-10-22-171021,171021,5,0,10,454,4.25,971.3224926668313,3
2020-10-23-171021,171021,6,0,4,460,3.5,1071.8319849446593,4
2020-10-24-171021,171021,0,0,8,460,7.625,1144.7530636353176,5
2020-10-25-171021,171021,0,0,0,460,2.25,1154.3518546280866,6
2020-10-26-171021,171021,22,0,6,482,5.125,1075.2687662169399,0
2020-10-27-171021,171021,6,0,9,488,8.0,1448.5132976901605,1
2020-10-28-171021,171021,9,0,7,497,7.875,1409.0761311255153,2
2020-10-29-171021,171021,9,0,10,506,10.75,1553.7460260302316,3
2020-10-30-171021,171021,11,1,2,517,7.75,2011.942740653298,4
2020-10-31-171021,171021,15,1,0,532,5.875,2241.428610700574,5
2020-11-01-171021,171021,11,0,0,543,2.625,1649.9944786437504,6
2020-11-02-171021,171021,17,0,0,560,2.25,1727.5972663330485,0
2020-11-03-171021,171021,8,1,0,568,6.125,1478.6091950285897,1
2020-11-04-171021,171021,10,1,0,578,7.125,1681.1998182638083,2
2020-11-05-171021,171021,10,1,0,588,8.125,1876.4626837971339,3
2020-11-06-171021,171021,4,1,0,592,8.0,1749.080419349285,4
2020-11-07-171021,171021,8,0,0,600,6.0,1880.9947022843273,5
2020-11-08-171021,171021,0,0,0,600,2.375,1923.5017315372122,6
2020-11-09-171021,171021,6,0,0,606,4.0,1633.7298550481207,0
2020-11-10-171021,171021,9,1,0,615,5.875,1495.0730267735087,1
2020-11-11-171021,171021,7,0,0,622,7.125,1659.0603192278695,2
2020-11-12-171021,171021,10,0,0,632,7.0,1756.2567753180292,3
2020-11-13-171021,171021,2,2,0,634,8.875,1702.4386698467645,4
2020-03-01-171022,171022,0,0,0,0,0.0,0.0,6
2020-03-02-171022,171022,0,0,3,0,0.0,1.0641511296685247,0
2020-03-03-171022,171022,0,0,1,0,0.0,5.566357650938283,1
2020-03-04-171022,171022,0,0,9,0,0.0,6.21780279410793,2
2020-03-05-171022,171022,0,0,9,0,0.0,6.353505198359456,3
2020-03-06-171022,171022,0,0,8,0,0.0,5.8849397698575086,4
2020-03-07-171022,171022,0,0,4,0,0.0,5.669158338129391,5
2020-03-08-171022,171022,0,0,6,0,0.0,5.90268524968562,6
2020-03-09-171022,171022,1,0,12,1,0.0,5.93425152921076,0
2020-03-10-171022,171022,2,0,10,3,0.0,64.45716539511895,1
2020-03-11-171022,171022,1,0,13,4,0.0,50.706658052304974,2
2020-03-12-171022,171022,0,0,17,4,0.0,29.29597252955158,3
2020-03-13-171022,171022,0,0,18,4,0.0,18.97455054504558,4
2020-03-14-171022,171022,0,0,6,4,0.0,9.487966179452876,5
2020-03-15-171022,171022,0,0,5,4,0.0,8.363813849293171,6
2020-03-16-171022,171022,3,0,23,7,0.0,0.7298671117894906,0
2020-03-17-171022,171022,1,0,15,8,0.0,1.3301561730748401,1
2020-03-18-171022,171022,9,0,9,17,0.0,1.7348234016386255,2
2020-03-19-171022,171022,9,0,13,26,4.0,2.2122001148653467,3
2020-03-20-171022,171022,8,0,13,34,1.0,5.354377647153203,4
2020-03-21-171022,171022,4,0,15,38,2.0,6.033370742368035,5
2020-03-22-171022,171022,6,0,5,44,1.0,7.105117175228489,6
2020-03-23-171022,171022,12,0,72,56,3.0,7.498338992607905,0
2020-03-24-171022,171022,10,0,8,66,0.0,10.406770438610188,1
2020-03-25-171022,171022,13,0,9,79,1.0,10.514004657697829,2
2020-03-26-171022,171022,17,0,4,96,2.0,8.888844000112815,3
2020-03-27-171022,171022,18,0,11,114,1.0,10.45433633023296,4
2020-03-28-171022,171022,6,0,0,120,1.0,10.557016551945154,5
2020-03-29-171022,171022,5,0,2,125,0.0,9.949856502277962,6
2020-03-30-171022,171022,23,0,10,148,1.0,6.1136931237938885,0
2020-03-31-171022,171022,15,0,6,163,2.0,6.376136293651876,1
2020-04-01-171022,171022,9,0,4,172,1.0,1.505710122874912,2
2020-04-02-171022,171022,13,0,12,185,0.0,6.697978970861874,3
2020-04-03-171022,171022,13,0,13,198,3.0,5.306947903413191,4
2020-04-04-171022,171022,15,0,1,213,2.0,5.045506661871425,5
2020-04-05-171022,171022,5,0,3,218,0.0,6.252686747927596,6
2020-04-06-171022,171022,72,0,7,290,2.0,6.321068892787639,0
2020-04-07-171022,171022,8,1,3,298,4.0,7.830954094109978,1
2020-04-08-171022,171022,9,0,4,307,3.0,9.806108550333242,2
2020-04-09-171022,171022,4,0,1,311,0.0,10.130956340664007,3
2020-04-10-171022,171022,11,0,13,322,0.0,0.9791757361019556,4
2020-04-11-171022,171022,0,0,0,322,1.0,1.2639586290572729,5
2020-04-12-171022,171022,2,0,1,324,4.0,1.9251500537470192,6
2020-04-13-171022,171022,10,0,11,334,4.0,3.508059042136712,0
2020-04-14-171022,171022,6,0,5,340,2.0,6.329212701791077,1
2020-04-15-171022,171022,4,0,4,344,1.0,7.74553740150964,2
2020-04-16-171022,171022,12,0,3,356,0.0,8.67391276437096,3
2020-04-17-171022,171022,13,0,3,369,1.0,8.491210030350997,4
2020-04-18-171022,171022,1,0,1,370,0.0,9.512582074874349,5
2020-04-19-171022,171022,3,0,0,373,0.0,8.908837122934308,6
2020-04-20-171022,171022,7,0,7,380,0.0,4.5251729105400935,0
2020-04-21-171022,171022,3,0,2,383,1.0,3.4209056280420755,1
2020-04-22-171022,171022,4,0,7,387,1.0,2.6383543242329024,2
2020-04-23-171022,171022,1,0,1,388,1.0,3.0729575681610504,3
2020-04-24-171022,171022,13,0,1,401,3.0,2.628596543755751,4
2020-04-25-171022,171022,0,0,0,401,0.0,4.568346624567237,5
2020-04-26-171022,171022,1,0,0,402,0.0,4.590653874027614,6
2020-04-27-171022,171022,11,0,2,413,1.0,4.102008166376062,0
2020-04-28-171022,171022,5,2,4,418,1.0,4.7583537342123,1
2020-04-29-171022,171022,4,0,3,422,2.0,5.09110125637925,2
2020-04-30-171022,171022,3,0,1,425,0.0,7.18561259370769,3
2020-05-01-171022,171022,3,0,1,428,0.0,9.414041260493466,4
2020-05-02-171022,171022,1,0,0,429,0.0,4.743713512560527,5
2020-05-03-171022,171022,0,0,0,429,0.0,7.062451268164271,6
2020-05-04-171022,171022,7,0,2,436,0.0,5.923338794581547,0
2020-05-05-171022,171022,2,0,0,438,1.0,5.777790204131157,1
2020-05-06-171022,171022,7,0,0,445,0.0,6.402315885576076,2
2020-05-07-171022,171022,1,0,1,446,1.0,3.7555391639817377,3
2020-05-08-171022,171022,1,0,0,447,2.0,2.654833698122221,4
2020-05-09-171022,171022,0,0,1,447,0.0,4.481256398528251,5
2020-05-10-171022,171022,0,0,0,447,0.0,10.963379362402254,6
2020-05-11-171022,171022,2,1,2,449,1.0,9.22453096449248,0
2020-05-12-171022,171022,4,0,6,453,0.0,9.93062999400429,1
2020-05-13-171022,171022,3,0,4,456,1.0,6.87768692925367,2
2020-05-14-171022,171022,1,0,3,457,1.0,4.3382876687797065,3
2020-05-15-171022,171022,1,0,3,458,1.0,3.4895664404347975,4
2020-05-16-171022,171022,0,0,1,458,0.0,3.8333757234550334,5
2020-05-17-171022,171022,0,2,0,458,0.0,3.7932529611690278,6
2020-05-18-171022,171022,2,0,1,460,2.0,3.8240615844935326,0
2020-05-19-171022,171022,0,0,2,460,2.0,4.621545486003331,1
2020-05-20-171022,171022,0,0,8,460,0.0,5.308036950234709,2
2020-05-21-171022,171022,1,0,3,461,1.0,4.492938821010733,3
2020-05-22-171022,171022,0,0,4,461,1.0,4.568038136061201,4
2020-05-23-171022,171022,1,0,0,462,0.0,6.114492548528899,5
2020-05-24-171022,171022,0,0,0,462,0.0,6.182561826208327,6
2020-05-25-171022,171022,2,0,5,464,2.0,4.475854451250434,0
2020-05-26-171022,171022,6,0,6,470,2.0,4.6109469173611854,1
2020-05-27-171022,171022,4,0,8,474,0.0,5.456871427627312,2
2020-05-28-171022,171022,3,0,4,477,5.0,5.733865981557905,3
2020-05-29-171022,171022,3,0,2,480,2.0,8.955379492714927,4
2020-05-30-171022,171022,1,0,0,481,0.0,10.04016084873052,5
2020-05-31-171022,171022,0,0,0,481,0.0,10.289152165342495,6
2020-06-01-171022,171022,1,0,0,482,1.0,5.960542721605009,0
2020-06-02-171022,171022,2,0,5,484,0.0,1.6321673867920534,1
2020-06-03-171022,171022,8,0,5,492,1.0,2.3798838842198546,2
2020-06-04-171022,171022,3,0,5,495,1.0,3.3001990591210277,3
2020-06-05-171022,171022,4,0,1,499,0.0,3.376252366468946,4
2020-06-06-171022,171022,0,0,0,499,0.0,2.62200103112322,5
2020-06-07-171022,171022,0,0,0,499,0.0,2.607529553417412,6
2020-06-08-171022,171022,5,0,5,504,2.0,2.595327716486885,0
2020-06-09-171022,171022,6,0,4,510,0.0,4.287375231623895,1
2020-06-10-171022,171022,8,0,1,518,1.0,7.10551979180999,2
2020-06-11-171022,171022,4,0,3,522,1.0,7.533888157952719,3
2020-06-12-171022,171022,2,0,1,524,0.0,7.465411755089811,4
2020-06-13-171022,171022,0,1,0,524,0.0,6.774618382136515,5
2020-06-14-171022,171022,0,0,0,524,0.0,5.619849995984267,6
2020-06-15-171022,171022,0,1,8,524,0.0,3.5176124705344325,0
2020-06-16-171022,171022,5,0,0,529,0.0,3.447500753079717,1
2020-06-17-171022,171022,5,0,6,534,0.0,2.6210618313720606,2
2020-06-18-171022,171022,5,0,11,539,0.0,1.7743180316093738,3
2020-06-19-171022,171022,1,0,4,540,1.0,0.9255262398946007,4
2020-06-20-171022,171022,0,0,0,540,0.0,1.9863078077567615,5
2020-06-21-171022,171022,0,0,1,540,0.0,2.034047014794068,6
2020-06-22-171022,171022,5,0,7,545,0.0,1.9802441505673114,0
2020-06-23-171022,171022,4,0,6,549,0.0,2.0689014866164017,1
2020-06-24-171022,171022,1,0,0,550,0.0,2.1223995893159313,2
2020-06-25-171022,171022,3,0,0,553,1.0,2.0871469107746607,3
2020-06-26-171022,171022,1,0,6,554,1.0,2.0093359984515327,4
2020-06-27-171022,171022,0,0,0,554,0.0,2.8117593687424116,5
2020-06-28-171022,171022,0,0,0,554,0.0,2.8285635319504396,6
2020-06-29-171022,171022,8,0,11,562,0.0,2.85631254113145,0
2020-06-30-171022,171022,0,0,1,562,0.0,3.846809091445798,1
2020-07-01-171022,171022,6,0,5,568,0.0,3.9066188229929546,2
2020-07-02-171022,171022,11,0,4,579,1.0,2.86232818669566,3
2020-07-03-171022,171022,4,0,3,583,0.0,3.666115730578461,4
2020-07-04-171022,171022,0,0,1,583,0.0,2.719828731818528,5
2020-07-05-171022,171022,1,0,1,584,0.0,2.7435108056300255,6
2020-07-06-171022,171022,7,0,6,591,0.0,1.7299560810088663,0
2020-07-07-171022,171022,6,0,4,597,0.0,1.772292109797148,1
2020-07-08-171022,171022,0,5,5,597,0.0,1.7422969370316723,2
2020-07-09-171022,171022,0,0,0,597,0.0,1.704619413186161,3
2020-07-10-171022,171022,6,0,2,603,0.0,4.039135471626815,4
2020-07-11-171022,171022,0,0,1,603,0.0,3.0004475800237174,5
2020-07-12-171022,171022,0,0,0,603,0.0,2.812866018505786,6
2020-07-13-171022,171022,11,0,0,614,0.0,2.7996360677565857,0
2020-07-14-171022,171022,1,0,1,615,1.0,2.9602898271540625,1
2020-07-15-171022,171022,5,0,0,620,1.0,1.9164039459620437,2
2020-07-16-171022,171022,4,0,1,624,2.0,1.708026703130497,3
2020-07-17-171022,171022,3,0,3,627,0.0,2.6644776838034945,4
2020-07-18-171022,171022,1,0,1,628,0.0,2.7454649423947317,5
2020-07-19-171022,171022,1,0,1,629,0.0,2.7322415921178003,6
2020-07-20-171022,171022,6,0,1,635,1.0,3.724924299573394,0
2020-07-21-171022,171022,4,0,5,639,0.0,3.766618104626015,1
2020-07-22-171022,171022,5,0,3,644,0.0,3.7608256160308255,2
2020-07-23-171022,171022,0,0,2,644,0.0,2.8163662269002137,3
2020-07-24-171022,171022,2,0,1,646,2.0,2.8779931513161707,4
2020-07-25-171022,171022,1,0,3,647,0.0,4.801342419889446,5
2020-07-26-171022,171022,0,0,2,647,0.0,4.700829476755801,6
2020-07-27-171022,171022,0,0,1,647,1.0,3.6907493710758597,0
2020-07-28-171022,171022,1,0,6,648,0.0,3.669347091549663,1
2020-07-29-171022,171022,0,0,4,648,0.0,3.6401179755471436,2
2020-07-30-171022,171022,1,0,4,649,2.0,3.497138806799549,3
2020-07-31-171022,171022,3,0,8,652,1.0,2.5679170018178064,4
2020-08-01-171022,171022,1,0,5,653,0.0,0.6381549859926221,5
2020-08-02-171022,171022,1,0,0,654,0.0,15.579395096612943,6
2020-08-03-171022,171022,1,0,3,655,0.0,13.891036090073982,0
2020-08-04-171022,171022,5,0,3,660,0.0,13.348727924372003,1
2020-08-05-171022,171022,3,0,5,663,2.0,10.702004128023303,2
2020-08-06-171022,171022,2,0,6,665,0.0,11.447566323305358,3
2020-08-07-171022,171022,1,0,2,666,2.0,10.145086384624788,4
2020-08-08-171022,171022,3,0,2,669,0.0,8.527468495668368,5
2020-08-09-171022,171022,2,0,0,671,0.0,8.25302597047378,6
2020-08-10-171022,171022,1,0,2,672,0.0,0.4982945691539374,0
2020-08-11-171022,171022,6,1,4,678,0.0,0.6137350034180566,1
2020-08-12-171022,171022,4,0,9,682,0.0,1.0102006577433915,2
2020-08-13-171022,171022,4,0,3,686,1.0,1.0131100676727054,3
2020-08-14-171022,171022,8,0,7,694,1.0,2.5768335520322534,4
2020-08-15-171022,171022,5,0,3,699,0.0,3.5676969586482024,5
2020-08-16-171022,171022,0,0,2,699,0.0,3.7000696998028477,6
2020-08-17-171022,171022,3,0,6,702,2.0,3.7894508659116504,0
2020-08-18-171022,171022,3,0,1,705,2.0,5.327105787305462,1
2020-08-19-171022,171022,5,0,5,710,8.0,6.063291583579222,2
2020-08-20-171022,171022,6,0,5,716,1.0,10.68168060230417,3
2020-08-21-171022,171022,2,0,10,718,2.0,11.060608772076398,4
2020-08-22-171022,171022,2,0,5,720,0.0,13.34501169325911,5
2020-08-23-171022,171022,0,0,4,720,2.0,13.66989979251661,6
2020-08-24-171022,171022,2,0,12,722,2.0,13.656172528940054,0
2020-08-25-171022,171022,4,0,5,726,1.0,13.995959153689356,1
2020-08-26-171022,171022,9,0,12,735,3.0,9.44468201143702,2
2020-08-27-171022,171022,3,1,14,738,1.0,11.802925570650352,3
2020-08-28-171022,171022,7,0,22,745,0.0,12.125346948921504,4
2020-08-29-171022,171022,3,0,23,748,2.0,10.564631634019841,5
2020-08-30-171022,171022,2,0,7,750,1.0,10.783600087287025,6
2020-08-31-171022,171022,6,0,17,756,4.0,10.413120065724222,0
2020-09-01-171022,171022,1,0,36,757,1.0,6.685526536790196,1
2020-09-02-171022,171022,5,0,21,762,1.0,55.4263654206893,2
2020-09-03-171022,171022,5,0,29,767,3.0,54.944741631767144,3
2020-09-04-171022,171022,10,0,28,777,0.0,35.93983161310895,4
2020-09-05-171022,171022,5,0,21,782,6.0,30.33429457310192,5
2020-09-06-171022,171022,4,0,6,786,2.0,22.88699710281922,6
2020-09-07-171022,171022,12,0,18,798,13.0,23.438992402974186,0
2020-09-08-171022,171022,5,0,21,803,4.0,27.437578615907253,1
2020-09-09-171022,171022,12,0,39,815,3.0,24.221724227879626,2
2020-09-10-171022,171022,14,0,29,829,3.0,4.8245817789939505,3
2020-09-11-171022,171022,22,0,44,851,5.0,9.016477636016406,4
2020-09-12-171022,171022,23,1,16,874,8.0,10.668480758149824,5
2020-09-13-171022,171022,7,0,9,881,5.0,15.988122671026455,6
2020-09-14-171022,171022,17,0,18,898,13.0,18.82377346590236,0
2020-09-15-171022,171022,36,0,16,934,10.0,28.656612677362983,1
2020-09-16-171022,171022,21,0,18,955,11.0,36.39071237265899,2
2020-09-17-171022,171022,29,0,43,984,10.0,43.543723887868715,3
2020-09-18-171022,171022,28,0,24,1012,8.0,47.40008664154205,4
2020-09-19-171022,171022,21,1,10,1033,11.0,51.35850615671122,5
2020-09-20-171022,171022,6,0,16,1039,4.0,50.34113208945512,6
2020-09-21-171022,171022,18,0,10,1057,3.0,42.87543339915368,0
2020-09-22-171022,171022,21,0,19,1078,4.0,39.255197687349195,1
2020-09-23-171022,171022,39,1,23,1117,18.0,34.1157113834608,2
2020-09-24-171022,171022,29,0,15,1146,18.0,36.83494162784529,3
2020-09-25-171022,171022,44,0,19,1190,17.0,45.49239066037323,4
2020-09-26-171022,171022,16,0,6,1206,13.0,44.01605940307991,5
2020-09-27-171022,171022,9,0,20,1215,1.0,54.3310185154184,6
2020-09-28-171022,171022,18,1,13,1233,4.0,52.89194895026882,0
2020-09-29-171022,171022,16,0,7,1249,4.0,52.457132049447615,1
2020-09-30-171022,171022,18,0,19,1267,6.0,45.301126064200396,2
2020-10-01-171022,171022,43,0,14,1310,7.0,0.0,3
2020-10-02-171022,171022,24,0,9,1334,7.0,19.58997838112018,4
2020-10-03-171022,171022,10,0,8,1344,5.0,47.152178672872296,5
2020-10-04-171022,171022,16,1,4,1360,2.0,57.999785492205646,6
2020-10-05-171022,171022,10,1,6,1370,3.0,42.20962815226282,0
2020-10-06-171022,171022,19,0,15,1389,14.0,36.68220060754941,1
2020-10-07-171022,171022,23,0,12,1412,10.0,36.073315243149494,2
2020-10-08-171022,171022,15,0,7,1427,4.0,31.288207402932944,3
2020-10-09-171022,171022,19,1,15,1446,12.0,30.19539488921145,4
2020-10-10-171022,171022,6,0,5,1452,2.0,3.9550137366370475,5
2020-10-11-171022,171022,20,0,3,1472,1.0,5.310696555811504,6
2020-10-12-171022,171022,13,0,16,1485,1.0,6.2245727303716025,0
2020-10-13-171022,171022,7,0,19,1492,4.0,6.7269625005069775,1
2020-10-14-171022,171022,19,0,21,1511,4.0,9.353840352977691,2
2020-10-15-171022,171022,14,0,37,1525,6.0,11.849601188507586,3
2020-10-16-171022,171022,9,0,16,1534,3.0,15.4270815248155,4
2020-10-17-171022,171022,8,0,7,1542,3.0,12.081452927910501,5
2020-10-18-171022,171022,4,0,7,1546,3.0,13.424339976033725,6
2020-10-19-171022,171022,6,0,4,1552,1.0,14.494757326792483,0
2020-10-20-171022,171022,15,0,20,1567,6.0,18.085230602059497,1
2020-10-21-171022,171022,12,0,30,1579,1.0,20.679804524329818,2
2020-10-22-171022,171022,7,1,16,1586,5.0,19.281447465692786,3
2020-10-23-171022,171022,15,1,14,1601,6.0,22.09036097875315,4
2020-10-24-171022,171022,5,0,19,1606,0.0,24.339772874126503,5
2020-10-25-171022,171022,3,0,10,1609,0.0,23.786609249664856,6
2020-10-26-171022,171022,16,0,8,1625,22.0,22.169484696972997,0
2020-10-27-171022,171022,19,1,22,1644,6.0,31.4849426860517,1
2020-10-28-171022,171022,21,0,39,1665,9.0,30.588928509487456,2
2020-10-29-171022,171022,37,1,32,1702,9.0,34.163362837950714,3
2020-10-30-171022,171022,16,0,34,1718,11.0,45.34713185096397,4
2020-10-31-171022,171022,7,1,0,1725,15.0,51.64269842016719,5
2020-11-01-171022,171022,7,1,0,1732,11.0,37.602877287493975,6
2020-11-02-171022,171022,4,1,0,1736,17.0,40.27405314472389,0
2020-11-03-171022,171022,20,0,0,1756,8.0,34.579051469550414,1
2020-11-04-171022,171022,30,0,0,1786,10.0,38.94636821778147,2
2020-11-05-171022,171022,16,1,0,1802,10.0,43.62889560522577,3
2020-11-06-171022,171022,14,5,0,1816,4.0,40.233098334035994,4
2020-11-07-171022,171022,19,0,0,1835,8.0,42.85079664661905,5
2020-11-08-171022,171022,10,0,0,1845,0.0,43.918871715332365,6
2020-11-09-171022,171022,8,0,0,1853,6.0,36.78381236071461,0
2020-11-10-171022,171022,22,1,0,1875,9.0,35.00304818128953,1
2020-11-11-171022,171022,39,3,0,1914,7.0,38.909614184649286,2
2020-11-12-171022,171022,32,0,0,1946,10.0,41.0096593072059,3
2020-11-13-171022,171022,34,0,0,1980,2.0,39.992524023123565,4
2020-03-01-171023,171023,0,0,3,0,0.0,0.0,6
2020-03-02-171023,171023,0,0,10,0,0.125,128.42444267043592,0
2020-03-03-171023,171023,0,1,6,0,0.0,660.5556814878473,1
2020-03-04-171023,171023,0,0,19,0,0.125,681.974800107559,2
2020-03-05-171023,171023,0,0,17,0,0.0,725.1052702051858,3
2020-03-06-171023,171023,0,0,22,0,0.25,658.9143613139579,4
2020-03-07-171023,171023,0,0,6,0,0.0,667.5247734814301,5
2020-03-08-171023,171023,0,0,5,0,0.0,667.9173408720811,6
2020-03-09-171023,171023,0,0,32,0,0.5,672.3972067308732,0
2020-03-10-171023,171023,2,0,19,2,0.625,2363.1580887578775,1
2020-03-11-171023,171023,3,0,30,5,0.5,1897.6041813442926,2
2020-03-12-171023,171023,0,0,18,5,0.625,1323.8373101250697,3
2020-03-13-171023,171023,5,0,18,10,1.75,810.6070925814772,4
2020-03-14-171023,171023,4,0,6,14,1.125,655.9570233859586,5
2020-03-15-171023,171023,3,0,3,17,1.75,530.4998370887469,6
2020-03-16-171023,171023,10,0,21,27,7.0,189.45634046575827,0
2020-03-17-171023,171023,6,1,6,33,5.625,346.6595606142233,1
2020-03-18-171023,171023,19,0,7,52,7.875,430.0491388760205,2
2020-03-19-171023,171023,17,0,6,69,11.5,571.0952568924845,3
2020-03-20-171023,171023,22,0,7,91,9.875,677.7669385677686,4
2020-03-21-171023,171023,6,0,6,97,2.875,792.0925393783755,5
2020-03-22-171023,171023,5,4,7,102,3.25,778.2995605257968,6
2020-03-23-171023,171023,32,0,13,134,16.25,716.0925237357403,0
2020-03-24-171023,171023,19,0,6,153,12.25,913.4392180628662,1
2020-03-25-171023,171023,30,0,7,183,11.375,988.2364400160582,2
2020-03-26-171023,171023,18,0,0,201,12.25,1021.9611035323292,3
2020-03-27-171023,171023,18,0,5,219,11.625,1190.1814400577346,4
2020-03-28-171023,171023,6,0,4,225,3.25,1182.7039300731672,5
2020-03-29-171023,171023,3,0,0,228,3.375,1205.227249111986,6
2020-03-30-171023,171023,21,0,5,249,10.125,915.9850500436986,0
2020-03-31-171023,171023,6,0,5,255,5.625,870.8628363321595,1
2020-04-01-171023,171023,7,1,7,262,6.5,130.9250243055879,2
2020-04-02-171023,171023,6,0,2,268,9.875,724.0059298902411,3
2020-04-03-171023,171023,7,0,5,275,9.875,217.66554230002916,4
2020-04-04-171023,171023,6,0,3,281,2.25,320.1562044019994,5
2020-04-05-171023,171023,7,0,1,288,0.75,344.8877794173991,6
2020-04-06-171023,171023,13,0,5,301,8.0,367.8544161608402,0
2020-04-07-171023,171023,6,0,4,307,19.0,439.1165247459062,1
2020-04-08-171023,171023,7,0,7,314,9.375,560.4203866376064,2
2020-04-09-171023,171023,0,0,1,314,8.125,625.7450425301356,3
2020-04-10-171023,171023,5,0,4,319,4.375,119.62349690152276,4
2020-04-11-171023,171023,4,0,0,323,1.125,161.93365718115425,5
2020-04-12-171023,171023,0,0,0,323,3.125,216.61708465393596,6
2020-04-13-171023,171023,5,0,0,328,31.375,246.081822211492,0
2020-04-14-171023,171023,5,0,3,333,7.75,588.9023511389908,1
2020-04-15-171023,171023,7,0,2,340,5.375,714.8641801598899,2
2020-04-16-171023,171023,2,0,5,342,4.75,798.2319576807945,3
2020-04-17-171023,171023,5,0,1,347,3.875,802.9160172699899,4
2020-04-18-171023,171023,3,0,1,350,0.75,847.8903229036367,5
2020-04-19-171023,171023,1,0,0,351,0.25,803.8640172222395,6
2020-04-20-171023,171023,5,0,4,356,5.0,517.7663649716609,0
2020-04-21-171023,171023,4,0,3,360,3.875,467.51554655467027,1
2020-04-22-171023,171023,7,0,5,367,3.875,442.2925388790965,2
2020-04-23-171023,171023,1,0,4,368,0.125,432.6600800595928,3
2020-04-24-171023,171023,4,0,6,372,3.625,353.30209113132105,4
2020-04-25-171023,171023,0,0,1,372,0.25,384.24375227823487,5
2020-04-26-171023,171023,0,0,1,372,0.375,385.8574809007863,6
2020-04-27-171023,171023,0,0,4,372,3.5,296.0633030730603,0
2020-04-28-171023,171023,3,0,1,375,2.375,274.64283490855337,1
2020-04-29-171023,171023,2,0,2,377,2.875,248.0335336924762,2
2020-04-30-171023,171023,5,0,4,382,2.875,338.8547046586573,3
2020-05-01-171023,171023,1,0,1,383,0.625,650.1789413006456,4
2020-05-02-171023,171023,1,0,0,384,0.5,211.64581253126607,5
2020-05-03-171023,171023,0,0,1,384,0.0,205.37918446259368,6
2020-05-04-171023,171023,4,0,4,388,3.0,152.9308198612254,0
2020-05-05-171023,171023,3,0,0,391,3.125,190.5720762814781,1
2020-05-06-171023,171023,5,0,1,396,4.75,234.91132872160063,2
2020-05-07-171023,171023,4,0,1,400,2.75,277.8808879536142,3
2020-05-08-171023,171023,6,0,1,406,4.375,301.97147530521886,4
2020-05-09-171023,171023,1,0,3,407,0.5,400.32046623697624,5
2020-05-10-171023,171023,1,0,0,408,0.625,681.6609484163284,6
2020-05-11-171023,171023,4,0,2,412,4.75,645.5373172387549,0
2020-05-12-171023,171023,1,0,3,413,3.25,676.4567120267873,1
2020-05-13-171023,171023,2,0,1,415,2.25,577.6153263099213,2
2020-05-14-171023,171023,4,0,1,419,2.25,382.7988589206828,3
2020-05-15-171023,171023,1,0,2,420,3.625,311.3304478866057,4
2020-05-16-171023,171023,0,0,1,420,0.625,270.3907296013209,5
2020-05-17-171023,171023,1,0,0,421,0.25,272.6635154580514,6
2020-05-18-171023,171023,4,0,0,425,2.875,272.8018836076719,0
2020-05-19-171023,171023,0,0,2,425,1.875,262.89587662539907,1
2020-05-20-171023,171023,1,0,0,426,2.0,235.62744634964184,2
2020-05-21-171023,171023,1,0,4,427,2.625,232.67623526979503,3
2020-05-22-171023,171023,1,0,3,428,1.625,214.60718799289228,4
2020-05-23-171023,171023,3,0,0,431,0.375,241.85154875198612,5
2020-05-24-171023,171023,0,0,0,431,0.0,253.46427357995708,6
2020-05-25-171023,171023,2,0,2,433,2.75,196.15078100114553,0
2020-05-26-171023,171023,3,0,0,436,2.375,217.46652594770532,1
2020-05-27-171023,171023,1,1,1,437,1.125,270.0892147044927,2
2020-05-28-171023,171023,1,0,1,438,1.25,263.2088530517376,3
2020-05-29-171023,171023,2,0,2,440,1.875,261.6111074209284,4
2020-05-30-171023,171023,1,0,1,441,0.25,269.1391333239688,5
2020-05-31-171023,171023,0,1,0,441,0.125,277.81929571386195,6
2020-06-01-171023,171023,0,0,2,441,2.875,500.2070337850044,0
2020-06-02-171023,171023,2,0,2,443,2.125,160.60990203047442,1
2020-06-03-171023,171023,0,0,1,443,1.625,138.8745076987923,2
2020-06-04-171023,171023,4,0,1,447,1.25,148.62317693698014,3
2020-06-05-171023,171023,3,0,1,450,1.125,166.6592785337778,4
2020-06-06-171023,171023,0,0,0,450,0.125,175.94097853885984,5
2020-06-07-171023,171023,0,0,0,450,0.0,173.9451514252937,6
2020-06-08-171023,171023,2,0,1,452,1.625,172.21331766561522,0
2020-06-09-171023,171023,0,0,3,452,0.875,173.29165494668388,1
2020-06-10-171023,171023,1,0,4,453,1.125,576.2788342255027,2
2020-06-11-171023,171023,1,0,2,454,1.625,494.97501088419165,3
2020-06-12-171023,171023,2,0,1,456,1.5,428.3852610111844,4
2020-06-13-171023,171023,1,0,0,457,0.125,358.7845330527607,5
2020-06-14-171023,171023,0,0,0,457,0.125,276.45227124813397,6
2020-06-15-171023,171023,2,0,2,459,2.0,168.5564311064906,0
2020-06-16-171023,171023,2,1,0,461,1.75,192.37523691581828,1
2020-06-17-171023,171023,1,0,0,462,1.75,180.98335235250397,2
2020-06-18-171023,171023,1,0,0,463,1.25,179.54900169556493,3
2020-06-19-171023,171023,1,0,3,464,1.5,181.70939741756405,4
2020-06-20-171023,171023,0,0,0,464,0.125,222.94605814533463,5
2020-06-21-171023,171023,0,0,0,464,0.0,222.23216389765855,6
2020-06-22-171023,171023,1,0,2,465,1.0,190.38490018846122,0
2020-06-23-171023,171023,3,0,0,468,1.25,163.24548975344334,1
2020-06-24-171023,171023,4,0,0,472,0.5,169.30055017101375,2
2020-06-25-171023,171023,2,0,0,474,0.375,160.09711045334342,3
2020-06-26-171023,171023,1,3,0,475,1.0,157.91787051434716,4
2020-06-27-171023,171023,0,0,0,475,0.125,140.7903134189037,5
2020-06-28-171023,171023,0,0,0,475,0.25,141.8828954502821,6
2020-06-29-171023,171023,2,0,0,477,1.75,143.53953654129126,0
2020-06-30-171023,171023,0,0,0,477,0.5,167.20441050021836,1
2020-07-01-171023,171023,0,0,0,477,0.375,171.16488049669857,2
2020-07-02-171023,171023,0,0,0,477,0.375,62.6746822074821,3
2020-07-03-171023,171023,3,0,2,480,0.625,81.16294611506531,4
2020-07-04-171023,171023,0,0,0,480,0.0,110.55956903963519,5
2020-07-05-171023,171023,0,0,0,480,0.0,110.7109108177129,6
2020-07-06-171023,171023,2,0,0,482,0.75,96.50160382744026,0
2020-07-07-171023,171023,0,0,1,482,0.625,98.63310109511417,1
2020-07-08-171023,171023,0,0,0,482,0.5,102.21924433258778,2
2020-07-09-171023,171023,0,0,1,482,0.5,96.55953062459932,3
2020-07-10-171023,171023,0,0,1,482,0.875,158.6606878922998,4
2020-07-11-171023,171023,0,0,0,482,0.0,135.97213601265216,5
2020-07-12-171023,171023,0,0,0,482,0.125,108.1292874042447,6
2020-07-13-171023,171023,0,0,0,482,0.375,113.17930375838509,0
2020-07-14-171023,171023,0,0,0,482,0.25,122.44601353250697,1
2020-07-15-171023,171023,0,0,0,482,0.5,98.16061877037794,2
2020-07-16-171023,171023,0,0,2,482,0.25,77.01351460056361,3
2020-07-17-171023,171023,2,0,1,484,0.75,75.57348703722525,4
2020-07-18-171023,171023,0,0,0,484,0.0,75.73425261577884,5
2020-07-19-171023,171023,0,0,0,484,0.125,63.578433419598525,6
2020-07-20-171023,171023,0,0,2,484,0.5,62.37070863606829,0
2020-07-21-171023,171023,1,0,0,485,1.0,63.510247681740644,1
2020-07-22-171023,171023,0,0,4,485,0.25,68.88714567194538,2
2020-07-23-171023,171023,1,0,1,486,0.5,74.85479304855598,3
2020-07-24-171023,171023,1,0,1,487,0.875,75.05884202792768,4
2020-07-25-171023,171023,0,0,0,487,0.375,89.22009154419763,5
2020-07-26-171023,171023,0,0,1,487,0.25,87.92025457978629,6
2020-07-27-171023,171023,0,0,1,487,1.125,76.23827196530806,0
2020-07-28-171023,171023,0,0,7,487,0.125,83.58220754850558,1
2020-07-29-171023,171023,0,0,6,487,0.5,82.7987302456126,2
2020-07-30-171023,171023,2,0,3,489,0.375,77.78995776822559,3
2020-07-31-171023,171023,1,0,3,490,1.125,86.7121398830536,4
2020-08-01-171023,171023,0,0,0,490,0.0,79.73877839908945,5
2020-08-02-171023,171023,0,0,0,490,0.125,364.45330776448253,6
2020-08-03-171023,171023,2,0,2,492,1.125,821.4709044208375,0
2020-08-04-171023,171023,0,0,4,492,1.125,697.3388401666243,1
2020-08-05-171023,171023,4,0,2,496,1.5,601.491813449047,2
2020-08-06-171023,171023,1,0,3,497,1.0,461.0233014712365,3
2020-08-07-171023,171023,1,0,8,498,0.5,309.38005825943554,4
2020-08-08-171023,171023,0,0,0,498,1.5,279.4843872432616,5
2020-08-09-171023,171023,1,0,5,499,0.125,303.0475425955144,6
2020-08-10-171023,171023,1,0,2,500,1.875,66.73780844715867,0
2020-08-11-171023,171023,7,0,4,507,1.375,102.02307959125804,1
2020-08-12-171023,171023,6,0,2,513,1.25,132.54138915274234,2
2020-08-13-171023,171023,3,0,10,516,1.125,163.89197291443756,3
2020-08-14-171023,171023,3,0,1,519,1.75,206.38204439960847,4
2020-08-15-171023,171023,0,0,0,519,0.375,246.83946838502774,5
2020-08-16-171023,171023,0,0,2,519,1.0,252.8094685932151,6
2020-08-17-171023,171023,2,0,4,521,1.875,287.88390395691135,0
2020-08-18-171023,171023,4,0,1,525,3.75,289.92995933099644,1
2020-08-19-171023,171023,2,0,3,527,3.125,313.7332920711,2
2020-08-20-171023,171023,3,0,4,530,4.375,275.83406316808544,3
2020-08-21-171023,171023,8,0,4,538,3.0,336.1563038286312,4
2020-08-22-171023,171023,0,0,7,538,1.5,379.7295136526761,5
2020-08-23-171023,171023,5,0,5,543,1.25,395.32363191914993,6
2020-08-24-171023,171023,2,0,9,545,4.0,404.6441285162755,0
2020-08-25-171023,171023,4,0,3,549,4.875,447.73140928198666,1
2020-08-26-171023,171023,2,0,3,551,2.5,526.1874105505583,2
2020-08-27-171023,171023,10,0,6,561,7.0,625.7419295603985,3
2020-08-28-171023,171023,1,0,6,562,6.75,671.1388968639321,4
2020-08-29-171023,171023,0,1,0,562,2.75,775.1917618351187,5
2020-08-30-171023,171023,2,0,5,564,2.625,760.0806092597096,6
2020-08-31-171023,171023,4,0,8,568,3.75,699.9733399325972,0
2020-09-01-171023,171023,1,0,6,569,2.0,310.92580211332245,1
2020-09-02-171023,171023,3,0,4,572,5.25,1044.6812351450685,2
2020-09-03-171023,171023,4,0,8,576,6.125,781.3621137127036,3
2020-09-04-171023,171023,4,0,7,580,3.375,784.5489821565795,4
2020-09-05-171023,171023,7,0,4,587,3.875,735.8007809066889,5
2020-09-06-171023,171023,5,0,3,592,4.75,715.4854689630433,6
2020-09-07-171023,171023,9,0,9,601,7.375,746.9761035603374,0
2020-09-08-171023,171023,3,0,12,604,2.625,815.949311345609,1
2020-09-09-171023,171023,3,0,3,607,4.125,721.0202008483225,2
2020-09-10-171023,171023,6,0,9,613,7.125,273.23880043676763,3
2020-09-11-171023,171023,6,0,5,619,7.25,406.8763337551085,4
2020-09-12-171023,171023,0,0,1,619,2.25,564.541955414252,5
2020-09-13-171023,171023,5,0,0,624,2.0,580.9481881844945,6
2020-09-14-171023,171023,8,0,11,632,7.5,598.8762874421745,0
2020-09-15-171023,171023,6,0,6,638,4.5,753.9787825633359,1
2020-09-16-171023,171023,4,1,4,642,8.0,923.788362884768,2
2020-09-17-171023,171023,8,0,8,650,8.625,1057.0656374502878,3
2020-09-18-171023,171023,7,0,8,657,4.625,1162.546061787687,4
2020-09-19-171023,171023,4,0,0,661,4.375,1128.146483796742,5
2020-09-20-171023,171023,3,0,3,664,2.5,1239.4458586539056,6
2020-09-21-171023,171023,9,0,5,673,5.75,1055.4241715234616,0
2020-09-22-171023,171023,12,0,6,685,6.5,1057.084048132369,1
2020-09-23-171023,171023,3,0,7,688,7.0,998.1896313755983,2
2020-09-24-171023,171023,9,0,10,697,6.0,861.8202687307369,3
2020-09-25-171023,171023,5,1,12,702,5.875,827.899472491638,4
2020-09-26-171023,171023,1,0,13,703,2.75,988.3740718948263,5
2020-09-27-171023,171023,0,0,0,703,2.25,946.0314597225945,6
2020-09-28-171023,171023,11,0,3,714,3.625,949.7909756425141,0
2020-09-29-171023,171023,6,0,10,720,4.125,917.1683378849228,1
2020-09-30-171023,171023,4,1,15,724,4.0,892.48676240857,2
2020-10-01-171023,171023,8,0,5,732,4.875,0.0,3
2020-10-02-171023,171023,8,0,8,740,4.75,1046.7735915599296,4
2020-10-03-171023,171023,0,0,0,740,2.375,2017.5543743784474,5
2020-10-04-171023,171023,3,0,4,743,1.25,2064.1799962752775,6
2020-10-05-171023,171023,5,0,9,748,7.0,1716.9358383735726,0
2020-10-06-171023,171023,6,0,17,754,6.625,1606.0710932161767,1
2020-10-07-171023,171023,7,1,8,761,5.625,1382.2920306438118,2
2020-10-08-171023,171023,10,1,16,771,9.625,1209.652838019918,3
2020-10-09-171023,171023,12,1,18,783,6.375,1417.792426244907,4
2020-10-10-171023,171023,13,0,3,796,2.875,145.57121492659138,5
2020-10-11-171023,171023,0,0,5,796,0.875,238.09068130233808,6
2020-10-12-171023,171023,3,0,18,799,1.5,267.14772373693427,0
2020-10-13-171023,171023,10,0,19,809,5.875,294.1981963461225,1
2020-10-14-171023,171023,15,0,23,824,5.125,457.2714091353797,2
2020-10-15-171023,171023,5,0,15,829,4.375,643.4123344779172,3
2020-10-16-171023,171023,8,0,24,837,8.375,803.4188558272267,4
2020-10-17-171023,171023,0,0,11,837,4.25,854.6206841242519,5
2020-10-18-171023,171023,4,0,8,841,1.5,838.339244932617,6
2020-10-19-171023,171023,9,0,5,850,5.5,863.023237243757,0
2020-10-20-171023,171023,17,0,12,867,7.25,1084.02679000331,1
2020-10-21-171023,171023,8,0,17,875,10.25,1128.3670092859484,2
2020-10-22-171023,171023,16,0,21,891,7.75,1248.8973838764605,3
2020-10-23-171023,171023,18,2,24,909,14.75,1392.0393509530713,4
2020-10-24-171023,171023,3,1,1,912,4.375,1702.5036767056238,5
2020-10-25-171023,171023,5,0,2,917,3.75,1724.1149411617107,6
2020-10-26-171023,171023,18,1,16,935,14.875,1584.257917449754,0
2020-10-27-171023,171023,19,1,12,954,14.25,1769.1001778623172,1
2020-10-28-171023,171023,23,0,16,977,13.25,1823.2718388528092,2
2020-10-29-171023,171023,15,0,17,992,11.75,1926.2722904939765,3
2020-10-30-171023,171023,24,1,15,1016,17.875,1642.8344562920443,4
2020-10-31-171023,171023,11,0,0,1027,6.75,1949.5741082467646,5
2020-11-01-171023,171023,8,0,0,1035,3.875,1137.516038611223,6
2020-11-02-171023,171023,5,0,0,1040,1.5,1555.9185129395773,0
2020-11-03-171023,171023,12,1,0,1052,8.875,1250.1127523409532,1
2020-11-04-171023,171023,17,0,0,1069,11.625,1518.9066597701635,2
2020-11-05-171023,171023,21,1,0,1090,11.375,1645.1576494816309,3
2020-11-06-171023,171023,24,1,0,1114,9.5,1853.5054995959695,4
2020-11-07-171023,171023,1,0,0,1115,6.75,2047.884218462967,5
2020-11-08-171023,171023,2,0,0,1117,3.0,1955.3898370097218,6
2020-11-09-171023,171023,16,0,0,1133,11.875,1987.4540514056034,0
2020-11-10-171023,171023,12,1,0,1145,8.75,1085.9326873351513,1
2020-11-11-171023,171023,16,1,0,1161,11.75,1306.64236195152,2
2020-11-12-171023,171023,17,0,0,1178,9.0,1457.65084268197,3
2020-11-13-171023,171023,15,0,0,1193,10.5,1570.1144988022652,4
2020-03-01-171024,171024,0,0,0,0,0.0,0.0,6
2020-03-02-171024,171024,0,0,5,0,0.16666666666666666,126.11055975086424,0
2020-03-03-171024,171024,0,0,6,0,0.0,737.7899514506141,1
2020-03-04-171024,171024,0,0,9,0,0.5,777.462015955957,2
2020-03-05-171024,171024,0,0,10,0,0.0,825.0201176502972,3
2020-03-06-171024,171024,0,0,9,0,0.16666666666666666,751.8598932603365,4
2020-03-07-171024,171024,0,0,3,0,0.0,801.8379353876146,5
2020-03-08-171024,171024,0,0,10,0,0.16666666666666666,836.6808229670263,6
2020-03-09-171024,171024,0,0,46,0,0.6666666666666666,834.9938488217265,0
2020-03-10-171024,171024,0,0,41,0,0.6666666666666666,2999.227547403025,1
2020-03-11-171024,171024,0,0,37,0,0.6666666666666666,2412.391896387556,2
2020-03-12-171024,171024,0,0,26,0,0.8333333333333334,1698.2667545941063,3
2020-03-13-171024,171024,5,0,19,5,1.3333333333333333,1111.2442713087644,4
2020-03-14-171024,171024,1,0,7,6,0.8333333333333334,795.3009566835715,5
2020-03-15-171024,171024,0,0,3,6,2.5,550.440113149957,6
2020-03-16-171024,171024,5,0,27,11,7.5,177.20244551205639,0
2020-03-17-171024,171024,6,1,9,17,8.5,326.35212527729345,1
2020-03-18-171024,171024,9,0,14,26,11.166666666666664,399.49018468017147,2
2020-03-19-171024,171024,10,0,13,36,14.833333333333336,495.4079078832613,3
2020-03-20-171024,171024,9,0,13,45,16.0,556.5170390113421,4
2020-03-21-171024,171024,3,2,2,48,3.1666666666666665,625.7178555407213,5
2020-03-22-171024,171024,10,0,2,58,5.333333333333333,606.5380628100139,6
2020-03-23-171024,171024,46,0,24,104,23.33333333333333,574.4941571491725,0
2020-03-24-171024,171024,41,0,16,145,16.166666666666668,720.6301761884367,1
2020-03-25-171024,171024,37,0,8,182,15.333333333333336,779.2576729893025,2
2020-03-26-171024,171024,26,0,10,208,17.333333333333332,802.128291441647,3
2020-03-27-171024,171024,19,0,6,227,17.5,924.3563974643092,4
2020-03-28-171024,171024,7,0,8,234,3.0,894.0452222547402,5
2020-03-29-171024,171024,3,0,3,237,3.5,899.5336210518853,6
2020-03-30-171024,171024,27,0,35,264,21.0,668.4427880482642,0
2020-03-31-171024,171024,9,0,8,273,10.5,643.1870981712809,1
2020-04-01-171024,171024,14,0,15,287,8.0,92.67701902496381,2
2020-04-02-171024,171024,13,0,6,300,10.833333333333336,471.07819221488586,3
2020-04-03-171024,171024,13,0,5,313,10.333333333333334,168.64119450151247,4
2020-04-04-171024,171024,2,0,2,315,2.833333333333333,247.14882962093492,5
2020-04-05-171024,171024,2,1,1,317,1.3333333333333333,265.07037763458754,6
2020-04-06-171024,171024,24,0,6,341,12.333333333333336,274.6103305253504,0
2020-04-07-171024,171024,16,0,4,357,8.5,324.6073742589159,1
2020-04-08-171024,171024,8,0,6,365,9.833333333333334,406.4963079110237,2
2020-04-09-171024,171024,10,0,0,375,8.5,450.2621239454716,3
2020-04-10-171024,171024,6,0,9,381,4.666666666666667,84.40173212294174,4
2020-04-11-171024,171024,8,0,1,389,2.333333333333333,116.90767821758968,5
2020-04-12-171024,171024,3,0,0,392,3.0,141.0532535806384,6
2020-04-13-171024,171024,35,0,9,427,39.16666666666666,159.11103024849726,0
2020-04-14-171024,171024,8,0,0,435,11.5,346.6524956112717,1
2020-04-15-171024,171024,15,0,9,450,9.333333333333334,446.3596815712101,2
2020-04-16-171024,171024,6,0,9,456,6.0,512.1414434221591,3
2020-04-17-171024,171024,5,0,0,461,5.0,510.96142556519794,4
2020-04-18-171024,171024,2,0,0,463,1.3333333333333333,540.7053182153875,5
2020-04-19-171024,171024,1,1,0,464,0.5,521.9622903950117,6
2020-04-20-171024,171024,6,1,8,470,6.5,370.8064833064287,0
2020-04-21-171024,171024,4,0,8,474,7.333333333333332,327.63068153572243,1
2020-04-22-171024,171024,6,0,4,480,5.0,301.13723667167994,2
2020-04-23-171024,171024,0,0,7,480,0.3333333333333333,305.72975251318286,3
2020-04-24-171024,171024,9,0,9,489,3.8333333333333335,249.9154514539523,4
2020-04-25-171024,171024,1,0,0,490,0.16666666666666666,282.2519805311405,5
2020-04-26-171024,171024,0,0,0,490,0.5,283.61883778940944,6
2020-04-27-171024,171024,9,0,4,499,4.333333333333333,214.73728215951814,0
2020-04-28-171024,171024,0,0,2,499,3.8333333333333335,210.22876093881516,1
2020-04-29-171024,171024,9,0,0,508,4.333333333333333,190.42812525233686,2
2020-04-30-171024,171024,9,0,5,517,5.166666666666667,276.14852272859923,3
2020-05-01-171024,171024,0,0,2,517,0.6666666666666666,483.97660975433496,4
2020-05-02-171024,171024,0,0,0,517,0.6666666666666666,143.88893297516358,5
2020-05-03-171024,171024,0,0,0,517,0.16666666666666666,140.68044394331616,6
2020-05-04-171024,171024,8,0,6,525,5.0,98.42309136051725,0
2020-05-05-171024,171024,8,0,4,533,5.333333333333333,133.27210913711696,1
2020-05-06-171024,171024,4,0,1,537,5.0,171.2796733713958,2
2020-05-07-171024,171024,7,0,1,544,4.166666666666667,207.03707286673423,3
2020-05-08-171024,171024,9,0,5,553,6.166666666666668,231.80559044524782,4
2020-05-09-171024,171024,0,0,2,553,0.3333333333333333,315.09587935509296,5
2020-05-10-171024,171024,0,0,0,553,0.5,548.5153340388259,6
2020-05-11-171024,171024,4,0,3,557,5.333333333333333,519.0785045700559,0
2020-05-12-171024,171024,2,0,2,559,4.0,561.1688205333262,1
2020-05-13-171024,171024,0,0,1,559,0.5,471.85298736577784,2
2020-05-14-171024,171024,5,0,0,564,3.0,314.1955055267256,3
2020-05-15-171024,171024,2,1,2,566,2.833333333333333,260.7036252548522,4
2020-05-16-171024,171024,0,0,0,566,0.16666666666666666,215.12288898288213,5
2020-05-17-171024,171024,0,0,0,566,0.3333333333333333,220.14243468581492,6
2020-05-18-171024,171024,6,0,7,572,3.333333333333333,221.35523529034026,0
2020-05-19-171024,171024,4,0,5,576,3.333333333333333,211.53072568659866,1
2020-05-20-171024,171024,1,0,5,577,3.5,201.91480400043014,2
2020-05-21-171024,171024,1,0,3,578,3.1666666666666665,207.3983831534137,3
2020-05-22-171024,171024,5,0,4,583,1.5,195.29713679298573,4
2020-05-23-171024,171024,2,0,1,585,0.6666666666666666,225.597426317711,5
2020-05-24-171024,171024,0,0,0,585,0.16666666666666666,242.91864298238454,6
2020-05-25-171024,171024,3,0,3,588,3.333333333333333,190.19227728926688,0
2020-05-26-171024,171024,2,0,6,590,3.0,213.36257386402582,1
2020-05-27-171024,171024,1,0,0,591,2.5,259.4680033643893,2
2020-05-28-171024,171024,0,0,1,591,2.1666666666666665,255.9132333423613,3
2020-05-29-171024,171024,2,0,1,593,2.6666666666666665,254.7065856509548,4
2020-05-30-171024,171024,0,0,0,593,0.0,257.55307349059535,5
2020-05-31-171024,171024,0,0,0,593,0.16666666666666666,267.8491480381211,6
2020-06-01-171024,171024,7,0,0,600,1.5,504.4391259635008,0
2020-06-02-171024,171024,5,0,9,605,2.0,167.66775882096616,1
2020-06-03-171024,171024,5,0,1,610,2.333333333333333,147.9602692230224,2
2020-06-04-171024,171024,3,0,4,613,2.6666666666666665,165.43260163913726,3
2020-06-05-171024,171024,4,0,1,617,2.6666666666666665,188.33965230127336,4
2020-06-06-171024,171024,1,0,0,618,0.16666666666666666,191.05997702659386,5
2020-06-07-171024,171024,0,0,0,618,0.0,191.56148744598536,6
2020-06-08-171024,171024,3,0,3,621,1.6666666666666667,189.3040066317875,0
2020-06-09-171024,171024,6,0,4,627,1.0,189.2224566874687,1
2020-06-10-171024,171024,0,0,1,627,1.5,589.3172688137224,2
2020-06-11-171024,171024,1,0,4,628,1.5,505.5486185403505,3
2020-06-12-171024,171024,1,0,9,629,1.1666666666666667,431.92975320902946,4
2020-06-13-171024,171024,0,1,0,629,0.3333333333333333,361.351460734374,5
2020-06-14-171024,171024,0,6,1,629,0.16666666666666666,276.4334576840962,6
2020-06-15-171024,171024,0,0,1,629,1.5,160.80450740361738,0
2020-06-16-171024,171024,9,0,1,638,0.3333333333333333,192.6971793864403,1
2020-06-17-171024,171024,1,0,1,639,1.5,190.31681551903637,2
2020-06-18-171024,171024,4,0,0,643,0.6666666666666666,196.03732732145835,3
2020-06-19-171024,171024,1,0,2,644,0.8333333333333334,201.52822858363535,4
2020-06-20-171024,171024,0,0,0,644,0.0,254.02028098674342,5
2020-06-21-171024,171024,0,0,1,644,0.0,253.67551751393648,6
2020-06-22-171024,171024,3,0,2,647,0.6666666666666666,216.11434416240516,0
2020-06-23-171024,171024,4,0,1,651,1.0,178.01430940277044,1
2020-06-24-171024,171024,1,0,2,652,0.6666666666666666,180.41483207386347,2
2020-06-25-171024,171024,4,0,2,656,0.3333333333333333,166.96879488250667,3
2020-06-26-171024,171024,9,1,2,665,1.6666666666666667,165.43288037738643,4
2020-06-27-171024,171024,0,0,0,665,0.0,151.56854923870986,5
2020-06-28-171024,171024,1,0,0,666,0.16666666666666666,152.25535419697133,6
2020-06-29-171024,171024,1,0,1,667,1.5,154.806797146058,0
2020-06-30-171024,171024,1,0,0,668,0.3333333333333333,194.74341608497923,1
2020-07-01-171024,171024,1,0,2,669,0.3333333333333333,196.09048556308142,2
2020-07-02-171024,171024,0,0,4,669,0.5,70.20232149254468,3
2020-07-03-171024,171024,2,0,0,671,0.5,105.85157929169104,4
2020-07-04-171024,171024,0,0,0,671,0.16666666666666666,140.67319875697856,5
2020-07-05-171024,171024,1,0,0,672,0.0,140.3757782080233,6
2020-07-06-171024,171024,2,0,1,674,0.16666666666666666,123.93014012598033,0
2020-07-07-171024,171024,1,0,3,675,0.5,129.80671184799607,1
2020-07-08-171024,171024,2,0,3,677,0.8333333333333334,133.64173680933135,2
2020-07-09-171024,171024,2,0,2,679,0.6666666666666666,128.01560629196229,3
2020-07-10-171024,171024,2,0,4,681,1.0,172.52571760555935,4
2020-07-11-171024,171024,0,0,0,681,0.16666666666666666,151.46077789477272,5
2020-07-12-171024,171024,0,0,0,681,0.0,118.33986256346012,6
2020-07-13-171024,171024,1,0,2,682,0.5,122.09970716606927,0
2020-07-14-171024,171024,0,0,1,682,0.8333333333333334,133.91414474453643,1
2020-07-15-171024,171024,2,0,1,684,0.6666666666666666,107.49728538272768,2
2020-07-16-171024,171024,4,0,5,688,0.5,87.94625780372263,3
2020-07-17-171024,171024,0,0,1,688,0.3333333333333333,91.7352595209125,4
2020-07-18-171024,171024,0,0,0,688,0.0,81.02321526410881,5
2020-07-19-171024,171024,0,0,0,688,0.0,68.78322022884305,6
2020-07-20-171024,171024,1,0,2,689,0.5,68.33021978440523,0
2020-07-21-171024,171024,3,0,2,692,0.3333333333333333,72.75407619053964,1
2020-07-22-171024,171024,3,0,4,695,1.1666666666666667,74.86789203471159,2
2020-07-23-171024,171024,2,0,0,697,0.6666666666666666,80.4005477599905,3
2020-07-24-171024,171024,4,0,1,701,1.1666666666666667,88.11636997485671,4
2020-07-25-171024,171024,0,0,1,701,0.16666666666666666,112.07536493687775,5
2020-07-26-171024,171024,0,0,1,701,0.3333333333333333,109.93005177370738,6
2020-07-27-171024,171024,2,0,2,703,0.5,95.8161988922642,0
2020-07-28-171024,171024,1,0,2,704,0.3333333333333333,102.09081589227932,1
2020-07-29-171024,171024,1,0,0,705,0.5,104.15130275447868,2
2020-07-30-171024,171024,5,0,7,710,1.0,97.26035493669744,3
2020-07-31-171024,171024,1,0,4,711,0.8333333333333334,104.9790076183379,4
2020-08-01-171024,171024,0,0,6,711,0.16666666666666666,103.34434098811442,5
2020-08-02-171024,171024,0,0,4,711,0.3333333333333333,411.2475887872697,6
2020-08-03-171024,171024,2,0,5,713,0.8333333333333334,966.432218630246,0
2020-08-04-171024,171024,2,0,3,715,1.0,830.1106053288751,1
2020-08-05-171024,171024,4,0,6,719,2.833333333333333,721.7977282935924,2
2020-08-06-171024,171024,0,0,6,719,1.5,557.1123848669234,3
2020-08-07-171024,171024,1,0,5,720,2.333333333333333,393.579467197721,4
2020-08-08-171024,171024,1,0,4,721,1.3333333333333333,337.6054872022928,5
2020-08-09-171024,171024,1,0,3,722,0.16666666666666666,358.85784128261736,6
2020-08-10-171024,171024,2,0,7,724,1.6666666666666667,80.94018251373379,0
2020-08-11-171024,171024,2,0,12,726,1.5,120.52540079560649,1
2020-08-12-171024,171024,0,0,8,726,2.1666666666666665,145.3890392886491,2
2020-08-13-171024,171024,7,0,15,733,3.1666666666666665,197.12720339950295,3
2020-08-14-171024,171024,4,0,16,737,2.5,236.19049370136923,4
2020-08-15-171024,171024,6,0,5,743,0.8333333333333334,282.6856676804561,5
2020-08-16-171024,171024,4,0,9,747,2.333333333333333,284.9412993698956,6
2020-08-17-171024,171024,5,0,6,752,4.0,337.68180646202194,0
2020-08-18-171024,171024,3,0,4,755,2.833333333333333,340.40741468531803,1
2020-08-19-171024,171024,6,0,4,761,3.1666666666666665,369.2330818308542,2
2020-08-20-171024,171024,6,0,4,767,6.166666666666668,315.7976254912019,3
2020-08-21-171024,171024,5,0,10,772,3.333333333333333,392.09739982313897,4
2020-08-22-171024,171024,4,0,6,776,2.333333333333333,455.22250369933585,5
2020-08-23-171024,171024,3,0,6,779,1.5,482.23941146420236,6
2020-08-24-171024,171024,7,0,22,786,3.0,497.68332712066217,0
2020-08-25-171024,171024,12,0,1,798,5.333333333333333,564.8291696252081,1
2020-08-26-171024,171024,8,0,16,806,4.333333333333333,639.7074437229937,2
2020-08-27-171024,171024,15,1,6,821,8.333333333333334,749.8974559471928,3
2020-08-28-171024,171024,16,0,14,837,8.0,802.2413301164847,4
2020-08-29-171024,171024,5,0,7,842,3.0,899.9578533621999,5
2020-08-30-171024,171024,9,0,3,851,1.0,888.4458175305351,6
2020-08-31-171024,171024,6,0,16,857,5.5,831.4018219754829,0
2020-09-01-171024,171024,4,0,13,861,4.666666666666667,378.52483976787863,1
2020-09-02-171024,171024,4,0,8,865,6.666666666666668,1200.4937493165983,2
2020-09-03-171024,171024,4,0,4,869,7.333333333333332,883.7436784191696,3
2020-09-04-171024,171024,10,0,6,879,5.166666666666667,893.5755171161732,4
2020-09-05-171024,171024,6,0,2,885,3.0,825.0174630122165,5
2020-09-06-171024,171024,6,1,3,891,1.8333333333333333,811.2600545336159,6
2020-09-07-171024,171024,22,0,7,913,10.333333333333334,864.6133112409577,0
2020-09-08-171024,171024,1,0,2,914,0.8333333333333334,988.6981668526882,1
2020-09-09-171024,171024,16,0,11,930,6.666666666666668,865.690154549805,2
2020-09-10-171024,171024,6,0,6,936,7.5,347.5030057128139,3
2020-09-11-171024,171024,14,0,10,950,9.166666666666666,549.6025354528467,4
2020-09-12-171024,171024,7,0,3,957,1.0,733.5702282831893,5
2020-09-13-171024,171024,3,0,2,960,2.5,766.1558458291945,6
2020-09-14-171024,171024,16,1,3,976,10.333333333333334,777.8600227351039,0
2020-09-15-171024,171024,13,0,7,989,4.833333333333333,997.7822254978239,1
2020-09-16-171024,171024,8,0,3,997,12.333333333333336,1214.5583675062392,2
2020-09-17-171024,171024,4,2,4,1001,8.666666666666666,1380.0688233305823,3
2020-09-18-171024,171024,6,0,4,1007,6.166666666666668,1423.5619354700254,4
2020-09-19-171024,171024,2,0,3,1009,2.0,1345.385762215138,5
2020-09-20-171024,171024,3,0,1,1012,2.1666666666666665,1434.9509290345209,6
2020-09-21-171024,171024,7,0,9,1019,7.333333333333332,1182.8397350981973,0
2020-09-22-171024,171024,2,0,10,1021,3.6666666666666665,1158.7644479840924,1
2020-09-23-171024,171024,11,3,13,1032,7.5,1048.9835628585406,2
2020-09-24-171024,171024,6,1,10,1038,7.0,928.631994356073,3
2020-09-25-171024,171024,10,2,15,1048,9.666666666666666,918.1517236965609,4
2020-09-26-171024,171024,3,0,7,1051,2.833333333333333,1105.054519921944,5
2020-09-27-171024,171024,2,0,3,1053,2.833333333333333,1088.852698470758,6
2020-09-28-171024,171024,3,0,4,1056,7.5,1098.7045783813855,0
2020-09-29-171024,171024,7,0,15,1063,6.666666666666668,1057.5109077170298,1
2020-09-30-171024,171024,3,0,9,1066,7.0,1056.3356590504357,2
2020-10-01-171024,171024,4,0,13,1070,5.333333333333333,0.0,3
2020-10-02-171024,171024,4,0,13,1074,7.666666666666668,1189.6352678601052,4
2020-10-03-171024,171024,3,0,5,1077,2.0,2389.563943516341,5
2020-10-04-171024,171024,1,2,2,1078,3.6666666666666665,2453.71350668331,6
2020-10-05-171024,171024,9,1,8,1087,7.5,2048.304372911545,0
2020-10-06-171024,171024,10,1,8,1097,7.666666666666668,1896.8389098895755,1
2020-10-07-171024,171024,13,1,14,1110,5.666666666666668,1650.5519832749378,2
2020-10-08-171024,171024,10,0,16,1120,5.5,1432.2707566790502,3
2020-10-09-171024,171024,15,1,23,1135,7.0,1638.9797384526482,4
2020-10-10-171024,171024,7,0,6,1142,2.333333333333333,160.00172434549359,5
2020-10-11-171024,171024,3,0,3,1145,0.5,285.864432854916,6
2020-10-12-171024,171024,4,0,14,1149,1.1666666666666667,330.8009829579256,0
2020-10-13-171024,171024,15,0,16,1164,6.0,361.6897143811745,1
2020-10-14-171024,171024,9,0,28,1173,7.333333333333332,533.3377057890979,2
2020-10-15-171024,171024,13,0,19,1186,6.166666666666668,749.4092632205115,3
2020-10-16-171024,171024,13,0,35,1199,7.833333333333332,932.7190467069875,4
2020-10-17-171024,171024,5,0,15,1204,4.5,1000.0769313275581,5
2020-10-18-171024,171024,2,0,2,1206,0.8333333333333334,966.7367499064385,6
2020-10-19-171024,171024,8,0,3,1214,8.666666666666666,980.3754217693325,0
2020-10-20-171024,171024,8,0,18,1222,9.666666666666666,1272.7534124946053,1
2020-10-21-171024,171024,14,1,28,1236,13.166666666666664,1318.021483613835,2
2020-10-22-171024,171024,16,0,32,1252,12.5,1483.0809238033185,3
2020-10-23-171024,171024,23,0,18,1275,21.66666666666667,1680.1925511864918,4
2020-10-24-171024,171024,6,1,16,1281,5.0,2024.6852148956732,5
2020-10-25-171024,171024,3,1,6,1284,3.1666666666666665,2043.5583615788796,6
2020-10-26-171024,171024,14,2,8,1298,20.666666666666668,1909.5352755018666,0
2020-10-27-171024,171024,16,1,21,1314,12.5,2139.1631831662226,1
2020-10-28-171024,171024,28,1,21,1342,19.666666666666668,2211.0190852278683,2
2020-10-29-171024,171024,19,0,20,1361,20.666666666666668,2323.0846224238016,3
2020-10-30-171024,171024,35,1,32,1396,22.33333333333333,1978.1768695262235,4
2020-10-31-171024,171024,15,1,0,1411,7.0,2305.7107695468208,5
2020-11-01-171024,171024,2,2,0,1413,5.5,1272.743923551459,6
2020-11-02-171024,171024,3,0,0,1416,2.6666666666666665,1873.8441948301775,0
2020-11-03-171024,171024,18,0,0,1434,19.5,1446.1951930948553,1
2020-11-04-171024,171024,28,0,0,1462,14.666666666666664,1799.9644195776898,2
2020-11-05-171024,171024,32,3,0,1494,18.5,1968.1810090480046,3
2020-11-06-171024,171024,18,2,0,1512,16.5,2231.118778351072,4
2020-11-07-171024,171024,16,2,0,1528,5.666666666666668,2392.0241969474973,5
2020-11-08-171024,171024,6,0,0,1534,4.666666666666667,2310.017628799423,6
2020-11-09-171024,171024,8,0,0,1542,19.666666666666668,2336.927032730917,0
2020-11-10-171024,171024,21,0,0,1563,12.833333333333336,1130.4003841117683,1
2020-11-11-171024,171024,21,1,0,1584,12.833333333333336,1359.1050872288329,2
2020-11-12-171024,171024,20,1,0,1604,14.0,1556.0663902394967,3
2020-11-13-171024,171024,32,3,0,1636,13.5,1669.5623813141265,4
2020-03-01-171025,171025,0,0,3,0,0.1,0.0,6
2020-03-02-171025,171025,0,0,9,0,0.0,79.44743897600932,0
2020-03-03-171025,171025,0,1,9,0,0.2,418.7660875393801,1
2020-03-04-171025,171025,0,0,9,0,0.1,453.6856953581821,2
2020-03-05-171025,171025,0,0,18,0,0.2,465.10503449125906,3
2020-03-06-171025,171025,0,0,13,0,0.2,402.35428249336496,4
2020-03-07-171025,171025,0,0,3,0,0.1,427.04893705242455,5
2020-03-08-171025,171025,0,0,4,0,0.0,421.984381375981,6
2020-03-09-171025,171025,0,0,15,0,0.3,413.9933938366158,0
2020-03-10-171025,171025,0,0,10,0,0.5,1546.1329141849533,1
2020-03-11-171025,171025,0,0,7,0,0.5,1241.598481159312,2
2020-03-12-171025,171025,0,0,15,0,0.5,875.1390934740663,3
2020-03-13-171025,171025,2,0,13,2,1.3,556.0154266775422,4
2020-03-14-171025,171025,0,0,1,2,1.2,410.0794969477099,5
2020-03-15-171025,171025,3,0,1,5,1.3,300.6064000199453,6
2020-03-16-171025,171025,9,0,8,14,5.4,104.73854560391104,0
2020-03-17-171025,171025,9,0,5,23,4.6,217.49206753530615,1
2020-03-18-171025,171025,9,1,10,32,8.4,297.59039204138776,2
2020-03-19-171025,171025,18,0,8,50,9.5,403.14292847203933,3
2020-03-20-171025,171025,13,0,38,63,11.7,523.0339051284958,4
2020-03-21-171025,171025,3,0,2,66,3.3,650.3758141520947,5
2020-03-22-171025,171025,4,0,0,70,4.1,636.7026609470927,6
2020-03-23-171025,171025,15,0,14,85,13.3,596.3598047520968,0
2020-03-24-171025,171025,10,0,15,95,11.8,707.7759374693612,1
2020-03-25-171025,171025,7,0,12,102,12.3,740.0609353734658,2
2020-03-26-171025,171025,15,0,17,117,11.7,723.5354894008759,3
2020-03-27-171025,171025,13,0,6,130,10.3,848.199863192297,4
2020-03-28-171025,171025,1,0,1,131,3.0,815.3312454129637,5
2020-03-29-171025,171025,1,0,8,132,2.4,808.5814268403783,6
2020-03-30-171025,171025,8,0,8,140,11.2,610.2850380171844,0
2020-03-31-171025,171025,5,0,5,145,6.4,584.6634574525938,1
2020-04-01-171025,171025,10,0,6,155,8.3,88.58660921763854,2
2020-04-02-171025,171025,8,0,5,163,9.3,342.4066591663521,3
2020-04-03-171025,171025,38,0,6,201,7.8,159.16866529155703,4
2020-04-04-171025,171025,2,0,0,203,2.5,285.3646348759954,5
2020-04-05-171025,171025,0,0,0,203,2.0,304.14165990858896,6
2020-04-06-171025,171025,14,0,7,217,8.4,318.44381675653113,0
2020-04-07-171025,171025,15,0,1,232,5.1,371.07170278713505,1
2020-04-08-171025,171025,12,0,4,244,6.4,426.7753940561502,2
2020-04-09-171025,171025,17,0,0,261,3.5,491.22929583641206,3
2020-04-10-171025,171025,6,0,4,267,3.8,101.09262917003939,4
2020-04-11-171025,171025,1,0,0,268,3.6,144.09574419593326,5
2020-04-12-171025,171025,8,0,1,276,2.5,168.14815157870873,6
2020-04-13-171025,171025,8,0,5,284,5.6,198.03399316809185,0
2020-04-14-171025,171025,5,0,4,289,5.8,297.8279613244228,1
2020-04-15-171025,171025,6,0,4,295,5.7,378.4531338598358,2
2020-04-16-171025,171025,5,0,5,300,3.1,455.9364147202142,3
2020-04-17-171025,171025,6,0,2,306,3.1,440.6628596321977,4
2020-04-18-171025,171025,0,0,1,306,1.3,459.64627211028164,5
2020-04-19-171025,171025,0,0,0,306,0.8,439.33897326046815,6
2020-04-20-171025,171025,7,0,2,313,4.4,417.938324704642,0
2020-04-21-171025,171025,1,0,4,314,4.0,403.36687375743145,1
2020-04-22-171025,171025,4,0,6,318,3.1,373.27428597749406,2
2020-04-23-171025,171025,0,0,2,318,0.2,365.5464163856182,3
2020-04-24-171025,171025,4,0,5,322,3.5,305.4009100853642,4
2020-04-25-171025,171025,0,0,2,322,0.3,337.7333488289822,5
2020-04-26-171025,171025,1,0,1,323,0.7,333.16422990989355,6
2020-04-27-171025,171025,5,1,5,328,3.4,219.92281894004412,0
2020-04-28-171025,171025,4,1,3,332,2.2,211.5126139100263,1
2020-04-29-171025,171025,4,0,9,336,2.9,194.3783403355285,2
2020-04-30-171025,171025,5,0,6,341,3.5,361.1194043852836,3
2020-05-01-171025,171025,2,0,1,343,0.6,518.7313034810966,4
2020-05-02-171025,171025,1,0,0,344,0.6,164.1379613841853,5
2020-05-03-171025,171025,0,0,0,344,0.3,124.73155945228339,6
2020-05-04-171025,171025,2,0,3,346,3.6,90.98600652991732,0
2020-05-05-171025,171025,4,0,1,350,2.6,123.74846411282141,1
2020-05-06-171025,171025,6,0,5,356,3.8,141.09807891860157,2
2020-05-07-171025,171025,2,0,3,358,3.3,173.12658996428883,3
2020-05-08-171025,171025,5,0,3,363,3.2,204.9496264571323,4
2020-05-09-171025,171025,2,0,0,365,0.3,275.69642248318615,5
2020-05-10-171025,171025,1,0,0,366,0.4,521.4161977820597,6
2020-05-11-171025,171025,5,0,1,371,2.9,499.06069202230634,0
2020-05-12-171025,171025,3,0,0,374,2.4,540.5430208228771,1
2020-05-13-171025,171025,9,0,0,383,1.2,446.76164438117394,2
2020-05-14-171025,171025,6,0,1,389,1.9,340.1817588431846,3
2020-05-15-171025,171025,1,0,1,390,2.4,273.4900360641817,4
2020-05-16-171025,171025,0,0,0,390,0.5,220.92432999752106,5
2020-05-17-171025,171025,0,0,0,390,0.4,217.5296165152106,6
2020-05-18-171025,171025,3,0,3,393,3.1,212.19375824922616,0
2020-05-19-171025,171025,1,0,3,394,2.4,207.1648636794124,1
2020-05-20-171025,171025,5,0,2,399,2.6,180.41508038466446,2
2020-05-21-171025,171025,3,0,2,402,2.4,191.8377890888935,3
2020-05-22-171025,171025,3,0,0,405,2.4,188.05555229247915,4
2020-05-23-171025,171025,0,0,0,405,0.5,221.5354968997048,5
2020-05-24-171025,171025,0,0,0,405,0.2,226.08279714429165,6
2020-05-25-171025,171025,1,0,1,406,2.5,181.916934214379,0
2020-05-26-171025,171025,0,0,0,406,1.8,197.9112761685287,1
2020-05-27-171025,171025,0,0,4,406,2.4,223.63932683596389,2
2020-05-28-171025,171025,1,0,4,407,1.0,210.65169847983952,3
2020-05-29-171025,171025,1,0,0,408,2.2,198.1887863289327,4
2020-05-30-171025,171025,0,0,0,408,0.2,192.919758395999,5
2020-05-31-171025,171025,0,0,0,408,0.3,200.788570774047,6
2020-06-01-171025,171025,3,1,3,411,1.6,402.8342159246545,0
2020-06-02-171025,171025,3,0,3,414,1.7,157.4877027784563,1
2020-06-03-171025,171025,2,0,3,416,0.9,108.7031716879471,2
2020-06-04-171025,171025,2,0,2,418,1.3,113.66396153705827,3
2020-06-05-171025,171025,0,0,3,418,1.2,127.79509841649747,4
2020-06-06-171025,171025,0,0,1,418,0.1,133.13623544979612,5
2020-06-07-171025,171025,0,0,0,418,0.1,128.94864811800858,6
2020-06-08-171025,171025,1,1,1,419,1.3,124.5698293189202,0
2020-06-09-171025,171025,0,0,3,419,0.7,121.6528387408742,1
2020-06-10-171025,171025,4,1,0,423,1.1,432.1464318767534,2
2020-06-11-171025,171025,4,0,0,427,0.9,380.2962432420828,3
2020-06-12-171025,171025,0,0,1,427,1.6,349.48526379197176,4
2020-06-13-171025,171025,0,0,1,427,0.2,292.60463928068543,5
2020-06-14-171025,171025,0,1,1,427,0.1,224.06301742395732,6
2020-06-15-171025,171025,3,1,2,430,2.1,147.50904900352344,0
2020-06-16-171025,171025,3,0,1,433,1.7,172.63562502038044,1
2020-06-17-171025,171025,3,0,1,436,0.9,169.44792122630616,2
2020-06-18-171025,171025,2,0,0,438,1.1,159.15636131843934,3
2020-06-19-171025,171025,3,0,2,441,1.6,155.54661933483024,4
2020-06-20-171025,171025,1,1,0,442,0.2,194.66768821097702,5
2020-06-21-171025,171025,0,0,0,442,0.1,198.11857783323097,6
2020-06-22-171025,171025,1,0,2,443,0.6,162.08209996787022,0
2020-06-23-171025,171025,3,0,2,446,0.9,138.52205668881078,1
2020-06-24-171025,171025,0,1,0,446,1.1,141.2003277307157,2
2020-06-25-171025,171025,0,0,0,446,0.6,128.68123311410426,3
2020-06-26-171025,171025,1,0,1,447,0.7,110.64188828497493,4
2020-06-27-171025,171025,1,0,0,448,0.0,98.64787717954246,5
2020-06-28-171025,171025,1,0,1,449,0.0,98.06230074384794,6
2020-06-29-171025,171025,2,0,2,451,1.1,100.15203979417143,0
2020-06-30-171025,171025,1,0,0,452,0.7,113.92019632907295,1
2020-07-01-171025,171025,1,0,0,453,0.6,120.62682288079773,2
2020-07-02-171025,171025,0,0,1,453,0.3,53.848940922372925,3
2020-07-03-171025,171025,2,0,4,455,0.8,81.78414386726146,4
2020-07-04-171025,171025,0,0,0,455,0.2,103.95252672550606,5
2020-07-05-171025,171025,0,0,0,455,0.0,103.14659020930239,6
2020-07-06-171025,171025,2,0,1,457,0.5,82.41095495997195,0
2020-07-07-171025,171025,2,0,2,459,0.3,84.80190804682874,1
2020-07-08-171025,171025,0,0,0,459,0.6,87.13693901393847,2
2020-07-09-171025,171025,0,0,2,459,0.4,82.0227206145937,3
2020-07-10-171025,171025,1,0,1,460,1.0,111.56717111731245,4
2020-07-11-171025,171025,0,0,1,460,0.2,105.46425756428428,5
2020-07-12-171025,171025,1,0,0,461,0.0,91.82849509673171,6
2020-07-13-171025,171025,2,0,4,463,0.3,98.66515198032798,0
2020-07-14-171025,171025,0,0,0,463,0.4,109.600421490766,1
2020-07-15-171025,171025,0,0,1,463,0.9,91.347654844196,2
2020-07-16-171025,171025,1,0,1,464,0.6,78.77094270748402,3
2020-07-17-171025,171025,4,0,3,468,0.6,73.97370661873988,4
2020-07-18-171025,171025,0,0,0,468,0.0,70.2946473700621,5
2020-07-19-171025,171025,0,0,1,468,0.2,57.67251667450837,6
2020-07-20-171025,171025,1,0,2,469,0.5,50.375905724386314,0
2020-07-21-171025,171025,2,0,1,471,0.7,53.4920889978359,1
2020-07-22-171025,171025,0,0,0,471,0.5,58.27041642830739,2
2020-07-23-171025,171025,2,0,1,473,0.5,62.48710985104756,3
2020-07-24-171025,171025,1,0,1,474,0.9,64.22888860595351,4
2020-07-25-171025,171025,1,0,3,475,0.0,78.0407003713505,5
2020-07-26-171025,171025,0,0,0,475,0.1,77.38700308656328,6
2020-07-27-171025,171025,4,0,0,479,0.8,68.46204249575226,0
2020-07-28-171025,171025,0,0,1,479,0.8,79.54756369618356,1
2020-07-29-171025,171025,1,0,0,480,0.7,79.0464993991991,2
2020-07-30-171025,171025,1,0,0,481,1.2,76.60308644139222,3
2020-07-31-171025,171025,3,0,3,484,1.0,83.90790723152266,4
2020-08-01-171025,171025,0,0,0,484,0.4,66.30808998197469,5
2020-08-02-171025,171025,1,0,0,485,0.0,315.14082384233404,6
2020-08-03-171025,171025,2,0,2,487,0.6,724.0609461054537,0
2020-08-04-171025,171025,1,0,4,488,0.8,595.8377791754478,1
2020-08-05-171025,171025,0,0,3,488,2.5,515.6585444784696,2
2020-08-06-171025,171025,1,0,2,489,0.7,401.89139122996323,3
2020-08-07-171025,171025,1,0,8,490,1.8,270.8851083629553,4
2020-08-08-171025,171025,3,0,3,493,1.0,245.3127587017553,5
2020-08-09-171025,171025,0,1,0,493,1.1,269.714162046874,6
2020-08-10-171025,171025,0,0,5,493,1.3,55.07333678226712,0
2020-08-11-171025,171025,1,0,17,494,2.9,83.33600386446685,1
2020-08-12-171025,171025,0,0,3,494,1.7,110.85864224717814,2
2020-08-13-171025,171025,0,0,21,494,2.9,141.68287743829694,3
2020-08-14-171025,171025,3,0,6,497,2.0,175.8560660142144,4
2020-08-15-171025,171025,0,0,0,497,0.8,214.33248513144895,5
2020-08-16-171025,171025,0,0,6,497,1.7,211.8857448988357,6
2020-08-17-171025,171025,2,0,2,499,2.2,239.87077367289731,0
2020-08-18-171025,171025,4,0,2,503,2.9,250.25084889162756,1
2020-08-19-171025,171025,3,0,4,506,2.5,267.3401054227103,2
2020-08-20-171025,171025,2,0,3,508,5.2,233.30080121611485,3
2020-08-21-171025,171025,8,0,1,516,4.1,271.63626975812593,4
2020-08-22-171025,171025,3,0,1,519,1.7,327.63267838334133,5
2020-08-23-171025,171025,0,0,1,519,3.1,338.646485362965,6
2020-08-24-171025,171025,5,0,3,524,3.3,334.00231885805954,0
2020-08-25-171025,171025,17,1,4,541,5.0,380.55063159370627,1
2020-08-26-171025,171025,3,0,4,544,5.9,455.3716490730245,2
2020-08-27-171025,171025,21,0,11,565,7.1,536.5329250719813,3
2020-08-28-171025,171025,6,0,2,571,7.3,584.9801110320418,4
2020-08-29-171025,171025,0,0,2,571,2.0,668.0602021696233,5
2020-08-30-171025,171025,6,0,0,577,1.9,661.5954783378945,6
2020-08-31-171025,171025,2,0,4,579,3.7,605.4342505386143,0
2020-09-01-171025,171025,2,0,10,581,3.4,271.9438086216202,1
2020-09-02-171025,171025,4,0,3,585,4.1,895.4751089953988,2
2020-09-03-171025,171025,3,0,2,588,2.8,604.1614312271367,3
2020-09-04-171025,171025,1,0,6,589,3.7,598.3111776829511,4
2020-09-05-171025,171025,1,0,4,590,3.0,540.4286921004484,5
2020-09-06-171025,171025,1,0,1,591,5.2,508.9581894060027,6
2020-09-07-171025,171025,3,0,5,594,5.5,546.4021719101539,0
2020-09-08-171025,171025,4,0,4,598,3.3,595.9689137910842,1
2020-09-09-171025,171025,4,0,6,602,5.5,533.314801502119,2
2020-09-10-171025,171025,11,1,10,613,8.8,240.96436134179447,3
2020-09-11-171025,171025,2,0,2,615,8.2,383.68620815366853,4
2020-09-12-171025,171025,2,0,2,617,2.7,499.8702688440235,5
2020-09-13-171025,171025,0,2,0,617,2.0,514.5184255441861,6
2020-09-14-171025,171025,4,1,1,621,9.1,519.5445914691611,0
2020-09-15-171025,171025,10,0,0,631,10.3,636.1445783929447,1
2020-09-16-171025,171025,3,0,3,634,11.1,779.9173642637787,2
2020-09-17-171025,171025,2,0,5,636,9.8,892.2990483274582,3
2020-09-18-171025,171025,6,0,1,642,12.2,899.8898143645399,4
2020-09-19-171025,171025,4,0,1,646,9.9,873.8243423743969,5
2020-09-20-171025,171025,1,0,1,647,2.4,991.8514162787387,6
2020-09-21-171025,171025,5,1,3,652,8.0,861.3511408481017,0
2020-09-22-171025,171025,4,1,8,656,8.3,840.315476178251,1
2020-09-23-171025,171025,6,0,3,662,7.8,775.8845692606385,2
2020-09-24-171025,171025,10,0,2,672,6.2,697.4547755192768,3
2020-09-25-171025,171025,2,0,5,674,8.6,675.6728113338352,4
2020-09-26-171025,171025,2,0,5,676,4.6,728.5710938170118,5
2020-09-27-171025,171025,0,0,3,676,0.6,722.4245985864038,6
2020-09-28-171025,171025,1,0,3,677,4.0,704.2884629887542,0
2020-09-29-171025,171025,0,0,13,677,6.0,649.9568707101455,1
2020-09-30-171025,171025,3,0,5,680,5.5,620.8374427086228,2
2020-10-01-171025,171025,5,0,5,685,5.8,0.0,3
2020-10-02-171025,171025,1,0,11,686,7.8,693.2763120165807,4
2020-10-03-171025,171025,1,2,9,687,1.6,1393.7365189951115,5
2020-10-04-171025,171025,1,0,0,688,3.1,1456.1574930406582,6
2020-10-05-171025,171025,3,0,1,691,4.0,1234.0405370882631,0
2020-10-06-171025,171025,8,0,12,699,6.7,1147.1297193054943,1
2020-10-07-171025,171025,3,1,3,702,5.4,1025.3325200520696,2
2020-10-08-171025,171025,2,0,5,704,4.5,891.8748059227028,3
2020-10-09-171025,171025,5,1,19,709,6.6,993.6196343920863,4
2020-10-10-171025,171025,5,0,6,714,3.9,102.5403010069657,5
2020-10-11-171025,171025,3,0,0,717,1.0,168.9907735953857,6
2020-10-12-171025,171025,3,0,13,720,1.6,191.5516166986432,0
2020-10-13-171025,171025,13,0,11,733,4.8,209.7462550381663,1
2020-10-14-171025,171025,5,0,15,738,7.9,305.73265106658084,2
2020-10-15-171025,171025,5,0,9,743,4.1,430.9176296323744,3
2020-10-16-171025,171025,11,0,30,754,6.6,525.8242502637016,4
2020-10-17-171025,171025,9,0,7,763,1.7,551.748979957231,5
2020-10-18-171025,171025,0,0,4,763,2.1,551.0659843912458,6
2020-10-19-171025,171025,1,0,0,764,5.5,564.8476014501435,0
2020-10-20-171025,171025,12,1,9,776,14.2,729.9558381219747,1
2020-10-21-171025,171025,3,0,16,779,9.8,791.6300905627945,2
2020-10-22-171025,171025,5,0,5,784,13.6,867.4545004223949,3
2020-10-23-171025,171025,19,1,5,803,14.3,969.961656303726,4
2020-10-24-171025,171025,6,0,2,809,3.2,1184.003126648372,5
2020-10-25-171025,171025,0,0,0,809,4.3,1216.8214908414316,6
2020-10-26-171025,171025,13,0,1,822,11.5,1136.0386127165536,0
2020-10-27-171025,171025,11,0,8,833,12.5,1275.5251838725947,1
2020-10-28-171025,171025,15,0,9,848,14.1,1297.104158195243,2
2020-10-29-171025,171025,9,0,1,857,15.9,1372.5999772785813,3
2020-10-30-171025,171025,30,0,1,887,16.3,1202.6514638594967,4
2020-10-31-171025,171025,7,1,0,894,7.3,1417.2711504365213,5
2020-11-01-171025,171025,4,0,0,898,7.3,771.8493413667736,6
2020-11-02-171025,171025,0,1,0,898,4.6,1082.3957132862354,0
2020-11-03-171025,171025,9,0,0,907,14.1,886.084609522916,1
2020-11-04-171025,171025,16,0,0,923,16.3,1115.5199300548115,2
2020-11-05-171025,171025,5,0,0,928,20.5,1219.5223060831731,3
2020-11-06-171025,171025,5,1,0,933,18.6,1303.5973312128442,4
2020-11-07-171025,171025,2,0,0,935,9.0,1422.6820078511068,5
2020-11-08-171025,171025,0,0,0,935,9.2,1423.2584520991754,6
2020-11-09-171025,171025,1,1,0,936,12.8,1463.3662027040602,0
2020-11-10-171025,171025,8,0,0,944,11.1,729.5423048222841,1
2020-11-11-171025,171025,9,1,0,953,10.2,869.0172563275978,2
2020-11-12-171025,171025,1,0,0,954,12.6,975.3391357007112,3
2020-11-13-171025,171025,1,1,0,955,12.4,1072.297173412535,4
2020-03-01-171026,171026,0,0,0,0,0.0,0.0,6
2020-03-02-171026,171026,0,0,7,0,0.0,34.638178216171745,0
2020-03-03-171026,171026,0,0,2,0,0.0,184.27524619304808,1
2020-03-04-171026,171026,0,1,3,0,0.0,187.4412723370839,2
2020-03-05-171026,171026,0,0,4,0,0.0,190.01355935935942,3
2020-03-06-171026,171026,0,0,7,0,0.125,156.16758237525715,4
2020-03-07-171026,171026,0,1,1,0,0.0,159.00057576832154,5
2020-03-08-171026,171026,0,0,0,0,0.125,155.14941524355862,6
2020-03-09-171026,171026,1,0,4,1,0.0,154.86228475042563,0
2020-03-10-171026,171026,1,0,3,2,0.375,587.3256480113546,1
2020-03-11-171026,171026,0,0,3,2,0.375,459.3603632116356,2
2020-03-12-171026,171026,1,0,6,3,0.25,330.10822371011034,3
2020-03-13-171026,171026,0,0,10,3,1.375,206.25903802649154,4
2020-03-14-171026,171026,1,0,4,4,0.5,145.6902055435238,5
2020-03-15-171026,171026,0,0,2,4,1.625,111.15476393990946,6
2020-03-16-171026,171026,7,0,2,11,4.0,41.84851413048118,0
2020-03-17-171026,171026,2,0,1,13,4.375,96.03597649405145,1
2020-03-18-171026,171026,3,1,6,16,5.75,124.84657660734742,2
2020-03-19-171026,171026,4,0,31,20,6.75,164.24130076859808,3
2020-03-20-171026,171026,7,0,5,27,7.25,202.03234525724645,4
2020-03-21-171026,171026,1,0,0,28,3.125,242.34603942483926,5
2020-03-22-171026,171026,0,0,1,28,2.375,240.2995631941288,6
2020-03-23-171026,171026,4,0,8,32,11.375,215.56024457084152,0
2020-03-24-171026,171026,3,0,4,35,7.5,261.3191231921948,1
2020-03-25-171026,171026,3,0,8,38,8.375,267.4959741308476,2
2020-03-26-171026,171026,6,0,6,44,8.25,261.53234560216765,3
2020-03-27-171026,171026,10,0,1,54,7.25,315.2768818077279,4
2020-03-28-171026,171026,4,0,1,58,1.75,313.372253231206,5
2020-03-29-171026,171026,2,0,1,60,2.375,310.8436962881507,6
2020-03-30-171026,171026,2,0,5,62,6.0,239.29827302693792,0
2020-03-31-171026,171026,1,0,2,63,3.5,221.56386308458974,1
2020-04-01-171026,171026,6,0,3,69,5.125,31.384053221267592,2
2020-04-02-171026,171026,31,0,1,100,3.625,140.49556683806492,3
2020-04-03-171026,171026,5,0,0,105,7.5,70.10095247446527,4
2020-04-04-171026,171026,0,0,0,105,2.25,133.30723187981775,5
2020-04-05-171026,171026,1,0,1,106,2.75,139.13921151070127,6
2020-04-06-171026,171026,8,0,0,114,5.125,147.16781901311134,0
2020-04-07-171026,171026,4,0,1,118,4.625,170.51571751571973,1
2020-04-08-171026,171026,8,4,2,126,3.875,199.94470028398797,2
2020-04-09-171026,171026,6,0,0,132,3.5,222.7976435693294,3
2020-04-10-171026,171026,1,0,1,133,2.375,41.657649955327116,4
2020-04-11-171026,171026,1,0,0,134,1.25,53.334656758749944,5
2020-04-12-171026,171026,1,0,0,135,1.625,64.25047447658392,6
2020-04-13-171026,171026,5,0,4,140,3.25,77.12754244696072,0
2020-04-14-171026,171026,2,0,0,142,2.625,121.31471811669218,1
2020-04-15-171026,171026,3,0,4,145,2.75,151.23621316118374,2
2020-04-16-171026,171026,1,0,3,146,3.25,176.7722442246042,3
2020-04-17-171026,171026,0,0,2,146,2.75,172.2055403999398,4
2020-04-18-171026,171026,0,0,0,146,0.625,183.43843398103414,5
2020-04-19-171026,171026,1,0,0,147,0.625,172.2897238378324,6
2020-04-20-171026,171026,0,1,3,147,3.0,181.2188641256722,0
2020-04-21-171026,171026,1,0,0,148,2.375,176.62197017117512,1
2020-04-22-171026,171026,2,0,3,150,2.375,162.25518857537145,2
2020-04-23-171026,171026,0,0,3,150,0.5,155.43873966296587,3
2020-04-24-171026,171026,1,0,0,151,2.0,133.90936702527807,4
2020-04-25-171026,171026,0,0,1,151,0.25,148.1420688625713,5
2020-04-26-171026,171026,0,0,1,151,0.75,146.48887422959928,6
2020-04-27-171026,171026,4,0,1,155,1.125,79.68948900290574,0
2020-04-28-171026,171026,0,0,1,155,2.25,78.26205095411757,1
2020-04-29-171026,171026,4,0,2,159,2.125,75.90718042727153,2
2020-04-30-171026,171026,3,0,0,162,1.625,155.8283184018478,3
2020-05-01-171026,171026,2,0,0,164,0.5,215.62890389506896,4
2020-05-02-171026,171026,0,0,0,164,0.5,66.84890613404724,5
2020-05-03-171026,171026,0,0,0,164,0.125,41.0357160631387,6
2020-05-04-171026,171026,3,0,3,167,1.875,30.868230538504157,0
2020-05-05-171026,171026,0,0,2,167,1.75,38.74938707273526,1
2020-05-06-171026,171026,3,0,0,170,3.5,44.97237091728217,2
2020-05-07-171026,171026,3,0,3,173,2.25,61.34889505420783,3
2020-05-08-171026,171026,0,0,3,173,1.75,76.04917311387807,4
2020-05-09-171026,171026,1,0,0,174,0.625,104.04524975160436,5
2020-05-10-171026,171026,1,0,0,175,0.5,235.7961980388494,6
2020-05-11-171026,171026,1,0,1,176,2.5,229.91628852996627,0
2020-05-12-171026,171026,1,0,0,177,1.125,256.9835939862958,1
2020-05-13-171026,171026,2,0,1,179,2.25,214.30172456339807,2
2020-05-14-171026,171026,0,0,1,179,1.75,173.77626330926864,3
2020-05-15-171026,171026,0,0,0,179,1.25,138.96208941662553,4
2020-05-16-171026,171026,0,0,0,179,0.75,102.08990527543841,5
2020-05-17-171026,171026,0,0,0,179,0.25,98.7299401310891,6
2020-05-18-171026,171026,3,0,1,182,1.625,97.21568007786524,0
2020-05-19-171026,171026,2,0,0,184,1.25,95.0277622636811,1
2020-05-20-171026,171026,0,0,0,184,1.25,77.92928716724833,2
2020-05-21-171026,171026,3,0,0,187,0.875,77.01136445027774,3
2020-05-22-171026,171026,3,0,0,190,1.125,79.81069640848119,4
2020-05-23-171026,171026,0,0,0,190,0.375,95.51508428002269,5
2020-05-24-171026,171026,0,0,0,190,0.0,95.38494710424666,6
2020-05-25-171026,171026,1,0,0,191,1.375,76.019591323365,0
2020-05-26-171026,171026,0,0,1,191,1.0,79.58652461497579,1
2020-05-27-171026,171026,1,1,0,192,0.5,87.17073818576614,2
2020-05-28-171026,171026,1,0,0,193,0.5,85.49719904738252,3
2020-05-29-171026,171026,0,1,2,193,1.125,77.27498058562031,4
2020-05-30-171026,171026,0,0,0,193,0.375,75.72241432427941,5
2020-05-31-171026,171026,0,0,0,193,0.125,81.73420465643325,6
2020-06-01-171026,171026,1,1,4,194,2.0,167.16600040768338,0
2020-06-02-171026,171026,0,0,3,194,1.0,80.60746929834215,1
2020-06-03-171026,171026,0,0,0,194,0.875,42.55211660338155,2
2020-06-04-171026,171026,0,0,2,194,0.875,47.65654271690566,3
2020-06-05-171026,171026,0,0,1,194,0.75,54.59107526398438,4
2020-06-06-171026,171026,0,1,0,194,0.0,55.00447431927579,5
2020-06-07-171026,171026,0,0,0,194,0.0,54.20779976875793,6
2020-06-08-171026,171026,0,0,1,194,0.875,52.53647286796438,0
2020-06-09-171026,171026,1,0,0,195,0.375,53.323829480783616,1
2020-06-10-171026,171026,0,0,0,195,1.0,199.3095683716291,2
2020-06-11-171026,171026,0,0,0,195,1.0,179.46252182932773,3
2020-06-12-171026,171026,2,0,0,197,0.75,165.81151579657615,4
2020-06-13-171026,171026,0,0,0,197,0.125,135.54809392417678,5
2020-06-14-171026,171026,0,1,0,197,0.0,102.94235147292042,6
2020-06-15-171026,171026,4,0,1,201,1.125,72.98257204894362,0
2020-06-16-171026,171026,3,0,0,204,1.25,86.5298842337184,1
2020-06-17-171026,171026,0,0,0,204,1.0,85.31647935761488,2
2020-06-18-171026,171026,2,0,0,206,0.5,79.40437054106746,3
2020-06-19-171026,171026,1,0,0,207,0.875,79.5210584851138,4
2020-06-20-171026,171026,0,0,0,207,0.125,96.99984190282666,5
2020-06-21-171026,171026,0,0,0,207,0.0,99.17995653561012,6
2020-06-22-171026,171026,1,0,0,208,0.5,79.21955774208388,0
2020-06-23-171026,171026,0,0,0,208,0.875,65.19018004764982,1
2020-06-24-171026,171026,0,0,0,208,0.75,66.059179605738,2
2020-06-25-171026,171026,0,0,0,208,0.625,57.63495090442319,3
2020-06-26-171026,171026,0,0,1,208,0.375,49.11223680829984,4
2020-06-27-171026,171026,0,0,0,208,0.25,42.9316971219938,5
2020-06-28-171026,171026,0,0,0,208,0.125,44.047681174697956,6
2020-06-29-171026,171026,1,0,0,209,0.625,46.20222379650753,0
2020-06-30-171026,171026,0,1,0,209,0.5,53.235384591076276,1
2020-07-01-171026,171026,0,0,1,209,0.375,57.399156992009104,2
2020-07-02-171026,171026,0,0,0,209,0.25,23.382212005534058,3
2020-07-03-171026,171026,0,0,0,209,0.75,45.66589398962469,4
2020-07-04-171026,171026,0,0,0,209,0.125,51.19197226898355,5
2020-07-05-171026,171026,0,0,0,209,0.0,49.57426102219593,6
2020-07-06-171026,171026,0,0,0,209,0.625,34.86573730134337,0
2020-07-07-171026,171026,0,0,0,209,0.625,37.93221747372152,1
2020-07-08-171026,171026,0,0,0,209,0.0,41.42621915506278,2
2020-07-09-171026,171026,0,0,0,209,0.25,37.59373227639435,3
2020-07-10-171026,171026,1,0,0,210,0.375,55.19448572793148,4
2020-07-11-171026,171026,0,0,0,210,0.0,50.8379869162992,5
2020-07-12-171026,171026,0,0,0,210,0.125,43.79861908850599,6
2020-07-13-171026,171026,0,0,3,210,0.25,45.93846864863268,0
2020-07-14-171026,171026,0,0,1,210,0.5,51.018925723454615,1
2020-07-15-171026,171026,1,0,0,211,0.625,38.16808477724801,2
2020-07-16-171026,171026,0,0,0,211,0.375,28.07750705663893,3
2020-07-17-171026,171026,0,0,0,211,1.0,24.74878353848578,4
2020-07-18-171026,171026,0,0,0,211,0.0,25.440495799097725,5
2020-07-19-171026,171026,0,0,0,211,0.0,23.17437138213628,6
2020-07-20-171026,171026,0,0,0,211,0.125,20.057207473925907,0
2020-07-21-171026,171026,0,1,2,211,0.625,22.221484565512135,1
2020-07-22-171026,171026,0,0,10,211,0.25,28.671145800916015,2
2020-07-23-171026,171026,0,0,0,211,0.75,30.08297483675002,3
2020-07-24-171026,171026,0,1,0,211,0.375,33.053074841797745,4
2020-07-25-171026,171026,0,0,2,211,0.125,38.87487997698818,5
2020-07-26-171026,171026,0,0,0,211,0.125,39.816654478136286,6
2020-07-27-171026,171026,3,0,1,214,0.75,36.14420437512463,0
2020-07-28-171026,171026,1,0,3,215,0.125,46.660366486130144,1
2020-07-29-171026,171026,0,0,2,215,0.25,41.868966033309846,2
2020-07-30-171026,171026,0,0,2,215,1.0,38.772591140677775,3
2020-07-31-171026,171026,0,0,7,215,1.0,40.910684287513206,4
2020-08-01-171026,171026,0,0,1,215,0.0,30.378172246816646,5
2020-08-02-171026,171026,0,0,1,215,0.125,146.1827434952172,6
2020-08-03-171026,171026,0,0,2,215,0.75,282.18417837788223,0
2020-08-04-171026,171026,2,0,4,217,0.625,241.9693391831189,1
2020-08-05-171026,171026,10,0,2,227,1.0,218.04080183855064,2
2020-08-06-171026,171026,0,0,1,227,0.875,185.87866484782273,3
2020-08-07-171026,171026,0,0,2,227,1.0,125.77384000942416,4
2020-08-08-171026,171026,2,0,0,229,0.625,115.16800069268616,5
2020-08-09-171026,171026,0,0,0,229,0.25,123.91314370356096,6
2020-08-10-171026,171026,1,0,0,230,0.875,21.10837553706077,0
2020-08-11-171026,171026,3,0,0,233,1.875,32.401944976872606,1
2020-08-12-171026,171026,2,0,0,235,1.375,50.54479364518871,2
2020-08-13-171026,171026,2,0,0,237,1.375,62.28886192373686,3
2020-08-14-171026,171026,7,0,4,244,1.75,76.83835285488266,4
2020-08-15-171026,171026,1,0,0,245,0.25,102.19450920476606,5
2020-08-16-171026,171026,1,0,6,246,0.5,104.65270694157664,6
2020-08-17-171026,171026,2,0,0,248,2.5,115.53260259511742,0
2020-08-18-171026,171026,4,0,1,252,1.875,121.69021473629476,1
2020-08-19-171026,171026,2,0,0,254,1.375,126.28560456559707,2
2020-08-20-171026,171026,1,0,0,255,2.125,109.74886979294098,3
2020-08-21-171026,171026,2,0,0,257,3.0,115.59657883420707,4
2020-08-22-171026,171026,0,0,0,257,0.625,134.74268364268383,5
2020-08-23-171026,171026,0,0,4,257,0.875,140.56004920256743,6
2020-08-24-171026,171026,0,0,1,257,1.875,135.67660183294274,0
2020-08-25-171026,171026,0,0,2,257,4.0,142.96735914968303,1
2020-08-26-171026,171026,0,0,1,257,1.5,171.72997062943517,2
2020-08-27-171026,171026,0,0,0,257,5.5,199.355259465876,3
2020-08-28-171026,171026,4,0,1,261,3.25,222.9874889191305,4
2020-08-29-171026,171026,0,0,1,261,0.375,258.9351431467764,5
2020-08-30-171026,171026,6,0,1,267,1.625,253.65855321520078,6
2020-08-31-171026,171026,0,0,9,267,1.25,247.06048332205643,0
2020-09-01-171026,171026,1,0,3,268,1.625,112.69637365574317,1
2020-09-02-171026,171026,0,0,3,268,2.375,446.3885050638595,2
2020-09-03-171026,171026,0,0,1,268,1.875,271.66572618585565,3
2020-09-04-171026,171026,0,0,4,268,3.125,243.87145450855243,4
2020-09-05-171026,171026,0,0,15,268,1.125,225.8118231123187,5
2020-09-06-171026,171026,4,0,5,272,1.375,208.65973416121074,6
2020-09-07-171026,171026,1,0,2,273,3.75,218.95417132657064,0
2020-09-08-171026,171026,2,0,10,275,2.0,236.31802146829554,1
2020-09-09-171026,171026,1,0,3,276,2.125,215.72356536611204,2
2020-09-10-171026,171026,0,0,0,276,3.0,97.05333050009445,3
2020-09-11-171026,171026,1,0,2,277,2.75,152.67388891398818,4
2020-09-12-171026,171026,1,0,6,278,1.375,181.74205295942653,5
2020-09-13-171026,171026,1,0,1,279,1.125,193.97826203352602,6
2020-09-14-171026,171026,9,0,0,288,4.0,197.6133442510557,0
2020-09-15-171026,171026,3,0,3,291,3.125,246.67571797290913,1
2020-09-16-171026,171026,3,0,1,294,2.75,308.96966436951845,2
2020-09-17-171026,171026,1,0,1,295,7.25,362.0520729579129,3
2020-09-18-171026,171026,4,1,1,299,4.25,377.7503268898976,4
2020-09-19-171026,171026,15,0,3,314,1.75,384.86618749196,5
2020-09-20-171026,171026,5,0,0,319,1.5,453.63666704629225,6
2020-09-21-171026,171026,2,1,5,321,3.75,394.5448143328494,0
2020-09-22-171026,171026,10,0,1,331,5.0,375.5848791028097,1
2020-09-23-171026,171026,3,0,5,334,3.875,356.528601829828,2
2020-09-24-171026,171026,0,0,2,334,4.375,319.6011487024075,3
2020-09-25-171026,171026,2,0,3,336,3.625,301.3024290197616,4
2020-09-26-171026,171026,6,0,2,342,2.0,290.33607228586396,5
2020-09-27-171026,171026,1,0,1,343,0.875,291.9286409520074,6
2020-09-28-171026,171026,0,0,1,343,3.125,294.9575854822605,0
2020-09-29-171026,171026,3,0,3,346,1.75,280.02139794936426,1
2020-09-30-171026,171026,1,0,6,347,2.125,249.26626652772956,2
2020-10-01-171026,171026,1,0,0,348,4.25,0.0,3
2020-10-02-171026,171026,1,1,4,349,4.0,328.0671797187513,4
2020-10-03-171026,171026,3,0,0,352,0.75,586.6145712210044,5
2020-10-04-171026,171026,0,0,4,352,0.625,619.9507597080351,6
2020-10-05-171026,171026,5,0,1,357,3.375,518.8111012614513,0
2020-10-06-171026,171026,1,0,5,358,4.0,456.804394175749,1
2020-10-07-171026,171026,5,1,6,363,2.625,404.8378096239967,2
2020-10-08-171026,171026,2,0,1,365,8.5,372.41597694071396,3
2020-10-09-171026,171026,3,0,1,368,4.75,446.9371094837905,4
2020-10-10-171026,171026,2,0,3,370,3.75,47.241760939514364,5
2020-10-11-171026,171026,1,0,2,371,1.75,85.16087586117698,6
2020-10-12-171026,171026,1,0,4,372,1.125,102.28166715341555,0
2020-10-13-171026,171026,3,0,15,375,4.875,116.63794965003342,1
2020-10-14-171026,171026,6,0,7,381,9.125,165.74542722691982,2
2020-10-15-171026,171026,0,0,2,381,3.125,229.5614855169007,3
2020-10-16-171026,171026,4,0,6,385,5.75,268.76699953965544,4
2020-10-17-171026,171026,0,0,7,385,2.625,284.21275135642986,5
2020-10-18-171026,171026,4,0,2,389,2.125,275.23842033313036,6
2020-10-19-171026,171026,1,0,1,390,6.375,279.03150649037565,0
2020-10-20-171026,171026,5,0,4,395,9.0,317.7639891734511,1
2020-10-21-171026,171026,6,0,7,401,7.375,332.8837182323148,2
2020-10-22-171026,171026,1,0,2,402,8.875,364.19564072346947,3
2020-10-23-171026,171026,1,0,7,403,14.25,379.0791356643823,4
2020-10-24-171026,171026,3,0,6,406,5.0,458.0376909714365,5
2020-10-25-171026,171026,2,0,2,408,2.5,469.3080424182833,6
2020-10-26-171026,171026,4,0,2,412,9.25,441.1249336923714,0
2020-10-27-171026,171026,15,0,8,427,9.0,486.25366007272925,1
2020-10-28-171026,171026,7,0,7,434,12.375,530.2695491771166,2
2020-10-29-171026,171026,2,0,6,436,6.5,563.5957453690562,3
2020-10-30-171026,171026,6,0,7,442,14.375,470.44592190977005,4
2020-10-31-171026,171026,7,0,0,449,4.875,555.2670577851418,5
2020-11-01-171026,171026,2,1,0,451,2.25,354.41621641704967,6
2020-11-02-171026,171026,1,0,0,452,1.0,426.92014265303203,0
2020-11-03-171026,171026,4,0,0,456,6.625,347.4741959398377,1
2020-11-04-171026,171026,7,0,0,463,9.5,407.2933565649523,2
2020-11-05-171026,171026,2,1,0,465,9.375,453.133435877724,3
2020-11-06-171026,171026,7,0,0,472,9.625,494.4741091212138,4
2020-11-07-171026,171026,6,0,0,478,9.375,544.3996184564346,5
2020-11-08-171026,171026,2,1,0,480,0.875,534.315165589376,6
2020-11-09-171026,171026,2,0,0,482,6.5,542.2494767114429,0
2020-11-10-171026,171026,8,0,0,490,4.875,324.8499384279523,1
2020-11-11-171026,171026,7,1,0,497,6.875,392.3056764115879,2
2020-11-12-171026,171026,6,0,0,503,4.25,441.20604949532094,3
2020-11-13-171026,171026,7,0,0,510,6.5,512.1081567593232,4
2020-03-01-171101,171101,0,0,0,0,0.0,0.0,6
2020-03-02-171101,171101,0,0,5,0,0.3333333333333333,6.989663534470303,0
2020-03-03-171101,171101,0,0,12,0,0.3333333333333333,28.582943629679754,1
2020-03-04-171101,171101,0,0,5,0,0.0,33.94813914687529,2
2020-03-05-171101,171101,0,0,11,0,0.3333333333333333,37.17980868099375,3
2020-03-06-171101,171101,0,0,5,0,0.3333333333333333,27.557354501218967,4
2020-03-07-171101,171101,0,0,4,0,0.3333333333333333,33.15514965249801,5
2020-03-08-171101,171101,0,0,2,0,0.3333333333333333,39.25805853305872,6
2020-03-09-171101,171101,0,0,20,0,0.3333333333333333,39.41515807254788,0
2020-03-10-171101,171101,0,0,10,0,0.0,340.300228497115,1
2020-03-11-171101,171101,1,0,19,1,0.6666666666666666,285.89001125953695,2
2020-03-12-171101,171101,1,0,17,2,1.6666666666666667,231.92715258980596,3
2020-03-13-171101,171101,3,0,12,5,1.0,98.5425154278538,4
2020-03-14-171101,171101,3,0,1,8,0.3333333333333333,93.64775957014257,5
2020-03-15-171101,171101,0,0,2,8,0.3333333333333333,83.28687144701114,6
2020-03-16-171101,171101,5,0,8,13,4.333333333333333,22.421656458300305,0
2020-03-17-171101,171101,12,0,6,25,6.333333333333332,34.02357779101075,1
2020-03-18-171101,171101,5,0,6,30,11.666666666666664,37.66905320218086,2
2020-03-19-171101,171101,11,0,6,41,11.666666666666664,39.926424258824255,3
2020-03-20-171101,171101,5,0,4,46,14.666666666666664,39.136763200547875,4
2020-03-21-171101,171101,4,0,1,50,2.6666666666666665,46.32750943516207,5
2020-03-22-171101,171101,2,0,1,52,0.6666666666666666,44.55779296140349,6
2020-03-23-171101,171101,20,0,3,72,15.0,37.98534138143325,0
2020-03-24-171101,171101,10,0,8,82,10.0,43.685589950553634,1
2020-03-25-171101,171101,19,0,6,101,8.333333333333334,43.03160130943387,2
2020-03-26-171101,171101,17,0,2,118,8.666666666666666,45.460820554106526,3
2020-03-27-171101,171101,12,0,3,130,10.666666666666666,51.321279817410215,4
2020-03-28-171101,171101,1,0,0,131,0.6666666666666666,51.67128554105484,5
2020-03-29-171101,171101,2,0,1,133,1.0,50.880125394909314,6
2020-03-30-171101,171101,8,0,8,141,9.666666666666666,39.347831377942015,0
2020-03-31-171101,171101,6,0,4,147,5.0,43.61631858577437,1
2020-04-01-171101,171101,6,0,3,153,6.0,6.397038352325142,2
2020-04-02-171101,171101,6,0,3,159,3.333333333333333,16.573810805080498,3
2020-04-03-171101,171101,4,0,3,163,3.6666666666666665,23.623325396160748,4
2020-04-04-171101,171101,1,0,2,164,2.0,30.11172447079269,5
2020-04-05-171101,171101,1,1,0,165,1.0,31.56277529984964,6
2020-04-06-171101,171101,3,0,5,168,6.333333333333332,33.22374675025825,0
2020-04-07-171101,171101,8,1,5,176,3.0,31.647748528315596,1
2020-04-08-171101,171101,6,1,5,182,2.333333333333333,29.152288114804385,2
2020-04-09-171101,171101,2,1,1,184,1.6666666666666667,30.048942541992524,3
2020-04-10-171101,171101,3,0,5,187,1.6666666666666667,14.643617330215935,4
2020-04-11-171101,171101,0,0,0,187,0.3333333333333333,15.142225773993136,5
2020-04-12-171101,171101,1,0,2,188,0.0,16.802139173050605,6
2020-04-13-171101,171101,8,1,5,196,1.6666666666666667,17.461570361901543,0
2020-04-14-171101,171101,4,0,5,200,4.333333333333333,18.40301087809434,1
2020-04-15-171101,171101,3,0,3,203,5.0,20.69346166228721,2
2020-04-16-171101,171101,3,0,3,206,2.0,22.34538715503919,3
2020-04-17-171101,171101,3,0,0,209,6.333333333333332,14.49167841025873,4
2020-04-18-171101,171101,2,0,0,211,0.0,20.220932372438615,5
2020-04-19-171101,171101,0,0,0,211,0.3333333333333333,18.580305302115057,6
2020-04-20-171101,171101,5,1,4,216,5.0,20.843656690404927,0
2020-04-21-171101,171101,5,0,3,221,1.6666666666666667,22.332163966250473,1
2020-04-22-171101,171101,5,0,30,226,2.333333333333333,21.370444275867747,2
2020-04-23-171101,171101,1,0,4,227,0.0,19.624274338251396,3
2020-04-24-171101,171101,5,0,4,232,4.666666666666667,13.0415495676069,4
2020-04-25-171101,171101,0,0,1,232,0.6666666666666666,17.541166391642697,5
2020-04-26-171101,171101,2,0,0,234,0.6666666666666666,17.6805060379724,6
2020-04-27-171101,171101,5,0,3,239,5.666666666666668,13.26155468303258,0
2020-04-28-171101,171101,5,0,8,244,5.0,21.36918023563094,1
2020-04-29-171101,171101,3,0,7,247,4.666666666666667,24.269669745629294,2
2020-04-30-171101,171101,3,0,5,250,6.0,30.270052388567564,3
2020-05-01-171101,171101,0,0,6,250,0.3333333333333333,32.95408237784307,4
2020-05-02-171101,171101,0,0,1,250,0.0,27.650599847645758,5
2020-05-03-171101,171101,0,0,0,250,0.0,18.238318158999007,6
2020-05-04-171101,171101,4,0,5,254,5.333333333333333,10.90656260969795,0
2020-05-05-171101,171101,3,0,1,257,5.333333333333333,20.682880227686997,1
2020-05-06-171101,171101,30,0,4,287,4.666666666666667,24.073394556259373,2
2020-05-07-171101,171101,4,0,1,291,3.0,30.542680678614595,3
2020-05-08-171101,171101,4,0,3,295,6.0,32.914976493843966,4
2020-05-09-171101,171101,1,0,4,296,0.3333333333333333,40.98784321196301,5
2020-05-10-171101,171101,0,0,0,296,0.0,27.904196669040985,6
2020-05-11-171101,171101,3,1,2,299,5.333333333333333,25.25762308778227,0
2020-05-12-171101,171101,8,1,2,307,5.666666666666668,29.377993676198837,1
2020-05-13-171101,171101,7,0,0,314,4.0,25.12244819754578,2
2020-05-14-171101,171101,5,0,2,319,3.333333333333333,29.746949393052958,3
2020-05-15-171101,171101,6,0,0,325,5.333333333333333,30.108490488060177,4
2020-05-16-171101,171101,1,0,0,326,1.3333333333333333,34.21691006953023,5
2020-05-17-171101,171101,0,0,0,326,0.0,36.190759950839634,6
2020-05-18-171101,171101,5,0,0,331,2.6666666666666665,36.295654863177596,0
2020-05-19-171101,171101,1,0,1,332,2.333333333333333,32.17701678049868,1
2020-05-20-171101,171101,4,0,3,336,2.0,27.85962673830447,2
2020-05-21-171101,171101,1,0,0,337,5.0,26.09415647453387,3
2020-05-22-171101,171101,3,0,3,340,5.0,37.58269175883341,4
2020-05-23-171101,171101,4,0,0,344,0.6666666666666666,38.08432990306599,5
2020-05-24-171101,171101,0,0,0,344,0.0,38.93802680737354,6
2020-05-25-171101,171101,2,0,3,346,3.333333333333333,37.06046783146374,0
2020-05-26-171101,171101,2,0,0,348,3.333333333333333,36.18591519118853,1
2020-05-27-171101,171101,0,0,1,348,1.6666666666666667,41.11765576246175,2
2020-05-28-171101,171101,2,1,0,350,0.0,42.25016491893953,3
2020-05-29-171101,171101,0,0,0,350,2.0,23.826957498109156,4
2020-05-30-171101,171101,0,0,0,350,0.0,25.73729903239642,5
2020-05-31-171101,171101,0,0,0,350,0.0,25.860091387770478,6
2020-06-01-171101,171101,0,0,5,350,0.0,55.047515627400436,0
2020-06-02-171101,171101,1,0,0,351,0.6666666666666666,8.98665302968474,1
2020-06-03-171101,171101,3,0,0,354,1.0,2.118589137979345,2
2020-06-04-171101,171101,0,0,0,354,1.6666666666666667,2.5285836773026187,3
2020-06-05-171101,171101,3,0,0,357,0.6666666666666666,5.250387429859385,4
2020-06-06-171101,171101,0,0,0,357,0.0,5.020654030617649,5
2020-06-07-171101,171101,0,0,0,357,0.0,5.120171152721735,6
2020-06-08-171101,171101,3,0,0,360,1.6666666666666667,5.071277045930736,0
2020-06-09-171101,171101,0,0,0,360,2.0,14.531211233678683,1
2020-06-10-171101,171101,1,0,2,361,0.3333333333333333,57.28715047288327,2
2020-06-11-171101,171101,0,0,1,361,0.6666666666666666,39.43452774035721,3
2020-06-12-171101,171101,0,0,0,361,0.6666666666666666,37.335012718160456,4
2020-06-13-171101,171101,0,2,0,361,0.0,27.74002425272655,5
2020-06-14-171101,171101,0,1,0,361,0.0,19.579161177433594,6
2020-06-15-171101,171101,5,0,1,366,1.6666666666666667,11.973291950280716,0
2020-06-16-171101,171101,0,0,0,366,0.6666666666666666,12.320509232659322,1
2020-06-17-171101,171101,0,0,0,366,0.0,12.841227832406734,2
2020-06-18-171101,171101,0,0,0,366,1.0,11.614458451015873,3
2020-06-19-171101,171101,0,0,0,366,2.333333333333333,5.181703814360146,4
2020-06-20-171101,171101,0,0,0,366,0.0,11.11147361737209,5
2020-06-21-171101,171101,0,0,0,366,0.0,11.234558124377749,6
2020-06-22-171101,171101,0,0,1,366,0.6666666666666666,8.137718935540619,0
2020-06-23-171101,171101,0,0,0,366,0.6666666666666666,8.090023972152078,1
2020-06-24-171101,171101,2,0,0,368,0.0,8.417412643468706,2
2020-06-25-171101,171101,1,0,0,369,0.3333333333333333,8.275702366351961,3
2020-06-26-171101,171101,0,0,0,369,0.6666666666666666,2.687641428776498,4
2020-06-27-171101,171101,0,0,0,369,0.3333333333333333,2.814776775154793,5
2020-06-28-171101,171101,0,0,1,369,0.0,3.0230406455691723,6
2020-06-29-171101,171101,1,0,0,370,0.0,3.12627194805575,0
2020-06-30-171101,171101,0,0,0,370,0.3333333333333333,2.9546548212478827,1
2020-07-01-171101,171101,0,0,0,370,0.0,17.88223642865319,2
2020-07-02-171101,171101,0,0,0,370,0.3333333333333333,1.0918655868073763,3
2020-07-03-171101,171101,0,0,0,370,0.6666666666666666,3.0959701200947016,4
2020-07-04-171101,171101,0,0,0,370,0.0,9.292243593691651,5
2020-07-05-171101,171101,0,0,0,370,0.0,9.325257366677317,6
2020-07-06-171101,171101,1,0,0,371,0.3333333333333333,6.732859103622705,0
2020-07-07-171101,171101,0,0,0,371,0.0,9.56477610995537,1
2020-07-08-171101,171101,0,0,0,371,0.0,9.282753672611427,2
2020-07-09-171101,171101,0,0,0,371,0.3333333333333333,8.76961230212532,3
2020-07-10-171101,171101,0,0,0,371,0.0,18.147910442128374,4
2020-07-11-171101,171101,0,0,0,371,0.0,15.411395607430219,5
2020-07-12-171101,171101,1,0,0,372,0.0,14.852879649815637,6
2020-07-13-171101,171101,0,0,0,372,0.3333333333333333,14.561611603066165,0
2020-07-14-171101,171101,0,0,0,372,0.0,14.715496744183316,1
2020-07-15-171101,171101,0,0,0,372,0.3333333333333333,4.939826404012481,2
2020-07-16-171101,171101,0,0,0,372,0.0,1.6739885245175672,3
2020-07-17-171101,171101,0,0,2,372,0.6666666666666666,1.7038021424258343,4
2020-07-18-171101,171101,0,0,0,372,0.0,0.982349985395084,5
2020-07-19-171101,171101,0,0,0,372,0.0,1.1132317437893917,6
2020-07-20-171101,171101,0,0,1,372,0.0,1.2640112749801458,0
2020-07-21-171101,171101,0,0,0,372,0.0,1.1537014236729481,1
2020-07-22-171101,171101,0,0,0,372,0.3333333333333333,1.1073894109595965,2
2020-07-23-171101,171101,0,0,0,372,0.0,1.4369080631852174,3
2020-07-24-171101,171101,0,0,0,372,0.0,1.2543775028484012,4
2020-07-25-171101,171101,0,0,0,372,0.0,1.1989333742694597,5
2020-07-26-171101,171101,0,0,0,372,0.0,1.1820821644411594,6
2020-07-27-171101,171101,0,0,3,372,0.6666666666666666,0.7585476549740315,0
2020-07-28-171101,171101,0,0,2,372,0.0,3.3531535739663507,1
2020-07-29-171101,171101,0,0,2,372,0.0,3.3891648499099114,2
2020-07-30-171101,171101,0,0,0,372,0.3333333333333333,3.4959969099273236,3
2020-07-31-171101,171101,2,0,1,374,2.0,3.899081503384846,4
2020-08-01-171101,171101,0,0,0,374,0.6666666666666666,8.176840310368657,5
2020-08-02-171101,171101,0,0,0,374,0.0,53.84912895417477,6
2020-08-03-171101,171101,1,0,2,375,1.6666666666666667,24.871591454189403,0
2020-08-04-171101,171101,0,0,13,375,0.3333333333333333,18.623821136292797,1
2020-08-05-171101,171101,0,0,1,375,0.0,15.547282071914161,2
2020-08-06-171101,171101,0,0,2,375,1.0,12.316359083208084,3
2020-08-07-171101,171101,0,0,1,375,0.6666666666666666,9.282128749413822,4
2020-08-08-171101,171101,0,0,0,375,0.3333333333333333,8.257509750622694,5
2020-08-09-171101,171101,0,0,0,375,0.0,6.9748588876665,6
2020-08-10-171101,171101,3,1,3,378,1.6666666666666667,2.903676278337923,0
2020-08-11-171101,171101,2,0,3,380,0.6666666666666666,4.6948855198343535,1
2020-08-12-171101,171101,2,0,2,382,2.6666666666666665,6.6870095073157,2
2020-08-13-171101,171101,0,0,2,382,0.3333333333333333,8.59525569267332,3
2020-08-14-171101,171101,1,0,2,383,2.0,27.07046974999134,4
2020-08-15-171101,171101,0,0,0,383,0.6666666666666666,33.97300861590391,5
2020-08-16-171101,171101,0,0,1,383,2.0,33.80894857855051,6
2020-08-17-171101,171101,2,0,1,385,0.3333333333333333,34.97075892137397,0
2020-08-18-171101,171101,13,0,0,398,3.333333333333333,34.487137291285904,1
2020-08-19-171101,171101,1,0,2,399,0.3333333333333333,53.91961169386518,2
2020-08-20-171101,171101,2,0,2,401,0.6666666666666666,32.57593810817498,3
2020-08-21-171101,171101,1,0,6,402,2.0,27.36395938619227,4
2020-08-22-171101,171101,0,0,1,402,0.0,30.56157789078081,5
2020-08-23-171101,171101,0,0,3,402,0.0,31.14293873611911,6
2020-08-24-171101,171101,3,0,1,405,2.0,30.351124861707596,0
2020-08-25-171101,171101,3,0,9,408,2.6666666666666665,15.747640920045106,1
2020-08-26-171101,171101,2,0,0,410,1.0,16.96419976521572,2
2020-08-27-171101,171101,2,0,11,412,1.6666666666666667,20.093889106233547,3
2020-08-28-171101,171101,2,0,1,414,1.0,22.02728192512221,4
2020-08-29-171101,171101,0,0,4,414,0.6666666666666666,21.257737705529188,5
2020-08-30-171101,171101,1,0,0,415,0.6666666666666666,25.270261365300552,6
2020-08-31-171101,171101,1,0,1,416,2.0,18.253795973841225,0
2020-09-01-171101,171101,0,0,3,416,2.333333333333333,6.846865659960583,1
2020-09-02-171101,171101,2,0,0,418,5.0,112.31943391410081,2
2020-09-03-171101,171101,2,0,6,420,0.6666666666666666,57.1272039911592,3
2020-09-04-171101,171101,6,0,9,426,2.6666666666666665,46.495596103147776,4
2020-09-05-171101,171101,1,0,1,427,2.0,50.93164346587882,5
2020-09-06-171101,171101,3,0,3,430,2.0,46.680309985486346,6
2020-09-07-171101,171101,1,0,3,431,2.0,30.776634278765222,0
2020-09-08-171101,171101,9,0,3,440,5.666666666666668,33.06148304591377,1
2020-09-09-171101,171101,0,0,4,440,0.3333333333333333,42.39235797762032,2
2020-09-10-171101,171101,11,0,3,451,5.0,16.359755767711718,3
2020-09-11-171101,171101,1,0,6,452,1.3333333333333333,34.91500182498521,4
2020-09-12-171101,171101,4,0,8,456,3.0,44.58813207141819,5
2020-09-13-171101,171101,0,0,4,456,2.0,49.601729589604496,6
2020-09-14-171101,171101,1,0,1,457,6.0,49.25289048001756,0
2020-09-15-171101,171101,3,0,3,460,4.0,63.65184095614603,1
2020-09-16-171101,171101,0,0,6,460,4.333333333333333,72.56782799238356,2
2020-09-17-171101,171101,6,0,11,466,6.666666666666668,79.90052379897855,3
2020-09-18-171101,171101,9,0,8,475,7.333333333333332,100.76485266556746,4
2020-09-19-171101,171101,1,0,0,476,3.333333333333333,115.42740238492769,5
2020-09-20-171101,171101,3,0,1,479,2.333333333333333,122.62019123229044,6
2020-09-21-171101,171101,3,0,3,482,4.666666666666667,112.13178390381918,0
2020-09-22-171101,171101,3,0,3,485,1.3333333333333333,112.00020757907659,1
2020-09-23-171101,171101,4,0,4,489,6.0,95.82775755683579,2
2020-09-24-171101,171101,3,0,2,492,2.6666666666666665,67.09169452666303,3
2020-09-25-171101,171101,6,0,5,498,4.333333333333333,52.39243431373009,4
2020-09-26-171101,171101,8,0,1,506,2.0,55.407978427416964,5
2020-09-27-171101,171101,4,0,0,510,2.333333333333333,49.260842999177605,6
2020-09-28-171101,171101,1,0,4,511,2.0,64.7630850122053,0
2020-09-29-171101,171101,3,0,0,514,1.0,58.7631513240364,1
2020-09-30-171101,171101,6,0,12,520,2.6666666666666665,50.74730036070207,2
2020-10-01-171101,171101,11,0,6,531,3.0,0.0,3
2020-10-02-171101,171101,8,0,12,539,1.6666666666666667,193.50088487041359,4
2020-10-03-171101,171101,0,0,1,539,0.6666666666666666,182.4304064493737,5
2020-10-04-171101,171101,1,0,0,540,0.0,209.59015152301032,6
2020-10-05-171101,171101,3,1,16,543,1.6666666666666667,166.98548106904872,0
2020-10-06-171101,171101,3,0,2,546,5.333333333333333,151.8568790171443,1
2020-10-07-171101,171101,4,1,14,550,3.0,149.29613378703417,2
2020-10-08-171101,171101,2,0,7,552,1.6666666666666667,126.69747914983944,3
2020-10-09-171101,171101,5,2,19,557,3.333333333333333,129.95478933169338,4
2020-10-10-171101,171101,1,0,5,558,1.0,6.543030893338922,5
2020-10-11-171101,171101,0,0,1,558,1.6666666666666667,15.07777614720294,6
2020-10-12-171101,171101,4,0,9,562,0.3333333333333333,28.63290142415219,0
2020-10-13-171101,171101,0,0,9,562,3.333333333333333,30.754518051135534,1
2020-10-14-171101,171101,12,0,6,574,3.333333333333333,36.105111732384685,2
2020-10-15-171101,171101,6,0,4,580,4.333333333333333,71.33974038025944,3
2020-10-16-171101,171101,12,0,18,592,14.333333333333336,90.3641494705561,4
2020-10-17-171101,171101,1,1,5,593,2.6666666666666665,174.69483757411516,5
2020-10-18-171101,171101,0,0,5,593,3.6666666666666665,175.766854117634,6
2020-10-19-171101,171101,16,0,2,609,7.333333333333332,177.04685619017764,0
2020-10-20-171101,171101,2,1,16,611,12.666666666666664,207.03890952726076,1
2020-10-21-171101,171101,14,0,13,625,7.0,217.80951192374852,2
2020-10-22-171101,171101,7,0,11,632,11.0,218.65449351413886,3
2020-10-23-171101,171101,19,1,20,651,14.333333333333336,159.6746206610144,4
2020-10-24-171101,171101,5,0,9,656,9.333333333333334,190.82981613398334,5
2020-10-25-171101,171101,1,0,4,657,2.333333333333333,189.306597078808,6
2020-10-26-171101,171101,9,0,13,666,16.666666666666668,179.02491104416038,0
2020-10-27-171101,171101,9,0,14,675,8.666666666666666,210.15716164645875,1
2020-10-28-171101,171101,6,0,10,681,7.666666666666668,179.72917762508678,2
2020-10-29-171101,171101,4,0,8,685,10.0,181.6017028655396,3
2020-10-30-171101,171101,18,0,18,703,19.666666666666668,147.50120742033923,4
2020-10-31-171101,171101,5,0,0,708,1.0,210.24256070521992,5
2020-11-01-171101,171101,5,0,0,713,4.666666666666667,60.82301287896898,6
2020-11-02-171101,171101,2,1,0,715,3.333333333333333,115.8174144718583,0
2020-11-03-171101,171101,16,0,0,731,10.0,129.68256963355392,1
2020-11-04-171101,171101,13,0,0,744,15.0,154.30985626611903,2
2020-11-05-171101,171101,11,0,0,755,16.0,187.34196628749004,3
2020-11-06-171101,171101,20,2,0,775,29.66666666666667,215.12857219631175,4
2020-11-07-171101,171101,9,0,0,784,4.0,303.3361687840875,5
2020-11-08-171101,171101,4,0,0,788,3.0,276.96939555246655,6
2020-11-09-171101,171101,13,0,0,801,21.33333333333333,269.10869923410354,0
2020-11-10-171101,171101,14,0,0,815,20.0,63.184669143750526,1
2020-11-11-171101,171101,10,3,0,825,9.333333333333334,90.49984837771136,2
2020-11-12-171101,171101,8,0,0,833,10.333333333333334,119.1137863956069,3
2020-11-13-171101,171101,18,0,0,851,8.0,119.85432890485768,4
2020-03-01-171102,171102,0,0,0,0,0.0,0.0,6
2020-03-02-171102,171102,0,0,0,0,0.0,7.684072021934034,0
2020-03-03-171102,171102,0,0,2,0,0.0,23.688983041507047,1
2020-03-04-171102,171102,0,0,0,0,0.0,30.070768860059218,2
2020-03-05-171102,171102,0,0,0,0,0.0,35.46449164788112,3
2020-03-06-171102,171102,0,0,0,0,0.0,22.48906570543052,4
2020-03-07-171102,171102,0,0,0,0,0.4,27.03564935401127,5
2020-03-08-171102,171102,0,0,0,0,0.0,29.44717347198687,6
2020-03-09-171102,171102,0,0,0,0,0.2,29.864450776827468,0
2020-03-10-171102,171102,0,0,0,0,0.0,309.25781265213925,1
2020-03-11-171102,171102,0,0,1,0,0.2,261.78269735838717,2
2020-03-12-171102,171102,0,0,1,0,0.6,177.47886384619756,3
2020-03-13-171102,171102,0,0,2,0,0.4,84.42348290220963,4
2020-03-14-171102,171102,0,0,0,0,0.4,67.99443994772257,5
2020-03-15-171102,171102,0,0,1,0,0.0,57.977378776939716,6
2020-03-16-171102,171102,0,0,0,0,0.6,12.964301367341172,0
2020-03-17-171102,171102,2,0,1,2,0.6,18.0365105631463,1
2020-03-18-171102,171102,0,0,2,2,1.2,31.29984525336598,2
2020-03-19-171102,171102,0,0,1,2,1.6,38.74639914995035,3
2020-03-20-171102,171102,0,1,0,2,0.6,42.987324449817336,4
2020-03-21-171102,171102,0,0,3,2,0.8,45.86200240435995,5
2020-03-22-171102,171102,0,0,0,2,0.0,47.46336928180946,6
2020-03-23-171102,171102,0,0,1,2,2.0,43.40568816861753,0
2020-03-24-171102,171102,0,0,1,2,0.2,41.541798859201066,1
2020-03-25-171102,171102,1,0,0,3,1.2,35.23766490002785,2
2020-03-26-171102,171102,1,0,0,4,0.6,34.71684635784706,3
2020-03-27-171102,171102,2,0,0,6,1.6,38.47032155075847,4
2020-03-28-171102,171102,0,0,0,6,0.2,48.17167436317248,5
2020-03-29-171102,171102,1,0,0,7,0.4,43.75411978771299,6
2020-03-30-171102,171102,0,0,0,7,1.4,37.520623110584914,0
2020-03-31-171102,171102,1,0,3,8,0.8,40.40581429124595,1
2020-04-01-171102,171102,2,0,0,10,2.0,8.963981811734943,2
2020-04-02-171102,171102,1,0,0,11,1.4,24.279713899049952,3
2020-04-03-171102,171102,0,0,0,11,2.0,15.364749820173769,4
2020-04-04-171102,171102,3,0,0,14,0.2,24.5626773760925,5
2020-04-05-171102,171102,0,0,1,14,0.2,34.68531312368812,6
2020-04-06-171102,171102,1,0,1,15,1.4,34.83574159481,0
2020-04-07-171102,171102,1,0,1,16,0.4,39.71878546958469,1
2020-04-08-171102,171102,0,0,0,16,1.8,43.25298062495449,2
2020-04-09-171102,171102,0,0,0,16,0.6,44.24135976122705,3
2020-04-10-171102,171102,0,0,1,16,0.6,26.90683544801912,4
2020-04-11-171102,171102,0,0,0,16,0.6,26.568239728746875,5
2020-04-12-171102,171102,0,1,0,16,0.6,27.11229473177196,6
2020-04-13-171102,171102,0,0,0,16,1.2,27.176759058276723,0
2020-04-14-171102,171102,3,0,0,19,0.2,26.92612126765141,1
2020-04-15-171102,171102,0,0,0,19,0.2,36.83363447611393,2
2020-04-16-171102,171102,0,0,0,19,3.8,37.86413779497086,3
2020-04-17-171102,171102,0,1,0,19,0.8,19.518461389760404,4
2020-04-18-171102,171102,0,0,0,19,0.0,23.572058805266458,5
2020-04-19-171102,171102,1,0,0,20,0.2,23.12381619039925,6
2020-04-20-171102,171102,1,1,0,21,0.8,31.26298043440042,0
2020-04-21-171102,171102,1,0,0,22,0.2,24.49469243571115,1
2020-04-22-171102,171102,0,0,0,22,0.0,29.248627776616424,2
2020-04-23-171102,171102,0,0,0,22,0.2,27.653963142682706,3
2020-04-24-171102,171102,1,0,0,23,0.8,23.451314081194354,4
2020-04-25-171102,171102,0,0,0,23,0.6,29.419610704647162,5
2020-04-26-171102,171102,0,0,0,23,0.0,26.33925771873064,6
2020-04-27-171102,171102,0,0,0,23,0.8,18.74058495290358,0
2020-04-28-171102,171102,0,0,0,23,0.8,16.952585415808834,1
2020-04-29-171102,171102,0,0,0,23,1.2,14.850512610041566,2
2020-04-30-171102,171102,0,0,0,23,1.4,29.46410368571792,3
2020-05-01-171102,171102,0,0,1,23,0.4,36.99807086762566,4
2020-05-02-171102,171102,0,0,0,23,0.8,30.809040458863223,5
2020-05-03-171102,171102,0,0,0,23,0.2,10.036436857521505,6
2020-05-04-171102,171102,0,0,1,23,0.2,9.171861244059397,0
2020-05-05-171102,171102,0,0,0,23,2.2,7.227357266591655,1
2020-05-06-171102,171102,0,0,0,23,1.2,11.296466743015609,2
2020-05-07-171102,171102,0,0,0,23,1.0,14.26616258474979,3
2020-05-08-171102,171102,0,0,0,23,1.8,17.216930615148716,4
2020-05-09-171102,171102,0,0,0,23,0.2,20.727416192269022,5
2020-05-10-171102,171102,0,1,0,23,0.0,41.15602046948746,6
2020-05-11-171102,171102,0,0,0,23,0.4,26.715051406836018,0
2020-05-12-171102,171102,0,0,1,23,1.4,29.618018239673187,1
2020-05-13-171102,171102,0,0,0,23,1.4,27.32828543613759,2
2020-05-14-171102,171102,0,0,0,23,0.2,22.58186027909154,3
2020-05-15-171102,171102,1,1,0,24,0.4,25.04216402639647,4
2020-05-16-171102,171102,0,0,0,24,0.6,34.99620741232296,5
2020-05-17-171102,171102,0,0,0,24,0.0,35.70534115857507,6
2020-05-18-171102,171102,1,0,0,25,0.6,36.566243100195045,0
2020-05-19-171102,171102,0,0,0,25,0.4,45.8878874275429,1
2020-05-20-171102,171102,0,0,0,25,0.2,40.843393806921576,2
2020-05-21-171102,171102,0,0,0,25,0.0,35.82310967020112,3
2020-05-22-171102,171102,0,0,0,25,0.0,25.99638320715487,4
2020-05-23-171102,171102,0,0,0,25,0.0,27.10813652992404,5
2020-05-24-171102,171102,0,0,0,25,0.2,27.29559710008452,6
2020-05-25-171102,171102,0,1,0,25,0.0,14.673559180211821,0
2020-05-26-171102,171102,1,0,0,26,1.4,10.019113588666603,1
2020-05-27-171102,171102,0,0,0,26,0.0,17.895277380330903,2
2020-05-28-171102,171102,0,2,0,26,0.2,17.5891102282729,3
2020-05-29-171102,171102,0,0,0,26,0.0,16.466255438492063,4
2020-05-30-171102,171102,0,0,0,26,0.0,16.832877277950736,5
2020-05-31-171102,171102,0,0,0,26,0.0,17.260747075963003,6
2020-06-01-171102,171102,0,0,0,26,0.0,31.553854608482574,0
2020-06-02-171102,171102,0,0,0,26,0.0,2.9815210968941397,1
2020-06-03-171102,171102,0,0,0,26,0.0,3.080418890312498,2
2020-06-04-171102,171102,0,0,0,26,0.0,1.4494765676617751,3
2020-06-05-171102,171102,0,0,0,26,0.0,2.632368411886586,4
2020-06-06-171102,171102,0,0,0,26,0.2,2.5020768067612393,5
2020-06-07-171102,171102,0,0,0,26,0.0,2.7238308904069544,6
2020-06-08-171102,171102,0,0,0,26,0.0,2.6963760976040136,0
2020-06-09-171102,171102,0,0,0,26,0.0,4.9967595584700195,1
2020-06-10-171102,171102,0,0,0,26,0.6,32.46644997808055,2
2020-06-11-171102,171102,0,0,0,26,0.0,28.622905286866,3
2020-06-12-171102,171102,0,0,0,26,0.2,23.093286649051738,4
2020-06-13-171102,171102,0,0,0,26,0.0,16.13353105162321,5
2020-06-14-171102,171102,0,0,0,26,0.0,10.646625872865869,6
2020-06-15-171102,171102,0,0,0,26,0.0,6.724133625976805,0
2020-06-16-171102,171102,0,0,0,26,0.0,6.665181635533761,1
2020-06-17-171102,171102,0,0,0,26,0.0,6.674924162342251,2
2020-06-18-171102,171102,0,0,0,26,0.2,3.991392811104369,3
2020-06-19-171102,171102,0,0,1,26,0.2,2.671872422820305,4
2020-06-20-171102,171102,0,0,0,26,0.2,4.642675907737507,5
2020-06-21-171102,171102,0,0,0,26,0.0,4.940370657687565,6
2020-06-22-171102,171102,0,0,0,26,0.0,4.161367486226155,0
2020-06-23-171102,171102,0,1,0,26,0.0,4.201517163071413,1
2020-06-24-171102,171102,0,0,0,26,0.2,5.7851450603174435,2
2020-06-25-171102,171102,0,0,0,26,0.0,5.940081000474634,3
2020-06-26-171102,171102,0,0,0,26,0.2,4.539857700651768,4
2020-06-27-171102,171102,0,0,0,26,0.0,4.21730851883297,5
2020-06-28-171102,171102,0,0,0,26,0.0,4.2921969579264125,6
2020-06-29-171102,171102,0,0,0,26,0.0,4.3581324677697975,0
2020-06-30-171102,171102,0,0,0,26,0.0,2.8025772390467028,1
2020-07-01-171102,171102,0,0,0,26,0.0,7.629866750685721,2
2020-07-02-171102,171102,0,0,0,26,0.2,0.6148417386452221,3
2020-07-03-171102,171102,1,0,0,27,0.0,1.5436330849647488,4
2020-07-04-171102,171102,0,0,0,27,0.0,12.840195584724338,5
2020-07-05-171102,171102,0,0,0,27,0.0,12.838718175130497,6
2020-07-06-171102,171102,0,0,0,27,0.0,12.184422215698145,0
2020-07-07-171102,171102,0,1,0,27,0.0,12.885716712661386,1
2020-07-08-171102,171102,0,0,0,27,0.0,12.77145843147002,2
2020-07-09-171102,171102,0,1,0,27,0.0,7.5638084124130405,3
2020-07-10-171102,171102,0,0,0,27,0.0,7.175591038848424,4
2020-07-11-171102,171102,0,0,0,27,0.0,6.765044694423675,5
2020-07-12-171102,171102,0,0,0,27,0.0,6.255242126097242,6
2020-07-13-171102,171102,0,0,0,27,0.0,5.817572731012639,0
2020-07-14-171102,171102,0,0,0,27,0.0,5.79408985216031,1
2020-07-15-171102,171102,0,0,0,27,0.0,2.8401288474491766,2
2020-07-16-171102,171102,0,0,0,27,0.0,1.7545848401463857,3
2020-07-17-171102,171102,0,0,0,27,0.0,1.8185749593253506,4
2020-07-18-171102,171102,0,0,0,27,0.0,0.6815528721302397,5
2020-07-19-171102,171102,0,0,0,27,0.0,0.7131827085780708,6
2020-07-20-171102,171102,0,0,1,27,0.0,1.1087023062403636,0
2020-07-21-171102,171102,0,0,0,27,0.0,1.2821320198661783,1
2020-07-22-171102,171102,0,0,0,27,0.0,1.3486427821307467,2
2020-07-23-171102,171102,0,0,0,27,0.0,1.3698614964331917,3
2020-07-24-171102,171102,0,0,2,27,0.0,1.3855747124142717,4
2020-07-25-171102,171102,0,0,0,27,0.0,1.355012484402414,5
2020-07-26-171102,171102,0,0,0,27,0.0,1.376487313266649,6
2020-07-27-171102,171102,0,0,0,27,0.0,0.8995822561142311,0
2020-07-28-171102,171102,0,0,0,27,0.0,1.4132664139101718,1
2020-07-29-171102,171102,0,0,1,27,0.0,1.4490667333490606,2
2020-07-30-171102,171102,0,0,0,27,0.2,7.677571682852402,3
2020-07-31-171102,171102,0,0,0,27,0.0,12.267022375729013,4
2020-08-01-171102,171102,0,0,0,27,0.0,3.4203555341568253,5
2020-08-02-171102,171102,0,0,0,27,0.0,45.158907160112406,6
2020-08-03-171102,171102,1,0,0,28,0.2,73.18783216412838,0
2020-08-04-171102,171102,0,0,0,28,0.0,56.20356209197162,1
2020-08-05-171102,171102,0,0,0,28,0.0,51.262951776953585,2
2020-08-06-171102,171102,0,0,0,28,0.0,48.848194952960654,3
2020-08-07-171102,171102,2,0,1,30,0.2,40.33407942090139,4
2020-08-08-171102,171102,0,0,0,30,0.0,48.06638364984302,5
2020-08-09-171102,171102,0,0,1,30,0.4,42.08614655630249,6
2020-08-10-171102,171102,0,0,1,30,0.2,2.1196089931284137,0
2020-08-11-171102,171102,0,0,0,30,0.0,3.242325784102184,1
2020-08-12-171102,171102,1,0,0,31,0.0,6.404964661804012,2
2020-08-13-171102,171102,0,0,1,31,1.2,7.754030111982265,3
2020-08-14-171102,171102,0,0,0,31,0.8,14.760600003506555,4
2020-08-15-171102,171102,0,0,0,31,0.2,18.37112215182497,5
2020-08-16-171102,171102,0,0,0,31,0.6,21.413514435584545,6
2020-08-17-171102,171102,0,0,0,31,0.8,32.48898388874521,0
2020-08-18-171102,171102,0,0,0,31,1.0,36.23378816865406,1
2020-08-19-171102,171102,0,0,0,31,0.2,40.32849332653415,2
2020-08-20-171102,171102,0,0,2,31,0.0,42.37842377749412,3
2020-08-21-171102,171102,1,0,0,32,0.4,51.06160436937606,4
2020-08-22-171102,171102,0,0,1,32,0.8,69.07570932825726,5
2020-08-23-171102,171102,1,0,3,33,0.6,89.63097625806665,6
2020-08-24-171102,171102,1,0,0,34,0.6,93.26778060266858,0
2020-08-25-171102,171102,0,0,1,34,0.4,112.74367659450914,1
2020-08-26-171102,171102,0,0,0,34,0.6,115.49084357664982,2
2020-08-27-171102,171102,1,0,0,35,0.2,121.12969580111368,3
2020-08-28-171102,171102,0,0,0,35,0.2,112.45688195295183,4
2020-08-29-171102,171102,0,0,9,35,0.2,99.460647700435,5
2020-08-30-171102,171102,0,0,0,35,0.2,71.36193828875092,6
2020-08-31-171102,171102,0,0,2,35,1.0,52.74277034592795,0
2020-09-01-171102,171102,0,0,0,35,0.4,42.103964130896,1
2020-09-02-171102,171102,0,0,0,35,0.2,160.91146246515882,2
2020-09-03-171102,171102,2,0,0,37,0.2,132.56375320583774,3
2020-09-04-171102,171102,0,0,0,37,0.4,112.9150443787197,4
2020-09-05-171102,171102,1,0,0,38,0.2,88.14142053310047,5
2020-09-06-171102,171102,3,0,0,41,0.0,77.66542718783917,6
2020-09-07-171102,171102,0,0,3,41,2.2,91.59744967641802,0
2020-09-08-171102,171102,1,0,1,42,1.2,85.18196594429989,1
2020-09-09-171102,171102,0,0,0,42,0.8,102.38745229880637,2
2020-09-10-171102,171102,0,0,0,42,2.0,28.127431016563154,3
2020-09-11-171102,171102,0,0,2,42,0.2,57.01069588301557,4
2020-09-12-171102,171102,9,0,1,51,0.6,72.16523573520516,5
2020-09-13-171102,171102,0,0,0,51,1.4,122.45773334177653,6
2020-09-14-171102,171102,2,0,1,53,0.4,114.02139299360785,0
2020-09-15-171102,171102,0,0,1,53,1.2,131.07909106568377,1
2020-09-16-171102,171102,0,0,0,53,0.4,140.25621322469237,2
2020-09-17-171102,171102,0,0,0,53,1.4,154.07221221971224,3
2020-09-18-171102,171102,0,0,2,53,2.6,177.69113146682778,4
2020-09-19-171102,171102,0,0,1,53,1.4,185.3528208644557,5
2020-09-20-171102,171102,0,1,0,53,1.2,138.44351745440645,6
2020-09-21-171102,171102,3,0,0,56,0.4,127.82550402364518,0
2020-09-22-171102,171102,1,0,1,57,1.8,135.8571552590654,1
2020-09-23-171102,171102,0,2,2,57,2.6,162.22811322768433,2
2020-09-24-171102,171102,0,0,0,57,4.6,126.20955939675305,3
2020-09-25-171102,171102,2,0,0,59,2.6,134.10810145409712,4
2020-09-26-171102,171102,1,0,0,60,1.8,157.64353293815998,5
2020-09-27-171102,171102,0,0,0,60,2.0,159.4474481740313,6
2020-09-28-171102,171102,1,0,0,61,1.4,161.51249028229498,0
2020-09-29-171102,171102,1,0,0,62,0.8,149.68617989725013,1
2020-09-30-171102,171102,0,0,2,62,2.4,123.42655776163357,2
2020-10-01-171102,171102,0,0,2,62,1.2,0.0,3
2020-10-02-171102,171102,2,0,2,64,2.0,150.07050368476303,4
2020-10-03-171102,171102,1,0,1,65,0.6,403.47306445388074,5
2020-10-04-171102,171102,0,0,2,65,0.4,458.41947617071946,6
2020-10-05-171102,171102,0,0,0,65,1.6,393.7551851694499,0
2020-10-06-171102,171102,1,0,3,66,1.0,303.304187047876,1
2020-10-07-171102,171102,2,1,0,68,0.2,267.95994091365515,2
2020-10-08-171102,171102,0,0,4,68,1.2,209.50791471499326,3
2020-10-09-171102,171102,0,1,1,68,0.4,220.75166104656924,4
2020-10-10-171102,171102,0,0,5,68,0.2,7.547619143743962,5
2020-10-11-171102,171102,0,0,2,68,0.0,11.471516939783978,6
2020-10-12-171102,171102,0,0,4,68,1.0,17.37260040275829,0
2020-10-13-171102,171102,0,0,9,68,0.0,28.86904565887089,1
2020-10-14-171102,171102,2,0,2,70,0.8,32.0930384586741,2
2020-10-15-171102,171102,2,0,4,72,1.2,68.26176187560836,3
2020-10-16-171102,171102,2,0,4,74,0.6,95.28048404019935,4
2020-10-17-171102,171102,1,0,2,75,0.6,122.03369448706371,5
2020-10-18-171102,171102,2,0,1,77,0.6,126.93245985892084,6
2020-10-19-171102,171102,0,0,2,77,1.2,138.92667760459955,0
2020-10-20-171102,171102,3,0,1,80,1.4,156.42822163361456,1
2020-10-21-171102,171102,0,0,1,80,2.0,153.35828118434694,2
2020-10-22-171102,171102,4,0,7,84,2.0,161.49820374275322,3
2020-10-23-171102,171102,1,0,5,85,4.2,176.62059946897125,4
2020-10-24-171102,171102,5,0,1,90,0.8,210.40787261016635,5
2020-10-25-171102,171102,2,1,0,92,1.8,224.29130125227354,6
2020-10-26-171102,171102,4,0,0,96,3.0,228.64080975909152,0
2020-10-27-171102,171102,9,3,0,105,4.0,274.9355924147033,1
2020-10-28-171102,171102,2,1,0,107,3.4,329.9888761679592,2
2020-10-29-171102,171102,4,0,1,111,3.0,347.9689968564976,3
2020-10-30-171102,171102,4,0,0,115,8.2,337.304809486696,4
2020-10-31-171102,171102,2,1,0,117,1.4,416.5899671032289,5
2020-11-01-171102,171102,1,0,0,118,1.4,82.49399999890625,6
2020-11-02-171102,171102,2,0,0,120,0.6,128.63480861980412,0
2020-11-03-171102,171102,1,0,0,121,5.0,113.31949443133792,1
2020-11-04-171102,171102,1,0,0,122,5.6,155.91056577407736,2
2020-11-05-171102,171102,7,2,0,129,3.2,184.82036101054194,3
2020-11-06-171102,171102,5,1,0,134,5.0,225.5274630726331,4
2020-11-07-171102,171102,1,0,0,135,1.6,280.81933053232194,5
2020-11-08-171102,171102,0,0,0,135,1.0,275.4110440808315,6
2020-11-09-171102,171102,0,0,0,135,3.0,262.2731977939856,0
2020-11-10-171102,171102,0,1,0,135,3.6,74.89475278468794,1
2020-11-11-171102,171102,0,0,0,135,5.6,101.37510497087499,2
2020-11-12-171102,171102,1,0,0,136,3.0,118.68476520930551,3
2020-11-13-171102,171102,0,0,0,136,3.6,125.95240538399167,4
2020-03-01-171103,171103,0,0,0,0,0.0,0.0,6
2020-03-02-171103,171103,0,0,0,0,0.0,2.6722104244504745,0
2020-03-03-171103,171103,0,0,0,0,0.0,6.40880942706443,1
2020-03-04-171103,171103,0,0,0,0,0.0,7.877969639717488,2
2020-03-05-171103,171103,0,0,0,0,0.0,8.123670859584278,3
2020-03-06-171103,171103,0,0,0,0,0.0,8.07304167630659,4
2020-03-07-171103,171103,0,0,0,0,0.0,6.30926440120004,5
2020-03-08-171103,171103,0,0,0,0,0.0,7.856126340312189,6
2020-03-09-171103,171103,0,0,0,0,0.5,8.165154783032404,0
2020-03-10-171103,171103,0,0,0,0,0.5,65.18991344768699,1
2020-03-11-171103,171103,0,0,0,0,0.0,49.02524670681036,2
2020-03-12-171103,171103,0,0,0,0,0.0,32.11046981211363,3
2020-03-13-171103,171103,0,0,0,0,0.0,17.80048078864636,4
2020-03-14-171103,171103,0,0,0,0,0.0,16.27276652461942,5
2020-03-15-171103,171103,0,0,0,0,0.0,14.624649803242551,6
2020-03-16-171103,171103,0,0,0,0,0.5,4.422798199368515,0
2020-03-17-171103,171103,0,0,0,0,2.5,6.590734969338456,1
2020-03-18-171103,171103,0,0,0,0,1.0,14.713026654206674,2
2020-03-19-171103,171103,0,0,1,0,1.0,18.26330047828923,3
2020-03-20-171103,171103,0,0,1,0,1.0,20.547073950859055,4
2020-03-21-171103,171103,0,1,0,0,0.5,22.57846603469581,5
2020-03-22-171103,171103,0,0,0,0,0.0,22.141233078353707,6
2020-03-23-171103,171103,0,0,0,0,1.0,20.24002180735544,0
2020-03-24-171103,171103,0,0,0,0,1.0,14.442341940326422,1
2020-03-25-171103,171103,0,0,0,0,2.0,13.705103452058138,2
2020-03-26-171103,171103,0,0,0,0,1.5,12.372717747076232,3
2020-03-27-171103,171103,0,0,0,0,1.0,15.331573653167663,4
2020-03-28-171103,171103,0,0,0,0,1.0,13.562660093647697,5
2020-03-29-171103,171103,0,0,0,0,0.0,15.304939263926613,6
2020-03-30-171103,171103,0,0,0,0,0.0,12.666782710193013,0
2020-03-31-171103,171103,0,0,0,0,1.0,9.79330802471166,1
2020-04-01-171103,171103,0,0,0,0,0.0,4.5516641780345015,2
2020-04-02-171103,171103,1,0,0,1,2.5,7.601144117897727,3
2020-04-03-171103,171103,1,0,0,2,0.5,14.516578474105934,4
2020-04-04-171103,171103,0,0,0,2,0.0,20.51734605458077,5
2020-04-05-171103,171103,0,0,0,2,0.0,19.903447431971788,6
2020-04-06-171103,171103,0,0,0,2,1.0,19.657338668411626,0
2020-04-07-171103,171103,0,0,0,2,1.5,21.48988846555612,1
2020-04-08-171103,171103,0,0,0,2,0.5,21.546345322423583,2
2020-04-09-171103,171103,0,1,0,2,0.5,17.450564295422545,3
2020-04-10-171103,171103,0,0,0,2,0.0,4.089232523426482,4
2020-04-11-171103,171103,0,0,0,2,0.0,4.037138837616881,5
2020-04-12-171103,171103,0,0,0,2,0.0,3.9256805006611915,6
2020-04-13-171103,171103,0,0,0,2,1.0,3.9410351714056118,0
2020-04-14-171103,171103,0,0,0,2,1.0,4.082585965506794,1
2020-04-15-171103,171103,0,0,0,2,0.5,6.586023657392836,2
2020-04-16-171103,171103,0,0,0,2,0.5,7.249824356777391,3
2020-04-17-171103,171103,0,0,0,2,0.5,6.308954837246028,4
2020-04-18-171103,171103,0,0,0,2,0.0,9.229656120383765,5
2020-04-19-171103,171103,0,0,0,2,0.0,9.808742688760132,6
2020-04-20-171103,171103,0,0,0,2,0.0,25.724548239133217,0
2020-04-21-171103,171103,0,0,0,2,0.0,24.030892942871624,1
2020-04-22-171103,171103,0,0,0,2,1.5,23.97227128877127,2
2020-04-23-171103,171103,0,0,0,2,1.0,26.99619419365185,3
2020-04-24-171103,171103,0,0,0,2,1.0,28.139540822685916,4
2020-04-25-171103,171103,0,0,0,2,0.5,32.87122919534083,5
2020-04-26-171103,171103,0,1,0,2,0.0,34.96330988322436,6
2020-04-27-171103,171103,0,0,0,2,0.0,16.217791568218253,0
2020-04-28-171103,171103,0,0,0,2,1.5,15.842841617826725,1
2020-04-29-171103,171103,0,0,0,2,2.5,20.303967702614766,2
2020-04-30-171103,171103,0,0,0,2,1.0,38.257024847257384,3
2020-05-01-171103,171103,0,0,0,2,0.5,20.774259795000983,4
2020-05-02-171103,171103,0,0,0,2,0.0,17.27064586741282,5
2020-05-03-171103,171103,0,0,0,2,0.0,8.74856201282195,6
2020-05-04-171103,171103,0,0,0,2,0.0,8.758461715091247,0
2020-05-05-171103,171103,0,0,0,2,0.0,4.873584958346287,1
2020-05-06-171103,171103,0,0,0,2,0.5,5.198995214081798,2
2020-05-07-171103,171103,0,0,0,2,0.5,8.352632667354742,3
2020-05-08-171103,171103,0,0,0,2,0.5,8.936013069844972,4
2020-05-09-171103,171103,0,0,0,2,0.0,9.74000618394096,5
2020-05-10-171103,171103,0,0,0,2,1.5,20.35191550304841,6
2020-05-11-171103,171103,0,0,0,2,0.0,21.68617075944499,0
2020-05-12-171103,171103,0,0,0,2,1.0,22.033941211876062,1
2020-05-13-171103,171103,0,0,0,2,0.0,22.20620920371845,2
2020-05-14-171103,171103,0,0,0,2,0.0,16.958220269107542,3
2020-05-15-171103,171103,0,0,0,2,2.0,14.672053446413884,4
2020-05-16-171103,171103,0,0,0,2,0.0,22.699662706498827,5
2020-05-17-171103,171103,0,0,0,2,0.0,20.258748544353253,6
2020-05-18-171103,171103,0,0,0,2,0.5,17.842891733668544,0
2020-05-19-171103,171103,0,0,0,2,1.0,21.500028384760885,1
2020-05-20-171103,171103,0,0,0,2,0.0,21.10962437024948,2
2020-05-21-171103,171103,0,0,0,2,0.0,21.144526333197987,3
2020-05-22-171103,171103,0,0,0,2,0.0,10.24794358185854,4
2020-05-23-171103,171103,0,0,0,2,0.0,10.856868805057825,5
2020-05-24-171103,171103,0,0,0,2,0.0,11.038872027262595,6
2020-05-25-171103,171103,0,0,0,2,1.0,6.9196366120039805,0
2020-05-26-171103,171103,0,0,0,2,0.5,4.03842475160242,1
2020-05-27-171103,171103,0,3,0,2,0.0,9.901354996065635,2
2020-05-28-171103,171103,0,1,0,2,0.0,9.877936012855624,3
2020-05-29-171103,171103,0,0,0,2,0.5,9.642300966346443,4
2020-05-30-171103,171103,0,0,0,2,0.0,12.337220724536111,5
2020-05-31-171103,171103,0,0,0,2,0.5,12.69202557975737,6
2020-06-01-171103,171103,0,0,0,2,0.0,13.794769174914665,0
2020-06-02-171103,171103,0,0,0,2,1.0,0.5854673504082624,1
2020-06-03-171103,171103,0,0,0,2,0.0,0.7181777231213191,2
2020-06-04-171103,171103,0,1,0,2,0.0,0.440378549691724,3
2020-06-05-171103,171103,0,0,0,2,0.0,0.7350477321617745,4
2020-06-06-171103,171103,0,0,0,2,0.0,0.7324743159859901,5
2020-06-07-171103,171103,0,0,0,2,0.0,0.7546922743089962,6
2020-06-08-171103,171103,0,0,0,2,0.0,0.7531518353990942,0
2020-06-09-171103,171103,0,0,0,2,0.0,1.037155545300422,1
2020-06-10-171103,171103,0,0,0,2,0.5,11.066182909663198,2
2020-06-11-171103,171103,0,0,0,2,0.0,10.584082534203663,3
2020-06-12-171103,171103,0,0,0,2,0.0,10.19267952027359,4
2020-06-13-171103,171103,0,0,0,2,0.0,5.685917912942364,5
2020-06-14-171103,171103,0,6,0,2,0.0,1.535230935571041,6
2020-06-15-171103,171103,0,0,0,2,0.0,0.9730928695255987,0
2020-06-16-171103,171103,0,0,0,2,0.5,1.0111428362876818,1
2020-06-17-171103,171103,0,0,0,2,0.0,0.9514846742177571,2
2020-06-18-171103,171103,0,0,0,2,0.0,0.8254272851557052,3
2020-06-19-171103,171103,0,0,0,2,0.0,0.641018697348172,4
2020-06-20-171103,171103,0,0,0,2,0.0,6.826988820677637,5
2020-06-21-171103,171103,0,0,0,2,0.0,7.01185725714805,6
2020-06-22-171103,171103,0,0,0,2,0.0,7.018057630461529,0
2020-06-23-171103,171103,0,0,0,2,0.0,7.2035565455454895,1
2020-06-24-171103,171103,0,0,0,2,0.0,7.862491023561012,2
2020-06-25-171103,171103,0,1,0,2,0.0,8.206304639328925,3
2020-06-26-171103,171103,0,0,0,2,0.0,8.165207824398264,4
2020-06-27-171103,171103,0,0,0,2,0.0,1.2478697447714977,5
2020-06-28-171103,171103,0,0,0,2,0.0,1.391432612849373,6
2020-06-29-171103,171103,0,0,0,2,0.0,1.5024235092195504,0
2020-06-30-171103,171103,0,0,0,2,0.0,1.2505744767507398,1
2020-07-01-171103,171103,0,0,0,2,0.0,2.738643320294374,2
2020-07-02-171103,171103,0,0,0,2,0.0,0.4818350710054102,3
2020-07-03-171103,171103,0,0,0,2,0.0,0.8150343434057059,4
2020-07-04-171103,171103,0,0,0,2,0.0,7.219905902232579,5
2020-07-05-171103,171103,0,0,0,2,0.0,7.35247060083603,6
2020-07-06-171103,171103,0,0,0,2,0.0,7.136681816901396,0
2020-07-07-171103,171103,0,0,0,2,0.0,7.379589199440271,1
2020-07-08-171103,171103,0,0,0,2,0.5,7.202306128001199,2
2020-07-09-171103,171103,0,0,0,2,0.0,11.287653198448918,3
2020-07-10-171103,171103,0,0,0,2,0.0,3.2371231398494373,4
2020-07-11-171103,171103,0,1,0,2,0.0,2.798779276031083,5
2020-07-12-171103,171103,0,0,0,2,0.0,2.389722763038317,6
2020-07-13-171103,171103,0,0,0,2,0.0,2.2498864093898483,0
2020-07-14-171103,171103,0,0,0,2,0.0,2.2875220835852925,1
2020-07-15-171103,171103,0,0,0,2,0.0,1.4616208401631274,2
2020-07-16-171103,171103,0,0,0,2,0.0,0.9303001614101333,3
2020-07-17-171103,171103,0,0,0,2,0.0,0.9397828833796231,4
2020-07-18-171103,171103,0,0,0,2,0.0,0.6250525693633722,5
2020-07-19-171103,171103,0,0,0,2,0.0,0.6388506360650441,6
2020-07-20-171103,171103,0,0,0,2,0.0,0.719144462215891,0
2020-07-21-171103,171103,0,0,0,2,0.0,0.843930771004055,1
2020-07-22-171103,171103,0,0,0,2,0.0,0.9295754067567545,2
2020-07-23-171103,171103,0,0,0,2,0.0,0.996820618251596,3
2020-07-24-171103,171103,0,0,0,2,0.0,1.0510814152225278,4
2020-07-25-171103,171103,0,0,0,2,0.0,1.1510833916689391,5
2020-07-26-171103,171103,0,0,5,2,0.0,1.1378101580565283,6
2020-07-27-171103,171103,0,0,0,2,0.0,0.95392658107221,0
2020-07-28-171103,171103,0,0,0,2,0.0,1.009410559197647,1
2020-07-29-171103,171103,0,0,0,2,0.0,1.0766356192094209,2
2020-07-30-171103,171103,0,0,0,2,0.0,1.173341326420291,3
2020-07-31-171103,171103,0,0,0,2,1.0,3.2298003421551726,4
2020-08-01-171103,171103,0,0,0,2,0.0,12.28401841485788,5
2020-08-02-171103,171103,0,0,0,2,0.5,54.66920802100589,6
2020-08-03-171103,171103,0,0,0,2,0.0,62.15984590168635,0
2020-08-04-171103,171103,0,0,0,2,0.0,44.830301061576336,1
2020-08-05-171103,171103,0,0,0,2,0.5,37.49877800005292,2
2020-08-06-171103,171103,0,0,1,2,0.0,36.68297174912344,3
2020-08-07-171103,171103,0,0,0,2,0.0,28.202282941446718,4
2020-08-08-171103,171103,0,0,0,2,0.5,59.879619303551024,5
2020-08-09-171103,171103,5,0,0,7,0.0,65.83726368763922,6
2020-08-10-171103,171103,0,0,0,7,0.0,13.521556380515166,0
2020-08-11-171103,171103,0,0,0,7,0.0,14.392421542609004,1
2020-08-12-171103,171103,0,0,0,7,0.5,48.99232506095408,2
2020-08-13-171103,171103,0,0,0,7,0.0,55.580565564746266,3
2020-08-14-171103,171103,0,0,0,7,0.5,57.57728654529921,4
2020-08-15-171103,171103,0,0,0,7,0.0,58.861876315013255,5
2020-08-16-171103,171103,0,0,0,7,0.5,60.46133713375756,6
2020-08-17-171103,171103,0,0,0,7,0.0,64.97670053214911,0
2020-08-18-171103,171103,0,0,0,7,0.0,63.466244879913276,1
2020-08-19-171103,171103,0,0,0,7,0.0,31.11791025058028,2
2020-08-20-171103,171103,1,0,2,8,0.0,65.35744452765252,3
2020-08-21-171103,171103,0,0,2,8,0.0,100.22894328554116,4
2020-08-22-171103,171103,0,0,0,8,0.5,257.7954252636608,5
2020-08-23-171103,171103,0,0,1,8,0.0,263.9321362146389,6
2020-08-24-171103,171103,0,0,1,8,0.0,261.6587976676519,0
2020-08-25-171103,171103,0,0,1,8,0.0,296.7227558916985,1
2020-08-26-171103,171103,0,0,0,8,0.5,269.4161183757426,2
2020-08-27-171103,171103,0,0,0,8,0.5,268.31404360394725,3
2020-08-28-171103,171103,0,0,0,8,0.5,230.02140709117384,4
2020-08-29-171103,171103,0,0,1,8,0.0,80.6360877318181,5
2020-08-30-171103,171103,0,0,0,8,0.5,59.695212617266876,6
2020-08-31-171103,171103,0,0,0,8,0.0,33.04703873447309,0
2020-09-01-171103,171103,0,0,0,8,0.5,186.66617298565205,1
2020-09-02-171103,171103,0,0,4,8,0.5,390.1860752815037,2
2020-09-03-171103,171103,2,0,0,10,26.0,109.34795590542146,3
2020-09-04-171103,171103,2,0,1,12,6.0,355.49226104237613,4
2020-09-05-171103,171103,0,0,0,12,1.5,409.7811674074209,5
2020-09-06-171103,171103,1,0,0,13,7.0,404.96002863951287,6
2020-09-07-171103,171103,1,0,0,14,4.0,462.0437555679181,0
2020-09-08-171103,171103,1,0,0,15,5.0,508.3875508559508,1
2020-09-09-171103,171103,0,0,0,15,1.5,547.9036648893651,2
2020-09-10-171103,171103,0,0,0,15,7.5,125.1314145490791,3
2020-09-11-171103,171103,0,0,1,15,2.0,148.1719400385104,4
2020-09-12-171103,171103,1,0,0,16,1.0,173.96073380480146,5
2020-09-13-171103,171103,0,0,0,16,0.0,190.94211533457633,6
2020-09-14-171103,171103,0,0,0,16,0.5,172.34194630202435,0
2020-09-15-171103,171103,0,0,0,16,2.5,171.20829216601908,1
2020-09-16-171103,171103,4,0,0,20,0.0,106.4943105379004,2
2020-09-17-171103,171103,0,0,0,20,18.0,171.7188345136554,3
2020-09-18-171103,171103,1,0,0,21,4.0,255.72181412632844,4
2020-09-19-171103,171103,0,0,0,21,0.0,274.21782996320417,5
2020-09-20-171103,171103,0,0,0,21,0.5,247.4851787083043,6
2020-09-21-171103,171103,0,0,0,21,6.5,240.17825700510184,0
2020-09-22-171103,171103,0,0,0,21,0.5,260.13794369923335,1
2020-09-23-171103,171103,0,0,0,21,1.5,210.3516071504979,2
2020-09-24-171103,171103,0,0,0,21,2.0,118.78820873060158,3
2020-09-25-171103,171103,1,0,0,22,1.0,101.39880973560544,4
2020-09-26-171103,171103,0,0,0,22,0.0,119.85282605642752,5
2020-09-27-171103,171103,0,0,0,22,0.0,118.71048341216519,6
2020-09-28-171103,171103,0,0,0,22,0.0,116.6581138551705,0
2020-09-29-171103,171103,0,0,0,22,0.5,83.1035404847495,1
2020-09-30-171103,171103,0,0,0,22,1.0,252.50353684245007,2
2020-10-01-171103,171103,0,0,0,22,0.5,0.0,3
2020-10-02-171103,171103,0,0,0,22,1.0,70.17050836823451,4
2020-10-03-171103,171103,0,0,0,22,0.5,216.32179010997848,5
2020-10-04-171103,171103,0,0,0,22,0.0,214.0265132888895,6
2020-10-05-171103,171103,0,0,0,22,0.5,202.25578371052546,0
2020-10-06-171103,171103,0,0,0,22,1.5,110.68978959998095,1
2020-10-07-171103,171103,0,0,0,22,0.0,86.45239416416835,2
2020-10-08-171103,171103,0,0,0,22,0.0,83.65949864770872,3
2020-10-09-171103,171103,0,0,3,22,2.0,87.77760802160809,4
2020-10-10-171103,171103,0,0,0,22,0.0,1.9317534885826506,5
2020-10-11-171103,171103,0,0,0,22,0.0,3.06057983617847,6
2020-10-12-171103,171103,0,0,0,22,0.5,4.5297389708930345,0
2020-10-13-171103,171103,0,0,5,22,1.0,10.998084024909819,1
2020-10-14-171103,171103,0,0,0,22,1.0,15.676905389427382,2
2020-10-15-171103,171103,0,0,0,22,0.5,26.775467180343412,3
2020-10-16-171103,171103,0,0,0,22,1.5,36.69574187996748,4
2020-10-17-171103,171103,0,0,0,22,0.5,44.17464019393782,5
2020-10-18-171103,171103,0,0,0,22,0.5,46.939009493137554,6
2020-10-19-171103,171103,0,0,0,22,3.5,49.80240534044529,0
2020-10-20-171103,171103,0,0,0,22,2.5,74.587734676903,1
2020-10-21-171103,171103,0,0,0,22,3.5,75.94797940226044,2
2020-10-22-171103,171103,0,0,0,22,0.5,92.29298857578401,3
2020-10-23-171103,171103,3,0,0,25,4.5,92.72700168157537,4
2020-10-24-171103,171103,0,0,0,25,1.0,126.75621406351048,5
2020-10-25-171103,171103,0,1,0,25,1.0,124.0093496348508,6
2020-10-26-171103,171103,0,0,0,25,0.0,106.03967675172278,0
2020-10-27-171103,171103,5,0,0,30,1.0,109.5691037661058,1
2020-10-28-171103,171103,0,0,0,30,5.5,199.69856514383906,2
2020-10-29-171103,171103,0,0,0,30,0.5,215.63701633819494,3
2020-10-30-171103,171103,0,0,0,30,5.5,177.10480976844872,4
2020-10-31-171103,171103,0,0,0,30,0.5,220.70111345119167,5
2020-11-01-171103,171103,0,0,0,30,2.0,59.20130650840615,6
2020-11-02-171103,171103,0,0,0,30,1.5,110.2819142053277,0
2020-11-03-171103,171103,0,0,0,30,0.0,93.0866145133148,1
2020-11-04-171103,171103,0,0,0,30,3.5,98.81938204252583,2
2020-11-05-171103,171103,0,0,0,30,3.0,124.1190046500734,3
2020-11-06-171103,171103,0,0,0,30,1.5,134.54660710891366,4
2020-11-07-171103,171103,0,0,0,30,0.0,141.54248703867174,5
2020-11-08-171103,171103,0,0,0,30,0.0,85.57869827791541,6
2020-11-09-171103,171103,0,0,0,30,0.5,71.43284578304376,0
2020-11-10-171103,171103,0,0,0,30,1.5,58.82333578021087,1
2020-11-11-171103,171103,0,0,0,30,1.0,70.13794682681494,2
2020-11-12-171103,171103,0,0,0,30,0.0,74.71372450874847,3
2020-11-13-171103,171103,0,0,0,30,3.5,64.38869241186842,4
2020-03-01-171104,171104,0,0,1,0,0.0,0.0,6
2020-03-02-171104,171104,0,0,1,0,0.0,27.942665607443438,0
2020-03-03-171104,171104,0,0,2,0,0.0,106.98415423298617,1
2020-03-04-171104,171104,0,0,8,0,0.0,114.12577582217861,2
2020-03-05-171104,171104,0,0,3,0,0.0,126.75894836528958,3
2020-03-06-171104,171104,0,0,6,0,0.0,104.25174817697874,4
2020-03-07-171104,171104,0,0,0,0,0.0,115.01762571705689,5
2020-03-08-171104,171104,0,0,4,0,0.0,108.40631829555653,6
2020-03-09-171104,171104,0,0,3,0,0.2,108.10279769358561,0
2020-03-10-171104,171104,0,0,6,0,0.0,839.0761127481022,1
2020-03-11-171104,171104,0,0,7,0,0.0,643.6131209087066,2
2020-03-12-171104,171104,0,0,3,0,0.2,419.57904934290707,3
2020-03-13-171104,171104,0,0,11,0,0.0,255.31937708596757,4
2020-03-14-171104,171104,0,0,1,0,0.0,176.387373267894,5
2020-03-15-171104,171104,1,0,3,1,0.4,150.25281530996298,6
2020-03-16-171104,171104,1,0,5,2,2.2,11.16344655161274,0
2020-03-17-171104,171104,2,1,4,4,5.4,28.841201474338334,1
2020-03-18-171104,171104,8,0,5,12,6.4,76.86241038830262,2
2020-03-19-171104,171104,3,1,7,15,5.0,132.32316263876987,3
2020-03-20-171104,171104,6,0,1,21,4.8,167.47957320332645,4
2020-03-21-171104,171104,0,0,1,21,2.4,200.9927983374131,5
2020-03-22-171104,171104,4,0,0,25,1.2,198.55835695779336,6
2020-03-23-171104,171104,3,0,8,28,9.8,194.65530653109747,0
2020-03-24-171104,171104,6,0,5,34,7.4,219.18971956760979,1
2020-03-25-171104,171104,7,0,3,41,4.2,205.72532129118437,2
2020-03-26-171104,171104,3,0,20,44,3.4,193.8645724565132,3
2020-03-27-171104,171104,11,0,18,55,3.6,221.06123068723085,4
2020-03-28-171104,171104,1,0,2,56,0.8,219.12107022139205,5
2020-03-29-171104,171104,3,0,0,59,1.6,216.21625920441736,6
2020-03-30-171104,171104,5,0,3,64,2.2,158.91360667494345,0
2020-03-31-171104,171104,4,0,5,68,3.0,140.47971699744602,1
2020-04-01-171104,171104,5,0,0,73,2.4,35.867490572547155,2
2020-04-02-171104,171104,7,0,5,80,3.2,91.95431864343777,3
2020-04-03-171104,171104,1,0,5,81,2.0,102.35707270195554,4
2020-04-04-171104,171104,1,0,3,82,0.8,115.69843388310541,5
2020-04-05-171104,171104,0,0,1,82,0.6,125.21283265463508,6
2020-04-06-171104,171104,8,0,0,90,4.0,126.6579553546565,0
2020-04-07-171104,171104,5,0,6,95,2.0,132.77834232356597,1
2020-04-08-171104,171104,3,0,4,98,1.8,130.89440995268106,2
2020-04-09-171104,171104,20,0,2,118,0.8,124.53235741770796,3
2020-04-10-171104,171104,18,0,6,136,2.8,27.54596253103562,4
2020-04-11-171104,171104,2,0,0,138,0.8,70.23757750789034,5
2020-04-12-171104,171104,0,0,0,138,5.0,77.29898395916405,6
2020-04-13-171104,171104,3,0,6,141,1.6,80.3373867090486,0
2020-04-14-171104,171104,5,0,7,146,3.0,95.23734002933224,1
2020-04-15-171104,171104,0,0,3,146,0.4,116.04569955250595,2
2020-04-16-171104,171104,5,0,7,151,1.2,120.48009326535262,3
2020-04-17-171104,171104,5,0,1,156,0.4,123.8146947687365,4
2020-04-18-171104,171104,3,0,0,159,0.0,98.23655418666024,5
2020-04-19-171104,171104,1,0,1,160,0.0,97.99506923359,6
2020-04-20-171104,171104,0,0,4,160,0.6,119.08731687166915,0
2020-04-21-171104,171104,6,0,5,166,2.2,98.2945584854603,1
2020-04-22-171104,171104,4,0,5,170,0.4,125.36136264463266,2
2020-04-23-171104,171104,2,0,26,172,0.0,115.34371227927872,3
2020-04-24-171104,171104,6,0,4,178,7.4,98.69284660171046,4
2020-04-25-171104,171104,0,0,1,178,0.6,119.12950008883283,5
2020-04-26-171104,171104,0,0,1,178,0.4,119.4546345852958,6
2020-04-27-171104,171104,6,0,4,184,1.4,85.44602964427884,0
2020-04-28-171104,171104,7,0,2,191,1.8,107.91981319554084,1
2020-04-29-171104,171104,3,0,13,194,1.0,104.6680076711905,2
2020-04-30-171104,171104,7,0,1,201,1.0,130.9802372221405,3
2020-05-01-171104,171104,1,0,4,202,0.0,166.43405725699873,4
2020-05-02-171104,171104,0,0,0,202,0.4,112.75586152137454,5
2020-05-03-171104,171104,1,0,0,203,0.0,39.75481113142315,6
2020-05-04-171104,171104,4,0,4,207,1.4,42.38171637131093,0
2020-05-05-171104,171104,5,0,2,212,1.8,47.75694630539489,1
2020-05-06-171104,171104,5,0,4,217,1.4,60.17543221638108,2
2020-05-07-171104,171104,26,0,3,243,1.2,66.13229450153577,3
2020-05-08-171104,171104,4,0,6,247,0.6,141.45343048314717,4
2020-05-09-171104,171104,1,0,0,248,0.2,171.74636390978773,5
2020-05-10-171104,171104,1,0,0,249,0.2,161.38364764987296,6
2020-05-11-171104,171104,4,1,0,253,0.6,152.3969471397982,0
2020-05-12-171104,171104,2,0,4,255,1.6,161.47865540515102,1
2020-05-13-171104,171104,13,0,1,268,1.4,147.20494818335902,2
2020-05-14-171104,171104,1,1,3,269,2.4,158.4693699708669,3
2020-05-15-171104,171104,4,2,2,273,0.8,172.0467637077923,4
2020-05-16-171104,171104,0,0,0,273,0.4,128.66476046177434,5
2020-05-17-171104,171104,0,1,0,273,0.0,129.7635628666792,6
2020-05-18-171104,171104,4,0,4,277,1.4,124.25563603617708,0
2020-05-19-171104,171104,2,0,1,279,1.6,134.75789025882014,1
2020-05-20-171104,171104,4,0,0,283,0.8,101.8470707493399,2
2020-05-21-171104,171104,3,0,6,286,1.0,96.63788312087925,3
2020-05-22-171104,171104,6,0,3,292,0.6,101.01203591549502,4
2020-05-23-171104,171104,0,0,0,292,0.0,116.98956967626482,5
2020-05-24-171104,171104,0,0,0,292,0.0,117.95905841618679,6
2020-05-25-171104,171104,0,0,3,292,0.6,93.676651425562,0
2020-05-26-171104,171104,4,0,0,296,0.0,74.2777884689909,1
2020-05-27-171104,171104,1,0,0,297,0.4,83.13659087321972,2
2020-05-28-171104,171104,3,1,3,300,1.2,61.9328440727963,3
2020-05-29-171104,171104,2,0,1,302,0.8,66.4262998717239,4
2020-05-30-171104,171104,0,0,0,302,0.0,59.44870686332378,5
2020-05-31-171104,171104,0,0,0,302,0.0,61.145334300761405,6
2020-06-01-171104,171104,4,0,2,306,0.6,215.02892499652148,0
2020-06-02-171104,171104,1,0,0,307,1.6,31.329252361419478,1
2020-06-03-171104,171104,0,0,1,307,1.2,49.10140126963642,2
2020-06-04-171104,171104,6,0,1,313,2.0,40.84425919017065,3
2020-06-05-171104,171104,3,1,0,316,0.4,72.85027330072174,4
2020-06-06-171104,171104,0,2,0,316,0.2,71.18800467989983,5
2020-06-07-171104,171104,0,0,0,316,0.0,71.31884533712274,6
2020-06-08-171104,171104,3,0,0,319,0.4,71.71526672679992,0
2020-06-09-171104,171104,0,0,2,319,0.4,84.19469116356902,1
2020-06-10-171104,171104,0,0,2,319,1.0,231.60349521088764,2
2020-06-11-171104,171104,3,0,0,322,0.2,213.1404630715074,3
2020-06-12-171104,171104,1,0,1,323,1.0,204.46059301026855,4
2020-06-13-171104,171104,0,1,0,323,0.0,184.73366904358463,5
2020-06-14-171104,171104,0,2,0,323,0.0,82.67429828052298,6
2020-06-15-171104,171104,2,0,1,325,0.8,53.094780153180764,0
2020-06-16-171104,171104,0,0,0,325,0.2,54.448223532887326,1
2020-06-17-171104,171104,1,0,0,326,0.4,45.111165745968655,2
2020-06-18-171104,171104,1,0,0,327,0.4,48.42283665438776,3
2020-06-19-171104,171104,0,0,0,327,0.0,45.113720400077476,4
2020-06-20-171104,171104,0,0,0,327,0.0,56.98291284001854,5
2020-06-21-171104,171104,0,0,0,327,0.0,57.11904178983377,6
2020-06-22-171104,171104,0,0,1,327,0.6,49.19268542510307,0
2020-06-23-171104,171104,2,0,0,329,0.6,49.984413349485365,1
2020-06-24-171104,171104,2,0,1,331,0.8,56.84331172055384,2
2020-06-25-171104,171104,0,2,0,331,0.8,62.25394107551565,3
2020-06-26-171104,171104,1,1,2,332,0.8,64.28587016840552,4
2020-06-27-171104,171104,0,0,0,332,0.2,53.27972793147961,5
2020-06-28-171104,171104,0,0,0,332,0.0,58.95583216926119,6
2020-06-29-171104,171104,1,0,0,333,0.6,59.226856786335205,0
2020-06-30-171104,171104,0,0,0,333,0.4,59.48079922109301,1
2020-07-01-171104,171104,0,0,0,333,0.2,95.2218754270063,2
2020-07-02-171104,171104,0,0,0,333,0.8,8.103676136142372,3
2020-07-03-171104,171104,0,0,1,333,0.4,19.141986491671794,4
2020-07-04-171104,171104,0,0,0,333,0.0,30.502520108376032,5
2020-07-05-171104,171104,0,0,0,333,0.0,30.602036782930124,6
2020-07-06-171104,171104,1,0,0,334,0.0,29.728920528247496,0
2020-07-07-171104,171104,0,0,0,334,0.0,29.169189279382433,1
2020-07-08-171104,171104,1,0,0,335,0.6,21.090194336586293,2
2020-07-09-171104,171104,0,0,0,335,0.6,21.480894750294194,3
2020-07-10-171104,171104,2,0,0,337,0.6,92.40395020965778,4
2020-07-11-171104,171104,0,0,0,337,0.2,72.87293929713479,5
2020-07-12-171104,171104,0,0,0,337,0.0,59.34297555926767,6
2020-07-13-171104,171104,0,0,0,337,0.2,54.251139570967084,0
2020-07-14-171104,171104,0,0,0,337,0.0,54.84065709386784,1
2020-07-15-171104,171104,0,0,1,337,0.4,36.115669036804015,2
2020-07-16-171104,171104,0,0,1,337,0.0,24.190510290920248,3
2020-07-17-171104,171104,1,0,4,338,0.0,23.816560969503534,4
2020-07-18-171104,171104,0,0,0,338,0.2,7.271654488710123,5
2020-07-19-171104,171104,0,0,0,338,0.2,7.747385753252228,6
2020-07-20-171104,171104,0,0,3,338,0.4,14.227969899194726,0
2020-07-21-171104,171104,0,0,0,338,0.0,23.982058667965013,1
2020-07-22-171104,171104,0,0,1,338,0.0,23.43657294234734,2
2020-07-23-171104,171104,0,0,0,338,0.2,23.28392328294703,3
2020-07-24-171104,171104,0,0,0,338,0.2,22.631289531643553,4
2020-07-25-171104,171104,0,0,0,338,0.0,22.984355033451376,5
2020-07-26-171104,171104,0,0,0,338,0.0,22.0113414380689,6
2020-07-27-171104,171104,0,0,0,338,0.2,15.773888006956176,0
2020-07-28-171104,171104,0,0,1,338,0.2,6.5391252393423915,1
2020-07-29-171104,171104,1,0,2,339,0.4,11.391992476468495,2
2020-07-30-171104,171104,1,0,0,340,0.0,22.568098045742254,3
2020-07-31-171104,171104,4,0,0,344,0.0,26.686492786422708,4
2020-08-01-171104,171104,0,0,4,344,0.2,23.113075571999946,5
2020-08-02-171104,171104,0,0,1,344,0.2,204.8648107760315,6
2020-08-03-171104,171104,3,0,3,347,0.0,216.79769344030018,0
2020-08-04-171104,171104,0,0,4,347,0.0,203.94557540368862,1
2020-08-05-171104,171104,1,0,5,348,0.4,156.54566664270413,2
2020-08-06-171104,171104,0,0,2,348,2.0,134.6394574277602,3
2020-08-07-171104,171104,0,0,3,348,0.4,113.17517352069099,4
2020-08-08-171104,171104,0,0,1,348,0.0,86.80186989712102,5
2020-08-09-171104,171104,0,0,0,348,0.2,88.79484203782708,6
2020-08-10-171104,171104,0,0,0,348,0.4,19.524979204591027,0
2020-08-11-171104,171104,1,0,1,349,0.2,27.135501905539037,1
2020-08-12-171104,171104,2,0,6,351,0.8,47.88411421147375,2
2020-08-13-171104,171104,0,1,1,351,0.2,54.71117720866468,3
2020-08-14-171104,171104,0,0,2,351,0.6,67.61730555285209,4
2020-08-15-171104,171104,4,0,0,355,2.4,81.88440315688324,5
2020-08-16-171104,171104,1,0,0,356,0.2,114.48466569219158,6
2020-08-17-171104,171104,3,0,4,359,0.6,124.00116455797732,0
2020-08-18-171104,171104,4,0,1,363,0.8,144.9180884055017,1
2020-08-19-171104,171104,5,0,8,368,1.6,161.34205137232334,2
2020-08-20-171104,171104,2,1,4,370,1.8,187.6296314597875,3
2020-08-21-171104,171104,3,0,7,373,1.8,222.79132286051197,4
2020-08-22-171104,171104,1,0,2,374,0.2,239.75448238320305,5
2020-08-23-171104,171104,0,0,0,374,0.6,252.1919128462932,6
2020-08-24-171104,171104,0,0,0,374,0.8,241.28817322619972,0
2020-08-25-171104,171104,1,0,3,375,2.0,232.60971561670968,1
2020-08-26-171104,171104,6,0,1,381,1.0,204.9787013067652,2
2020-08-27-171104,171104,1,0,2,382,1.6,251.23419392483902,3
2020-08-28-171104,171104,2,0,0,384,1.6,225.88657405985498,4
2020-08-29-171104,171104,0,0,0,384,1.2,198.91522700801573,5
2020-08-30-171104,171104,0,0,2,384,4.2,201.0739347160232,6
2020-08-31-171104,171104,4,0,1,388,1.0,187.20626584293422,0
2020-09-01-171104,171104,1,0,0,389,1.2,82.06667037236818,1
2020-09-02-171104,171104,8,0,1,397,1.4,379.46924318956997,2
2020-09-03-171104,171104,4,0,4,401,1.0,270.87455524373706,3
2020-09-04-171104,171104,7,0,5,408,1.4,217.49413768561402,4
2020-09-05-171104,171104,2,0,4,410,0.4,217.27080102632473,5
2020-09-06-171104,171104,0,0,1,410,0.2,201.58317325421427,6
2020-09-07-171104,171104,0,0,4,410,0.0,192.84535969310312,0
2020-09-08-171104,171104,3,0,2,413,3.8,194.86042771735487,1
2020-09-09-171104,171104,1,0,2,414,2.6,234.93573661220285,2
2020-09-10-171104,171104,2,0,2,416,2.0,61.87167775205876,3
2020-09-11-171104,171104,0,0,2,416,2.0,98.63606299155525,4
2020-09-12-171104,171104,0,1,1,416,0.6,123.44708715101805,5
2020-09-13-171104,171104,2,0,0,418,0.6,124.9347420651405,6
2020-09-14-171104,171104,1,0,0,419,1.2,134.0756252569662,0
2020-09-15-171104,171104,0,0,1,419,4.0,142.34152848799823,1
2020-09-16-171104,171104,1,0,0,420,1.6,163.24875556130317,2
2020-09-17-171104,171104,4,0,2,424,3.8,188.33608332200038,3
2020-09-18-171104,171104,5,0,4,429,2.8,307.97895416259223,4
2020-09-19-171104,171104,4,1,0,433,2.0,326.10585817690526,5
2020-09-20-171104,171104,1,0,0,434,1.8,405.9184504277475,6
2020-09-21-171104,171104,4,0,1,438,0.8,415.6917726348212,0
2020-09-22-171104,171104,2,1,2,440,4.4,413.143139458355,1
2020-09-23-171104,171104,2,0,7,442,2.8,454.03370578076596,2
2020-09-24-171104,171104,2,1,2,444,2.4,369.7173533564362,3
2020-09-25-171104,171104,2,0,26,446,1.8,376.0282412263156,4
2020-09-26-171104,171104,1,0,0,447,1.2,370.83617677340277,5
2020-09-27-171104,171104,0,0,0,447,0.4,343.3406967451128,6
2020-09-28-171104,171104,0,0,2,447,1.4,328.5531424555546,0
2020-09-29-171104,171104,1,0,5,448,2.2,310.58333614776313,1
2020-09-30-171104,171104,0,0,12,448,1.6,233.466856575833,2
2020-10-01-171104,171104,2,0,8,450,2.2,0.0,3
2020-10-02-171104,171104,4,0,19,454,1.4,476.29658546944194,4
2020-10-03-171104,171104,0,0,0,454,1.4,937.7195623443405,5
2020-10-04-171104,171104,0,0,1,454,0.2,877.9890360815044,6
2020-10-05-171104,171104,1,2,3,455,0.6,750.5065193516621,0
2020-10-06-171104,171104,2,0,9,457,1.8,668.3144887037369,1
2020-10-07-171104,171104,7,1,7,464,1.4,501.65387584202597,2
2020-10-08-171104,171104,2,0,3,466,1.2,423.79476650584957,3
2020-10-09-171104,171104,26,1,30,492,2.0,454.6476964116272,4
2020-10-10-171104,171104,0,0,0,492,1.6,45.54362944627471,5
2020-10-11-171104,171104,0,0,2,492,0.8,75.62872174904545,6
2020-10-12-171104,171104,2,0,8,494,1.4,85.41648080366349,0
2020-10-13-171104,171104,5,0,4,499,1.8,105.41952403225656,1
2020-10-14-171104,171104,12,0,25,511,1.4,143.9831537991112,2
2020-10-15-171104,171104,8,0,14,519,3.4,216.27045481589994,3
2020-10-16-171104,171104,19,0,16,538,2.2,338.6618839969388,4
2020-10-17-171104,171104,0,0,2,538,1.2,404.5566075767643,5
2020-10-18-171104,171104,1,0,1,539,1.0,407.2652488198357,6
2020-10-19-171104,171104,3,0,1,542,1.8,426.88462939575567,0
2020-10-20-171104,171104,9,0,15,551,1.8,474.25500657338864,1
2020-10-21-171104,171104,7,0,15,558,4.0,507.0218259378139,2
2020-10-22-171104,171104,3,0,18,561,2.6,522.6585883493947,3
2020-10-23-171104,171104,30,0,12,591,5.2,465.6868875068818,4
2020-10-24-171104,171104,0,0,3,591,2.6,633.5876679627423,5
2020-10-25-171104,171104,2,0,1,593,4.6,635.5466551869813,6
2020-10-26-171104,171104,8,1,13,601,3.8,677.7587728841822,0
2020-10-27-171104,171104,4,1,4,605,3.4,758.071224807612,1
2020-10-28-171104,171104,25,1,36,630,5.6,735.6056108617483,2
2020-10-29-171104,171104,14,1,17,644,4.6,782.3009330526371,3
2020-10-30-171104,171104,16,1,12,660,13.4,694.0412112115299,4
2020-10-31-171104,171104,2,0,0,662,2.6,898.1235663076329,5
2020-11-01-171104,171104,1,1,0,663,7.2,272.7077357153196,6
2020-11-02-171104,171104,1,0,0,664,1.6,498.85093067983803,0
2020-11-03-171104,171104,15,0,0,679,4.2,403.44756541717766,1
2020-11-04-171104,171104,15,2,0,694,5.2,503.17104295065235,2
2020-11-05-171104,171104,18,0,0,712,11.6,649.1730043297864,3
2020-11-06-171104,171104,12,0,0,724,9.2,743.6236487801643,4
2020-11-07-171104,171104,3,0,0,727,4.2,788.9293474614025,5
2020-11-08-171104,171104,1,0,0,728,1.6,796.8234753786685,6
2020-11-09-171104,171104,13,0,0,741,4.6,780.3042753186601,0
2020-11-10-171104,171104,4,0,0,745,4.8,333.73804599652914,1
2020-11-11-171104,171104,36,5,0,781,5.8,408.08897735994304,2
2020-11-12-171104,171104,17,1,0,798,9.0,600.294342752122,3
2020-11-13-171104,171104,12,5,0,810,9.2,720.9361130181285,4
2020-03-01-171105,171105,0,0,0,0,0.0,0.0,6
2020-03-02-171105,171105,0,1,1,0,0.0,46.28126791587795,0
2020-03-03-171105,171105,0,2,8,0,0.0,174.86409042147847,1
2020-03-04-171105,171105,0,1,6,0,0.16666666666666666,189.16132386295607,2
2020-03-05-171105,171105,0,0,8,0,0.0,209.4197865795274,3
2020-03-06-171105,171105,0,0,7,0,0.0,171.88334583920837,4
2020-03-07-171105,171105,0,0,2,0,0.0,189.80704596390777,5
2020-03-08-171105,171105,0,0,1,0,0.0,177.956332449343,6
2020-03-09-171105,171105,0,0,13,0,0.0,177.16578967560605,0
2020-03-10-171105,171105,0,0,4,0,0.0,1430.1546627643706,1
2020-03-11-171105,171105,0,1,1,0,0.0,1088.8266588950999,2
2020-03-12-171105,171105,0,0,5,0,0.0,708.9437297182042,3
2020-03-13-171105,171105,0,0,3,0,0.0,431.9479950173496,4
2020-03-14-171105,171105,0,0,1,0,0.0,298.1638141974371,5
2020-03-15-171105,171105,0,0,2,0,0.16666666666666666,253.66779508935971,6
2020-03-16-171105,171105,1,0,0,1,0.6666666666666666,17.573500927484243,0
2020-03-17-171105,171105,8,0,6,9,0.3333333333333333,45.16083628703501,1
2020-03-18-171105,171105,6,0,2,15,2.5,124.26510197337069,2
2020-03-19-171105,171105,8,0,6,23,1.5,215.21033153579612,3
2020-03-20-171105,171105,7,0,5,30,2.1666666666666665,274.0007748608844,4
2020-03-21-171105,171105,2,0,3,32,0.6666666666666666,329.70384265261015,5
2020-03-22-171105,171105,1,0,1,33,0.8333333333333334,325.0559799974554,6
2020-03-23-171105,171105,13,0,1,46,1.5,318.8241871230476,0
2020-03-24-171105,171105,4,0,2,50,1.6666666666666667,359.2328021275723,1
2020-03-25-171105,171105,1,0,0,51,1.6666666666666667,333.58960043303534,2
2020-03-26-171105,171105,5,0,1,56,1.0,311.624649487759,3
2020-03-27-171105,171105,3,0,2,59,3.1666666666666665,357.18519375913866,4
2020-03-28-171105,171105,1,0,0,60,0.3333333333333333,353.38550158789593,5
2020-03-29-171105,171105,2,0,0,62,0.5,349.3759489698717,6
2020-03-30-171105,171105,0,0,2,62,1.5,254.72196151504244,0
2020-03-31-171105,171105,6,0,2,68,1.5,226.4020609908682,1
2020-04-01-171105,171105,2,0,1,70,1.8333333333333333,60.554725838925904,2
2020-04-02-171105,171105,6,0,2,76,1.5,153.45100648390158,3
2020-04-03-171105,171105,5,0,0,81,0.8333333333333334,169.7914508575917,4
2020-04-04-171105,171105,3,0,0,84,0.16666666666666666,195.14831252633553,5
2020-04-05-171105,171105,1,0,0,85,0.16666666666666666,212.6716256127175,6
2020-04-06-171105,171105,1,0,0,86,2.0,215.90050527041134,0
2020-04-07-171105,171105,2,0,4,88,1.0,225.80663260436904,1
2020-04-08-171105,171105,0,0,1,88,0.8333333333333334,221.9221917806843,2
2020-04-09-171105,171105,1,0,0,89,3.6666666666666665,210.7846305688031,3
2020-04-10-171105,171105,2,0,2,91,3.333333333333333,45.21876524927669,4
2020-04-11-171105,171105,0,0,0,91,0.6666666666666666,117.02960502851647,5
2020-04-12-171105,171105,0,0,1,91,0.0,129.1270208359068,6
2020-04-13-171105,171105,2,0,3,93,0.6666666666666666,132.50959521790708,0
2020-04-14-171105,171105,2,0,4,95,1.3333333333333333,157.71248085285148,1
2020-04-15-171105,171105,1,0,2,96,0.16666666666666666,191.92600394491967,2
2020-04-16-171105,171105,2,0,3,98,1.1666666666666667,199.1750987714234,3
2020-04-17-171105,171105,0,0,0,98,1.5,206.21509018642007,4
2020-04-18-171105,171105,0,0,1,98,0.6666666666666666,164.08449531303194,5
2020-04-19-171105,171105,0,0,0,98,0.3333333333333333,163.5295912563162,6
2020-04-20-171105,171105,0,0,1,98,0.3333333333333333,201.98109158173853,0
2020-04-21-171105,171105,4,0,0,102,1.1666666666666667,167.15514626175815,1
2020-04-22-171105,171105,1,0,2,103,0.8333333333333334,213.59844871164435,2
2020-04-23-171105,171105,0,0,4,103,0.5,195.1250006874245,3
2020-04-24-171105,171105,2,0,2,105,1.1666666666666667,167.39455886276914,4
2020-04-25-171105,171105,0,0,1,105,0.3333333333333333,197.7497095755537,5
2020-04-26-171105,171105,1,0,1,106,0.0,197.2243503401719,6
2020-04-27-171105,171105,3,1,0,109,1.0,139.65598144047652,0
2020-04-28-171105,171105,4,0,3,113,1.3333333333333333,178.1434034897694,1
2020-04-29-171105,171105,2,0,1,115,1.3333333333333333,172.68787880091696,2
2020-04-30-171105,171105,3,0,7,118,1.1666666666666667,217.48552482076803,3
2020-05-01-171105,171105,0,0,0,118,0.5,277.77591928487624,4
2020-05-02-171105,171105,1,0,1,119,0.0,189.14703241361232,5
2020-05-03-171105,171105,0,0,0,119,0.16666666666666666,65.25869111907924,6
2020-05-04-171105,171105,1,0,2,120,1.0,69.18038513152982,0
2020-05-05-171105,171105,0,0,3,120,1.0,78.21095121772103,1
2020-05-06-171105,171105,2,0,3,122,1.3333333333333333,97.52526345815049,2
2020-05-07-171105,171105,4,0,2,126,4.5,106.61804950488951,3
2020-05-08-171105,171105,2,0,0,128,1.1666666666666667,232.37632313301134,4
2020-05-09-171105,171105,1,0,0,129,0.16666666666666666,284.121160172583,5
2020-05-10-171105,171105,1,0,0,130,0.16666666666666666,262.83907003818825,6
2020-05-11-171105,171105,0,0,0,130,0.8333333333333334,247.22765210394715,0
2020-05-12-171105,171105,3,0,0,133,0.6666666666666666,261.54849798312443,1
2020-05-13-171105,171105,1,0,0,134,2.5,240.19184481082476,2
2020-05-14-171105,171105,7,0,3,141,0.3333333333333333,260.6694342161659,3
2020-05-15-171105,171105,0,0,0,141,0.8333333333333334,286.9493859496335,4
2020-05-16-171105,171105,1,0,0,142,0.0,213.89116045509212,5
2020-05-17-171105,171105,0,0,0,142,0.0,215.33747112149905,6
2020-05-18-171105,171105,2,0,0,144,1.5,205.81210043105793,0
2020-05-19-171105,171105,3,0,4,147,0.8333333333333334,223.21766287421138,1
2020-05-20-171105,171105,3,0,3,150,1.0,168.51666416468228,2
2020-05-21-171105,171105,2,0,4,152,0.5,160.23198461455257,3
2020-05-22-171105,171105,0,0,0,152,1.1666666666666667,168.47719654294815,4
2020-05-23-171105,171105,0,0,1,152,0.0,194.63067701553814,5
2020-05-24-171105,171105,0,0,0,152,0.0,196.44267682485486,6
2020-05-25-171105,171105,0,0,1,152,0.16666666666666666,156.76234259453807,0
2020-05-26-171105,171105,0,0,1,152,0.6666666666666666,124.74383824228713,1
2020-05-27-171105,171105,0,1,0,152,0.16666666666666666,139.15529431474437,2
2020-05-28-171105,171105,3,1,0,155,0.6666666666666666,101.37398297751162,3
2020-05-29-171105,171105,0,0,2,155,0.3333333333333333,109.19398632413726,4
2020-05-30-171105,171105,0,1,0,155,0.0,96.59568423181216,5
2020-05-31-171105,171105,0,0,0,155,0.0,98.95412681470094,6
2020-06-01-171105,171105,0,1,0,155,0.6666666666666666,362.0045677655673,0
2020-06-02-171105,171105,4,0,1,159,0.16666666666666666,51.21521417720995,1
2020-06-03-171105,171105,3,0,1,162,0.0,80.3000561175805,2
2020-06-04-171105,171105,4,0,1,166,1.0,67.38682727245902,3
2020-06-05-171105,171105,0,0,0,166,0.6666666666666666,121.06329669197189,4
2020-06-06-171105,171105,1,0,0,167,0.0,117.27315362528586,5
2020-06-07-171105,171105,0,0,0,167,0.0,117.30000939109978,6
2020-06-08-171105,171105,1,0,1,168,0.6666666666666666,117.88415595782327,0
2020-06-09-171105,171105,1,0,1,169,0.0,138.53516316758675,1
2020-06-10-171105,171105,0,0,1,169,0.3333333333333333,385.87243293352185,2
2020-06-11-171105,171105,0,0,1,169,0.6666666666666666,353.4848943276654,3
2020-06-12-171105,171105,2,0,2,171,0.16666666666666666,340.8327446216424,4
2020-06-13-171105,171105,0,0,1,171,0.0,306.84317601094796,5
2020-06-14-171105,171105,0,4,0,171,0.0,135.6944686400779,6
2020-06-15-171105,171105,0,1,0,171,0.5,84.57169242514223,0
2020-06-16-171105,171105,1,0,0,172,0.0,86.0527498219524,1
2020-06-17-171105,171105,1,0,0,173,0.16666666666666666,71.50868334782157,2
2020-06-18-171105,171105,1,0,1,174,0.16666666666666666,79.24410413656075,3
2020-06-19-171105,171105,0,0,1,174,0.0,74.90627869930418,4
2020-06-20-171105,171105,0,0,0,174,0.0,95.29627244380903,5
2020-06-21-171105,171105,0,0,0,174,0.0,95.55388366525689,6
2020-06-22-171105,171105,1,0,0,175,0.0,83.1179634045423,0
2020-06-23-171105,171105,1,0,0,176,0.3333333333333333,84.21988478543734,1
2020-06-24-171105,171105,1,0,0,177,0.3333333333333333,95.20378362838586,2
2020-06-25-171105,171105,1,0,1,178,0.16666666666666666,102.57523437736552,3
2020-06-26-171105,171105,2,0,2,180,0.3333333333333333,104.32531520148015,4
2020-06-27-171105,171105,1,0,0,181,0.0,86.3811247514866,5
2020-06-28-171105,171105,0,0,0,181,0.0,95.85711756097106,6
2020-06-29-171105,171105,0,0,0,181,0.3333333333333333,96.17953495658182,0
2020-06-30-171105,171105,0,0,0,181,0.3333333333333333,97.22589650022267,1
2020-07-01-171105,171105,0,0,0,181,0.16666666666666666,155.46680750265025,2
2020-07-02-171105,171105,1,0,0,182,0.0,12.07973251731756,3
2020-07-03-171105,171105,1,0,0,183,0.0,31.96901672478281,4
2020-07-04-171105,171105,0,0,0,183,0.0,50.91104258572423,5
2020-07-05-171105,171105,0,0,0,183,0.0,50.97036905647015,6
2020-07-06-171105,171105,0,0,2,183,0.16666666666666666,49.78875643084045,0
2020-07-07-171105,171105,0,0,0,183,0.0,48.063021303251354,1
2020-07-08-171105,171105,0,0,0,183,0.5,34.0095014657335,2
2020-07-09-171105,171105,1,0,0,184,0.0,33.34934340555481,3
2020-07-10-171105,171105,2,0,0,186,0.8333333333333334,149.09818575105365,4
2020-07-11-171105,171105,0,0,0,186,0.16666666666666666,118.68901742007154,5
2020-07-12-171105,171105,0,0,0,186,0.0,97.88090332954656,6
2020-07-13-171105,171105,0,0,0,186,0.0,89.13125944966403,0
2020-07-14-171105,171105,0,0,1,186,0.0,89.63714953507882,1
2020-07-15-171105,171105,0,0,2,186,0.16666666666666666,59.30115393377257,2
2020-07-16-171105,171105,0,0,0,186,0.0,39.73545365498154,3
2020-07-17-171105,171105,0,0,0,186,0.16666666666666666,39.41542771456928,4
2020-07-18-171105,171105,0,0,0,186,0.0,10.924736271438722,5
2020-07-19-171105,171105,0,0,0,186,0.16666666666666666,11.40817310633372,6
2020-07-20-171105,171105,2,0,0,188,0.0,21.780391340472526,0
2020-07-21-171105,171105,0,0,0,188,0.0,38.83211228228702,1
2020-07-22-171105,171105,0,0,1,188,0.0,38.45804228166408,2
2020-07-23-171105,171105,0,0,1,188,0.16666666666666666,38.415484400244004,3
2020-07-24-171105,171105,0,0,0,188,0.0,37.45501666298751,4
2020-07-25-171105,171105,0,0,0,188,0.0,37.85251957194835,5
2020-07-26-171105,171105,0,0,1,188,0.0,36.50797937506511,6
2020-07-27-171105,171105,0,0,1,188,0.0,26.420812959356173,0
2020-07-28-171105,171105,1,0,1,189,0.0,10.121933095077843,1
2020-07-29-171105,171105,2,0,0,191,0.16666666666666666,18.448719667656594,2
2020-07-30-171105,171105,0,0,1,191,0.16666666666666666,37.560397278362565,3
2020-07-31-171105,171105,0,0,3,191,0.6666666666666666,44.38803459273452,4
2020-08-01-171105,171105,0,0,4,191,0.0,36.192413502173345,5
2020-08-02-171105,171105,0,0,1,191,0.16666666666666666,343.3010423001573,6
2020-08-03-171105,171105,0,0,3,191,0.5,357.6146960504281,0
2020-08-04-171105,171105,0,0,3,191,0.0,334.3244804484923,1
2020-08-05-171105,171105,1,0,2,192,0.3333333333333333,252.95948922050792,2
2020-08-06-171105,171105,1,0,5,193,0.0,215.84688558243425,3
2020-08-07-171105,171105,0,0,7,193,0.16666666666666666,180.5050522709819,4
2020-08-08-171105,171105,0,0,0,193,0.0,132.49727661608688,5
2020-08-09-171105,171105,1,0,1,194,0.5,136.6928627767458,6
2020-08-10-171105,171105,1,0,1,195,0.16666666666666666,29.63594496804059,0
2020-08-11-171105,171105,1,0,1,196,0.6666666666666666,41.961580850506394,1
2020-08-12-171105,171105,0,0,2,196,0.3333333333333333,77.43699505961584,2
2020-08-13-171105,171105,1,0,2,197,0.0,88.66482399067141,3
2020-08-14-171105,171105,3,0,2,200,0.0,111.9269044006067,4
2020-08-15-171105,171105,4,0,4,204,0.6666666666666666,138.27746772141384,5
2020-08-16-171105,171105,1,0,0,205,0.3333333333333333,190.99879511269415,6
2020-08-17-171105,171105,3,0,2,208,0.6666666666666666,206.3364844376237,0
2020-08-18-171105,171105,3,0,3,211,0.6666666666666666,241.48699303544387,1
2020-08-19-171105,171105,2,0,3,213,0.8333333333333334,271.3084350818488,2
2020-08-20-171105,171105,5,0,3,218,1.0,313.0177403461968,3
2020-08-21-171105,171105,7,0,2,225,1.0,370.56152814784264,4
2020-08-22-171105,171105,0,0,1,225,0.5,398.67952252153816,5
2020-08-23-171105,171105,1,0,0,226,0.16666666666666666,416.29571375617365,6
2020-08-24-171105,171105,1,0,0,227,0.3333333333333333,396.9001051291426,0
2020-08-25-171105,171105,1,0,6,228,0.6666666666666666,379.27888464254727,1
2020-08-26-171105,171105,2,0,2,230,1.8333333333333333,328.7936210342276,2
2020-08-27-171105,171105,2,0,2,232,1.0,408.41673653177696,3
2020-08-28-171105,171105,2,0,2,234,0.6666666666666666,365.2175593579136,4
2020-08-29-171105,171105,4,0,1,238,1.5,317.23233643078345,5
2020-08-30-171105,171105,0,0,0,238,0.6666666666666666,328.86244918613914,6
2020-08-31-171105,171105,2,0,1,240,0.8333333333333334,302.11278486310044,0
2020-09-01-171105,171105,3,0,1,243,0.16666666666666666,132.47258579538467,1
2020-09-02-171105,171105,3,0,2,246,1.6666666666666667,642.0616116909425,2
2020-09-03-171105,171105,3,0,4,249,0.8333333333333334,439.9610875832552,3
2020-09-04-171105,171105,2,0,8,251,1.6666666666666667,354.60217237772315,4
2020-09-05-171105,171105,1,0,7,252,0.3333333333333333,353.965760581822,5
2020-09-06-171105,171105,0,0,4,252,0.0,327.4835112270967,6
2020-09-07-171105,171105,0,0,0,252,0.6666666666666666,308.34644234595515,0
2020-09-08-171105,171105,6,0,2,258,1.1666666666666667,314.03981263310266,1
2020-09-09-171105,171105,2,0,9,260,0.8333333333333334,377.4604389850767,2
2020-09-10-171105,171105,2,0,5,262,1.6666666666666667,99.02560752565138,3
2020-09-11-171105,171105,2,0,8,264,0.8333333333333334,157.48557778558387,4
2020-09-12-171105,171105,1,0,4,265,0.3333333333333333,198.3160914260199,5
2020-09-13-171105,171105,0,0,1,265,1.0,202.18783278448717,6
2020-09-14-171105,171105,1,0,0,266,0.8333333333333334,216.73612782294978,0
2020-09-15-171105,171105,1,0,5,267,1.5,229.49128389622553,1
2020-09-16-171105,171105,2,0,4,269,1.6666666666666667,260.4919708805517,2
2020-09-17-171105,171105,4,0,4,273,12.833333333333336,304.1623398234393,3
2020-09-18-171105,171105,8,0,3,281,2.5,525.968953493204,4
2020-09-19-171105,171105,7,0,4,288,1.5,558.3074400776949,5
2020-09-20-171105,171105,4,0,0,292,0.5,697.7016454706575,6
2020-09-21-171105,171105,0,0,1,292,1.5,718.0083311063444,0
2020-09-22-171105,171105,2,0,2,294,1.8333333333333333,716.7001665079615,1
2020-09-23-171105,171105,9,0,4,303,1.8333333333333333,778.1686479177991,2
2020-09-24-171105,171105,5,2,3,308,0.8333333333333334,623.930805445077,3
2020-09-25-171105,171105,8,0,4,316,0.5,627.5779507129064,4
2020-09-26-171105,171105,4,0,4,320,0.16666666666666666,614.8436400046593,5
2020-09-27-171105,171105,1,0,0,321,0.3333333333333333,567.9173019803384,6
2020-09-28-171105,171105,0,0,1,321,0.0,542.0848366926829,0
2020-09-29-171105,171105,5,1,1,326,0.8333333333333334,507.9649695054718,1
2020-09-30-171105,171105,4,0,5,330,0.5,382.0976518724931,2
2020-10-01-171105,171105,4,0,12,334,0.6666666666666666,0.0,3
2020-10-02-171105,171105,3,0,2,337,1.1666666666666667,800.1992406578627,4
2020-10-03-171105,171105,4,0,3,341,0.3333333333333333,1580.0908208626986,5
2020-10-04-171105,171105,0,0,3,341,0.3333333333333333,1475.7081036876323,6
2020-10-05-171105,171105,1,0,3,342,0.5,1262.588734749703,0
2020-10-06-171105,171105,2,1,7,344,1.0,1124.5022032427592,1
2020-10-07-171105,171105,4,0,13,348,1.6666666666666667,837.8991675593679,2
2020-10-08-171105,171105,3,1,6,351,1.8333333333333333,703.6672290380272,3
2020-10-09-171105,171105,4,0,15,355,5.333333333333333,756.0062770681819,4
2020-10-10-171105,171105,4,0,8,359,1.1666666666666667,73.65727741183102,5
2020-10-11-171105,171105,0,0,19,359,0.5,124.98735725758257,6
2020-10-12-171105,171105,1,0,16,360,1.6666666666666667,140.28961260868724,0
2020-10-13-171105,171105,1,0,12,361,2.1666666666666665,173.31271357123728,1
2020-10-14-171105,171105,5,0,22,366,2.6666666666666665,236.09188940792524,2
2020-10-15-171105,171105,12,0,15,378,4.333333333333333,360.04549373648797,3
2020-10-16-171105,171105,2,0,47,380,6.833333333333332,571.0117970592405,4
2020-10-17-171105,171105,3,0,3,383,1.5,687.4291502708174,5
2020-10-18-171105,171105,3,0,15,386,0.6666666666666666,693.8030157358784,6
2020-10-19-171105,171105,3,0,3,389,2.0,726.141148678508,0
2020-10-20-171105,171105,7,0,19,396,4.333333333333333,810.3650145487214,1
2020-10-21-171105,171105,13,0,24,409,5.666666666666668,872.2452422898898,2
2020-10-22-171105,171105,6,0,22,415,1.3333333333333333,908.5363118965431,3
2020-10-23-171105,171105,15,0,22,430,9.166666666666666,809.1601631908947,4
2020-10-24-171105,171105,8,0,8,438,0.6666666666666666,1094.4893845904508,5
2020-10-25-171105,171105,19,0,1,457,2.1666666666666665,1103.5313021645084,6
2020-10-26-171105,171105,16,1,15,473,2.6666666666666665,1184.0480763643523,0
2020-10-27-171105,171105,12,0,10,485,2.1666666666666665,1325.3112238182173,1
2020-10-28-171105,171105,22,0,20,507,6.0,1276.575663237898,2
2020-10-29-171105,171105,15,2,17,522,3.8333333333333335,1342.9551097952703,3
2020-10-30-171105,171105,47,0,7,569,5.5,1188.6883390750638,4
2020-10-31-171105,171105,3,2,0,572,1.0,1533.6269056620324,5
2020-11-01-171105,171105,15,0,0,587,4.666666666666667,450.9090692362321,6
2020-11-02-171105,171105,3,1,0,590,0.8333333333333334,832.2734518472791,0
2020-11-03-171105,171105,19,0,0,609,3.1666666666666665,680.0983637139504,1
2020-11-04-171105,171105,24,0,0,633,4.5,848.0584231759531,2
2020-11-05-171105,171105,22,1,0,655,5.666666666666668,1103.794357237567,3
2020-11-06-171105,171105,22,4,0,677,5.0,1260.979644959476,4
2020-11-07-171105,171105,8,0,0,685,2.6666666666666665,1340.3810702484004,5
2020-11-08-171105,171105,1,0,0,686,1.6666666666666667,1355.5564209806862,6
2020-11-09-171105,171105,15,2,0,701,2.833333333333333,1329.7988114564055,0
2020-11-10-171105,171105,10,0,0,711,3.8333333333333335,561.3074395598977,1
2020-11-11-171105,171105,20,1,0,731,7.5,689.3196037064652,2
2020-11-12-171105,171105,17,3,0,748,7.0,1017.2069869397561,3
2020-11-13-171105,171105,7,2,0,755,8.666666666666666,1224.1137019739303,4
2020-03-01-171106,171106,0,0,0,0,0.0,0.0,6
2020-03-02-171106,171106,0,0,0,0,0.0,4.545403786362611,0
2020-03-03-171106,171106,0,0,0,0,0.0,12.80386361679115,1
2020-03-04-171106,171106,0,0,0,0,0.0,13.609112450584274,2
2020-03-05-171106,171106,0,0,0,0,0.0,15.81843214561465,3
2020-03-06-171106,171106,0,0,0,0,0.0,12.408550408754001,4
2020-03-07-171106,171106,0,0,1,0,0.2,14.044582207981664,5
2020-03-08-171106,171106,0,0,0,0,0.0,15.883264252303018,6
2020-03-09-171106,171106,0,0,1,0,0.0,15.879006056312933,0
2020-03-10-171106,171106,0,0,0,0,0.0,141.56775284539015,1
2020-03-11-171106,171106,0,0,0,0,0.0,118.67939075087612,2
2020-03-12-171106,171106,0,0,0,0,0.0,87.59978898315552,3
2020-03-13-171106,171106,0,0,1,0,0.2,50.596425495975076,4
2020-03-14-171106,171106,0,0,0,0,0.2,38.169591143057914,5
2020-03-15-171106,171106,0,0,0,0,0.2,31.556690262432717,6
2020-03-16-171106,171106,0,0,0,0,0.4,5.857669121332385,0
2020-03-17-171106,171106,0,0,0,0,2.2,8.232257629917646,1
2020-03-18-171106,171106,0,0,1,0,3.2,14.520854409696268,2
2020-03-19-171106,171106,0,0,0,0,3.0,20.166103711087153,3
2020-03-20-171106,171106,0,1,0,0,3.2,22.82699730461325,4
2020-03-21-171106,171106,1,1,0,1,0.8,25.396884727233576,5
2020-03-22-171106,171106,0,2,0,1,1.0,26.532893221471575,6
2020-03-23-171106,171106,1,0,0,2,4.0,24.859367383917057,0
2020-03-24-171106,171106,0,0,0,2,2.0,27.043961419909824,1
2020-03-25-171106,171106,0,0,0,2,2.0,24.729368222009406,2
2020-03-26-171106,171106,0,0,0,2,1.6,24.300137655559865,3
2020-03-27-171106,171106,1,0,1,3,3.6,27.11585559304216,4
2020-03-28-171106,171106,0,0,0,3,0.6,27.83609000115325,5
2020-03-29-171106,171106,0,0,0,3,1.2,25.37457501271699,6
2020-03-30-171106,171106,0,1,0,3,1.4,18.84895920884857,0
2020-03-31-171106,171106,0,0,0,3,2.2,18.616893180916335,1
2020-04-01-171106,171106,1,0,0,4,3.0,5.043384625994562,2
2020-04-02-171106,171106,0,0,0,4,3.0,11.448894109025538,3
2020-04-03-171106,171106,0,0,0,4,2.2,11.854347667495267,4
2020-04-04-171106,171106,0,0,0,4,1.0,16.85227405483761,5
2020-04-05-171106,171106,0,0,0,4,0.2,19.662214699066382,6
2020-04-06-171106,171106,0,0,0,4,2.0,19.524051589684586,0
2020-04-07-171106,171106,0,0,0,4,1.8,21.083858856799207,1
2020-04-08-171106,171106,0,1,1,4,0.8,22.476727137548405,2
2020-04-09-171106,171106,0,0,0,4,4.2,22.315571455680235,3
2020-04-10-171106,171106,1,0,0,5,4.0,12.831780145421128,4
2020-04-11-171106,171106,0,0,0,5,0.4,15.201092729084833,5
2020-04-12-171106,171106,0,0,0,5,0.0,15.388825402920396,6
2020-04-13-171106,171106,0,0,0,5,1.0,16.166608004844207,0
2020-04-14-171106,171106,0,0,0,5,1.6,16.53733253874426,1
2020-04-15-171106,171106,0,0,2,5,0.2,20.050312494525745,2
2020-04-16-171106,171106,0,0,0,5,1.4,20.988386720590114,3
2020-04-17-171106,171106,0,0,0,5,1.2,12.204040732143822,4
2020-04-18-171106,171106,0,0,0,5,0.6,12.283455829194097,5
2020-04-19-171106,171106,0,0,0,5,0.2,12.106985027828214,6
2020-04-20-171106,171106,0,0,0,5,0.0,15.361335072210435,0
2020-04-21-171106,171106,0,0,0,5,2.4,12.884482234395092,1
2020-04-22-171106,171106,1,0,0,6,1.0,16.20923620894301,2
2020-04-23-171106,171106,0,0,1,6,0.4,15.995368887067348,3
2020-04-24-171106,171106,0,0,0,6,1.8,13.316588553410137,4
2020-04-25-171106,171106,0,0,0,6,0.0,17.17629327871651,5
2020-04-26-171106,171106,0,0,0,6,0.2,16.816758826371306,6
2020-04-27-171106,171106,0,0,0,6,1.8,12.108564042720893,0
2020-04-28-171106,171106,0,0,0,6,2.4,13.392754771548349,1
2020-04-29-171106,171106,2,0,0,8,1.0,12.149474822213675,2
2020-04-30-171106,171106,0,0,1,8,2.0,21.304991235243534,3
2020-05-01-171106,171106,0,0,0,8,0.4,20.740605704207255,4
2020-05-02-171106,171106,0,0,0,8,0.2,17.070537262770607,5
2020-05-03-171106,171106,0,0,0,8,0.2,4.879102356407374,6
2020-05-04-171106,171106,0,0,2,8,1.2,4.885709481813128,0
2020-05-05-171106,171106,0,0,0,8,1.2,4.812893179187959,1
2020-05-06-171106,171106,0,0,0,8,1.6,6.374527045062231,2
2020-05-07-171106,171106,1,0,0,9,6.0,8.025863226964992,3
2020-05-08-171106,171106,0,0,1,9,1.2,13.017082264095242,4
2020-05-09-171106,171106,0,0,0,9,0.4,15.446097931839631,5
2020-05-10-171106,171106,0,0,0,9,0.4,21.205163203918154,6
2020-05-11-171106,171106,0,0,0,9,1.0,17.87512797431902,0
2020-05-12-171106,171106,0,0,0,9,1.6,20.069995188551303,1
2020-05-13-171106,171106,0,0,0,9,3.0,20.520691241112836,2
2020-05-14-171106,171106,1,0,0,10,1.6,18.302264689424057,3
2020-05-15-171106,171106,0,0,0,10,1.2,17.93265592134955,4
2020-05-16-171106,171106,0,0,0,10,0.2,19.55071872563142,5
2020-05-17-171106,171106,0,0,0,10,0.0,19.82121438229084,6
2020-05-18-171106,171106,2,0,0,12,1.6,19.686516178312576,0
2020-05-19-171106,171106,0,0,0,12,1.4,22.780848740361485,1
2020-05-20-171106,171106,0,0,0,12,1.4,18.49833655695472,2
2020-05-21-171106,171106,0,0,0,12,1.0,17.429496155494274,3
2020-05-22-171106,171106,1,0,0,13,1.2,13.462144894724009,4
2020-05-23-171106,171106,0,0,0,13,0.0,15.177884446198988,5
2020-05-24-171106,171106,0,0,0,13,0.0,15.341509389042185,6
2020-05-25-171106,171106,0,0,0,13,0.0,9.431774275744724,0
2020-05-26-171106,171106,0,0,0,13,0.8,6.922485622376332,1
2020-05-27-171106,171106,0,1,0,13,0.4,9.00738358858004,2
2020-05-28-171106,171106,0,1,0,13,1.4,7.653786543966564,3
2020-05-29-171106,171106,0,0,0,13,0.4,8.043145181287068,4
2020-05-30-171106,171106,0,0,0,13,0.0,7.378083483927816,5
2020-05-31-171106,171106,0,0,0,13,0.0,7.699662742326097,6
2020-06-01-171106,171106,0,0,0,13,0.8,21.090819848397054,0
2020-06-02-171106,171106,0,0,0,13,1.0,2.588280728423638,1
2020-06-03-171106,171106,0,0,0,13,0.6,4.86370851184515,2
2020-06-04-171106,171106,0,0,0,13,2.0,3.0450320447712613,3
2020-06-05-171106,171106,0,0,0,13,0.6,5.713897583616113,4
2020-06-06-171106,171106,0,0,0,13,0.2,5.816325713587458,5
2020-06-07-171106,171106,0,0,0,13,0.0,5.980416358861646,6
2020-06-08-171106,171106,0,0,0,13,0.8,6.121173727584008,0
2020-06-09-171106,171106,0,0,0,13,0.2,7.319872018604969,1
2020-06-10-171106,171106,0,0,0,13,0.0,25.46441720536202,2
2020-06-11-171106,171106,0,0,0,13,0.6,23.47003821040601,3
2020-06-12-171106,171106,0,0,0,13,0.6,21.288467997225403,4
2020-06-13-171106,171106,0,1,0,13,0.0,17.501717290319387,5
2020-06-14-171106,171106,0,0,0,13,0.0,8.322253155183649,6
2020-06-15-171106,171106,0,0,0,13,0.4,5.7724506508206,0
2020-06-16-171106,171106,0,0,0,13,0.2,5.96536572299976,1
2020-06-17-171106,171106,0,0,0,13,0.4,5.01084923119879,2
2020-06-18-171106,171106,0,0,0,13,0.4,4.640808573818678,3
2020-06-19-171106,171106,0,0,0,13,0.0,4.126930972432158,4
2020-06-20-171106,171106,0,0,0,13,0.0,5.704633150586784,5
2020-06-21-171106,171106,0,0,0,13,0.0,5.91286548291802,6
2020-06-22-171106,171106,0,0,0,13,0.2,5.145958170765606,0
2020-06-23-171106,171106,0,0,0,13,0.8,5.3185798537312685,1
2020-06-24-171106,171106,0,0,0,13,0.6,7.6179445581689595,2
2020-06-25-171106,171106,0,0,0,13,0.2,8.015615956767942,3
2020-06-26-171106,171106,0,0,0,13,0.8,8.044257494304167,4
2020-06-27-171106,171106,0,0,0,13,0.2,6.668479793348352,5
2020-06-28-171106,171106,0,0,0,13,0.0,7.175316702657893,6
2020-06-29-171106,171106,0,0,0,13,0.2,7.181089461603445,0
2020-06-30-171106,171106,0,0,0,13,0.0,5.438192291636604,1
2020-07-01-171106,171106,0,0,0,13,0.0,9.507682915624038,2
2020-07-02-171106,171106,0,0,0,13,0.2,0.9166710274984462,3
2020-07-03-171106,171106,0,0,0,13,0.2,1.9348783533490312,4
2020-07-04-171106,171106,0,0,0,13,0.0,6.050016776313525,5
2020-07-05-171106,171106,0,0,0,13,0.0,6.090467144354198,6
2020-07-06-171106,171106,0,0,0,13,0.2,5.92765544902093,0
2020-07-07-171106,171106,0,0,0,13,0.0,6.14042391954157,1
2020-07-08-171106,171106,0,0,0,13,0.2,5.487554284202592,2
2020-07-09-171106,171106,0,0,0,13,0.2,5.271401228974938,3
2020-07-10-171106,171106,0,0,0,13,0.8,10.226440576000812,4
2020-07-11-171106,171106,0,0,0,13,0.0,7.84012486724917,5
2020-07-12-171106,171106,0,0,0,13,0.0,6.5079254057055875,6
2020-07-13-171106,171106,0,0,0,13,0.0,6.040500290287403,0
2020-07-14-171106,171106,0,0,0,13,0.0,6.170757748798802,1
2020-07-15-171106,171106,0,0,0,13,0.2,3.9370328315077856,2
2020-07-16-171106,171106,0,0,0,13,0.0,2.46938304188363,3
2020-07-17-171106,171106,0,0,0,13,0.2,2.564345819304807,4
2020-07-18-171106,171106,0,0,0,13,0.0,1.025073273627401,5
2020-07-19-171106,171106,0,0,0,13,0.0,1.1222673091161144,6
2020-07-20-171106,171106,0,0,0,13,0.4,1.7650920820833689,0
2020-07-21-171106,171106,0,0,0,13,0.0,2.491316790820556,1
2020-07-22-171106,171106,0,0,0,13,0.0,2.5027383116278625,2
2020-07-23-171106,171106,0,0,0,13,0.0,2.4206113249269285,3
2020-07-24-171106,171106,0,0,0,13,0.0,2.3445140818584966,4
2020-07-25-171106,171106,0,0,0,13,0.0,2.502096483952766,5
2020-07-26-171106,171106,0,0,0,13,0.0,2.490604335966353,6
2020-07-27-171106,171106,0,0,0,13,0.0,1.7009795369155762,0
2020-07-28-171106,171106,0,0,0,13,0.2,1.1367947599331893,1
2020-07-29-171106,171106,0,0,0,13,0.6,1.5017204680331624,2
2020-07-30-171106,171106,0,0,0,13,0.4,3.0786561843366593,3
2020-07-31-171106,171106,0,0,0,13,0.8,5.894912610774831,4
2020-08-01-171106,171106,0,0,0,13,0.0,3.3926121406136076,5
2020-08-02-171106,171106,0,0,0,13,0.0,41.144281941564174,6
2020-08-03-171106,171106,0,0,0,13,0.6,58.63269350377463,0
2020-08-04-171106,171106,0,0,0,13,0.0,48.38348646721651,1
2020-08-05-171106,171106,0,0,0,13,0.4,42.680661704318545,2
2020-08-06-171106,171106,0,0,0,13,0.2,39.70410585997179,3
2020-08-07-171106,171106,0,0,1,13,0.0,29.725968625998348,4
2020-08-08-171106,171106,0,0,1,13,0.0,29.029123038817225,5
2020-08-09-171106,171106,0,0,1,13,0.4,28.609007188627416,6
2020-08-10-171106,171106,0,0,0,13,0.2,2.7854529410028865,0
2020-08-11-171106,171106,0,0,0,13,0.4,3.724689056728482,1
2020-08-12-171106,171106,0,0,0,13,0.4,7.308339636069981,2
2020-08-13-171106,171106,0,0,0,13,0.2,8.63050611000463,3
2020-08-14-171106,171106,0,0,1,13,0.6,11.061899041064581,4
2020-08-15-171106,171106,0,0,0,13,1.8,13.122590954376086,5
2020-08-16-171106,171106,0,0,2,13,1.0,18.751772905315825,6
2020-08-17-171106,171106,0,0,1,13,1.4,25.094974943431904,0
2020-08-18-171106,171106,0,0,0,13,1.4,27.81436151873966,1
2020-08-19-171106,171106,0,0,0,13,2.6,28.798073131413286,2
2020-08-20-171106,171106,0,0,1,13,1.4,40.59480069721732,3
2020-08-21-171106,171106,1,0,1,14,2.4,49.94469639340778,4
2020-08-22-171106,171106,1,0,0,15,0.8,60.696209388719964,5
2020-08-23-171106,171106,1,0,0,16,0.8,72.39780128329191,6
2020-08-24-171106,171106,0,0,0,16,1.0,74.439508815219,0
2020-08-25-171106,171106,0,0,2,16,1.4,83.02493876003135,1
2020-08-26-171106,171106,0,0,1,16,1.6,82.68123494844627,2
2020-08-27-171106,171106,0,0,4,16,0.8,87.33349491646766,3
2020-08-28-171106,171106,1,0,0,17,1.4,79.33838470329428,4
2020-08-29-171106,171106,0,0,0,17,0.8,73.08865974578802,5
2020-08-30-171106,171106,2,0,3,19,0.2,52.97717535488111,6
2020-08-31-171106,171106,1,0,0,20,2.0,46.84093182996024,0
2020-09-01-171106,171106,0,0,5,20,1.0,29.692685274220338,1
2020-09-02-171106,171106,0,0,0,20,2.8,102.85202013772336,2
2020-09-03-171106,171106,1,0,2,21,1.4,69.92005151336339,3
2020-09-04-171106,171106,1,0,1,22,1.8,62.02331905620245,4
2020-09-05-171106,171106,0,0,0,22,0.8,61.293352653522085,5
2020-09-06-171106,171106,0,0,0,22,0.2,58.28984321142765,6
2020-09-07-171106,171106,0,0,1,22,0.0,63.239950368969275,0
2020-09-08-171106,171106,2,0,1,24,3.8,59.683202599475536,1
2020-09-09-171106,171106,1,0,0,25,2.2,82.10238179132911,2
2020-09-10-171106,171106,4,0,1,29,2.0,17.837612380715612,3
2020-09-11-171106,171106,0,0,0,29,0.4,36.25283782296229,4
2020-09-12-171106,171106,0,0,0,29,0.2,41.43119941578696,5
2020-09-13-171106,171106,3,0,0,32,0.4,47.30501414836187,6
2020-09-14-171106,171106,0,0,0,32,0.4,49.06011400489332,0
2020-09-15-171106,171106,5,0,0,37,1.0,52.752139964201845,1
2020-09-16-171106,171106,0,0,0,37,1.4,61.536430387166305,2
2020-09-17-171106,171106,2,0,0,39,1.6,71.0336457450496,3
2020-09-18-171106,171106,1,0,0,40,3.0,84.82693851844425,4
2020-09-19-171106,171106,0,1,0,40,2.2,92.1286207790398,5
2020-09-20-171106,171106,0,0,1,40,1.4,93.42483359151359,6
2020-09-21-171106,171106,1,0,0,41,0.8,93.32326602235668,0
2020-09-22-171106,171106,1,3,0,42,4.8,84.97574141219675,1
2020-09-23-171106,171106,0,0,0,42,2.4,113.98064171620413,2
2020-09-24-171106,171106,1,0,0,43,3.0,92.9982049607878,3
2020-09-25-171106,171106,0,0,2,43,2.2,102.94534328421221,4
2020-09-26-171106,171106,0,0,1,43,1.2,107.60663993824764,5
2020-09-27-171106,171106,0,0,2,43,0.2,103.21856219305931,6
2020-09-28-171106,171106,0,0,5,43,0.8,99.7107635066954,0
2020-09-29-171106,171106,0,0,0,43,1.6,98.77566642916318,1
2020-09-30-171106,171106,0,0,0,43,1.0,69.6586688580748,2
2020-10-01-171106,171106,0,0,1,43,2.2,0.0,3
2020-10-02-171106,171106,0,0,6,43,1.4,75.54192993594064,4
2020-10-03-171106,171106,0,0,0,43,0.8,190.71060726808489,5
2020-10-04-171106,171106,1,0,0,44,0.0,203.9619282709052,6
2020-10-05-171106,171106,0,1,6,44,0.6,178.09721294608985,0
2020-10-06-171106,171106,0,0,0,44,1.2,139.20867549878943,1
2020-10-07-171106,171106,0,0,0,44,2.4,116.88197679231803,2
2020-10-08-171106,171106,0,0,2,44,1.6,100.96651596655883,3
2020-10-09-171106,171106,2,0,7,46,6.0,110.39300013121527,4
2020-10-10-171106,171106,1,0,3,47,0.8,9.06880884972429,5
2020-10-11-171106,171106,2,0,2,49,0.0,12.514480432344788,6
2020-10-12-171106,171106,5,0,1,54,1.0,16.079407309811785,0
2020-10-13-171106,171106,0,0,3,54,1.2,24.842877481789643,1
2020-10-14-171106,171106,0,0,1,54,3.6,28.58849395012456,2
2020-10-15-171106,171106,1,0,4,55,4.6,40.60435042334086,3
2020-10-16-171106,171106,6,0,5,61,4.4,54.595941834815164,4
2020-10-17-171106,171106,0,0,2,61,0.8,61.66196038342262,5
2020-10-18-171106,171106,0,0,2,61,1.2,62.74719093213996,6
2020-10-19-171106,171106,6,0,2,67,1.6,65.18257639899028,0
2020-10-20-171106,171106,0,0,0,67,3.4,74.10224384457857,1
2020-10-21-171106,171106,0,0,0,67,5.6,74.41278017956901,2
2020-10-22-171106,171106,2,0,4,69,2.4,82.93981373743887,3
2020-10-23-171106,171106,7,0,5,76,11.6,83.14415076877202,4
2020-10-24-171106,171106,3,0,0,79,1.8,109.45922216654787,5
2020-10-25-171106,171106,2,0,6,81,5.2,111.92068776008878,6
2020-10-26-171106,171106,1,0,2,82,6.4,114.85837386357125,0
2020-10-27-171106,171106,3,0,8,85,6.0,131.1500031808026,1
2020-10-28-171106,171106,1,3,2,86,10.4,158.31357290575053,2
2020-10-29-171106,171106,4,0,4,90,6.8,164.00853966237398,3
2020-10-30-171106,171106,5,0,8,95,16.4,142.67796704657755,4
2020-10-31-171106,171106,2,0,0,97,1.6,190.38153308926263,5
2020-11-01-171106,171106,2,0,0,99,3.4,54.294235314313795,6
2020-11-02-171106,171106,2,0,0,101,1.4,103.11217761440315,0
2020-11-03-171106,171106,0,0,0,101,7.4,82.88100120802665,1
2020-11-04-171106,171106,0,1,0,101,9.6,103.35260084249924,2
2020-11-05-171106,171106,4,2,0,105,9.0,119.68969768310072,3
2020-11-06-171106,171106,5,2,0,110,8.4,121.05363977014713,4
2020-11-07-171106,171106,0,0,0,110,3.4,141.85017678989348,5
2020-11-08-171106,171106,6,0,0,116,0.6,140.94240471156445,6
2020-11-09-171106,171106,2,0,0,118,7.2,135.09922503009335,0
2020-11-10-171106,171106,8,0,0,126,4.0,52.272394563301575,1
2020-11-11-171106,171106,2,0,0,128,11.4,68.38232662424429,2
2020-11-12-171106,171106,4,0,0,132,7.2,85.64586691897763,3
2020-11-13-171106,171106,8,0,0,140,4.8,94.42618084562125,4
2020-03-01-171107,171107,0,0,0,0,0.0,0.0,6
2020-03-02-171107,171107,0,0,1,0,0.0,14.039291349079168,0
2020-03-03-171107,171107,0,0,0,0,0.0,57.41503766621536,1
2020-03-04-171107,171107,0,0,2,0,0.14285714285714285,67.86948396833827,2
2020-03-05-171107,171107,0,0,0,0,0.0,75.95966130710588,3
2020-03-06-171107,171107,0,0,0,0,0.0,60.89333971999392,4
2020-03-07-171107,171107,0,0,0,0,0.14285714285714285,72.28284065657625,5
2020-03-08-171107,171107,0,0,0,0,0.0,80.95887373016502,6
2020-03-09-171107,171107,0,0,1,0,0.14285714285714285,81.3970372073537,0
2020-03-10-171107,171107,0,0,0,0,0.0,529.176292440684,1
2020-03-11-171107,171107,0,0,2,0,0.2857142857142857,429.84953539337596,2
2020-03-12-171107,171107,0,0,0,0,0.42857142857142855,333.56270208997876,3
2020-03-13-171107,171107,0,0,0,0,0.14285714285714285,167.9495830218989,4
2020-03-14-171107,171107,0,0,0,0,0.14285714285714285,140.8873392215794,5
2020-03-15-171107,171107,0,0,0,0,0.2857142857142857,120.11370800804202,6
2020-03-16-171107,171107,1,0,0,1,1.2857142857142858,32.201626075865285,0
2020-03-17-171107,171107,0,0,1,1,1.7142857142857142,53.92434304740331,1
2020-03-18-171107,171107,2,1,1,3,2.2857142857142856,65.26976627591657,2
2020-03-19-171107,171107,0,0,0,3,2.571428571428572,82.95742674170971,3
2020-03-20-171107,171107,0,4,1,3,2.571428571428572,89.81753225518133,4
2020-03-21-171107,171107,0,0,0,3,1.2857142857142858,107.11160463507527,5
2020-03-22-171107,171107,0,0,1,3,0.5714285714285714,104.03882736474054,6
2020-03-23-171107,171107,1,0,3,4,5.142857142857143,90.11057801930363,0
2020-03-24-171107,171107,0,0,1,4,1.7142857142857142,107.84297238393322,1
2020-03-25-171107,171107,2,0,1,6,1.8571428571428568,101.05202681734595,2
2020-03-26-171107,171107,0,0,1,6,2.0,105.29752425059625,3
2020-03-27-171107,171107,0,0,0,6,2.8571428571428568,119.40505892921922,4
2020-03-28-171107,171107,0,0,0,6,0.2857142857142857,122.19701729980389,5
2020-03-29-171107,171107,0,0,0,6,0.8571428571428571,118.52627619986723,6
2020-03-30-171107,171107,0,0,0,6,3.1428571428571432,88.21450068383784,0
2020-03-31-171107,171107,1,0,1,7,2.8571428571428568,98.02544928226385,1
2020-04-01-171107,171107,1,0,0,8,2.142857142857143,22.490642771496937,2
2020-04-02-171107,171107,0,0,0,8,2.2857142857142856,71.01598275752488,3
2020-04-03-171107,171107,1,0,2,9,2.7142857142857144,60.51040851207184,4
2020-04-04-171107,171107,0,0,1,9,0.5714285714285714,74.18604630654667,5
2020-04-05-171107,171107,1,0,1,10,0.2857142857142857,75.64422507692495,6
2020-04-06-171107,171107,3,0,0,13,2.0,79.26806899928442,0
2020-04-07-171107,171107,1,0,0,14,1.5714285714285714,86.12032373940181,1
2020-04-08-171107,171107,1,0,0,15,2.0,85.70787426927197,2
2020-04-09-171107,171107,1,0,0,16,1.2857142857142858,85.98961918113979,3
2020-04-10-171107,171107,0,0,0,16,2.0,28.06111650524554,4
2020-04-11-171107,171107,0,0,0,16,1.8571428571428568,33.927305655563515,5
2020-04-12-171107,171107,0,1,0,16,0.8571428571428571,42.63142519181655,6
2020-04-13-171107,171107,0,0,0,16,3.2857142857142856,45.812272556994145,0
2020-04-14-171107,171107,1,0,0,17,1.8571428571428568,56.3478481500769,1
2020-04-15-171107,171107,0,0,2,17,0.7142857142857143,66.88139129190877,2
2020-04-16-171107,171107,0,0,0,17,3.4285714285714284,72.50682984626533,3
2020-04-17-171107,171107,2,0,1,19,1.2857142857142858,68.00546195233908,4
2020-04-18-171107,171107,1,0,0,20,0.14285714285714285,78.94234246650164,5
2020-04-19-171107,171107,1,0,0,21,0.14285714285714285,71.93799550662091,6
2020-04-20-171107,171107,0,0,0,21,1.0,71.60267838273614,0
2020-04-21-171107,171107,0,0,0,21,1.0,69.65751142598619,1
2020-04-22-171107,171107,0,1,1,21,0.7142857142857143,71.28460124667745,2
2020-04-23-171107,171107,0,0,0,21,0.2857142857142857,60.42575961049449,3
2020-04-24-171107,171107,0,0,0,21,2.2857142857142856,43.600432987310725,4
2020-04-25-171107,171107,0,0,0,21,0.42857142857142855,55.0409264903769,5
2020-04-26-171107,171107,0,0,0,21,0.2857142857142857,55.22015272079311,6
2020-04-27-171107,171107,0,0,1,21,1.7142857142857142,42.2930173659374,0
2020-04-28-171107,171107,0,0,0,21,1.2857142857142858,52.39279187305708,1
2020-04-29-171107,171107,2,0,0,23,2.2857142857142856,55.48710538241227,2
2020-04-30-171107,171107,0,1,0,23,2.2857142857142856,79.34308855093286,3
2020-05-01-171107,171107,1,0,0,24,0.2857142857142857,96.86901470219252,4
2020-05-02-171107,171107,0,0,0,24,0.5714285714285714,65.50279303189134,5
2020-05-03-171107,171107,0,0,0,24,0.0,35.89966816264213,6
2020-05-04-171107,171107,0,0,0,24,2.2857142857142856,27.484635517385005,0
2020-05-05-171107,171107,0,0,0,24,1.0,41.67591253621684,1
2020-05-06-171107,171107,1,0,1,25,10.714285714285714,49.932775483347626,2
2020-05-07-171107,171107,0,0,0,25,4.142857142857143,86.83097196778924,3
2020-05-08-171107,171107,0,0,0,25,2.8571428571428568,110.39433627025899,4
2020-05-09-171107,171107,0,0,0,25,0.2857142857142857,140.12383852677908,5
2020-05-10-171107,171107,0,0,0,25,0.14285714285714285,94.13213095399998,6
2020-05-11-171107,171107,1,0,0,26,1.0,88.21149378820675,0
2020-05-12-171107,171107,0,0,0,26,4.142857142857143,96.20538674486686,1
2020-05-13-171107,171107,0,0,0,26,1.7142857142857142,87.9676475639636,2
2020-05-14-171107,171107,0,0,0,26,1.2857142857142858,93.73243907501416,3
2020-05-15-171107,171107,0,11,0,26,0.8571428571428571,84.77952745023315,4
2020-05-16-171107,171107,0,0,0,26,0.5714285714285714,83.0227679483269,5
2020-05-17-171107,171107,0,0,0,26,0.0,84.23859537111832,6
2020-05-18-171107,171107,0,0,0,26,2.142857142857143,84.92828938565788,0
2020-05-19-171107,171107,0,0,0,26,2.4285714285714284,83.3161994947111,1
2020-05-20-171107,171107,1,0,0,27,2.2857142857142856,64.26908852922102,2
2020-05-21-171107,171107,0,0,0,27,1.5714285714285714,70.78829138389744,3
2020-05-22-171107,171107,0,0,0,27,1.4285714285714286,86.65997371757972,4
2020-05-23-171107,171107,0,0,0,27,0.0,92.74518261373106,5
2020-05-24-171107,171107,0,0,0,27,0.14285714285714285,94.95105215620495,6
2020-05-25-171107,171107,0,0,0,27,0.0,83.23561187671379,0
2020-05-26-171107,171107,0,0,0,27,1.2857142857142858,75.14172991454251,1
2020-05-27-171107,171107,0,0,1,27,0.14285714285714285,86.88108017760102,2
2020-05-28-171107,171107,0,0,0,27,2.2857142857142856,78.07730041097838,3
2020-05-29-171107,171107,0,0,0,27,0.14285714285714285,56.48002646441024,4
2020-05-30-171107,171107,0,0,0,27,0.0,54.574931114427685,5
2020-05-31-171107,171107,0,0,0,27,0.0,55.33125389844446,6
2020-06-01-171107,171107,0,0,0,27,0.2857142857142857,185.0425160862629,0
2020-06-02-171107,171107,0,0,0,27,1.1428571428571428,18.548315057815337,1
2020-06-03-171107,171107,0,0,0,27,0.42857142857142855,9.66347195704003,2
2020-06-04-171107,171107,0,0,0,27,1.1428571428571428,12.235657904061956,3
2020-06-05-171107,171107,0,0,0,27,0.14285714285714285,20.42072519614279,4
2020-06-06-171107,171107,0,0,0,27,0.42857142857142855,19.539815730837777,5
2020-06-07-171107,171107,0,0,0,27,0.0,20.849289550915906,6
2020-06-08-171107,171107,0,0,0,27,0.2857142857142857,20.779022018673572,0
2020-06-09-171107,171107,0,0,0,27,0.42857142857142855,34.643573305578144,1
2020-06-10-171107,171107,1,0,0,28,0.8571428571428571,186.46722441116646,2
2020-06-11-171107,171107,0,0,0,28,0.0,157.97672197277507,3
2020-06-12-171107,171107,0,0,0,28,0.42857142857142855,149.80400923031635,4
2020-06-13-171107,171107,0,0,0,28,0.0,93.65424074315119,5
2020-06-14-171107,171107,0,4,0,28,0.0,57.77425133726847,6
2020-06-15-171107,171107,0,0,0,28,0.14285714285714285,28.530958479051527,0
2020-06-16-171107,171107,0,0,0,28,0.2857142857142857,28.984962846543965,1
2020-06-17-171107,171107,0,0,0,28,0.14285714285714285,28.38119435363847,2
2020-06-18-171107,171107,0,0,0,28,0.14285714285714285,22.516075949389652,3
2020-06-19-171107,171107,0,0,0,28,0.2857142857142857,13.860665743752934,4
2020-06-20-171107,171107,0,0,0,28,0.0,25.538474937797215,5
2020-06-21-171107,171107,0,0,0,28,0.0,26.04545437684179,6
2020-06-22-171107,171107,0,0,0,28,0.2857142857142857,20.68162794399839,0
2020-06-23-171107,171107,0,0,0,28,0.14285714285714285,20.61455670509892,1
2020-06-24-171107,171107,0,1,0,28,0.14285714285714285,22.148704942404194,2
2020-06-25-171107,171107,0,1,0,28,0.2857142857142857,22.071722318223486,3
2020-06-26-171107,171107,0,0,2,28,0.42857142857142855,13.548487123733029,4
2020-06-27-171107,171107,0,0,0,28,0.14285714285714285,11.452721751628594,5
2020-06-28-171107,171107,0,0,0,28,0.0,12.368731487921925,6
2020-06-29-171107,171107,0,0,0,28,0.14285714285714285,12.56975091124855,0
2020-06-30-171107,171107,0,0,0,28,0.2857142857142857,12.992295772351408,1
2020-07-01-171107,171107,0,0,0,28,0.0,43.18410052938299,2
2020-07-02-171107,171107,0,0,0,28,0.14285714285714285,3.8207980690942556,3
2020-07-03-171107,171107,0,0,0,28,0.14285714285714285,12.570849557943884,4
2020-07-04-171107,171107,0,0,0,28,0.0,19.961220054707784,5
2020-07-05-171107,171107,0,0,0,28,0.14285714285714285,20.138992631464617,6
2020-07-06-171107,171107,0,0,0,28,0.0,16.30584296587022,0
2020-07-07-171107,171107,0,0,0,28,0.0,20.20916534981324,1
2020-07-08-171107,171107,0,0,0,28,0.0,18.5155665750991,2
2020-07-09-171107,171107,0,3,0,28,0.14285714285714285,17.59515985638181,3
2020-07-10-171107,171107,2,1,0,30,0.2857142857142857,42.03893261276855,4
2020-07-11-171107,171107,0,0,0,30,0.0,38.86937291867223,5
2020-07-12-171107,171107,0,0,0,30,0.0,36.461791239005734,6
2020-07-13-171107,171107,0,0,0,30,0.0,34.14803044359239,0
2020-07-14-171107,171107,0,0,0,30,0.14285714285714285,34.61802559745791,1
2020-07-15-171107,171107,0,0,0,30,0.0,18.472949955177633,2
2020-07-16-171107,171107,0,0,0,30,0.0,11.565865594123625,3
2020-07-17-171107,171107,0,0,0,30,0.0,11.611807689779885,4
2020-07-18-171107,171107,0,0,0,30,0.0,4.012472814512206,5
2020-07-19-171107,171107,0,0,0,30,0.0,4.032648946976654,6
2020-07-20-171107,171107,0,0,0,30,0.2857142857142857,4.936741135128542,0
2020-07-21-171107,171107,0,0,0,30,0.2857142857142857,5.254651852230274,1
2020-07-22-171107,171107,0,0,0,30,0.0,6.140501537878713,2
2020-07-23-171107,171107,0,0,0,30,1.1428571428571428,6.537022147997581,3
2020-07-24-171107,171107,0,0,0,30,0.14285714285714285,10.177956568887884,4
2020-07-25-171107,171107,0,0,0,30,0.0,10.80480563521487,5
2020-07-26-171107,171107,0,0,1,30,0.0,10.5926095878322,6
2020-07-27-171107,171107,0,0,0,30,0.0,9.215723143196271,0
2020-07-28-171107,171107,0,0,3,30,0.14285714285714285,12.070516656383056,1
2020-07-29-171107,171107,0,0,0,30,0.42857142857142855,11.700037636985785,2
2020-07-30-171107,171107,0,0,0,30,0.0,9.754017877527957,3
2020-07-31-171107,171107,0,0,0,30,0.2857142857142857,10.969544005912134,4
2020-08-01-171107,171107,0,0,0,30,0.0,16.110663037658778,5
2020-08-02-171107,171107,0,0,0,30,0.0,116.16129057596679,6
2020-08-03-171107,171107,0,0,0,30,0.2857142857142857,124.52254755347298,0
2020-08-04-171107,171107,0,0,0,30,0.14285714285714285,109.7392732672125,1
2020-08-05-171107,171107,0,0,0,30,0.2857142857142857,83.92045555597306,2
2020-08-06-171107,171107,0,0,0,30,0.14285714285714285,64.77594319261415,3
2020-08-07-171107,171107,0,0,0,30,0.42857142857142855,55.729149363932336,4
2020-08-08-171107,171107,0,0,1,30,0.0,35.62443176622464,5
2020-08-09-171107,171107,1,0,0,31,0.5714285714285714,32.93700507018682,6
2020-08-10-171107,171107,0,0,2,31,0.2857142857142857,7.152669061320122,0
2020-08-11-171107,171107,3,0,0,34,0.5714285714285714,12.010143866352717,1
2020-08-12-171107,171107,0,0,2,34,0.42857142857142855,25.81003190408937,2
2020-08-13-171107,171107,0,0,3,34,1.2857142857142858,34.21966023005161,3
2020-08-14-171107,171107,0,0,0,34,1.1428571428571428,71.17294971289772,4
2020-08-15-171107,171107,0,0,8,34,1.0,88.35221150245395,5
2020-08-16-171107,171107,0,0,0,34,0.2857142857142857,93.8147008146156,6
2020-08-17-171107,171107,0,0,0,34,0.7142857142857143,96.67636744488867,0
2020-08-18-171107,171107,0,0,0,34,0.5714285714285714,98.67590975114496,1
2020-08-19-171107,171107,0,0,1,34,0.2857142857142857,122.29491415829716,2
2020-08-20-171107,171107,0,0,0,34,1.0,82.14518501057994,3
2020-08-21-171107,171107,0,0,0,34,1.4285714285714286,77.74487556696673,4
2020-08-22-171107,171107,1,0,0,35,0.14285714285714285,84.4354065107047,5
2020-08-23-171107,171107,0,0,0,35,0.14285714285714285,89.11555140002861,6
2020-08-24-171107,171107,2,0,4,37,0.7142857142857143,85.08261399620041,0
2020-08-25-171107,171107,0,0,1,37,0.5714285714285714,68.04074592735003,1
2020-08-26-171107,171107,2,0,0,39,1.0,69.91643579040698,2
2020-08-27-171107,171107,3,0,0,42,0.5714285714285714,97.47290410025539,3
2020-08-28-171107,171107,0,0,0,42,0.42857142857142855,104.42940292875569,4
2020-08-29-171107,171107,8,0,0,50,0.7142857142857143,100.64397191537088,5
2020-08-30-171107,171107,0,0,1,50,0.2857142857142857,125.07044011316685,6
2020-08-31-171107,171107,0,0,1,50,0.2857142857142857,107.47821144458663,0
2020-09-01-171107,171107,0,0,3,50,0.7142857142857143,34.54210253690475,1
2020-09-02-171107,171107,1,0,6,51,0.5714285714285714,444.20405150199133,2
2020-09-03-171107,171107,0,0,61,51,0.5714285714285714,216.4431361258638,3
2020-09-04-171107,171107,0,0,3,51,0.7142857142857143,176.58440076836666,4
2020-09-05-171107,171107,0,0,1,51,0.42857142857142855,162.30210842760795,5
2020-09-06-171107,171107,0,0,0,51,0.14285714285714285,143.87937829675644,6
2020-09-07-171107,171107,4,0,3,55,0.42857142857142855,109.53362122024936,0
2020-09-08-171107,171107,1,0,2,56,1.4285714285714286,121.49376960314184,1
2020-09-09-171107,171107,0,0,2,56,0.42857142857142855,130.69643032735866,2
2020-09-10-171107,171107,0,0,2,56,1.2857142857142858,44.666149778910736,3
2020-09-11-171107,171107,0,0,1,56,0.5714285714285714,83.29450094670766,4
2020-09-12-171107,171107,0,0,0,56,0.2857142857142857,107.63714907986255,5
2020-09-13-171107,171107,1,0,0,57,0.0,118.12351088423803,6
2020-09-14-171107,171107,1,0,0,58,0.42857142857142855,118.28031781097383,0
2020-09-15-171107,171107,3,0,0,61,1.0,143.18209201572924,1
2020-09-16-171107,171107,6,0,2,67,0.5714285714285714,163.95468556016448,2
2020-09-17-171107,171107,61,0,0,128,1.4285714285714286,190.10525745324725,3
2020-09-18-171107,171107,3,0,0,131,3.4285714285714284,363.31474411094644,4
2020-09-19-171107,171107,1,1,0,132,1.5714285714285714,396.0017162118358,5
2020-09-20-171107,171107,0,0,0,132,1.1428571428571428,411.6580092995486,6
2020-09-21-171107,171107,3,0,1,135,0.2857142857142857,389.7736957523241,0
2020-09-22-171107,171107,2,0,1,137,1.1428571428571428,384.3164023866774,1
2020-09-23-171107,171107,2,0,0,139,3.0,363.38644074212425,2
2020-09-24-171107,171107,2,1,1,141,3.571428571428572,195.09446261750716,3
2020-09-25-171107,171107,1,1,0,142,4.857142857142857,173.43164133474693,4
2020-09-26-171107,171107,0,1,0,142,2.8571428571428568,188.81223715052457,5
2020-09-27-171107,171107,0,1,0,142,2.0,187.58992616524836,6
2020-09-28-171107,171107,0,0,0,142,1.2857142857142858,215.08698761939334,0
2020-09-29-171107,171107,0,1,0,142,2.571428571428572,202.06078904308538,1
2020-09-30-171107,171107,2,0,1,144,3.2857142857142856,169.5445699227488,2
2020-10-01-171107,171107,0,0,0,144,1.4285714285714286,0.0,3
2020-10-02-171107,171107,0,1,0,144,3.7142857142857135,400.9220840018088,4
2020-10-03-171107,171107,0,1,0,144,0.7142857142857143,466.7319186018143,5
2020-10-04-171107,171107,0,0,0,144,1.0,464.30944562374975,6
2020-10-05-171107,171107,1,2,0,145,1.0,380.8677961089443,0
2020-10-06-171107,171107,1,0,1,146,3.1428571428571432,345.84944693856914,1
2020-10-07-171107,171107,0,1,1,146,2.0,311.2245284320456,2
2020-10-08-171107,171107,1,0,0,147,4.0,258.19661100970603,3
2020-10-09-171107,171107,0,0,0,147,3.0,286.7176619894165,4
2020-10-10-171107,171107,0,0,0,147,2.8571428571428568,18.1664898165178,5
2020-10-11-171107,171107,0,0,5,147,1.4285714285714286,40.65682944617423,6
2020-10-12-171107,171107,0,0,0,147,0.8571428571428571,63.79587465256894,0
2020-10-13-171107,171107,0,0,2,147,0.7142857142857143,75.3439793951527,1
2020-10-14-171107,171107,1,0,1,148,1.8571428571428568,89.27201410703982,2
2020-10-15-171107,171107,0,0,0,148,4.857142857142857,151.4152279520709,3
2020-10-16-171107,171107,0,0,2,148,2.7142857142857144,218.83014639404564,4
2020-10-17-171107,171107,0,0,0,148,2.4285714285714284,343.36817500154154,5
2020-10-18-171107,171107,0,1,6,148,1.0,357.88778905631136,6
2020-10-19-171107,171107,0,0,0,148,2.0,363.35506594522667,0
2020-10-20-171107,171107,1,1,1,149,4.285714285714286,417.925475887922,1
2020-10-21-171107,171107,1,1,1,150,6.571428571428571,459.51543141511723,2
2020-10-22-171107,171107,0,1,0,150,4.428571428571429,485.0994753134985,3
2020-10-23-171107,171107,0,0,0,150,6.571428571428571,406.1072128313251,4
2020-10-24-171107,171107,0,1,2,150,1.8571428571428568,469.0986410157007,5
2020-10-25-171107,171107,5,0,2,155,3.7142857142857135,463.9906173694477,6
2020-10-26-171107,171107,0,0,0,155,5.285714285714286,451.82109514338356,0
2020-10-27-171107,171107,2,0,1,157,3.4285714285714284,501.9633487588044,1
2020-10-28-171107,171107,1,0,0,158,6.428571428571429,442.2021614821814,2
2020-10-29-171107,171107,0,2,0,158,4.285714285714286,422.5842217674342,3
2020-10-30-171107,171107,2,0,0,160,12.0,338.19057070689894,4
2020-10-31-171107,171107,0,1,0,160,1.1428571428571428,448.5783113130759,5
2020-11-01-171107,171107,6,0,0,166,3.1428571428571432,159.49440250762774,6
2020-11-02-171107,171107,0,0,0,166,1.1428571428571428,273.1399331628927,0
2020-11-03-171107,171107,1,0,0,167,8.0,271.0524107302583,1
2020-11-04-171107,171107,1,0,0,168,7.571428571428571,335.3406297375453,2
2020-11-05-171107,171107,0,0,0,168,5.571428571428571,407.67899911692393,3
2020-11-06-171107,171107,0,0,0,168,4.571428571428571,429.70710403879235,4
2020-11-07-171107,171107,2,1,0,170,2.571428571428572,540.824012608811,5
2020-11-08-171107,171107,2,1,0,172,0.7142857142857143,510.0221026158007,6
2020-11-09-171107,171107,0,0,0,172,3.571428571428572,492.92364497365145,0
2020-11-10-171107,171107,1,0,0,173,4.857142857142857,176.55208571743873,1
2020-11-11-171107,171107,0,0,0,173,5.285714285714286,228.3867047208098,2
2020-11-12-171107,171107,0,0,0,173,4.571428571428571,284.89152257386183,3
2020-11-13-171107,171107,0,0,0,173,3.2857142857142856,299.2020395402388,4
2020-03-01-171108,171108,0,0,0,0,0.0,0.0,6
2020-03-02-171108,171108,0,0,1,0,0.0,4.025601411910198,0
2020-03-03-171108,171108,0,2,0,0,0.0,13.97688120533692,1
2020-03-04-171108,171108,0,2,0,0,0.0,15.904464446706235,2
2020-03-05-171108,171108,0,0,0,0,0.0,17.647849263223154,3
2020-03-06-171108,171108,0,0,0,0,0.0,12.939152664016305,4
2020-03-07-171108,171108,0,0,0,0,0.25,15.534736507948598,5
2020-03-08-171108,171108,0,0,0,0,0.0,17.848229302843535,6
2020-03-09-171108,171108,0,0,0,0,0.25,17.971515390608076,0
2020-03-10-171108,171108,0,0,0,0,0.0,156.21847648522404,1
2020-03-11-171108,171108,0,0,0,0,0.25,128.77842963294682,2
2020-03-12-171108,171108,0,0,0,0,0.75,98.91565307405712,3
2020-03-13-171108,171108,0,0,0,0,0.25,46.79455377283977,4
2020-03-14-171108,171108,0,0,0,0,0.25,41.250918612271775,5
2020-03-15-171108,171108,0,0,0,0,0.0,35.385829990382256,6
2020-03-16-171108,171108,1,0,0,1,0.75,9.157404478014497,0
2020-03-17-171108,171108,0,0,0,1,1.0,14.643072981628055,1
2020-03-18-171108,171108,0,0,0,1,1.75,17.630317300829862,2
2020-03-19-171108,171108,0,0,0,1,1.75,21.86633355055405,3
2020-03-20-171108,171108,0,2,0,1,0.5,23.606156705421387,4
2020-03-21-171108,171108,0,1,0,1,0.5,26.47576709327307,5
2020-03-22-171108,171108,0,0,0,1,0.0,25.928505741856576,6
2020-03-23-171108,171108,0,1,0,1,2.0,22.567887811384452,0
2020-03-24-171108,171108,0,0,0,1,0.25,26.854993214600725,1
2020-03-25-171108,171108,0,0,0,1,1.75,24.354458254209973,2
2020-03-26-171108,171108,0,0,0,1,0.75,25.324618979128143,3
2020-03-27-171108,171108,0,0,0,1,2.25,28.262746597645872,4
2020-03-28-171108,171108,0,0,0,1,0.25,30.890145351666643,5
2020-03-29-171108,171108,0,0,0,1,0.5,29.404417608205947,6
2020-03-30-171108,171108,0,0,1,1,1.25,22.02135758830377,0
2020-03-31-171108,171108,0,0,0,1,1.25,24.857213716322285,1
2020-04-01-171108,171108,0,0,0,1,2.0,4.12996245097937,2
2020-04-02-171108,171108,0,0,0,1,1.5,15.610589985675002,3
2020-04-03-171108,171108,0,0,0,1,1.5,14.254823277159621,4
2020-04-04-171108,171108,0,0,0,1,0.75,17.592655387576993,5
2020-04-05-171108,171108,0,0,0,1,0.5,18.564663195027414,6
2020-04-06-171108,171108,0,0,0,1,2.5,19.481139904854018,0
2020-04-07-171108,171108,0,0,0,1,0.75,20.743410623581205,1
2020-04-08-171108,171108,0,0,0,1,2.5,20.748054617097715,2
2020-04-09-171108,171108,0,0,0,1,0.75,21.24800374474441,3
2020-04-10-171108,171108,0,0,0,1,0.5,8.835131891278504,4
2020-04-11-171108,171108,0,0,0,1,0.75,9.333778624882386,5
2020-04-12-171108,171108,0,1,0,1,0.75,10.596627755378485,6
2020-04-13-171108,171108,1,0,0,2,1.0,11.298579064558618,0
2020-04-14-171108,171108,0,0,0,2,1.25,13.082915394579306,1
2020-04-15-171108,171108,0,0,0,2,0.25,15.30421461710995,2
2020-04-16-171108,171108,0,0,0,2,3.25,16.175638436396,3
2020-04-17-171108,171108,0,0,0,2,1.25,14.703114835488524,4
2020-04-18-171108,171108,0,0,0,2,0.25,17.63512692948592,5
2020-04-19-171108,171108,0,0,0,2,0.5,16.460675192274337,6
2020-04-20-171108,171108,0,0,0,2,0.75,17.037337288251535,0
2020-04-21-171108,171108,0,0,0,2,0.25,17.106332969145235,1
2020-04-22-171108,171108,0,0,0,2,0.0,17.71565520553363,2
2020-04-23-171108,171108,0,0,0,2,0.0,13.383473671859155,3
2020-04-24-171108,171108,0,0,0,2,0.75,10.452483123265209,4
2020-04-25-171108,171108,0,0,0,2,0.5,13.505271319550323,5
2020-04-26-171108,171108,0,0,0,2,0.0,13.311314437522887,6
2020-04-27-171108,171108,0,0,0,2,0.25,10.233459396975345,0
2020-04-28-171108,171108,0,0,0,2,0.75,12.926514597684847,1
2020-04-29-171108,171108,0,0,0,2,2.0,13.478233928080007,2
2020-04-30-171108,171108,0,0,1,2,1.75,18.976099566420118,3
2020-05-01-171108,171108,0,0,0,2,0.75,21.932883281058423,4
2020-05-02-171108,171108,0,0,0,2,0.5,15.7486878360179,5
2020-05-03-171108,171108,0,0,0,2,0.0,8.881260548517595,6
2020-05-04-171108,171108,0,0,0,2,0.25,6.794359911730536,0
2020-05-05-171108,171108,0,0,0,2,0.5,9.04561199133299,1
2020-05-06-171108,171108,0,0,0,2,1.0,13.708023675272777,2
2020-05-07-171108,171108,0,0,0,2,1.25,17.513649057357686,3
2020-05-08-171108,171108,0,0,0,2,0.5,20.523857909909957,4
2020-05-09-171108,171108,0,0,0,2,0.25,25.930201052847224,5
2020-05-10-171108,171108,0,0,0,2,0.0,21.40984253719831,6
2020-05-11-171108,171108,0,0,0,2,0.5,19.090236803920142,0
2020-05-12-171108,171108,0,0,1,2,1.5,21.00813535629151,1
2020-05-13-171108,171108,0,0,0,2,1.25,18.627110759159034,2
2020-05-14-171108,171108,1,1,0,3,0.0,20.725214926252725,3
2020-05-15-171108,171108,0,0,0,3,0.5,19.018820314802205,4
2020-05-16-171108,171108,0,0,0,3,0.75,20.16898139199328,5
2020-05-17-171108,171108,0,0,0,3,0.0,20.97527919747683,6
2020-05-18-171108,171108,0,0,0,3,0.75,21.5047573758461,0
2020-05-19-171108,171108,0,0,0,3,0.5,21.094795199740087,1
2020-05-20-171108,171108,0,1,0,3,0.5,17.320182526096474,2
2020-05-21-171108,171108,0,0,0,3,0.0,16.931903830937408,3
2020-05-22-171108,171108,0,0,0,3,0.0,19.662221606713643,4
2020-05-23-171108,171108,0,0,0,3,0.0,19.921785307748536,5
2020-05-24-171108,171108,0,0,0,3,0.25,20.22285426138788,6
2020-05-25-171108,171108,0,0,0,3,0.0,17.552128259365467,0
2020-05-26-171108,171108,1,0,0,4,1.75,16.262135523417925,1
2020-05-27-171108,171108,0,0,1,4,0.0,19.451883300264193,2
2020-05-28-171108,171108,0,1,0,4,0.25,19.38961884296515,3
2020-05-29-171108,171108,0,0,0,4,0.0,13.13434159493684,4
2020-05-30-171108,171108,0,0,0,4,0.0,14.342245568756168,5
2020-05-31-171108,171108,0,0,0,4,0.0,14.626419802836239,6
2020-06-01-171108,171108,0,0,0,4,0.0,37.62163142875019,0
2020-06-02-171108,171108,0,0,0,4,0.0,4.65935588554712,1
2020-06-03-171108,171108,0,0,0,4,0.0,2.186807827714623,2
2020-06-04-171108,171108,0,0,0,4,0.0,1.6986475675346142,3
2020-06-05-171108,171108,0,1,0,4,0.0,3.064819730749625,4
2020-06-06-171108,171108,0,0,0,4,0.25,2.7686114914446662,5
2020-06-07-171108,171108,0,0,0,4,0.0,3.0704924547175256,6
2020-06-08-171108,171108,0,0,0,4,0.0,3.016649296208887,0
2020-06-09-171108,171108,0,0,0,4,0.0,6.659933966756923,1
2020-06-10-171108,171108,1,0,0,5,0.5,37.58381456919018,2
2020-06-11-171108,171108,0,0,0,5,0.0,30.968368279981522,3
2020-06-12-171108,171108,0,0,0,5,0.25,25.582659736165272,4
2020-06-13-171108,171108,0,1,0,5,0.0,19.32341916354909,5
2020-06-14-171108,171108,0,0,0,5,0.0,13.732061974035943,6
2020-06-15-171108,171108,0,0,0,5,0.0,7.554097267976576,0
2020-06-16-171108,171108,0,0,0,5,0.0,7.318150467703626,1
2020-06-17-171108,171108,0,0,0,5,0.0,7.3952719973782415,2
2020-06-18-171108,171108,0,0,0,5,0.0,5.228926635428233,3
2020-06-19-171108,171108,0,0,0,5,0.25,3.012988395353604,4
2020-06-20-171108,171108,0,0,0,5,0.0,5.592261495063934,5
2020-06-21-171108,171108,0,0,0,5,0.0,6.164197871530364,6
2020-06-22-171108,171108,0,0,0,5,0.0,5.024844316698373,0
2020-06-23-171108,171108,0,0,0,5,0.0,5.066449706586255,1
2020-06-24-171108,171108,0,0,0,5,0.0,5.570854512183697,2
2020-06-25-171108,171108,0,0,0,5,0.0,5.592625804275337,3
2020-06-26-171108,171108,0,1,0,5,0.25,3.0724088766548783,4
2020-06-27-171108,171108,0,1,0,5,0.0,3.12791487284391,5
2020-06-28-171108,171108,0,0,0,5,0.0,2.8675997002392637,6
2020-06-29-171108,171108,0,0,0,5,0.0,2.915733531338729,0
2020-06-30-171108,171108,0,0,0,5,0.0,2.7414579679199322,1
2020-07-01-171108,171108,0,0,0,5,0.0,9.01119709087957,2
2020-07-02-171108,171108,0,0,0,5,0.0,0.8332452104924617,3
2020-07-03-171108,171108,0,0,0,5,0.25,1.77599911928244,4
2020-07-04-171108,171108,0,0,0,5,0.0,5.40357783550569,5
2020-07-05-171108,171108,0,0,0,5,0.0,5.465780669280378,6
2020-07-06-171108,171108,0,0,0,5,0.0,4.350373484940361,0
2020-07-07-171108,171108,0,0,0,5,0.0,5.448363164206488,1
2020-07-08-171108,171108,0,0,0,5,0.0,5.300236724973441,2
2020-07-09-171108,171108,0,0,0,5,0.0,4.742321129532662,3
2020-07-10-171108,171108,0,0,0,5,0.5,9.323893463473649,4
2020-07-11-171108,171108,0,0,0,5,0.0,8.764653716902236,5
2020-07-12-171108,171108,0,0,0,5,0.0,8.339217709679849,6
2020-07-13-171108,171108,0,0,0,5,0.0,7.9021054056323,0
2020-07-14-171108,171108,0,0,0,5,0.0,8.091526799517736,1
2020-07-15-171108,171108,0,0,0,5,0.0,3.5429023956371006,2
2020-07-16-171108,171108,0,0,0,5,0.0,1.9627284958489133,3
2020-07-17-171108,171108,0,0,0,5,0.0,2.015515321860886,4
2020-07-18-171108,171108,0,0,0,5,0.0,0.7963955787383266,5
2020-07-19-171108,171108,0,0,0,5,0.0,0.9489383846995277,6
2020-07-20-171108,171108,0,0,0,5,0.0,1.4506629305677268,0
2020-07-21-171108,171108,0,0,0,5,0.0,1.4289273112034047,1
2020-07-22-171108,171108,0,0,0,5,0.0,1.457202232080025,2
2020-07-23-171108,171108,0,0,0,5,0.0,1.6596614559468048,3
2020-07-24-171108,171108,0,0,0,5,0.0,1.6486351997477375,4
2020-07-25-171108,171108,0,0,0,5,0.0,1.553129990363553,5
2020-07-26-171108,171108,0,0,0,5,0.0,1.5430742895843739,6
2020-07-27-171108,171108,0,0,0,5,0.0,0.8438604242117402,0
2020-07-28-171108,171108,0,0,0,5,0.0,1.9340489642535625,1
2020-07-29-171108,171108,0,0,0,5,0.0,1.9738739136462766,2
2020-07-30-171108,171108,0,0,0,5,0.0,2.5002086925220595,3
2020-07-31-171108,171108,0,0,0,5,0.0,3.3882394483635343,4
2020-08-01-171108,171108,0,0,0,5,0.0,4.109193752263295,5
2020-08-02-171108,171108,0,0,0,5,0.0,36.56836428201909,6
2020-08-03-171108,171108,0,0,0,5,0.5,32.94428157825582,0
2020-08-04-171108,171108,0,0,0,5,0.0,25.690401270062125,1
2020-08-05-171108,171108,0,0,0,5,0.0,20.524739423815944,2
2020-08-06-171108,171108,0,0,0,5,0.0,17.40228583237854,3
2020-08-07-171108,171108,0,0,0,5,0.75,13.825295810412388,4
2020-08-08-171108,171108,0,0,0,5,0.0,10.823108377006694,5
2020-08-09-171108,171108,0,0,0,5,0.5,9.651069882108592,6
2020-08-10-171108,171108,0,0,0,5,0.25,1.7805603845575002,0
2020-08-11-171108,171108,0,0,0,5,0.75,3.0979563695124526,1
2020-08-12-171108,171108,0,0,0,5,0.25,5.636935253373071,2
2020-08-13-171108,171108,0,0,0,5,1.5,6.853825064796439,3
2020-08-14-171108,171108,0,0,0,5,1.0,17.788104309749603,4
2020-08-15-171108,171108,0,0,1,5,0.25,22.4686320102926,5
2020-08-16-171108,171108,0,0,0,5,0.25,23.753739566251305,6
2020-08-17-171108,171108,0,0,0,5,0.5,25.95621312748004,0
2020-08-18-171108,171108,0,0,0,5,0.25,27.34261374178306,1
2020-08-19-171108,171108,0,0,0,5,0.0,36.57005155865552,2
2020-08-20-171108,171108,0,0,1,5,0.0,26.989028904732855,3
2020-08-21-171108,171108,0,0,0,5,0.5,25.12184587691881,4
2020-08-22-171108,171108,0,0,0,5,0.25,29.854289547563887,5
2020-08-23-171108,171108,0,0,0,5,0.25,32.622794253753455,6
2020-08-24-171108,171108,0,0,0,5,1.25,31.263948298953853,0
2020-08-25-171108,171108,0,0,0,5,0.25,27.897579862666987,1
2020-08-26-171108,171108,0,0,0,5,1.0,28.510000630586475,2
2020-08-27-171108,171108,0,0,0,5,1.0,33.98778435539989,3
2020-08-28-171108,171108,0,0,0,5,0.0,34.487877513416485,4
2020-08-29-171108,171108,1,0,0,6,2.0,31.856511881929507,5
2020-08-30-171108,171108,0,0,0,6,0.0,32.12871523373262,6
2020-08-31-171108,171108,0,0,0,6,0.0,24.94858194049538,0
2020-09-01-171108,171108,0,0,0,6,0.25,9.215604409864603,1
2020-09-02-171108,171108,0,0,0,6,0.25,110.25288954911679,2
2020-09-03-171108,171108,1,0,2,7,0.5,69.97072390423841,3
2020-09-04-171108,171108,0,0,0,7,0.5,52.03419891163476,4
2020-09-05-171108,171108,0,0,0,7,0.5,45.48219082037962,5
2020-09-06-171108,171108,0,0,0,7,0.75,40.047265068845874,6
2020-09-07-171108,171108,0,0,0,7,1.5,32.10665906967381,0
2020-09-08-171108,171108,0,0,0,7,1.5,35.43848896664103,1
2020-09-09-171108,171108,0,0,0,7,0.0,43.74950929521812,2
2020-09-10-171108,171108,0,0,1,7,1.0,10.941668432078508,3
2020-09-11-171108,171108,0,0,0,7,0.0,22.933451951802127,4
2020-09-12-171108,171108,0,0,0,7,2.5,29.58538425113988,5
2020-09-13-171108,171108,0,0,0,7,0.25,36.48585804853727,6
2020-09-14-171108,171108,0,0,0,7,1.25,39.095701081311134,0
2020-09-15-171108,171108,0,0,0,7,2.0,47.6577614618521,1
2020-09-16-171108,171108,0,0,0,7,2.0,54.357291642517986,2
2020-09-17-171108,171108,2,0,0,9,16.0,60.24090181543568,3
2020-09-18-171108,171108,0,0,0,9,2.75,92.64737332646227,4
2020-09-19-171108,171108,0,1,0,9,0.5,100.27334565200526,5
2020-09-20-171108,171108,0,0,0,9,0.5,97.21570482015424,6
2020-09-21-171108,171108,0,0,0,9,2.0,91.8073749948374,0
2020-09-22-171108,171108,0,0,0,9,0.75,93.59044071313593,1
2020-09-23-171108,171108,0,0,0,9,1.5,91.4298465856493,2
2020-09-24-171108,171108,1,2,0,10,2.5,59.408830070838306,3
2020-09-25-171108,171108,0,0,0,10,1.75,61.14097503514989,4
2020-09-26-171108,171108,0,0,0,10,2.0,67.05182475340446,5
2020-09-27-171108,171108,0,0,0,10,2.25,67.85874684921423,6
2020-09-28-171108,171108,0,0,0,10,0.5,73.38199849511653,0
2020-09-29-171108,171108,0,0,0,10,0.25,66.58026842111082,1
2020-09-30-171108,171108,0,0,0,10,2.75,54.25425851875487,2
2020-10-01-171108,171108,0,0,0,10,0.0,0.0,3
2020-10-02-171108,171108,0,0,0,10,2.75,93.33377430609002,4
2020-10-03-171108,171108,0,2,0,10,0.25,134.40202096190004,5
2020-10-04-171108,171108,0,0,0,10,0.25,149.36397321668608,6
2020-10-05-171108,171108,0,0,2,10,0.25,125.68924690046391,0
2020-10-06-171108,171108,0,0,0,10,1.25,111.38322501919745,1
2020-10-07-171108,171108,0,0,1,10,0.5,101.75069862401227,2
2020-10-08-171108,171108,0,0,1,10,0.5,84.25913377026774,3
2020-10-09-171108,171108,0,0,0,10,0.25,86.5488769145605,4
2020-10-10-171108,171108,0,0,1,10,0.25,6.1239460013620715,5
2020-10-11-171108,171108,0,0,0,10,0.0,10.207358930974111,6
2020-10-12-171108,171108,0,0,0,10,0.5,15.915632463396854,0
2020-10-13-171108,171108,0,0,0,10,0.0,20.283544864131674,1
2020-10-14-171108,171108,0,0,1,10,1.5,22.988547411722415,2
2020-10-15-171108,171108,0,0,0,10,2.0,40.05945293898565,3
2020-10-16-171108,171108,0,0,2,10,0.75,52.43826440928016,4
2020-10-17-171108,171108,0,0,1,10,0.75,82.96535200672665,5
2020-10-18-171108,171108,0,0,5,10,0.75,84.22447699429077,6
2020-10-19-171108,171108,2,0,0,12,0.5,85.4550083783585,0
2020-10-20-171108,171108,0,0,19,12,1.75,98.72761935098231,1
2020-10-21-171108,171108,1,0,4,13,2.5,104.12455230407619,2
2020-10-22-171108,171108,1,0,0,14,2.25,111.34518478579034,3
2020-10-23-171108,171108,0,0,0,14,3.0,97.74272719241199,4
2020-10-24-171108,171108,1,0,0,15,1.75,114.40430467186494,5
2020-10-25-171108,171108,0,0,0,15,3.25,114.4738305415961,6
2020-10-26-171108,171108,0,0,2,15,2.75,110.76162638671173,0
2020-10-27-171108,171108,0,0,0,15,4.75,125.2463919410566,1
2020-10-28-171108,171108,1,0,2,16,2.75,121.10297693067284,2
2020-10-29-171108,171108,0,0,0,16,4.25,121.67439826354482,3
2020-10-30-171108,171108,2,0,0,18,7.25,104.40002308109015,4
2020-10-31-171108,171108,1,1,0,19,1.5,139.33311438229114,5
2020-11-01-171108,171108,5,0,0,24,2.0,38.63758715470472,6
2020-11-02-171108,171108,0,0,0,24,0.75,84.11231849975812,0
2020-11-03-171108,171108,19,0,0,43,1.25,82.90214298662454,1
2020-11-04-171108,171108,4,0,0,47,4.5,107.25251371568129,2
2020-11-05-171108,171108,0,0,0,47,4.25,124.6636959003647,3
2020-11-06-171108,171108,0,0,0,47,3.25,136.48279995355125,4
2020-11-07-171108,171108,0,1,0,47,2.5,172.07430755987144,5
2020-11-08-171108,171108,0,0,0,47,1.0,161.72464260538362,6
2020-11-09-171108,171108,2,0,0,49,1.5,155.6363118646856,0
2020-11-10-171108,171108,0,0,0,49,3.75,41.053737588148685,1
2020-11-11-171108,171108,2,0,0,51,2.5,56.1019210470797,2
2020-11-12-171108,171108,0,0,0,51,3.25,72.48664239003125,3
2020-11-13-171108,171108,0,0,0,51,2.25,76.55641757561024,4
2020-03-01-171109,171109,0,0,0,0,0.0,0.0,6
2020-03-02-171109,171109,0,0,0,0,0.0,6.486485650891966,0
2020-03-03-171109,171109,0,0,1,0,0.0,15.204764807797748,1
2020-03-04-171109,171109,0,0,0,0,0.0,16.02322992278916,2
2020-03-05-171109,171109,0,0,0,0,0.0,18.914387043836584,3
2020-03-06-171109,171109,0,0,1,0,0.0,14.192930384436266,4
2020-03-07-171109,171109,1,0,1,1,0.0,15.193832741346773,5
2020-03-08-171109,171109,0,0,0,1,0.0,20.426612838786,6
2020-03-09-171109,171109,0,0,1,1,0.2857142857142857,20.547940874711582,0
2020-03-10-171109,171109,0,0,0,1,0.14285714285714285,218.2684642385455,1
2020-03-11-171109,171109,0,0,0,1,0.0,189.51994201479945,2
2020-03-12-171109,171109,0,0,0,1,0.14285714285714285,143.60140316367156,3
2020-03-13-171109,171109,1,0,0,2,0.0,80.26341038306481,4
2020-03-14-171109,171109,1,0,0,3,0.0,66.83455811693446,5
2020-03-15-171109,171109,0,0,0,3,0.2857142857142857,59.0756127256979,6
2020-03-16-171109,171109,0,0,0,3,1.2857142857142858,14.076133153067804,0
2020-03-17-171109,171109,1,0,0,4,3.7142857142857135,16.718845868073203,1
2020-03-18-171109,171109,0,0,5,4,3.8571428571428568,28.774198329134194,2
2020-03-19-171109,171109,0,0,1,4,3.0,34.51756459701988,3
2020-03-20-171109,171109,1,0,4,5,2.4285714285714284,34.725734024118566,4
2020-03-21-171109,171109,1,0,1,6,1.4285714285714286,37.43547791078293,5
2020-03-22-171109,171109,0,0,0,6,0.5714285714285714,40.820853229243944,6
2020-03-23-171109,171109,1,1,0,7,5.428571428571429,38.13782425554187,0
2020-03-24-171109,171109,0,1,1,7,4.428571428571429,37.861023370070555,1
2020-03-25-171109,171109,0,0,0,7,3.7142857142857135,35.06849037342991,2
2020-03-26-171109,171109,0,0,0,7,1.8571428571428568,35.72872457827718,3
2020-03-27-171109,171109,0,0,0,7,2.8571428571428568,39.8404516114327,4
2020-03-28-171109,171109,0,0,0,7,0.8571428571428571,40.130334328115644,5
2020-03-29-171109,171109,0,0,0,7,1.0,35.05286191795122,6
2020-03-30-171109,171109,0,0,0,7,1.8571428571428568,26.450408738314287,0
2020-03-31-171109,171109,0,0,0,7,1.8571428571428568,25.68286670524979,1
2020-04-01-171109,171109,5,0,0,12,2.0,9.392919518433859,2
2020-04-02-171109,171109,1,0,0,13,2.4285714285714284,17.61847699889318,3
2020-04-03-171109,171109,4,0,1,17,1.0,18.207368853765,4
2020-04-04-171109,171109,1,0,0,18,0.5714285714285714,33.584673705811035,5
2020-04-05-171109,171109,0,0,0,18,0.2857142857142857,40.411911487957724,6
2020-04-06-171109,171109,0,0,0,18,3.2857142857142856,38.690555453788114,0
2020-04-07-171109,171109,1,0,0,19,1.7142857142857142,41.524971184140895,1
2020-04-08-171109,171109,0,0,0,19,1.4285714285714286,44.69719521205437,2
2020-04-09-171109,171109,0,0,0,19,0.42857142857142855,43.380433132314536,3
2020-04-10-171109,171109,0,0,0,19,1.7142857142857142,29.443546968586602,4
2020-04-11-171109,171109,0,2,0,19,0.5714285714285714,30.494040673590582,5
2020-04-12-171109,171109,0,0,0,19,3.571428571428572,30.074757825236045,6
2020-04-13-171109,171109,0,0,0,19,1.1428571428571428,30.947055313476937,0
2020-04-14-171109,171109,0,0,1,19,2.571428571428572,28.640769312227636,1
2020-04-15-171109,171109,0,0,0,19,0.2857142857142857,34.528595642174565,2
2020-04-16-171109,171109,0,0,0,19,0.7142857142857143,35.78760256483457,3
2020-04-17-171109,171109,1,0,0,20,0.42857142857142855,12.511958112090827,4
2020-04-18-171109,171109,0,0,0,20,0.0,17.027361654291624,5
2020-04-19-171109,171109,0,0,0,20,0.14285714285714285,17.04207045934017,6
2020-04-20-171109,171109,0,0,0,20,0.42857142857142855,27.061164951066978,0
2020-04-21-171109,171109,0,0,0,20,1.0,23.208088371338135,1
2020-04-22-171109,171109,0,0,1,20,0.5714285714285714,27.552920960640332,2
2020-04-23-171109,171109,0,0,0,20,0.2857142857142857,29.099220187734687,3
2020-04-24-171109,171109,0,0,0,20,5.428571428571429,24.390882235453574,4
2020-04-25-171109,171109,0,0,0,20,0.2857142857142857,29.632777398381624,5
2020-04-26-171109,171109,0,1,0,20,0.14285714285714285,29.33144040892138,6
2020-04-27-171109,171109,0,0,0,20,0.5714285714285714,18.39197020101017,0
2020-04-28-171109,171109,1,0,0,21,1.0,18.12710382058769,1
2020-04-29-171109,171109,0,0,0,21,1.0,18.036417134912313,2
2020-04-30-171109,171109,0,0,0,21,0.5714285714285714,40.08954067335183,3
2020-05-01-171109,171109,0,0,1,21,0.2857142857142857,30.833961569264336,4
2020-05-02-171109,171109,0,0,0,21,0.14285714285714285,27.92420213585788,5
2020-05-03-171109,171109,0,0,0,21,0.0,7.048523392898259,6
2020-05-04-171109,171109,0,0,1,21,0.8571428571428571,7.008279572147316,0
2020-05-05-171109,171109,0,0,0,21,1.4285714285714286,5.1691718552712445,1
2020-05-06-171109,171109,1,0,0,22,0.7142857142857143,6.819735041806696,2
2020-05-07-171109,171109,0,0,0,22,0.42857142857142855,11.178881897811724,3
2020-05-08-171109,171109,0,0,0,22,0.2857142857142857,14.337204056328583,4
2020-05-09-171109,171109,0,0,0,22,0.0,16.312515093655712,5
2020-05-10-171109,171109,0,0,0,22,0.42857142857142855,33.59472093200813,6
2020-05-11-171109,171109,0,0,0,22,0.42857142857142855,25.594696553457112,0
2020-05-12-171109,171109,0,0,0,22,1.2857142857142858,28.504966005496982,1
2020-05-13-171109,171109,0,1,0,22,1.0,29.25450288701462,2
2020-05-14-171109,171109,0,0,0,22,0.7142857142857143,21.34986585342978,3
2020-05-15-171109,171109,1,0,0,23,1.1428571428571428,20.826676056840117,4
2020-05-16-171109,171109,0,0,0,23,0.14285714285714285,30.396763097076406,5
2020-05-17-171109,171109,0,1,0,23,0.0,29.757639200093728,6
2020-05-18-171109,171109,1,0,0,24,1.0,29.106219513601907,0
2020-05-19-171109,171109,0,0,0,24,1.1428571428571428,36.85650192694878,1
2020-05-20-171109,171109,0,0,0,24,0.14285714285714285,31.989169373615574,2
2020-05-21-171109,171109,0,0,0,24,0.42857142857142855,30.106371454333445,3
2020-05-22-171109,171109,0,0,0,24,0.42857142857142855,18.4853215347158,4
2020-05-23-171109,171109,0,0,0,24,0.0,20.51176127882904,5
2020-05-24-171109,171109,0,0,0,24,0.0,20.945448774789632,6
2020-05-25-171109,171109,0,0,0,24,0.5714285714285714,9.918576464776573,0
2020-05-26-171109,171109,0,0,0,24,0.2857142857142857,6.3049706944430595,1
2020-05-27-171109,171109,0,2,0,24,0.2857142857142857,11.01466047831834,2
2020-05-28-171109,171109,0,0,0,24,0.5714285714285714,10.763960225603295,3
2020-05-29-171109,171109,0,1,0,24,0.7142857142857143,11.332173488974867,4
2020-05-30-171109,171109,0,0,0,24,0.0,11.033056633953876,5
2020-05-31-171109,171109,0,0,0,24,0.14285714285714285,11.464074923315284,6
2020-06-01-171109,171109,0,0,0,24,0.42857142857142855,23.843810549933654,0
2020-06-02-171109,171109,0,0,0,24,0.8571428571428571,1.8683264552062764,1
2020-06-03-171109,171109,0,0,0,24,0.42857142857142855,4.385712252825351,2
2020-06-04-171109,171109,0,0,0,24,0.8571428571428571,1.6043469401294006,3
2020-06-05-171109,171109,0,0,0,24,0.14285714285714285,2.9154791989683346,4
2020-06-06-171109,171109,0,0,0,24,0.0,3.1735342348230233,5
2020-06-07-171109,171109,0,0,0,24,0.0,3.2722184582822105,6
2020-06-08-171109,171109,0,0,0,24,0.0,3.3162305452455034,0
2020-06-09-171109,171109,0,0,0,24,0.14285714285714285,4.186422924702237,1
2020-06-10-171109,171109,0,0,0,24,0.7142857142857143,23.673404574106385,2
2020-06-11-171109,171109,0,0,0,24,0.0,21.758991320953875,3
2020-06-12-171109,171109,0,0,0,24,0.42857142857142855,19.806725102776163,4
2020-06-13-171109,171109,0,1,0,24,0.0,12.538613026030253,5
2020-06-14-171109,171109,0,4,0,24,0.0,5.67079902893469,6
2020-06-15-171109,171109,0,0,0,24,0.42857142857142855,4.060492400798147,0
2020-06-16-171109,171109,0,0,0,24,0.14285714285714285,4.171470399222953,1
2020-06-17-171109,171109,0,0,0,24,0.14285714285714285,3.6930717767635484,2
2020-06-18-171109,171109,0,0,0,24,0.14285714285714285,2.826135883506072,3
2020-06-19-171109,171109,0,0,0,24,0.0,2.3968241269890562,4
2020-06-20-171109,171109,0,0,0,24,0.0,5.193127768170003,5
2020-06-21-171109,171109,0,0,0,24,0.0,5.359925564692123,6
2020-06-22-171109,171109,0,0,0,24,0.2857142857142857,5.073911291964855,0
2020-06-23-171109,171109,0,0,0,24,0.2857142857142857,5.168474940972352,1
2020-06-24-171109,171109,0,1,0,24,0.42857142857142855,8.38496760722376,2
2020-06-25-171109,171109,0,0,0,24,0.2857142857142857,8.937151158294817,3
2020-06-26-171109,171109,0,1,0,24,0.14285714285714285,8.645319979510324,4
2020-06-27-171109,171109,0,0,0,24,0.0,5.843635774345484,5
2020-06-28-171109,171109,0,0,0,24,0.0,6.190116564370328,6
2020-06-29-171109,171109,0,0,0,24,0.2857142857142857,6.386296264573431,0
2020-06-30-171109,171109,0,0,0,24,0.14285714285714285,3.47850451690593,1
2020-07-01-171109,171109,0,0,0,24,0.0,6.889237344309572,2
2020-07-02-171109,171109,0,0,0,24,0.42857142857142855,0.8869080447651307,3
2020-07-03-171109,171109,0,0,0,24,0.2857142857142857,1.5078032149732614,4
2020-07-04-171109,171109,0,0,0,24,0.0,12.082226242742674,5
2020-07-05-171109,171109,0,0,0,24,0.0,12.272685484833012,6
2020-07-06-171109,171109,0,0,0,24,0.0,12.11847937599845,0
2020-07-07-171109,171109,0,0,0,24,0.0,12.188124228743286,1
2020-07-08-171109,171109,0,3,0,24,0.2857142857142857,11.709343436700063,2
2020-07-09-171109,171109,0,0,0,24,0.2857142857142857,11.408966798070061,3
2020-07-10-171109,171109,0,0,0,24,0.0,7.25583060999765,4
2020-07-11-171109,171109,0,0,0,24,0.0,5.70605036611473,5
2020-07-12-171109,171109,0,0,0,24,0.0,4.730565221384858,6
2020-07-13-171109,171109,0,0,0,24,0.14285714285714285,4.4824762482234854,0
2020-07-14-171109,171109,0,1,0,24,0.0,4.5875436110123875,1
2020-07-15-171109,171109,0,0,0,24,0.14285714285714285,2.868068448278339,2
2020-07-16-171109,171109,0,0,1,24,0.0,1.7814112808216005,3
2020-07-17-171109,171109,0,0,0,24,0.0,1.8043101707992806,4
2020-07-18-171109,171109,0,0,0,24,0.14285714285714285,1.026890129608636,5
2020-07-19-171109,171109,0,0,0,24,0.0,1.0793945182820153,6
2020-07-20-171109,171109,0,0,0,24,0.0,1.4245332060054998,0
2020-07-21-171109,171109,0,0,0,24,0.0,1.7758268869116136,1
2020-07-22-171109,171109,0,0,0,24,0.0,1.8236725233650706,2
2020-07-23-171109,171109,0,0,0,24,0.14285714285714285,1.8423177835800617,3
2020-07-24-171109,171109,0,0,0,24,0.14285714285714285,1.9467574840793576,4
2020-07-25-171109,171109,0,0,0,24,0.0,2.0618044524620993,5
2020-07-26-171109,171109,0,0,1,24,0.0,2.0366793317639313,6
2020-07-27-171109,171109,0,0,0,24,0.14285714285714285,1.5675336709552212,0
2020-07-28-171109,171109,0,0,0,24,0.0,1.5212938720297688,1
2020-07-29-171109,171109,0,0,0,24,0.0,1.6587984380047556,2
2020-07-30-171109,171109,1,0,0,25,0.0,3.9044192068181607,3
2020-07-31-171109,171109,0,0,0,25,0.2857142857142857,11.066313783796529,4
2020-08-01-171109,171109,0,0,0,25,0.14285714285714285,5.778836153000625,5
2020-08-02-171109,171109,0,0,2,25,0.14285714285714285,62.35547506847857,6
2020-08-03-171109,171109,0,0,0,25,0.14285714285714285,95.1896693520512,0
2020-08-04-171109,171109,0,0,0,25,0.0,79.69727946342186,1
2020-08-05-171109,171109,0,0,0,25,0.2857142857142857,74.09535075874354,2
2020-08-06-171109,171109,0,0,0,25,1.2857142857142858,72.14019826884936,3
2020-08-07-171109,171109,0,0,0,25,0.5714285714285714,55.539347223919066,4
2020-08-08-171109,171109,0,0,3,25,0.14285714285714285,65.36746920656728,5
2020-08-09-171109,171109,1,0,2,26,0.0,64.92015216599344,6
2020-08-10-171109,171109,0,0,1,26,0.0,5.367080380387963,0
2020-08-11-171109,171109,0,0,1,26,0.0,6.2765555669394,1
2020-08-12-171109,171109,0,0,0,26,0.8571428571428571,16.783523274255657,2
2020-08-13-171109,171109,0,0,1,26,0.0,19.705658864460986,3
2020-08-14-171109,171109,0,0,0,26,0.14285714285714285,22.391169789047456,4
2020-08-15-171109,171109,0,0,0,26,1.1428571428571428,23.928779505303638,5
2020-08-16-171109,171109,2,0,1,28,0.2857142857142857,30.0194318893698,6
2020-08-17-171109,171109,0,0,4,28,0.14285714285714285,46.98329358834873,0
2020-08-18-171109,171109,0,0,1,28,0.14285714285714285,48.659088157694654,1
2020-08-19-171109,171109,0,0,0,28,0.8571428571428571,41.21402060568197,2
2020-08-20-171109,171109,0,0,0,28,0.14285714285714285,64.42515248786917,3
2020-08-21-171109,171109,0,0,0,28,0.5714285714285714,87.98534590298826,4
2020-08-22-171109,171109,3,0,0,31,0.2857142857142857,137.32407407736432,5
2020-08-23-171109,171109,2,0,0,33,0.42857142857142855,166.32751681749943,6
2020-08-24-171109,171109,1,0,0,34,0.5714285714285714,171.60025720257175,0
2020-08-25-171109,171109,1,0,0,35,0.8571428571428571,200.79180781637302,1
2020-08-26-171109,171109,0,0,3,35,0.5714285714285714,201.79017625470442,2
2020-08-27-171109,171109,1,0,5,36,0.8571428571428571,204.6741534897869,3
2020-08-28-171109,171109,0,0,0,36,0.8571428571428571,180.85912367144016,4
2020-08-29-171109,171109,0,0,0,36,0.14285714285714285,141.91220209702112,5
2020-08-30-171109,171109,1,0,0,37,3.1428571428571432,87.00110535948066,6
2020-08-31-171109,171109,4,0,0,41,0.42857142857142855,69.68471849435328,0
2020-09-01-171109,171109,1,0,0,42,0.5714285714285714,90.8936418408347,1
2020-09-02-171109,171109,0,0,0,42,0.5714285714285714,214.50474762863297,2
2020-09-03-171109,171109,0,0,0,42,8.0,132.87137140965132,3
2020-09-04-171109,171109,0,0,0,42,2.142857142857143,167.53815008133222,4
2020-09-05-171109,171109,0,0,0,42,0.7142857142857143,174.00579025004703,5
2020-09-06-171109,171109,0,0,1,42,2.571428571428572,168.93031222083928,6
2020-09-07-171109,171109,0,0,0,42,1.1428571428571428,191.98320751417424,0
2020-09-08-171109,171109,0,1,6,42,3.571428571428572,192.30051273980416,1
2020-09-09-171109,171109,3,0,1,45,1.5714285714285714,230.86156371318657,2
2020-09-10-171109,171109,5,0,4,50,2.8571428571428568,52.60841124954578,3
2020-09-11-171109,171109,0,0,1,50,1.0,92.45871974620326,4
2020-09-12-171109,171109,0,0,0,50,1.5714285714285714,105.37028674592813,5
2020-09-13-171109,171109,0,0,0,50,0.42857142857142855,122.43473255061039,6
2020-09-14-171109,171109,0,1,1,50,0.7142857142857143,118.12014981548927,0
2020-09-15-171109,171109,0,0,2,50,3.2857142857142856,123.88121019989089,1
2020-09-16-171109,171109,0,0,0,50,0.7142857142857143,117.79165167052005,2
2020-09-17-171109,171109,0,0,0,50,5.857142857142858,147.5162472247062,3
2020-09-18-171109,171109,0,0,0,50,1.7142857142857142,164.61383481757173,4
2020-09-19-171109,171109,0,0,0,50,0.0,178.2436153998194,5
2020-09-20-171109,171109,1,0,0,51,0.7142857142857143,164.62030142575213,6
2020-09-21-171109,171109,0,0,1,51,2.7142857142857144,165.71096183437766,0
2020-09-22-171109,171109,6,1,1,57,2.8571428571428568,161.76798820441059,1
2020-09-23-171109,171109,1,0,1,58,0.5714285714285714,202.42394855404865,2
2020-09-24-171109,171109,4,1,3,62,1.5714285714285714,155.558732917784,3
2020-09-25-171109,171109,1,0,0,63,0.7142857142857143,168.80690366018524,4
2020-09-26-171109,171109,0,0,0,63,0.42857142857142855,185.92438328243134,5
2020-09-27-171109,171109,0,0,0,63,0.14285714285714285,182.66374198489206,6
2020-09-28-171109,171109,1,0,1,64,1.1428571428571428,177.74162997777546,0
2020-09-29-171109,171109,2,0,0,66,1.1428571428571428,171.47947397926595,1
2020-09-30-171109,171109,0,0,1,66,0.7142857142857143,168.0449028443419,2
2020-10-01-171109,171109,0,0,0,66,1.1428571428571428,0.0,3
2020-10-02-171109,171109,0,0,1,66,0.7142857142857143,111.26034874210279,4
2020-10-03-171109,171109,0,0,1,66,0.5714285714285714,335.43632537696885,5
2020-10-04-171109,171109,0,0,2,66,0.14285714285714285,375.7588794191332,6
2020-10-05-171109,171109,1,0,0,67,0.42857142857142855,330.10894427426854,0
2020-10-06-171109,171109,1,0,0,68,1.4285714285714286,230.44958362096264,1
2020-10-07-171109,171109,1,0,0,69,0.5714285714285714,198.8708670122333,2
2020-10-08-171109,171109,3,0,3,72,0.2857142857142857,179.27121846350053,3
2020-10-09-171109,171109,0,0,7,72,1.2857142857142858,196.99912036594708,4
2020-10-10-171109,171109,0,0,0,72,0.14285714285714285,10.74094526342072,5
2020-10-11-171109,171109,0,0,3,72,0.5714285714285714,13.934199776698247,6
2020-10-12-171109,171109,1,0,5,73,1.1428571428571428,18.19334658710309,0
2020-10-13-171109,171109,0,0,11,73,0.42857142857142855,33.08683565626428,1
2020-10-14-171109,171109,1,0,3,74,0.8571428571428571,36.9048626341744,2
2020-10-15-171109,171109,0,0,1,74,1.4285714285714286,54.428153655996724,3
2020-10-16-171109,171109,1,0,12,75,1.7142857142857142,69.04426774411974,4
2020-10-17-171109,171109,1,0,2,76,0.7142857142857143,78.26594865094874,5
2020-10-18-171109,171109,2,0,1,78,0.42857142857142855,82.33910151916814,6
2020-10-19-171109,171109,0,0,2,78,2.142857142857143,89.45232783182264,0
2020-10-20-171109,171109,0,0,1,78,1.4285714285714286,101.49165215407683,1
2020-10-21-171109,171109,0,0,1,78,2.571428571428572,97.289560103333,2
2020-10-22-171109,171109,3,0,1,81,1.5714285714285714,114.18806589260534,3
2020-10-23-171109,171109,7,0,5,88,3.571428571428572,125.31665298935671,4
2020-10-24-171109,171109,0,0,0,88,1.8571428571428568,161.18772639345468,5
2020-10-25-171109,171109,3,1,1,91,1.1428571428571428,160.52793030102686,6
2020-10-26-171109,171109,5,0,5,96,1.4285714285714286,161.47600617259764,0
2020-10-27-171109,171109,11,0,2,107,2.571428571428572,188.95556687788815,1
2020-10-28-171109,171109,3,0,1,110,2.7142857142857144,271.02635156936003,2
2020-10-29-171109,171109,1,0,0,111,2.4285714285714284,281.76168737608657,3
2020-10-30-171109,171109,12,0,0,123,5.285714285714286,237.9275757949232,4
2020-10-31-171109,171109,2,0,0,125,1.8571428571428568,318.9659881944781,5
2020-11-01-171109,171109,1,0,0,126,1.0,86.0956370780668,6
2020-11-02-171109,171109,2,1,0,128,1.4285714285714286,142.6726123636352,0
2020-11-03-171109,171109,1,0,0,129,0.42857142857142855,116.08010763794961,1
2020-11-04-171109,171109,1,0,0,130,2.2857142857142856,141.6820945269869,2
2020-11-05-171109,171109,1,0,0,131,6.857142857142858,161.20799792645295,3
2020-11-06-171109,171109,5,1,0,136,3.0,162.76847286217406,4
2020-11-07-171109,171109,0,0,0,136,1.1428571428571428,198.26448156518663,5
2020-11-08-171109,171109,1,0,0,137,1.0,182.33271688415215,6
2020-11-09-171109,171109,5,0,0,142,1.5714285714285714,173.08106114143624,0
2020-11-10-171109,171109,2,0,0,144,2.571428571428572,78.60487428062935,1
2020-11-11-171109,171109,1,0,0,145,0.8571428571428571,101.12230175643509,2
2020-11-12-171109,171109,0,0,0,145,1.7142857142857142,115.47322714863634,3
2020-11-13-171109,171109,0,0,0,145,3.1428571428571432,116.93598070027332,4
2020-03-01-171110,171110,0,0,0,0,0.0,0.0,6
2020-03-02-171110,171110,0,0,0,0,0.25,11.124382979299263,0
2020-03-03-171110,171110,0,0,0,0,0.0,42.64363359617278,1
2020-03-04-171110,171110,0,0,2,0,0.0,45.398873966086384,2
2020-03-05-171110,171110,0,0,2,0,0.0,48.912558778316765,3
2020-03-06-171110,171110,0,0,1,0,0.0,38.28608878569813,4
2020-03-07-171110,171110,0,0,1,0,0.25,43.5442312263135,5
2020-03-08-171110,171110,0,0,4,0,0.0,47.83910304809255,6
2020-03-09-171110,171110,0,0,7,0,0.25,47.5590949285434,0
2020-03-10-171110,171110,0,0,1,0,0.0,295.944015579151,1
2020-03-11-171110,171110,0,0,2,0,1.0,250.37887880330192,2
2020-03-12-171110,171110,0,0,1,0,0.75,195.25002171398677,3
2020-03-13-171110,171110,2,0,0,2,0.75,86.27362974298026,4
2020-03-14-171110,171110,0,0,0,2,0.25,83.60384950864872,5
2020-03-15-171110,171110,0,0,1,2,0.25,74.77169426166255,6
2020-03-16-171110,171110,0,0,2,2,1.75,26.3749189192623,0
2020-03-17-171110,171110,0,0,0,2,0.5,38.73975115805597,1
2020-03-18-171110,171110,2,0,4,4,2.25,44.197143768931326,2
2020-03-19-171110,171110,2,0,0,6,2.5,52.55217966111661,3
2020-03-20-171110,171110,1,0,0,7,2.75,55.69891968462249,4
2020-03-21-171110,171110,1,0,0,8,1.5,64.66792109286948,5
2020-03-22-171110,171110,4,0,1,12,1.5,62.869460498701464,6
2020-03-23-171110,171110,7,0,3,19,3.0,60.68358153410919,0
2020-03-24-171110,171110,1,0,1,20,2.5,79.38142721664369,1
2020-03-25-171110,171110,2,0,1,22,4.0,78.30770731543373,2
2020-03-26-171110,171110,1,0,0,23,3.0,83.23543185768264,3
2020-03-27-171110,171110,0,0,0,23,4.25,92.40159561000385,4
2020-03-28-171110,171110,0,0,3,23,0.5,97.45544720475647,5
2020-03-29-171110,171110,1,0,1,24,0.75,95.88926022997876,6
2020-03-30-171110,171110,2,0,1,26,3.25,66.38952456715151,0
2020-03-31-171110,171110,0,0,0,26,1.5,72.43144305351578,1
2020-04-01-171110,171110,4,0,1,30,2.5,9.540590886537327,2
2020-04-02-171110,171110,0,0,1,30,1.0,42.002802096572545,3
2020-04-03-171110,171110,0,0,2,30,1.25,35.234868644844425,4
2020-04-04-171110,171110,0,0,1,30,0.5,40.74959688825405,5
2020-04-05-171110,171110,1,0,0,31,0.25,40.84513534790419,6
2020-04-06-171110,171110,3,2,0,34,1.75,43.30092105908172,0
2020-04-07-171110,171110,1,0,2,35,0.5,46.67938614113315,1
2020-04-08-171110,171110,1,0,1,36,0.75,45.9631228510911,2
2020-04-09-171110,171110,0,0,0,36,0.5,48.01364523243538,3
2020-04-10-171110,171110,0,0,1,36,1.0,16.88827347345304,4
2020-04-11-171110,171110,3,0,0,39,0.5,19.752127580030518,5
2020-04-12-171110,171110,1,0,0,40,0.0,25.131932631885242,6
2020-04-13-171110,171110,1,0,0,41,0.25,27.60075334461286,0
2020-04-14-171110,171110,0,0,0,41,0.75,31.795704458782254,1
2020-04-15-171110,171110,1,0,0,42,1.75,36.97501272873221,2
2020-04-16-171110,171110,1,0,0,43,2.5,41.970535886387324,3
2020-04-17-171110,171110,2,0,0,45,2.75,39.9385258938467,4
2020-04-18-171110,171110,1,0,0,46,0.0,47.36235096709372,5
2020-04-19-171110,171110,0,0,0,46,0.5,42.09402439329696,6
2020-04-20-171110,171110,0,0,6,46,1.25,40.81623978637511,0
2020-04-21-171110,171110,2,0,2,48,1.25,42.25515834578057,1
2020-04-22-171110,171110,1,0,1,49,1.25,42.10890800739831,2
2020-04-23-171110,171110,0,0,0,49,0.25,37.84145720656912,3
2020-04-24-171110,171110,1,0,1,50,1.5,27.745594824090453,4
2020-04-25-171110,171110,0,0,1,50,0.5,36.26077074768489,5
2020-04-26-171110,171110,0,0,0,50,0.0,37.25060914146874,6
2020-04-27-171110,171110,0,0,0,50,3.0,31.288389937473333,0
2020-04-28-171110,171110,0,0,1,50,1.0,38.447802153059556,1
2020-04-29-171110,171110,0,0,3,50,0.25,36.021414587658825,2
2020-04-30-171110,171110,0,0,2,50,1.75,41.264844765745266,3
2020-05-01-171110,171110,0,0,4,50,0.25,49.17454196816814,4
2020-05-02-171110,171110,0,0,0,50,0.5,36.52668020539552,5
2020-05-03-171110,171110,0,0,0,50,0.75,22.453088686709677,6
2020-05-04-171110,171110,6,0,0,56,2.25,16.035606677884658,0
2020-05-05-171110,171110,2,0,1,58,4.0,31.66338205647199,1
2020-05-06-171110,171110,1,0,0,59,0.5,45.268676828416034,2
2020-05-07-171110,171110,0,0,1,59,1.5,56.87598240391962,3
2020-05-08-171110,171110,1,0,0,60,2.75,64.65369782925808,4
2020-05-09-171110,171110,1,0,0,61,0.75,76.149767895373,5
2020-05-10-171110,171110,0,0,0,61,0.0,47.43194822125591,6
2020-05-11-171110,171110,0,0,1,61,1.25,43.76245155522639,0
2020-05-12-171110,171110,1,2,1,62,1.5,46.909359363799325,1
2020-05-13-171110,171110,3,0,0,65,1.75,39.46582002526503,2
2020-05-14-171110,171110,2,0,0,67,0.75,45.165073997842875,3
2020-05-15-171110,171110,4,0,0,71,0.5,41.84699825761125,4
2020-05-16-171110,171110,0,0,0,71,0.25,45.67834135542525,5
2020-05-17-171110,171110,0,0,0,71,0.0,46.99269057393414,6
2020-05-18-171110,171110,0,0,0,71,0.25,47.78547420613929,0
2020-05-19-171110,171110,1,0,0,72,2.0,44.57750248706137,1
2020-05-20-171110,171110,0,0,0,72,0.25,34.289611559277176,2
2020-05-21-171110,171110,1,0,0,73,2.25,33.488306027768274,3
2020-05-22-171110,171110,0,0,0,73,0.25,43.094423702515485,4
2020-05-23-171110,171110,0,0,0,73,0.0,45.3944466526922,5
2020-05-24-171110,171110,0,1,0,73,0.0,46.56015205389007,6
2020-05-25-171110,171110,1,0,0,74,1.5,43.358463999801124,0
2020-05-26-171110,171110,1,0,0,75,0.5,41.382950960637835,1
2020-05-27-171110,171110,0,1,0,75,0.5,48.65080797308681,2
2020-05-28-171110,171110,0,0,1,75,0.5,48.98112899113258,3
2020-05-29-171110,171110,0,0,0,75,0.5,32.91382025396823,4
2020-05-30-171110,171110,0,0,0,75,0.0,35.90624053604932,5
2020-05-31-171110,171110,0,0,0,75,0.0,36.86483875819102,6
2020-06-01-171110,171110,0,0,0,75,0.0,104.8751970536965,0
2020-06-02-171110,171110,0,0,0,75,0.5,12.254184036256405,1
2020-06-03-171110,171110,0,0,0,75,0.75,8.03786199784369,2
2020-06-04-171110,171110,0,0,0,75,0.25,8.350648004051255,3
2020-06-05-171110,171110,0,0,1,75,0.5,10.234685282568286,4
2020-06-06-171110,171110,0,1,0,75,0.0,11.262471509284978,5
2020-06-07-171110,171110,0,0,0,75,0.0,11.495432029607404,6
2020-06-08-171110,171110,0,0,0,75,1.25,10.220530443383645,0
2020-06-09-171110,171110,0,0,0,75,0.25,18.458771150618283,1
2020-06-10-171110,171110,0,0,0,75,0.25,105.82580914075403,2
2020-06-11-171110,171110,1,0,0,76,0.75,76.61413261190893,3
2020-06-12-171110,171110,0,0,1,76,0.25,63.68665269501567,4
2020-06-13-171110,171110,0,0,0,76,0.0,46.35925179389653,5
2020-06-14-171110,171110,0,0,0,76,0.0,31.685556926275424,6
2020-06-15-171110,171110,0,0,0,76,0.5,17.85658506584806,0
2020-06-16-171110,171110,0,0,0,76,0.0,15.214875664183513,1
2020-06-17-171110,171110,0,0,0,76,0.25,15.114771116712296,2
2020-06-18-171110,171110,0,0,0,76,0.25,13.98114348670238,3
2020-06-19-171110,171110,1,0,0,77,0.25,6.5812842787487735,4
2020-06-20-171110,171110,0,0,0,77,0.25,15.159998799915158,5
2020-06-21-171110,171110,0,0,0,77,0.0,15.953500751373674,6
2020-06-22-171110,171110,0,0,0,77,0.0,13.748296863052511,0
2020-06-23-171110,171110,0,0,0,77,0.25,14.072204761596607,1
2020-06-24-171110,171110,0,0,0,77,0.25,14.509678459970711,2
2020-06-25-171110,171110,0,0,0,77,0.5,14.759377232557341,3
2020-06-26-171110,171110,1,1,0,78,0.0,9.413135802163046,4
2020-06-27-171110,171110,0,0,0,78,0.0,7.5300393480439505,5
2020-06-28-171110,171110,0,0,0,78,0.0,7.283857662179857,6
2020-06-29-171110,171110,0,0,0,78,0.0,8.5281593021695,0
2020-06-30-171110,171110,0,1,0,78,0.0,9.81902818551571,1
2020-07-01-171110,171110,0,0,0,78,0.0,21.552344135378647,2
2020-07-02-171110,171110,0,0,0,78,0.25,8.84004660427562,3
2020-07-03-171110,171110,0,0,0,78,0.0,5.922624915294107,4
2020-07-04-171110,171110,0,0,1,78,0.25,15.163582562997465,5
2020-07-05-171110,171110,0,0,0,78,0.0,16.203728374873098,6
2020-07-06-171110,171110,0,0,0,78,0.25,12.761273739213713,0
2020-07-07-171110,171110,0,0,0,78,0.0,15.019335817048196,1
2020-07-08-171110,171110,0,0,1,78,0.0,13.754157864067665,2
2020-07-09-171110,171110,0,0,0,78,0.0,13.458040153669963,3
2020-07-10-171110,171110,0,0,0,78,0.5,21.76119870196314,4
2020-07-11-171110,171110,0,0,0,78,0.0,19.793386188323055,5
2020-07-12-171110,171110,0,0,0,78,0.0,17.533709246916448,6
2020-07-13-171110,171110,0,0,0,78,0.5,17.2483832494024,0
2020-07-14-171110,171110,0,0,0,78,0.75,19.51955931297507,1
2020-07-15-171110,171110,0,0,0,78,0.0,11.145438700317351,2
2020-07-16-171110,171110,0,0,1,78,0.25,7.940576034567685,3
2020-07-17-171110,171110,0,0,0,78,0.25,8.995631179944866,4
2020-07-18-171110,171110,1,0,0,79,0.0,7.656480748003812,5
2020-07-19-171110,171110,0,0,0,79,0.0,9.704938057916038,6
2020-07-20-171110,171110,0,0,0,79,0.0,8.134543396384565,0
2020-07-21-171110,171110,0,0,0,79,0.0,6.043099609859301,1
2020-07-22-171110,171110,1,0,0,80,0.0,6.260920866544069,2
2020-07-23-171110,171110,0,0,0,80,0.0,7.380273620789831,3
2020-07-24-171110,171110,0,0,0,80,0.0,6.395736276577938,4
2020-07-25-171110,171110,0,0,0,80,0.0,4.629185968518077,5
2020-07-26-171110,171110,0,0,0,80,0.0,4.609792844029582,6
2020-07-27-171110,171110,0,0,0,80,0.5,3.6153292724810915,0
2020-07-28-171110,171110,0,0,0,80,0.0,7.071874859466144,1
2020-07-29-171110,171110,0,1,0,80,0.25,6.934527435456199,2
2020-07-30-171110,171110,1,0,1,81,0.25,6.264260830487318,3
2020-07-31-171110,171110,0,0,0,81,0.5,10.610511597450145,4
2020-08-01-171110,171110,0,0,0,81,0.0,9.8048651718201,5
2020-08-02-171110,171110,0,0,0,81,0.0,67.5770257865999,6
2020-08-03-171110,171110,0,0,0,81,0.25,41.69478811757795,0
2020-08-04-171110,171110,0,0,0,81,0.0,32.997271912402255,1
2020-08-05-171110,171110,0,0,0,81,0.0,27.344850583959733,2
2020-08-06-171110,171110,0,0,0,81,0.0,22.719887189149535,3
2020-08-07-171110,171110,0,0,0,81,0.5,17.199679833046034,4
2020-08-08-171110,171110,0,0,0,81,0.0,20.08482786828375,5
2020-08-09-171110,171110,0,0,0,81,0.0,16.9002433204066,6
2020-08-10-171110,171110,0,0,0,81,0.0,4.597365138680823,0
2020-08-11-171110,171110,0,0,0,81,0.5,6.633956408729256,1
2020-08-12-171110,171110,0,0,0,81,0.5,8.63686644418797,2
2020-08-13-171110,171110,1,0,0,82,0.25,11.093754524923016,3
2020-08-14-171110,171110,0,0,0,82,0.0,34.495527435030795,4
2020-08-15-171110,171110,0,0,0,82,0.0,42.747822135670404,5
2020-08-16-171110,171110,0,0,0,82,0.25,44.22875404302982,6
2020-08-17-171110,171110,0,0,0,82,0.75,46.635280439125516,0
2020-08-18-171110,171110,0,0,0,82,3.0,47.32054748876705,1
2020-08-19-171110,171110,0,0,0,82,0.25,68.70275101265858,2
2020-08-20-171110,171110,0,0,0,82,1.5,43.464908597779896,3
2020-08-21-171110,171110,0,0,2,82,0.75,40.9960396946868,4
2020-08-22-171110,171110,0,0,0,82,0.25,47.511687467829915,5
2020-08-23-171110,171110,0,0,0,82,0.75,47.407322623164845,6
2020-08-24-171110,171110,0,0,1,82,0.75,45.75437781073361,0
2020-08-25-171110,171110,0,0,7,82,0.5,33.925049812183204,1
2020-08-26-171110,171110,0,0,2,82,0.75,35.742730703280884,2
2020-08-27-171110,171110,0,0,0,82,0.0,41.180266725787774,3
2020-08-28-171110,171110,0,0,0,82,0.5,40.961781147933394,4
2020-08-29-171110,171110,0,0,0,82,0.25,39.62759438535533,5
2020-08-30-171110,171110,0,0,1,82,0.0,41.22293391681069,6
2020-08-31-171110,171110,0,0,1,82,0.75,30.159657433339156,0
2020-09-01-171110,171110,0,0,0,82,1.5,16.27027849973785,1
2020-09-02-171110,171110,0,0,0,82,1.5,124.76336167282201,2
2020-09-03-171110,171110,0,0,0,82,0.0,132.17743716910906,3
2020-09-04-171110,171110,2,0,1,84,1.0,98.67142777652698,4
2020-09-05-171110,171110,0,0,0,84,0.25,90.15770908852133,5
2020-09-06-171110,171110,0,0,1,84,0.25,75.34662595013094,6
2020-09-07-171110,171110,1,0,32,85,2.5,52.0706840998463,0
2020-09-08-171110,171110,7,0,1,92,1.0,54.07483352085346,1
2020-09-09-171110,171110,2,0,1,94,0.25,68.48500020396256,2
2020-09-10-171110,171110,0,0,4,94,1.5,21.845765825516967,3
2020-09-11-171110,171110,0,0,3,94,1.0,40.37672521742151,4
2020-09-12-171110,171110,0,0,3,94,0.75,52.74798908551854,5
2020-09-13-171110,171110,1,0,4,95,1.75,57.76619855820054,6
2020-09-14-171110,171110,1,0,1,96,1.0,59.74257754994906,0
2020-09-15-171110,171110,0,0,2,96,0.75,76.49820246418673,1
2020-09-16-171110,171110,0,0,0,96,1.0,85.59598157655235,2
2020-09-17-171110,171110,0,0,3,96,1.25,91.10920562114836,3
2020-09-18-171110,171110,1,0,4,97,3.5,99.13693763496497,4
2020-09-19-171110,171110,0,0,9,97,2.5,111.85569488066417,5
2020-09-20-171110,171110,1,0,1,98,2.0,117.5113071437296,6
2020-09-21-171110,171110,32,0,0,130,0.0,111.64490857003732,0
2020-09-22-171110,171110,1,1,3,131,1.0,164.03853795749671,1
2020-09-23-171110,171110,1,0,1,132,2.25,154.44652444402254,2
2020-09-24-171110,171110,4,0,1,136,3.25,142.64372636873497,3
2020-09-25-171110,171110,3,0,0,139,3.75,146.4096350164465,4
2020-09-26-171110,171110,3,1,1,142,1.0,156.23653215470708,5
2020-09-27-171110,171110,4,0,0,146,1.75,163.14108710680435,6
2020-09-28-171110,171110,1,0,0,147,1.5,175.45381676902832,0
2020-09-29-171110,171110,2,1,3,149,0.75,121.31135872360856,1
2020-09-30-171110,171110,0,1,0,149,1.25,107.97855870079837,2
2020-10-01-171110,171110,3,0,2,152,1.5,0.0,3
2020-10-02-171110,171110,4,0,1,156,1.25,216.92016564155477,4
2020-10-03-171110,171110,9,1,0,165,2.0,220.97562906320377,5
2020-10-04-171110,171110,1,1,0,166,0.5,261.1925548241143,6
2020-10-05-171110,171110,0,0,1,166,2.5,222.37330120742672,0
2020-10-06-171110,171110,3,0,1,169,2.5,205.77100212503947,1
2020-10-07-171110,171110,1,0,37,170,1.25,192.08593002202838,2
2020-10-08-171110,171110,1,0,37,171,2.0,165.78567244093213,3
2020-10-09-171110,171110,0,1,2,171,1.25,158.89788240711204,4
2020-10-10-171110,171110,1,0,2,172,1.75,15.471698280964453,5
2020-10-11-171110,171110,0,0,1,172,1.25,27.819274666253794,6
2020-10-12-171110,171110,0,0,1,172,0.75,40.975797347814336,0
2020-10-13-171110,171110,3,0,1,175,0.5,45.42967952346385,1
2020-10-14-171110,171110,0,0,3,175,2.75,58.11782572604036,2
2020-10-15-171110,171110,2,0,1,177,2.25,94.61352481404957,3
2020-10-16-171110,171110,1,0,3,178,6.75,122.19479916441807,4
2020-10-17-171110,171110,0,1,4,178,2.5,190.68801014505584,5
2020-10-18-171110,171110,0,0,2,178,1.5,187.2239292170798,6
2020-10-19-171110,171110,1,2,0,179,3.25,187.2906203916453,0
2020-10-20-171110,171110,1,0,5,180,9.5,216.4478187607353,1
2020-10-21-171110,171110,37,0,0,217,2.5,231.03555602159213,2
2020-10-22-171110,171110,37,1,6,254,2.75,275.714991414314,3
2020-10-23-171110,171110,2,0,2,256,6.0,289.4840464487907,4
2020-10-24-171110,171110,2,1,1,258,1.75,311.13435783374996,5
2020-10-25-171110,171110,1,1,0,259,1.0,307.6567469510295,6
2020-10-26-171110,171110,1,0,1,260,5.5,288.35902263133676,0
2020-10-27-171110,171110,1,3,3,261,3.75,303.902541010115,1
2020-10-28-171110,171110,3,0,0,264,3.5,287.19348414421114,2
2020-10-29-171110,171110,1,0,1,265,3.25,251.10968151117265,3
2020-10-30-171110,171110,3,0,0,268,9.0,169.8288740208414,4
2020-10-31-171110,171110,4,0,0,272,1.0,224.49162701684992,5
2020-11-01-171110,171110,2,2,0,274,1.25,85.04146604213871,6
2020-11-02-171110,171110,0,0,0,274,1.25,135.72829920451133,0
2020-11-03-171110,171110,5,1,0,279,3.5,140.34238669745133,1
2020-11-04-171110,171110,0,0,0,279,6.5,171.9584947110551,2
2020-11-05-171110,171110,6,2,0,285,5.0,201.874912551006,3
2020-11-06-171110,171110,2,0,0,287,15.5,229.04973408367783,4
2020-11-07-171110,171110,1,1,0,288,1.5,301.20482971536717,5
2020-11-08-171110,171110,0,0,0,288,1.5,276.3182661743875,6
2020-11-09-171110,171110,1,1,0,289,4.5,268.3455755783092,0
2020-11-10-171110,171110,3,0,0,292,3.0,85.13420850566415,1
2020-11-11-171110,171110,0,1,0,292,6.0,109.06962647025712,2
2020-11-12-171110,171110,1,1,0,293,2.25,132.64438325259104,3
2020-11-13-171110,171110,0,2,0,293,4.0,135.5925845966463,4
2020-03-01-171111,171111,0,0,0,0,0.0,0.0,6
2020-03-02-171111,171111,0,0,2,0,0.3333333333333333,5.642829372672038,0
2020-03-03-171111,171111,0,1,11,0,0.3333333333333333,23.380936219557796,1
2020-03-04-171111,171111,0,0,12,0,0.0,27.846004644665072,2
2020-03-05-171111,171111,1,0,14,1,0.3333333333333333,30.510890242364685,3
2020-03-06-171111,171111,0,0,15,1,0.3333333333333333,22.90495818245082,4
2020-03-07-171111,171111,0,0,4,1,0.3333333333333333,27.24121498693504,5
2020-03-08-171111,171111,0,0,1,1,0.3333333333333333,32.03794619174524,6
2020-03-09-171111,171111,1,0,19,2,0.3333333333333333,32.10164453329739,0
2020-03-10-171111,171111,0,1,13,2,0.0,277.7444564532568,1
2020-03-11-171111,171111,1,0,12,3,0.6666666666666666,233.80438538429246,2
2020-03-12-171111,171111,0,0,6,3,1.6666666666666667,188.7352578687929,3
2020-03-13-171111,171111,0,0,15,3,1.0,79.10831792535082,4
2020-03-14-171111,171111,0,0,1,3,0.3333333333333333,75.1705762762302,5
2020-03-15-171111,171111,0,0,4,3,0.3333333333333333,66.60096820769837,6
2020-03-16-171111,171111,2,0,14,5,4.333333333333333,18.31527464399133,0
2020-03-17-171111,171111,11,1,15,16,6.333333333333332,27.34931449231037,1
2020-03-18-171111,171111,12,0,7,28,11.666666666666664,29.723881143537007,2
2020-03-19-171111,171111,14,0,9,42,11.666666666666664,30.871972204949426,3
2020-03-20-171111,171111,15,0,5,57,14.666666666666664,29.6322527698157,4
2020-03-21-171111,171111,4,1,1,61,2.6666666666666665,34.90611199914301,5
2020-03-22-171111,171111,1,0,0,62,0.6666666666666666,33.59537453287526,6
2020-03-23-171111,171111,19,0,13,81,15.0,28.754432605456905,0
2020-03-24-171111,171111,13,0,16,94,10.0,33.0831873500495,1
2020-03-25-171111,171111,12,0,9,106,8.333333333333334,32.837101905346344,2
2020-03-26-171111,171111,6,0,5,112,8.666666666666666,34.84054662372445,3
2020-03-27-171111,171111,15,0,3,127,10.666666666666666,39.36977796715988,4
2020-03-28-171111,171111,1,0,0,128,0.6666666666666666,39.80697741442583,5
2020-03-29-171111,171111,4,0,12,132,1.0,39.14840912995311,6
2020-03-30-171111,171111,14,0,12,146,9.666666666666666,30.162445962075996,0
2020-03-31-171111,171111,15,0,10,161,5.0,33.81814905141937,1
2020-04-01-171111,171111,7,0,10,168,6.0,4.8366594410766215,2
2020-04-02-171111,171111,9,0,4,177,3.333333333333333,12.67423085326472,3
2020-04-03-171111,171111,5,0,6,182,3.6666666666666665,18.376782098114365,4
2020-04-04-171111,171111,1,0,1,183,2.0,23.461068170851398,5
2020-04-05-171111,171111,0,0,0,183,1.0,24.58768198025115,6
2020-04-06-171111,171111,13,0,7,196,6.333333333333332,25.8295636865181,0
2020-04-07-171111,171111,16,0,1,212,3.0,24.448036592567245,1
2020-04-08-171111,171111,9,0,4,221,2.333333333333333,22.601116609647434,2
2020-04-09-171111,171111,5,0,0,226,1.6666666666666667,23.487173944492064,3
2020-04-10-171111,171111,3,0,2,229,1.6666666666666667,11.578567606640004,4
2020-04-11-171111,171111,0,0,0,229,0.3333333333333333,11.838662705789492,5
2020-04-12-171111,171111,12,0,0,241,0.0,13.351790647951066,6
2020-04-13-171111,171111,12,0,6,253,1.6666666666666667,13.958612153963774,0
2020-04-14-171111,171111,10,0,6,263,4.333333333333333,14.585120786763374,1
2020-04-15-171111,171111,10,0,11,273,5.0,16.139155320943225,2
2020-04-16-171111,171111,4,0,9,277,2.0,17.364607039555207,3
2020-04-17-171111,171111,6,0,4,283,6.333333333333332,11.319645645528057,4
2020-04-18-171111,171111,1,0,0,284,0.0,15.656986921931106,5
2020-04-19-171111,171111,0,0,0,284,0.3333333333333333,14.25023845718135,6
2020-04-20-171111,171111,7,0,14,291,5.0,15.843326975362707,0
2020-04-21-171111,171111,1,0,6,292,1.6666666666666667,17.01387640149389,1
2020-04-22-171111,171111,4,0,32,296,2.333333333333333,16.332925026117323,2
2020-04-23-171111,171111,0,0,3,296,0.0,14.839318736114786,3
2020-04-24-171111,171111,2,0,9,298,4.666666666666667,9.924898792670254,4
2020-04-25-171111,171111,0,0,1,298,0.6666666666666666,13.3904069923966,5
2020-04-26-171111,171111,0,0,1,298,0.6666666666666666,13.491786995045333,6
2020-04-27-171111,171111,6,0,8,304,5.666666666666668,10.066114102831573,0
2020-04-28-171111,171111,6,0,20,310,5.0,16.281783802511747,1
2020-04-29-171111,171111,11,0,40,321,4.666666666666667,18.447490860423937,2
2020-04-30-171111,171111,9,0,14,330,6.0,22.98171648682301,3
2020-05-01-171111,171111,4,0,12,334,0.3333333333333333,25.0257624068073,4
2020-05-02-171111,171111,0,0,1,334,0.0,20.988568600728197,5
2020-05-03-171111,171111,0,0,1,334,0.0,13.996101508024118,6
2020-05-04-171111,171111,14,0,10,348,5.333333333333333,8.479487288467698,0
2020-05-05-171111,171111,6,0,11,354,5.333333333333333,16.321594382181395,1
2020-05-06-171111,171111,32,0,5,386,4.666666666666667,19.062302633040208,2
2020-05-07-171111,171111,3,0,8,389,3.0,23.998247264627615,3
2020-05-08-171111,171111,9,0,4,398,6.0,25.953301748110235,4
2020-05-09-171111,171111,1,0,0,399,0.3333333333333333,32.157802061007004,5
2020-05-10-171111,171111,1,1,0,400,0.0,21.672471090902924,6
2020-05-11-171111,171111,8,0,6,408,5.333333333333333,19.634115332228163,0
2020-05-12-171111,171111,20,1,7,428,5.666666666666668,22.77911416523937,1
2020-05-13-171111,171111,40,1,2,468,4.0,19.30486689638947,2
2020-05-14-171111,171111,14,0,2,482,3.333333333333333,22.828328291305024,3
2020-05-15-171111,171111,12,0,0,494,5.333333333333333,22.761132326740274,4
2020-05-16-171111,171111,1,0,0,495,1.3333333333333333,25.826102067415054,5
2020-05-17-171111,171111,1,0,0,496,0.0,27.39250829640331,6
2020-05-18-171111,171111,10,0,0,506,2.6666666666666665,27.56126306459729,0
2020-05-19-171111,171111,11,0,2,517,2.333333333333333,24.55149039176188,1
2020-05-20-171111,171111,5,0,4,522,2.0,21.44580643821802,2
2020-05-21-171111,171111,8,0,0,530,5.0,20.239967951219498,3
2020-05-22-171111,171111,4,0,1,534,5.0,29.847959789095924,4
2020-05-23-171111,171111,0,0,0,534,0.6666666666666666,30.10202964165031,5
2020-05-24-171111,171111,0,0,0,534,0.0,30.802821183999015,6
2020-05-25-171111,171111,6,0,0,540,3.333333333333333,29.30145130080348,0
2020-05-26-171111,171111,7,0,1,547,3.333333333333333,28.319740344067228,1
2020-05-27-171111,171111,2,0,1,549,1.6666666666666667,32.27405835816119,2
2020-05-28-171111,171111,2,1,0,551,0.0,33.43802049681051,3
2020-05-29-171111,171111,0,1,2,551,2.0,18.887427650896036,4
2020-05-30-171111,171111,0,1,0,551,0.0,20.58240182842215,5
2020-05-31-171111,171111,0,0,1,551,0.0,20.73662139949231,6
2020-06-01-171111,171111,0,0,0,551,0.0,43.924652853008176,0
2020-06-02-171111,171111,2,7,3,553,0.6666666666666666,7.180124358369203,1
2020-06-03-171111,171111,4,0,2,557,1.0,1.6519183319735267,2
2020-06-04-171111,171111,0,0,1,557,1.6666666666666667,1.9627887605465655,3
2020-06-05-171111,171111,1,0,0,558,0.6666666666666666,4.087552138028923,4
2020-06-06-171111,171111,0,0,0,558,0.0,3.906083000470745,5
2020-06-07-171111,171111,0,0,0,558,0.0,4.0267087261728065,6
2020-06-08-171111,171111,0,0,1,558,1.6666666666666667,4.006787428527255,0
2020-06-09-171111,171111,1,0,4,559,2.0,11.673747113685067,1
2020-06-10-171111,171111,1,0,1,560,0.3333333333333333,46.481138236015155,2
2020-06-11-171111,171111,0,0,0,560,0.6666666666666666,31.948820423168243,3
2020-06-12-171111,171111,2,0,1,562,0.6666666666666666,30.158300972347245,4
2020-06-13-171111,171111,0,0,0,562,0.0,22.342580480050948,5
2020-06-14-171111,171111,1,1,0,563,0.0,15.700484089471516,6
2020-06-15-171111,171111,0,1,0,563,1.6666666666666667,9.671738252126989,0
2020-06-16-171111,171111,3,0,1,566,0.6666666666666666,9.828378816565818,1
2020-06-17-171111,171111,2,0,0,568,0.0,10.172566831833905,2
2020-06-18-171111,171111,1,0,2,569,1.0,9.295403947255815,3
2020-06-19-171111,171111,0,0,1,569,2.333333333333333,4.035219866145454,4
2020-06-20-171111,171111,0,0,0,569,0.0,8.889126189438414,5
2020-06-21-171111,171111,0,0,0,569,0.0,9.004008256076423,6
2020-06-22-171111,171111,1,0,0,570,0.6666666666666666,6.511798344186447,0
2020-06-23-171111,171111,4,0,0,574,0.6666666666666666,6.527690613015606,1
2020-06-24-171111,171111,1,0,0,575,0.0,6.832938335122092,2
2020-06-25-171111,171111,0,0,0,575,0.3333333333333333,6.722101225290595,3
2020-06-26-171111,171111,1,0,0,576,0.6666666666666666,2.207351086582686,4
2020-06-27-171111,171111,0,0,0,576,0.3333333333333333,2.278359537189078,5
2020-06-28-171111,171111,0,0,0,576,0.0,2.4094469881597025,6
2020-06-29-171111,171111,0,0,0,576,0.0,2.500441526864965,0
2020-06-30-171111,171111,1,0,0,577,0.3333333333333333,2.4148133456611194,1
2020-07-01-171111,171111,0,0,0,577,0.0,14.53119861843584,2
2020-07-02-171111,171111,2,0,0,579,0.3333333333333333,0.9500650070734229,3
2020-07-03-171111,171111,1,0,0,580,0.6666666666666666,2.5757141311586755,4
2020-07-04-171111,171111,0,0,0,580,0.0,7.58823732381365,5
2020-07-05-171111,171111,0,0,0,580,0.0,7.6588882150945565,6
2020-07-06-171111,171111,0,0,0,580,0.3333333333333333,5.531961572310163,0
2020-07-07-171111,171111,0,2,0,580,0.0,7.807347969021539,1
2020-07-08-171111,171111,0,0,0,580,0.0,7.578299365833847,2
2020-07-09-171111,171111,0,0,0,580,0.3333333333333333,7.1804194717789676,3
2020-07-10-171111,171111,0,0,0,580,0.0,14.636128052883837,4
2020-07-11-171111,171111,0,0,0,580,0.0,12.360655258138056,5
2020-07-12-171111,171111,0,0,0,580,0.0,11.868394516598206,6
2020-07-13-171111,171111,0,0,0,580,0.3333333333333333,11.603088010073026,0
2020-07-14-171111,171111,0,0,1,580,0.0,11.829709561225972,1
2020-07-15-171111,171111,0,0,0,580,0.3333333333333333,3.9673612137084544,2
2020-07-16-171111,171111,0,0,1,580,0.0,1.3726454939498467,3
2020-07-17-171111,171111,0,0,1,580,0.6666666666666666,1.4147037658258548,4
2020-07-18-171111,171111,0,0,0,580,0.0,0.8814451036148173,5
2020-07-19-171111,171111,0,0,0,580,0.0,1.026100057865813,6
2020-07-20-171111,171111,0,0,0,580,0.0,1.105723489978982,0
2020-07-21-171111,171111,0,0,0,580,0.0,0.9584054648618915,1
2020-07-22-171111,171111,0,0,0,580,0.3333333333333333,0.9265471117837447,2
2020-07-23-171111,171111,0,0,0,580,0.0,1.1725925499012497,3
2020-07-24-171111,171111,0,0,1,580,0.0,1.0198572801385306,4
2020-07-25-171111,171111,0,0,0,580,0.0,0.950011245475689,5
2020-07-26-171111,171111,0,0,0,580,0.0,0.9493600196273353,6
2020-07-27-171111,171111,0,0,0,580,0.6666666666666666,0.6281475341308407,0
2020-07-28-171111,171111,1,0,1,581,0.0,2.757048498240382,1
2020-07-29-171111,171111,0,0,0,581,0.0,2.767105124006404,2
2020-07-30-171111,171111,1,0,1,582,0.3333333333333333,2.839212444888247,3
2020-07-31-171111,171111,1,0,1,583,2.0,3.2261239086506937,4
2020-08-01-171111,171111,0,0,1,583,0.6666666666666666,6.7313868707263005,5
2020-08-02-171111,171111,0,0,1,583,0.0,44.56084852208307,6
2020-08-03-171111,171111,0,0,1,583,1.6666666666666667,19.785686633907986,0
2020-08-04-171111,171111,0,0,3,583,0.3333333333333333,14.526810204661098,1
2020-08-05-171111,171111,0,0,1,583,0.0,12.204297256976364,2
2020-08-06-171111,171111,0,0,3,583,1.0,9.732475635465534,3
2020-08-07-171111,171111,1,0,1,584,0.6666666666666666,7.1809229763975155,4
2020-08-08-171111,171111,0,0,1,584,0.3333333333333333,6.730130192304271,5
2020-08-09-171111,171111,0,0,0,584,0.0,5.712001177931637,6
2020-08-10-171111,171111,0,0,3,584,1.6666666666666667,2.431280259479183,0
2020-08-11-171111,171111,1,0,2,585,0.6666666666666666,3.823393781019959,1
2020-08-12-171111,171111,0,0,0,585,2.6666666666666665,5.302832948216871,2
2020-08-13-171111,171111,1,0,3,586,0.3333333333333333,6.674320932868852,3
2020-08-14-171111,171111,1,0,1,587,2.0,21.782161770118247,4
2020-08-15-171111,171111,1,0,1,588,0.6666666666666666,27.40043851240278,5
2020-08-16-171111,171111,1,0,3,589,2.0,27.48415756878652,6
2020-08-17-171111,171111,1,0,4,590,0.3333333333333333,28.305049165594927,0
2020-08-18-171111,171111,3,0,6,593,3.333333333333333,27.83355336730497,1
2020-08-19-171111,171111,1,1,4,594,0.3333333333333333,44.50273985623056,2
2020-08-20-171111,171111,3,0,4,597,0.6666666666666666,27.397656043520968,3
2020-08-21-171111,171111,1,0,6,598,2.0,23.28493135242485,4
2020-08-22-171111,171111,1,0,7,599,0.0,26.09866175448316,5
2020-08-23-171111,171111,0,0,6,599,0.0,26.368963219063723,6
2020-08-24-171111,171111,3,0,0,602,2.0,25.75284231763447,0
2020-08-25-171111,171111,2,0,3,604,2.6666666666666665,13.383443301868823,1
2020-08-26-171111,171111,0,0,0,604,1.0,14.291353452596114,2
2020-08-27-171111,171111,3,0,12,607,1.6666666666666667,16.670619075112548,3
2020-08-28-171111,171111,1,1,1,608,1.0,17.90424577708397,4
2020-08-29-171111,171111,1,0,4,609,0.6666666666666666,17.245263710132427,5
2020-08-30-171111,171111,3,0,2,612,0.6666666666666666,20.03455949661991,6
2020-08-31-171111,171111,4,0,3,616,2.0,14.181327804964425,0
2020-09-01-171111,171111,6,0,1,622,2.333333333333333,5.743920317251678,1
2020-09-02-171111,171111,4,0,3,626,5.0,88.16324719159846,2
2020-09-03-171111,171111,4,0,5,630,0.6666666666666666,47.868912915172984,3
2020-09-04-171111,171111,6,0,9,636,2.6666666666666665,39.240939678690836,4
2020-09-05-171111,171111,7,0,1,643,2.0,42.81566500713198,5
2020-09-06-171111,171111,6,0,12,649,2.0,39.23374181064604,6
2020-09-07-171111,171111,0,0,6,649,2.0,25.639432521189683,0
2020-09-08-171111,171111,3,0,1,652,5.666666666666668,27.192068890336586,1
2020-09-09-171111,171111,0,0,8,652,0.3333333333333333,35.00070560776476,2
2020-09-10-171111,171111,12,0,9,664,5.0,13.912435420848979,3
2020-09-11-171111,171111,1,0,4,665,1.3333333333333333,29.219658846721522,4
2020-09-12-171111,171111,4,0,3,669,3.0,37.18815479866865,5
2020-09-13-171111,171111,2,0,5,671,2.0,41.01583112530463,6
2020-09-14-171111,171111,3,0,2,674,6.0,40.37217393761297,0
2020-09-15-171111,171111,1,0,2,675,4.0,52.223081722901334,1
2020-09-16-171111,171111,3,0,11,678,4.333333333333333,59.37212739959858,2
2020-09-17-171111,171111,5,0,9,683,6.666666666666668,64.88207924054495,3
2020-09-18-171111,171111,9,0,6,692,7.333333333333332,79.04957576455934,4
2020-09-19-171111,171111,1,0,2,693,3.333333333333333,91.50683851094361,5
2020-09-20-171111,171111,12,1,1,705,2.333333333333333,97.17272933154729,6
2020-09-21-171111,171111,6,0,7,711,4.666666666666667,88.72472117674432,0
2020-09-22-171111,171111,1,1,1,712,1.3333333333333333,89.44706946060646,1
2020-09-23-171111,171111,8,0,3,720,6.0,76.69241567374286,2
2020-09-24-171111,171111,9,0,2,729,2.6666666666666665,56.069657449177356,3
2020-09-25-171111,171111,4,1,4,733,4.333333333333333,44.69652460552656,4
2020-09-26-171111,171111,3,1,0,736,2.0,47.607807632912575,5
2020-09-27-171111,171111,5,0,6,741,2.333333333333333,42.99631400500088,6
2020-09-28-171111,171111,2,1,4,743,2.0,56.49102894770267,0
2020-09-29-171111,171111,2,1,3,745,1.0,50.504583454480496,1
2020-09-30-171111,171111,11,0,4,756,2.6666666666666665,43.91681044104594,2
2020-10-01-171111,171111,9,0,3,765,3.0,0.0,3
2020-10-02-171111,171111,6,0,10,771,1.6666666666666667,163.31044999044784,4
2020-10-03-171111,171111,2,2,0,773,0.6666666666666666,152.03184944695568,5
2020-10-04-171111,171111,1,1,2,774,0.0,174.45129162800865,6
2020-10-05-171111,171111,7,0,15,781,1.6666666666666667,139.30016228718728,0
2020-10-06-171111,171111,1,0,15,782,5.333333333333333,127.91562940243233,1
2020-10-07-171111,171111,3,0,5,785,3.0,125.51245272202185,2
2020-10-08-171111,171111,2,0,22,787,1.6666666666666667,107.7034251656876,3
2020-10-09-171111,171111,4,3,18,791,3.333333333333333,110.3207793767578,4
2020-10-10-171111,171111,0,0,2,791,1.0,5.641804724265329,5
2020-10-11-171111,171111,6,0,0,797,1.6666666666666667,13.043731254790108,6
2020-10-12-171111,171111,4,0,20,801,0.3333333333333333,24.74456597680789,0
2020-10-13-171111,171111,3,0,12,804,3.333333333333333,26.54881487631627,1
2020-10-14-171111,171111,4,0,18,808,3.333333333333333,31.14989629718896,2
2020-10-15-171111,171111,3,0,13,811,4.333333333333333,61.30939468846553,3
2020-10-16-171111,171111,10,0,41,821,14.333333333333336,77.69186291686394,4
2020-10-17-171111,171111,0,0,4,821,2.6666666666666665,149.6389648883945,5
2020-10-18-171111,171111,2,1,6,823,3.6666666666666665,150.34414388931972,6
2020-10-19-171111,171111,15,0,6,838,7.333333333333332,150.76260293489446,0
2020-10-20-171111,171111,15,0,14,853,12.666666666666664,174.9129040082408,1
2020-10-21-171111,171111,5,0,14,858,7.0,184.0536909191476,2
2020-10-22-171111,171111,22,0,12,880,11.0,185.2733406981258,3
2020-10-23-171111,171111,18,0,31,898,14.333333333333336,135.64663788122982,4
2020-10-24-171111,171111,2,2,8,900,9.333333333333334,162.09070292573753,5
2020-10-25-171111,171111,0,1,10,900,2.333333333333333,160.08091433830418,6
2020-10-26-171111,171111,20,0,15,920,16.666666666666668,151.39300358177223,0
2020-10-27-171111,171111,12,2,19,932,8.666666666666666,176.92629201659508,1
2020-10-28-171111,171111,18,2,12,950,7.666666666666668,151.17987115707763,2
2020-10-29-171111,171111,13,0,15,963,10.0,152.2709187733852,3
2020-10-30-171111,171111,41,1,78,1004,19.666666666666668,123.4864841248041,4
2020-10-31-171111,171111,4,3,0,1008,1.0,174.9474272223828,5
2020-11-01-171111,171111,6,3,0,1014,4.666666666666667,51.01490054673562,6
2020-11-02-171111,171111,6,0,0,1020,3.333333333333333,96.65643683844876,0
2020-11-03-171111,171111,14,3,0,1034,10.0,108.01760234319005,1
2020-11-04-171111,171111,14,0,0,1048,15.0,127.56985419816962,2
2020-11-05-171111,171111,12,0,0,1060,16.0,155.16980294506914,3
2020-11-06-171111,171111,31,3,0,1091,29.66666666666667,177.30277694523085,4
2020-11-07-171111,171111,8,0,0,1099,4.0,252.57981601352546,5
2020-11-08-171111,171111,10,1,0,1109,3.0,229.45130148975437,6
2020-11-09-171111,171111,15,0,0,1124,21.33333333333333,222.59906067978176,0
2020-11-10-171111,171111,19,2,0,1143,20.0,51.95187585262802,1
2020-11-11-171111,171111,12,2,0,1155,9.333333333333334,73.79792358154091,2
2020-11-12-171111,171111,15,0,0,1170,10.333333333333334,97.9774044307002,3
2020-11-13-171111,171111,78,1,0,1248,8.0,98.10999811432721,4
2020-03-01-171112,171112,0,0,0,0,0.0,0.0,6
2020-03-02-171112,171112,0,0,3,0,0.25,11.643120532368073,0
2020-03-03-171112,171112,0,0,11,0,0.25,48.34668161259839,1
2020-03-04-171112,171112,0,0,10,0,0.0,57.8268204838274,2
2020-03-05-171112,171112,0,0,10,0,0.5,63.88427716912216,3
2020-03-06-171112,171112,0,0,16,0,0.25,47.518770901741604,4
2020-03-07-171112,171112,0,0,4,0,0.25,56.419253103406,5
2020-03-08-171112,171112,0,0,0,0,0.25,66.45896855279199,6
2020-03-09-171112,171112,0,0,19,0,0.5,66.66575926988779,0
2020-03-10-171112,171112,0,0,9,0,0.0,583.1095944558178,1
2020-03-11-171112,171112,0,0,10,0,1.0,489.1553423678147,2
2020-03-12-171112,171112,1,0,8,1,1.25,393.2136931268821,3
2020-03-13-171112,171112,0,0,9,1,1.5,164.2101356554093,4
2020-03-14-171112,171112,0,0,1,1,1.0,156.32284634527633,5
2020-03-15-171112,171112,0,0,1,1,0.25,138.4553353737177,6
2020-03-16-171112,171112,3,0,10,4,4.25,38.37346700060486,0
2020-03-17-171112,171112,11,0,0,15,7.75,57.2764858529257,1
2020-03-18-171112,171112,10,1,4,25,10.5,62.15204090267284,2
2020-03-19-171112,171112,10,0,3,35,12.5,64.11416763808481,3
2020-03-20-171112,171112,16,1,6,51,12.0,61.46406138635512,4
2020-03-21-171112,171112,4,0,3,55,3.0,72.12068471925465,5
2020-03-22-171112,171112,0,0,1,55,1.25,69.5198754759301,6
2020-03-23-171112,171112,19,0,5,74,16.25,59.11877817855314,0
2020-03-24-171112,171112,9,0,5,83,11.0,68.01270618601237,1
2020-03-25-171112,171112,10,0,4,93,11.5,67.47003028800314,2
2020-03-26-171112,171112,8,0,0,101,10.25,71.77176227409493,3
2020-03-27-171112,171112,9,0,2,110,12.5,80.79790664916592,4
2020-03-28-171112,171112,1,0,0,111,0.75,81.93513330287712,5
2020-03-29-171112,171112,1,0,0,112,2.0,80.92023991344796,6
2020-03-30-171112,171112,10,0,0,122,10.25,62.30700808907783,0
2020-03-31-171112,171112,0,0,5,122,9.0,70.11462539057197,1
2020-04-01-171112,171112,4,1,8,126,6.75,9.942092342308744,2
2020-04-02-171112,171112,3,0,2,129,5.5,26.165554060417385,3
2020-04-03-171112,171112,6,0,8,135,3.5,38.0894032121103,4
2020-04-04-171112,171112,3,0,0,138,1.25,48.85648221989395,5
2020-04-05-171112,171112,1,0,0,139,0.75,50.96331177930618,6
2020-04-06-171112,171112,5,0,4,144,7.5,53.68575295703101,0
2020-04-07-171112,171112,5,2,3,149,7.0,50.74859457525978,1
2020-04-08-171112,171112,4,1,2,153,4.5,46.87650286510984,2
2020-04-09-171112,171112,0,0,0,153,3.0,48.77856798729685,3
2020-04-10-171112,171112,2,0,5,155,2.25,24.176929234929467,4
2020-04-11-171112,171112,0,1,1,155,0.25,24.71017247914731,5
2020-04-12-171112,171112,0,0,0,155,3.25,27.901315693169263,6
2020-04-13-171112,171112,0,0,4,155,6.25,29.162561582508545,0
2020-04-14-171112,171112,5,0,3,160,5.5,30.418012500997328,1
2020-04-15-171112,171112,8,1,3,168,5.0,33.481810951591186,2
2020-04-16-171112,171112,2,0,4,170,2.75,36.02689181921006,3
2020-04-17-171112,171112,8,0,0,178,5.0,23.15330945042714,4
2020-04-18-171112,171112,0,0,0,178,0.75,32.24259961941654,5
2020-04-19-171112,171112,0,1,0,178,0.25,29.248702970546056,6
2020-04-20-171112,171112,4,0,2,182,5.75,32.577458531315784,0
2020-04-21-171112,171112,3,0,6,185,2.0,34.940865894618646,1
2020-04-22-171112,171112,2,0,4,187,3.5,33.63503316630745,2
2020-04-23-171112,171112,0,0,4,187,0.25,30.65665082260398,3
2020-04-24-171112,171112,5,0,6,192,4.0,20.550539447389937,4
2020-04-25-171112,171112,1,0,0,193,0.25,27.65939114730117,5
2020-04-26-171112,171112,0,0,0,193,1.0,27.932306740868704,6
2020-04-27-171112,171112,4,0,4,197,6.0,20.76536487208009,0
2020-04-28-171112,171112,3,0,6,200,5.75,33.898500781707426,1
2020-04-29-171112,171112,3,0,6,203,6.25,38.56979445524258,2
2020-04-30-171112,171112,4,0,1,207,6.5,47.910331295627216,3
2020-05-01-171112,171112,0,0,6,207,1.25,52.341966167186655,4
2020-05-02-171112,171112,0,0,2,207,0.0,43.8044088797624,5
2020-05-03-171112,171112,0,0,0,207,0.0,29.428137001983245,6
2020-05-04-171112,171112,2,0,2,209,8.0,17.835594566652382,0
2020-05-05-171112,171112,6,0,1,215,4.75,34.4540321195618,1
2020-05-06-171112,171112,4,0,3,219,18.0,40.01608562316242,2
2020-05-07-171112,171112,4,0,1,223,3.0,49.99448245254684,3
2020-05-08-171112,171112,6,0,5,229,6.25,53.924205074802565,4
2020-05-09-171112,171112,0,0,0,229,0.75,66.93872320787283,5
2020-05-10-171112,171112,0,1,0,229,0.25,45.30387650389612,6
2020-05-11-171112,171112,4,0,2,233,5.75,41.06269856156526,0
2020-05-12-171112,171112,6,1,6,239,9.75,47.20744220739576,1
2020-05-13-171112,171112,6,0,3,245,13.25,39.92415655858862,2
2020-05-14-171112,171112,1,0,0,246,7.0,47.63270995708358,3
2020-05-15-171112,171112,6,0,3,252,7.0,47.692251967015395,4
2020-05-16-171112,171112,2,0,0,254,1.0,54.05193011581322,5
2020-05-17-171112,171112,0,0,0,254,0.25,57.32378172217817,6
2020-05-18-171112,171112,2,0,0,256,5.25,57.68793863113216,0
2020-05-19-171112,171112,1,0,2,257,4.5,51.51241243461364,1
2020-05-20-171112,171112,3,0,2,260,3.0,45.016040159521054,2
2020-05-21-171112,171112,1,0,0,261,5.75,42.57915329572626,3
2020-05-22-171112,171112,5,0,2,266,4.25,62.930072619838995,4
2020-05-23-171112,171112,0,0,0,266,1.5,63.33213763300333,5
2020-05-24-171112,171112,0,0,0,266,0.0,64.68579243175164,6
2020-05-25-171112,171112,2,0,0,268,4.0,61.464563574698445,0
2020-05-26-171112,171112,6,0,2,274,3.25,59.08823160194442,1
2020-05-27-171112,171112,3,3,0,277,1.0,67.36337836944044,2
2020-05-28-171112,171112,0,1,0,277,1.0,69.85917954679371,3
2020-05-29-171112,171112,3,3,1,280,0.75,39.37323090282881,4
2020-05-30-171112,171112,0,0,0,280,0.0,43.132734436417444,5
2020-05-31-171112,171112,0,0,0,280,0.0,43.58161923193367,6
2020-06-01-171112,171112,0,0,2,280,0.0,92.0675574694692,0
2020-06-02-171112,171112,2,0,0,282,0.75,15.03406478420371,1
2020-06-03-171112,171112,2,0,0,284,2.0,3.364167925287784,2
2020-06-04-171112,171112,0,0,3,284,1.25,3.967588582883052,3
2020-06-05-171112,171112,2,0,3,286,1.0,8.47495282652765,4
2020-06-06-171112,171112,0,0,0,286,0.0,8.03473369246879,5
2020-06-07-171112,171112,0,0,0,286,0.0,8.305106676394653,6
2020-06-08-171112,171112,0,0,0,286,2.0,8.26303137871513,0
2020-06-09-171112,171112,2,0,2,288,1.25,24.329894622963415,1
2020-06-10-171112,171112,0,0,0,288,0.75,96.61959863840738,2
2020-06-11-171112,171112,0,0,0,288,0.5,66.27862889102664,3
2020-06-12-171112,171112,1,0,0,289,0.75,62.78230030438411,4
2020-06-13-171112,171112,0,0,0,289,0.0,46.75385175750111,5
2020-06-14-171112,171112,0,0,0,289,0.25,32.77334126208061,6
2020-06-15-171112,171112,2,0,0,291,2.0,20.405087303018277,0
2020-06-16-171112,171112,0,0,0,291,1.25,20.74494414022737,1
2020-06-17-171112,171112,0,0,0,291,0.5,21.349133682569548,2
2020-06-18-171112,171112,3,0,0,294,0.25,19.441601065804598,3
2020-06-19-171112,171112,3,0,1,297,1.0,8.289011240252448,4
2020-06-20-171112,171112,0,0,0,297,0.0,18.40996987031894,5
2020-06-21-171112,171112,0,0,0,297,0.0,18.604797778176316,6
2020-06-22-171112,171112,0,0,0,297,0.75,13.406422917349449,0
2020-06-23-171112,171112,2,0,0,299,1.0,13.45668261320689,1
2020-06-24-171112,171112,0,0,0,299,0.75,14.084314233890233,2
2020-06-25-171112,171112,0,1,1,299,0.5,13.88635660481232,3
2020-06-26-171112,171112,0,1,0,299,0.75,4.448805121348982,4
2020-06-27-171112,171112,0,0,0,299,0.25,4.5835922917005645,5
2020-06-28-171112,171112,0,0,0,299,0.0,4.847605242321454,6
2020-06-29-171112,171112,0,0,1,299,0.25,5.058404180399477,0
2020-06-30-171112,171112,0,0,0,299,0.5,4.871034378743903,1
2020-07-01-171112,171112,0,0,1,299,0.0,30.229168949871784,2
2020-07-02-171112,171112,0,0,0,299,0.75,1.8728035911924072,3
2020-07-03-171112,171112,1,0,2,300,0.5,5.378568771077962,4
2020-07-04-171112,171112,0,0,0,300,0.0,15.737375621034944,5
2020-07-05-171112,171112,0,0,0,300,0.0,15.850885929945258,6
2020-07-06-171112,171112,0,0,0,300,0.5,11.422169196641486,0
2020-07-07-171112,171112,0,0,0,300,0.0,16.186958094357863,1
2020-07-08-171112,171112,0,0,0,300,0.0,15.78459003384523,2
2020-07-09-171112,171112,1,0,0,301,0.0,14.965050311642472,3
2020-07-10-171112,171112,0,0,0,301,0.0,30.498053275492595,4
2020-07-11-171112,171112,0,0,0,301,0.0,25.91012981966385,5
2020-07-12-171112,171112,0,0,0,301,0.25,24.9614830574441,6
2020-07-13-171112,171112,1,0,0,302,0.0,24.368696621187595,0
2020-07-14-171112,171112,0,0,0,302,0.0,24.842464057671673,1
2020-07-15-171112,171112,1,0,0,303,0.0,8.24576478337239,2
2020-07-16-171112,171112,0,0,1,303,0.0,2.864697887778952,3
2020-07-17-171112,171112,2,0,2,305,0.0,2.9275712675659875,4
2020-07-18-171112,171112,0,0,0,305,0.0,1.7363561283908664,5
2020-07-19-171112,171112,0,0,0,305,0.0,2.028217958585832,6
2020-07-20-171112,171112,0,0,2,305,0.0,2.210573646076176,0
2020-07-21-171112,171112,0,0,1,305,0.0,1.9165160854357948,1
2020-07-22-171112,171112,0,0,0,305,0.25,1.8774718735829157,2
2020-07-23-171112,171112,0,0,2,305,0.0,2.3563559616322878,3
2020-07-24-171112,171112,0,0,1,305,0.0,2.0495974816535543,4
2020-07-25-171112,171112,0,0,0,305,0.0,1.9325770946187342,5
2020-07-26-171112,171112,0,0,0,305,0.0,1.938173079407936,6
2020-07-27-171112,171112,0,0,0,305,0.5,1.2791088521846365,0
2020-07-28-171112,171112,0,0,1,305,0.25,5.713360222965866,1
2020-07-29-171112,171112,0,0,4,305,0.0,5.744593579633959,2
2020-07-30-171112,171112,1,0,1,306,0.25,5.88560879485695,3
2020-07-31-171112,171112,2,0,3,308,1.75,6.656010103231453,4
2020-08-01-171112,171112,0,0,0,308,0.5,14.040012180801565,5
2020-08-02-171112,171112,0,0,1,308,0.0,93.15566186932216,6
2020-08-03-171112,171112,2,0,0,310,1.0,41.63391619155811,0
2020-08-04-171112,171112,1,0,0,311,0.0,30.671220324153957,1
2020-08-05-171112,171112,0,0,1,311,0.0,25.66499868061398,2
2020-08-06-171112,171112,2,0,1,313,0.25,20.341286507794585,3
2020-08-07-171112,171112,1,0,3,314,0.5,14.99023168858816,4
2020-08-08-171112,171112,0,0,0,314,0.25,13.81232539938048,5
2020-08-09-171112,171112,0,0,0,314,0.0,11.72595890610651,6
2020-08-10-171112,171112,0,0,1,314,2.0,5.076690390307732,0
2020-08-11-171112,171112,1,0,6,315,1.0,7.819250333270162,1
2020-08-12-171112,171112,4,0,3,319,1.5,10.951326037771704,2
2020-08-13-171112,171112,1,0,2,320,0.25,13.673827056577764,3
2020-08-14-171112,171112,3,0,1,323,1.25,45.504475024823975,4
2020-08-15-171112,171112,0,0,1,323,0.75,57.16242263987102,5
2020-08-16-171112,171112,1,0,2,324,1.5,57.193342163599084,6
2020-08-17-171112,171112,0,0,2,324,1.0,58.574146183167606,0
2020-08-18-171112,171112,0,0,2,324,6.5,57.65480038004133,1
2020-08-19-171112,171112,1,0,2,325,0.5,92.46307242450071,2
2020-08-20-171112,171112,1,0,2,326,1.5,56.89861602179596,3
2020-08-21-171112,171112,3,0,1,329,1.25,48.38993441894854,4
2020-08-22-171112,171112,0,0,5,329,0.25,54.28391991930937,5
2020-08-23-171112,171112,0,0,2,329,0.0,55.205871427148125,6
2020-08-24-171112,171112,1,0,2,330,2.75,54.05165460442247,0
2020-08-25-171112,171112,6,0,3,336,1.75,27.99552953608758,1
2020-08-26-171112,171112,3,0,0,339,0.5,29.81789235442697,2
2020-08-27-171112,171112,2,0,3,341,2.0,35.01535481954406,3
2020-08-28-171112,171112,1,0,1,342,1.25,37.63137756400435,4
2020-08-29-171112,171112,1,0,2,343,0.5,36.26119965074842,5
2020-08-30-171112,171112,2,0,6,345,1.0,42.175199834332446,6
2020-08-31-171112,171112,2,0,5,347,2.25,29.821105066424035,0
2020-09-01-171112,171112,2,0,6,349,2.75,11.926011151146419,1
2020-09-02-171112,171112,2,0,3,351,4.75,186.21031258102053,2
2020-09-03-171112,171112,2,0,2,353,1.5,99.93175673812806,3
2020-09-04-171112,171112,1,0,3,354,4.75,82.18325425009309,4
2020-09-05-171112,171112,5,0,1,359,2.25,89.52557754064591,5
2020-09-06-171112,171112,2,0,4,361,3.25,82.13002869232612,6
2020-09-07-171112,171112,2,0,8,363,1.25,53.450417449643034,0
2020-09-08-171112,171112,3,0,2,366,6.5,56.78112527666658,1
2020-09-09-171112,171112,0,0,6,366,0.25,72.68254059684031,2
2020-09-10-171112,171112,3,0,1,369,8.75,29.050105478066477,3
2020-09-11-171112,171112,1,0,2,370,1.25,61.053469141009714,4
2020-09-12-171112,171112,2,0,4,372,3.75,78.14312011309153,5
2020-09-13-171112,171112,6,1,0,378,0.5,85.87880973530619,6
2020-09-14-171112,171112,5,0,4,383,4.25,84.51391343227424,0
2020-09-15-171112,171112,6,0,3,389,2.5,109.79814681202815,1
2020-09-16-171112,171112,3,0,2,392,3.25,125.11615185473673,2
2020-09-17-171112,171112,2,0,8,394,7.25,136.26361168116608,3
2020-09-18-171112,171112,3,0,0,397,9.25,167.74305053984762,4
2020-09-19-171112,171112,1,0,1,398,2.75,193.97702718227777,5
2020-09-20-171112,171112,4,1,0,402,4.5,206.34849382964694,6
2020-09-21-171112,171112,8,0,3,410,3.75,188.35867491249707,0
2020-09-22-171112,171112,2,1,3,412,1.5,188.99129297419046,1
2020-09-23-171112,171112,6,0,0,418,6.0,161.6732808098664,2
2020-09-24-171112,171112,1,0,0,419,4.75,116.4639770337192,3
2020-09-25-171112,171112,2,0,0,421,5.25,92.34391541571465,4
2020-09-26-171112,171112,4,0,0,425,3.25,98.11445554227626,5
2020-09-27-171112,171112,0,0,0,425,4.0,88.56819124626891,6
2020-09-28-171112,171112,4,0,0,429,1.25,117.0322060154684,0
2020-09-29-171112,171112,3,0,3,432,1.25,104.82465814829644,1
2020-09-30-171112,171112,2,0,2,434,5.75,91.1929751478695,2
2020-10-01-171112,171112,8,0,3,442,5.25,0.0,3
2020-10-02-171112,171112,0,0,7,442,4.75,342.6558494120389,4
2020-10-03-171112,171112,1,0,1,443,0.75,317.4513229246723,5
2020-10-04-171112,171112,0,0,2,443,0.5,364.64782686262777,6
2020-10-05-171112,171112,3,0,4,446,3.0,291.0271974773973,0
2020-10-06-171112,171112,3,0,11,449,4.25,267.98954717749353,1
2020-10-07-171112,171112,0,0,3,449,4.0,263.58253986618126,2
2020-10-08-171112,171112,0,0,4,449,2.25,225.56382382463693,3
2020-10-09-171112,171112,0,4,13,449,4.75,231.43200694135015,4
2020-10-10-171112,171112,0,0,12,449,1.0,11.634898253259806,5
2020-10-11-171112,171112,0,0,4,449,2.75,27.28080382391363,6
2020-10-12-171112,171112,0,0,5,449,2.25,52.0775945408219,0
2020-10-13-171112,171112,3,0,11,452,2.5,55.88305592423468,1
2020-10-14-171112,171112,2,0,4,454,6.0,65.31560411433384,2
2020-10-15-171112,171112,3,0,4,457,4.75,129.02492047822537,3
2020-10-16-171112,171112,7,0,12,464,14.5,163.14623430590532,4
2020-10-17-171112,171112,1,0,0,465,2.0,314.75864154003364,5
2020-10-18-171112,171112,2,0,5,467,2.75,315.798318462652,6
2020-10-19-171112,171112,4,1,4,471,12.25,315.92367056137397,0
2020-10-20-171112,171112,11,0,7,482,11.0,364.8898192059762,1
2020-10-21-171112,171112,3,1,10,485,9.25,382.926499316685,2
2020-10-22-171112,171112,4,0,10,489,14.5,384.4027327410128,3
2020-10-23-171112,171112,13,0,16,502,16.75,279.39503400389754,4
2020-10-24-171112,171112,12,0,4,514,5.75,334.5370299622415,5
2020-10-25-171112,171112,4,0,4,518,1.0,330.0080588235662,6
2020-10-26-171112,171112,5,0,11,523,18.5,312.76403058995123,0
2020-10-27-171112,171112,11,0,10,534,9.0,367.13467437229093,1
2020-10-28-171112,171112,4,0,8,538,10.75,313.25168494462116,2
2020-10-29-171112,171112,4,0,4,542,10.75,316.15563441751345,3
2020-10-30-171112,171112,12,0,8,554,26.5,257.27706161633637,4
2020-10-31-171112,171112,0,0,0,554,3.0,365.99043543650737,5
2020-11-01-171112,171112,5,2,0,559,5.0,106.5630556159792,6
2020-11-02-171112,171112,4,0,0,563,3.5,201.30411820338264,0
2020-11-03-171112,171112,7,0,0,570,13.25,225.68795011782174,1
2020-11-04-171112,171112,10,0,0,580,15.5,267.49326664019907,2
2020-11-05-171112,171112,10,0,0,590,15.25,327.2591124864871,3
2020-11-06-171112,171112,16,1,0,606,31.0,373.170263734497,4
2020-11-07-171112,171112,4,0,0,610,6.25,533.4154072699474,5
2020-11-08-171112,171112,4,0,0,614,4.75,483.63001949832056,6
2020-11-09-171112,171112,11,0,0,625,20.25,467.1540613850365,0
2020-11-10-171112,171112,10,0,0,635,20.75,108.71388659177737,1
2020-11-11-171112,171112,8,1,0,643,10.5,153.4185691907355,2
2020-11-12-171112,171112,4,0,0,647,12.5,203.0898284935318,3
2020-11-13-171112,171112,8,1,0,655,28.0,203.00126977365284,4
2020-03-01-171113,171113,0,0,0,0,0.0,0.0,6
2020-03-02-171113,171113,0,1,2,0,0.16666666666666666,16.035868219092684,0
2020-03-03-171113,171113,0,0,1,0,0.0,74.18041739850833,1
2020-03-04-171113,171113,0,0,6,0,0.0,76.47713191731376,2
2020-03-05-171113,171113,0,0,6,0,0.0,85.37346849143212,3
2020-03-06-171113,171113,0,0,4,0,0.0,66.65462019597271,4
2020-03-07-171113,171113,0,0,4,0,0.16666666666666666,73.98904537119996,5
2020-03-08-171113,171113,0,0,4,0,0.0,78.6159975138952,6
2020-03-09-171113,171113,0,0,5,0,0.16666666666666666,78.52131297922399,0
2020-03-10-171113,171113,0,0,5,0,0.0,292.85405926952984,1
2020-03-11-171113,171113,1,0,4,1,0.8333333333333334,247.51969045470162,2
2020-03-12-171113,171113,0,0,2,1,0.5,183.2200725484981,3
2020-03-13-171113,171113,2,0,8,3,0.6666666666666666,91.83193405569976,4
2020-03-14-171113,171113,0,0,2,3,0.16666666666666666,81.72495297128528,5
2020-03-15-171113,171113,0,0,0,3,0.5,69.16343928331864,6
2020-03-16-171113,171113,2,0,3,5,1.3333333333333333,32.10586285034431,0
2020-03-17-171113,171113,1,0,3,6,0.8333333333333334,48.9047531999058,1
2020-03-18-171113,171113,6,0,2,12,1.6666666666666667,59.493217010185006,2
2020-03-19-171113,171113,6,0,1,18,1.8333333333333333,76.58083353719131,3
2020-03-20-171113,171113,4,0,2,22,3.0,85.30820563560076,4
2020-03-21-171113,171113,4,0,1,26,1.6666666666666667,98.69296214256067,5
2020-03-22-171113,171113,4,0,0,30,1.8333333333333333,99.04799689184418,6
2020-03-23-171113,171113,5,0,2,35,6.333333333333332,98.01993610535274,0
2020-03-24-171113,171113,5,0,2,40,2.5,127.26378364184741,1
2020-03-25-171113,171113,4,0,1,44,5.0,127.57410104379196,2
2020-03-26-171113,171113,2,0,0,46,3.333333333333333,135.27493394403305,3
2020-03-27-171113,171113,8,0,3,54,3.8333333333333335,151.07588834834343,4
2020-03-28-171113,171113,2,0,0,56,0.16666666666666666,169.07864751261275,5
2020-03-29-171113,171113,0,0,0,56,0.8333333333333334,167.96892898262814,6
2020-03-30-171113,171113,3,0,0,59,4.333333333333333,117.8927644401742,0
2020-03-31-171113,171113,3,0,3,62,1.5,118.85786395799563,1
2020-04-01-171113,171113,2,0,6,64,3.333333333333333,16.491473234972297,2
2020-04-02-171113,171113,1,0,3,65,1.8333333333333333,86.39008600889012,3
2020-04-03-171113,171113,2,0,9,67,1.8333333333333333,50.449033793430715,4
2020-04-04-171113,171113,1,0,0,68,0.3333333333333333,56.85983697713976,5
2020-04-05-171113,171113,0,0,1,68,0.5,56.85232002863324,6
2020-04-06-171113,171113,2,0,2,70,4.666666666666667,59.451138540140434,0
2020-04-07-171113,171113,2,0,3,72,1.3333333333333333,70.4405995989259,1
2020-04-08-171113,171113,1,0,5,73,1.3333333333333333,73.38100872292759,2
2020-04-09-171113,171113,0,0,0,73,1.1666666666666667,73.30544439016707,3
2020-04-10-171113,171113,3,0,2,76,2.5,17.618453888230967,4
2020-04-11-171113,171113,0,0,1,76,2.333333333333333,28.89086294762808,5
2020-04-12-171113,171113,0,0,0,76,0.6666666666666666,34.46027568742805,6
2020-04-13-171113,171113,0,0,2,76,3.1666666666666665,36.89913423112002,0
2020-04-14-171113,171113,3,0,2,79,2.0,47.365460798174446,1
2020-04-15-171113,171113,6,0,1,85,1.6666666666666667,60.278150593720866,2
2020-04-16-171113,171113,3,0,3,88,1.3333333333333333,76.96776749677312,3
2020-04-17-171113,171113,9,0,1,97,1.6666666666666667,77.18987716010888,4
2020-04-18-171113,171113,0,0,0,97,0.5,87.69801449959023,5
2020-04-19-171113,171113,1,0,2,98,0.16666666666666666,83.51652731906042,6
2020-04-20-171113,171113,2,0,3,100,1.0,81.06846824118031,0
2020-04-21-171113,171113,3,0,6,103,2.5,78.73869135417469,1
2020-04-22-171113,171113,5,0,0,108,0.8333333333333334,79.24704779044961,2
2020-04-23-171113,171113,0,0,2,108,0.3333333333333333,81.22145050121124,3
2020-04-24-171113,171113,2,0,1,110,2.6666666666666665,59.01220559076815,4
2020-04-25-171113,171113,1,0,1,111,0.3333333333333333,72.46299549357187,5
2020-04-26-171113,171113,0,0,0,111,0.16666666666666666,74.18522433528857,6
2020-04-27-171113,171113,2,0,2,113,2.5,64.01246948875227,0
2020-04-28-171113,171113,2,1,3,115,0.8333333333333334,68.55958970152737,1
2020-04-29-171113,171113,1,0,2,116,1.3333333333333333,56.84744109248739,2
2020-04-30-171113,171113,3,0,0,119,2.0,61.724000164523844,3
2020-05-01-171113,171113,1,0,0,120,0.0,80.0097377836517,4
2020-05-02-171113,171113,0,0,0,120,0.16666666666666666,47.13229253976013,5
2020-05-03-171113,171113,2,0,0,122,0.0,31.598364800064154,6
2020-05-04-171113,171113,3,0,1,125,4.5,25.15750234889081,0
2020-05-05-171113,171113,6,0,3,131,1.5,45.725209106556576,1
2020-05-06-171113,171113,0,0,0,131,12.0,69.01240269571409,2
2020-05-07-171113,171113,2,0,0,133,5.5,87.63638462876635,3
2020-05-08-171113,171113,1,0,1,134,3.1666666666666665,111.54277105820817,4
2020-05-09-171113,171113,1,1,0,135,0.5,127.4124514762111,5
2020-05-10-171113,171113,0,0,0,135,0.0,84.54643126503257,6
2020-05-11-171113,171113,2,0,2,137,1.5,77.5952092183797,0
2020-05-12-171113,171113,3,0,1,140,4.0,84.53798218192995,1
2020-05-13-171113,171113,2,0,0,142,1.8333333333333333,70.71355984061776,2
2020-05-14-171113,171113,0,0,2,142,1.1666666666666667,69.86610813040664,3
2020-05-15-171113,171113,0,0,0,142,2.0,64.23842231690767,4
2020-05-16-171113,171113,0,0,0,142,0.16666666666666666,66.14913869018879,5
2020-05-17-171113,171113,0,0,0,142,0.0,64.04380002504266,6
2020-05-18-171113,171113,1,0,0,143,1.5,65.77639020300201,0
2020-05-19-171113,171113,3,0,2,146,2.833333333333333,61.991015330703206,1
2020-05-20-171113,171113,0,0,1,146,2.6666666666666665,45.03356484902257,2
2020-05-21-171113,171113,0,0,0,146,3.333333333333333,47.79557526854113,3
2020-05-22-171113,171113,1,0,1,147,1.6666666666666667,54.36688101789993,4
2020-05-23-171113,171113,0,0,0,147,0.16666666666666666,63.114510118809584,5
2020-05-24-171113,171113,0,0,0,147,0.0,65.64747223166606,6
2020-05-25-171113,171113,2,0,1,149,1.0,56.74886094150743,0
2020-05-26-171113,171113,1,0,0,150,0.6666666666666666,53.07342344826918,1
2020-05-27-171113,171113,0,3,0,150,0.5,61.73315165061821,2
2020-05-28-171113,171113,2,0,1,152,2.0,57.415204315811366,3
2020-05-29-171113,171113,0,0,0,152,0.6666666666666666,51.356635108746985,4
2020-05-30-171113,171113,0,0,0,152,0.0,50.7111944497765,5
2020-05-31-171113,171113,0,0,0,152,0.0,52.04108945231673,6
2020-06-01-171113,171113,0,0,0,152,0.0,158.6029207484289,0
2020-06-02-171113,171113,2,1,0,154,0.6666666666666666,14.955602540907787,1
2020-06-03-171113,171113,1,0,1,155,0.5,20.01466153095612,2
2020-06-04-171113,171113,0,0,0,155,1.1666666666666667,21.761403888861324,3
2020-06-05-171113,171113,1,0,0,156,0.3333333333333333,22.248548166580733,4
2020-06-06-171113,171113,0,0,0,156,0.16666666666666666,26.916097742686137,5
2020-06-07-171113,171113,0,0,0,156,0.0,27.30286335627411,6
2020-06-08-171113,171113,1,0,0,157,0.6666666666666666,23.16429975115224,0
2020-06-09-171113,171113,0,0,1,157,0.3333333333333333,29.51289596728809,1
2020-06-10-171113,171113,0,0,0,157,0.3333333333333333,166.00934018489457,2
2020-06-11-171113,171113,1,0,2,158,0.5,131.60872917789317,3
2020-06-12-171113,171113,0,0,0,158,0.3333333333333333,111.40829598547498,4
2020-06-13-171113,171113,0,3,0,158,0.0,73.42367831696976,5
2020-06-14-171113,171113,0,1,0,158,0.0,41.25798222491579,6
2020-06-15-171113,171113,0,2,0,158,0.5,22.217525046074428,0
2020-06-16-171113,171113,0,0,0,158,0.0,18.07799996900991,1
2020-06-17-171113,171113,1,0,0,159,0.0,17.759561572874915,2
2020-06-18-171113,171113,0,0,0,159,0.0,18.61856196100702,3
2020-06-19-171113,171113,0,0,0,159,0.6666666666666666,10.740387889597546,4
2020-06-20-171113,171113,0,0,1,159,0.0,24.86456322788422,5
2020-06-21-171113,171113,0,0,0,159,0.0,25.711637767677765,6
2020-06-22-171113,171113,0,0,0,159,0.3333333333333333,24.072395120823675,0
2020-06-23-171113,171113,1,0,0,160,0.0,24.250257123904483,1
2020-06-24-171113,171113,0,0,0,160,0.16666666666666666,24.703356450830547,2
2020-06-25-171113,171113,2,0,0,162,0.16666666666666666,25.76831051576911,3
2020-06-26-171113,171113,0,0,2,162,0.16666666666666666,24.46565485951489,4
2020-06-27-171113,171113,0,0,0,162,0.0,16.511114769057187,5
2020-06-28-171113,171113,0,0,0,162,0.16666666666666666,16.91522006616796,6
2020-06-29-171113,171113,0,0,2,162,0.0,21.3670539257745,0
2020-06-30-171113,171113,0,0,3,162,0.3333333333333333,25.263017020591384,1
2020-07-01-171113,171113,0,0,0,162,0.0,31.93569939764442,2
2020-07-02-171113,171113,0,0,1,162,0.0,23.364759507380363,3
2020-07-03-171113,171113,0,0,1,162,0.0,12.797934644256841,4
2020-07-04-171113,171113,1,0,0,163,0.0,27.63926750807931,5
2020-07-05-171113,171113,0,0,0,163,0.16666666666666666,31.132676568083465,6
2020-07-06-171113,171113,0,0,0,163,0.16666666666666666,26.872787164916115,0
2020-07-07-171113,171113,0,0,0,163,0.0,28.29988500645311,1
2020-07-08-171113,171113,0,1,0,163,0.0,24.181946120037757,2
2020-07-09-171113,171113,0,0,0,163,0.0,23.503197683833434,3
2020-07-10-171113,171113,2,0,0,165,0.0,31.5206691001915,4
2020-07-11-171113,171113,0,0,0,165,0.0,30.440301453552117,5
2020-07-12-171113,171113,0,0,0,165,0.0,23.325508715139634,6
2020-07-13-171113,171113,2,0,1,167,0.0,22.788307108570645,0
2020-07-14-171113,171113,3,0,0,170,0.16666666666666666,30.215539454268168,1
2020-07-15-171113,171113,0,0,1,170,0.0,27.270893229579073,2
2020-07-16-171113,171113,1,0,1,171,0.16666666666666666,24.15809963567075,3
2020-07-17-171113,171113,1,0,0,172,0.0,27.63656971877811,4
2020-07-18-171113,171113,0,0,0,172,0.16666666666666666,23.688446276378137,5
2020-07-19-171113,171113,0,0,0,172,0.0,25.457902710765826,6
2020-07-20-171113,171113,0,0,1,172,0.0,18.895534974737984,0
2020-07-21-171113,171113,0,0,0,172,0.0,11.812731078048945,1
2020-07-22-171113,171113,0,0,0,172,0.16666666666666666,12.544889092893243,2
2020-07-23-171113,171113,0,0,0,172,0.0,10.762535662595585,3
2020-07-24-171113,171113,0,0,1,172,0.16666666666666666,7.6103285709340645,4
2020-07-25-171113,171113,0,0,0,172,0.0,6.979234474685069,5
2020-07-26-171113,171113,0,0,0,172,0.0,6.864176102220731,6
2020-07-27-171113,171113,1,0,0,173,0.16666666666666666,6.382820033540847,0
2020-07-28-171113,171113,0,0,0,173,0.0,11.657831331775203,1
2020-07-29-171113,171113,1,0,1,174,0.16666666666666666,11.189079107604531,2
2020-07-30-171113,171113,1,0,1,175,0.16666666666666666,13.215958153393075,3
2020-07-31-171113,171113,0,0,0,175,0.5,23.820702183462444,4
2020-08-01-171113,171113,0,0,0,175,0.0,13.129172455605485,5
2020-08-02-171113,171113,0,0,0,175,0.0,66.73661617062615,6
2020-08-03-171113,171113,1,0,0,176,0.5,85.295643978255,0
2020-08-04-171113,171113,0,0,0,176,0.16666666666666666,83.11603751890844,1
2020-08-05-171113,171113,0,0,0,176,0.16666666666666666,73.55324689527049,2
2020-08-06-171113,171113,0,0,3,176,0.3333333333333333,61.54884064848643,3
2020-08-07-171113,171113,1,0,1,177,0.8333333333333334,48.11553055241089,4
2020-08-08-171113,171113,0,0,0,177,0.0,57.349665116082875,5
2020-08-09-171113,171113,0,0,2,177,0.0,47.70008623842868,6
2020-08-10-171113,171113,0,0,1,177,0.16666666666666666,8.964436291094625,0
2020-08-11-171113,171113,0,0,1,177,0.5,10.09220326655092,1
2020-08-12-171113,171113,1,0,0,178,0.6666666666666666,12.271022697097594,2
2020-08-13-171113,171113,1,0,0,179,0.5,16.848237250514426,3
2020-08-14-171113,171113,0,1,1,179,0.3333333333333333,38.725756785454244,4
2020-08-15-171113,171113,0,0,0,179,0.3333333333333333,47.57746690392014,5
2020-08-16-171113,171113,0,0,0,179,0.16666666666666666,49.56830444180349,6
2020-08-17-171113,171113,0,0,1,179,0.3333333333333333,52.43924044293669,0
2020-08-18-171113,171113,0,0,1,179,1.3333333333333333,53.54309874879615,1
2020-08-19-171113,171113,0,0,0,179,0.3333333333333333,66.76528902588268,2
2020-08-20-171113,171113,3,0,0,182,0.8333333333333334,45.48232721822569,3
2020-08-21-171113,171113,1,0,0,183,0.3333333333333333,55.031026286294036,4
2020-08-22-171113,171113,0,0,0,183,0.0,65.71332209320292,5
2020-08-23-171113,171113,2,0,0,185,0.0,64.79258117566691,6
2020-08-24-171113,171113,1,0,0,186,1.1666666666666667,64.39948177628892,0
2020-08-25-171113,171113,1,0,0,187,0.3333333333333333,64.83884873504198,1
2020-08-26-171113,171113,0,0,0,187,0.6666666666666666,69.08863984721413,2
2020-08-27-171113,171113,0,0,2,187,1.1666666666666667,77.39599588872716,3
2020-08-28-171113,171113,1,0,0,188,0.8333333333333334,75.04886836705828,4
2020-08-29-171113,171113,0,0,0,188,0.16666666666666666,77.51734732507964,5
2020-08-30-171113,171113,0,0,0,188,0.0,83.35273391188144,6
2020-08-31-171113,171113,1,0,0,189,1.1666666666666667,67.47215441284527,0
2020-09-01-171113,171113,1,0,0,190,1.1666666666666667,41.81519822624034,1
2020-09-02-171113,171113,0,0,0,190,1.0,151.18010954766686,2
2020-09-03-171113,171113,0,0,0,190,0.0,155.72771610378453,3
2020-09-04-171113,171113,0,0,1,190,1.6666666666666667,128.40428909308605,4
2020-09-05-171113,171113,0,0,4,190,0.3333333333333333,120.96742439755302,5
2020-09-06-171113,171113,0,0,4,190,0.3333333333333333,101.91921927221696,6
2020-09-07-171113,171113,0,0,0,190,0.6666666666666666,84.49198546487722,0
2020-09-08-171113,171113,0,0,0,190,1.8333333333333333,80.00848159645224,1
2020-09-09-171113,171113,0,0,0,190,0.6666666666666666,83.6655204550768,2
2020-09-10-171113,171113,2,0,1,192,1.1666666666666667,36.92573211896662,3
2020-09-11-171113,171113,0,0,0,192,0.8333333333333334,58.02033693494942,4
2020-09-12-171113,171113,0,0,2,192,0.16666666666666666,75.0583005319699,5
2020-09-13-171113,171113,0,0,0,192,0.5,78.29312724057058,6
2020-09-14-171113,171113,0,0,1,192,1.6666666666666667,73.41191307002259,0
2020-09-15-171113,171113,0,0,0,192,1.0,93.21233649997177,1
2020-09-16-171113,171113,0,0,0,192,1.0,107.88870921540324,2
2020-09-17-171113,171113,0,0,0,192,0.6666666666666666,115.84058046970513,3
2020-09-18-171113,171113,1,0,2,193,2.833333333333333,121.06474950063962,4
2020-09-19-171113,171113,4,0,0,197,0.3333333333333333,130.85976684960707,5
2020-09-20-171113,171113,4,1,1,201,0.5,145.9765076219386,6
2020-09-21-171113,171113,0,0,2,201,5.5,143.31526017930054,0
2020-09-22-171113,171113,0,1,3,201,0.6666666666666666,189.41925602028525,1
2020-09-23-171113,171113,0,0,1,201,1.5,180.2411535416815,2
2020-09-24-171113,171113,1,0,4,202,2.833333333333333,169.59809082011483,3
2020-09-25-171113,171113,0,0,1,202,5.166666666666667,170.68999111969293,4
2020-09-26-171113,171113,2,0,3,204,2.833333333333333,171.38665385111858,5
2020-09-27-171113,171113,0,0,1,204,2.1666666666666665,183.3600896455173,6
2020-09-28-171113,171113,1,0,0,205,2.1666666666666665,184.61903370186332,0
2020-09-29-171113,171113,0,0,1,205,2.833333333333333,138.9513733101797,1
2020-09-30-171113,171113,0,0,7,205,2.6666666666666665,129.35921833051344,2
2020-10-01-171113,171113,0,0,5,205,1.5,0.0,3
2020-10-02-171113,171113,2,0,5,207,2.333333333333333,282.0557242757974,4
2020-10-03-171113,171113,0,0,5,207,2.833333333333333,303.97916035024457,5
2020-10-04-171113,171113,1,1,1,208,1.3333333333333333,335.90292121637856,6
2020-10-05-171113,171113,2,0,6,210,1.1666666666666667,296.9234150588652,0
2020-10-06-171113,171113,3,1,8,213,3.8333333333333335,262.39962814139653,1
2020-10-07-171113,171113,1,1,1,214,1.5,239.4133691351548,2
2020-10-08-171113,171113,4,0,1,218,2.0,205.6909671174177,3
2020-10-09-171113,171113,1,1,6,219,2.333333333333333,208.87504510379603,4
2020-10-10-171113,171113,3,0,2,222,1.5,18.696146276879844,5
2020-10-11-171113,171113,1,0,1,223,0.8333333333333334,39.75907924514213,6
2020-10-12-171113,171113,0,0,3,223,0.3333333333333333,53.8591470932915,0
2020-10-13-171113,171113,1,0,11,224,1.6666666666666667,59.47754188315852,1
2020-10-14-171113,171113,7,0,5,231,1.0,81.45598902329334,2
2020-10-15-171113,171113,5,0,7,236,1.6666666666666667,124.63696819461018,3
2020-10-16-171113,171113,5,0,5,241,4.666666666666667,167.40271035968118,4
2020-10-17-171113,171113,5,0,2,246,1.1666666666666667,233.4773986494621,5
2020-10-18-171113,171113,1,0,2,247,1.1666666666666667,230.0839167319965,6
2020-10-19-171113,171113,6,0,0,253,2.333333333333333,235.4983229400873,0
2020-10-20-171113,171113,8,0,2,261,6.0,276.37600350575474,1
2020-10-21-171113,171113,1,0,4,262,8.666666666666666,295.18406726898525,2
2020-10-22-171113,171113,1,0,6,263,10.833333333333336,332.60959659508575,3
2020-10-23-171113,171113,6,0,4,269,4.5,356.3933347783667,4
2020-10-24-171113,171113,2,0,5,271,1.6666666666666667,376.9842882881344,5
2020-10-25-171113,171113,1,0,2,272,0.8333333333333334,367.0611302341294,6
2020-10-26-171113,171113,3,0,0,275,6.5,328.20920605993854,0
2020-10-27-171113,171113,11,0,2,286,1.1666666666666667,346.186155123317,1
2020-10-28-171113,171113,5,0,1,291,3.0,342.15809957548726,2
2020-10-29-171113,171113,7,0,0,298,1.6666666666666667,315.3349211529443,3
2020-10-30-171113,171113,5,0,4,303,7.5,232.30992514746947,4
2020-10-31-171113,171113,2,0,0,305,2.1666666666666665,288.0658155622748,5
2020-11-01-171113,171113,2,0,0,307,1.3333333333333333,144.81921347130756,6
2020-11-02-171113,171113,0,2,0,307,2.0,159.35740027292718,0
2020-11-03-171113,171113,2,0,0,309,5.5,153.69014545506283,1
2020-11-04-171113,171113,4,0,0,313,3.8333333333333335,193.8755230100482,2
2020-11-05-171113,171113,6,0,0,319,3.6666666666666665,218.13056428382208,3
2020-11-06-171113,171113,4,0,0,323,8.333333333333334,240.14657109307325,4
2020-11-07-171113,171113,5,0,0,328,1.0,295.7466179706062,5
2020-11-08-171113,171113,2,0,0,330,0.5,278.6019235431704,6
2020-11-09-171113,171113,0,0,0,330,3.1666666666666665,273.53252829855455,0
2020-11-10-171113,171113,2,0,0,332,3.0,136.3355375646097,1
2020-11-11-171113,171113,1,1,0,333,2.0,156.08407191101665,2
2020-11-12-171113,171113,0,1,0,333,2.0,165.0754320355187,3
2020-11-13-171113,171113,4,0,0,337,1.3333333333333333,161.47163922667394,4
2020-03-01-171114,171114,0,0,0,0,0.0,0.0,6
2020-03-02-171114,171114,0,0,1,0,0.0,4.188901782667608,0
2020-03-03-171114,171114,0,0,5,0,0.0,10.028641394070078,1
2020-03-04-171114,171114,0,1,2,0,0.0,12.187364815599164,2
2020-03-05-171114,171114,0,0,2,0,0.0,12.692820837608817,3
2020-03-06-171114,171114,0,0,2,0,0.0,12.37230957652956,4
2020-03-07-171114,171114,0,0,0,0,0.3333333333333333,9.884474286142375,5
2020-03-08-171114,171114,0,0,0,0,0.0,12.386465201663242,6
2020-03-09-171114,171114,1,0,2,1,0.0,12.837894678373564,0
2020-03-10-171114,171114,1,0,2,2,0.0,105.33293518665334,1
2020-03-11-171114,171114,0,0,1,2,0.0,80.5445113908061,2
2020-03-12-171114,171114,0,0,3,2,0.0,53.77588385501873,3
2020-03-13-171114,171114,0,0,2,2,0.3333333333333333,29.84555034991539,4
2020-03-14-171114,171114,0,0,2,2,0.3333333333333333,26.941041629871222,5
2020-03-15-171114,171114,0,0,0,2,0.0,24.160378850208595,6
2020-03-16-171114,171114,1,0,0,3,0.0,7.107908419504191,0
2020-03-17-171114,171114,5,1,2,8,0.3333333333333333,10.369055937656517,1
2020-03-18-171114,171114,2,1,0,10,0.0,22.699297417956604,2
2020-03-19-171114,171114,2,0,4,12,0.0,28.114087473267507,3
2020-03-20-171114,171114,2,0,1,14,0.3333333333333333,31.414635398428118,4
2020-03-21-171114,171114,0,0,0,14,0.6666666666666666,34.48262450744735,5
2020-03-22-171114,171114,0,0,0,14,0.0,34.030425622810014,6
2020-03-23-171114,171114,2,0,2,16,0.3333333333333333,31.15150059150023,0
2020-03-24-171114,171114,2,0,3,18,0.0,22.78723561378426,1
2020-03-25-171114,171114,1,0,1,19,1.0,21.57917241694372,2
2020-03-26-171114,171114,3,0,1,22,0.0,19.695013957039453,3
2020-03-27-171114,171114,2,0,0,24,0.0,24.172347666150543,4
2020-03-28-171114,171114,2,0,0,26,0.0,21.639935294501253,5
2020-03-29-171114,171114,0,0,0,26,0.0,23.883139040997246,6
2020-03-30-171114,171114,0,0,0,26,0.0,19.63226458030282,0
2020-03-31-171114,171114,2,0,2,28,0.0,15.453280781688704,1
2020-04-01-171114,171114,0,0,1,28,1.6666666666666667,7.048114705169356,2
2020-04-02-171114,171114,4,0,1,32,1.0,11.871979430691319,3
2020-04-03-171114,171114,1,0,1,33,1.6666666666666667,21.86240187197736,4
2020-04-04-171114,171114,0,0,0,33,0.3333333333333333,31.31108628695394,5
2020-04-05-171114,171114,0,0,0,33,0.0,30.784876794889833,6
2020-04-06-171114,171114,2,0,0,35,0.0,30.340187207953484,0
2020-04-07-171114,171114,3,0,0,38,0.3333333333333333,33.12817046032218,1
2020-04-08-171114,171114,1,0,3,39,0.0,33.37590116570981,2
2020-04-09-171114,171114,1,0,2,40,0.0,27.40808005670212,3
2020-04-10-171114,171114,0,0,2,40,0.0,7.433071823671209,4
2020-04-11-171114,171114,0,0,1,40,0.0,7.4132684588966224,5
2020-04-12-171114,171114,0,1,0,40,0.0,7.230855022946564,6
2020-04-13-171114,171114,0,0,0,40,0.6666666666666666,7.298738015917567,0
2020-04-14-171114,171114,2,0,3,42,0.0,7.382005934583001,1
2020-04-15-171114,171114,1,0,5,43,0.0,11.296350171931362,2
2020-04-16-171114,171114,1,0,2,44,0.0,12.318501569404745,3
2020-04-17-171114,171114,1,0,1,45,0.3333333333333333,9.743319349024485,4
2020-04-18-171114,171114,0,0,0,45,0.0,14.18647414674636,5
2020-04-19-171114,171114,0,1,0,45,0.0,15.021204287566832,6
2020-04-20-171114,171114,0,0,0,45,0.0,38.468876378453714,0
2020-04-21-171114,171114,0,0,0,45,0.0,35.82759929144307,1
2020-04-22-171114,171114,3,0,1,48,0.0,35.970923023890386,2
2020-04-23-171114,171114,2,0,1,50,0.0,40.40715079605912,3
2020-04-24-171114,171114,2,0,1,52,0.0,41.80691248278942,4
2020-04-25-171114,171114,1,0,0,53,0.0,48.89654719578431,5
2020-04-26-171114,171114,0,0,1,53,0.0,51.89381552789668,6
2020-04-27-171114,171114,0,0,0,53,0.0,24.322248512003487,0
2020-04-28-171114,171114,3,0,2,56,0.3333333333333333,23.76832442791462,1
2020-04-29-171114,171114,5,0,0,61,0.0,30.188603606544568,2
2020-04-30-171114,171114,2,0,0,63,0.0,57.20135764768895,3
2020-05-01-171114,171114,1,0,4,64,0.0,31.53727429154864,4
2020-05-02-171114,171114,0,0,0,64,0.0,26.337828416093867,5
2020-05-03-171114,171114,0,0,0,64,0.0,12.969849701806417,6
2020-05-04-171114,171114,0,0,1,64,0.0,12.981938357848694,0
2020-05-05-171114,171114,0,0,2,64,0.0,7.290473030529244,1
2020-05-06-171114,171114,1,0,0,65,0.3333333333333333,7.845680327155831,2
2020-05-07-171114,171114,1,0,0,66,0.0,12.616147603815932,3
2020-05-08-171114,171114,1,0,0,67,0.0,13.621917300386334,4
2020-05-09-171114,171114,0,0,0,67,0.0,14.883507272902532,5
2020-05-10-171114,171114,1,0,0,68,0.6666666666666666,31.07388296937592,6
2020-05-11-171114,171114,0,0,1,68,0.0,32.576158350285304,0
2020-05-12-171114,171114,2,0,1,70,0.0,33.229645916071895,1
2020-05-13-171114,171114,0,1,0,70,0.0,33.51684280796433,2
2020-05-14-171114,171114,0,0,0,70,0.0,25.543960161751468,3
2020-05-15-171114,171114,4,0,1,74,0.3333333333333333,22.223717668136192,4
2020-05-16-171114,171114,0,0,0,74,0.0,34.28680658297743,5
2020-05-17-171114,171114,0,0,1,74,0.0,30.73778364915769,6
2020-05-18-171114,171114,1,0,0,75,0.3333333333333333,27.224131638424986,0
2020-05-19-171114,171114,2,0,2,77,0.0,32.89754552830989,1
2020-05-20-171114,171114,0,0,0,77,0.0,32.08005291960892,2
2020-05-21-171114,171114,0,0,0,77,0.0,32.03167255527135,3
2020-05-22-171114,171114,0,0,0,77,0.0,15.728814401904453,4
2020-05-23-171114,171114,0,1,0,77,0.0,16.712170831126294,5
2020-05-24-171114,171114,0,0,0,77,0.0,16.997027319286644,6
2020-05-25-171114,171114,1,0,0,78,0.3333333333333333,10.486212072524522,0
2020-05-26-171114,171114,1,0,0,79,0.0,6.147269893827987,1
2020-05-27-171114,171114,0,6,1,79,0.0,14.838195304525586,2
2020-05-28-171114,171114,0,3,0,79,0.0,14.791361230914095,3
2020-05-29-171114,171114,1,0,0,80,0.0,14.481854483617658,4
2020-05-30-171114,171114,0,0,0,80,0.0,18.347444532925614,5
2020-05-31-171114,171114,1,0,0,81,0.0,18.88108305231003,6
2020-06-01-171114,171114,0,0,0,81,0.0,21.1183006575437,0
2020-06-02-171114,171114,2,0,0,83,0.0,0.9415368391272692,1
2020-06-03-171114,171114,0,2,0,83,0.0,1.2644778982162674,2
2020-06-04-171114,171114,0,0,0,83,0.0,0.7185806596664259,3
2020-06-05-171114,171114,0,0,0,83,0.0,1.2117451696949741,4
2020-06-06-171114,171114,0,0,0,83,0.0,1.2216293778231535,5
2020-06-07-171114,171114,0,0,0,83,0.0,1.258822223848125,6
2020-06-08-171114,171114,0,0,0,83,0.0,1.2589476122194025,0
2020-06-09-171114,171114,0,1,0,83,0.0,1.7135327608013493,1
2020-06-10-171114,171114,1,0,0,84,0.0,17.179740062901562,2
2020-06-11-171114,171114,0,0,0,84,0.0,16.38489630844169,3
2020-06-12-171114,171114,0,0,0,84,0.0,15.718761537131064,4
2020-06-13-171114,171114,0,0,0,84,0.0,8.84693527228772,5
2020-06-14-171114,171114,0,0,0,84,0.0,2.5089066377757856,6
2020-06-15-171114,171114,0,0,0,84,0.0,1.6147440087467846,0
2020-06-16-171114,171114,0,0,0,84,0.3333333333333333,1.6753580495046871,1
2020-06-17-171114,171114,0,0,0,84,0.0,1.5643761575180815,2
2020-06-18-171114,171114,0,0,0,84,0.0,1.337392930874726,3
2020-06-19-171114,171114,0,0,0,84,0.0,1.0492932796324577,4
2020-06-20-171114,171114,0,0,0,84,0.0,10.105103858735133,5
2020-06-21-171114,171114,0,0,0,84,0.0,10.380133022514782,6
2020-06-22-171114,171114,0,0,0,84,0.0,10.374004817289771,0
2020-06-23-171114,171114,0,0,0,84,0.0,10.646068907049422,1
2020-06-24-171114,171114,0,0,1,84,0.0,11.763629251439857,2
2020-06-25-171114,171114,0,0,0,84,0.0,12.28781117603797,3
2020-06-26-171114,171114,0,0,0,84,0.0,12.213323634628138,4
2020-06-27-171114,171114,0,0,0,84,0.0,2.1038437822498444,5
2020-06-28-171114,171114,0,0,0,84,0.0,2.3287509858764457,6
2020-06-29-171114,171114,0,0,0,84,0.0,2.498875035153953,0
2020-06-30-171114,171114,0,0,0,84,0.0,1.9837902782199206,1
2020-07-01-171114,171114,0,0,0,84,0.0,4.305842507700998,2
2020-07-02-171114,171114,0,0,0,84,0.0,0.7407274859761961,3
2020-07-03-171114,171114,0,0,0,84,0.0,1.253127114366438,4
2020-07-04-171114,171114,0,0,0,84,0.0,11.031907281346612,5
2020-07-05-171114,171114,0,0,0,84,0.0,11.232819727341571,6
2020-07-06-171114,171114,0,0,0,84,0.0,10.913910808468613,0
2020-07-07-171114,171114,0,0,0,84,0.0,11.267397305846185,1
2020-07-08-171114,171114,1,0,0,85,0.0,10.986947168422509,2
2020-07-09-171114,171114,0,0,0,85,0.0,16.85508544045901,3
2020-07-10-171114,171114,0,0,0,85,0.0,5.043096542064721,4
2020-07-11-171114,171114,0,0,0,85,0.0,4.3305678418729805,5
2020-07-12-171114,171114,0,0,0,85,0.0,3.690198598453109,6
2020-07-13-171114,171114,0,0,0,85,0.0,3.475761317179765,0
2020-07-14-171114,171114,0,0,0,85,0.0,3.535527321109747,1
2020-07-15-171114,171114,0,0,0,85,0.0,2.2559141477320654,2
2020-07-16-171114,171114,0,0,0,85,0.0,1.433638765000628,3
2020-07-17-171114,171114,0,0,2,85,0.0,1.448403040210625,4
2020-07-18-171114,171114,0,0,0,85,0.0,0.9542834314033152,5
2020-07-19-171114,171114,0,0,1,85,0.0,0.9769321857765243,6
2020-07-20-171114,171114,0,0,0,85,0.0,1.1107092225977984,0
2020-07-21-171114,171114,0,0,0,85,0.0,1.308871094980141,1
2020-07-22-171114,171114,0,0,1,85,0.0,1.4348099690236276,2
2020-07-23-171114,171114,0,0,0,85,0.0,1.532638558091912,3
2020-07-24-171114,171114,0,0,0,85,0.0,1.6163177422416246,4
2020-07-25-171114,171114,0,0,1,85,0.0,1.7663803656130672,5
2020-07-26-171114,171114,0,0,0,85,0.0,1.7458782341528996,6
2020-07-27-171114,171114,0,0,0,85,0.0,1.4564171805095263,0
2020-07-28-171114,171114,0,0,0,85,0.0,1.5338938296310505,1
2020-07-29-171114,171114,0,0,1,85,0.0,1.6378496375157434,2
2020-07-30-171114,171114,0,0,0,85,0.3333333333333333,1.8947761649099584,3
2020-07-31-171114,171114,2,0,1,87,0.0,5.232004657983721,4
2020-08-01-171114,171114,0,1,0,87,0.0,17.99494789461544,5
2020-08-02-171114,171114,1,0,1,88,0.0,82.00540097130168,6
2020-08-03-171114,171114,0,0,0,88,0.0,94.51523016174532,0
2020-08-04-171114,171114,0,0,0,88,0.0,68.74471800150774,1
2020-08-05-171114,171114,1,0,0,89,0.0,57.891806095535514,2
2020-08-06-171114,171114,0,0,0,89,0.0,56.614229596210265,3
2020-08-07-171114,171114,0,0,0,89,0.0,43.529781579309244,4
2020-08-08-171114,171114,1,0,1,90,0.0,89.66764092480877,5
2020-08-09-171114,171114,0,0,0,90,2.0,98.22449674696783,6
2020-08-10-171114,171114,0,0,0,90,0.0,19.75569135794635,0
2020-08-11-171114,171114,0,0,0,90,0.0,21.057745966617997,1
2020-08-12-171114,171114,1,0,1,91,0.0,71.44038492838511,2
2020-08-13-171114,171114,0,0,0,91,0.0,81.08218179634945,3
2020-08-14-171114,171114,1,0,1,92,0.0,84.09873147811278,4
2020-08-15-171114,171114,0,0,0,92,0.0,86.0295145786929,5
2020-08-16-171114,171114,1,0,1,93,0.6666666666666666,88.65240483029075,6
2020-08-17-171114,171114,0,0,0,93,0.0,96.04482567808972,0
2020-08-18-171114,171114,0,0,1,93,0.0,93.9571904859543,1
2020-08-19-171114,171114,0,0,1,93,0.0,46.97793955900846,2
2020-08-20-171114,171114,0,0,50,93,0.3333333333333333,97.50735829933946,3
2020-08-21-171114,171114,0,0,12,93,0.0,148.96530661666316,4
2020-08-22-171114,171114,1,0,3,94,1.0,378.4834885154571,5
2020-08-23-171114,171114,0,0,14,94,0.6666666666666666,388.8421375998779,6
2020-08-24-171114,171114,0,0,8,94,0.3333333333333333,385.8443288409043,0
2020-08-25-171114,171114,0,0,9,94,0.3333333333333333,437.8746040371471,1
2020-08-26-171114,171114,1,0,3,95,0.0,398.5991666933291,2
2020-08-27-171114,171114,0,0,15,95,0.6666666666666666,397.1633916595357,3
2020-08-28-171114,171114,1,0,4,96,0.0,340.76500811387524,4
2020-08-29-171114,171114,0,0,2,96,0.0,123.5744568677857,5
2020-08-30-171114,171114,1,0,0,97,0.3333333333333333,90.53647780476746,6
2020-08-31-171114,171114,0,0,1,97,1.3333333333333333,51.249297149707544,0
2020-09-01-171114,171114,1,0,5,98,0.3333333333333333,273.60733082591764,1
2020-09-02-171114,171114,1,0,0,99,0.0,573.2028686114407,2
2020-09-03-171114,171114,50,0,36,149,1.3333333333333333,164.45264817703446,3
2020-09-04-171114,171114,12,0,8,161,0.6666666666666666,520.7741509950924,4
2020-09-05-171114,171114,3,0,0,164,0.0,599.3016323233652,5
2020-09-06-171114,171114,14,0,1,178,0.3333333333333333,592.0920537790117,6
2020-09-07-171114,171114,8,0,13,186,0.3333333333333333,675.5140491724572,0
2020-09-08-171114,171114,9,0,1,195,0.6666666666666666,742.2761199885118,1
2020-09-09-171114,171114,3,0,3,198,1.0,801.209671779459,2
2020-09-10-171114,171114,15,0,4,213,1.6666666666666667,182.97637087532462,3
2020-09-11-171114,171114,4,0,2,217,0.0,218.24895068624107,4
2020-09-12-171114,171114,2,1,0,219,0.3333333333333333,256.06767360659694,5
2020-09-13-171114,171114,0,0,0,219,0.0,281.4191702702938,6
2020-09-14-171114,171114,1,2,0,220,0.0,254.40442749405642,0
2020-09-15-171114,171114,5,0,1,225,0.0,253.07375560870744,1
2020-09-16-171114,171114,0,2,2,225,1.3333333333333333,159.55169229706863,2
2020-09-17-171114,171114,36,0,0,261,0.0,255.04801961300424,3
2020-09-18-171114,171114,8,0,2,269,0.3333333333333333,376.9279888825825,4
2020-09-19-171114,171114,0,0,1,269,0.0,404.28094448173994,5
2020-09-20-171114,171114,1,0,0,270,0.3333333333333333,365.0658197179145,6
2020-09-21-171114,171114,13,1,1,283,0.0,354.59927822968535,0
2020-09-22-171114,171114,1,0,3,284,2.0,383.1391006075697,1
2020-09-23-171114,171114,3,0,0,287,0.3333333333333333,313.5668024606187,2
2020-09-24-171114,171114,4,2,0,291,1.3333333333333333,179.2378186081154,3
2020-09-25-171114,171114,2,0,4,293,0.6666666666666666,154.88755105889845,4
2020-09-26-171114,171114,0,0,0,293,0.0,182.36287899941507,5
2020-09-27-171114,171114,0,0,0,293,0.0,180.5467001285037,6
2020-09-28-171114,171114,0,0,1,293,0.3333333333333333,177.33288948208704,0
2020-09-29-171114,171114,1,0,1,294,0.6666666666666666,128.6784314753078,1
2020-09-30-171114,171114,2,0,2,296,0.0,372.47310381190096,2
2020-10-01-171114,171114,0,1,1,296,0.3333333333333333,0.0,3
2020-10-02-171114,171114,2,0,3,298,0.0,106.89630350520781,4
2020-10-03-171114,171114,1,0,1,299,0.0,329.1394700674644,5
2020-10-04-171114,171114,0,0,1,299,0.0,327.94774680609754,6
2020-10-05-171114,171114,1,1,6,300,0.3333333333333333,308.6019056531286,0
2020-10-06-171114,171114,3,0,3,303,0.3333333333333333,171.50171617698203,1
2020-10-07-171114,171114,0,0,7,303,0.3333333333333333,134.9388275236256,2
2020-10-08-171114,171114,0,0,1,303,1.0,129.88883840804314,3
2020-10-09-171114,171114,4,3,9,307,0.0,136.7494331743585,4
2020-10-10-171114,171114,0,0,2,307,0.0,3.3456223185840677,5
2020-10-11-171114,171114,0,0,2,307,0.0,5.139430833960382,6
2020-10-12-171114,171114,1,0,0,308,0.3333333333333333,7.478988321246721,0
2020-10-13-171114,171114,1,0,2,309,0.3333333333333333,17.57591424804143,1
2020-10-14-171114,171114,2,0,11,311,0.3333333333333333,24.515058505087033,2
2020-10-15-171114,171114,1,0,1,312,0.0,41.41844879008393,3
2020-10-16-171114,171114,3,0,11,315,0.3333333333333333,56.47232104498469,4
2020-10-17-171114,171114,1,0,1,316,0.3333333333333333,67.72711458712139,5
2020-10-18-171114,171114,1,0,4,317,0.6666666666666666,71.92165286136742,6
2020-10-19-171114,171114,6,0,3,323,0.3333333333333333,76.41836950044046,0
2020-10-20-171114,171114,3,0,0,326,0.6666666666666666,112.74592527495116,1
2020-10-21-171114,171114,7,0,7,333,0.0,114.4851069206818,2
2020-10-22-171114,171114,1,0,6,334,1.0,138.91174558176226,3
2020-10-23-171114,171114,9,0,3,343,3.333333333333333,140.12024293937662,4
2020-10-24-171114,171114,2,0,0,345,0.0,191.01069694139474,5
2020-10-25-171114,171114,2,0,0,347,1.0,187.01996850975559,6
2020-10-26-171114,171114,0,1,1,347,1.6666666666666667,161.1889308569616,0
2020-10-27-171114,171114,2,0,3,349,5.333333333333333,167.7126675128202,1
2020-10-28-171114,171114,11,0,2,360,1.0,301.821642134365,2
2020-10-29-171114,171114,1,0,0,361,0.3333333333333333,325.33924510034075,3
2020-10-30-171114,171114,11,0,7,372,4.0,267.5457652969325,4
2020-10-31-171114,171114,1,1,0,373,0.6666666666666666,334.5826963398195,5
2020-11-01-171114,171114,4,2,0,377,0.3333333333333333,89.77902645329232,6
2020-11-02-171114,171114,3,0,0,380,0.6666666666666666,166.31253859504005,0
2020-11-03-171114,171114,0,0,0,380,0.3333333333333333,140.1533141876485,1
2020-11-04-171114,171114,7,0,0,387,0.3333333333333333,149.75223938003822,2
2020-11-05-171114,171114,6,0,0,393,0.3333333333333333,187.2133597071067,3
2020-11-06-171114,171114,3,3,0,396,1.6666666666666667,202.31337299692143,4
2020-11-07-171114,171114,0,0,0,396,0.0,214.2499576666517,5
2020-11-08-171114,171114,0,0,0,396,0.3333333333333333,132.81416719439858,6
2020-11-09-171114,171114,1,0,0,397,1.6666666666666667,111.95582817746914,0
2020-11-10-171114,171114,3,0,0,400,0.6666666666666666,88.8417322679483,1
2020-11-11-171114,171114,2,0,0,402,0.3333333333333333,106.31794287801256,2
2020-11-12-171114,171114,0,0,0,402,0.0,113.66086283247296,3
2020-11-13-171114,171114,7,1,0,409,0.0,98.86729505412737,4
2020-03-01-171115,171115,0,0,0,0,0.0,0.0,6
2020-03-02-171115,171115,0,0,0,0,0.14285714285714285,10.670383300784541,0
2020-03-03-171115,171115,0,0,0,0,0.0,43.94919827677883,1
2020-03-04-171115,171115,0,1,1,0,0.0,49.1649188720094,2
2020-03-05-171115,171115,0,0,1,0,0.0,54.32223871654844,3
2020-03-06-171115,171115,0,0,0,0,0.0,45.82389083871947,4
2020-03-07-171115,171115,0,0,1,0,0.2857142857142857,54.69063856804091,5
2020-03-08-171115,171115,0,0,0,0,0.0,58.00653684527636,6
2020-03-09-171115,171115,0,0,2,0,0.2857142857142857,59.9340025637309,0
2020-03-10-171115,171115,0,0,0,0,0.0,472.4979889935678,1
2020-03-11-171115,171115,0,0,2,0,0.5714285714285714,384.98534275814063,2
2020-03-12-171115,171115,0,0,1,0,1.0,285.12488411603596,3
2020-03-13-171115,171115,0,0,1,0,0.8571428571428571,120.51641178995051,4
2020-03-14-171115,171115,0,0,0,0,0.2857142857142857,111.47585389480136,5
2020-03-15-171115,171115,0,0,1,0,0.2857142857142857,89.49272918750354,6
2020-03-16-171115,171115,0,3,2,0,1.1428571428571428,25.485038601905504,0
2020-03-17-171115,171115,0,0,1,0,1.5714285714285714,38.3045107799725,1
2020-03-18-171115,171115,1,0,0,1,2.571428571428572,45.60491355807892,2
2020-03-19-171115,171115,1,1,1,2,1.8571428571428568,59.70399599114452,3
2020-03-20-171115,171115,0,2,1,2,1.2857142857142858,63.38138847257588,4
2020-03-21-171115,171115,1,0,0,3,0.42857142857142855,68.05989740635965,5
2020-03-22-171115,171115,0,0,0,3,0.8571428571428571,68.50306826698011,6
2020-03-23-171115,171115,2,0,1,5,2.7142857142857144,62.86092334968832,0
2020-03-24-171115,171115,0,0,0,5,1.1428571428571428,87.11097389257543,1
2020-03-25-171115,171115,2,0,0,7,2.571428571428572,78.48722570797716,2
2020-03-26-171115,171115,1,0,1,8,2.142857142857143,85.47845618374116,3
2020-03-27-171115,171115,1,0,1,9,2.142857142857143,97.80965507016197,4
2020-03-28-171115,171115,0,0,0,9,0.2857142857142857,106.74134234470924,5
2020-03-29-171115,171115,1,0,0,10,1.0,100.9096730277978,6
2020-03-30-171115,171115,2,0,1,12,2.571428571428572,71.60296979564616,0
2020-03-31-171115,171115,1,0,0,13,1.1428571428571428,84.72484605191097,1
2020-04-01-171115,171115,0,0,0,13,2.8571428571428568,11.910653176851522,2
2020-04-02-171115,171115,1,0,6,14,1.0,61.51243486654714,3
2020-04-03-171115,171115,1,0,0,15,1.4285714285714286,59.45736479212712,4
2020-04-04-171115,171115,0,0,0,15,0.5714285714285714,54.84510669687844,5
2020-04-05-171115,171115,0,0,1,15,0.5714285714285714,51.29754354785541,6
2020-04-06-171115,171115,1,0,2,16,2.2857142857142856,53.65055873439062,0
2020-04-07-171115,171115,0,0,1,16,0.7142857142857143,49.07861574051836,1
2020-04-08-171115,171115,0,0,0,16,1.7142857142857142,47.50163099276307,2
2020-04-09-171115,171115,1,0,1,17,0.5714285714285714,48.749610221848634,3
2020-04-10-171115,171115,1,0,2,18,0.5714285714285714,19.02248469566196,4
2020-04-11-171115,171115,0,1,1,18,1.1428571428571428,22.984221610911444,5
2020-04-12-171115,171115,0,0,0,18,0.7142857142857143,27.26332263733707,6
2020-04-13-171115,171115,1,0,3,19,0.8571428571428571,29.888811161556962,0
2020-04-14-171115,171115,0,0,0,19,0.7142857142857143,38.43742835137386,1
2020-04-15-171115,171115,0,0,0,19,0.7142857142857143,41.891430794190114,2
2020-04-16-171115,171115,6,0,0,25,2.4285714285714284,45.30166745489318,3
2020-04-17-171115,171115,0,0,0,25,1.0,62.40514550269913,4
2020-04-18-171115,171115,0,0,2,25,0.14285714285714285,65.33783171651582,5
2020-04-19-171115,171115,1,0,1,26,0.14285714285714285,61.54911209765446,6
2020-04-20-171115,171115,2,0,0,28,1.2857142857142858,59.65403476386966,0
2020-04-21-171115,171115,1,0,9,29,0.5714285714285714,68.71561204705172,1
2020-04-22-171115,171115,0,0,2,29,0.14285714285714285,73.02548163785664,2
2020-04-23-171115,171115,1,0,0,30,0.14285714285714285,42.922698490128084,3
2020-04-24-171115,171115,2,0,7,32,0.8571428571428571,44.22132253009198,4
2020-04-25-171115,171115,1,0,0,33,0.2857142857142857,57.826663047247685,5
2020-04-26-171115,171115,0,0,0,33,0.0,58.87059158897629,6
2020-04-27-171115,171115,3,0,1,36,1.1428571428571428,51.809516672088925,0
2020-04-28-171115,171115,0,0,1,36,1.2857142857142858,60.68856068554832,1
2020-04-29-171115,171115,0,1,2,36,1.4285714285714286,58.15329236770485,2
2020-04-30-171115,171115,0,0,0,36,1.5714285714285714,62.08589491248818,3
2020-05-01-171115,171115,0,0,0,36,0.14285714285714285,55.475388620579295,4
2020-05-02-171115,171115,2,0,0,38,0.42857142857142855,38.49903062181912,5
2020-05-03-171115,171115,1,0,0,39,0.0,20.337411984854736,6
2020-05-04-171115,171115,0,0,0,39,2.0,18.479490637840215,0
2020-05-05-171115,171115,9,0,0,48,0.5714285714285714,26.078037869704055,1
2020-05-06-171115,171115,2,0,0,50,0.7142857142857143,66.42065099179406,2
2020-05-07-171115,171115,0,0,0,50,1.4285714285714286,84.16834656867675,3
2020-05-08-171115,171115,7,0,0,57,0.8571428571428571,88.83066630459928,4
2020-05-09-171115,171115,0,0,0,57,0.5714285714285714,119.35374230050715,5
2020-05-10-171115,171115,0,3,0,57,0.0,52.883314767329715,6
2020-05-11-171115,171115,1,0,0,58,0.42857142857142855,51.074748012617306,0
2020-05-12-171115,171115,1,0,0,59,1.1428571428571428,56.84380404673658,1
2020-05-13-171115,171115,2,0,0,61,1.7142857142857142,50.50790911608951,2
2020-05-14-171115,171115,0,0,0,61,0.8571428571428571,65.2730807987379,3
2020-05-15-171115,171115,0,0,0,61,1.1428571428571428,61.231874660482454,4
2020-05-16-171115,171115,0,0,0,61,0.5714285714285714,55.576796629017835,5
2020-05-17-171115,171115,0,0,0,61,0.0,57.862734948871804,6
2020-05-18-171115,171115,0,0,0,61,0.2857142857142857,58.60581907432824,0
2020-05-19-171115,171115,0,0,0,61,0.8571428571428571,51.75369267473727,1
2020-05-20-171115,171115,0,0,0,61,0.42857142857142855,39.56048281093364,2
2020-05-21-171115,171115,0,0,0,61,1.5714285714285714,37.80090727787407,3
2020-05-22-171115,171115,0,0,0,61,0.0,46.35767989030063,4
2020-05-23-171115,171115,0,0,0,61,0.0,45.84897719941302,5
2020-05-24-171115,171115,0,0,0,61,0.14285714285714285,46.58066518633544,6
2020-05-25-171115,171115,0,0,0,61,0.7142857142857143,44.20025696457276,0
2020-05-26-171115,171115,0,0,0,61,1.2857142857142858,42.90321455410867,1
2020-05-27-171115,171115,0,0,1,61,0.5714285714285714,42.29478882796661,2
2020-05-28-171115,171115,0,0,0,61,0.0,44.31176674472485,3
2020-05-29-171115,171115,0,0,0,61,0.42857142857142855,28.48693600282942,4
2020-05-30-171115,171115,0,1,0,61,0.0,37.01754453303421,5
2020-05-31-171115,171115,0,0,0,61,0.0,37.90123437339333,6
2020-06-01-171115,171115,0,0,0,61,0.0,162.51452070173116,0
2020-06-02-171115,171115,0,0,0,61,0.0,15.757143695761782,1
2020-06-03-171115,171115,0,0,0,61,0.42857142857142855,9.142993375726519,2
2020-06-04-171115,171115,0,1,1,61,0.14285714285714285,5.845250821633426,3
2020-06-05-171115,171115,0,0,0,61,0.14285714285714285,7.735884190711626,4
2020-06-06-171115,171115,0,0,1,61,0.14285714285714285,8.285465384717645,5
2020-06-07-171115,171115,0,1,0,61,0.0,9.011606763934054,6
2020-06-08-171115,171115,0,0,0,61,0.5714285714285714,9.109149398781184,0
2020-06-09-171115,171115,0,0,0,61,0.14285714285714285,17.40375148074339,1
2020-06-10-171115,171115,1,0,1,62,0.14285714285714285,170.26262504297054,2
2020-06-11-171115,171115,0,0,0,62,0.42857142857142855,154.33074881634514,3
2020-06-12-171115,171115,0,0,0,62,0.42857142857142855,101.36408302241233,4
2020-06-13-171115,171115,0,0,0,62,0.0,76.85706448776287,5
2020-06-14-171115,171115,0,1,0,62,0.0,64.69242489069666,6
2020-06-15-171115,171115,0,0,0,62,0.2857142857142857,23.639432272288353,0
2020-06-16-171115,171115,0,0,0,62,0.0,22.078511449006907,1
2020-06-17-171115,171115,0,0,0,62,0.0,21.853646670048423,2
2020-06-18-171115,171115,1,0,1,63,0.0,13.068084928651716,3
2020-06-19-171115,171115,0,0,0,63,0.42857142857142855,11.733483097959526,4
2020-06-20-171115,171115,1,0,0,64,0.0,18.005208956197052,5
2020-06-21-171115,171115,0,0,0,64,0.0,24.27323932308064,6
2020-06-22-171115,171115,0,0,0,64,0.14285714285714285,21.73786083152881,0
2020-06-23-171115,171115,0,0,0,64,0.0,22.122293881350334,1
2020-06-24-171115,171115,1,1,0,65,0.0,22.602207771168263,2
2020-06-25-171115,171115,0,0,0,65,0.14285714285714285,22.977025552112583,3
2020-06-26-171115,171115,0,1,0,65,0.2857142857142857,16.960313362176425,4
2020-06-27-171115,171115,0,0,0,65,0.0,17.694376322120128,5
2020-06-28-171115,171115,0,0,0,65,0.0,11.895653064651459,6
2020-06-29-171115,171115,0,0,0,65,0.0,12.315263359931734,0
2020-06-30-171115,171115,0,0,0,65,0.0,14.426189499697323,1
2020-07-01-171115,171115,0,0,0,65,0.0,21.70454168793188,2
2020-07-02-171115,171115,1,0,0,66,0.0,4.468265508671061,3
2020-07-03-171115,171115,0,0,0,66,0.14285714285714285,5.048482021670409,4
2020-07-04-171115,171115,0,0,0,66,0.0,12.86219698121694,5
2020-07-05-171115,171115,0,0,0,66,0.0,13.164141509710536,6
2020-07-06-171115,171115,0,0,0,66,0.14285714285714285,10.268408779597591,0
2020-07-07-171115,171115,0,0,0,66,0.0,12.6568196493521,1
2020-07-08-171115,171115,0,0,0,66,0.0,11.612235101598698,2
2020-07-09-171115,171115,0,0,0,66,0.0,11.028108474389251,3
2020-07-10-171115,171115,0,0,0,66,0.0,22.71033156612526,4
2020-07-11-171115,171115,0,0,0,66,0.0,19.77653717375513,5
2020-07-12-171115,171115,0,0,0,66,0.0,17.265496557830055,6
2020-07-13-171115,171115,0,0,0,66,0.14285714285714285,16.551288298770945,0
2020-07-14-171115,171115,0,0,0,66,0.0,17.48374841563163,1
2020-07-15-171115,171115,0,0,0,66,0.0,7.175696068376155,2
2020-07-16-171115,171115,0,0,0,66,0.14285714285714285,3.5984577041013464,3
2020-07-17-171115,171115,0,0,0,66,0.0,4.400127024513935,4
2020-07-18-171115,171115,0,0,0,66,0.14285714285714285,3.770256041754737,5
2020-07-19-171115,171115,0,0,0,66,0.0,4.974510620304605,6
2020-07-20-171115,171115,0,0,0,66,0.0,11.083917307684258,0
2020-07-21-171115,171115,0,0,0,66,0.0,10.744636109251761,1
2020-07-22-171115,171115,0,0,0,66,0.14285714285714285,11.051904534369696,2
2020-07-23-171115,171115,0,0,0,66,0.0,11.607709550069698,3
2020-07-24-171115,171115,0,0,0,66,0.0,11.563966845828872,4
2020-07-25-171115,171115,0,0,0,66,0.0,10.608834389598485,5
2020-07-26-171115,171115,0,0,0,66,0.0,10.638686534805723,6
2020-07-27-171115,171115,0,0,0,66,0.14285714285714285,3.0850480664311277,0
2020-07-28-171115,171115,0,0,0,66,0.0,5.936486510501681,1
2020-07-29-171115,171115,0,0,0,66,0.14285714285714285,5.931562233612802,2
2020-07-30-171115,171115,0,1,0,66,0.14285714285714285,5.938578526775338,3
2020-07-31-171115,171115,0,0,0,66,0.2857142857142857,7.9856323453236335,4
2020-08-01-171115,171115,0,0,0,66,0.0,9.600689718561174,5
2020-08-02-171115,171115,0,0,0,66,0.0,132.4117447490948,6
2020-08-03-171115,171115,0,0,2,66,0.2857142857142857,98.30425369222897,0
2020-08-04-171115,171115,0,1,4,66,0.0,62.87145466457551,1
2020-08-05-171115,171115,0,0,1,66,0.0,45.75188755818078,2
2020-08-06-171115,171115,0,0,0,66,0.2857142857142857,41.18285375894198,3
2020-08-07-171115,171115,0,0,1,66,0.8571428571428571,27.518359695952874,4
2020-08-08-171115,171115,0,0,1,66,0.14285714285714285,26.394203886075267,5
2020-08-09-171115,171115,0,0,1,66,0.2857142857142857,24.836256128817485,6
2020-08-10-171115,171115,0,0,0,66,1.7142857142857142,4.342134463198148,0
2020-08-11-171115,171115,0,0,0,66,0.5714285714285714,14.371814077535307,1
2020-08-12-171115,171115,0,0,1,66,0.42857142857142855,18.517370340655027,2
2020-08-13-171115,171115,0,0,0,66,1.5714285714285714,23.2283455873146,3
2020-08-14-171115,171115,0,0,1,66,0.8571428571428571,54.221310961438505,4
2020-08-15-171115,171115,0,0,0,66,0.14285714285714285,67.93358940053415,5
2020-08-16-171115,171115,0,0,0,66,0.2857142857142857,70.5284088231415,6
2020-08-17-171115,171115,2,0,1,68,0.7142857142857143,82.47254357209958,0
2020-08-18-171115,171115,4,0,0,72,1.7142857142857142,98.59114123682318,1
2020-08-19-171115,171115,1,1,1,73,0.0,141.2018135797858,2
2020-08-20-171115,171115,0,0,0,73,0.5714285714285714,116.4180121160845,3
2020-08-21-171115,171115,1,0,0,74,0.7142857142857143,107.85591512752994,4
2020-08-22-171115,171115,1,0,0,75,0.0,130.50287241537785,5
2020-08-23-171115,171115,1,0,0,76,0.5714285714285714,131.90695543404718,6
2020-08-24-171115,171115,0,0,9,76,1.0,115.8275511299251,0
2020-08-25-171115,171115,0,0,2,76,1.0,98.52374690218416,1
2020-08-26-171115,171115,1,0,1,77,1.0,97.6640331229566,2
2020-08-27-171115,171115,0,0,1,77,0.2857142857142857,118.04403610681496,3
2020-08-28-171115,171115,1,0,1,78,0.42857142857142855,118.495590197272,4
2020-08-29-171115,171115,0,0,2,78,0.2857142857142857,108.48617011829106,5
2020-08-30-171115,171115,0,0,7,78,0.0,95.17675918782126,6
2020-08-31-171115,171115,1,0,0,79,0.5714285714285714,65.49325617025767,0
2020-09-01-171115,171115,0,0,1,79,1.5714285714285714,25.859711545752162,1
2020-09-02-171115,171115,1,0,0,80,1.0,275.9241902298553,2
2020-09-03-171115,171115,0,0,2,80,0.5714285714285714,442.52726114646487,3
2020-09-04-171115,171115,0,0,5,80,1.2857142857142858,275.70052443824045,4
2020-09-05-171115,171115,0,0,6,80,0.42857142857142855,191.72621960804952,5
2020-09-06-171115,171115,0,1,3,80,0.5714285714285714,163.6535898947718,6
2020-09-07-171115,171115,9,0,0,89,0.5714285714285714,131.41245381762351,0
2020-09-08-171115,171115,2,0,3,91,1.8571428571428568,165.96051955658317,1
2020-09-09-171115,171115,1,0,8,92,0.2857142857142857,183.26972338286373,2
2020-09-10-171115,171115,1,0,10,93,1.1428571428571428,29.830274167990297,3
2020-09-11-171115,171115,1,0,8,94,0.7142857142857143,51.43551402605382,4
2020-09-12-171115,171115,2,0,2,96,1.5714285714285714,76.96561085545713,5
2020-09-13-171115,171115,7,0,1,103,0.14285714285714285,95.28646038787846,6
2020-09-14-171115,171115,0,0,5,103,1.5714285714285714,139.5487324513441,0
2020-09-15-171115,171115,1,0,2,104,1.0,166.5044968541275,1
2020-09-16-171115,171115,0,0,3,104,0.7142857142857143,174.27484258263306,2
2020-09-17-171115,171115,2,0,6,106,0.8571428571428571,176.91434223266486,3
2020-09-18-171115,171115,5,0,1,111,2.571428571428572,213.81671388785497,4
2020-09-19-171115,171115,6,0,3,117,0.14285714285714285,215.68956603410336,5
2020-09-20-171115,171115,3,0,1,120,1.0,203.03202483579406,6
2020-09-21-171115,171115,0,0,7,120,5.7142857142857135,200.18486822339236,0
2020-09-22-171115,171115,3,0,1,123,0.7142857142857143,232.57502692502123,1
2020-09-23-171115,171115,8,0,0,131,1.2857142857142858,236.7919396832661,2
2020-09-24-171115,171115,10,0,2,141,2.2857142857142856,241.2343315594401,3
2020-09-25-171115,171115,8,0,1,149,2.7142857142857144,320.035658347224,4
2020-09-26-171115,171115,2,1,0,151,1.5714285714285714,360.5624003936652,5
2020-09-27-171115,171115,1,0,0,152,3.0,364.59905097435194,6
2020-09-28-171115,171115,5,1,2,157,0.42857142857142855,370.07721003484363,0
2020-09-29-171115,171115,2,1,0,159,1.4285714285714286,345.0341289628977,1
2020-09-30-171115,171115,3,0,0,162,2.142857142857143,285.1032809137256,2
2020-10-01-171115,171115,6,1,0,168,1.0,0.0,3
2020-10-02-171115,171115,1,1,1,169,3.0,215.36608697872182,4
2020-10-03-171115,171115,3,0,0,172,2.2857142857142856,314.2138618168443,5
2020-10-04-171115,171115,1,0,0,173,0.42857142857142855,364.582141434939,6
2020-10-05-171115,171115,7,1,2,180,0.2857142857142857,312.5796628382452,0
2020-10-06-171115,171115,1,1,4,181,2.4285714285714284,323.1649255269046,1
2020-10-07-171115,171115,0,2,0,181,1.5714285714285714,285.4330674198288,2
2020-10-08-171115,171115,2,0,1,183,0.5714285714285714,248.50792732492684,3
2020-10-09-171115,171115,1,1,3,184,1.1428571428571428,239.13954381680938,4
2020-10-10-171115,171115,0,0,1,184,1.1428571428571428,45.903332198166396,5
2020-10-11-171115,171115,0,0,0,184,0.5714285714285714,56.716007067903924,6
2020-10-12-171115,171115,2,0,3,186,0.42857142857142855,71.50400735706557,0
2020-10-13-171115,171115,0,0,1,186,0.8571428571428571,89.64589006604577,1
2020-10-14-171115,171115,0,0,5,186,1.5714285714285714,99.5655865390043,2
2020-10-15-171115,171115,0,0,1,186,1.8571428571428568,135.4438719388302,3
2020-10-16-171115,171115,1,0,4,187,3.8571428571428568,161.31675658081738,4
2020-10-17-171115,171115,0,0,0,187,1.2857142857142858,200.46416833949883,5
2020-10-18-171115,171115,0,0,0,187,1.1428571428571428,200.3790437595165,6
2020-10-19-171115,171115,2,1,0,189,1.4285714285714286,198.8355475998475,0
2020-10-20-171115,171115,4,0,2,193,4.857142857142857,224.43627998911978,1
2020-10-21-171115,171115,0,1,7,193,7.142857142857142,249.63669347443658,2
2020-10-22-171115,171115,1,0,5,194,8.0,284.4755507829509,3
2020-10-23-171115,171115,3,0,12,197,3.571428571428572,282.56116614589985,4
2020-10-24-171115,171115,1,1,1,198,2.0,326.30058030532183,5
2020-10-25-171115,171115,0,1,2,198,2.571428571428572,329.27590323794226,6
2020-10-26-171115,171115,3,1,2,201,4.0,308.8340437959388,0
2020-10-27-171115,171115,1,0,2,202,2.7142857142857144,346.5520738090131,1
2020-10-28-171115,171115,5,0,15,207,2.4285714285714284,316.11805573513004,2
2020-10-29-171115,171115,1,0,3,208,3.2857142857142856,315.2381830878172,3
2020-10-30-171115,171115,4,1,9,212,8.0,251.38031446912382,4
2020-10-31-171115,171115,0,3,0,212,1.7142857142857142,335.8365961505483,5
2020-11-01-171115,171115,0,0,0,212,1.0,131.33004977045417,6
2020-11-02-171115,171115,0,0,0,212,1.1428571428571428,338.04859387999846,0
2020-11-03-171115,171115,2,0,0,214,2.7142857142857144,312.8592005657415,1
2020-11-04-171115,171115,7,0,0,221,3.571428571428572,365.0929445333271,2
2020-11-05-171115,171115,5,1,0,226,4.285714285714286,394.58866759542565,3
2020-11-06-171115,171115,12,3,0,238,9.0,448.7738838473549,4
2020-11-07-171115,171115,1,1,0,239,1.1428571428571428,524.6250504044567,5
2020-11-08-171115,171115,2,0,0,241,1.0,478.94247171067514,6
2020-11-09-171115,171115,2,0,0,243,3.2857142857142856,464.82745450538505,0
2020-11-10-171115,171115,2,0,0,245,3.0,125.57597871165001,1
2020-11-11-171115,171115,15,1,0,260,2.571428571428572,154.9482951734812,2
2020-11-12-171115,171115,3,0,0,263,2.571428571428572,217.94751680480294,3
2020-11-13-171115,171115,9,0,0,272,1.2857142857142858,248.96483427849125,4
2020-03-01-171116,171116,0,0,0,0,0.0,0.0,6
2020-03-02-171116,171116,0,0,0,0,0.0,9.312439555417495,0
2020-03-03-171116,171116,0,0,0,0,0.0,30.702711210479645,1
2020-03-04-171116,171116,0,0,2,0,0.0,35.4906008917167,2
2020-03-05-171116,171116,0,0,4,0,0.0,40.42888017997606,3
2020-03-06-171116,171116,0,0,2,0,0.0,29.337848227414895,4
2020-03-07-171116,171116,0,0,1,0,0.2857142857142857,34.862944343067504,5
2020-03-08-171116,171116,0,0,0,0,0.0,39.62229808582413,6
2020-03-09-171116,171116,0,0,2,0,0.14285714285714285,39.90853404276967,0
2020-03-10-171116,171116,0,0,0,0,0.0,351.8071085252901,1
2020-03-11-171116,171116,0,0,1,0,0.14285714285714285,291.3323033444759,2
2020-03-12-171116,171116,0,0,0,0,0.42857142857142855,218.7285877756342,3
2020-03-13-171116,171116,0,0,4,0,0.2857142857142857,111.2146585319951,4
2020-03-14-171116,171116,0,0,1,0,0.2857142857142857,92.01601971049195,5
2020-03-15-171116,171116,0,0,0,0,0.0,78.2303438083863,6
2020-03-16-171116,171116,0,0,2,0,0.7142857142857143,18.363392388449846,0
2020-03-17-171116,171116,0,0,1,0,1.8571428571428568,28.71708458261603,1
2020-03-18-171116,171116,2,0,2,2,1.5714285714285714,39.07624723358128,2
2020-03-19-171116,171116,4,0,1,6,1.5714285714285714,50.164361795284066,3
2020-03-20-171116,171116,2,0,1,8,1.1428571428571428,55.19226538754084,4
2020-03-21-171116,171116,1,0,0,9,0.7142857142857143,61.43926852674333,5
2020-03-22-171116,171116,0,0,0,9,0.14285714285714285,61.29775101773169,6
2020-03-23-171116,171116,2,0,1,11,3.0,54.216409101845024,0
2020-03-24-171116,171116,0,0,0,11,0.7142857142857143,60.080022751734475,1
2020-03-25-171116,171116,1,0,0,12,1.0,53.850153290518364,2
2020-03-26-171116,171116,0,0,0,12,1.1428571428571428,54.35857095915863,3
2020-03-27-171116,171116,4,0,0,16,1.2857142857142858,60.49840806646733,4
2020-03-28-171116,171116,1,0,0,17,0.14285714285714285,65.77216121150322,5
2020-03-29-171116,171116,0,0,0,17,0.5714285714285714,61.84083410902296,6
2020-03-30-171116,171116,2,0,0,19,0.42857142857142855,47.72184233312103,0
2020-03-31-171116,171116,1,0,1,20,1.4285714285714286,51.28033842114037,1
2020-04-01-171116,171116,2,0,0,22,2.0,10.40779534413065,2
2020-04-02-171116,171116,1,0,0,23,1.7142857142857142,31.88449474284129,3
2020-04-03-171116,171116,1,0,0,24,2.0,28.14340248189916,4
2020-04-04-171116,171116,0,1,0,24,1.0,38.32292456977035,5
2020-04-05-171116,171116,0,0,0,24,0.42857142857142855,43.304085367203186,6
2020-04-06-171116,171116,1,0,0,25,1.4285714285714286,44.66724769543517,0
2020-04-07-171116,171116,0,0,0,25,0.8571428571428571,49.34966739764016,1
2020-04-08-171116,171116,0,0,0,25,1.4285714285714286,50.89935928348294,2
2020-04-09-171116,171116,0,0,0,25,0.5714285714285714,51.35711539929719,3
2020-04-10-171116,171116,0,0,0,25,0.7142857142857143,24.02165251021495,4
2020-04-11-171116,171116,0,0,0,25,0.42857142857142855,25.943571633264753,5
2020-04-12-171116,171116,0,0,0,25,0.42857142857142855,27.678701421442007,6
2020-04-13-171116,171116,0,0,0,25,1.0,29.016826278968544,0
2020-04-14-171116,171116,1,0,0,26,0.8571428571428571,31.470624299411142,1
2020-04-15-171116,171116,0,0,0,26,0.2857142857142857,38.81830679070216,2
2020-04-16-171116,171116,0,0,0,26,2.142857142857143,40.76414072895611,3
2020-04-17-171116,171116,0,0,1,26,0.8571428571428571,29.13193985851522,4
2020-04-18-171116,171116,0,0,0,26,0.14285714285714285,34.372921786941156,5
2020-04-19-171116,171116,0,0,0,26,0.2857142857142857,32.97921888661686,6
2020-04-20-171116,171116,0,0,1,26,0.42857142857142855,37.3192556966044,0
2020-04-21-171116,171116,0,0,1,26,0.7142857142857143,33.860577451796395,1
2020-04-22-171116,171116,0,0,0,26,0.2857142857142857,37.19339604967371,2
2020-04-23-171116,171116,0,0,0,26,0.0,32.44665227999744,3
2020-04-24-171116,171116,0,0,0,26,0.7142857142857143,25.175613793077503,4
2020-04-25-171116,171116,0,0,0,26,0.2857142857142857,32.0625881267036,5
2020-04-26-171116,171116,0,0,0,26,0.14285714285714285,30.838021022953715,6
2020-04-27-171116,171116,0,1,0,26,0.5714285714285714,22.450692537523288,0
2020-04-28-171116,171116,0,1,2,26,1.1428571428571428,26.23684806491437,1
2020-04-29-171116,171116,0,0,1,26,1.7142857142857142,26.450883401394886,2
2020-04-30-171116,171116,0,0,0,26,1.4285714285714286,43.534077524440136,3
2020-05-01-171116,171116,1,0,0,27,0.2857142857142857,50.42076237281671,4
2020-05-02-171116,171116,0,0,0,27,0.42857142857142855,37.155767789303454,5
2020-05-03-171116,171116,0,0,0,27,0.0,16.88109028617118,6
2020-05-04-171116,171116,1,0,1,28,0.14285714285714285,13.67021295407925,0
2020-05-05-171116,171116,1,0,2,29,0.14285714285714285,16.06941456746236,1
2020-05-06-171116,171116,0,0,0,29,1.0,21.520942032979484,2
2020-05-07-171116,171116,0,0,0,29,1.4285714285714286,29.100576386101928,3
2020-05-08-171116,171116,0,0,0,29,0.5714285714285714,37.207932560743956,4
2020-05-09-171116,171116,0,0,0,29,0.2857142857142857,46.025177532628945,5
2020-05-10-171116,171116,0,1,0,29,0.14285714285714285,51.235793704934984,6
2020-05-11-171116,171116,0,0,0,29,0.2857142857142857,43.33708810701101,0
2020-05-12-171116,171116,2,0,0,31,1.0,47.993986647649905,1
2020-05-13-171116,171116,1,0,0,32,0.7142857142857143,44.30263889004287,2
2020-05-14-171116,171116,0,0,1,32,1.2857142857142858,43.973092726690155,3
2020-05-15-171116,171116,0,0,0,32,0.42857142857142855,41.33970712761079,4
2020-05-16-171116,171116,0,0,0,32,0.5714285714285714,45.56428858530971,5
2020-05-17-171116,171116,0,0,0,32,0.0,46.774257993152645,6
2020-05-18-171116,171116,1,0,0,33,1.0,47.50683146019702,0
2020-05-19-171116,171116,2,0,0,35,0.42857142857142855,50.77987741262489,1
2020-05-20-171116,171116,0,0,0,35,0.7142857142857143,42.262769066278864,2
2020-05-21-171116,171116,0,0,0,35,0.2857142857142857,40.78405343099769,3
2020-05-22-171116,171116,0,0,0,35,0.14285714285714285,40.43953846147612,4
2020-05-23-171116,171116,0,0,0,35,0.0,42.430503648800276,5
2020-05-24-171116,171116,0,0,0,35,0.14285714285714285,42.950443140374034,6
2020-05-25-171116,171116,0,0,0,35,0.0,33.1609862670309,0
2020-05-26-171116,171116,0,0,0,35,1.1428571428571428,28.60323599098163,1
2020-05-27-171116,171116,0,0,0,35,0.0,36.07448617576553,2
2020-05-28-171116,171116,1,0,0,36,0.42857142857142855,34.385483286720046,3
2020-05-29-171116,171116,0,0,0,36,0.0,26.20892152867814,4
2020-05-30-171116,171116,0,0,0,36,0.0,26.58764337155734,5
2020-05-31-171116,171116,0,1,0,36,0.0,27.166911288180692,6
2020-06-01-171116,171116,0,0,0,36,0.0,65.9779775809428,0
2020-06-02-171116,171116,0,0,0,36,0.5714285714285714,7.971269800160961,1
2020-06-03-171116,171116,0,0,0,36,0.42857142857142855,6.137802546477787,2
2020-06-04-171116,171116,0,0,0,36,0.5714285714285714,4.538398544856859,3
2020-06-05-171116,171116,0,1,0,36,0.0,8.40217103906585,4
2020-06-06-171116,171116,0,0,0,36,0.2857142857142857,7.988279085055482,5
2020-06-07-171116,171116,0,0,0,36,0.0,8.560231472135293,6
2020-06-08-171116,171116,0,1,0,36,0.14285714285714285,8.593273466722703,0
2020-06-09-171116,171116,0,0,0,36,0.14285714285714285,14.796901402048892,1
2020-06-10-171116,171116,0,0,0,36,0.42857142857142855,68.90384948735873,2
2020-06-11-171116,171116,0,0,0,36,0.0,58.59645137655551,3
2020-06-12-171116,171116,0,0,0,36,0.42857142857142855,52.1309666752384,4
2020-06-13-171116,171116,0,1,0,36,0.0,38.23342029058313,5
2020-06-14-171116,171116,0,0,0,36,0.0,23.500408798008607,6
2020-06-15-171116,171116,0,0,0,36,0.0,14.539631958318132,0
2020-06-16-171116,171116,0,0,0,36,0.14285714285714285,14.535387363899702,1
2020-06-17-171116,171116,0,0,0,36,0.14285714285714285,14.192081702902087,2
2020-06-18-171116,171116,0,0,0,36,0.14285714285714285,10.570702916189244,3
2020-06-19-171116,171116,0,0,0,36,0.14285714285714285,6.84824921208159,4
2020-06-20-171116,171116,0,0,0,36,0.0,11.56889867436702,5
2020-06-21-171116,171116,0,0,0,36,0.0,12.08585148270172,6
2020-06-22-171116,171116,0,0,0,36,0.14285714285714285,9.859581700736722,0
2020-06-23-171116,171116,0,0,0,36,0.14285714285714285,10.020225366673408,1
2020-06-24-171116,171116,0,0,0,36,0.14285714285714285,12.377795640854131,2
2020-06-25-171116,171116,0,0,0,36,0.14285714285714285,12.639304728528089,3
2020-06-26-171116,171116,0,3,0,36,0.42857142857142855,9.03642543546011,4
2020-06-27-171116,171116,0,0,0,36,0.14285714285714285,8.262956303932052,5
2020-06-28-171116,171116,0,0,0,36,0.0,8.656127849657938,6
2020-06-29-171116,171116,0,0,0,36,0.0,8.689985511763684,0
2020-06-30-171116,171116,0,0,0,36,0.0,7.04276595251591,1
2020-07-01-171116,171116,0,0,0,36,0.0,19.289880226961245,2
2020-07-02-171116,171116,0,0,0,36,0.14285714285714285,1.4713309218580377,3
2020-07-03-171116,171116,0,0,0,36,0.2857142857142857,3.915985764726791,4
2020-07-04-171116,171116,0,0,0,36,0.0,13.0003508486992,5
2020-07-05-171116,171116,0,0,0,36,0.0,13.071628255462539,6
2020-07-06-171116,171116,0,0,0,36,0.0,11.443334667800823,0
2020-07-07-171116,171116,0,0,0,36,0.0,13.209734694306356,1
2020-07-08-171116,171116,0,0,0,36,0.0,12.592475121162968,2
2020-07-09-171116,171116,0,0,0,36,0.14285714285714285,10.661461503678966,3
2020-07-10-171116,171116,0,0,0,36,0.5714285714285714,19.965739539030118,4
2020-07-11-171116,171116,0,0,0,36,0.0,18.257159857539854,5
2020-07-12-171116,171116,0,0,0,36,0.0,16.83055039957255,6
2020-07-13-171116,171116,0,0,0,36,0.0,15.713642668614652,0
2020-07-14-171116,171116,0,0,0,36,0.0,15.936700721641703,1
2020-07-15-171116,171116,0,0,0,36,0.0,8.160160639077192,2
2020-07-16-171116,171116,0,0,0,36,0.0,4.977388294115124,3
2020-07-17-171116,171116,0,0,0,36,0.0,5.0783297433708015,4
2020-07-18-171116,171116,0,0,0,36,0.0,1.6052699820510756,5
2020-07-19-171116,171116,0,0,0,36,0.0,1.6878091625103575,6
2020-07-20-171116,171116,0,0,0,36,0.2857142857142857,2.497077061767306,0
2020-07-21-171116,171116,0,0,0,36,0.0,3.022125383431937,1
2020-07-22-171116,171116,0,0,0,36,0.0,3.0887312504631135,2
2020-07-23-171116,171116,0,0,0,36,0.0,3.2103641059895613,3
2020-07-24-171116,171116,0,0,0,36,0.0,3.253227710207553,4
2020-07-25-171116,171116,0,0,0,36,0.0,3.369379152013174,5
2020-07-26-171116,171116,0,0,0,36,0.0,3.352449944194007,6
2020-07-27-171116,171116,0,0,0,36,0.0,2.286730624359489,0
2020-07-28-171116,171116,0,0,0,36,0.14285714285714285,3.3873183122531634,1
2020-07-29-171116,171116,0,0,0,36,0.2857142857142857,3.64602097609033,2
2020-07-30-171116,171116,0,0,0,36,0.14285714285714285,6.4912907728152405,3
2020-07-31-171116,171116,0,0,0,36,0.0,10.030528532432452,4
2020-08-01-171116,171116,0,0,0,36,0.0,7.971074501732546,5
2020-08-02-171116,171116,0,0,1,36,0.0,77.9837124908735,6
2020-08-03-171116,171116,0,0,1,36,0.2857142857142857,95.39404704084825,0
2020-08-04-171116,171116,0,0,0,36,0.0,77.66393118126138,1
2020-08-05-171116,171116,0,0,0,36,0.14285714285714285,65.95981429191598,2
2020-08-06-171116,171116,0,0,0,36,0.14285714285714285,58.139820009026295,3
2020-08-07-171116,171116,0,0,1,36,0.42857142857142855,46.39479563357295,4
2020-08-08-171116,171116,0,0,0,36,0.0,40.342804770036025,5
2020-08-09-171116,171116,0,0,0,36,0.5714285714285714,37.44795388115491,6
2020-08-10-171116,171116,0,0,0,36,0.2857142857142857,4.304862307439178,0
2020-08-11-171116,171116,0,0,0,36,0.5714285714285714,6.773943146037048,1
2020-08-12-171116,171116,0,0,0,36,0.14285714285714285,13.990528170264952,2
2020-08-13-171116,171116,0,0,0,36,1.0,16.81212381784556,3
2020-08-14-171116,171116,0,0,0,36,1.0,33.67141429463744,4
2020-08-15-171116,171116,0,0,0,36,0.7142857142857143,41.87043235632945,5
2020-08-16-171116,171116,1,0,0,37,0.42857142857142855,47.63754025350241,6
2020-08-17-171116,171116,1,0,0,38,0.5714285714285714,56.11428491220623,0
2020-08-18-171116,171116,0,0,0,38,0.5714285714285714,59.57217328517582,1
2020-08-19-171116,171116,0,0,0,38,0.2857142857142857,70.85339489957337,2
2020-08-20-171116,171116,0,0,0,38,0.7142857142857143,65.16568680351581,3
2020-08-21-171116,171116,1,0,0,39,1.2857142857142858,69.7595540334008,4
2020-08-22-171116,171116,0,0,0,39,0.7142857142857143,84.84082950048702,5
2020-08-23-171116,171116,0,0,0,39,0.7142857142857143,99.46811476766001,6
2020-08-24-171116,171116,0,0,0,39,1.0,99.78503787766033,0
2020-08-25-171116,171116,0,0,1,39,0.42857142857142855,104.67220634378367,1
2020-08-26-171116,171116,0,0,0,39,0.8571428571428571,106.09211588944348,2
2020-08-27-171116,171116,0,0,0,39,1.0,117.88784391770099,3
2020-08-28-171116,171116,0,0,0,39,0.42857142857142855,113.46360671315006,4
2020-08-29-171116,171116,0,0,0,39,1.8571428571428568,104.29475309427802,5
2020-08-30-171116,171116,0,0,0,39,0.42857142857142855,91.26193037871455,6
2020-08-31-171116,171116,0,0,0,39,1.0,75.04900127867188,0
2020-09-01-171116,171116,0,0,0,39,0.7142857142857143,37.264340582584644,1
2020-09-02-171116,171116,0,0,1,39,0.5714285714285714,258.7597863069349,2
2020-09-03-171116,171116,0,0,0,39,1.0,140.77272516909045,3
2020-09-04-171116,171116,0,0,1,39,0.7142857142857143,116.7896858320517,4
2020-09-05-171116,171116,0,0,0,39,0.42857142857142855,107.60268924098466,5
2020-09-06-171116,171116,0,0,0,39,0.42857142857142855,97.99748474672084,6
2020-09-07-171116,171116,0,0,0,39,0.8571428571428571,93.7365804379246,0
2020-09-08-171116,171116,1,0,0,40,1.8571428571428568,94.6132960310906,1
2020-09-09-171116,171116,0,0,0,40,0.8571428571428571,121.70595422559737,2
2020-09-10-171116,171116,0,0,0,40,2.142857142857143,30.53864969186189,3
2020-09-11-171116,171116,0,0,0,40,0.2857142857142857,63.63497898367538,4
2020-09-12-171116,171116,0,0,0,40,1.5714285714285714,78.00558650793526,5
2020-09-13-171116,171116,0,0,0,40,0.5714285714285714,99.25146594166964,6
2020-09-14-171116,171116,0,0,0,40,0.8571428571428571,99.96999297787023,0
2020-09-15-171116,171116,0,0,0,40,2.0,116.18249573972885,1
2020-09-16-171116,171116,1,0,0,41,1.2857142857142858,133.39764285943744,2
2020-09-17-171116,171116,0,0,0,41,10.285714285714286,151.6656805524588,3
2020-09-18-171116,171116,1,0,0,42,2.7142857142857144,226.3456238994101,4
2020-09-19-171116,171116,0,0,0,42,1.2857142857142858,244.50147245171334,5
2020-09-20-171116,171116,0,0,0,42,1.0,234.36108915882056,6
2020-09-21-171116,171116,0,0,0,42,1.2857142857142858,223.72943917938585,0
2020-09-22-171116,171116,0,1,0,42,1.7142857142857142,218.17627297114566,1
2020-09-23-171116,171116,0,0,0,42,2.2857142857142856,234.8129834724821,2
2020-09-24-171116,171116,0,1,0,42,3.0,152.3098263001791,3
2020-09-25-171116,171116,0,0,0,42,2.2857142857142856,155.2761771156086,4
2020-09-26-171116,171116,0,0,0,42,1.7142857142857142,167.68119512578937,5
2020-09-27-171116,171116,0,0,0,42,1.4285714285714286,165.6439177237915,6
2020-09-28-171116,171116,0,0,1,42,0.42857142857142855,172.84847650947955,0
2020-09-29-171116,171116,0,0,0,42,1.1428571428571428,163.8611844576917,1
2020-09-30-171116,171116,0,0,0,42,2.142857142857143,126.82653659986487,2
2020-10-01-171116,171116,0,0,3,42,0.5714285714285714,0.0,3
2020-10-02-171116,171116,0,0,0,42,2.0,200.77719485850898,4
2020-10-03-171116,171116,0,1,0,42,0.7142857142857143,373.04033636773886,5
2020-10-04-171116,171116,0,0,0,42,0.2857142857142857,407.48932447046496,6
2020-10-05-171116,171116,0,0,2,42,0.42857142857142855,346.8467687714119,0
2020-10-06-171116,171116,0,0,1,42,1.1428571428571428,285.89750929746253,1
2020-10-07-171116,171116,0,1,6,42,1.0,253.7258205332719,2
2020-10-08-171116,171116,0,0,0,42,1.1428571428571428,208.83486263930666,3
2020-10-09-171116,171116,0,1,5,42,1.0,221.57484463964335,4
2020-10-10-171116,171116,0,0,1,42,0.8571428571428571,12.83311129068498,5
2020-10-11-171116,171116,0,0,2,42,0.2857142857142857,21.101597206058074,6
2020-10-12-171116,171116,1,0,3,43,1.1428571428571428,32.16135426153861,0
2020-10-13-171116,171116,0,0,3,43,0.14285714285714285,44.643297627156365,1
2020-10-14-171116,171116,0,0,2,43,1.7142857142857142,50.779989060217126,2
2020-10-15-171116,171116,3,0,4,46,2.571428571428572,87.73794996335518,3
2020-10-16-171116,171116,0,0,6,46,1.7142857142857142,118.6482605809982,4
2020-10-17-171116,171116,0,0,1,46,1.0,170.6681157713324,5
2020-10-18-171116,171116,0,0,0,46,1.1428571428571428,174.27165053366386,6
2020-10-19-171116,171116,2,0,1,48,1.5714285714285714,179.24831143647893,0
2020-10-20-171116,171116,1,0,1,49,1.8571428571428568,208.1885733040287,1
2020-10-21-171116,171116,6,0,8,55,2.571428571428572,215.23499404450416,2
2020-10-22-171116,171116,0,0,4,55,3.0,228.9644453578678,3
2020-10-23-171116,171116,5,0,1,60,5.142857142857143,206.6683773143107,4
2020-10-24-171116,171116,1,1,1,61,2.571428571428572,252.1743493705242,5
2020-10-25-171116,171116,2,0,0,63,5.0,257.7570753690359,6
2020-10-26-171116,171116,3,0,2,66,4.285714285714286,256.1542283830979,0
2020-10-27-171116,171116,3,0,4,69,6.0,295.955539328242,1
2020-10-28-171116,171116,2,1,0,71,5.142857142857143,316.59258330908676,2
2020-10-29-171116,171116,4,0,2,75,4.714285714285714,324.30820693256294,3
2020-10-30-171116,171116,6,0,3,81,12.714285714285715,289.6613777304026,4
2020-10-31-171116,171116,1,0,0,82,1.8571428571428568,380.10706764456967,5
2020-11-01-171116,171116,0,0,0,82,4.428571428571429,98.08145946304795,6
2020-11-02-171116,171116,1,0,0,83,1.2857142857142858,191.0152763131618,0
2020-11-03-171116,171116,1,1,0,84,6.142857142857142,173.60210444333168,1
2020-11-04-171116,171116,8,0,0,92,5.571428571428571,225.8426145162253,2
2020-11-05-171116,171116,4,2,0,96,5.7142857142857135,266.33833444154993,3
2020-11-06-171116,171116,1,1,0,97,6.2857142857142865,288.3313524333232,4
2020-11-07-171116,171116,1,1,0,98,2.4285714285714284,358.4694543756643,5
2020-11-08-171116,171116,0,1,0,98,1.7142857142857142,344.710110046532,6
2020-11-09-171116,171116,2,0,0,100,4.0,331.0911211826632,0
2020-11-10-171116,171116,4,0,0,104,4.428571428571429,101.07618601293409,1
2020-11-11-171116,171116,0,0,0,104,5.0,137.4135021031102,2
2020-11-12-171116,171116,2,1,0,106,4.571428571428571,171.41151510774864,3
2020-11-13-171116,171116,3,0,0,109,3.0,181.9887500493118,4
2020-03-01-171117,171117,0,0,2,0,0.0,0.0,6
2020-03-02-171117,171117,0,3,3,0,0.14285714285714285,30.377887137538764,0
2020-03-03-171117,171117,0,0,1,0,0.0,181.7992661878213,1
2020-03-04-171117,171117,0,1,5,0,0.0,201.8458494368412,2
2020-03-05-171117,171117,0,2,3,0,0.0,217.81413431860653,3
2020-03-06-171117,171117,0,0,8,0,0.0,176.9857342888011,4
2020-03-07-171117,171117,0,0,5,0,0.2857142857142857,209.69824415310757,5
2020-03-08-171117,171117,0,0,3,0,0.0,221.3180826833697,6
2020-03-09-171117,171117,0,0,16,0,0.2857142857142857,221.09707906680552,0
2020-03-10-171117,171117,0,0,6,0,0.0,592.6059735149772,1
2020-03-11-171117,171117,1,0,8,1,0.7142857142857143,440.96803086569645,2
2020-03-12-171117,171117,0,0,7,1,0.8571428571428571,340.7219041555521,3
2020-03-13-171117,171117,0,0,9,1,0.8571428571428571,186.79402154140786,4
2020-03-14-171117,171117,0,0,0,1,0.2857142857142857,160.98521508383482,5
2020-03-15-171117,171117,2,0,2,3,0.14285714285714285,131.02396931862614,6
2020-03-16-171117,171117,3,0,11,6,2.0,59.486120375008994,0
2020-03-17-171117,171117,1,0,4,7,1.2857142857142858,102.17454466584252,1
2020-03-18-171117,171117,5,0,6,12,2.8571428571428568,114.6008975340136,2
2020-03-19-171117,171117,3,0,4,15,3.0,149.9178596695697,3
2020-03-20-171117,171117,8,1,6,23,2.0,165.41987671734017,4
2020-03-21-171117,171117,5,1,1,28,1.7142857142857142,211.83374420498637,5
2020-03-22-171117,171117,3,0,0,31,1.2857142857142858,214.15644100856514,6
2020-03-23-171117,171117,16,0,7,47,4.714285714285714,195.26136925378398,0
2020-03-24-171117,171117,6,0,5,53,1.7142857142857142,284.03907640355806,1
2020-03-25-171117,171117,8,0,4,61,3.7142857142857135,286.5465357695452,2
2020-03-26-171117,171117,7,0,6,68,2.142857142857143,310.0032272907581,3
2020-03-27-171117,171117,9,0,9,77,3.571428571428572,356.6585754415193,4
2020-03-28-171117,171117,0,0,8,77,0.8571428571428571,371.69048952454006,5
2020-03-29-171117,171117,2,0,3,79,0.7142857142857143,347.1108573702835,6
2020-03-30-171117,171117,11,0,12,90,3.0,238.03984210937313,0
2020-03-31-171117,171117,4,0,10,94,1.8571428571428568,265.7998711331325,1
2020-04-01-171117,171117,6,0,2,100,3.2857142857142856,39.38958081647813,2
2020-04-02-171117,171117,4,0,6,104,1.4285714285714286,223.97963820862174,3
2020-04-03-171117,171117,6,0,4,110,1.8571428571428568,174.40473778973654,4
2020-04-04-171117,171117,1,0,1,111,0.2857142857142857,187.15183555386562,5
2020-04-05-171117,171117,0,1,1,111,0.5714285714285714,188.33646179883036,6
2020-04-06-171117,171117,7,0,4,118,2.8571428571428568,188.11862429832496,0
2020-04-07-171117,171117,5,0,2,123,4.0,197.04100578026708,1
2020-04-08-171117,171117,4,0,4,127,2.0,216.00670883012967,2
2020-04-09-171117,171117,6,0,1,133,2.2857142857142856,213.32773026793078,3
2020-04-10-171117,171117,9,0,10,142,1.8571428571428568,47.99443565198469,4
2020-04-11-171117,171117,8,0,1,150,0.7142857142857143,90.38576988011148,5
2020-04-12-171117,171117,3,0,1,153,0.42857142857142855,130.12616686740245,6
2020-04-13-171117,171117,12,0,7,165,1.5714285714285714,147.37227631554617,0
2020-04-14-171117,171117,10,0,2,175,1.0,212.16744390603014,1
2020-04-15-171117,171117,2,0,6,177,3.2857142857142856,270.52726706101214,2
2020-04-16-171117,171117,6,0,6,183,2.4285714285714284,289.244494024586,3
2020-04-17-171117,171117,4,0,0,187,2.7142857142857144,290.62724542411235,4
2020-04-18-171117,171117,1,0,1,188,0.2857142857142857,290.58593423435855,5
2020-04-19-171117,171117,1,0,0,189,0.2857142857142857,251.98572372665961,6
2020-04-20-171117,171117,4,0,14,193,1.2857142857142858,197.9693323543761,0
2020-04-21-171117,171117,2,0,5,195,0.8571428571428571,168.61070789493417,1
2020-04-22-171117,171117,4,0,69,199,1.0,162.4571425040618,2
2020-04-23-171117,171117,1,0,20,200,0.0,154.2163755355105,3
2020-04-24-171117,171117,10,0,13,210,1.7142857142857142,120.12262887954354,4
2020-04-25-171117,171117,1,0,0,211,0.5714285714285714,178.75654810936823,5
2020-04-26-171117,171117,1,0,0,212,0.0,181.2717017217547,6
2020-04-27-171117,171117,7,0,5,219,1.4285714285714286,156.54399883364505,0
2020-04-28-171117,171117,2,0,20,221,1.2857142857142858,177.49745014536768,1
2020-04-29-171117,171117,6,0,5,227,2.0,179.89998648907553,2
2020-04-30-171117,171117,6,0,1,233,2.7142857142857144,240.9392600132525,3
2020-05-01-171117,171117,0,0,5,233,0.42857142857142855,251.95967522451477,4
2020-05-02-171117,171117,1,0,0,234,0.2857142857142857,208.23106563816847,5
2020-05-03-171117,171117,0,0,0,234,0.5714285714285714,104.3117600369522,6
2020-05-04-171117,171117,14,0,8,248,1.7142857142857142,99.76431921271859,0
2020-05-05-171117,171117,5,0,11,253,1.4285714285714286,182.94760808326473,1
2020-05-06-171117,171117,69,0,11,322,1.7142857142857142,220.75658675102474,2
2020-05-07-171117,171117,20,0,9,342,2.0,574.4900774988598,3
2020-05-08-171117,171117,13,0,10,355,1.7142857142857142,710.0979102497041,4
2020-05-09-171117,171117,0,0,0,355,0.5714285714285714,836.1437084450523,5
2020-05-10-171117,171117,0,0,0,355,0.0,232.58947222072632,6
2020-05-11-171117,171117,5,0,0,360,1.2857142857142858,219.9196953542089,0
2020-05-12-171117,171117,20,0,2,380,1.5714285714285714,251.97260111216644,1
2020-05-13-171117,171117,5,0,1,385,1.5714285714285714,311.8632332736699,2
2020-05-14-171117,171117,1,1,11,386,0.7142857142857143,305.70884455499885,3
2020-05-15-171117,171117,5,0,1,391,0.5714285714285714,275.7205393816832,4
2020-05-16-171117,171117,0,0,0,391,0.5714285714285714,270.07880921551157,5
2020-05-17-171117,171117,0,1,0,391,0.0,270.86137797068966,6
2020-05-18-171117,171117,8,1,0,399,0.7142857142857143,274.1384728452957,0
2020-05-19-171117,171117,11,0,3,410,1.2857142857142858,293.97385891109434,1
2020-05-20-171117,171117,11,0,0,421,0.7142857142857143,206.30718092998202,2
2020-05-21-171117,171117,9,0,4,430,1.2857142857142858,274.1116412119229,3
2020-05-22-171117,171117,10,0,0,440,0.14285714285714285,312.2773641502256,4
2020-05-23-171117,171117,0,0,1,440,0.0,378.05497664601916,5
2020-05-24-171117,171117,0,0,0,440,0.2857142857142857,387.4929430010929,6
2020-05-25-171117,171117,0,0,0,440,1.2857142857142858,333.2737800165603,0
2020-05-26-171117,171117,2,0,0,442,1.1428571428571428,260.4876562708967,1
2020-05-27-171117,171117,1,0,2,443,0.2857142857142857,281.1346414431017,2
2020-05-28-171117,171117,11,2,0,454,0.5714285714285714,208.7206561197521,3
2020-05-29-171117,171117,1,0,0,455,0.5714285714285714,205.79663342141845,4
2020-05-30-171117,171117,0,0,0,455,0.2857142857142857,143.7543196646649,5
2020-05-31-171117,171117,0,0,0,455,0.14285714285714285,144.934053891058,6
2020-06-01-171117,171117,0,0,1,455,0.42857142857142855,1013.4074498995261,0
2020-06-02-171117,171117,3,0,0,458,0.7142857142857143,32.86322371059218,1
2020-06-03-171117,171117,0,0,0,458,0.7142857142857143,19.509549841913408,2
2020-06-04-171117,171117,4,0,0,462,0.42857142857142855,28.607554507413766,3
2020-06-05-171117,171117,0,0,1,462,0.5714285714285714,55.30276978123777,4
2020-06-06-171117,171117,1,0,0,463,0.14285714285714285,57.47639913577976,5
2020-06-07-171117,171117,0,0,0,463,0.14285714285714285,66.57244201666951,6
2020-06-08-171117,171117,0,0,1,463,1.0,66.40903816876391,0
2020-06-09-171117,171117,0,0,0,463,0.8571428571428571,77.41766520881323,1
2020-06-10-171117,171117,2,0,0,465,0.8571428571428571,1084.8215106904377,2
2020-06-11-171117,171117,0,0,1,465,0.8571428571428571,981.0119754268749,3
2020-06-12-171117,171117,0,0,0,465,0.7142857142857143,913.2854264260603,4
2020-06-13-171117,171117,0,0,0,465,0.14285714285714285,345.35590953443165,5
2020-06-14-171117,171117,0,0,0,465,0.0,171.98830142514583,6
2020-06-15-171117,171117,1,0,0,466,0.2857142857142857,44.66985156800166,0
2020-06-16-171117,171117,0,0,1,466,0.42857142857142855,49.841070557384654,1
2020-06-17-171117,171117,0,0,0,466,0.8571428571428571,49.43618833075888,2
2020-06-18-171117,171117,0,0,0,466,0.42857142857142855,30.33591432732432,3
2020-06-19-171117,171117,1,0,0,467,0.7142857142857143,22.656422890116254,4
2020-06-20-171117,171117,0,0,0,467,0.14285714285714285,65.32666527691688,5
2020-06-21-171117,171117,0,0,0,467,0.0,66.76067473028657,6
2020-06-22-171117,171117,1,0,0,468,0.2857142857142857,56.28587177783896,0
2020-06-23-171117,171117,0,0,0,468,0.5714285714285714,56.5205540132524,1
2020-06-24-171117,171117,0,1,0,468,0.2857142857142857,56.557691785812935,2
2020-06-25-171117,171117,1,0,0,469,0.2857142857142857,56.39352825205011,3
2020-06-26-171117,171117,0,0,0,469,0.14285714285714285,50.248704169875445,4
2020-06-27-171117,171117,0,0,0,469,0.0,22.084300454088144,5
2020-06-28-171117,171117,0,0,0,469,0.0,22.688147372560593,6
2020-06-29-171117,171117,0,0,0,469,0.42857142857142855,24.120568334074942,0
2020-06-30-171117,171117,1,0,1,470,0.14285714285714285,26.86050794264266,1
2020-07-01-171117,171117,0,0,0,470,0.14285714285714285,90.80140681401404,2
2020-07-02-171117,171117,0,0,0,470,0.0,19.967987212678874,3
2020-07-03-171117,171117,0,0,0,470,0.0,37.05128225560989,4
2020-07-04-171117,171117,0,0,0,470,0.14285714285714285,49.519863111799616,5
2020-07-05-171117,171117,0,0,0,470,0.14285714285714285,50.3253059618281,6
2020-07-06-171117,171117,0,0,0,470,0.42857142857142855,46.45012067527968,0
2020-07-07-171117,171117,0,0,0,470,0.0,49.41395940194908,1
2020-07-08-171117,171117,0,0,0,470,0.0,38.39002177263837,2
2020-07-09-171117,171117,0,0,0,470,0.0,37.72981847691785,3
2020-07-10-171117,171117,0,0,1,470,0.5714285714285714,83.42452593708244,4
2020-07-11-171117,171117,0,0,0,470,0.0,48.541278823166635,5
2020-07-12-171117,171117,0,0,0,470,0.0,44.18160046140613,6
2020-07-13-171117,171117,0,0,0,470,0.42857142857142855,33.594731847526376,0
2020-07-14-171117,171117,1,0,0,471,0.42857142857142855,35.79040718967555,1
2020-07-15-171117,171117,0,0,1,471,0.2857142857142857,32.66216090572118,2
2020-07-16-171117,171117,0,0,0,471,0.42857142857142855,24.82470221396121,3
2020-07-17-171117,171117,0,0,1,471,0.42857142857142855,25.39720389708865,4
2020-07-18-171117,171117,0,0,0,471,0.0,20.270989009396065,5
2020-07-19-171117,171117,0,0,0,471,0.0,20.66324823074629,6
2020-07-20-171117,171117,0,0,0,471,0.14285714285714285,18.798998593762995,0
2020-07-21-171117,171117,0,0,1,471,0.42857142857142855,7.887239590455476,1
2020-07-22-171117,171117,0,0,0,471,0.14285714285714285,10.487013224273156,2
2020-07-23-171117,171117,0,0,0,471,1.0,10.645283969526584,3
2020-07-24-171117,171117,1,0,0,472,0.14285714285714285,17.046366355277332,4
2020-07-25-171117,171117,0,2,0,472,0.0,27.546389841966672,5
2020-07-26-171117,171117,0,0,0,472,0.0,27.944976136219264,6
2020-07-27-171117,171117,0,0,0,472,0.42857142857142855,27.22058227974537,0
2020-07-28-171117,171117,0,0,0,472,0.42857142857142855,31.2348595587836,1
2020-07-29-171117,171117,1,0,3,473,0.5714285714285714,28.664118001036694,2
2020-07-30-171117,171117,0,0,1,473,0.7142857142857143,30.79070082183295,3
2020-07-31-171117,171117,1,0,1,474,0.5714285714285714,34.192276013264404,4
2020-08-01-171117,171117,0,0,2,474,0.0,25.139595341228098,5
2020-08-02-171117,171117,0,0,0,474,0.42857142857142855,130.44877982004726,6
2020-08-03-171117,171117,0,0,0,474,0.42857142857142855,159.23391961816685,0
2020-08-04-171117,171117,1,0,0,475,0.0,131.58407542770084,1
2020-08-05-171117,171117,0,0,0,475,0.0,115.34647746324825,2
2020-08-06-171117,171117,0,0,1,475,0.0,84.92729755145851,3
2020-08-07-171117,171117,0,0,0,475,0.5714285714285714,69.95589934353293,4
2020-08-08-171117,171117,0,0,0,475,0.0,52.39199214619102,5
2020-08-09-171117,171117,0,0,0,475,0.2857142857142857,47.415019580200784,6
2020-08-10-171117,171117,0,0,1,475,0.14285714285714285,8.567427864917338,0
2020-08-11-171117,171117,0,0,1,475,0.8571428571428571,13.016401650716636,1
2020-08-12-171117,171117,3,0,0,478,0.2857142857142857,24.174153883525054,2
2020-08-13-171117,171117,1,0,2,479,1.1428571428571428,55.261355658945035,3
2020-08-14-171117,171117,1,0,0,480,0.5714285714285714,99.49224282013516,4
2020-08-15-171117,171117,2,0,0,482,0.2857142857142857,124.31751579690156,5
2020-08-16-171117,171117,0,0,0,482,0.0,145.01234580248905,6
2020-08-17-171117,171117,0,0,0,482,0.14285714285714285,146.7074182964544,0
2020-08-18-171117,171117,0,0,0,482,1.2857142857142858,145.59647398901402,1
2020-08-19-171117,171117,0,0,0,482,0.2857142857142857,160.68078021425055,2
2020-08-20-171117,171117,1,0,0,483,2.0,91.86411664193264,3
2020-08-21-171117,171117,0,0,0,483,1.0,92.18571353427791,4
2020-08-22-171117,171117,0,0,1,483,0.7142857142857143,80.43440185426233,5
2020-08-23-171117,171117,0,0,1,483,0.5714285714285714,86.94893707894195,6
2020-08-24-171117,171117,1,1,0,484,2.4285714285714284,85.59730200028199,0
2020-08-25-171117,171117,1,1,0,485,3.2857142857142856,82.20320351484048,1
2020-08-26-171117,171117,0,0,1,485,3.4285714285714284,102.10957594161951,2
2020-08-27-171117,171117,2,0,1,487,2.0,127.00207572731932,3
2020-08-28-171117,171117,0,1,1,487,1.4285714285714286,136.9784537501598,4
2020-08-29-171117,171117,0,0,0,487,2.8571428571428568,142.370202117468,5
2020-08-30-171117,171117,0,0,0,487,1.8571428571428568,163.8695063779284,6
2020-08-31-171117,171117,0,0,0,487,1.0,146.37461970135604,0
2020-09-01-171117,171117,0,0,1,487,2.0,42.72356087687315,1
2020-09-02-171117,171117,0,0,0,487,2.4285714285714284,464.5093085579824,2
2020-09-03-171117,171117,0,0,1,487,1.1428571428571428,687.4934212403223,3
2020-09-04-171117,171117,0,0,6,487,1.4285714285714286,550.6544393605582,4
2020-09-05-171117,171117,1,0,2,488,0.42857142857142855,445.98111641263876,5
2020-09-06-171117,171117,1,0,1,489,0.2857142857142857,336.60125842038735,6
2020-09-07-171117,171117,0,0,0,489,1.7142857142857142,287.1971610183215,0
2020-09-08-171117,171117,0,0,1,489,2.0,248.8306768750071,1
2020-09-09-171117,171117,1,0,4,490,0.5714285714285714,189.03549506105196,2
2020-09-10-171117,171117,1,0,9,491,2.2857142857142856,46.6551094025909,3
2020-09-11-171117,171117,1,1,21,492,0.8571428571428571,76.63126331627636,4
2020-09-12-171117,171117,0,0,8,492,0.8571428571428571,107.33959170249024,5
2020-09-13-171117,171117,0,0,2,492,0.2857142857142857,118.26238355616509,6
2020-09-14-171117,171117,0,0,8,492,2.4285714285714284,118.91437593904848,0
2020-09-15-171117,171117,1,0,9,493,2.0,152.9653114155323,1
2020-09-16-171117,171117,0,0,9,493,2.7142857142857144,189.95775217905913,2
2020-09-17-171117,171117,1,0,4,494,10.428571428571429,216.6706211809185,3
2020-09-18-171117,171117,6,0,6,500,3.8571428571428568,357.7247461865079,4
2020-09-19-171117,171117,2,0,0,502,1.0,427.85972234076945,5
2020-09-20-171117,171117,1,1,5,503,1.4285714285714286,447.7580815870707,6
2020-09-21-171117,171117,0,0,5,503,1.2857142857142858,431.99523725889367,0
2020-09-22-171117,171117,1,0,10,504,0.8571428571428571,426.58558538804493,1
2020-09-23-171117,171117,4,1,2,508,1.5714285714285714,422.8870493300676,2
2020-09-24-171117,171117,9,0,4,517,4.142857142857143,348.6827973191715,3
2020-09-25-171117,171117,21,0,6,538,3.1428571428571432,346.02575632386896,4
2020-09-26-171117,171117,8,0,2,546,2.2857142857142856,417.4555896621429,5
2020-09-27-171117,171117,2,0,1,548,2.571428571428572,493.8574811670253,6
2020-09-28-171117,171117,8,0,1,556,0.8571428571428571,518.0744377796588,0
2020-09-29-171117,171117,9,0,1,565,0.2857142857142857,546.9009654288742,1
2020-09-30-171117,171117,9,0,2,574,2.571428571428572,505.99383584331247,2
2020-10-01-171117,171117,4,0,1,578,1.4285714285714286,0.0,3
2020-10-02-171117,171117,6,0,2,584,3.8571428571428568,454.930523975894,4
2020-10-03-171117,171117,0,0,1,584,2.2857142857142856,673.7178556316289,5
2020-10-04-171117,171117,5,0,1,589,0.8571428571428571,630.1237648953869,6
2020-10-05-171117,171117,5,0,6,594,0.7142857142857143,521.9781583767457,0
2020-10-06-171117,171117,10,0,6,604,4.714285714285714,485.54157814943267,1
2020-10-07-171117,171117,2,0,4,606,1.8571428571428568,457.0743398632917,2
2020-10-08-171117,171117,4,0,17,610,5.428571428571429,409.91672935171647,3
2020-10-09-171117,171117,6,0,8,616,2.4285714285714284,472.5165786972763,4
2020-10-10-171117,171117,2,0,2,618,2.4285714285714284,31.8652515981694,5
2020-10-11-171117,171117,1,0,1,619,2.8571428571428568,65.11006922600902,6
2020-10-12-171117,171117,1,0,10,620,0.2857142857142857,102.04818867747525,0
2020-10-13-171117,171117,1,0,3,621,1.0,113.743117337311,1
2020-10-14-171117,171117,2,0,9,623,3.4285714285714284,135.70211839562396,2
2020-10-15-171117,171117,1,0,1,624,3.0,211.72058772057704,3
2020-10-16-171117,171117,2,0,12,626,6.142857142857142,278.28496936845625,4
2020-10-17-171117,171117,1,0,0,627,3.0,376.46735147609155,5
2020-10-18-171117,171117,1,0,1,628,1.8571428571428568,374.23531510925073,6
2020-10-19-171117,171117,6,0,4,634,1.8571428571428568,365.5598647278138,0
2020-10-20-171117,171117,6,0,13,640,6.2857142857142865,465.01126992547483,1
2020-10-21-171117,171117,4,0,8,644,2.4285714285714284,507.1079547613963,2
2020-10-22-171117,171117,17,0,4,661,3.1428571428571432,531.6107903855257,3
2020-10-23-171117,171117,8,0,0,669,4.142857142857143,590.3646859615027,4
2020-10-24-171117,171117,2,0,0,671,2.571428571428572,704.8784704451366,5
2020-10-25-171117,171117,1,2,1,672,1.8571428571428568,704.0344010358956,6
2020-10-26-171117,171117,10,0,2,682,4.857142857142857,651.6512395455989,0
2020-10-27-171117,171117,3,1,7,685,4.857142857142857,740.8296838543347,1
2020-10-28-171117,171117,9,0,3,694,3.4285714285714284,703.4479411523073,2
2020-10-29-171117,171117,1,1,3,695,5.571428571428571,729.109820556692,3
2020-10-30-171117,171117,12,0,5,707,8.0,485.0530370185691,4
2020-10-31-171117,171117,0,1,0,707,2.4285714285714284,599.3920871634207,5
2020-11-01-171117,171117,1,0,0,708,1.4285714285714286,361.45235371996944,6
2020-11-02-171117,171117,4,0,0,712,1.2857142857142858,423.95251846542783,0
2020-11-03-171117,171117,13,1,0,725,3.2857142857142856,424.1334747956893,1
2020-11-04-171117,171117,8,0,0,733,4.285714285714286,555.4029355774304,2
2020-11-05-171117,171117,4,0,0,737,4.142857142857143,654.1535853540544,3
2020-11-06-171117,171117,0,3,0,737,10.285714285714286,609.4021982468882,4
2020-11-07-171117,171117,0,0,0,737,3.8571428571428568,666.941349871677,5
2020-11-08-171117,171117,1,0,0,738,1.5714285714285714,593.7559843533588,6
2020-11-09-171117,171117,2,1,0,740,3.1428571428571432,556.8532005637903,0
2020-11-10-171117,171117,7,0,0,747,3.2857142857142856,350.51444434061216,1
2020-11-11-171117,171117,3,2,0,750,4.0,400.40916350443547,2
2020-11-12-171117,171117,3,1,0,753,3.2857142857142856,428.8684413486523,3
2020-11-13-171117,171117,5,0,0,758,2.8571428571428568,402.8314352752625,4
2020-03-01-171118,171118,0,0,0,0,0.0,0.0,6
2020-03-02-171118,171118,0,0,0,0,0.0,5.6169166257558345,0
2020-03-03-171118,171118,0,0,0,0,0.0,15.618301671526943,1
2020-03-04-171118,171118,0,0,0,0,0.0,16.38880149076003,2
2020-03-05-171118,171118,0,0,0,0,0.0,19.079229545743875,3
2020-03-06-171118,171118,0,0,0,0,0.0,15.21491890980387,4
2020-03-07-171118,171118,0,0,0,0,0.25,17.05556615136208,5
2020-03-08-171118,171118,0,0,0,0,0.0,19.317093878929235,6
2020-03-09-171118,171118,0,0,1,0,0.25,19.28726180275255,0
2020-03-10-171118,171118,0,0,0,0,0.0,170.62533942099344,1
2020-03-11-171118,171118,0,0,1,0,0.0,143.66332877695777,2
2020-03-12-171118,171118,0,0,0,0,0.25,106.1250305050702,3
2020-03-13-171118,171118,0,0,0,0,0.25,62.120925983224694,4
2020-03-14-171118,171118,0,0,0,0,0.25,46.52032503883159,5
2020-03-15-171118,171118,0,0,1,0,0.75,38.498086492009904,6
2020-03-16-171118,171118,0,0,0,0,2.25,7.016597368119326,0
2020-03-17-171118,171118,0,0,0,0,5.5,9.589809813030003,1
2020-03-18-171118,171118,0,0,1,0,7.75,17.608543639671634,2
2020-03-19-171118,171118,0,0,0,0,4.5,24.513361293198056,3
2020-03-20-171118,171118,0,2,0,0,5.0,27.65457871733746,4
2020-03-21-171118,171118,0,0,0,0,2.25,30.936119869486735,5
2020-03-22-171118,171118,0,0,0,0,2.0,32.52791659189369,6
2020-03-23-171118,171118,1,0,0,1,9.25,30.678285665500606,0
2020-03-24-171118,171118,0,0,1,1,8.75,33.29387568350141,1
2020-03-25-171118,171118,1,0,1,2,6.5,30.710272921727515,2
2020-03-26-171118,171118,0,0,0,2,3.0,30.17157739411375,3
2020-03-27-171118,171118,0,0,0,2,5.75,33.79401268614272,4
2020-03-28-171118,171118,0,0,0,2,1.0,34.194435457798896,5
2020-03-29-171118,171118,1,0,0,3,2.0,31.098424573263582,6
2020-03-30-171118,171118,0,0,0,3,4.0,22.981964197342684,0
2020-03-31-171118,171118,0,0,0,3,3.25,22.378584850452427,1
2020-04-01-171118,171118,1,0,0,4,4.75,6.339454805318474,2
2020-04-02-171118,171118,0,0,0,4,4.5,13.60632881055463,3
2020-04-03-171118,171118,0,0,0,4,2.5,14.660493352440664,4
2020-04-04-171118,171118,0,0,0,4,0.75,21.076741593505247,5
2020-04-05-171118,171118,0,0,0,4,0.5,24.54489967490944,6
2020-04-06-171118,171118,0,0,0,4,6.75,24.210353214908157,0
2020-04-07-171118,171118,1,0,2,5,3.25,25.923350127224822,1
2020-04-08-171118,171118,1,0,0,6,2.75,27.62779257177682,2
2020-04-09-171118,171118,0,0,0,6,5.5,27.31930737177779,3
2020-04-10-171118,171118,0,0,1,6,7.5,16.10884433642681,4
2020-04-11-171118,171118,0,0,0,6,1.5,19.263207829516073,5
2020-04-12-171118,171118,0,0,0,6,6.25,19.443733445860516,6
2020-04-13-171118,171118,0,0,0,6,2.25,20.46724876215612,0
2020-04-14-171118,171118,0,0,0,6,4.25,20.73099323946684,1
2020-04-15-171118,171118,0,0,0,6,0.25,25.03440884946125,2
2020-04-16-171118,171118,0,0,0,6,2.25,26.243346815927048,3
2020-04-17-171118,171118,0,0,0,6,2.0,14.64798742156885,4
2020-04-18-171118,171118,0,0,0,6,0.75,14.497273677624868,5
2020-04-19-171118,171118,0,0,0,6,0.25,14.339824847852242,6
2020-04-20-171118,171118,0,0,0,6,0.5,18.60686982881009,0
2020-04-21-171118,171118,2,0,0,8,2.5,15.46943010104263,1
2020-04-22-171118,171118,0,0,0,8,1.25,19.81096917803578,2
2020-04-23-171118,171118,0,0,0,8,0.5,20.036215907983518,3
2020-04-24-171118,171118,1,0,0,9,10.0,16.69774167370602,4
2020-04-25-171118,171118,0,0,0,9,0.25,21.556450055556112,5
2020-04-26-171118,171118,0,0,0,9,0.25,21.20015349501228,6
2020-04-27-171118,171118,0,0,1,9,2.5,15.237320280940173,0
2020-04-28-171118,171118,0,0,1,9,3.0,16.86067091330255,1
2020-04-29-171118,171118,0,0,0,9,1.25,15.22565249222879,2
2020-04-30-171118,171118,0,0,0,9,2.25,26.774724123894696,3
2020-05-01-171118,171118,0,1,1,9,0.25,25.414319992819436,4
2020-05-02-171118,171118,0,0,0,9,0.25,21.16773389720473,5
2020-05-03-171118,171118,0,0,0,9,0.25,5.687413286346374,6
2020-05-04-171118,171118,0,0,0,9,2.25,5.7975748036342045,0
2020-05-05-171118,171118,0,0,0,9,3.5,5.788710110355926,1
2020-05-06-171118,171118,0,0,0,9,2.5,7.36151907200829,2
2020-05-07-171118,171118,0,0,0,9,7.0,9.37438276586899,3
2020-05-08-171118,171118,0,0,0,9,1.25,15.727384289297623,4
2020-05-09-171118,171118,0,0,0,9,0.25,18.52499972634289,5
2020-05-10-171118,171118,0,0,0,9,0.25,25.826357744356958,6
2020-05-11-171118,171118,1,0,0,10,1.5,21.828694571451166,0
2020-05-12-171118,171118,1,0,0,11,1.5,24.57522179434279,1
2020-05-13-171118,171118,0,0,1,11,4.75,25.35482484345279,2
2020-05-14-171118,171118,0,0,0,11,1.5,22.231024363428837,3
2020-05-15-171118,171118,1,0,0,12,1.75,21.96842841499431,4
2020-05-16-171118,171118,0,0,0,12,0.25,23.996083542018447,5
2020-05-17-171118,171118,0,0,0,12,0.0,24.274906748847144,6
2020-05-18-171118,171118,0,0,0,12,2.25,23.977491184473237,0
2020-05-19-171118,171118,0,0,0,12,1.5,27.897692016226586,1
2020-05-20-171118,171118,0,0,0,12,1.25,22.567323587069943,2
2020-05-21-171118,171118,0,0,0,12,1.5,21.244722058159514,3
2020-05-22-171118,171118,0,0,0,12,2.25,16.012078044198205,4
2020-05-23-171118,171118,0,0,0,12,0.0,18.286909250865232,5
2020-05-24-171118,171118,0,0,0,12,0.0,18.524420434950176,6
2020-05-25-171118,171118,0,0,0,12,0.5,11.127172094008168,0
2020-05-26-171118,171118,0,0,0,12,1.0,8.013051885552311,1
2020-05-27-171118,171118,1,4,0,13,0.5,10.398323699250332,2
2020-05-28-171118,171118,0,0,0,13,1.5,8.650833459584469,3
2020-05-29-171118,171118,0,3,0,13,1.5,9.464372198461229,4
2020-05-30-171118,171118,0,0,0,13,0.0,8.48844537032111,5
2020-05-31-171118,171118,0,0,0,13,0.0,8.897531879565605,6
2020-06-01-171118,171118,0,0,0,13,1.75,25.050131068066168,0
2020-06-02-171118,171118,0,0,0,13,1.25,3.1358863184687626,1
2020-06-03-171118,171118,0,0,0,13,0.75,6.29444501114319,2
2020-06-04-171118,171118,0,0,0,13,3.0,3.9549323239434204,3
2020-06-05-171118,171118,0,0,0,13,1.0,7.424254014909509,4
2020-06-06-171118,171118,0,0,0,13,0.0,7.605741882173684,5
2020-06-07-171118,171118,0,0,0,13,0.0,7.781880393433287,6
2020-06-08-171118,171118,0,0,0,13,0.75,7.9767841491882265,0
2020-06-09-171118,171118,0,0,1,13,0.25,9.330763307661849,1
2020-06-10-171118,171118,0,0,0,13,1.0,30.952838688535948,2
2020-06-11-171118,171118,0,0,0,13,0.75,28.489356014643672,3
2020-06-12-171118,171118,0,0,1,13,1.0,26.18454583421653,4
2020-06-13-171118,171118,0,0,0,13,0.0,21.61511090028209,5
2020-06-14-171118,171118,0,0,0,13,0.0,9.828184865890643,6
2020-06-15-171118,171118,0,0,0,13,1.25,6.955896532869124,0
2020-06-16-171118,171118,0,0,0,13,0.0,7.261067612300874,1
2020-06-17-171118,171118,0,0,0,13,0.5,5.9515057156110975,2
2020-06-18-171118,171118,0,1,0,13,0.5,5.820855843704839,3
2020-06-19-171118,171118,0,0,0,13,0.0,5.271800767735968,4
2020-06-20-171118,171118,0,0,0,13,0.0,7.237116747721572,5
2020-06-21-171118,171118,0,0,0,13,0.0,7.463610504843256,6
2020-06-22-171118,171118,0,0,0,13,0.5,6.498543754672631,0
2020-06-23-171118,171118,1,0,0,14,0.75,6.726579733388724,1
2020-06-24-171118,171118,0,0,0,14,1.25,9.747710350305123,2
2020-06-25-171118,171118,0,0,0,14,0.5,10.285860626620858,3
2020-06-26-171118,171118,1,0,0,15,0.25,10.529865180842636,4
2020-06-27-171118,171118,0,0,0,15,0.0,8.629353447730761,5
2020-06-28-171118,171118,0,0,0,15,0.0,9.33254876006685,6
2020-06-29-171118,171118,0,0,0,15,0.75,9.344228273536707,0
2020-06-30-171118,171118,0,0,0,15,0.25,7.056702516368171,1
2020-07-01-171118,171118,0,1,1,15,0.0,12.086158739987694,2
2020-07-02-171118,171118,0,0,0,15,0.75,1.1888205591836936,3
2020-07-03-171118,171118,0,0,0,15,0.25,2.466840296866583,4
2020-07-04-171118,171118,0,0,0,15,0.0,7.586654752603346,5
2020-07-05-171118,171118,0,0,0,15,0.0,7.640758689968537,6
2020-07-06-171118,171118,0,0,0,15,0.25,7.487560115260026,0
2020-07-07-171118,171118,0,0,0,15,0.0,7.69548784340166,1
2020-07-08-171118,171118,0,0,0,15,0.5,6.8220298317130865,2
2020-07-09-171118,171118,0,0,0,15,0.5,6.706126080755175,3
2020-07-10-171118,171118,0,0,0,15,0.5,13.055668908208368,4
2020-07-11-171118,171118,0,0,0,15,0.0,9.757139292952795,5
2020-07-12-171118,171118,0,0,0,15,0.0,7.995492723815644,6
2020-07-13-171118,171118,0,0,0,15,0.25,7.444077737746256,0
2020-07-14-171118,171118,0,0,0,15,0.0,7.6170881400878,1
2020-07-15-171118,171118,1,0,0,16,0.0,4.943709863441702,2
2020-07-16-171118,171118,0,0,0,16,0.0,3.0733086748309586,3
2020-07-17-171118,171118,0,0,0,16,0.25,3.198358508466142,4
2020-07-18-171118,171118,0,0,0,16,0.25,1.3313698400571714,5
2020-07-19-171118,171118,0,0,0,16,0.0,1.4658717114210136,6
2020-07-20-171118,171118,0,0,0,16,0.0,2.2747332973366756,0
2020-07-21-171118,171118,0,0,0,16,0.0,3.236456431564939,1
2020-07-22-171118,171118,0,0,0,16,0.0,3.2433071173846186,2
2020-07-23-171118,171118,0,0,0,16,0.25,3.1244349353840835,3
2020-07-24-171118,171118,0,0,0,16,0.25,3.03074258872648,4
2020-07-25-171118,171118,0,0,0,16,0.0,3.24168977261141,5
2020-07-26-171118,171118,0,0,0,16,0.0,3.2268666600775258,6
2020-07-27-171118,171118,0,0,0,16,0.25,2.2228649114494052,0
2020-07-28-171118,171118,0,0,0,16,0.0,1.4014984041666732,1
2020-07-29-171118,171118,0,0,0,16,0.25,1.8880257569357668,2
2020-07-30-171118,171118,0,0,0,16,0.5,3.8114503251046354,3
2020-07-31-171118,171118,0,0,0,16,1.0,7.448510523660991,4
2020-08-01-171118,171118,0,0,1,16,0.25,4.2764671549912485,5
2020-08-02-171118,171118,0,0,0,16,0.0,51.650834894716965,6
2020-08-03-171118,171118,0,0,0,16,0.75,73.89632153936329,0
2020-08-04-171118,171118,0,0,0,16,0.0,61.21125364999627,1
2020-08-05-171118,171118,0,0,6,16,0.5,54.29662160804354,2
2020-08-06-171118,171118,0,0,0,16,2.25,50.68992480879871,3
2020-08-07-171118,171118,0,0,1,16,0.5,37.778156314356735,4
2020-08-08-171118,171118,0,0,0,16,0.0,37.38592702360693,5
2020-08-09-171118,171118,0,0,1,16,0.25,37.045992987061396,6
2020-08-10-171118,171118,0,0,3,16,0.0,3.6155759390768667,0
2020-08-11-171118,171118,0,0,4,16,0.25,4.752577316316184,1
2020-08-12-171118,171118,0,0,0,16,1.5,9.249433077490822,2
2020-08-13-171118,171118,0,0,0,16,0.0,10.93104898233025,3
2020-08-14-171118,171118,0,0,3,16,0.0,13.235609074089774,4
2020-08-15-171118,171118,1,0,0,17,2.75,15.519644188689574,5
2020-08-16-171118,171118,0,0,0,17,0.75,22.83382471843545,6
2020-08-17-171118,171118,0,0,0,17,0.75,30.94375317043672,0
2020-08-18-171118,171118,0,0,0,17,1.25,34.31842321980619,1
2020-08-19-171118,171118,6,0,3,23,1.25,34.95966546690267,2
2020-08-20-171118,171118,0,0,0,23,0.75,51.48126948345804,3
2020-08-21-171118,171118,1,0,0,24,1.0,64.14144020784668,4
2020-08-22-171118,171118,0,0,1,24,1.25,77.97616416480285,5
2020-08-23-171118,171118,1,0,1,25,0.75,93.17003205691607,6
2020-08-24-171118,171118,3,0,0,28,0.25,96.15498373569773,0
2020-08-25-171118,171118,4,0,9,32,1.0,107.4089830329307,1
2020-08-26-171118,171118,0,0,5,32,2.25,106.85934369995184,2
2020-08-27-171118,171118,0,0,1,32,1.5,112.23702611983396,3
2020-08-28-171118,171118,3,0,0,35,1.0,101.4503229568989,4
2020-08-29-171118,171118,0,0,0,35,0.25,93.40559172981088,5
2020-08-30-171118,171118,0,0,0,35,5.5,66.32385735709708,6
2020-08-31-171118,171118,0,0,0,35,2.75,59.11736929935925,0
2020-09-01-171118,171118,0,0,4,35,1.25,38.847561806928496,1
2020-09-02-171118,171118,3,0,3,38,2.0,123.07747581491765,2
2020-09-03-171118,171118,0,0,0,38,1.5,85.5823103347351,3
2020-09-04-171118,171118,0,0,1,38,2.5,77.48943013307434,4
2020-09-05-171118,171118,1,0,0,39,0.5,77.87784219140002,5
2020-09-06-171118,171118,1,0,1,40,0.0,74.50405758904313,6
2020-09-07-171118,171118,0,0,0,40,0.0,81.64729768002088,0
2020-09-08-171118,171118,9,0,14,49,1.75,76.60136707216904,1
2020-09-09-171118,171118,5,0,0,54,1.75,105.67396953829991,2
2020-09-10-171118,171118,1,0,4,55,2.75,22.87540135420707,3
2020-09-11-171118,171118,0,0,0,55,0.75,46.1344231495593,4
2020-09-12-171118,171118,0,0,1,55,0.0,52.30609826832392,5
2020-09-13-171118,171118,0,0,0,55,1.25,58.589509203630925,6
2020-09-14-171118,171118,0,0,3,55,0.75,60.80293039552183,0
2020-09-15-171118,171118,4,0,0,59,3.5,64.66567194905635,1
2020-09-16-171118,171118,3,0,1,62,0.5,75.21464310094004,2
2020-09-17-171118,171118,0,0,5,62,2.25,87.17373100963293,3
2020-09-18-171118,171118,1,0,0,63,1.75,99.86035383494756,4
2020-09-19-171118,171118,0,0,0,63,1.0,108.74102304109906,5
2020-09-20-171118,171118,1,1,0,64,1.25,111.921994573441,6
2020-09-21-171118,171118,0,0,0,64,1.75,112.45227423355584,0
2020-09-22-171118,171118,14,0,1,78,3.0,101.31045027680184,1
2020-09-23-171118,171118,0,0,0,78,1.0,139.93189560946976,2
2020-09-24-171118,171118,4,0,0,82,2.25,117.21417808306023,3
2020-09-25-171118,171118,0,1,0,82,1.0,130.25843755338184,4
2020-09-26-171118,171118,1,0,0,83,0.5,135.61485858114554,5
2020-09-27-171118,171118,0,0,0,83,0.25,129.41324866484462,6
2020-09-28-171118,171118,3,0,0,86,1.25,124.30689897723974,0
2020-09-29-171118,171118,0,0,0,86,2.25,123.77100436178642,1
2020-09-30-171118,171118,1,0,0,87,0.5,86.83064618982328,2
2020-10-01-171118,171118,5,0,0,92,1.0,0.0,3
2020-10-02-171118,171118,0,0,0,92,1.25,91.33012259474263,4
2020-10-03-171118,171118,0,0,0,92,0.5,235.61127811722164,5
2020-10-04-171118,171118,0,1,0,92,0.25,251.516548580076,6
2020-10-05-171118,171118,0,0,0,92,1.0,220.01966845205763,0
2020-10-06-171118,171118,1,0,0,93,2.0,170.4647791003016,1
2020-10-07-171118,171118,0,0,2,93,2.5,142.40623316013762,2
2020-10-08-171118,171118,0,0,0,93,1.75,124.01373194820263,3
2020-10-09-171118,171118,0,0,1,93,7.75,136.17883502727713,4
2020-10-10-171118,171118,0,0,0,93,0.25,11.535393957089623,5
2020-10-11-171118,171118,0,0,0,93,1.0,15.773565711024794,6
2020-10-12-171118,171118,0,0,0,93,2.25,19.974897551499048,0
2020-10-13-171118,171118,0,0,0,93,1.5,31.000627975289213,1
2020-10-14-171118,171118,0,0,0,93,3.75,35.81363111409563,2
2020-10-15-171118,171118,0,0,0,93,3.0,49.83480496658903,3
2020-10-16-171118,171118,0,0,1,93,6.75,66.94174242564179,4
2020-10-17-171118,171118,0,0,0,93,1.0,73.91379361667849,5
2020-10-18-171118,171118,0,0,0,93,0.75,75.20648630605058,6
2020-10-19-171118,171118,0,1,0,93,2.25,78.39787840145398,0
2020-10-20-171118,171118,0,0,1,93,2.5,88.68331331147134,1
2020-10-21-171118,171118,2,0,0,95,2.5,88.76078903128027,2
2020-10-22-171118,171118,0,0,0,95,3.0,99.30922550754653,3
2020-10-23-171118,171118,1,0,2,96,11.5,100.31504761428226,4
2020-10-24-171118,171118,0,0,5,96,1.25,133.33642492721685,5
2020-10-25-171118,171118,0,0,0,96,1.75,135.99476733924817,6
2020-10-26-171118,171118,0,0,1,96,4.0,140.01493932017974,0
2020-10-27-171118,171118,0,0,0,96,4.75,159.73693410106608,1
2020-10-28-171118,171118,0,0,0,96,8.0,195.37726234968738,2
2020-10-29-171118,171118,0,0,0,96,5.75,202.74738775393666,3
2020-10-30-171118,171118,1,0,2,97,10.75,174.92547932897799,4
2020-10-31-171118,171118,0,0,0,97,3.25,234.6022744492228,5
2020-11-01-171118,171118,0,1,0,97,1.0,68.33356781804065,6
2020-11-02-171118,171118,0,0,0,97,1.75,127.73750900064077,0
2020-11-03-171118,171118,1,0,0,98,4.0,101.65202818684038,1
2020-11-04-171118,171118,0,0,0,98,4.0,124.7047321833244,2
2020-11-05-171118,171118,0,0,0,98,12.5,144.53168482867662,3
2020-11-06-171118,171118,2,0,0,100,6.75,144.69816512816863,4
2020-11-07-171118,171118,5,0,0,105,1.0,169.1124003830829,5
2020-11-08-171118,171118,0,0,0,105,2.25,168.6111273315745,6
2020-11-09-171118,171118,1,0,0,106,6.25,161.57181403540534,0
2020-11-10-171118,171118,0,0,0,106,4.25,65.07056067521671,1
2020-11-11-171118,171118,0,0,0,106,10.25,84.6378142482841,2
2020-11-12-171118,171118,0,0,0,106,6.5,105.96624787847266,3
2020-11-13-171118,171118,2,0,0,108,5.5,117.20506375656498,4
2020-03-01-171119,171119,0,0,0,0,0.0,0.0,6
2020-03-02-171119,171119,0,0,0,0,0.0,7.999785076507699,0
2020-03-03-171119,171119,0,1,0,0,0.0,31.531030885383032,1
2020-03-04-171119,171119,1,1,0,1,0.0,46.00616227220934,2
2020-03-05-171119,171119,0,0,0,1,0.0,56.07722361547269,3
2020-03-06-171119,171119,0,0,1,1,0.0,55.01002399191091,4
2020-03-07-171119,171119,0,0,0,1,0.0,64.00579426946345,5
2020-03-08-171119,171119,0,0,0,1,0.0,69.99813032284766,6
2020-03-09-171119,171119,0,0,0,1,0.0,70.33683197433399,0
2020-03-10-171119,171119,0,0,0,1,0.0,269.2319408880654,1
2020-03-11-171119,171119,0,0,0,1,0.0,214.45695506481476,2
2020-03-12-171119,171119,0,0,0,1,0.0,147.22423842012338,3
2020-03-13-171119,171119,0,0,0,1,0.0,99.07916730827799,4
2020-03-14-171119,171119,0,0,0,1,0.0,58.08292516177998,5
2020-03-15-171119,171119,0,0,0,1,0.0,39.18538362263291,6
2020-03-16-171119,171119,0,1,2,1,1.3333333333333333,7.684560531256574,0
2020-03-17-171119,171119,0,0,3,1,1.5,16.487874308795348,1
2020-03-18-171119,171119,0,3,2,1,1.8333333333333333,25.923805786104406,2
2020-03-19-171119,171119,0,1,1,1,1.6666666666666667,40.111642607713016,3
2020-03-20-171119,171119,1,2,2,2,1.8333333333333333,47.419366297776186,4
2020-03-21-171119,171119,0,0,0,2,0.6666666666666666,61.43872686375265,5
2020-03-22-171119,171119,0,0,0,2,0.3333333333333333,61.05797110863545,6
2020-03-23-171119,171119,0,0,0,2,2.833333333333333,56.33059632198757,0
2020-03-24-171119,171119,0,0,0,2,1.8333333333333333,64.95803261934623,1
2020-03-25-171119,171119,0,0,1,2,1.3333333333333333,60.150179386597074,2
2020-03-26-171119,171119,0,1,0,2,1.5,62.76649857741686,3
2020-03-27-171119,171119,0,0,1,2,1.3333333333333333,72.2019887590457,4
2020-03-28-171119,171119,0,0,2,2,0.16666666666666666,68.52549377212046,5
2020-03-29-171119,171119,0,0,0,2,0.5,66.99965358569699,6
2020-03-30-171119,171119,2,0,1,4,0.6666666666666666,48.93171115711046,0
2020-03-31-171119,171119,3,0,0,7,1.8333333333333333,59.703988632330216,1
2020-04-01-171119,171119,2,0,1,9,0.6666666666666666,34.20165161439577,2
2020-04-02-171119,171119,1,0,2,10,1.0,72.31839385681997,3
2020-04-03-171119,171119,2,0,2,12,1.5,42.28017732279437,4
2020-04-04-171119,171119,0,0,0,12,0.5,42.34192396495522,5
2020-04-05-171119,171119,0,1,0,12,0.5,43.647340913709506,6
2020-04-06-171119,171119,0,0,1,12,1.1666666666666667,46.28464893095169,0
2020-04-07-171119,171119,0,0,0,12,1.6666666666666667,53.91132938739138,1
2020-04-08-171119,171119,1,0,0,13,0.3333333333333333,57.08599431680838,2
2020-04-09-171119,171119,0,0,1,13,0.5,59.97286540675479,3
2020-04-10-171119,171119,1,0,1,14,0.5,24.940070420339964,4
2020-04-11-171119,171119,2,0,0,16,0.0,32.00730031804771,5
2020-04-12-171119,171119,0,0,0,16,0.16666666666666666,45.30710853934962,6
2020-04-13-171119,171119,1,0,0,17,1.5,46.43027688220761,0
2020-04-14-171119,171119,0,0,0,17,1.3333333333333333,58.69950839128849,1
2020-04-15-171119,171119,1,0,0,18,0.16666666666666666,65.60384551762272,2
2020-04-16-171119,171119,2,0,0,20,0.6666666666666666,73.20409565485525,3
2020-04-17-171119,171119,2,0,0,22,0.6666666666666666,69.69048324666124,4
2020-04-18-171119,171119,0,0,0,22,0.16666666666666666,76.82173053853859,5
2020-04-19-171119,171119,0,1,0,22,0.16666666666666666,66.65721451367693,6
2020-04-20-171119,171119,1,0,0,23,0.3333333333333333,68.37335650665295,0
2020-04-21-171119,171119,0,0,0,23,3.333333333333333,68.71208063850915,1
2020-04-22-171119,171119,0,0,1,23,0.3333333333333333,74.90470601970037,2
2020-04-23-171119,171119,1,0,0,24,0.0,65.38105777767642,3
2020-04-24-171119,171119,1,0,3,25,0.6666666666666666,50.36718887225171,4
2020-04-25-171119,171119,0,0,0,25,0.3333333333333333,59.6014500638007,5
2020-04-26-171119,171119,0,1,0,25,0.16666666666666666,59.26812419247274,6
2020-04-27-171119,171119,0,0,0,25,0.6666666666666666,45.663216673127586,0
2020-04-28-171119,171119,0,0,0,25,1.1666666666666667,43.93680354004117,1
2020-04-29-171119,171119,0,0,1,25,1.1666666666666667,37.25039158320143,2
2020-04-30-171119,171119,0,0,0,25,0.5,50.35230813976726,3
2020-05-01-171119,171119,0,0,0,25,0.16666666666666666,62.369724219223684,4
2020-05-02-171119,171119,0,0,0,25,0.16666666666666666,41.77864622257413,5
2020-05-03-171119,171119,0,0,0,25,0.0,13.989111512837512,6
2020-05-04-171119,171119,0,0,1,25,0.3333333333333333,13.347984383705139,0
2020-05-05-171119,171119,0,0,0,25,0.0,16.390540587092985,1
2020-05-06-171119,171119,1,0,1,26,0.8333333333333334,19.26669972056945,2
2020-05-07-171119,171119,0,0,0,26,0.6666666666666666,37.1261816732599,3
2020-05-08-171119,171119,3,0,0,29,0.3333333333333333,58.03816434331228,4
2020-05-09-171119,171119,0,0,0,29,0.16666666666666666,93.13682581547826,5
2020-05-10-171119,171119,0,1,0,29,0.16666666666666666,66.42052935912334,6
2020-05-11-171119,171119,0,0,0,29,0.3333333333333333,63.30693192715236,0
2020-05-12-171119,171119,0,0,0,29,1.0,64.95941434491152,1
2020-05-13-171119,171119,1,3,0,30,0.8333333333333334,59.03374600795936,2
2020-05-14-171119,171119,0,0,0,30,1.5,64.05886974065334,3
2020-05-15-171119,171119,0,0,0,30,0.16666666666666666,55.9437915148944,4
2020-05-16-171119,171119,0,2,0,30,0.16666666666666666,47.090810717305544,5
2020-05-17-171119,171119,0,0,0,30,0.0,45.69817073724524,6
2020-05-18-171119,171119,1,0,0,31,0.8333333333333334,45.41987578549622,0
2020-05-19-171119,171119,0,0,0,31,0.8333333333333334,51.95753804581265,1
2020-05-20-171119,171119,1,0,0,32,0.8333333333333334,33.64929168234711,2
2020-05-21-171119,171119,0,0,0,32,0.3333333333333333,42.301987563431695,3
2020-05-22-171119,171119,0,0,0,32,0.3333333333333333,45.182943138021585,4
2020-05-23-171119,171119,0,0,0,32,0.0,50.561129962601655,5
2020-05-24-171119,171119,0,0,0,32,0.0,51.500242415371254,6
2020-05-25-171119,171119,0,0,0,32,0.3333333333333333,37.915007435979796,0
2020-05-26-171119,171119,0,0,0,32,0.0,33.367745385799196,1
2020-05-27-171119,171119,0,1,0,32,0.0,36.029172420167434,2
2020-05-28-171119,171119,0,4,0,32,1.0,21.589308478900914,3
2020-05-29-171119,171119,0,0,0,32,0.3333333333333333,21.499599084954454,4
2020-05-30-171119,171119,0,0,0,32,0.0,19.759093549635452,5
2020-05-31-171119,171119,0,0,0,32,0.16666666666666666,20.25562579095635,6
2020-06-01-171119,171119,0,1,0,32,0.6666666666666666,113.12017140848863,0
2020-06-02-171119,171119,0,0,0,32,0.8333333333333334,8.317939320533009,1
2020-06-03-171119,171119,0,0,0,32,0.5,9.485002286369761,2
2020-06-04-171119,171119,0,0,0,32,0.6666666666666666,16.662879710821876,3
2020-06-05-171119,171119,0,0,0,32,0.3333333333333333,21.49053230393185,4
2020-06-06-171119,171119,0,0,0,32,0.16666666666666666,21.26305169332905,5
2020-06-07-171119,171119,0,0,0,32,0.0,21.802211263146273,6
2020-06-08-171119,171119,0,1,0,32,0.6666666666666666,21.78943869640087,0
2020-06-09-171119,171119,0,0,0,32,0.6666666666666666,24.527775929016634,1
2020-06-10-171119,171119,0,0,0,32,0.8333333333333334,118.48410202216789,2
2020-06-11-171119,171119,0,0,0,32,0.16666666666666666,115.36249848930447,3
2020-06-12-171119,171119,0,0,0,32,0.3333333333333333,113.89659705607465,4
2020-06-13-171119,171119,0,0,0,32,0.0,86.09472516960159,5
2020-06-14-171119,171119,0,0,0,32,0.0,56.40141515784747,6
2020-06-15-171119,171119,0,1,0,32,0.16666666666666666,18.063039351663335,0
2020-06-16-171119,171119,0,0,1,32,0.3333333333333333,18.33832969503495,1
2020-06-17-171119,171119,0,0,0,32,0.16666666666666666,14.871078016129754,2
2020-06-18-171119,171119,0,0,0,32,0.16666666666666666,12.134061835588497,3
2020-06-19-171119,171119,0,0,0,32,0.0,11.034936537242768,4
2020-06-20-171119,171119,0,0,0,32,0.0,15.065824362441486,5
2020-06-21-171119,171119,0,0,0,32,0.0,14.958378177780505,6
2020-06-22-171119,171119,0,0,0,32,0.16666666666666666,13.016062952294478,0
2020-06-23-171119,171119,0,0,0,32,0.3333333333333333,12.797470450055041,1
2020-06-24-171119,171119,0,0,0,32,0.16666666666666666,14.002295864626968,2
2020-06-25-171119,171119,0,0,0,32,0.3333333333333333,13.94859901315099,3
2020-06-26-171119,171119,0,1,0,32,0.5,13.053133183276671,4
2020-06-27-171119,171119,0,0,0,32,0.16666666666666666,10.754322681950924,5
2020-06-28-171119,171119,0,0,0,32,0.0,11.960016623667691,6
2020-06-29-171119,171119,0,0,0,32,0.3333333333333333,12.14440321683957,0
2020-06-30-171119,171119,1,0,0,33,0.16666666666666666,13.11718194974594,1
2020-07-01-171119,171119,0,0,0,33,0.16666666666666666,30.827348101058305,2
2020-07-02-171119,171119,0,0,0,33,0.16666666666666666,4.133765203847367,3
2020-07-03-171119,171119,0,0,0,33,0.16666666666666666,16.52109699366397,4
2020-07-04-171119,171119,0,0,0,33,0.0,9.467833464605825,5
2020-07-05-171119,171119,0,0,0,33,0.16666666666666666,9.519879797568104,6
2020-07-06-171119,171119,0,0,0,33,0.16666666666666666,8.842609891701281,0
2020-07-07-171119,171119,0,0,0,33,0.0,8.897442464072828,1
2020-07-08-171119,171119,0,0,0,33,0.3333333333333333,7.319654486606888,2
2020-07-09-171119,171119,0,0,1,33,0.16666666666666666,7.361701212823846,3
2020-07-10-171119,171119,0,0,0,33,0.8333333333333334,21.933322968009243,4
2020-07-11-171119,171119,0,0,0,33,0.3333333333333333,23.267495914061712,5
2020-07-12-171119,171119,0,0,0,33,0.0,21.022761449217796,6
2020-07-13-171119,171119,0,0,0,33,0.0,19.989675524315434,0
2020-07-14-171119,171119,0,0,0,33,0.0,20.345060181808396,1
2020-07-15-171119,171119,0,0,0,33,0.16666666666666666,15.294773953460183,2
2020-07-16-171119,171119,0,0,0,33,0.16666666666666666,12.11665362350643,3
2020-07-17-171119,171119,0,0,0,33,0.0,12.241133849592565,4
2020-07-18-171119,171119,0,0,0,33,0.0,4.287436343882421,5
2020-07-19-171119,171119,0,0,0,33,0.3333333333333333,3.9621474941037365,6
2020-07-20-171119,171119,0,0,0,33,0.3333333333333333,5.535396510124354,0
2020-07-21-171119,171119,0,0,0,33,0.6666666666666666,7.149221337408742,1
2020-07-22-171119,171119,0,0,1,33,0.16666666666666666,9.394032659562265,2
2020-07-23-171119,171119,1,0,0,34,1.1666666666666667,9.118937292209653,3
2020-07-24-171119,171119,0,0,1,34,0.0,19.244938425192785,4
2020-07-25-171119,171119,0,0,0,34,0.0,19.50256496561648,5
2020-07-26-171119,171119,0,0,2,34,0.0,18.42510351897126,6
2020-07-27-171119,171119,0,0,0,34,0.16666666666666666,17.23217095691852,0
2020-07-28-171119,171119,0,0,0,34,0.5,16.021473030341507,1
2020-07-29-171119,171119,0,0,0,34,0.3333333333333333,14.643468786522309,2
2020-07-30-171119,171119,0,0,0,34,0.3333333333333333,6.3850604176392025,3
2020-07-31-171119,171119,0,0,0,34,0.3333333333333333,7.4379167475996875,4
2020-08-01-171119,171119,0,0,0,34,0.0,7.335567120260323,5
2020-08-02-171119,171119,0,0,0,34,0.16666666666666666,52.842964250363146,6
2020-08-03-171119,171119,0,0,0,34,0.16666666666666666,127.07144920218371,0
2020-08-04-171119,171119,0,0,0,34,0.0,127.82583830920434,1
2020-08-05-171119,171119,1,0,0,35,0.16666666666666666,85.77231258837688,2
2020-08-06-171119,171119,0,0,1,35,0.16666666666666666,67.46671628111076,3
2020-08-07-171119,171119,1,0,1,36,0.16666666666666666,59.437503494031866,4
2020-08-08-171119,171119,0,0,0,36,0.0,50.345621520024935,5
2020-08-09-171119,171119,2,0,0,38,0.3333333333333333,50.010990665764574,6
2020-08-10-171119,171119,0,0,0,38,0.3333333333333333,5.417590897231652,0
2020-08-11-171119,171119,0,0,0,38,1.3333333333333333,8.197285087962397,1
2020-08-12-171119,171119,0,0,3,38,0.16666666666666666,22.012663486025787,2
2020-08-13-171119,171119,0,0,0,38,0.5,33.67944407680025,3
2020-08-14-171119,171119,0,0,0,38,0.5,41.4602066542961,4
2020-08-15-171119,171119,0,0,0,38,0.6666666666666666,47.48700768256616,5
2020-08-16-171119,171119,0,0,2,38,0.16666666666666666,53.20964989019177,6
2020-08-17-171119,171119,0,0,0,38,0.5,56.35115242582667,0
2020-08-18-171119,171119,0,0,0,38,0.5,60.76280073334859,1
2020-08-19-171119,171119,0,0,0,38,0.3333333333333333,56.66708205649278,2
2020-08-20-171119,171119,1,0,0,39,1.6666666666666667,45.891004496003944,3
2020-08-21-171119,171119,1,0,0,40,1.8333333333333333,62.89171543791183,4
2020-08-22-171119,171119,0,0,0,40,0.6666666666666666,67.96480495734951,5
2020-08-23-171119,171119,0,0,0,40,0.16666666666666666,72.6406093444669,6
2020-08-24-171119,171119,0,0,0,40,1.0,68.48503261010173,0
2020-08-25-171119,171119,0,0,0,40,1.5,69.99761466422116,1
2020-08-26-171119,171119,3,0,0,43,0.8333333333333334,69.70555021256932,2
2020-08-27-171119,171119,0,1,1,43,2.1666666666666665,115.58325617515489,3
2020-08-28-171119,171119,0,0,0,43,1.0,113.69079799230444,4
2020-08-29-171119,171119,0,0,0,43,2.1666666666666665,109.8399631669971,5
2020-08-30-171119,171119,2,0,0,45,0.0,131.71146728342316,6
2020-08-31-171119,171119,0,0,0,45,0.5,129.1146270052039,0
2020-09-01-171119,171119,0,0,0,45,0.8333333333333334,60.36530378907967,1
2020-09-02-171119,171119,0,0,0,45,1.3333333333333333,360.49736473437116,2
2020-09-03-171119,171119,0,0,0,45,0.8333333333333334,233.7741801825086,3
2020-09-04-171119,171119,0,0,2,45,1.6666666666666667,184.00059590445403,4
2020-09-05-171119,171119,0,0,1,45,0.16666666666666666,133.64305748733534,5
2020-09-06-171119,171119,0,0,1,45,0.0,122.76746300597988,6
2020-09-07-171119,171119,0,0,0,45,1.6666666666666667,97.43517005154511,0
2020-09-08-171119,171119,0,0,4,45,1.5,112.91556743236131,1
2020-09-09-171119,171119,0,0,3,45,1.5,90.15705514003932,2
2020-09-10-171119,171119,1,0,0,46,1.0,53.65436428286823,3
2020-09-11-171119,171119,0,0,0,46,1.8333333333333333,76.81032324092261,4
2020-09-12-171119,171119,0,0,0,46,0.8333333333333334,102.93913211477259,5
2020-09-13-171119,171119,0,0,2,46,0.3333333333333333,109.012360317173,6
2020-09-14-171119,171119,0,0,0,46,1.3333333333333333,100.89394322182301,0
2020-09-15-171119,171119,0,0,4,46,1.0,110.3327640477784,1
2020-09-16-171119,171119,0,0,0,46,1.8333333333333333,114.1912990269116,2
2020-09-17-171119,171119,0,0,2,46,12.666666666666664,134.72508729056577,3
2020-09-18-171119,171119,2,0,0,48,2.6666666666666665,301.34564891582676,4
2020-09-19-171119,171119,1,0,1,49,1.8333333333333333,308.23172826779074,5
2020-09-20-171119,171119,1,0,1,50,1.0,325.23887379291455,6
2020-09-21-171119,171119,0,1,1,50,1.3333333333333333,316.3939953628374,0
2020-09-22-171119,171119,4,0,2,54,1.5,310.6309943765721,1
2020-09-23-171119,171119,3,0,2,57,4.166666666666667,328.47985651446095,2
2020-09-24-171119,171119,0,0,7,57,1.8333333333333333,190.6108867795052,3
2020-09-25-171119,171119,0,0,3,57,9.166666666666666,177.21664742625114,4
2020-09-26-171119,171119,0,0,3,57,1.3333333333333333,209.93545176062378,5
2020-09-27-171119,171119,2,0,1,59,0.16666666666666666,202.98338203326728,6
2020-09-28-171119,171119,0,0,2,59,0.0,215.4914125227508,0
2020-09-29-171119,171119,4,0,1,63,1.1666666666666667,202.11449235761057,1
2020-09-30-171119,171119,0,0,3,63,2.6666666666666665,162.23695937761266,2
2020-10-01-171119,171119,2,0,13,65,0.8333333333333334,0.0,3
2020-10-02-171119,171119,0,0,14,65,2.333333333333333,426.0910824545565,4
2020-10-03-171119,171119,1,0,9,66,1.0,407.3288053685001,5
2020-10-04-171119,171119,1,0,1,67,0.5,302.13304075689973,6
2020-10-05-171119,171119,1,0,1,68,0.8333333333333334,247.47351930683172,0
2020-10-06-171119,171119,2,0,14,70,1.6666666666666667,232.8967614243639,1
2020-10-07-171119,171119,2,0,18,72,2.833333333333333,171.81574667856168,2
2020-10-08-171119,171119,7,0,2,79,3.333333333333333,146.53682684435353,3
2020-10-09-171119,171119,3,1,12,82,2.1666666666666665,214.53789104716907,4
2020-10-10-171119,171119,3,0,0,85,3.1666666666666665,23.897162463025776,5
2020-10-11-171119,171119,1,0,0,86,1.3333333333333333,55.50469750194982,6
2020-10-12-171119,171119,2,0,4,88,0.16666666666666666,70.82115004937386,0
2020-10-13-171119,171119,1,0,0,89,1.8333333333333333,91.70201408152876,1
2020-10-14-171119,171119,3,0,5,92,1.0,111.58202905352968,2
2020-10-15-171119,171119,13,0,1,105,2.6666666666666665,155.16519183137217,3
2020-10-16-171119,171119,14,0,0,119,1.0,274.39511780358134,4
2020-10-17-171119,171119,9,0,0,128,0.8333333333333334,346.6676685991164,5
2020-10-18-171119,171119,1,0,0,129,1.6666666666666667,393.56801291949216,6
2020-10-19-171119,171119,1,0,0,130,1.6666666666666667,403.85547173834533,0
2020-10-20-171119,171119,14,0,1,144,1.5,426.92614976360954,1
2020-10-21-171119,171119,18,0,1,162,3.5,508.20350365865187,2
2020-10-22-171119,171119,2,0,3,164,2.0,571.9135451441928,3
2020-10-23-171119,171119,12,0,0,176,3.8333333333333335,517.0821869604508,4
2020-10-24-171119,171119,0,0,3,176,1.5,557.2491531173208,5
2020-10-25-171119,171119,0,0,1,176,6.0,544.6048973480224,6
2020-10-26-171119,171119,4,2,0,180,3.0,543.767483808063,0
2020-10-27-171119,171119,0,0,3,180,3.1666666666666665,561.5661475123648,1
2020-10-28-171119,171119,5,0,2,185,4.5,461.98698604591,2
2020-10-29-171119,171119,1,1,0,186,3.8333333333333335,366.6611464616631,3
2020-10-30-171119,171119,0,1,2,186,9.333333333333334,262.79615342008213,4
2020-10-31-171119,171119,0,0,0,186,0.8333333333333334,307.34108814930016,5
2020-11-01-171119,171119,0,1,0,186,6.833333333333332,176.84426420701266,6
2020-11-02-171119,171119,0,0,0,186,0.6666666666666666,221.5873797034743,0
2020-11-03-171119,171119,1,2,0,187,4.833333333333333,190.7728133124121,1
2020-11-04-171119,171119,1,0,0,188,4.833333333333333,235.61883440658795,2
2020-11-05-171119,171119,3,0,0,191,5.166666666666667,279.76315571903075,3
2020-11-06-171119,171119,0,0,0,191,6.833333333333332,262.74836356902836,4
2020-11-07-171119,171119,3,0,0,194,2.833333333333333,279.84508774072384,5
2020-11-08-171119,171119,1,1,0,195,0.6666666666666666,278.9805064170965,6
2020-11-09-171119,171119,0,1,0,195,2.6666666666666665,277.0908951730085,0
2020-11-10-171119,171119,3,0,0,198,3.0,189.65611992701355,1
2020-11-11-171119,171119,2,0,0,200,4.333333333333333,216.41259092428348,2
2020-11-12-171119,171119,0,0,0,200,6.666666666666668,252.77861037553384,3
2020-11-13-171119,171119,2,0,0,202,6.666666666666668,276.1495859610218,4
2020-03-01-171120,171120,0,0,1,0,0.0,0.0,6
2020-03-02-171120,171120,0,0,6,0,0.25,40.37217623511891,0
2020-03-03-171120,171120,1,0,7,1,0.0,168.85177066663516,1
2020-03-04-171120,171120,0,0,24,1,0.0,201.38209588015093,2
2020-03-05-171120,171120,1,0,23,2,0.25,221.76750500844926,3
2020-03-06-171120,171120,1,0,24,3,0.0,165.1741293212075,4
2020-03-07-171120,171120,0,0,4,3,0.25,196.32989653142226,5
2020-03-08-171120,171120,1,0,1,4,0.0,231.24951006609768,6
2020-03-09-171120,171120,0,0,24,4,0.5,231.92864627711495,0
2020-03-10-171120,171120,0,0,19,4,0.0,2019.7327310096184,1
2020-03-11-171120,171120,0,0,10,4,1.0,1695.6525108030828,2
2020-03-12-171120,171120,1,0,13,5,1.25,1365.524956566409,3
2020-03-13-171120,171120,2,0,17,7,1.0,571.4995736331255,4
2020-03-14-171120,171120,0,0,1,7,1.0,543.3874106764299,5
2020-03-15-171120,171120,1,0,2,8,0.0,481.1497770637036,6
2020-03-16-171120,171120,6,0,13,14,3.5,132.8497071718484,0
2020-03-17-171120,171120,7,0,15,21,8.75,198.35866888281845,1
2020-03-18-171120,171120,24,1,7,45,7.0,215.19938958191375,2
2020-03-19-171120,171120,23,1,5,68,9.25,222.31309926339281,3
2020-03-20-171120,171120,24,1,4,92,10.0,212.90685479815107,4
2020-03-21-171120,171120,4,0,2,96,3.0,249.44551888573835,5
2020-03-22-171120,171120,1,0,1,97,1.0,240.0365537638994,6
2020-03-23-171120,171120,24,0,10,121,15.0,204.35823783538484,0
2020-03-24-171120,171120,19,1,4,140,8.5,235.04220510839355,1
2020-03-25-171120,171120,10,0,3,150,11.5,233.03441934996127,2
2020-03-26-171120,171120,13,0,5,163,9.0,247.70806476443403,3
2020-03-27-171120,171120,17,0,3,180,10.5,279.35479998375394,4
2020-03-28-171120,171120,1,0,0,181,0.75,283.0436462035046,5
2020-03-29-171120,171120,2,1,0,183,1.75,279.1407544562717,6
2020-03-30-171120,171120,13,0,5,196,9.5,215.0045598270674,0
2020-03-31-171120,171120,15,0,8,211,5.25,241.34693748858786,1
2020-04-01-171120,171120,7,0,6,218,6.0,34.38162246407892,2
2020-04-02-171120,171120,5,0,4,223,5.0,90.44582322078443,3
2020-04-03-171120,171120,4,0,9,227,4.0,131.0426447852066,4
2020-04-04-171120,171120,2,0,0,229,1.5,167.92007957768644,5
2020-04-05-171120,171120,1,0,1,230,0.75,175.35464790280975,6
2020-04-06-171120,171120,10,0,10,240,6.25,184.5720339859438,0
2020-04-07-171120,171120,4,0,1,244,7.25,174.83503814780835,1
2020-04-08-171120,171120,3,0,5,247,4.75,161.54851989573498,2
2020-04-09-171120,171120,5,0,0,252,1.75,168.0216844964914,3
2020-04-10-171120,171120,3,1,7,255,2.0,82.88993479173864,4
2020-04-11-171120,171120,0,0,1,255,0.25,84.80803960836116,5
2020-04-12-171120,171120,0,0,2,255,3.25,95.62987052201939,6
2020-04-13-171120,171120,5,1,7,260,5.0,99.9869183532706,0
2020-04-14-171120,171120,8,0,10,268,4.75,104.49281059440142,1
2020-04-15-171120,171120,6,0,11,274,5.5,115.42777496898057,2
2020-04-16-171120,171120,4,0,10,278,2.25,124.0794354452802,3
2020-04-17-171120,171120,9,0,1,287,4.75,80.09620753094208,4
2020-04-18-171120,171120,0,0,0,287,0.75,111.42441449048295,5
2020-04-19-171120,171120,1,0,0,288,0.0,101.3140308064101,6
2020-04-20-171120,171120,10,0,8,298,4.25,112.85838055979835,0
2020-04-21-171120,171120,1,0,9,299,2.5,120.84887813904557,1
2020-04-22-171120,171120,5,0,10,304,2.75,116.23109097723481,2
2020-04-23-171120,171120,0,0,2,304,0.25,105.97425710652385,3
2020-04-24-171120,171120,7,0,11,311,3.5,70.9347724661417,4
2020-04-25-171120,171120,1,0,0,312,0.25,95.52836687123309,5
2020-04-26-171120,171120,2,0,0,314,0.5,96.33656335154393,6
2020-04-27-171120,171120,7,0,10,321,5.25,71.66862685777102,0
2020-04-28-171120,171120,10,0,9,331,4.0,116.76826873375282,1
2020-04-29-171120,171120,11,0,3,342,4.25,132.77831573057722,2
2020-04-30-171120,171120,10,0,6,352,5.0,165.1977248600855,3
2020-05-01-171120,171120,1,0,8,353,1.0,180.6493783872232,4
2020-05-02-171120,171120,0,0,1,353,0.0,150.70860912450667,5
2020-05-03-171120,171120,0,0,0,353,0.0,100.99401411974378,6
2020-05-04-171120,171120,8,0,6,361,6.5,61.1904405447454,0
2020-05-05-171120,171120,9,0,1,370,4.0,117.84301523933911,1
2020-05-06-171120,171120,10,0,2,380,16.5,136.9070627866979,2
2020-05-07-171120,171120,2,0,5,382,3.5,171.84175025958962,3
2020-05-08-171120,171120,11,0,10,393,5.0,185.56875240141784,4
2020-05-09-171120,171120,0,0,2,393,0.75,230.63096059683846,5
2020-05-10-171120,171120,0,0,0,393,0.25,156.2691476022847,6
2020-05-11-171120,171120,10,1,4,403,4.25,141.6534547129222,0
2020-05-12-171120,171120,9,1,3,412,9.0,163.18487591120197,1
2020-05-13-171120,171120,3,1,0,415,14.0,138.23560851902562,2
2020-05-14-171120,171120,6,0,0,421,5.75,164.5110863719086,3
2020-05-15-171120,171120,8,0,1,429,6.5,164.60562220041928,4
2020-05-16-171120,171120,1,0,0,430,1.25,186.60683400474215,5
2020-05-17-171120,171120,0,0,0,430,0.25,197.80630389793228,6
2020-05-18-171120,171120,6,0,0,436,4.25,198.9926464611896,0
2020-05-19-171120,171120,1,0,0,437,4.5,177.54565973338367,1
2020-05-20-171120,171120,2,0,1,439,3.25,155.06078023130263,2
2020-05-21-171120,171120,5,0,4,444,4.75,146.61078542263218,3
2020-05-22-171120,171120,10,0,0,454,3.0,216.1901423912248,4
2020-05-23-171120,171120,2,0,0,456,1.0,217.73220396505187,5
2020-05-24-171120,171120,0,0,0,456,0.0,222.6632093013563,6
2020-05-25-171120,171120,4,0,1,460,3.5,211.75647465373126,0
2020-05-26-171120,171120,3,0,3,463,4.0,204.07439936005065,1
2020-05-27-171120,171120,0,1,1,463,1.75,232.78336066775643,2
2020-05-28-171120,171120,0,6,0,463,1.0,241.24442535069744,3
2020-05-29-171120,171120,1,0,1,464,1.25,136.0962097381144,4
2020-05-30-171120,171120,0,0,0,464,0.0,148.97906104301242,5
2020-05-31-171120,171120,0,0,0,464,0.0,150.43387844577614,6
2020-06-01-171120,171120,0,0,1,464,0.0,318.42224945460487,0
2020-06-02-171120,171120,0,0,2,464,1.25,51.87145965989123,1
2020-06-03-171120,171120,1,0,0,465,2.25,11.71638871878061,2
2020-06-04-171120,171120,4,0,0,469,0.25,13.858792799569153,3
2020-06-05-171120,171120,0,0,3,469,1.5,29.43456850614152,4
2020-06-06-171120,171120,0,0,0,469,0.0,27.96998552415652,5
2020-06-07-171120,171120,0,1,0,469,0.0,28.88442291122617,6
2020-06-08-171120,171120,1,0,2,470,1.75,28.72616190762959,0
2020-06-09-171120,171120,3,0,0,473,1.0,84.26218009098793,1
2020-06-10-171120,171120,1,0,0,474,0.5,334.88899712871637,2
2020-06-11-171120,171120,0,0,1,474,0.5,230.16783619268764,3
2020-06-12-171120,171120,1,0,2,475,0.75,217.93740339721884,4
2020-06-13-171120,171120,0,1,1,475,0.0,161.93375904323992,5
2020-06-14-171120,171120,0,0,0,475,0.25,113.53360897307022,6
2020-06-15-171120,171120,1,3,0,476,2.25,70.46037771678554,0
2020-06-16-171120,171120,2,0,1,478,0.75,71.71258611933179,1
2020-06-17-171120,171120,0,0,0,478,0.5,73.93877691701529,2
2020-06-18-171120,171120,0,0,1,478,1.0,67.2635387219105,3
2020-06-19-171120,171120,3,0,1,481,1.0,28.870482860830204,4
2020-06-20-171120,171120,0,1,0,481,0.0,63.887884728174086,5
2020-06-21-171120,171120,0,0,0,481,0.0,64.58994840613738,6
2020-06-22-171120,171120,2,0,0,483,0.25,46.611954112303295,0
2020-06-23-171120,171120,0,0,0,483,1.5,46.73887405914363,1
2020-06-24-171120,171120,0,1,0,483,0.75,48.89014221207157,2
2020-06-25-171120,171120,1,0,0,484,0.25,48.20440352297995,3
2020-06-26-171120,171120,2,0,0,486,0.25,15.519534136692682,4
2020-06-27-171120,171120,1,0,0,487,0.0,15.992220358916367,5
2020-06-28-171120,171120,0,0,0,487,0.0,16.943690187382785,6
2020-06-29-171120,171120,0,0,0,487,0.25,17.64329330297541,0
2020-06-30-171120,171120,1,0,0,488,0.25,16.968480601354543,1
2020-07-01-171120,171120,0,0,0,488,0.0,104.68904783455308,2
2020-07-02-171120,171120,1,0,0,489,0.5,6.524060164347544,3
2020-07-03-171120,171120,1,0,0,490,0.5,18.604982256086004,4
2020-07-04-171120,171120,0,0,0,490,0.0,54.53534982999699,5
2020-07-05-171120,171120,0,0,0,490,0.0,54.93812885834922,6
2020-07-06-171120,171120,0,0,0,490,0.5,39.61292484109296,0
2020-07-07-171120,171120,0,0,0,490,0.0,56.16492886870424,1
2020-07-08-171120,171120,0,0,1,490,0.0,54.67573253792209,2
2020-07-09-171120,171120,0,0,0,490,0.25,51.821889029319905,3
2020-07-10-171120,171120,0,1,0,490,0.0,105.74353261541593,4
2020-07-11-171120,171120,0,0,0,490,0.0,89.7550390180919,5
2020-07-12-171120,171120,0,0,0,490,0.25,86.42837897539583,6
2020-07-13-171120,171120,0,0,1,490,0.25,84.39888037276798,0
2020-07-14-171120,171120,0,0,0,490,0.0,85.93014647631506,1
2020-07-15-171120,171120,0,0,0,490,0.25,28.646935337940036,2
2020-07-16-171120,171120,0,0,0,490,0.0,9.972670135426362,3
2020-07-17-171120,171120,0,0,2,490,0.5,10.189904961927748,4
2020-07-18-171120,171120,0,0,2,490,0.0,6.026598747189793,5
2020-07-19-171120,171120,0,0,0,490,0.0,7.014673213761672,6
2020-07-20-171120,171120,0,0,3,490,0.0,7.637895186414466,0
2020-07-21-171120,171120,0,0,0,490,0.0,6.64597053162139,1
2020-07-22-171120,171120,1,0,0,491,0.0,6.48391747242456,2
2020-07-23-171120,171120,0,0,1,491,0.0,8.183872654180412,3
2020-07-24-171120,171120,0,0,0,491,0.0,7.123700208627407,4
2020-07-25-171120,171120,0,0,1,491,0.0,6.723992168096301,5
2020-07-26-171120,171120,0,0,0,491,0.0,6.726779668500823,6
2020-07-27-171120,171120,1,0,5,492,0.25,4.4472293436350725,0
2020-07-28-171120,171120,0,0,1,492,0.25,19.805170082646107,1
2020-07-29-171120,171120,0,0,3,492,0.0,19.91952240928368,2
2020-07-30-171120,171120,0,0,0,492,0.5,20.446755431733635,3
2020-07-31-171120,171120,2,0,3,494,1.75,23.100245696985553,4
2020-08-01-171120,171120,2,0,2,496,0.0,48.621772650499324,5
2020-08-02-171120,171120,0,0,5,496,0.0,322.3463790552346,6
2020-08-03-171120,171120,3,0,1,499,0.75,144.9436493014623,0
2020-08-04-171120,171120,0,0,3,499,0.25,106.87539311270538,1
2020-08-05-171120,171120,0,0,0,499,0.0,89.40631669133936,2
2020-08-06-171120,171120,1,0,1,500,0.5,70.89633101544766,3
2020-08-07-171120,171120,0,0,2,500,0.75,52.41811458223785,4
2020-08-08-171120,171120,1,0,0,501,0.0,48.06703864723575,5
2020-08-09-171120,171120,0,0,0,501,0.0,40.81890964276718,6
2020-08-10-171120,171120,5,0,3,506,0.75,17.537346236335324,0
2020-08-11-171120,171120,1,0,2,507,1.0,27.187095846116303,1
2020-08-12-171120,171120,3,0,0,510,1.75,38.182794999227696,2
2020-08-13-171120,171120,0,0,3,510,0.5,47.775138562739755,3
2020-08-14-171120,171120,3,0,2,513,1.25,157.57763371035733,4
2020-08-15-171120,171120,2,0,1,515,0.25,198.05083417757513,5
2020-08-16-171120,171120,5,0,0,520,0.5,198.03317252360296,6
2020-08-17-171120,171120,1,0,4,521,0.75,203.12952459341204,0
2020-08-18-171120,171120,3,0,1,524,5.75,200.0702857142674,1
2020-08-19-171120,171120,0,0,9,524,0.75,319.6920702023313,2
2020-08-20-171120,171120,1,0,0,525,1.5,196.51699547062486,3
2020-08-21-171120,171120,2,0,5,527,1.5,166.9459246225363,4
2020-08-22-171120,171120,0,0,1,527,0.25,187.11720733851786,5
2020-08-23-171120,171120,0,0,3,527,0.0,190.44603346208913,6
2020-08-24-171120,171120,3,0,4,530,2.25,186.32768550586553,0
2020-08-25-171120,171120,2,0,12,532,2.75,96.62502585602638,1
2020-08-26-171120,171120,0,0,1,532,1.25,103.06626447148602,2
2020-08-27-171120,171120,3,0,9,535,1.75,121.09571349599032,3
2020-08-28-171120,171120,2,1,1,537,1.0,130.44165618141108,4
2020-08-29-171120,171120,1,1,6,538,0.5,125.73097784946025,5
2020-08-30-171120,171120,0,0,0,538,1.5,146.66205191107997,6
2020-08-31-171120,171120,4,0,11,542,1.75,104.06054679807212,0
2020-09-01-171120,171120,1,0,4,543,3.0,41.321220803098186,1
2020-09-02-171120,171120,9,0,6,552,3.0,648.3638667341379,2
2020-09-03-171120,171120,0,0,15,552,2.0,345.6344917953048,3
2020-09-04-171120,171120,5,0,12,557,3.75,284.02942525833595,4
2020-09-05-171120,171120,1,0,9,558,3.25,309.6580285499392,5
2020-09-06-171120,171120,3,0,2,561,3.0,283.9352680922474,6
2020-09-07-171120,171120,4,0,6,565,0.75,185.10587252274365,0
2020-09-08-171120,171120,12,0,2,577,4.25,196.87406080643646,1
2020-09-09-171120,171120,1,0,11,578,0.0,252.06120613022392,2
2020-09-10-171120,171120,9,0,5,587,7.25,100.45531215092342,3
2020-09-11-171120,171120,1,0,5,588,1.25,211.1231889166648,4
2020-09-12-171120,171120,6,0,2,594,2.75,269.82318437925915,5
2020-09-13-171120,171120,0,0,1,594,2.0,297.02789635287775,6
2020-09-14-171120,171120,11,0,2,605,2.75,292.37911145000703,0
2020-09-15-171120,171120,4,0,0,609,3.0,379.13459223490906,1
2020-09-16-171120,171120,6,1,6,615,2.5,431.91233123130974,2
2020-09-17-171120,171120,15,1,1,630,4.0,471.2626638018659,3
2020-09-18-171120,171120,12,0,4,642,7.0,582.7840819823548,4
2020-09-19-171120,171120,9,1,0,651,0.75,673.5337155173925,5
2020-09-20-171120,171120,2,0,0,653,5.0,716.0472408099452,6
2020-09-21-171120,171120,6,2,2,659,4.25,653.9114380534297,0
2020-09-22-171120,171120,2,0,7,661,1.5,655.8881635577533,1
2020-09-23-171120,171120,11,1,7,672,4.75,561.6299444623714,2
2020-09-24-171120,171120,5,0,3,677,3.75,402.74824840746214,3
2020-09-25-171120,171120,5,1,8,682,4.5,318.8846930945364,4
2020-09-26-171120,171120,2,0,0,684,3.75,338.94408948507584,5
2020-09-27-171120,171120,1,0,1,685,3.75,305.4504445392324,6
2020-09-28-171120,171120,2,0,0,687,1.75,403.53896806798616,0
2020-09-29-171120,171120,0,0,6,687,2.0,362.33655584764244,1
2020-09-30-171120,171120,6,0,4,693,4.75,314.95201599987627,2
2020-10-01-171120,171120,1,0,7,694,7.0,0.0,3
2020-10-02-171120,171120,4,0,20,698,3.75,1182.3406386719066,4
2020-10-03-171120,171120,0,0,4,698,1.0,1098.1544174931882,5
2020-10-04-171120,171120,0,0,4,698,0.5,1261.2570643426802,6
2020-10-05-171120,171120,2,1,14,700,3.25,1006.9450002999239,0
2020-10-06-171120,171120,7,0,10,707,3.25,926.2015098747517,1
2020-10-07-171120,171120,7,0,14,714,2.25,910.66263796048,2
2020-10-08-171120,171120,3,0,22,717,1.5,779.488388409764,3
2020-10-09-171120,171120,8,2,17,725,2.75,799.6959608150352,4
2020-10-10-171120,171120,0,0,13,725,1.0,40.21821732493994,5
2020-10-11-171120,171120,1,0,1,726,2.5,94.08658781682979,6
2020-10-12-171120,171120,0,0,32,726,2.25,179.32449780234845,0
2020-10-13-171120,171120,6,0,13,732,1.75,192.28252159511996,1
2020-10-14-171120,171120,4,0,15,736,5.5,225.03973773179393,2
2020-10-15-171120,171120,7,0,21,743,3.75,444.5948488672193,3
2020-10-16-171120,171120,20,0,25,763,11.25,562.4320463111374,4
2020-10-17-171120,171120,4,0,3,767,1.25,1084.3594585678231,5
2020-10-18-171120,171120,4,0,8,771,2.25,1088.5880734546265,6
2020-10-19-171120,171120,14,1,2,785,9.75,1090.3442848794368,0
2020-10-20-171120,171120,10,0,15,795,11.25,1262.6081958152083,1
2020-10-21-171120,171120,14,0,21,809,6.5,1324.9283059404847,2
2020-10-22-171120,171120,22,0,30,831,10.0,1330.0042791408434,3
2020-10-23-171120,171120,17,0,27,848,15.75,968.0810994949873,4
2020-10-24-171120,171120,13,0,8,861,5.5,1158.756970378961,5
2020-10-25-171120,171120,1,1,3,862,1.75,1143.7556146857623,6
2020-10-26-171120,171120,32,1,37,894,11.75,1083.463714877388,0
2020-10-27-171120,171120,13,3,46,907,8.5,1270.034380429658,1
2020-10-28-171120,171120,15,0,12,922,8.0,1084.0217695894285,2
2020-10-29-171120,171120,21,0,21,943,6.5,1094.1332602811372,3
2020-10-30-171120,171120,25,0,14,968,23.25,890.2115436294077,4
2020-10-31-171120,171120,3,1,0,971,2.25,1265.8735475419178,5
2020-11-01-171120,171120,8,1,0,979,4.25,368.7081229701845,6
2020-11-02-171120,171120,2,0,0,981,4.0,696.7499513686414,0
2020-11-03-171120,171120,15,1,0,996,11.25,780.2599886271116,1
2020-11-04-171120,171120,21,1,0,1017,12.75,924.776941905939,2
2020-11-05-171120,171120,30,1,0,1047,10.25,1129.825275672492,3
2020-11-06-171120,171120,27,3,0,1074,28.25,1289.190495144403,4
2020-11-07-171120,171120,8,1,0,1082,5.25,1838.9935148767613,5
2020-11-08-171120,171120,3,1,0,1085,5.0,1668.594028844681,6
2020-11-09-171120,171120,37,2,0,1122,13.75,1613.7556085724682,0
2020-11-10-171120,171120,46,0,0,1168,11.75,376.7138245185173,1
2020-11-11-171120,171120,12,2,0,1180,9.5,532.4998388909324,2
2020-11-12-171120,171120,21,0,0,1201,8.25,704.5881962302805,3
2020-11-13-171120,171120,14,0,0,1215,26.5,704.750557362315,4
2020-03-01-171121,171121,0,0,0,0,0.0,0.0,6
2020-03-02-171121,171121,0,1,2,0,0.14285714285714285,22.63021412631176,0
2020-03-03-171121,171121,0,1,2,0,0.0,93.57967656220967,1
2020-03-04-171121,171121,0,0,3,0,0.0,105.8058466111849,2
2020-03-05-171121,171121,0,0,3,0,0.0,115.29015527924014,3
2020-03-06-171121,171121,0,0,0,0,0.0,87.8249015006487,4
2020-03-07-171121,171121,1,0,1,1,0.14285714285714285,104.73485716817765,5
2020-03-08-171121,171121,0,0,0,1,0.0,119.99641293170015,6
2020-03-09-171121,171121,1,0,5,2,0.14285714285714285,120.31412636622963,0
2020-03-10-171121,171121,0,0,1,2,0.0,892.4524547047952,1
2020-03-11-171121,171121,1,0,3,3,0.42857142857142855,739.9809853397672,2
2020-03-12-171121,171121,3,0,2,6,0.42857142857142855,590.6958410446612,3
2020-03-13-171121,171121,1,0,3,7,0.14285714285714285,267.4591926087953,4
2020-03-14-171121,171121,1,0,0,8,0.14285714285714285,246.6617890678455,5
2020-03-15-171121,171121,0,0,1,8,0.2857142857142857,217.40150821573954,6
2020-03-16-171121,171121,2,0,3,10,1.2857142857142858,63.44104557529709,0
2020-03-17-171121,171121,2,0,2,12,0.5714285714285714,100.74738495389951,1
2020-03-18-171121,171121,3,0,3,15,1.5714285714285714,114.60440731034006,2
2020-03-19-171121,171121,3,0,4,18,1.4285714285714286,134.0277446530581,3
2020-03-20-171121,171121,0,0,4,18,2.0,138.40705875162695,4
2020-03-21-171121,171121,1,0,0,19,1.0,165.4575636940835,5
2020-03-22-171121,171121,0,0,1,19,0.5714285714285714,161.62926749227654,6
2020-03-23-171121,171121,5,0,5,24,3.2857142857142856,140.2630374202619,0
2020-03-24-171121,171121,1,0,1,25,1.1428571428571428,170.0913637588504,1
2020-03-25-171121,171121,3,0,9,28,2.7142857142857144,163.10968065933605,2
2020-03-26-171121,171121,2,0,2,30,2.0,172.69727629679352,3
2020-03-27-171121,171121,3,0,2,33,3.1428571428571432,195.14169995396452,4
2020-03-28-171121,171121,0,0,3,33,0.14285714285714285,203.98106747565922,5
2020-03-29-171121,171121,1,0,3,34,0.5714285714285714,197.74746966942266,6
2020-03-30-171121,171121,3,0,4,37,3.0,145.8314498115361,0
2020-03-31-171121,171121,2,0,0,39,1.1428571428571428,164.4415903336172,1
2020-04-01-171121,171121,3,0,1,42,2.571428571428572,25.717293292778557,2
2020-04-02-171121,171121,4,0,13,46,1.2857142857142858,96.70740949283982,3
2020-04-03-171121,171121,4,0,3,50,1.4285714285714286,95.95372511723602,4
2020-04-04-171121,171121,0,0,0,50,0.7142857142857143,118.42873397966923,5
2020-04-05-171121,171121,1,0,0,51,0.2857142857142857,120.73706554266766,6
2020-04-06-171121,171121,5,0,2,56,2.4285714285714284,127.07362864100745,0
2020-04-07-171121,171121,1,0,0,57,1.0,130.8965514934424,1
2020-04-08-171121,171121,9,0,0,66,0.7142857142857143,127.00129903279031,2
2020-04-09-171121,171121,2,1,0,68,1.1428571428571428,129.95543833359426,3
2020-04-10-171121,171121,2,0,2,70,1.4285714285714286,48.4521030733036,4
2020-04-11-171121,171121,3,0,2,73,1.2857142857142858,52.729704563869376,5
2020-04-12-171121,171121,3,0,0,76,0.42857142857142855,64.43335624853435,6
2020-04-13-171121,171121,4,0,1,80,2.0,70.04838766571805,0
2020-04-14-171121,171121,0,0,3,80,2.142857142857143,82.50844487485207,1
2020-04-15-171121,171121,1,0,6,81,0.42857142857142855,95.09934505582983,2
2020-04-16-171121,171121,13,0,7,94,1.7142857142857142,102.81974959996184,3
2020-04-17-171121,171121,3,0,1,97,1.1428571428571428,93.64165782163121,4
2020-04-18-171121,171121,0,0,2,97,0.2857142857142857,113.88790060154125,5
2020-04-19-171121,171121,0,0,0,97,0.5714285714285714,102.14479158543192,6
2020-04-20-171121,171121,2,0,0,99,1.1428571428571428,100.09871721606137,0
2020-04-21-171121,171121,0,0,1,99,0.7142857142857143,102.50908061153835,1
2020-04-22-171121,171121,0,0,3,99,0.5714285714285714,101.17858880083939,2
2020-04-23-171121,171121,0,0,5,99,0.2857142857142857,82.69470378139201,3
2020-04-24-171121,171121,2,0,2,101,2.142857142857143,58.48028148395753,4
2020-04-25-171121,171121,2,0,1,103,0.2857142857142857,78.31734481799688,5
2020-04-26-171121,171121,0,0,0,103,0.14285714285714285,79.81933734969266,6
2020-04-27-171121,171121,1,0,1,104,2.2857142857142856,62.34285285826976,0
2020-04-28-171121,171121,3,0,4,107,0.5714285714285714,84.60182713260744,1
2020-04-29-171121,171121,6,0,4,113,1.1428571428571428,91.9898261088878,2
2020-04-30-171121,171121,7,0,0,120,1.4285714285714286,123.01443510868438,3
2020-05-01-171121,171121,1,0,1,121,0.2857142857142857,142.5636773712742,4
2020-05-02-171121,171121,2,0,3,123,0.42857142857142855,104.45757147371492,5
2020-05-03-171121,171121,0,0,0,123,0.14285714285714285,64.66388121850044,6
2020-05-04-171121,171121,0,0,1,123,3.0,45.7538454617397,0
2020-05-05-171121,171121,1,0,0,124,2.2857142857142856,76.63732766443499,1
2020-05-06-171121,171121,3,0,1,127,10.285714285714286,96.88261970722391,2
2020-05-07-171121,171121,5,0,0,132,3.2857142857142856,150.4014423923037,3
2020-05-08-171121,171121,2,0,0,134,3.0,176.05604645332068,4
2020-05-09-171121,171121,1,0,0,135,0.14285714285714285,216.3831327149514,5
2020-05-10-171121,171121,0,1,1,135,0.0,131.75166439708087,6
2020-05-11-171121,171121,1,0,0,136,1.2857142857142858,122.64086964762106,0
2020-05-12-171121,171121,4,0,6,140,3.571428571428572,136.20531792607636,1
2020-05-13-171121,171121,4,0,0,144,1.5714285714285714,124.11521573830767,2
2020-05-14-171121,171121,0,1,0,144,0.7142857142857143,138.36290359687945,3
2020-05-15-171121,171121,1,0,0,145,1.1428571428571428,127.07114025894492,4
2020-05-16-171121,171121,3,0,0,148,0.14285714285714285,134.45497719273797,5
2020-05-17-171121,171121,0,0,0,148,0.0,138.63564067427376,6
2020-05-18-171121,171121,1,0,0,149,1.4285714285714286,140.62221073942305,0
2020-05-19-171121,171121,0,0,0,149,2.571428571428572,131.4522020715542,1
2020-05-20-171121,171121,1,0,0,150,1.8571428571428568,105.26488563484043,2
2020-05-21-171121,171121,0,0,0,150,2.571428571428572,109.16133038674066,3
2020-05-22-171121,171121,0,0,0,150,1.4285714285714286,141.96794664625588,4
2020-05-23-171121,171121,0,0,1,150,0.0,147.13620189150373,5
2020-05-24-171121,171121,1,0,0,151,0.0,150.8896618357751,6
2020-05-25-171121,171121,0,0,0,151,0.5714285714285714,138.34076520460889,0
2020-05-26-171121,171121,6,0,0,157,0.7142857142857143,128.71227199912775,1
2020-05-27-171121,171121,0,0,1,157,0.42857142857142855,148.82232773038373,2
2020-05-28-171121,171121,0,0,0,157,1.7142857142857142,144.2506772767577,3
2020-05-29-171121,171121,0,0,1,157,0.42857142857142855,94.50376957937398,4
2020-05-30-171121,171121,0,0,0,157,0.0,97.043645379428,5
2020-05-31-171121,171121,0,0,0,157,0.0,98.34934456415215,6
2020-06-01-171121,171121,0,0,0,157,0.0,287.5839839505139,0
2020-06-02-171121,171121,0,0,0,157,0.42857142857142855,32.56291537848085,1
2020-06-03-171121,171121,0,0,0,157,0.0,11.188424560203398,2
2020-06-04-171121,171121,0,0,0,157,0.7142857142857143,12.63470751681431,3
2020-06-05-171121,171121,0,0,1,157,0.0,22.93983379630125,4
2020-06-06-171121,171121,1,0,0,158,0.14285714285714285,21.845285677182552,5
2020-06-07-171121,171121,0,0,0,158,0.0,23.8611019504645,6
2020-06-08-171121,171121,0,1,0,158,0.5714285714285714,23.45596901076045,0
2020-06-09-171121,171121,0,0,0,158,0.14285714285714285,50.79373640865171,1
2020-06-10-171121,171121,1,0,0,159,0.7142857142857143,290.0105479315379,2
2020-06-11-171121,171121,0,0,0,159,0.2857142857142857,229.0531170375446,3
2020-06-12-171121,171121,1,0,1,160,0.0,208.47549383482317,4
2020-06-13-171121,171121,0,0,0,160,0.0,129.45849093397277,5
2020-06-14-171121,171121,0,0,0,160,0.0,85.33048961370156,6
2020-06-15-171121,171121,0,0,0,160,0.42857142857142855,45.70761635396359,0
2020-06-16-171121,171121,0,0,0,160,0.0,45.1891666790226,1
2020-06-17-171121,171121,0,0,0,160,0.0,46.14458993241499,2
2020-06-18-171121,171121,0,0,0,160,0.14285714285714285,37.30782619737656,3
2020-06-19-171121,171121,1,0,0,161,0.2857142857142857,18.63305446201681,4
2020-06-20-171121,171121,0,0,0,161,0.14285714285714285,39.81653131945136,5
2020-06-21-171121,171121,0,0,0,161,0.0,41.606116800262406,6
2020-06-22-171121,171121,0,0,0,161,0.14285714285714285,32.318334033353196,0
2020-06-23-171121,171121,0,1,0,161,0.0,32.131027214117466,1
2020-06-24-171121,171121,0,0,0,161,0.14285714285714285,33.61287708890248,2
2020-06-25-171121,171121,0,0,0,161,0.14285714285714285,33.29590472795392,3
2020-06-26-171121,171121,1,0,0,162,0.0,15.829509458683116,4
2020-06-27-171121,171121,0,0,0,162,0.0,13.974172575971537,5
2020-06-28-171121,171121,0,0,0,162,0.0,13.83692999640676,6
2020-06-29-171121,171121,0,0,0,162,0.0,14.445473487927007,0
2020-06-30-171121,171121,0,0,0,162,0.14285714285714285,15.030519705202831,1
2020-07-01-171121,171121,0,0,0,162,0.0,63.901641459452364,2
2020-07-02-171121,171121,0,0,0,162,0.14285714285714285,7.0075145213056365,3
2020-07-03-171121,171121,0,0,0,162,0.14285714285714285,14.972940193177042,4
2020-07-04-171121,171121,0,0,0,162,0.0,34.09788546574986,5
2020-07-05-171121,171121,0,0,0,162,0.0,34.61683177085048,6
2020-07-06-171121,171121,0,0,0,162,0.14285714285714285,26.47250182879916,0
2020-07-07-171121,171121,0,0,0,162,0.0,34.66118060410257,1
2020-07-08-171121,171121,0,0,0,162,0.0,32.951768635725564,2
2020-07-09-171121,171121,0,0,0,162,0.0,31.618991091283277,3
2020-07-10-171121,171121,0,0,0,162,0.2857142857142857,65.9644391353126,4
2020-07-11-171121,171121,0,0,0,162,0.0,57.59435441644115,5
2020-07-12-171121,171121,0,0,0,162,0.0,54.86615162193566,6
2020-07-13-171121,171121,0,0,0,162,0.0,52.01477669547852,0
2020-07-14-171121,171121,0,0,0,162,0.14285714285714285,53.3328881654003,1
2020-07-15-171121,171121,0,0,0,162,0.0,23.25351594631824,2
2020-07-16-171121,171121,0,0,0,162,0.0,12.037678421831512,3
2020-07-17-171121,171121,0,0,0,162,0.0,12.363836511024516,4
2020-07-18-171121,171121,0,1,0,162,0.0,6.611803607774033,5
2020-07-19-171121,171121,0,0,0,162,0.0,7.842210431854754,6
2020-07-20-171121,171121,0,0,1,162,0.0,8.557913162497442,0
2020-07-21-171121,171121,0,0,0,162,0.0,7.040178960980145,1
2020-07-22-171121,171121,0,0,0,162,0.0,7.574439430923046,2
2020-07-23-171121,171121,0,0,0,162,0.0,9.039118082696934,3
2020-07-24-171121,171121,0,0,1,162,0.14285714285714285,10.53568683939379,4
2020-07-25-171121,171121,0,0,0,162,0.0,10.52660908219461,5
2020-07-26-171121,171121,0,0,1,162,0.0,10.552477002271067,6
2020-07-27-171121,171121,0,0,1,162,0.14285714285714285,8.195369648063833,0
2020-07-28-171121,171121,0,0,0,162,0.0,16.357977583985758,1
2020-07-29-171121,171121,0,0,0,162,0.14285714285714285,15.873907520110981,2
2020-07-30-171121,171121,0,0,6,162,0.0,14.520300334067308,3
2020-07-31-171121,171121,0,0,4,162,0.42857142857142855,17.142310469195827,4
2020-08-01-171121,171121,0,0,1,162,0.0,28.219420595073768,5
2020-08-02-171121,171121,0,0,0,162,0.0,199.12191541796892,6
2020-08-03-171121,171121,1,0,1,163,0.14285714285714285,135.8842576682409,0
2020-08-04-171121,171121,0,0,1,163,0.14285714285714285,106.8223926258876,1
2020-08-05-171121,171121,0,0,0,163,0.0,85.67868177306627,2
2020-08-06-171121,171121,0,0,0,163,0.0,66.8745034526899,3
2020-08-07-171121,171121,1,0,0,164,0.42857142857142855,53.584035844474755,4
2020-08-08-171121,171121,0,0,0,164,0.0,38.8594305667193,5
2020-08-09-171121,171121,1,0,0,165,0.14285714285714285,33.43578549336738,6
2020-08-10-171121,171121,1,0,2,166,0.0,10.788593451836578,0
2020-08-11-171121,171121,0,0,1,166,0.42857142857142855,17.976556055917072,1
2020-08-12-171121,171121,0,0,2,166,0.7142857142857143,30.01292662720003,2
2020-08-13-171121,171121,6,0,0,172,0.14285714285714285,39.57498272879714,3
2020-08-14-171121,171121,4,0,0,176,0.14285714285714285,111.0450540213075,4
2020-08-15-171121,171121,1,0,0,177,0.2857142857142857,140.131029580836,5
2020-08-16-171121,171121,0,0,0,177,0.14285714285714285,144.78826178394078,6
2020-08-17-171121,171121,1,0,0,178,0.42857142857142855,149.0410828642137,0
2020-08-18-171121,171121,1,0,1,179,1.5714285714285714,150.25144611573074,1
2020-08-19-171121,171121,0,0,0,179,0.14285714285714285,212.49082952403353,2
2020-08-20-171121,171121,0,0,0,179,0.14285714285714285,131.07731796646374,3
2020-08-21-171121,171121,0,0,2,179,0.5714285714285714,111.14649957539767,4
2020-08-22-171121,171121,0,0,1,179,0.2857142857142857,122.33094976537055,5
2020-08-23-171121,171121,0,0,0,179,0.2857142857142857,126.15224167906378,6
2020-08-24-171121,171121,2,0,2,181,0.8571428571428571,120.7263850820872,0
2020-08-25-171121,171121,1,0,3,182,0.14285714285714285,79.81965760653836,1
2020-08-26-171121,171121,2,0,0,184,0.42857142857142855,85.75845002298075,2
2020-08-27-171121,171121,0,0,4,184,0.8571428571428571,108.34651759817027,3
2020-08-28-171121,171121,0,0,0,184,0.14285714285714285,117.88490135326555,4
2020-08-29-171121,171121,0,0,1,184,1.2857142857142858,114.40232475635715,5
2020-08-30-171121,171121,0,0,0,184,0.0,135.88680221669426,6
2020-08-31-171121,171121,0,0,2,184,0.14285714285714285,104.60487973713808,0
2020-09-01-171121,171121,1,0,5,185,0.5714285714285714,32.488069694298254,1
2020-09-02-171121,171121,0,0,1,185,0.8571428571428571,531.6406500606653,2
2020-09-03-171121,171121,0,0,3,185,0.42857142857142855,323.8451719354523,3
2020-09-04-171121,171121,2,0,7,187,0.2857142857142857,255.17341628413348,4
2020-09-05-171121,171121,1,0,1,188,0.2857142857142857,243.24812586549362,5
2020-09-06-171121,171121,0,0,2,188,0.7142857142857143,212.16986848392,6
2020-09-07-171121,171121,2,0,2,190,1.8571428571428568,150.73953220299865,0
2020-09-08-171121,171121,3,0,0,193,1.0,161.9031853767687,1
2020-09-09-171121,171121,0,0,4,193,0.2857142857142857,190.08111571630297,2
2020-09-10-171121,171121,4,0,8,197,0.7142857142857143,59.16794683882537,3
2020-09-11-171121,171121,0,0,4,197,0.5714285714285714,120.41989419481779,4
2020-09-12-171121,171121,1,0,7,198,1.7142857142857142,155.04216332342662,5
2020-09-13-171121,171121,0,0,9,198,1.1428571428571428,172.49631475920648,6
2020-09-14-171121,171121,2,0,1,200,0.7142857142857143,177.0859044431084,0
2020-09-15-171121,171121,5,0,0,205,1.0,224.02621895858692,1
2020-09-16-171121,171121,1,0,9,206,1.5714285714285714,256.968132204203,2
2020-09-17-171121,171121,3,0,0,209,9.857142857142858,286.0784760003718,3
2020-09-18-171121,171121,7,0,9,216,3.1428571428571432,431.0706940362028,4
2020-09-19-171121,171121,1,0,0,217,1.2857142857142858,484.12469070475447,5
2020-09-20-171121,171121,2,0,1,219,0.7142857142857143,498.24742743027497,6
2020-09-21-171121,171121,2,0,0,221,0.8571428571428571,462.9479424985015,0
2020-09-22-171121,171121,0,0,3,221,1.0,479.16911329326973,1
2020-09-23-171121,171121,4,0,0,225,2.142857142857143,433.5531412669669,2
2020-09-24-171121,171121,8,0,1,233,3.4285714285714284,280.7110196470318,3
2020-09-25-171121,171121,4,0,1,237,5.428571428571429,256.41253390706265,4
2020-09-26-171121,171121,7,0,1,244,1.5714285714285714,277.5715373313383,5
2020-09-27-171121,171121,9,0,0,253,1.2857142857142858,280.1891705271634,6
2020-09-28-171121,171121,1,0,1,254,2.0,330.11292584398336,0
2020-09-29-171121,171121,0,0,0,254,1.7142857142857142,293.7503628263906,1
2020-09-30-171121,171121,9,0,3,263,2.0,253.8661640984434,2
2020-10-01-171121,171121,0,0,3,263,1.4285714285714286,0.0,3
2020-10-02-171121,171121,9,0,1,272,1.4285714285714286,598.582193663735,4
2020-10-03-171121,171121,0,0,2,272,0.7142857142857143,647.7074864578428,5
2020-10-04-171121,171121,1,0,1,273,0.8571428571428571,712.3674304112044,6
2020-10-05-171121,171121,0,0,0,273,1.8571428571428568,581.2273202418714,0
2020-10-06-171121,171121,3,0,2,276,2.7142857142857144,533.1070571114427,1
2020-10-07-171121,171121,0,1,3,276,0.8571428571428571,508.5115314003064,2
2020-10-08-171121,171121,1,0,5,277,1.2857142857142858,426.6514542336616,3
2020-10-09-171121,171121,1,1,6,278,1.2857142857142858,439.04879162682516,4
2020-10-10-171121,171121,1,0,1,279,0.7142857142857143,27.106151999214042,5
2020-10-11-171121,171121,0,0,4,279,0.7142857142857143,56.36867443867585,6
2020-10-12-171121,171121,1,0,4,280,0.7142857142857143,96.6797367975567,0
2020-10-13-171121,171121,0,0,5,280,0.2857142857142857,109.08071047531163,1
2020-10-14-171121,171121,3,0,6,283,1.2857142857142858,126.91455918652598,2
2020-10-15-171121,171121,3,0,9,286,1.2857142857142858,230.37829598711485,3
2020-10-16-171121,171121,1,0,17,287,3.0,299.61203244533164,4
2020-10-17-171121,171121,2,0,3,289,0.7142857142857143,524.7825899753974,5
2020-10-18-171121,171121,1,1,1,290,1.1428571428571428,528.9399036003566,6
2020-10-19-171121,171121,0,0,0,290,2.2857142857142856,531.8187075685436,0
2020-10-20-171121,171121,2,0,2,292,4.571428571428571,619.5671858933521,1
2020-10-21-171121,171121,3,0,8,295,2.2857142857142856,666.6529037936169,2
2020-10-22-171121,171121,5,0,6,300,4.285714285714286,698.380673140409,3
2020-10-23-171121,171121,6,0,7,306,4.285714285714286,582.7332371676123,4
2020-10-24-171121,171121,1,1,6,307,1.8571428571428568,673.7683090592598,5
2020-10-25-171121,171121,4,0,2,311,1.7142857142857142,663.6412743094572,6
2020-10-26-171121,171121,4,0,4,315,4.714285714285714,632.95853943468,0
2020-10-27-171121,171121,5,0,10,320,2.8571428571428568,716.1287820075015,1
2020-10-28-171121,171121,6,0,10,326,3.4285714285714284,631.4354672237039,2
2020-10-29-171121,171121,9,0,10,335,2.142857142857143,623.487311084037,3
2020-10-30-171121,171121,17,1,6,352,7.428571428571429,491.47287015040547,4
2020-10-31-171121,171121,3,3,0,355,0.5714285714285714,679.390923528417,5
2020-11-01-171121,171121,1,1,0,356,2.0,219.72896215691466,6
2020-11-02-171121,171121,0,2,0,356,1.5714285714285714,415.29021154113747,0
2020-11-03-171121,171121,2,1,0,358,6.428571428571429,441.7070022660351,1
2020-11-04-171121,171121,8,1,0,366,6.142857142857142,535.0592567380863,2
2020-11-05-171121,171121,6,2,0,372,4.0,638.610300729531,3
2020-11-06-171121,171121,7,3,0,379,9.142857142857142,700.3480003536035,4
2020-11-07-171121,171121,6,0,0,385,0.7142857142857143,934.0759633936051,5
2020-11-08-171121,171121,2,0,0,387,1.0,859.1034760528873,6
2020-11-09-171121,171121,4,0,0,391,3.4285714285714284,828.6242129412885,0
2020-11-10-171121,171121,10,0,0,401,2.571428571428572,229.06403542999203,1
2020-11-11-171121,171121,10,1,0,411,4.0,310.89568595990374,2
2020-11-12-171121,171121,10,0,0,421,2.142857142857143,398.15562219277047,3
2020-11-13-171121,171121,6,3,0,427,2.7142857142857144,407.5673473601312,4
2020-03-01-171122,171122,0,0,0,0,0.0,0.0,6
2020-03-02-171122,171122,1,0,4,1,0.0,177.59635341798173,0
2020-03-03-171122,171122,0,0,1,1,0.1111111111111111,714.6930154519079,1
2020-03-04-171122,171122,0,0,1,1,0.0,841.5229199534765,2
2020-03-05-171122,171122,0,1,2,1,0.2222222222222222,917.3274728821698,3
2020-03-06-171122,171122,0,1,4,1,0.1111111111111111,688.1655332066321,4
2020-03-07-171122,171122,1,0,0,2,0.1111111111111111,821.3927121003971,5
2020-03-08-171122,171122,0,0,1,2,0.1111111111111111,964.5471921323974,6
2020-03-09-171122,171122,1,0,2,3,0.2222222222222222,966.6451589967148,0
2020-03-10-171122,171122,0,0,2,3,0.0,8227.467500465626,1
2020-03-11-171122,171122,2,0,5,5,0.5555555555555556,6927.022071165133,2
2020-03-12-171122,171122,3,0,5,8,0.6666666666666666,5601.988076996536,3
2020-03-13-171122,171122,1,0,6,9,1.1111111111111112,2373.5826118025943,4
2020-03-14-171122,171122,1,0,0,10,0.4444444444444444,2260.6920661363597,5
2020-03-15-171122,171122,0,0,0,10,0.3333333333333333,2012.4293828246211,6
2020-03-16-171122,171122,4,0,6,14,2.555555555555556,553.0727021794952,0
2020-03-17-171122,171122,1,0,0,15,5.0,836.8420123952759,1
2020-03-18-171122,171122,1,0,7,16,7.5555555555555545,925.7067797036079,2
2020-03-19-171122,171122,2,0,2,18,8.11111111111111,988.7927830264512,3
2020-03-20-171122,171122,4,0,1,22,8.11111111111111,972.3759715260592,4
2020-03-21-171122,171122,0,0,1,22,3.111111111111111,1161.1908513289222,5
2020-03-22-171122,171122,1,0,1,23,1.6666666666666667,1123.8685354785416,6
2020-03-23-171122,171122,2,0,4,25,13.0,970.343286004386,0
2020-03-24-171122,171122,2,0,0,27,7.111111111111112,1124.4764961036567,1
2020-03-25-171122,171122,5,0,0,32,7.777777777777778,1109.91519822774,2
2020-03-26-171122,171122,5,0,0,37,6.333333333333332,1174.0585460582984,3
2020-03-27-171122,171122,6,0,0,43,8.222222222222221,1326.386217726449,4
2020-03-28-171122,171122,0,0,1,43,0.6666666666666666,1346.2385909462746,5
2020-03-29-171122,171122,0,0,0,43,1.5555555555555556,1321.737404753155,6
2020-03-30-171122,171122,6,0,0,49,7.333333333333332,1009.1122949275853,0
2020-03-31-171122,171122,0,0,0,49,5.111111111111111,1129.6110565067604,1
2020-04-01-171122,171122,7,0,1,56,4.333333333333333,163.21617854496168,2
2020-04-02-171122,171122,2,0,0,58,3.6666666666666665,451.9853678428973,3
2020-04-03-171122,171122,1,0,2,59,3.555555555555556,615.5994938800325,4
2020-04-04-171122,171122,1,0,0,60,1.0,777.9770162385342,5
2020-04-05-171122,171122,1,0,0,61,0.5555555555555556,814.5023380157352,6
2020-04-06-171122,171122,4,0,1,65,5.4444444444444455,857.7605304603783,0
2020-04-07-171122,171122,0,0,1,65,4.666666666666667,819.203755637794,1
2020-04-08-171122,171122,0,0,0,65,4.111111111111111,761.0519660576199,2
2020-04-09-171122,171122,0,0,0,65,2.333333333333333,788.3787916092429,3
2020-04-10-171122,171122,0,0,2,65,2.888888888888889,378.29432924224625,4
2020-04-11-171122,171122,1,0,0,66,1.5555555555555556,390.4375554379871,5
2020-04-12-171122,171122,0,0,0,66,2.2222222222222223,442.8140739773118,6
2020-04-13-171122,171122,0,0,6,66,4.777777777777779,463.8765393033073,0
2020-04-14-171122,171122,0,0,2,66,4.4444444444444455,492.2962178136533,1
2020-04-15-171122,171122,1,0,0,67,4.111111111111111,547.2408157033918,2
2020-04-16-171122,171122,0,0,4,67,4.666666666666667,592.4109824593172,3
2020-04-17-171122,171122,2,0,0,69,4.888888888888889,409.2548992463125,4
2020-04-18-171122,171122,0,0,0,69,0.5555555555555556,553.5072218211784,5
2020-04-19-171122,171122,0,0,0,69,0.4444444444444444,501.7467607479768,6
2020-04-20-171122,171122,1,0,6,70,4.0,548.849356362831,0
2020-04-21-171122,171122,1,0,1,71,2.0,590.1681094072292,1
2020-04-22-171122,171122,0,0,0,71,2.888888888888889,568.8731869711285,2
2020-04-23-171122,171122,0,0,3,71,0.3333333333333333,510.5884153471893,3
2020-04-24-171122,171122,2,0,1,73,4.0,343.71717824428015,4
2020-04-25-171122,171122,0,0,1,73,0.7777777777777778,463.4295974547053,5
2020-04-26-171122,171122,0,0,0,73,0.5555555555555556,469.36144667896644,6
2020-04-27-171122,171122,6,0,2,79,3.888888888888889,354.59761195283727,0
2020-04-28-171122,171122,2,0,2,81,3.4444444444444446,554.6902441899116,1
2020-04-29-171122,171122,0,0,3,81,4.5555555555555545,620.4685352935254,2
2020-04-30-171122,171122,4,0,3,85,4.666666666666667,772.4066931393977,3
2020-05-01-171122,171122,0,0,2,85,0.7777777777777778,842.555139626018,4
2020-05-02-171122,171122,0,0,1,85,0.5555555555555556,704.8668994560803,5
2020-05-03-171122,171122,0,0,0,85,0.3333333333333333,462.94216324333263,6
2020-05-04-171122,171122,6,0,0,91,5.666666666666668,283.35586349523385,0
2020-05-05-171122,171122,1,0,5,92,5.222222222222221,537.3383403678374,1
2020-05-06-171122,171122,0,0,1,92,16.77777777777778,637.9185924247913,2
2020-05-07-171122,171122,3,0,9,95,4.4444444444444455,814.7616884920338,3
2020-05-08-171122,171122,1,0,0,96,6.0,887.1135016137353,4
2020-05-09-171122,171122,1,0,0,97,0.5555555555555556,1094.6985312192678,5
2020-05-10-171122,171122,0,1,0,97,0.1111111111111111,727.275066726829,6
2020-05-11-171122,171122,2,0,4,99,3.7777777777777777,660.8462956252556,0
2020-05-12-171122,171122,2,0,1,101,8.0,764.8133691574801,1
2020-05-13-171122,171122,3,0,2,104,8.0,655.6292541707778,2
2020-05-14-171122,171122,3,0,0,107,3.2222222222222223,771.4973907790256,3
2020-05-15-171122,171122,2,0,2,109,4.666666666666667,766.7283603017893,4
2020-05-16-171122,171122,1,0,0,110,0.8888888888888888,867.1131420899462,5
2020-05-17-171122,171122,0,0,0,110,0.1111111111111111,916.3020328673842,6
2020-05-18-171122,171122,0,0,0,110,3.6666666666666665,922.4898771607803,0
2020-05-19-171122,171122,5,0,0,115,3.2222222222222223,823.4550033813291,1
2020-05-20-171122,171122,1,0,0,116,2.888888888888889,707.266903541624,2
2020-05-21-171122,171122,9,0,1,125,2.7777777777777777,668.3038040501675,3
2020-05-22-171122,171122,0,0,0,125,3.6666666666666665,963.4665650752224,4
2020-05-23-171122,171122,0,0,0,125,0.6666666666666666,975.2931541599177,5
2020-05-24-171122,171122,0,0,0,125,0.1111111111111111,996.5708027983169,6
2020-05-25-171122,171122,4,0,4,129,1.8888888888888888,945.8170449471334,0
2020-05-26-171122,171122,1,0,1,130,3.111111111111111,916.4101467722645,1
2020-05-27-171122,171122,2,0,0,132,0.6666666666666666,1043.2996988084901,2
2020-05-28-171122,171122,0,1,2,132,1.8888888888888888,1070.8085961925476,3
2020-05-29-171122,171122,2,0,0,134,0.5555555555555556,612.3144552592036,4
2020-05-30-171122,171122,0,0,0,134,0.0,659.7289532330841,5
2020-05-31-171122,171122,0,0,0,134,0.0,663.8031688848772,6
2020-06-01-171122,171122,0,0,2,134,0.0,1456.839460511214,0
2020-06-02-171122,171122,0,0,0,134,1.1111111111111112,230.60713175013592,1
2020-06-03-171122,171122,0,0,0,134,1.2222222222222223,58.17320141372492,2
2020-06-04-171122,171122,1,0,0,135,0.8888888888888888,67.97204621647509,3
2020-06-05-171122,171122,0,0,1,135,0.7777777777777778,134.73302969161415,4
2020-06-06-171122,171122,0,0,0,135,0.2222222222222222,129.48108258017078,5
2020-06-07-171122,171122,0,0,0,135,0.0,133.76611526462284,6
2020-06-08-171122,171122,4,0,0,139,0.5555555555555556,132.05679808232142,0
2020-06-09-171122,171122,1,0,0,140,0.6666666666666666,368.3729796035443,1
2020-06-10-171122,171122,0,0,0,140,0.7777777777777778,1526.0248022958692,2
2020-06-11-171122,171122,2,0,0,142,0.2222222222222222,1060.5079085795198,3
2020-06-12-171122,171122,0,0,0,142,0.5555555555555556,989.5654245177504,4
2020-06-13-171122,171122,0,0,0,142,0.0,724.2209042673093,5
2020-06-14-171122,171122,0,2,0,142,0.1111111111111111,507.6974093399649,6
2020-06-15-171122,171122,2,1,0,144,1.0,306.47017137402446,0
2020-06-16-171122,171122,0,0,0,144,0.5555555555555556,309.5916607984615,1
2020-06-17-171122,171122,0,0,0,144,0.3333333333333333,321.7330335774787,2
2020-06-18-171122,171122,0,0,0,144,0.5555555555555556,292.30831801757995,3
2020-06-19-171122,171122,1,0,0,145,1.0,129.68713893930845,4
2020-06-20-171122,171122,0,0,0,145,0.1111111111111111,282.7838176011436,5
2020-06-21-171122,171122,0,0,0,145,0.0,287.6904090074722,6
2020-06-22-171122,171122,0,0,1,145,0.4444444444444444,210.5990111457967,0
2020-06-23-171122,171122,0,0,0,145,0.7777777777777778,210.23130992503448,1
2020-06-24-171122,171122,0,1,0,145,0.4444444444444444,219.53676548427944,2
2020-06-25-171122,171122,0,0,0,145,0.5555555555555556,215.61460014708405,3
2020-06-26-171122,171122,0,0,0,145,0.5555555555555556,75.47608468094275,4
2020-06-27-171122,171122,0,0,0,145,0.1111111111111111,76.36525270086531,5
2020-06-28-171122,171122,0,0,0,145,0.0,80.05668614207897,6
2020-06-29-171122,171122,0,0,0,145,0.1111111111111111,83.57183465698483,0
2020-06-30-171122,171122,0,0,0,145,0.3333333333333333,81.69856935523177,1
2020-07-01-171122,171122,0,0,0,145,0.0,455.2913451275093,2
2020-07-02-171122,171122,0,0,0,145,0.4444444444444444,36.15604286370564,3
2020-07-03-171122,171122,0,0,0,145,0.3333333333333333,81.6507898112671,4
2020-07-04-171122,171122,0,0,0,145,0.1111111111111111,240.82398201334087,5
2020-07-05-171122,171122,0,0,0,145,0.0,243.45627342997795,6
2020-07-06-171122,171122,1,0,0,146,0.1111111111111111,176.80707014719195,0
2020-07-07-171122,171122,0,2,0,146,0.0,245.91597109336803,1
2020-07-08-171122,171122,0,0,0,146,0.0,238.1580908799226,2
2020-07-09-171122,171122,0,0,0,146,0.1111111111111111,226.02463142582445,3
2020-07-10-171122,171122,0,0,0,146,0.2222222222222222,459.8142190020294,4
2020-07-11-171122,171122,0,0,0,146,0.0,387.89407687623327,5
2020-07-12-171122,171122,0,0,0,146,0.1111111111111111,371.51272308166824,6
2020-07-13-171122,171122,0,0,1,146,0.3333333333333333,363.04571090475423,0
2020-07-14-171122,171122,0,0,0,146,0.4444444444444444,371.04732647682465,1
2020-07-15-171122,171122,0,0,0,146,0.1111111111111111,128.21995635657672,2
2020-07-16-171122,171122,0,0,0,146,0.1111111111111111,46.50037382483177,3
2020-07-17-171122,171122,0,0,2,146,0.3333333333333333,48.65023650303731,4
2020-07-18-171122,171122,0,0,0,146,0.1111111111111111,32.67827336006839,5
2020-07-19-171122,171122,0,0,0,146,0.0,38.889153385844146,6
2020-07-20-171122,171122,0,0,0,146,0.0,41.19398458638107,0
2020-07-21-171122,171122,0,0,0,146,0.0,35.30543668177189,1
2020-07-22-171122,171122,0,0,0,146,0.2222222222222222,34.19528810158458,2
2020-07-23-171122,171122,0,0,0,146,0.0,43.37074793225548,3
2020-07-24-171122,171122,0,0,1,146,0.1111111111111111,37.93271821629673,4
2020-07-25-171122,171122,0,0,0,146,0.0,34.42527110446746,5
2020-07-26-171122,171122,0,0,0,146,0.0,34.096689736439814,6
2020-07-27-171122,171122,1,0,0,147,0.2222222222222222,22.671609065310065,0
2020-07-28-171122,171122,0,0,0,147,0.1111111111111111,89.16270641652551,1
2020-07-29-171122,171122,0,0,1,147,0.2222222222222222,89.38671915842573,2
2020-07-30-171122,171122,0,0,0,147,0.4444444444444444,90.92726161775312,3
2020-07-31-171122,171122,2,0,0,149,0.8888888888888888,105.68582817658455,4
2020-08-01-171122,171122,0,0,0,149,0.2222222222222222,209.02767387729003,5
2020-08-02-171122,171122,0,0,0,149,0.0,1386.993410997719,6
2020-08-03-171122,171122,0,0,0,149,0.8888888888888888,626.5308208053716,0
2020-08-04-171122,171122,0,0,7,149,0.2222222222222222,461.90820812507025,1
2020-08-05-171122,171122,0,0,0,149,0.0,387.37240391504525,2
2020-08-06-171122,171122,0,0,0,149,0.3333333333333333,310.10990576496016,3
2020-08-07-171122,171122,1,0,1,150,0.4444444444444444,229.73936169743928,4
2020-08-08-171122,171122,0,0,0,150,0.1111111111111111,218.4069895018426,5
2020-08-09-171122,171122,0,0,0,150,0.1111111111111111,184.49587103132268,6
2020-08-10-171122,171122,0,0,2,150,1.0,75.86673846522356,0
2020-08-11-171122,171122,0,0,0,150,0.5555555555555556,121.44338202963112,1
2020-08-12-171122,171122,1,0,0,151,1.4444444444444444,167.20333436528156,2
2020-08-13-171122,171122,0,0,0,151,1.2222222222222223,215.14428686161085,3
2020-08-14-171122,171122,0,0,0,151,1.4444444444444444,692.4549994975268,4
2020-08-15-171122,171122,0,0,0,151,0.6666666666666666,871.3052551226015,5
2020-08-16-171122,171122,0,0,0,151,0.7777777777777778,877.9562175883447,6
2020-08-17-171122,171122,0,0,0,151,0.7777777777777778,908.6025983206127,0
2020-08-18-171122,171122,7,0,4,158,2.6666666666666665,895.2707318518902,1
2020-08-19-171122,171122,0,0,4,158,0.4444444444444444,1410.9674666936678,2
2020-08-20-171122,171122,0,0,0,158,1.2222222222222223,859.730310320661,3
2020-08-21-171122,171122,1,0,2,159,1.0,727.9645738051066,4
2020-08-22-171122,171122,0,0,0,159,0.2222222222222222,814.4620252937357,5
2020-08-23-171122,171122,0,0,1,159,0.3333333333333333,820.1915746182916,6
2020-08-24-171122,171122,2,0,0,161,1.5555555555555556,798.0115315491037,0
2020-08-25-171122,171122,0,0,2,161,1.7777777777777777,425.5185394842746,1
2020-08-26-171122,171122,0,0,0,161,0.8888888888888888,456.80324049897104,2
2020-08-27-171122,171122,0,0,3,161,1.3333333333333333,533.8203113776487,3
2020-08-28-171122,171122,0,0,2,161,0.8888888888888888,571.995124227546,4
2020-08-29-171122,171122,0,0,1,161,0.3333333333333333,551.149039776996,5
2020-08-30-171122,171122,0,0,0,161,0.6666666666666666,637.3762982717685,6
2020-08-31-171122,171122,0,0,2,161,1.4444444444444444,452.41477276530674,0
2020-09-01-171122,171122,4,0,2,165,1.2222222222222223,182.93494428700845,1
2020-09-02-171122,171122,4,0,4,169,2.0,2750.2511709458295,2
2020-09-03-171122,171122,0,0,3,169,0.8888888888888888,1569.8607843377463,3
2020-09-04-171122,171122,2,0,7,171,2.4444444444444446,1268.099927795035,4
2020-09-05-171122,171122,0,0,0,171,1.7777777777777777,1357.3841742843326,5
2020-09-06-171122,171122,1,0,1,172,1.6666666666666667,1232.951441688579,6
2020-09-07-171122,171122,0,0,0,172,2.1111111111111107,812.2036716552279,0
2020-09-08-171122,171122,2,0,0,174,4.333333333333333,858.1181466017867,1
2020-09-09-171122,171122,0,0,1,174,0.5555555555555556,1103.4998781503543,2
2020-09-10-171122,171122,3,0,2,177,4.777777777777779,422.87894743882435,3
2020-09-11-171122,171122,2,0,6,179,0.6666666666666666,890.8308500283104,4
2020-09-12-171122,171122,1,0,0,180,2.1111111111111107,1134.3230325703794,5
2020-09-13-171122,171122,0,0,6,180,1.7777777777777777,1255.3109365304697,6
2020-09-14-171122,171122,2,0,0,182,2.555555555555556,1244.975548366428,0
2020-09-15-171122,171122,2,0,0,184,2.333333333333333,1608.9795977383624,1
2020-09-16-171122,171122,4,0,0,188,1.4444444444444444,1827.5729276517202,2
2020-09-17-171122,171122,3,0,0,191,3.7777777777777777,2000.9881664484349,3
2020-09-18-171122,171122,7,0,1,198,5.888888888888888,2419.333054403278,4
2020-09-19-171122,171122,0,0,1,198,2.7777777777777777,2789.811926892429,5
2020-09-20-171122,171122,1,1,0,199,3.555555555555556,2956.2937538280107,6
2020-09-21-171122,171122,0,0,0,199,6.333333333333332,2698.729600248588,0
2020-09-22-171122,171122,0,1,6,199,1.4444444444444444,2765.6171806188704,1
2020-09-23-171122,171122,1,0,2,200,5.111111111111111,2386.274084943702,2
2020-09-24-171122,171122,2,2,2,202,5.5555555555555545,1774.9397334203763,3
2020-09-25-171122,171122,6,1,2,208,5.888888888888888,1449.5848676187038,4
2020-09-26-171122,171122,0,0,3,208,4.333333333333333,1541.7313723439179,5
2020-09-27-171122,171122,6,0,4,214,2.888888888888889,1415.5541781241257,6
2020-09-28-171122,171122,0,0,1,214,2.7777777777777777,1814.5329055495627,0
2020-09-29-171122,171122,0,0,1,214,2.333333333333333,1594.4723458811657,1
2020-09-30-171122,171122,0,0,4,214,5.111111111111111,1386.344064366992,2
2020-10-01-171122,171122,0,0,3,214,4.666666666666667,0.0,3
2020-10-02-171122,171122,1,0,16,215,4.4444444444444455,4911.070932914252,4
2020-10-03-171122,171122,1,0,3,216,1.6666666666666667,4638.2397725129495,5
2020-10-04-171122,171122,0,1,5,216,1.2222222222222223,5317.237656329066,6
2020-10-05-171122,171122,0,1,4,216,3.2222222222222223,4251.584561956362,0
2020-10-06-171122,171122,6,0,17,222,3.7777777777777777,3884.193631995916,1
2020-10-07-171122,171122,2,0,4,224,2.0,3798.7237074074383,2
2020-10-08-171122,171122,2,0,7,226,2.1111111111111107,3241.7401658949243,3
2020-10-09-171122,171122,2,0,13,228,2.888888888888889,3301.7300126114246,4
2020-10-10-171122,171122,3,0,3,231,0.8888888888888888,176.9669617249229,5
2020-10-11-171122,171122,4,0,2,235,1.0,396.56123974375896,6
2020-10-12-171122,171122,1,0,13,236,1.3333333333333333,739.8239168081061,0
2020-10-13-171122,171122,1,0,2,237,1.8888888888888888,801.2278621367266,1
2020-10-14-171122,171122,4,0,4,241,3.7777777777777777,942.7712421653241,2
2020-10-15-171122,171122,3,0,5,244,3.333333333333333,1834.0857337984262,3
2020-10-16-171122,171122,16,0,22,260,6.5555555555555545,2332.551019641862,4
2020-10-17-171122,171122,3,0,0,263,1.5555555555555556,4456.048679726872,5
2020-10-18-171122,171122,5,0,1,268,1.2222222222222223,4477.3256335479955,6
2020-10-19-171122,171122,4,0,4,272,7.111111111111112,4496.546356014282,0
2020-10-20-171122,171122,17,0,8,289,6.5555555555555545,5217.287308197493,1
2020-10-21-171122,171122,4,0,14,293,9.0,5521.063401679147,2
2020-10-22-171122,171122,7,0,8,300,12.888888888888891,5612.984207784611,3
2020-10-23-171122,171122,13,1,46,313,10.222222222222221,4217.932249827106,4
2020-10-24-171122,171122,3,1,0,316,4.4444444444444455,4996.045147891174,5
2020-10-25-171122,171122,2,1,2,318,1.4444444444444444,4941.37041244606,6
2020-10-26-171122,171122,13,2,16,331,9.666666666666666,4669.801394208015,0
2020-10-27-171122,171122,2,1,4,333,7.333333333333332,5429.257082540156,1
2020-10-28-171122,171122,4,2,8,337,7.888888888888888,4662.993441360555,2
2020-10-29-171122,171122,5,0,6,342,6.777777777777778,4665.7728620811795,3
2020-10-30-171122,171122,22,2,2,364,15.222222222222221,3741.131674196321,4
2020-10-31-171122,171122,0,1,0,364,2.333333333333333,5287.724144653258,5
2020-11-01-171122,171122,1,0,0,365,3.333333333333333,1555.2101803677438,6
2020-11-02-171122,171122,4,0,0,369,2.0,2958.298503079852,0
2020-11-03-171122,171122,8,1,0,377,8.444444444444445,3300.489313727444,1
2020-11-04-171122,171122,14,0,0,391,9.444444444444443,3902.034656519768,2
2020-11-05-171122,171122,8,1,0,399,10.0,4710.118034864966,3
2020-11-06-171122,171122,46,0,0,445,13.222222222222221,5386.2450149172955,4
2020-11-07-171122,171122,0,2,0,445,4.666666666666667,7616.771679004414,5
2020-11-08-171122,171122,2,1,0,447,3.111111111111111,6938.669417219028,6
2020-11-09-171122,171122,16,0,0,463,9.444444444444443,6742.971789469788,0
2020-11-10-171122,171122,4,4,0,467,12.555555555555555,1588.3281076229732,1
2020-11-11-171122,171122,8,1,0,475,7.888888888888888,2264.016229681346,2
2020-11-12-171122,171122,6,0,0,481,7.222222222222222,2998.5957273650706,3
2020-11-13-171122,171122,2,0,0,483,15.777777777777779,3021.037875750707,4
